маҷк	a little
арацәа	a lot
ирацәаны	a lot of
агәыгәҭажьра	abandon
ихылаԥшыдоу	abandoned
ақәныҟәара	abide
абаҩхатәра	ability
Аҧсуа	Abkhaz
Аҧсшәа	Abkhaz
алшара змо	able
аханы	above
нырцә	abroad
аҟамзаара	absence
иҟам	absent
хымԥада	absolutely
ахәлабгара	absorb
абстрактә	abstract
абсурдтә	absurd
амцхә	abundance
абеиа	abundant
аӷьра	abuse
акцент	accent
адкылара	accept
анеирҭа	access
амашәыр	accident
анхарҭаҭыԥ	accommodation
анагӡара	accomplish
инҵәаз	accomplished
ишаҳәо ала	according
аԥхьаӡара	account
аиашаԥҵәара	accuracy
аиқәҷаб	accurate
аара адҵара	accused
ахьаа	ache
азнеира	achieve
ақәҿиара	achievement
адырра	acknowledge
аибадырра	acquaintance
аиура	acquire
аиура	acquired
арҳамҭа	acquisition
арҳара	acquisition
аиасра	across
аусура	act
аусура	action
активтә	active
аусушьа	activities
активра	activity
актер	actor
актуалра зцу	actual
ииашаҵәҟьаны	actually
аҵры	acute
анраалара	adapt
ацҵара	add
ахьыԥшытә	addicted
ацҵа	addition
ахарҭәаара	addition
инаццҵаны	additional
адрес	address
иашьашәало	adequate
агәыларатәи	adjacent
аҟазшьарба	adjective
аиҿкаара	adjust
ашанхара	admire
адырра	admit
ԥас аҟаҵара	adopt
иблахкыгоу	adorable
заа	advance
аԥхьагыларатә	advanced
аԥыжәара	advantage
аҟала	adventure
ацынгыла	adverb
аӡыргара	advertisement
аӡыргара	advertising
аӡыргара ашьҭра	advertising
алабжьара	advice
абжьагара	advise
иабжьеигеит	advise
адукат	advocate
аестетикатә	aesthetic
аус	affair
аннырра	affect
адҳәалара	affection
азин аҭара	afford
имариоу	affordable
ашәара	afraid
ашьҭахь	after
шьыбжьон	afternoon
пыҭрак ашьҭахь	afterwards
даҽазнык	again
аҿагылара	against
ақәра	age
агентра	agency
агент	agent
агрессиатә	aggressive
аихатыр	agile
шьҭахьҟа	ago
ақәшаҳаҭра	agree
аиқәшаҳаҭхара	agreement
ақыҭанхара	agriculture
аԥхьа	ahead
ацхыраара	aid
ахықәкы	aim
аҳауа	air
аҳаирбаӷәаза	airport
ацәаҳәақәа рыбжьысра	aisle
агәҭынчымра	alarm
алкоҳоль	alcohol
агәҭынчымра	alert
зыԥсы то	alive
зегьы	all
ибзиоуп	all right
иреиӷьӡоу зегьы	all the best
алшара аҭара	allow
иҟалон	allowed
зынӡаск	almost
ихала	alone
иаваршәны	along
уаҳа	already
Ибзиоуп	Alright
иара убас	also
альтернативтә	alternative
аха	although
есымша	always
аҟазара	am
иџьоушьаша	amazing
ҩ-ҵакык змоу	ambiguous
амбициа	ambition
амбициатә	ambitious
ариашара арчеира	amend
абжьара	amid
агәҭаны	among
ҳаҩныҵҟа	among us
ҳабжәара	among us
аԥхьаӡара	amount
аицҵалыҵ	amount
агәмырҿыӷьга	amusing
аҭҵаара	analysis
анализ	analysis
ҳазхылҵыз	ancestors
аԥырсал	anchor
ажәытәтәи	ancient
иара убас	and
уаргьы	and you
амаалықь	angel
ацәгьара	anger
амаалықь	angle
абааԥсы	angry
аԥстәы	animal
ашьаҳәырӡыӡ	ankle
ашықәсхыҵра	anniversary
алаҳәара	announcement
аргәамҵра	annoy
игәамҵуа	annoyed
узыргәамҵуа	annoying
есышықәсантәи	annual
анонимтә	anonymous
егьы	another
аҭак	answer
аҭак аҟаҵара	answer
аԥеиԥшбара	anticipate
агәҭынчымра	anxiety
иҭынчым	anxious
иарбанзаалак	any
уаҳа	anymore
аӡәырҩы	anyone
акагьы	anything
захьынџьара	anyway
зеиԥш ыҟамзаргьы	anyways
хазы	apart
ауада	apartment
аҭамзаара аарҭшра	apologize
иубартәы иҟоу	apparent
акәхап	apparently
ахырхара	appeal
ацәырҵра	appear
аԥшра	appearance
ацәырҵра	appeared
аппетит	appetite
аҵәа	apple
арзаҳал	application
ахархәара	apply
аиԥылара	appointment
пату ақәҵара	appreciate
аҭабура	appreciation
азнеишьа	approach
иақәшәо	appropriate
азыразра	approval
ашьақәырӷәӷәара	approve
азыразра	approved
иазыразхоу	approved
иҿырԥшны	approximately
мшаԥымза	april
машәырлатәи	arbitrary
архитектура	architect
архитектура	architecture
архив	archive
архив аҭагалара	archive
уара	are you
уеилахома	are you busy
ԥҳәыс дааигахьома	are you married
ԥҳәыс даажәгахьома мамзаргьы шәхала шәыҟо	are you married or single
Ара шәыҟоума?	Are you still there?
уа уҟома	are you there
аҵакырадгьыл	area
аимакра	argue
аимак-аиҿакра	argue
аҵаҵӷәы	argument
аизҳара	arise
анапы	arm
аибашьратә	army
акәша-мыкәша	around
аиҿкаара	arrange
аиқәшаҳаҭра	arrangement
ааира	arrival
аара	arrive
сааит	arrived
иԥагьоу	arrogant
ахәымпал	arrow
аҟазара	art
ахәҭаҷ	article
астатиа	article
иԥсабаратәым	artificial
артист	artist
ас еиԥш	as
уи аамҭазы	as long as
ишаҳәо ала	as well
аиашазы	as well as
ахәа	ash
иԥхашьаԥхаҵо	ashamed
азҵаара ақәыргылара	ask
сазҵааит	asked
ацәара	asleep
аспект	aspect
Ассамиз	Assamese
ақәылара	assault
аизгара	assembly
аилазаара	assembly
зҽадызцалоу	assertive
ахәшьара аҭара	assess
ахәшьара аҭара	assessment
аобиект	asset
аресурсқәа	assets
аҭара	assign
адҵа	assignment
ацхыраара	assist
ацхырааҩ	assistant
ацхыраара	assistant
адҳәалара	associate
изыдҳәалоу	associated
ассоциациа	association
агәаанагара аарԥшра	assume
агәҭакы	assumption
аҵыхәтәан	at least
исфеит	ate
аспортсмен	athlete
аидҳәалара	attach
еиду	attached
агәылаҵа	attachment
ажәылара	attack
аҽазкра	attempt
аҭаара	attend
аҭаара	attendance
азҿлымҳара	attention
азнеишьа	attitude
азааигәатәра	attract
аттракцион	attraction
улаԥш зыдхало	attractive
атрибут	attribute
ахәаԥшцәа	audience
нанҳәа	august
саб иаҳәшьа	aunt
аб иаҳәшьа	aunty
аиашаҵәҟьазаара	authentic
автор	author
амчра	authority
ҭагалан	autumn
иахьауа	available
агәҭатәи	average
аҽацәыхьчара	avoid
ааԥшра	awake
аҳамҭа	award
идырны	aware
аилкаара	aware
адырра	awareness
наҟ	away
иџьоушьаша	awesome
ҳаӷеимшхаратәи	awful
еилҟьам	awkward
Аимара	Aymara
амаалыкь	baby
абакалавр	bachelor
абӷа	back
шьҭахьҟа аара	back
ақәыԥшылара	background
ацәгьа	bad
амакәан	bag
ахьырԥшыга	bait
аџьра	bake
ачаӡырҭа	bakery
афатә иарҭо асода	baking soda
абаланс	balance
абаланс ашьақәыргылара	balance
ампыл	ball
Бамбара	Bambara
абанан	banana
агәыԥ	band
аҭҟәацра	bang
абанк	bank
абар	bar
аарла	barely
аиқәшаҳаҭра	bargain
ашра	bark
ақьар	barley
абариер	barrier
ашьаҭа	base
ашьаҭа змоу	based
афундамент	basement
аӷәраҵа	basement
ихадоу	basic
ҵакыла	basically
абазилик	basil
агмыг	bastard
апартиа	batch
агәыԥ	batch
аванна	bath
ванна	bathroom
абатареа	battery
аибашьра	battle
аӡыбжьаха	bay
аҟазаара	be
згәы зҽану	be careful
аплиаж	beach
ашәахәа	beam
аҟәыд	beans
амшә	bear
ахгара	bear
аԥаҵа	beard
ачҳара	bearing
ацәыршәага	beast
аисра	beat
ааха	beat
иԥшӡоуп	beautiful
аԥшӡара	beauty
иҟалаз	became
избанзар	because
аҟалара	become
аиарҭа	bed
ашьҭаларҭа	bedroom
ашьха	bee
ажәжьы	beef
ауараш	beer
аԥхьа	before
салагахьан	began
алагара	begin
алагала	beginning
ахьӡала	behalf
ахымҩаԥгашьа	behave
ахымҩаԥгашьа	behavior
ахымҩаԥгашьа	behaviour
ашьҭахь	behind
агәрагара	belief
агәра гара	believe
амгәа	belly
атәра	belong
бзиа ирбо	beloved
аҵаҟа	below
амаҟа	belt
аҟәардә	bench
архәара	bend
аҵаҟа	beneath
ахашәала	benefit
ахашәала	benefits
ааигәа	beside
уи адагьы	besides
еиӷьӡоу	best
аманшәалара	best of luck
ҳаҭырла	best regards
еиӷьу	better
агәҭа	between
арыжәтә	beverage
ашьҭахь	beyond
Бипури	Bhojpuri
анаскьагара	bias
ииашам агәаанагра змоу	biased
амаланыҟәа	bicycle
ахә ақәҵара	bid
аду	big
амаланыҟәа	bike
аԥхьаӡара	bill
алашәы	bind
аҵыс	bird
амш ира	birthday
маҷк	bit
ацҳара	bit
ацҳара	bite
аша	bitter
аиқәаҵәа	black
аԥаҵасага	blade
ахараҵара	blame
абланк	blank
ахыза	blanket
атҟәацра	blast
аршкәакәара	bleach
аиларԥсара	blend
аныҳәара	bless
ақәныҳәара	bless
иныҳәо	blessed
алашә	blind
насыԥ амазаара	bliss
аблок	block
аблокада азура	block
ашьа каҭәара	blood
ашьа	blood
ашәҭкакаҷра	bloom
аҭәҳәара	blow
жәҩангәыԥштәыла	blue
абзамыҟә	blunt
анапхагара	board
аборт	board
анышь	boat
ацәеижь	body
аиларшра	boil
апаш	bold
аидҿаҳәалара	bond
абаҩ	bone
ашәҟәы	book
аиҳаракра	boost
абустер	booster
аботинка	boot
аботинкақәа	boots
аҳәаа	border
агәҿыӷьра	bore
угәы зырҿыӷьуа	bored
угәы зырҿыӷьуа	boring
аира	born
уаара агара	borrow
анаԥхгаҩы	boss
аҩбагьы	both
аргәаҟра	bother
аԥаҭлыка	bottle
ҵаҟа	bottom
иааҳхәаз	bought
аԥара	bounce
аидҳәалара	bound
аибаркыра	bound
аҳәаақәа	boundaries
абант	bow
ахырхәара	bow
асындықәра	bowl
аҿа	bowl
акәалаԥ	box
аҷкәын	boy
аӡәы иҷкәын	boyfriend
анапхаҵа	bracelet
ахшыбаҩ	brain
аусхкы	branch
амахәҭа	branch
абренд	brand
агәымшәа	brave
аилагара	breach
ача	bread
аангылара	break
аԥыхра	break
шьыжьхьа	breakfast
агәы	breast
агәышԥы	breast
аҳауа агара	breath
аԥсыԥ агара	breathe
ажәла	breed
ақьырмыт	brick
хаҵа ицараны иҟоу	bride
ацҳа	bridge
иаазыркьаҿу	brief
алаша	bright
абриллиант	brilliant
аагара	bring
сашьа	bro
аборт	broad
анапхгара	broad
атранслиациа амҩаԥгара	broadcast
иԥҽыз	broke
иԥҽыз	broken
аҩмсаг	broom
аиашьа	brother
амаҳә	brother in law
иаазгаз	brought
аагара	brought
аҩабжьа	brown
арыцқьара	brush
аведра	bucket
аҷкәын	buddy
абиуџьет	budget
агха	bug
абжы	bug
аргылара	build
ахыбра	building
аргылара	built
амасса	bulk
ацә	bull
аршәара	bully
аҷырпаӷь	bully
акыдҟьара	bump
ажьымжәа	bunch
анапаҟьа аҿаҳәара	bunch
анапаҟьа аҿаҳәара	bundle
аидара ақәҵара	burden
аидара	burden
анышә иамадоу	buried
абылра	burn
атҟәацра	burst
анышә аҭара	bury
автобус	bus
ачықь	bush
аус	business
абиуст	bust
ажәра	bust
еилахоу	busy
аха	but
ахәша	butter
аԥарԥалыкь	butterfly
аҳәынҵәра	button
аахахәара	buy
уаанӡа	by
мамзаргьы	by the way
абзиараз	bye
акапуста	cabbage
ауада	cabinet
аҭра	cage
аторт	cake
аҳәыс	calf
аҿыҭра	call
исызҿыҭы	call me
ахьӡ аҭан	called
иҭынчу	calm
сааит	came
агитациа азура	campaign
акампаниа	campaign
азыманшәалара	can
алшара амамзаара	can't
Аԥыхра	Cancel
акьыба	cancer
аҟыбаҩ бзиа змоу	capable
амчхара	capacity
аҳҭнықалақь	capital
анапынҵа	caption
акра	capture
амаланыҟәа	car
акариера	career
зыхшыҩ азызышьҭуа	careful
гәҽанызаарыла	carefully
акы хьаас измам	careless
ахӡыӡаара здыруа	caring
амаӡаҩы	carpenter
ауарҳал	carpet
аҷых	carrot
агара	carry
ацҵара	carry on
анагӡара	carry out
ахҭыс	case
аԥара наԥынҵа	cash
аршәра	cast
анаршә	cast
аханбаа	castle
есымшатәи	casual
ацгәы	cat
акра	catch
акатегориа	category
арахә рацәаны	cattle
искит	caught
амзызс	cause
агәҽанызаара	caution
згәы зҽану	cautious
аҳаԥы	cave
аанкылара	cease
аҭуан	ceiling
аныҳәа амҩаԥгара	celebrate
аклетка	cell
ацентр	center
ашәышықәса	century
аԥалқәа	cereal
ацереммониа	ceremony
зыгәра угаша	certain
иашоуп	certain
ҳәарада	certainly
асертификат	certificate
аибаркыра	chain
аҟәардә	chair
аԥышәара	challenge
алшара	chance
аԥсахра	change
аҩнытәи аусқәа	chaos
алеишәа	character
аҟазшьарба	characteristics
аиҵаҵа	charge
агәыҳалалра	charity
убла хызкуа	charming
аграфик	chart
адиаграмма	chart
ашьҭазаара	chase
ачат	chat
зыхә ҳаракым	cheap
амч аҳәара	cheat
амцҳәара	cheating
агәаҭара	check
аӡамҩа	cheek
агәырӷьара	cheer
згәы ҭгәырӷьаауа	cheerful
шәныҳәаз	cheers
ашә	cheese
ахимиа	chemistry
аҳаҭыр ақәҵара	cherish
ашахмат	chess
агәышԥы	chest
ажаҳәара	chew
акәҷышь	chicken
ашеф	chief
ахәыҷы	child
ахәыҷра	childhood
ахәыҷқәа	children
ахьҭа	chill
алҩацарҭа	chimneys
ацламҳәа	chin
ашоколад	chocolate
алхра	choice
алхра	choose
аԥҟара	chop
аҩнытәи аус	chores
аӡамҩа хыгьежьаа	chubby
ауахәама	church
акорица	cinnamon
агьежь	circle
аҭагылазаашьа	circumstances
анхаҩы	citizen
ақалақь	city
аҭаххара	claim
аилыркаара	clarify
акласс	class
анышәаԥшь	clay
ацқьа	clean
аилкаара	clear
ацқьа	clear
аусзуҩы	clerk
аҟәыш	clever
аклиент	client
аԥаҩ	cliff
аклимат	climate
ахалара	climb
иудҷабло	clingy
ассаҭ	clock
аркра	close
ашьқьаԥ	closet
амаҭәа	cloth
амаҭәа	clothes
аԥсҭҳәа	cloud
аԥсҭҳәақәа	cloudy
аклоун	clown
ацаԥха	clue
еилҟьам	clumsy
акластер	cluster
азыҟаҵаҩ	coach
арацәа	coal
аԥшаҳәа	coast
апальто	coat
акаҳуа	coffee
акогнитивтә	cognitive
аиқәшәара	coincidence
ахьҭа	cold
ахыбгалара	collapse
ахәда	collar
акколега	colleague
аколлегацәа	colleagues
аизакра	collect
аколлекциа	collection
аколледж	college
аԥштә	color
аԥштәы змам ииаҵәоу аидеақәа гәеибаркырала ицәан	colorless green ideas slept furiously
аԥштәы	colour
аколонка	column
ахҳәа	comb
аҳәара	comb
аицааира	combination
аиԥшьра	combine
аара	come
араа уааскьеи	come here
ирлас	come on
аманшәалара	comfort
иманшәало	comfortable
аара	coming
уажәыҵәҟьа иҟало	coming soon
акоманда	command
акомментариақәа аҟаҵара	comment
ареклама	commercial
акоммерциатә	commercial
акомиссиа	commission
аҟаҵара	commit
ахыдҵа	commitment
иҟасҵеит	committed
атоуар	commodity
иаабац	common
аиҿцәажәара	communicate
аимадара	communication
аилазаара	community
анеира	commute
акомпанион	companion
акомпаниа	company
аҿырԥшра	compare
аиҿырԥшра	comparison
арыцҳашьара	compassion
арыцҳашьара злоу	compassionate
еишьашәало	compatible
аицлабра	compete
издыруа	competent
аицлабра	competition
аконкуренциа злоу	competitive
агәынамӡара	complain
агәынамӡара аарԥшра	complain
ашшра	complaint
акомплемент	complement
ахыркәшара	complete
зынӡаск	completely
ицәгьоу	complex
аиқәшаҳаҭра	compliance
ауадаҩ	complicated
акомплимент	compliment
анагӡара	comply
ахыҭҳәаа	composition
еилоу	compound
аилкаара	comprehension
ганрацәалатәи	comprehensive
азааибагара	compromise
мчылатәи	compulsory
акомпиутер	computer
аҽеизакра	concentrate
аконцепциа	concept
агәҭынчымра аарԥшра	concern
ахьаакра	concerned
аконцерт	concert
алкаа	conclusion
хықәкылатәи	concrete
аилаӡара	condition
аилаӡара	conditions
анапхгара	conduct
аконференциа	conference
аиашаҳәара	confess
агәра зго	confidence
агәра зго	confident
ашьақәырӷәӷәара	confirm
аконфликт	conflict
ииҳәо-ииуа иақәымшәо	confused
аилаҩеиласра	confusion
адныҳәалара	congrats
адныҳәалара	congratulation
адныҳәаларақәа	congratulations
аидҳәалага	conjunction
аидҵара	connect
ампыҵахалара	conquer
ахдыр	conscious
агәаҟәышра	consciousness
аиқәшаҳаҭхара	consent
ақәшаҳаҭра	consent
аҭагылазаашьақәа	consequences
ахьчара	conservation
згәы зҽану	conservative
агәаанагара	consider
иԥхьаӡоуп	considered
ашьақәгылара	consist
аишьҭаргылашьа	consistency
аишьҭаргылашьатә	consistent
есымшатәи	constant
есымша	constantly
аимгәакра	constipation
аконструкциа	construction
аргылара	construction
ахархәара	consume
ахарџь	consumption
ахархәара	consumption
аконтакт	contact
иҿку	contagious
алаҵара	contain
аҵанакра	contains
ҳаамҭазтәи	contemporary
агәымхашьара	contempt
аконтент	content
аицлабра	contest
аконтекст	context
аконтинент	continent
ацҵара	continue
аконтракт	contract
аиԥшымзаара	contrast
алаҵара	contribute
алагалара	contribute
алагала	contribution
аконтроль азура	control
аконтроль	control
аимактә	controversial
агәраргара	convenience
аманшәала	convenient
аиҿцәажәара	conversation
аконвертациа аҟаҵара	convert
ацҳара	convey
агәраргара	convince
агәра ахарҵара	convince
агәраргара	convinced
афатәҟаҵара	cook
афатә аҟаҵара	cooking
ибзиаӡоуп	cool
аусеицуура	cooperation
амч ақәхара	cope
абҩа	copper
ихадоу	core
аԥш	corn
акәакь	corner
ииашоуп	correct
ахәԥса	cost
акостиум	costume
акоттедж	cottage
абамба	cotton
атахта	couch
ақәҩара	couch
аимҳәа	cough
сазыманшәалан	could
аилазаара	council
аԥхьаӡара	count
адәқьанеишәа	counter
ақалақь	country
ақыҳа	countryside
ҩба	couple
агәымшәара	courage
амзыз	course
акорт	court
аӡбарҭа	court
аҳаҭырқәҵара	courtesy
абиешьеиԥҳа	cousin
ахҩара	cover
ажә	cow
ашәаргәында	coward
аманшәала	cozy
ашьышьыркьата	crab
аиҟәԥара	crack
анапҟазара	craft
агаӡабызшәа	crap
амашәыр	crash
абзиабара	crash
иӷәӷәаны аҭаххара	craving
аҳәазара	crawl
ахага	crazy
аԥҵара	create
икреативтәу	creative
акредит	credit
акамыртата	creep
игәырхынҳәыгоу	creepy
аекипаж	crew
ацәгьаҟаҵара	crime
акриминал	crime
акриндж	cringe
акризис	crisis
акритериа	criteria
критикала	critical
акритика	criticism
аԥҟара	crop
аҭоура	crops
аиасра	cross
аҟәраан	crow
ауаажәларр	crowd
ихарҭәаау	crowded
акорона	crown
акрызҵазкуа	crucial
агәымбыл	cruel
акруиз	cruise
аилырбгара	crush
абзиабара	crush
аҵәыуара	cry
анаша	cucumber
адырӷәӷәалара	cuddle
акультура	culture
агызмалра	cunning
аҭаҟә	cup
ашьқаԥ	cupboard
аанкылара	curb
абордиур	curb
ахәшәтәра	cure
акоменданттә сааҭ	curfew
адырраҭахра	curiosity
зегь здырыц зҭаху	curious
ахахәырфы	curly
аԥара	currency
уажәтәи	current
уажәазы	currently
ашәира	curse
аԥарда	curtain
ахчы	cushion
ашьцылара	custom
атрадициа	custom
аклиент	customer
ашьцыларақәа	customs
атрадициақәа	customs
аԥҟара	cut
ишԥабзиоу	cute
амаланыҟәала аныҟәара	cycle
амаланыҟәара	cycling
аб	dad
папа	daddy
есыҽнытәи	daily
ахштә	dairy
амшынҵа	dairy
аӡкыра	dam
ааха	damage
аҩсҭаа ихәхааит	damn
аԥсаҳәа	damp
акәашара	dance
ашәарҭара	danger
ашәарҭазаара	dangerous
ишәарҭоу	dangerous
аиқәаҵәа	dark
сыхазына	darling
атире	dash
амш	data
аинформациа	data
амш	date
аиқәшәара	date
аӡӷаб	daughter
амш	day
иԥсу	dead
анҵәара аамҭа	deadline
адагәа	deaf
аиқәшаҳаҭра абжьгара	deal
ҳаҭыр зқәу	dear
Ҳаҭыр зқу зегьы	Dear All
Ҳаҭыр зқәу аклиент	Dear Customer
Ҳаҭыр зқәу аҭаацәа	Dear Parents
Ҳаҭыр зқәу	Dear Sir
Ҳаҭыр зқәу астудентцәа	Dear students
Ҳаҭыр зқәу акоманда	Dear Team
аԥсра	death
аимак-аиҿак	debate
адебит	debit
аԥҽыхақәа	debris
ауал	debt
жәашықәса	decade
жәашықәса	decay
иҿкоу	deceased
амц аҳәара	deceive
ԥхынҷкәын	december
жәашықәса	decent
аӡбара	decide
иӡбоу	decided
аӡбара	decision
ахыӷәра	deck
агхара	decline
агырхара	decrease
азкызаара	dedicated
гәык-ала азыҟалара	dedication
аус	deed
ахымҩаԥгашьа	deed
аҵаула	deep
абнацә	deer
амҳәара	default
аиааира	defeat
аиааира агара	defeat
ахьчара	defend
аилкаара аарԥшра	define
еилкаа	definitely
аҵакы	definition
аанагара	definition
аҩаӡара	degree
ахырԥара	delay
анаскьагара	delayed
аныхра	delete
цасҳәа иҟаҵоу	deliberate
иаамсҭашәоу	delicate
ихаау	delicious
акы азы агәырӷьара	delight
згәалаҟазаара бзиоу	delighted
азнагара	deliver
инагоу	delivered
азнагара	delivery
адҵаҟаҵара	demand
злеишәа цәгьоу	demanding
адемократиа	democracy
аџьныш	demon
аарԥшра	demonstrate
иақәшаҳаҭымхаз	denied
ажәпара	density
адантист	dentist
мап акра	deny
аҟәша	department
ацара	departure
ахьыԥшызаара	depend
аркәадара	deploy
адепозит	deposit
агәкаҳаратә	depressed
агәкажьра	depression
аҵаулара	depth
ахцәажәара	describe
ахцәажәара	description
асакара	desert
џьабаала ирҳау	deserve
арҿиара	design
адизаин	design
ахҵара	designation
аанагара	designation
агәаҳәара	desire
аишәа	desk
агәы каҳара	despair
згәы каҳау	desperate
уи адагьы	despite
асакара	dessert
уахьнеиуа аҭыԥ	destination
алахьынҵа	destiny
аилырбгара	destroy
аилырбгара	destruction
адеталь	detail
ахәҭаҷқәа	details
аԥшаара	detect
агәыӷьра	determination
ашьақәыргылара	determine
ишьақәыргылан	determined
ахьаацәгьа змоу	devastated
арҿиара	develop
изҳазыӷьоу	developed
арҿиара	development
адеваис	device
аҩсҭаа	devil
азкызаара	devoted
Дивеи	Dhivehi
адиабет	diabetes
адиареа	diarrhea
амшынҵа	diary
ажәар	dictionary
иҟасҵеит	did
аԥсра	die
иԥсыз	died
адиета	diet
аиԥшымзаара	difference
акы еиԥшым	different
ицәгьоу	difficult
арашәара	dig
ахаҭабзиара	dignity
згәы ақәызкуа	diligent
шьыбжьхьа	dinner
аӡааҟәрылара	dip
ишиашо	direct
ахырхарҭа	direction
анапхгаҩы	director
аҟьашьра	dirt
агәам	dirt
иҟашьу	dirty
иззлымшо	disable
аусура злымшо	disabled
аӡра	disappear
агәы ахыршәара	disappointed
арыцҳара	disaster
мап ацәкра	discard
аусура амхра	discharge
алеишәа	discipline
агыжьра	discount
аарԥшра	discover
адискриминациа	discrimination
ахцәажәара	discuss
алацәажәара	discussion
ачымазара	disease
ачымазарақәа	diseases
амаскировка азура	disguise
алкаара	disgusting
афатәхкы	dish
асаан ду	dish
асаанқәа	dishes
афатәхкқәа	dishes
аушьҭра	dismiss
ашьҭра	dispatch
адисплеи	display
ахархәара аҭара	disposal
аиқәшаҳаҭымхара	dispute
абжьазаара	distance
акы еиԥшым	distinct
аиҩдыраара	distinguish
арыцҳара	distress
аихшара	distribution
аокруг	district
ажәа аԥыҩлара	disturb
ажра	ditch
аӡааҟәрылара	dive
еиуеиԥшым	diverse
ахаҭабзиара	diversity
ашара	divide
анцәа ишииҳәара	divine
аилыҵра	divorce
аблахаҵ гьыжьра	dizzy
аҟаҵара	do
уара	do you
бзиа сыубома	do you love me
аҳақьым	doctor
адокумент	document
аҟаҵара	does
ала	dog
Догри	Dogri
уажәы акы аҟаҵара	doing
акьанџьа	doll
адомен	domain
аҩнытәи	domestic
адоминант	dominant
Умшәан	Don't worry
аԥара азышьҭра	donate
иҟаҵоуп	done
аҽада	donkey
анаркотик	dope
ҩбаны иҟоу	double
агәыҩбара	doubt
амажәа	dough
ҵаҟа	down
аҭгара	download
аҿырԥштәы	draft
аиқәаҵәа	draft
ахара	drag
аҭарбара	drain
адрама	drama
асахьа аҭыхра	draw
аидчаԥала	drawer
аҭыхра	drawing
ашәара	dread
ашәарҭа	dread
агәаҳәара амазаара	dream
аԥхыӡ абара	dream
аҵкы	dress
парпантала акылҵәара	drill
ажәра	drink
амашьына ныҟәцара	drive
ампыҵшәара	drop
ацәкаҳара	dropped
аарҩара	drought
ижәны иҟоу	drunk
аба	dry
акәата	duck
аҷкәын	dude
иҟаҵатәу	due
уи инақәыршәаны	due to
агаӡа	dull
агаӡҳәы	dumb
агәамеизакырҭа	dump
аԥара	dump
акыраамҭа	duration
уи аамҭазы	during
асаба	dust
асаба арыцқьара	dust
ауал	duty
аԥхықәра	duty
анхара	dwell
иԥсуа	dying
иарбанзаалак	each
ҳара-ҳара	each other
азхьра	eager
ауарба	eagle
алымҳа	ear
зааӡа	earlier
шаанӡа	early
арҳара	earn
алымҳақәа	ears
адгьыл	earth
адгьылҵысра	earthquake
арласра	ease
имарианы	easily
амраҭашәара	east
имариоу	easy
акрыфара	eat
акрыфара	eating
аекономикатә	economic
аекономика	economy
акьыԥшь	edge
аредактура азура	edit
аҵара	education
аеффект	effect
ахырҳага	effective
алҵшәара	efficiency
ахырҳага	efficient
аҽазышәара	effort
акәтаӷь	egg
аҟандыл	eggplant
аего	ego
ааба	eight
жәаа	eighteen
ԥшьынҩажәа	eighty
мамзаргьы	either
архиара	elaborate
амышьхәылҵ	elbow
аиҳабра	elder
еиҳабу	elderly
зычаԥашьа бзиоу	elegant
аелимент	element
аслан	elephant
жәеиза	eleven
иақәшәо	eligible
аныхра	eliminate
даҽакы	else
иԥхашьо	embarrassed
иԥхашьо	embarrassing
агәыдыҳәҳәалара	embrace
ацәырҵра	emerge
аҷыдалкаатә ҭагылазаашьа	emergency
аемоциатә	emotional
аицгәырҩара	empathy
алкаара	emphasis
аҵышьра	emphasize
аусзуҩы	employee
аусзуҩцә	employees
аусураҭаҩ	employer
аусдкылара	employment
иҭацәу	empty
алшара аҭара	enable
аинҟьара	encounter
агәазҭанаҵара	encourage
аҵыхәтәа	end
алгара	end
ианыӡаараны иҟоу	endangered
аҽазышәара	endeavor
анарха	endurance
ачҳара	endure
ахгара	endure
аӷа	enemy
аенергиа	energy
ахгәарԥхара	engage
иалархәу	engaged
аизҳәара	engagement
аҳәара	engagement
амотор	engine
аинџьныр	engineer
Англыз бызшәа	English
аиӷьтәра	enhance
агәырӷьара	enjoy
идуӡӡоу	enormous
азхара	enough
агәраргара	ensure
аҩналара	enter
агәмырҿыӷьра	entertainment
аентузиазм	enthusiasm
игәырӷьаҵәа иҟоу	enthusiastic
зегьы	entire
азин змоу	entitled
аҵакы	entity
аҩналарҭа	entrance
анаплакҩы	entrepreneur
аконверт	envelope
акәша-мыкәша иҟоу	environment
ашьыцра	envy
аепикатә	epic
апандемикатә	epidemic
еицырзеиԥшу	equal
амаҭәахә	equipment
аҵабыргра	equity
аеквивалент	equivalent
аныхга	eraser
агха	error
аҽыҵәахра	escape
еиҳа	especially
ахыҭҳәаа	essay
аҵакы	essence
ихадоу	essential
ашьақәырӷәӷәара	establish
ишьақәыргылоу	established
амазара	estate
ахәшьара аҭара	estimate
ахәшьара змоу	estimated
уб егь	etc
наунагӡатәи	eternal
аетика	ethics
ахәшьара аҭара	evaluate
ахәшьара	evaluation
ахәшьара аҭара	evaluation
уи адагьы	even
аха	even though
ахәылԥаз	evening
ахҭыс	event
акраҵанакуа	eventually
ианакәзаалак	ever
есымша	every
зегьы	everybody
дарбанзаалак	everyone
зегьы	everything
иубарҭоу	evidence
абааԥсы	evil
аеволиуциа	evolution
аҿиара	evolve
Иуи	Ewe
уаанӡатәи	ex
ииашоу	exact
иҵабыргыҵәҟьаны	exactly
аԥышәа	exam
аԥышәара	examine
аҿырԥштәы	example
аԥгара	exceed
ибзиаӡоуп	excellent
ада	except
аҷыдалкаа	exception
амцхәра	excess
иахырҟьоу	excessive
аиҭныԥсахлара	exchange
згәы шьҭыҵуа	excited
абыжкра	excitement
угәалаҟазаара шьҭызхуа	exciting
зеиԥшыҟам	exclusive
аҭамзаара	excuse
саҭамыз	excuse me
анагӡара	execute
анагӡатәы	execution
анагӡаратә	executive
азыҟаҵара	exercise
аҽаршьцылара	exercise
амчыдатәра	exhaust
узырааԥсоу	exhausted
ацәыргақәҵара	exhibit
ацәыргақәҵа	exhibition
аҟазаара	exist
аҟазаара	existence
иҟаҵәҟьоу	existing
адәылҵырҭа	exit
адәылҵра	exit
аиҵыхра	expand
аԥеиԥшзаара	expect
узықәгәыӷуа	expected
узықәгәыӷуаз	expected
ахарџь	expenses
зыхә ҳараку	expensive
аԥышәа	experience
аԥышәа	experiment
аексперт	expert
анҵәара	expired
аилыркаара	explain
аилыркаара	explanation
ахрхәара	exploit
аҭҵаара	explore
аекспорт ахь ашьҭра	export
аҵхра	expose
ихьчам	exposed
аекспозициа	exposure
арбара	express
аҳәара	expression
арҭбаара	extend
еиҵыху	extended
арҭбаара	extension
арҭбаара	extent
аҩныҵҟатҽи	external
иҟам ианыӡаахьоу	extinct
ихарҭәаау	extra
алкаа	extract
аҷыдалкаатә	extraordinary
аекстрим	extreme
иҷыданы	extremely
ала	eye
аблақәа	eyes
аба	fabric
иџьашьахәу	fabulous
аҿы	face
аинҟьара	face
арманшәалара	facilitate
аманшәалара	facilities
ахархәага	facility
аҵабырг	fact
афактор	factor
азауад	factory
афактқәа	facts
аҩара	fade
аҵарбгара	fail
иуқәманшәалахаз	failed
аҭабгара	failure
аҭабгарҭа	failure
алаԥсра	faint
зыгәра угаша	fair
даара	fairly
алакәтә	fairy
ицқьоу	faith
ииашоу	faith
агәакьа	faithful
аԥаршеи	fake
акаҳара	fall
амц	FALSE
ахьӡ	fame
изышьцылоу	familiar
аҭаацәа	family
амлакра	famine
еицырдыруа	famous
аҿынҵәааҩы	fan
афен	fan
агәаԥхара	fancy
афантастикатә	fantastic
ихараны	far
аиԥырҵра	farewell
аферма	farm
арахәааӡаҩы	farmer
иблахкыгоу	fascinating
амода	fashion
ирласу	fast
ашәпа	fat
аџьалтә	fatal
алахьынҵа	fate
аб	father
ааԥсара	fatigue
ахара	fault
бзиа избо	favorite
амаҵзура	favour
бзиа избо	favourite
ашәара	fear
ачаражәра	feast
ахӡы	feather
аҷыдара	feature
аҷыдарақәа	features
жәабранмза	february
акрысфацәеит	fed up
ахәԥса ахшәаара	fee
ахә	fee
акраҿаҵара	feed
аимадара	feedback
анырра	feel
ацәанырра	feel
ацәанырра аиура	feeling
ашьаргәыҵа	feet
икаҳаит	fell
арԥыс	fellow
иснырит	felt
аԥҳәыс	female
аанда	fence
иԥсылоу	fertile
афестиваль	festival
аагара	fetch
арыхьҭашьра	fever
маҷк	few
имаҷны	fewer
аԥҳәысҳәаҩ	fiance
амц	fiction
адәы	field
агәеибакратә	fierce
жәохә	fifteen
ԥшьынҩажәижәаба	fifty
ақәԥара	fight
еиқәԥоу	fighting
аԥхьаӡац	figure
афигура	figure
аилкаара	figure out
аԥхьаӡара	figure out
афаил	file
ахарҭәаара	fill
ихарҭәаау	filled
афильм	film
игәырхынҳәыгоу	filthy
аҵыхәтәан	finally
афинансқәа	finance
афинанстә	financial
аԥшаара	find
аилкаара анарԥшра	find out
ибзиаӡоуп	fine
анацәкьара	finger
ахыркәшара	finish
изылгаз	finished
амца	fire
иӷәӷәоу	firm
афирма	firm
актәи	first
ахьӡ	first name
аԥсыӡ	fish
анаалара	fit
хәба	five
арӷәӷәара	fix
азгәаҭара	fixed
абираҟ	flag
ацәырҵра	flash
ауада	flat
иагу	flaw
ахымкых	flawless
аҩра	flee
акәац	flesh
сԥыруан	flew
ахарҟәалара	flex
унапаҿы иааиуа	flexible
аԥырра	flight
хыхьҟа аршәра	flip
афлирт	flirt
афлирт	flirting
аӡсара	float
афатә	flood
азхаз	floor
аихагыла	floor
ашыла	flour
ачашыла	flour
аҭәҳәара	flow
ашәҭ	flower
аимҳәа	flu
ирласу	fluent
ирласны	fluently
ихәымсысу	fluffy
аӡшьар	fluid
аԥырра	fly
ацентр	focus
анаҟәа	fog
анаҟәа ахылара	foggy
аиқәҵара	fold
азааигәара	folks
ашьҭанеира	follow
ашьҭанеира	follow up
анаҩсан	following
афатә	food
агаӡа	fool
игаӡоу	foolish
ашьапсыргәыҵа	foot
афутбол	football
азы	for
Ҿырԥштәыс иаагоуп	For example
ҿырԥштәыс	for instance
уара узы	for you
ақәиҭымтәра	forbidden
амч	force
арбара	forecast
алахь	forehead
атәым	foreign
абна	forest
наӡаӡа	forever
ахашҭра	forget
аинаалара	forgive
исхашҭит	forgot
ачқьыԥ	fork
аформа	form
ашьақәыргылара	form
иформалтәу	formal
уаанӡатәи	former
мышрақә	fortunately
аманшәалара	fortune
ԥшьынҩажҽа	forty
ԥшьынҩажҽи ҩба	forty-two
аԥхьаҟа	forward
арҽхәара	foster
еисит	fought
исыԥшааит	found
ашьаҭа	foundation
ԥшьба	four
жәыԥшь	fourteen
абгахәыҿы	fox
аԥсыҽ	fragile
адаԥа	frame
адаԥа	framework
амцҳәара	fraud
африк	freak
хәыда-ԥсада	free
ахақәиҭра	freedom
аҵаара	freeze
алассы-лассра	frequency
илассу	frequent
лассы-лассы	frequently
ацқьа	fresh
ахәаша	friday
архьшәашәага	fridge
аҩыза	friend
аибаҭахрала	friendly
аҩызцәа	friends
аиҩызара	friendship
ишәо	frightened
аршәара	frightening
адаӷь	frog
уахьынтә	from
аԥхьа	front
иҵаау	frozen
ашәыр	fruit
агәы архьра	frustrated
абылтәы	fuel
Фулфҩлд	Fulfulde
иҭәу	full
алахҿыхра	fun
афункциа	function
аус аура	function
ихадароу	fundamental
аԥсыжра	funeral
иччархәу	funny
ахәы	fur
агәеибакратә	furious
аҩнымаҭәа	furniture
ихароу	further
насгьы	furthermore
иҟалаша	future
аиура	gain
ахәмарра	game
абжьажь	gap
агараж	garage
агәамсам	garbage
абаҳча	garden
аџыш	garlic
агәашә	gate
аизакра	gather
аҽеизгара	gathering
ашәара	gauge
исҭеит	gave
амеханизм	gear
ажәла	gender
еицырзеиԥшу	general
инеидкыланы	generally
арҿиара	generate
абшьҭра	generation
агәыҭбаа	generous
агении	genius
ажанр	genre
аамсҭашәа	gentle
аҵабырг	genuine
анапырхахара	gesture
анеира	get
аиура	get
аҽеилаҳәара	get dressed
агылара	get up
агәабзиара шәоуааит	get well soon
аҟалара	getting
аԥсыгага	ghost
аԥсыгага	ghosting
адуӡӡа	giant
аҳамҭа	gift
аимбир	ginger
аӡӷаб	girl
аӡәы иӡӷаб	girlfriend
аҭара	give
аҽаҭара	give up
иҭоу	given
аигәырӷьара	glad
анахәаԥшра	glance
анаҿаԥшра	glance
асаркьа	glass
ацәца	glass
абласаркьа	glasses
алацәҟәра	glimpse
аглобалтә	global
илахьеиқәҵагоу	gloomy
анапхаҵақәа	gloves
алашара	glow
алашара	glow up
аклеи	glue
ацара	go
ԥхьаҟа ацара	go ahead
наҟ ацара	go away
аиарҭахь ацара	go to bed
ахықәкы	goal
ахықәкқәа	goals
аџьма	goat
ҳазшаз	god
анцәа дшәхылаԥшааит	god bless you
ацара	goes
акы аҟаҵара агәҭакра	going to
ахьы	gold
дцеит	gone
сгәы иҭоуп	gonna
ацара	goo
ибзиоуп	good
мшыбзиа	good afternoon
абзиараз	good bye
амш бзиа	good day
хәлыбзиа	good evening
аус бзиоуп	good job
аԥшӡа	good looking
абзиара уақәшәааит	good luck
шьшьыбзиа	good morning
шьыжьыбзиа сылашара	good morning my love
шәҵх аабзиахааит	good night
абзиараз	goodbye
шәҵх аабзиахааит	goodnight
атоуарқәа	goods
Google	Google
Google Аиҭагара	Google Translate
аҟыз	goose
иџьоушьаша	gorgeous
уҳәан-сҳәан	gossip
иҳауз	got
еилыскааит	got it
аиҳабыра	government
амҵасра	grab
ахәшьара	grade
ахәшьара аҭара	grade
хәыҷы-хәыҷла	gradually
аушьҭымҭа	graduate
арыц	grain
агрант	grant
азинс ишәыҭо	granted
ажь	grapes
аилкаа аҟаҵара	grasp
ашьац	grass
иуџьызшьо	grateful
аџьшьара	gratitude
анышәынҭра	grave
ахәаԥштәыла	gray
идуӡӡоуп	great
аԥсыцәгьа	greed
аԥсыцәгьа	greedy
аиаҵәа	green
аԥсшәаҳәара	greet
аԥсшәаҳәара	greeting
аԥсшәаҳәара	greetings
ахәаԥштәы	grey
асетка	grid
агәырҩа	grief
алагара	grind
амҵасра	grip
абакалеа	grocery
аԥҳәысҳәаҩ	groom
азеиԥш	gross
адгьыл	ground
агәыԥ	group
азҳара	grow
азҳара	growth
игәаау	grumpy
Гуарани	Guarani
агарантиа	guarantee
агарантиа аҭара	guarantee
ахьчара	guard
иаҳҳәап	guess
асас	guest
анапхгара	guidance
анаԥхгара	guide
аекскурсиамҩаԥгаҩ	guide
ахара зхароу	guilty
арԥыс	guy
арԥарцәа	guys
агимнастикатә зал	gym
ашьцылара	habit
анызаарҭа	habitat
исыман	had
ақырцх	hail
ахцәы	hair
абжа	half
аҩналарҭа	hall
анапы	hand
аркра	handle
иԥшӡоу	handsome
акнаҳара	hang
аамҭа ибзианы амҩаԥгара	hang out
ажәҩан	happen
иҟалаз	happened
анасыԥ	happiness
насыԥ змоу	happy
амш иира шәыдысныҳәалоит	happy birthday
умш иира удысныҳәалоит	happy birthday to you
ашықәс ҿыц шәадныҳәалаз	happy new year
икьакьоу	hard
цәгьала	hardly
зынӡаск	hardly ever
аԥырхага	harm
аԥырхага аҟаҵара	harm
ацәгьа	harmful
абжьеиқәшәара	harmony
аџьбара	harsh
аҽаҩра	harvest
амазаара	has
ацәымӷзаара	hate
а́мазаара	have
шәмш аабзиахааит	have a good day
шәмш аабзиахааит	have a nice day
шьыжьхьафара	have breakfast
аччара-ахәмарра	have fun
акрыуфахьома	have you eaten
амазара	having
ашәарҭа	hazard
ашәарҭара	hazard
анаҟәа	haze
иара	he
иара имоуп	he has
иара дыҟоуп	he is
ахы	head
ахыхь	headache
ахәшәтәра	heal
абзиахара	healing
агәабзиара	health
згәы бзиоу	healthy
аҳара	hear
исаҳаит	heard
агәы	heart
агәы	heat
ажәҩан	heaven
ахьанҭа	heavy
иҭынчым	hectic
аҳаракыра	height
ахҭылҵ	heir
ақәлара	heist
акра	held
амҩаԥгара	held
џьаҳаным	hell
Бзиара умаз	Hello
мшыбзиа сылашара	hello dear
ушԥаҟоу	hello how are you
ушԥаҟо	hello how are you doing
алакҭаҩ	helmet
ацхыраара	help
ацхыраара иазхиоу	helpful
убри азын	hence
лара лтәы	her
исаҳаит	herd
абра	here
амалҭынха	heritage
аҵысра	hesitate
Еи	Hey
Бзиара умаз	Hi
мшыбзиа шәшԥаҟоу	hi how are you
Мшыбзиа	Hi there
иҵәаху	hidden
аҵәахра	hide
аиерархиа	hierarchy
иҳараку	high
аҵышьра	highlight
аныҟәара	hike
шьапыла аныҟәара	hiking
алахҿых	hilarious
ахәы	hill
иара изы	him
ақәырԥшара	hint
авара	hip
аварақәа	hips
адкылара	hire
аусурахь адкылара	hiring
иара итәы	his
ахҭыс	history
асра	hit
Ҳмм	Hmm
ахобби	hobby
акра	hold
аангылара	hold on
акылҵәара	hole
аԥсшьара амш	holiday
акгьы зҭам	hollow
аҩны	home
аҩныҟатәи адҵа	homework
ииашоу	honest
ииашацәҟьаны	honestly
Сыхазына	Honey
апату аҳаҭыр	honor
акапиушон	hood
аҿаршә	hook
аԥара	hop
агәаанагара	hope
ақәгәыӷырала	hopefully
узықәгәыӷратә иҟам	hopeless
аиаалатә	horizontal
атәыҩа	horn
ҳаӷеимшхаратәи	horrible
акаамеҭ	horror
аҽы	horse
ахәышәтәырҭа	hospital
асасдкылара	hospitality
анаԥхгаҩы	host
асасцәа рырԥылара	host
аиӷаратә	hostile
ишоуроу	hot
ашоура	hot
аотель	hotel
асааҭ	hour
асааҭқәа	hours
аҩны	house
анхара	household
ишԥа	how
уара угәаанагара	how about you
шәшԥаҟоу	how are you
шәгәалаҟазаара шԥаҟоу	how are you doing
угәалаҟазаара шԥаҟоу иахьа	how are you doing today
ушԥаҟо иахьа	how are you today
ушԥаҟоу	how do you do
ишԥа	how is
заҟа	how many
изыԥсоузеи	how much
заҟа ирласны	how often
заҟа ухыҵуеи	how old are you
умш шԥацеи	how was your day
шәҵх шԥацеи	how was your night
даҽакала	however
ахаб	hub
схаҵа	hubby
агәыдыҳәҳәалара	hug
идуӡӡоу	huge
ауаҩы	human
ахӡырымгаҩ	humble
аԥсаа	humid
ацәаакыра	humidity
шәкы	hundred
амлакра	hungry
ашәарыцара	hunt
аԥшацәгьа	hurricane
аццакра	hurry
ирццак	hurry up
ахьаа азнаагара	hurt
аԥшәма	husband
ашаҟь-шаҟьара	hustle
аҩныжә	hut
агигиена	hygiene
Сара	I
Сара сыҟоуп	I am
Сара сыбзиоуп	I am fine
Сара исылшоит	I can
Сара исзыҟаҵом	I can't
Сара иҟасҵоит	I do
Сара исыздырӡом	I do not know
Сара исзеилкаауам	I do not understand
Сара мап	I don't
Сара исыздырӡом	I don't know
Сара исзеилкаауам	I don't understand
Ишәҳәаз сзеилмыргеит	I don't understand what you mean
Сара исзеилкаауам	I don't understand you
Сара исыздырӡом	I don’t know
Сара исзеилкаауам	I don’t understand
сгәы иаанагоит	i guess
Сара исыман	I had
Сара исымоуп	I have
Сара сыҟан	I have been
Ус ауп ҳәа сыҟоуп	I hope so
Сара исдыруеит	I know
Сара бзиа избоит	I like
Сара узгәаԥхоит	I like you
Сара уара бзиа узбоит	I love
Сашьеиҳаб бзиа дзбоит	I love my big brother
Саҳәшьеиҳаб бзиа дзбоит	I love my big sister
Саб бзиа дзбоит	I love my father
Сашьа бзиа дзбоит	I love my little brother
Саҳәшьа бзиа дзбоит	I love my little sister
Сара сан бзиа дзбоит	I love my mother
Сара уара бзиа бзбоит	I love you
Сара уара даара бзиа узбоит	I love you so much
Саргьа бзиа узбоит	I love you too
Исҳәарц исҭаху	I mean
Угәхьаазгоит	I miss you
Даара угәхьаазгоит	I miss you so much
Сара избоит	I see
Сара сгәы иаанагоит	I think
Сара еилыскаауеит	I understand
Сара исҭахуп	I want
Узбар сҭахуп	I want to see you
Сара усҭахуп	I want you
Сара сыҟан	I was
Сара сҟалоит	I will
Сара сыҟоуп	I'm
Сыбзиоуп	I'm fine
Сыбзиоуп	I'm good
Ара сыҟоуп	I'm here
Саҭамыз	I'm sorry
аҵаа	ice
аршәы	ice cream
аидеиа	idea
аидеал	ideal
аидеалтә	ideal
еиԥшу	identical
аидентификациа азура	identify
аиԥшра	identity
аилымга	idiot
азаҵә	idle
ҟалозар	if
атәамбара	ignore
ачымазара	ill
азакәан иақәымшәо	illegal
ачымазара	illness
Иакано	Ilocano
асахьа	image
аимидж	image
ахахьы аагара	imagine
агәҭатәи	immediate
иаразнак	immediately
идуӡӡоу	immense
агәылаҵара	impact
агәылаҵа	impact
ачҳара згу	impatient
анагӡара	implement
аимпорт ахгара	import
акрызҵазкуа	important
ишуҭахым аҭара	impose
изыҟамло	impossible
ахаҿы ааныжьра	impress
агәазнеира	impression
ухы-угәаҿы иаанхо	impressive
аиӷьтәра	improve
аиӷьтәра	improvement
аҩныҵҟа	in
уи инацҵаны	in addition
Фактла	In fact
аԥхьа	in front of
уи азы	in order to
еиқәымшәо	inappropriate
гәарԥхаратә	incentive
ахҭыс	incident
аҵанакра	include
иаҵанакуа	including
ахашәала	income
аманшәаламра	inconvenience
ацҵара	increase
аизырҳара	increased
зеиԥш ыҟам	incredible
ииашаҵәҟьаны	indeed
ихьыԥшым	independent
Индиа	India
азгәаҭара	indicate
аҭыԥантәи	indigenous
индивидуалтәу	individual
аиндустриа	industry
хырԥашьа змам	inevitable
ҿыц ииз	infant
аинфекциа	infection
аҵыхәаԥҵәарадара	infinity
ашәра	inflammation
аинфлиациа	inflation
анырра	influence
аинформациаҭара	inform
аинформациа	information
аингредиентқәа	ingredients
аҭынхара	inheritance
раԥхьаӡатәи	initial
аинициатива	initiative
аинициатива аазырԥшуа	initiative
ааха зауз	injured
ахәра	injury
ак зхарам	innocent
ааԥхьара	innovation
ажәанҵа	inquiry
аилага	insane
амаҵақәа	insect
узқәымгәыӷуа	insecure
алаҵара	insert
аҩныҵҟа	inside
аҳара	insight
атәы аргара	insist
азмыцәара	insomnia
агәышьҭыҵра	inspiration
агәеизырҳара	inspire
аргылара	install
аҿырԥштәа	instance
есымшааира	instant
аҭыԥан	instead
уи аҭыԥан	instead of
аинструкциақәа	instructions
аинструмент	instrument
ацәахыхра	insult
аԥгаԥсаҟаҵара	insurance
икьысым	intact
ахә ҳаракы змо	integrity
ииашоу	integrity
ахәыцратә	intellectual
аҟәышра	intelligence
аҟәыш	intelligent
аҽазкра	intend
идырны иҟаҵоу	intended
еибарххоу	intense
агәҭакы	intention
аицҟаҵара	interact
аицҟаҵара	interaction
аинтерес	interest
аинтерес аарԥшра	interest
аинтерес аарԥшра	interested
аинтерес змоу	interesting
аҿаԥалара	interfere
агәҭатәи	intermediate
аҩныҵҟатәи	internal
жәларбжьаратәи	international
аинтернатура	internship
аилыркаара	interpret
аиҭагаҩ	interpreter
аԥыхра	interrupt
аинтервиу	interview
аинтимтә	intimate
аҩныҵҟа	into
алагалара	introduce
алагалара	introduction
аинтроверт	introvert
ацәанырра	intuition
ииашам	invalid
арҿиара	invent
аинвентарь	inventory
алаҵара	invest
аҭҵаара	investigate
ааԥхьара	invitation
ааԥхьара	invite
агәылаҵара	invoice
аҽалагалара	involve
иалагалоу	involved
аиха	iron
ауанҭара	iron
ауанҭа	iron
адгьылбжьаха	island
аҽацәахьчара	isolated
азҵаара	issue
ауадаҩрақәа	issues
иара	it
иара ыҟоуп	it is
иара иҟан	it was
иара ыҟоуп	it's
акагьы аурым	it's ok
Акагьы ауры	It's okay
аҭаҵа	item
агәылаҵа	items
иаратәы	its
Сара сыҟоуп	I’m
ажакет	jacket
абахҭа	jail
Ажьырныҳәа	January
абанка	jar
ацламкәагә	jaw
иҳалалу	jealous
агаӡа	jerk
ахьымаҭәа	jewelry
аусура	job
ирласны аныҟәара	jogging
ацлара	join
аиԥшьра	joint
асамарҟәыл	joke
ажурналист	journalist
аныҟәара	journey
агәырӷьара	joy
аӡбаҩ	judge
ашәырӡ	juice
ԥхынгәы	july
аԥара	jump
рашәарамза	june
ажә-мыжә	junk
абыржәыҵәҟьа	just
игәашәҭ	just do it
аиаша	justice
ариашара	justify
Калаалисут	Kalaallisut
иаланахалаз	keen
ахьчара	keep
ус шәнеила	keep it up
искыз	kept
ачаиршыга	kettle
ацаԥха	key
асра	kick
ахәыҷы	kid
алафҳәара	kidding
аҷаҷа	kidney
ахәыҷқәа	kids
ашьра	kill
ақьиа	kind
еиԥш	kinda
ҳаҭыр ақәҵо	kindly
аразра	kindness
аҳ	king
агәыдкылара	kiss
ахәыҟаҵарҭа	kitchen
аҳауа иалоу амаҭ	kite
ацыгәхәыҷы	kitten
ашьамхы	knee
исдырит	knew
аҳәызба	knife
арыцар	knight
адырра	know
адырра	knowledge
еицырдыру	known
Канкани	Konkani
Крио	Krio
ақәҷаб	label
аус	labor
аусура	labor
аџьаа	labour
иамам	lack
амардуан	ladder
хаҵа имцац аӡӷаб	lady
иааныжьу	laid
аӡиа	lake
асыс	lamb
ацыркь	lame
алампа	lamp
адгьыл	land
артәара	land
апеизаж	landscape
абызшәа	language
ашьамхы	lap
адуӡӡа	large
ииасхьоу	last
аҵыхәтантәи аха акрызҵазкуа	last but not least
ажәла	last name
ахьшәа	late
аабыкьа	lately
насшәа	later
аҵыхәтәантәи	latest
аҵыхәтәантәи	latter
аччара	laugh
аччара	laughing
аԥышәарччара	laughter
адәықәҵара	launch
аӡәӡәарҭа	laundry
азакәан	law
адәҳәыԥш	lawn
адукат	lawyer
аиурист	lawyer
ақәҵара	lay
ашьҭалара	lay
аҽыҭ	layer
амакет	layout
аашьаҩ	lazy
анаԥгара	lead
анапхгаҩы	leader
абӷьыц	leaf
ацәцара	leak
алаҟәра	lean
аԥара	leap
аҵара	learn
аҭҵаара	learning
аҵара	learning
арентра агара	lease
ашьҭахьтәи	least
асахҭан	leather
ааныжьра	leave
абыӷьқәа	leaves
напхгара азысуан	led
иаанижьит	left
ашьапы	leg
аҭынха	legacy
азакәан инақәыршәаны	legal
алегенда	legend
еицырдыруа	legend
азакәан иақәныҟәо	legit
аԥсшьара	leisure
уаарас аҭара	lend
аура	length
еиҵоу	less
аурок	lesson
ақәиҭтәра	let
ашәҟәы	letter
алатук	lettuce
асалаҭ	lettuce
аҩаӡара	level
арычагқәа рсистема	leverage
ахархәара	leverage
ауал	liability
аԥхықәра	liability
абиблиотека	library
абызра	lick
ашьҭалара	lie
амцҳәара	lie
амц	lies
амцҳәара	lies
аԥсҭазаара	life
ашьҭыхра	lift
алифт	lift
алашара	light
илашароу	lightning
агәаԥхара	like
иҟалар ҟалоит	likely
иара убас	likewise
ацәаҳәа	line
Лингала	Lingala
азхьарԥш	link
алым	lion
аӡшьар	liquid
ахьӡынҵа	list
ахҩылаа	list
аӡырҩра	listen
аӡырҩра	listening
нбанла	literally
алитертура	literature
агәамсам	litter
агәамсам акажьра	litter
ахәыҷы	little
анхара	live
агәаҵәа	liver
анхара	lives
зыԥсы ҭоу	living
анхарҭатә уада	living room
аинцәыш	lizard
аартра	load
ачахы	loaf
аԥсахтә	loan
аҭыԥантәи	local
иахьыҟоу аҭыԥ	location
аркра	lock
алокдаун	lockdown
аркра	lockdown
ақды	log
иччарху	lol
азаҵә	lonely
ау	long
шәсымбеижьҭеи крааҵуеит	long time no see
ахәаԥшра	look
аиқәҳәала	loop
ацәыӡра	loose
аԥшәма	lord
ацәыӡра	lose
ацәыӡра	loss
ацәыӡ	loss
исцәыӡит	lost
ирацәаны	lot
абжьы ҭыган	loud
амшгара	lounge
абзиабара	love
бзиа узбоит	love you
аԥшӡа	lovely
илаҟәу	low
еиҳа илаҟәу	lower
узықәгәыӷша	loyal
аҵабыргра	loyalty
аманшәалара	luck
насыԥ змоу	lucky
Луганда	Luganda
аидара	luggage
агәал	lump
шьыбжьхьа	lunch
арыԥҳақәа	lungs
амал	luxury
ашьҭалара	lying
амашьына	machine
ахага	mad
амадам	madam
иҟасҵеит	made
ажурнал	magazine
иблахкыгоу	magnificent
ауадаеилыргаҩы	maid
ихадоу	main
ацхраара	maintain
аҵакы	maintenance
амаҵзура	maintenance
Маисили	Maithili
еиҳа	major
еиҳараӡак	majority
аҟаҵара	make
амеикап	make up
аиҿкаара	make up
ахаҵа	male
ахәаахәҭырҭа	mall
ахаҵа	man
анапхгараҭара	manage
анапхгараҭара	management
анапхгара	management
аменеџьер	manager
амчмырхаратә	mandatory
аманифест	manifest
анырра аҭара	manipulate
анырра	manipulate
аманера	manner
анапхгара	manual
ирацәаны	many
абзиара шәахь игьыжьааит	many many happy returns of the day
аҭаалымҟаҵара	march
анашьҭра	margin
аџьармыкьа	market
ачара	marriage
хаҵа дрымоуп	married
асабрада	mask
амасса	mass
имассивтәу	massive
аԥшәма	master
аиқәыршәара	match
аҩыза	mate
иматериалтәу	material
аматериал	material
аматематика	math
аус	matter
азҵаара	matter
ашәра	maturity
иҟалар ҟалоит	may
лаҵарамза	may
иҟалар ҟалоит	maybe
сара	me
саргьы	me too
афатә	meal
иаанагоит	mean
аҵакы	meaning
иаанагоит	means
иаанагон	meant
уи аамҭазы	meanwhile
ашәара	measure
ашәага-зага	measures
акәац	meat
амедицинатә	medical
амедицина	medicine
амедитациа	meditation
агәҭатәи	medium
аиқәшәара	meet
аиԥылара	meeting
Меитеилон	Meiteilon
аԥсасира	melt
агәаларшәарақәа	memories
агәынкылара	memory
ахшыҩтә	mental
агәаларшәара	mention
аӡбахә аҳәара	mentioned
анапхгаҩы	mentor
ауаҷар	merchant
агәыҳалалра	mercy
баша	merely
ашықәс ҿыц шәадныҳәалаз	merry christmas
агәам	mess
ацҳамҭа	message
еилыргам	messy
аметал	metal
аметод	method
аҳәынаԥқәа	mice
агәҭа	middle
агәҭатәи	middle
ҵхабжьон	midnight
иҟаҵатәыз	might
атаата	mild
аҵәыш	milestone
аибашьратә	military
ахш	milk
амиллион	million
ахшыҩ	mind
исҳәарц исҭаху	mind
ахәыцра	mindset
сара стәы	mine
аилаԥсара	mingle
аилаҭәа	mingle
аилаҭәара	mingle
ихәыҷу	minor
аминута	minute
аминуҭқәа	minutes
анашана	miracle
асаркьа	mirror
еиуеиԥшым	miscellaneous
аҳәатәхамҵа	mischievous
анасыԥда	miserable
агәаҟра	misery
азгәамҭара	miss
агәхьаагара	miss
угәхьаазгоит	miss you
иагу	missing
адҵа	mission
анаҟәа	mist
агха	mistake
Мизо	Mizo
амобилтә ҭел	mobile
ахыччара	mock
амодель	model
арҟәымшәышәра	moderate
ҳаамҭазтәи	modern
аԥхашьа	modest
аԥсаа	moist
ацәаакыра	moisture
аԥақәа	mold
ашьана	mole
ан	mom
абӷьааҳәа	moment
ашәахьа	monday
аԥара	money
ацклаԥшра	monitor
амонитор	monitor
амаамын	monkey
амза	month
агәалаҟазаара	mood
ақьынцыц	moody
амза	moon
ацәаҩашәатә	moral
еиҳа	more
уи аамышьҭахьгьы	moreover
ашьыжь	morning
аипотека	mortgage
еиҳараӡак	most
еиҳараӡак	mostly
ан	mother
аиҭаҵра	motion
амотивациа	motivation
ашьха	mountain
аҳәынаԥ	mouse
аҿы	mouth
аиҭаҵра	move
аҵысра	movement
акино	movie
миссис	mrs
ирацәаны	much
аҟьашь	mud
ацәца	mug
ажьышәа	muscle
амузеи	museum
акәыкәбаа	mushroom
амузыка	music
аҟаҵарахәҭазаара	must
абжьыда	mute
еицырзеиԥшу	mutual
сара стәы	my
Сылашара	My dear
сҩыза	my friend
Сыӷба амаҭԥсыӡла иҭәуп	My hovercraft is full of eels
сыхазына	my love
сара исыхьӡуп	my name is
изхаҭабузеи	my pleasure
сара схаҭа	myself
еилкаам	mysterious
амаӡа	mystery
амиф	myth
анацәхыԥ	nail
ҩба злаӡам	naive
ахьӡ	name
ажәабжьҳәара	narrative
ажәабжь	narrative
аҭшәа	narrow
угәы зырхынҳәуа	nasty
амилаҭтә	national
амилаҭ	nationality
агәакьа	native
ахатәы	native
иԥсабаратәу	natural
аԥсабара	nature
агәырхынҳәра	nausea
агәырхынҳәыга	nausea
ааигәа	near
ааигәа	nearby
ааигәа	nearly
агәахәара узҭо	neat
иаҭаху	necessary
ахәда	neck
ахәдахаҵа	necklace
иаҭахуп	need
анегативтә	negative
атәамбара	neglect
аиҿцәажәара	negotiate
агәыла	neighbor
агәылара	neighborhood
аӡәымзар	neither
аиаҳәшьаԥа	nephew
аҟәыш	nerd
згәы хыҭхыҭуа	nervous
аҵысҭра	nest
аимадаратә ҳа	net
аҳа	network
инеитралтәу	neutral
ахаангьы	never
еснагь ԥхьаҟа	never give up
ахахьы амгара	never mind
ахахьы амгара	nevermind
уи адагьы	nevertheless
аҿыц	new
ахҭысқәа	news
анаҩсантәи	next
ааигәа	next to
ибзиоуп	nice
иԥшӡоуп	nice
ҳаибадырра сеигәырӷьеит	nice to meet you
аиашьеиаԥҳа	niece
аҵх	night
уахынла	night
аԥхыӡ бааԥсы	nightmare
ажәбатәи	nine
зежә	nineteen
ԥшьынҩажәижәаба	ninety
Мамоу	No
ауадаҩра ыҟам	no problem
уи зыҟалом	no way
аӡәгьы	nobody
ашьҭыбжь	noise
зыбжьы дуу	noisy
аӡәгьы	none
шьыбжьон	noon
мап	nope
инормоу	normal
жәҩанҵәырхара	north
аԥынҵа	nose
аностальгиатә	nostalgic
мамоу	not
изхаҭабузеи	not at all
ицәгьам	not bad
Уажәазы акәым	Not now
макьаназы	not yet
азгәаҭа	note
иазгәаҭоу	noted
акагьы	nothing
агәаҭара	notice
азгәаҭара	noticed
ахьыӡҟа	noun
ахьыӡҟақәа	nouns
ановелла	novel
абҵарамза	november
абыржәы	now
уажәазы	nowadays
ауадаҩра	nuisance
аноль	null
аҿаҳа	numb
аномер	number
амедиеҳәшьа	nurse
араса	nut
амускаттә раса	nutmeg
акрыфара	nutrition
аҭоуба	oath
аԥсылацәахара	obesity
аххәыцра	obey
амаҭәар	object
ахықәкы	objective
ахыдҵа	obligation
арлашьцара	obscure
ацклаԥшра	observation
ацклаԥшра	observe
иханагалаз	obsessed
аханагалара	obsession
иажәхьоу	obsolete
аԥынгыла	obstacle
аиура	obtain
ирҳау	obtained
илабҿабоу	obvious
акәхап	obviously
зны-зынла	occasionally
аусзкра	occupation
аҭыԥ аанызкылаз	occupied
аакылҟьара	occur
ацәырҵра	occur
ицәырҵит	occurred
ацәарҵра	occurs
аокеан	ocean
абҵарамза	october
уамашәа иҟоу	odd
алшарақәа	odds
ҳәарада	of course
ирцәоу	off
ахьымӡӷ узырго	offensive
адгалара	offer
аофис	office
иофициалтәу	official
лассы-лассы	often
Оҳ	Oh
иашаҵәҟьоума	oh really
ахәша	oil
ибзиоуп	ok
ибзиоуп сыхазына	ok dear
ибзиоуп сыхаара	ok honey
ибзиоуп сыхазына	ok my love
ибзиоуп	okay
ибзиоуп сыԥшқа	okay baby
ибзиоуп сылашара	okay dear
ибзиоуп сыхаара	okay honey
ибзиоуп сыхазына	okay my love
ажә	old
аханы	on
знык	once
акы	one
бызшәак ахаан иузхаӡом	one language is never enough
аџьымшьы	onion
онлаин	online
амацара	only
иаарту	open
аартра	open
аоперациа	operation
агәаанагара	opinion
аҟыбаҩ	opportunities
алшара	opportunity
аҿаԥхьатәи	opposite
аоптимисттә	optimistic
авариант	option
иҟоумҵар ҟало	optional
мамзаргьы	or
апатырқалԥштәы	orange
аҿаҵа	order
аҿаҵа аҟаҵара	order
иаабац	ordinary
аиҿкаара	organization
аориентациа	orientation
ахыҵхырҭа	origin
иоригиналу	original
Оромо	Oromo
аиба	orphan
егьы	other
даҽакала	otherwise
аҟаҵатә	ought
ҳара ҳтәы	our
Ҳара ҳмиссиа: дарбанзаалак зегьы адунеи реилркаара дара реилибакаара абызшәақәа рхархәарала.	Our mission: to enable everyone, everywhere to understand the world and express themselves across languages.
Ҳара ҳмиссиа: адунеи аинформациа ашьақәыргылара уи иуниверсалраны аилкаара насгьы азнеира.	Our mission: to organize the world's information and make it universally accessible and useful.
анҭыԥ	out
алҵшәа	outcome
амаҭәа	outfit
знаалашьа бзиоу	outgoing
аҭыжьра	outlet
аконтур	outline
адәахьала	outside
иаалукааша	outstanding
аԥечка	oven
аханы	over
абна	over there
еицырзеиԥшу	overall
аиааира	overcome
иӷәӷәаны арҵәира	overthinking
ахьаацәгьа змоу	overwhelmed
иаԥыжәоу	overwhelming
амазара	owe
аты	owl
изтәу	own
аԥшәма	owner
ацә	ox
ашьаҿа	pace
апакет	pack
аҭра аҭаҵара	pack
аҭра	package
исшәеит	paid
ахьаа	pain
ашәра	paint
асахьа	painting
асахьа ҭыхра	painting
аихацалакы	pair
ацәыш	pale
апальма	palm
адырган	pan
апандемиатә	pandemic
апандемиа	pandemic
агәыҭҟьа-ԥсыҭҟьара	panic
аиқәа	pants
ақьаад	paper
џьанаҭ	paradise
еицтәараны	parallel
ашьҭра	parcel
ашьҭымҭа	parcel
аҭамзаара	pardon
изхылҵыз	parents
парк	park
апарпар	parrot
ахәысхәа	parsley
ахәҭа	part
алахәзаара	participate
хаҭала	particular
акы иеиԥшымкәа	particularly
алахәылаҩ	partner
ахәылԥаз	party
алсра	pass
абжьысра	passage
адунеи аԥсахра	passed
ацәанырра ӷәӷәа	passion
ацәанырра ӷәӷәа зныԥшуа	passionate
ипассивтәу	passive
апароль	password
иаҳхысхьо	past
ақәҵа	patch
амҩахәасҭа	path
арыцҳа	pathetic
ачҳара	patience
аԥшра	patient
аҽырԥштәы	pattern
ааҭгылара	pause
атротуар	pavement
ашәара	pay
ашәара	payment
ахәԥса	payment
аҭынчра	peace
аҭынчратә	peaceful
атама	peach
ашьха ақәцәа	peak
аҳа	pear
акарклаш	peas
ахатәҷыдаратә	peculiar
ачхәра	pee
ацәырԥссара	peel
цқьа ахәаԥшра	peer
аиқәылацәа	peers
акалам	pen
акарандашь	pencil
аамҭазы	pending
ауаа	people
апырпыл	pepper
агәынкылара	perceive
агәынкылара	perception
ибзаӡоуп	perfect
адгалара	perform
адгалара	performance
ақәгылара	performance
иҟалар ҟалоит	perhaps
апериод	period
еснагьтәы	permanent
азин	permission
азин аҭара	permit
зҽадызцало	perseverance
есымшатәи	persistent
ауаҩы	person
хаҭалатәи	personal
ахаҿра	personality
еизҳауа	perspective
агәраргара	persuade
архәанча	pervert
ааӡамҭа	pet
аетап	phase
афеномен	phenomenon
афилософиа	philosophy
аҭел	phone
асахьа	photo
афраза	phrase
афизикатә	physical
ашьҭыхра	pick
ашьҭыхра	pick up
асахьа	picture
аҭынчра	piece
аҟыра	piece
аса	pieces
аҳәа	pig
аҳәыҳә	pigeon
аиқәырчаҟәа	pile
ахчы	pillow
апилот	pilot
агәлаҵа	pin
ананас	pineapple
агәилтә	pink
ажра	pit
аршәра	pitch
агәы алсра	pity
аҭыԥ	place
аҭыԥқәа	places
амырза	plague
амариа	plain
апланҟаҵара	plan
аплан	plan
аҳаирплан	plane
аҵиаа алаҵара	plant
аҵиаа	plant
аҵиаақәа	plants
асаан	plate
аҭыԥ	platform
аплатформа	platform
ахәмарра	play
ахәмарра	playing
ихәмаруа	playing
агәахәара узҭо	pleasant
аҳәара сымоуп	please
зхы згәы аху	pleased
агәынаӡара	pleasure
агәахәара	pleasure
аҭоуба ашьҭаҵара	pledge
ирацәаны	plenty
асиужет	plot
арыԥҵә	plug
ахаџьгәара	plug
аҳәаса	plum
аӡымҩангаҩы	plumber
арацәа	plural
аподкаст	podcast
ажәынраала	poem
апоезиа	poetry
аҭыԥ	point
аҩаӡара	point
ашҳам	poison
аполициа	police
аполитика	policy
аамсҭашәа	polite
аҟьашьра	pollution
аӡҭакы	pond
аӡҭарчы	pool
аркарара	poop
аӷар	poor
апоп	pop
еицырдыруа	popular
ауааԥсыра	population
аҳәажьы	pork
ақашь	porridge
апорт	port
аҭыԥ	position
ипозитивтәу	positive
амазаара	possess
амазаара	possession
амазаратә падеж	possessive
амазара	possessive
иҟалар зылшо	possible
аԥошьҭа	post
анаскьагара	postpone
акартошка	potato
ипотенциалу	potential
афунт	pound
аӷарра	poverty
амч	power
иӷәӷәоу	powerful
аманшәала	practical
апрактика	practice
апрактика ахысра	practice
арҽхәара	praise
апранк	prank
анцәа иҳәара	pray
зыхә ҳараку	precious
аиқәҷаб	precise
убасҵәҟьа	precisely
иҟалаша аҳәара	predict
аиӷьашьара	prefer
аиӷьашьара	preference
аимгәадура	pregnant
амцхаҵара	prejudice
ауада	premises
апремиум	premium
архиара	preparation
архиара	prepare
аиқәыршәара	prepared
аԥхьангыла	preposition
аҟазаара	presence
адгалара	present
аҳамҭа	present
азԥхьанагара	presentation
апрезентециа	presentation
ахьчара	preserve
апрезидент	president
апресса	press
ақәыӷәӷәара	press
ақәыӷәӷәара	pressure
аҽыргызмалра	pretend
иԥшӡоу	pretty
аԥырҟәҟәаара	prevent
уаанӡатәи	previous
аԥшаах	prey
ахә	price
агәадура	pride
апап	priest
раԥхьаӡатәи	primary
ихадоу	prime
апринцесса	princess
ипринципалтәу	principal
уаанӡатәи	prior
раԥхьаӡатәи	priority
абахҭа	prison
амаӡара	privacy
хаҭалатәи	private
аԥыжәара	privilege
априз	prize
ԥсыхәа зламоу ала	probably
ауадаҩра	problem
апроцедура	procedure
ацҵара	proceed
апроцесс	process
анапы алакра	produce
апродукт	product
алҵшәа	production
апрофессиа	profession
азҟаза	professional
апрофиль	profile
ахашәала	profit
аҵаула	profound
апрогресс	progress
апроект	project
еицырдыруа	prominent
аргәыӷра	promise
анаскьагара	promote
анахара	promotion
ирласу	prompt
зхы хоу	prone
ахьӡынхәрақәа	pronouns
ацәажәашьа	pronunciation
ашьақәырӷәӷәара	proof
ииашоу	proper
ииашаны	properly
аҟазшьақәа	properties
амазара	property
бсыцца ҳәа аҳәара	proposal
аперспектива	prospect
ашәҭкакаҷра	prosperity
аизҳара	prosperous
ахьчара	protect
зхы ҳаҭыр ақәызҵо	proud
ашьақәырӷәӷәара	prove
адгалара	provide
адгалара	provided
иудгалоу	provided
ақыҭа	province
аҭагылазаашьа	provision
аиқәыршәара	provision
асагәратә еизҳара	puberty
зегьы ишырбо-ишраҳауа	public
ахара	pull
аҟаб	pumpkin
апунктуалтә	punctual
аҵаҩы	pupil
аахәара	purchase
ицқьоу	pure
адәыкрынԥштәы	purple
амзыс	purpose
аԥараҭра	purse
ашьҭашәарыцара	pursue
ашьҭазаара	pursuit
агәыҵасра	push
ақәҵара	put
аквалификациа	qualification
ахаҭабзиара	quality
ахыԥхьаӡара	quantity
акарантин	quarantine
аицәҳара	quarrel
аԥшьбарак	quarter
Кечуа	Quechua
аҳкәажә	queen
уамашәа иҟоу	queer
агәазыҳәарақәа	query
азҵаара	question
араан	queue
ирласу	quick
ирласны	quickly
иахьауа	quiet
ақәыршә	quilt
ааныжьра	quit
иазханы	quite
аквиз	quiz
ацитата	quotation
ацитата аагара	quote
ацитата	quote
ахыцқәа	quotes
ажьа	rabbit
араса	race
ирласны аныҟәара	race
агәеибакра	rage
ақәа	rain
азырҳара	raise
ааӡара	raise
ишьҭыху	raised
сыҩит	ran
имашәыру	random
адиапазон	range
иаӷьу	rapid
ирласны	rapidly
аӷа	rare
шамахамзар	rarely
акәыкәмасса	rash
аҳәынаԥ	rat
атариф	rate
еиҳа	rather
аихьыԥшызаара	ratio
ирационалтәу	rational
аӡа	raw
анеира	reach
инеиз	reached
ареакциа	reaction
аԥхьара	read
аԥхьара	reading
амазеи	ready
уажәтәи	real
алабҿабара	reality
аилкаара аарԥшра	realize
иазоушьҭу	realized
ииашаҵәҟьаны	really
зеиԥш маҷу	rear
амзыз	reason
аҭакзыԥхықәу	reasonable
архынҳәра	recall
арецепт	receipt
аквитанциа	receipt
аиура	receive
иоуит	received
аабыкьатәи	recent
аабыкьа	recently
адкылара	reception
адкыларҭа	reception
арецепт	recipe
аҟаҵашьа	recipe
ихшыҩдоу	reckless
азхаҵара	recognition
адырра	recognize
арекомендациа	recommend
арекомендациа азура	recommend
арекоммендациа змоу	recommended
арекорд	record
аҭаҩра	record
абзиахара	recover
аиҭашьақәыргылара	recovery
ԥшькәакь	rectangle
аҟаԥшь	red
аҿыхра	redeem
ахҿыхра	redemption
армаҷра	reduce
имцхәу	redundant
азхьарԥшра	refer
азхьарԥш	reference
аныбаалара	reflect
анырҷҷалара	reflection
ахынкылара	refrain
априпев	refrain
архьшәашәага	refrigerator
аԥара архынҳәра	refund
мап ацәкра	refuse
мап ацәкра	refused
аҭҵаара	regard
аҵыхәала	regarding
хьаас имкыкәа	regardless
ҳаҭырла	regards
арегион	region
ашәҟәы аҭагалара	register
агәалсра	regret
еиԥырҟьам	regular
есымша	regularly
мап ацәкра	reject
аҵанакра	relate
иаҵанакуеит	related
аизыҟазаара	relationship
акы иадҳәалоу	relative
ауа	relative
ауацәа	relatives
аԥсшьара	relax
аушьҭра	release
иоужьҭу	released
иахәҭоу	relevant
зыгәра угаша	reliable
армариара	relief
аласхара	relieve
азоужьра	relieved
анцәахаҵара	religion
адин	religion
адинтә	religious
акәанызанра	reluctant
агәрагара	rely
аанхара	remain
иаанхаз	remaining
зеиӷьыҟам	remarkable
ахәшә	remedy
агәалашәара	remember
агәалаҳәара	remind
аргәаларшәага	reminder
инаскьагоу	remote
аԥыргара	remove
ацхраара	render
арентла агара	rent
аремонт аҟаҵара	repair
даҽазнык аҳәара	repeat
аҭыԥ аԥсахра	replace
аҭак аҟаҵара	reply
ацҳара	report
аарԥшра	represent
арепуиациа	reputation
азыҳәамҭа	request
агәазыҳәара	require
аҳәара	required
аиқәырхара	rescue
аҭҵаара	research
агәаларшәара	resemble
агәыԥжәара	resentment
аанкылара	reservation
арезерв аҟаҵара	reserve
арезерв	reserve
анхаҩы	resident
амаҵура ааныжьра	resign
аилаҟаҵара	resilience
иҭышәынтәалоу	resilient
аиҿагылазаара	resist
аҿагылара	resistance
аилыргара	resolution
аӡбара	resolve
аԥсшьара	resort
аԥсшьарҭа	resort
аресурсқәа	resources
аҳаҭырбара	respect
аҭак ҟаҵара	respond
аҭак ҟаҵара	response
аҭакзыԥхықәу	responsibility
аҭакзыԥхықәу	responsible
аԥсшьара	rest
џьанаҭ шәагмыз	rest in peace
акрыфарҭа	restaurant
арҿыцра	restore
аҳәаа аҭагӡазаара	restrict
алҵшәа	result
алҵшәа	results
анаркьаҿ	resume
анаркьаҿ аҟаҵара	resume
азаҵәылаҭира	retail
ахынҳәра	retain
аанкылара	retention
атәанчахәытә	retired
шьҭахьҟа цара	retreat
агара	retrieve
ахынҳәра	return
аарԥшра	reveal
иаарту	revealed
ашьоура	revenge
ахашәалахәы	revenue
аҿагыларатә	reverse
аиҭахәаԥшра	review
ариашара	revise
аревизиа аҟаҵара	revision
ареволиуциа	revolution
аҳамҭа аҭара	reward
аритм	rhythm
аваҵкьара	rib
арис	rice
абеи	rich
аԥыргара	rid
ацара	ride
арччага	ridiculous
ииашоуп	right
абыржәыҵәҟьа	right now
аџьбара	rigid
амацәаз	ring
аҵыршара	rinse
аиларбгара	riot
абунт	riot
аԥыжәжәара	rip
иҟалоу	ripe
ашьҭыхра	rise
ашәарҭара	risk
аиндаҭлаҩ	rival
аиндаҭлара	rival
аӡиас	river
амҩа	road
аџьра	roast
икьакьоу	robust
ахаҳә	rock
аҵәгәыр	rod
ароль	role
арулет	roll
ахыб	roof
ауада	room
адац	root
ашаха	rope
абаа	rotten
ахжәа	rough
имчны	roughly
агьыжь	round
амаршрут	route
арутина	routine
ацәаҳәа	row
арыцқьара	rub
аныхра	rubber
аныхга	rubber
агәамсам	rubbish
ахжәа	rude
ауарҳал	rug
аилырбгара	ruin
аԥҟара	rule
алинеика	ruler
аԥҟарақәа	rules
аҩра	run
аҩра	running
иҩуа	running
ақыҭатә	rural
аццакра	rush
асакь	sack
ишәаз	sacred
аӡхәы	sacrifice
ишәарҭам	safe
ишәарҭам аиқәԥара	safe flight
ишәарҭам	safety
адыр аҟәыӷа	sage
иҳәеит	said
аӡсара	sail
мшынлы аныҟәара	sailing
азы	sake
ауалафахәы	salary
аҭиира	sale
амлагәыр	salmon
аџьыкхыш	salt
иара аҩыза	same
Убасҵәҟьа абра	Same here
аҿырԥштәы	sample
аԥслымӡ	sand
Санскрит	Sanskrit
асаркастикатә	sarcastic
ахԥара	sassy
стәан	sat
агәахәара	satisfaction
ицәгьам	satisfied
азырхара	satisfy
агәы иақәшәо	satisfying
Асабша	Saturday
асосиска	sausage
аколбас	sausage
абнатә	savage
ахьчара	save
избеит	saw
аҳәара	say
амҽхакрбага	scale
анапхыцәгьара	scam
ашәахсҭа	scar
иӷару	scarce
ишәо	scared
ахәдакәырша	scarf
ахлымӡаах	scary
еиԥхьытта икаԥсо	scattered
асцена	scene
ақәгылара	scene
апеизаж	scenery
аффыҩра	scent
аффҩы	scent
аихшанҵа	schedule
ашкол	school
анаука	science
аҵарауаҩ	scientist
аҭҵааҩцәа	scientists
амаркатыл	scissors
аӷьра	scold
амҽхак	scope
асчет	score
алом	scrap
ацәҟьара	scratch
аҳәҳәара	scream
аекран	screen
аскрин	screen
авинт	screw
ақәныҟәа	script
амшын	sea
атиулен	seal
аԥшаара	search
асезон	season
аҭыԥ	seat
аҩбатәи	second
амаӡа	secret
ахәҭа	section
узықәгәыӷуа	secure
ахьчара	security
ахьчацәа	security
абара	see
ҳаибабоит	see you
ҳаибабоит насшәа	see you later
ҳаибабоит ирласны	see you soon
уаҵәынӡа	see you tomorrow
ажәла	seed
аԥшаара	seek
ацәырҵра	seem
ацәырҵра	seems
избаз	seen
ампыҵахалара	seize
асексуалтә азеилымкаара	seizure
шамахамзар	seldom
алхра	select
хаҭала	self
аҽыхәышәтәра	self healing
зхы бзиа избо	selfish
аҭиира	sell
ашьҭра	send
асахьа сзаашьҭ	send me your picture
аиҳабы	senior
ацәанырра	sense
зхы здыруа	sensible
анырралшара змоу	sensitive
инасышьҭит	sent
аҳәоу	sentence
аҳәоуқәа	sentences
хазы иҟоу	separate
Сепеди	Sepedi
цәыббрамза	september
аишьҭаргылашьа	sequence
аишьҭагыла	series
аҭышәынтәалара	serious
хъмаррада	seriously
архиара	serve
амаҵзура	service
асеанс	session
ақәыргылара	set
атәара	set
ақәыргылара	set up
акәша-мыкәша	setting
ашьақәыргылара	setting
аангылара	settle
анхара	settle
бжьба	seven
жҽыбыжь	seventeen
хынҩажәиажәаба	seventy
ԥыҭк	several
ихьанҭоу	severe
аԥара	sew
ацәылаԥштәхәы	shade
агага	shadow
аршаҟьшаҟьра	shake
иҟалоит	shall
ихәуҷу	shallow
аԥхашьара	shame
аформа	shape
ашара	share
аҵры	sharp
лара	she
лара илымоуп	she has
лара дыҟоуп	she is
акаҭәара	shed
ауаса	sheep
абӷьыц	sheet
ақәҵарҭа	shelf
амыдаӷьцәа	shell
аҽыҵәахырҭа	shelter
аԥырак	shield
аиҭаҵра	shift
алашара	shine
аӷба	ship
аӷбала ахгара	shipping
ашәҵатәы	shirt
аимаа	shoes
ахысра	shoot
адәқьан	shop
амаҭәаахәара	shopping
аԥшаҳәа	shore
акьаҿ	short
азымхара	shortage
ахәыҷы	shot
ажәҩа	shoulder
аҿыҭра	shout
арбара	show
исырба	show me
адуш	shower
акреветка	shrimp
армаҷра	shrink
аркра	shut
аҿы аркра	shut up
аԥхашьаҩ	shy
аиашьеи аиаҳәшьеи	sibling
аиаҳәшьеи аиашьеи	siblings
згәы бзиам	sick
аган	side
ақәыԥсычҳара	sigh
алаԥш	sight
аблахкыгарҭа	sightseeing
анапынҵара	sign
анапынҵа	signature
инагоу	significant
аҭынчра	silence
иҭынчу	silent
абырфын	silk
агаӡа	silly
араӡын	silver
еиԥшу	similar
агаӡахәыҷы	simp
амариа	simple
аамҭакала	simultaneously
аахыс	since
гәыкала иҟоу	sincere
гәыкала	sincerely
ашәаҳәара	sing
ашәаԥәаҩ	singer
аӡәы	single
аҿыӡәӡәарҭа	sink
Сер	Sir
аиаҳәшьа	sister
анхәыԥҳа	sister in law
атәара	sit
асаит	site
аҭагылазаашьа	situation
фба	six
жҽаф	sixteen
хынҩажәа	sixty
аразмер	size
ашьцыларақәа	skill
аԥышәақәа	skills
ацәа	skin
изгу	skinny
аԥара	skip
абжьажьра	skip
аиԥка	skirt
ажәҩан	sky
атәитәых	slave
ацәара	sleep
ицәоу	sleeping
ацәара	sleeping
ацәа акра	sleepy
амаӷра	sleeve
аса	slice
ақәҟьара	slide
хәыҷык	slightly
аинаала	slim
ампыҵҟьара	slip
анаара	slope
аслот	slot
имыццакӡакәа	slow
ԥшьаала	slowly
ахәыҷы	small
аҟәыш	smart
афыҩра	smell
аԥышәырччара	smile
аҭаҭын ахара	smoke
алҩа	smoke
аршша	smooth
ахжәыла	snack
акамыршша	snail
амаҭ	snake
аҿақ аргара	snap
асы	snow
убри азы	so
ишԥабзиоу	so cute
уажәаанӡа	so far
арбааӡара	soak
асапын	soap
иашьым	sober
ампыл асра	soccer
исоциалтәу	social
ауаажәларра	society
ақалбадқәа	socks
атаата	soft
апрограмматә еибыҭа	software
адгьыл	soil
исҭиит	sold
зегьы ҭиуп	sold out
аруаҩ	soldier
ашьапаҵа	sole
акьакьа	solid
аҳасабра	solution
аӡбара	solve
аӡәырҩы	somebody
акалашәа	somehow
аӡәырҩы	someone
изакәызаалак	something
зны-зынла	sometimes
ашәа	song
уажәыҵәҟьа	soon
абаа	sophisticated
Сорани	Sorani
ичмазҩу	sore
ахәда ахьра	sore throat
алахьеиқәҵара	sorrow
Саҭамыз	Sorry
асорт	sort
иԥшаауан	sought
аԥсы	soul
сыбжа	soulmate
абжьы агара	sound
абжьы	sound
асуп	soup
аҵәыҵәы	sour
ахыҵхырҭа	source
алада	south
акосмос	space
аспам	spam
арҵәиира	span
Аиспантҽи	Spanish
арезервтә	spare
ацәажәара	speak
ҷыдалатәи	special
аиԥшымзаара	species
иҷыдоу	specific
ахәаԥшырҭатә	spectacular
ацәажәара	speech
аҿымҭ	speechless
аласра	speed
нбанла аҳәара	spell
аныхра	spend
аамҭа агара	spend
инысхит	spent
аца	spicy
аҟәымӷ	spike
аргьежьра	spin
ашпинат	spinach
аԥсы	spirit
акажьцәара	spit
иблахкыгоу	splendid
аиҟәшара	split
абжьыхра	spoil
иԥхасҭоу	spoiled
ахала иҟалаз	spontaneous
амҳаҵә	spoon
ашәыта	spot
ашьана	spot
аԥшәма	spouse
алаҵара	spread
ааԥын	spring
акәакь	square
арӷәӷәара	squeeze
акальмар	squid
аеш	squirrel
аиқәԥара	stab
иҭышәынтәалоу	stable
ачаҟәа	stack
аусзуҩцәа	staff
астадиа	stage
асцена	stage
ақәгылара	stage
ашәыта	stain
аҿаԥса	stairs
азыԥҵәа	stake
ахәҵәы	stalk
акиоск	stall
акьыԥхь	stamp
агылара	stand
астандарт	standard
аиаҵәа	star
алагара	start
иалагеит	started
амлаиакуа	starving
аштат	state
аҟазшьа	state
арзаҳал	statement
астанциа	station
аҳаҭәара	statue
астатус	status
аанкылара	stay
шәхы шәацклаԥш	stay safe
аҭышәынтәала	steady
ишьақәтәоу	steady
астеик	steak
аӷьычра	steal
афақь	steam
аџыр	steel
аҿҟьара	steep
адац	stem
ашьаҿа	step
акылахара	stick
алаба	stick
агәымбыл	stiff
макьаназы	still
ахы	sting
акаҷбеи	stingy
аиларҩынтра	stir
аҵәах	stock
иӷьычу	stolen
аца	stomach
ахаҳә	stone
сгылан	stood
аҟәардә	stool
аанкылара	stop
аҵәахырҭа	storage
адәқьан	store
ацәқәырԥара	storm
ахҭыс	story
аԥечка	stove
ииашоу	straight
амариа	straightforward
аибарххара	strain
уамашәа иҟоу	strange
атәымуаҩ	stranger
астратегиа	strategy
аҭәиц	straw
аҵыҵындры	strawberry
ацәаҳәа	streak
аӡыхь	stream
алеира	stream
адәы	street
амч	strength
астресс	stress
анашьҭызаара	stretch
алеишәацәгьа	strict
асра	strike
арахәыц	string
ахаԥсара	string
ацәаҳәа	strip
ашьҭазаара	strive
ашьышьра	stroke
аӷәӷәа	strong
иршанхоу	struck
аструкткра	structure
ақәԥара	struggle
иқәԥо	struggling
аӷәӷәа	stubborn
алахара	stuck
астудент	student
аҵара	study
аҵара	studying
абаша	stuff
убла хызкуа	stunning
абзамыҟә	stupid
астиль	style
амаҭәар	subject
анапаҿы аагара	submission
адкылара	submit
аҵакы	substance
амаҭәашьар	substance
аиҭныԥсахлара	substitute
абаа	subtle
аизҳазыӷьара	succeed
аихьӡара	success
ақәҿиара змоу	successful
аҩыза	such
абри аҩыза	such as
ацәацәара	suck
иаалырҟьаны	sudden
иаалырҟьаны	suddenly
агәаҟра	suffer
аргәаҟра	suffer
игәаҟуа	suffering
заҟа аҭаху	sufficient
ашьақар	sugar
адгалара	suggest
алагалара	suggestion
акостиум	suit
анналара	suit
иақәшо	suitable
ачемодан	suitcase
ацҵа	sum
ацҵара	sum
аҭакра	summary
аԥхын	summer
асаммит	summit
амра	sun
амҽыша	sunday
амраԥхара	sunny
амара аҭашәара	sunset
амра аԥхара	sunshine
еиҷьӡоу	super
анапхгара	superior
анапхгаҩы	supervisor
ауаххьа	supper
азнагара	supply
адгылара	support
агәазҩара	suppose
угәы иззаанаго	supposed
агәрагара	sure
ақәыԥшыра	surface
агәырҩара	surge
аԥҟара	surgery
ажәла	surname
аршанхар	surprise
иџьоушьартә иҟоу	surprised
аҽаҭара	surrender
архынҳәтә	surrender
акәша-мыкәша иҟоу	surrounding
ацклаԥшра	surveillance
аҿахәы аҿыхра	survey
азҵаара	survey
аиқәхара	survive
гәҩарас аҟаҵара	suspect
аҭагылазаашьатә	suspended
игәҩароу	suspicious
ақәшаҳаҭхара	sustain
аҭышәынтәалара	sustainability
аҭышәынтәала	sustainable
аԥшаара	swag
ажәҵыс	swallow
албаадара	swallow
аԥсахра	swap
ажәа аҭара	swear
ахаа	sweat
асвитер	sweater
аԥссара	sweep
ихаау	sweet
аҵх алыԥхаа	sweet dreams
ахаа бзиа избо	sweet tooth
ахаара	sweetheart
аԥшацәқәырԥа	swell
акылчаа	swelling
аӡсара	swim
аӡсара	swimming
ауаргьала	swing
арҵысра	swing
арцәара	switch
иҭчаау	swollen
аҟама	sword
асимбол	symbol
асимпатиа	sympathy
асимптомқәа	symptoms
асистема	system
аишәа	table
аӡбара	tackle
ақәҷаб	tag
аҵыхәа	tail
ашьҭыхра	take
наҟ агара	take away
ахӡыӡаара	take care
ашәыхра	take off
игаз	taken
ацәажәара	talk
ацәажәара бзиа збо	talkative
иҳараку	tall
акран	tap
аскотч	tape
ахықәкы	target
адҵа	task
агьама агәаҭара	taste
агьама	taste
ихаау	tasty
исирҵеит	taught
ачаи	tea
арҵара	teach
арҵаҩы	teacher
акоманда	team
алаӷырӡ	tear
алаӷырӡ	tears
аҵәы алаҵара	tease
атехнологиа	technology
ахаԥыцқәа	teeth
аиҭаҳәара	tell
исаҳә	tell me
алеишәа	temper
атемпература	temperature
ауахәама	temple
аамҭалатәи	temporary
жәаба	ten
жәы нызықь	ten thousand
ауаданкылаҩ	tenant
атенденциа аиура	tend
атенденциа	tendency
агәыбзыӷ	tender
аџьабаа ду зцу	tense
аибарххара	tension
атент	tent
аԥышәаратә	tentative
атермин	term
асеместр	term
аиқәшаҳаҭрақәа	terms
ҳаӷеимшхаратәи	terrible
аџьшьахә	terrific
аҳыԥ	territory
атест	test
атекст	text
еиҳа	than
ҭабуп аҳәара	thank
иҭабуп	thank you
Иҭабуп шәахьыԥшыз шәеидара гәаҳҭонаҵы	Thank you for your patience while we investigate shipment
иҭабуп даараӡа	thank you so much
иҭабуп даараӡа	thank you very much
иҭабуп	thanks
Иҭабуп ҳапродукт ахархәаразы	Thanks for using our app
уи	that
уи ыҟоуп	that is
ари бзиоуп	that's good
аӷьычра	theft
дара ртәы	their
дара рзы	them
атема	theme
дара рхала	themselves
насшәа	then
атеориа	theory
уа	there
уа иҟоуп	there are
иҟоуп	there is
убри азын	therefore
арҭ	these
дара	they
дара ыҟоуп	they are
ашәпа	thick
аӷьыч	thief
ауаҭәа	thigh
изгу	thin
акы	thing
амаҭәарқәа	things
амаҭәақәа	things
ахәыцра	think
ахԥатәи	third
ашабара	thirsty
ижҽаба	thirteen
ҩыжәаба	thirty
абри	this
ари	this is
изыцклаԥшу	thorough
уацклаԥшуа	thoroughly
урҭ	those
аха	though
азхәыцра	thought
иҵауланы ихәыцуа	thoughtful
ахәыцрақәа	thoughts
нызықьк	thousand
ашәарҭара	thread
ашәарҭара	threat
ақәмақарра	threaten
хԥа	three
ашәхымс	threshold
ибыжку	thrilled
аӷьацара	thrive
ахәламшәа	throat
алсра	through
ахыҵра	throughout
аршәра	throw
анацәкьыс ду	thumb
адыд-мацәыс	thunder
Аԥшьаша	Thursday
аха	thus
азгәаҭаҷа аҟаҵара	tick
азгәаҭаҷа	tick
ашьҭыҵра	tide
арыцқьара	tidy
ацқьа	tidy
ахәыдхаҵа	tie
аҿаҳәара	tie
атигр	tiger
ирххоу	tight
Тигриниа	Tigrinya
аамҭа	time
иԥхашьа-ԥхаҵо	timid
ахәыҷӡа	tiny
аԥарамҵаԥса	tip
аԥара мҵаԥса	tips
агьежьхарԥа	tire
иааԥсоу	tired
аҿахьшьы	tissue
анапхьшьы	tissue
ахьӡ	title
аҟазаара	to be
атост	toast
ача ӡны	toast
иахьа	today
ахәыҷыԥшқа	toddler
ашьацәкьарақәа	toes
ҳаицны	together
ашьышьмаҭра	toilet
исҳәаз	told
анычҳара	tolerance
ачҳара	tolerate
апатырџьан	tomato
уаҵәы	tomorrow
абз	tongue
уаха	tonight
абригьы	too
уигьы	too
исгеит	took
аинструмент	tool
аинструментқәа	tools
ахаԥыц	tooth
ацәқәа	top
атема	topic
иԥжәоу	torn
аргәаҟра	torture
азеиԥш	total
алакьысра	touch
иӷәӷәоу	tough
атур	tour
уи аганахь	toward
уи ахь	towards
ампахьшьы	towel
ақалақь	town
ашҳам злоу	toxic
ашьҭазааҩ	trace
ашьҭра	trace
атрек	track
ашьҭра	track
ахәаахәҭра	trade
атрадициа	tradition
атрадициатә	traditional
атрафик	traffic
ашьҭазаара	trail
адәыӷба	train
азыҟаҵара	training
аҷыдара	trait
аҷыдарақәа	traits
аиагара	transfer
аиасра	transition
аиҭагара	translate
акеикеи	transparent
атранспорт	transport
атранспорт	transportation
ацәҟьа	trap
агәамсам	trash
атравма	trauma
аныҟәара	travel
аподнос	tray
амазара	treasure
ахымҩаԥгара	treat
ахәшәтәра	treatment
аҵла	tree
идуӡӡоу	tremendous
атенденциа аарԥшра	trend
атенденциа	trend
ашьҭра	trial
атриук	trick
амцҳәара	trick
иааԥсоу	tried
атриггер	trigger
амхра	trim
аныҟәара	trip
ауадаҩра	trouble
аиқәа	trousers
аидарамҩангага	truck
ииашоу	TRUE
ачемодан	trunk
ацбы	trunk
агәрагара	trust
аиаша	truth
аҽазкра	try
Тсонга	Tsonga
аметро	tube
Аҩаша	Tuesday
аҵара	tuition
ашәышәи	turkey
акуркума	turmeric
ааҳәра	turn
акәуа	turtle
арепетитор	tutor
жәаҩа	twelve
ҩажәа	twenty
ҩажәиак	twenty-one
Туи	Twi
ҩынтә	twice
аргьежьра	twist
ҩба	two
атип	type
акьыԥхьра	type
иазҷыдоу	typical
агмыг	ugly
аҵыхәтәантәи	ultimate
аҳаргь	umbrella
иззыҟамҵо	unable
саб иашьа	uncle
зыхдырра зцәыӡыз	unconscious
аҵаҟа	under
аҵаҟа	underneath
иҭәамшьоу	underrated
аилкаара	understand
еилыскааит	understood
гәаҟрыла	unfortunately
ауниформа	uniform
ауникалра змо	unique
аиҟәшара	unit
ауниверситет	university
еилкаам	unknown
уаанӡа	unless
уаанӡа	until
иаалукааша акы	unusual
хыхь	up
шәара ишышәҳәо	up to you
арҿыцра	update
арҿыцра	upgrade
аханы	upon
абжьааԥны	upset
ақалақьтә	urban
агәарԥхара	urge
иузахмырԥо	urgent
ҳара ҳзы	us
ахрахәара	use
ахархәара	used
ихәарҭоу	useful
ихәарҭам	useless
иаабац	usual
абжьааԥны	usually
ахәарҭазаара	utility
аԥсшьара	vacation
авакцинациа	vaccination
авакцина аҟаҵара	vaccine
авакцина	vaccine
асабеизгага	vacuum
ибзианы иубарҭам	vague
аҵабырг	valid
аҵабыргылатә	valid
аԥшаҳәа	valley
зыхә дуу	valuable
ахә	value
аҵакдура	value
ахкы	variety
еиуеиԥшым	various
еиуеиԥшым	vary
аваза	vase
аҭбааҭыцә	vast
ауҭраҭыхқәа	vegetable
ауҭраҭыхқәа	vegetables
амашьына	vehicle
аҭиҩы	vendor
ашҳам	venom
ашәарҭа	venture
ашәарҭара аҭаргылара	venture
аибабара аҭыԥ	venue
арҵабыргра	verify
ауниверсалтә	versatile
авариант	version
ивертикалтәу	vertical
зынӡаск	very
ибзиаӡоу	very good
аӷба	vessel
ацхыраарала	via
аваиб	vibe
аваиб	vibes
игәымбылџьбароу	vicious
аӡхәы	victim
авидео	video
асахьа	view
ақыҭа	village
ацәгьауҩы	villain
абжьеи	vinegar
авинтаж	vintage
амч ахархәара	violence
адәыкрынԥштәы	violent
аԥсы зхоу	viral
амыркыцра	virgin
ивиртуалтәу	virtual
ахаҭабзиара	virtue
аблабара	vision
аҭаара	visit
лаԥшылатәи	visual
аԥсҭазааратә	vital
еилҟьоу	vivid
ажәар	vocabulary
абжьы	voice
аҭацәыра	void
амҽхак	volume
аволонтер	volunteer
аҿыхра	vomit
аблаамӡ	vomit
узыргәаҭеиуа	vulnerable
ауалафахәы	wage
ауалафахәы	wages
аӡара	waist
аԥшра	wait
анаҳаҩ	waiter
аԥшра	waiting
ааԥшра	wake
аҿыхара	wake up
аныҟәара	walk
аныҟәараан	walking
аҭӡы	wall
аԥараҭра	wallet
агәаразаара	wander
аҭаххара	wanna
аҭаххара	want
исҭахын	wanted
аибашьра	war
ашьқьаԥ	wardrobe
ашьҭаҵарҭа	warehouse
иԥхоу	warm
агәҽанҵара	warn
азаардырра	warning
аибашьҩы	warrior
иҟан	was
аӡәӡәара	wash
ус баша аамҭа агара	waste
ахәаԥшра	watch
аӡы	water
ашьынка	watermelon
ацәқәырԥа	wave
амҩа	way
ҳара	we
ҳара ҳаҟоуп	we are
ҳара иҳалшоит	we can
аԥсыҽ	weak
аԥсыҽра	weakness
амал	wealth
абеи	wealthy
аныҟәгара	wear
ашәҵара	wearing
амш зеиԥшроу	weather
ачара	wedding
Ахаша	Wednesday
аҳәира	weed
амчыбжь	week
апсшьарамшы	weekend
акапан	weight
уамашәа иҟоу	weird
бзиала шәаабеит	welcome
амшхәыбзазара	welfare
Нас	Well
ибзиаӡоуп	well done
сцеит	went
иҟан	were
аӡара	west
ибааӡоу	wet
акит	whale
изакузеи	what
уара угәы ишԥаанаго	what about you
узҿуи	what are you doing
иҟауҵои уажәы	what are you doing now
узҿуи уажәы	what are you doing right now
унапы злакуи	what do you do
аԥара злашәырҳауеи	what do you do for a living
ишәҳәарц ишәҭахуи	what do you mean
иуҭахузеи	what do you want
иҟалазеи	what happened
иарбану ари	what is
ари закузеи	what is this
узаанаҭузеи	what is your job
иухьӡуи	what is your name
иҟалазеи	what's up
иухьӡуи	what's your name
иарбанзаалак	whatever
ачарыц	wheat
абарбал	wheel
ианба	when
ианакәызаалак	whenever
иаба	where
уабаҟо	where are you
уабатәиу	where are you from
уабаҟо уажәы	where are you now
уабанхо	where do you live
иаьаҟо	where is
уи аамҭазы	whereas
мамзаргьы	whether
иарбану	which
уи аамҭазы	while
ашәышәра	whisper
ашәышәра	whistle
ашкәакәа	white
дарбан	who
узусҭара	who are you
дызусҭада	who is
дызусҭада	who is this
зегьы	whole
иззы	whom
изтәыда	whose
избан	why
избан мап	why not
ибааԥсу	wicked
аҭбаа	wide
аԥҳәыс емба	widow
аҭбаара	width
аԥҳәыс	wife
абнатә	wild
аҭахра	willing
аиааира	win
аԥша	wind
аԥенџьыр	window
аԥша асуеит	windy
аҩы	wine
аӡын	winter
иҟалоу	wipe
аҭел	wire
аҟәыӷара	wisdom
аҟәыӷара	wise
агәаҳәара	wish
абзиа шәзеиӷьасшьоит	wish you all the best
арупап	witch
аԥыхра	withdraw
амхра	withdrawal
уи иалагӡаны	within
уи ада	without
ашаҳаҭҩы	witness
абызҩыца	witty
абга	wolf
аԥҳәыс	woman
аҳәса	women
саиааит	won
аџьашьахәы	wonder
аџьашьара	wonder
убла хызкуа	wonderful
амҿымаҭәахә	wood
абна	wood
аласа	wool
ажәа	word
ажәақәа	words
аусура	work
аус аура	work out
аусура	working
адунеи	world
ахәаҷа	worm
ирхоу	worn
агәҭынчымра	worried
агәынгара	worry
еицәоу	worse
амҵахырхәара	worship
еицәоуп	worst
аԥсара	worth
уи аҭсоуп	worth it
иаԥсоу	worthy
ахәра	wound
Уоу	Wow
аиларҳәра	wrap
агәеибакра	wrath
анапыхәда	wrist
аҩра	write
Абра ижәҩы	Write here
аҩра	writing
иҩу	written
ииашам	wrong
исҩит	wrote
ашҭа амӡырха	yard
аҿырҳара	yawn
Ааи	Yeah
ашықәс	year
ашықәсқәа	years
адрожь	yeast
аҟаара	yell
аҩежь	yellow
Ааи	Yes
ииашоуп сыԥшқа	yes baby
ааи сыхазына	yes dear
ииашоуп сыхаара	yes honey
ааи сылашара	yes my love
ииашоуп	yes of course
иацы	yesterday
макьаназы	yet
аҳәҳәара	yield
шәара	you
уара	you
уара уҟоуп	you are
уԥшӡоуп	you are beautiful
даараӡа быԥшӡоуп	you are so beautiful
бзиала шәаабеит	you are welcome
уара иузыҟаҵоит	you can
Уара иудыруеит	You know
уаргьы	you too
бзиала шәаабеит	you're welcome
ақәыԥш	young
уара утәы	your
бзиала шәаабеит	your welcome
ухала	yourself
аҿара	youth
бзиала шәаабеит	you’re welcome
ихаау	yummy
ануль	zero
