зы	a
тӀэкӀу	a little
мащӀэ	a little
куэд	a lot
фӀэкхъу	a lot
бэ	a lot
зыкъом	a lot of
бгынэн	abandon
хэкӀыжын	abandon
бгынагъэ	abandoned
щыранагъэ	abandoned
Зэтехуэн	abide
зэдегъэщӀын	abide
пэлъэщын	ability
хурикъун	ability
хъуфынщ	able
ехьылӀауэ	about
ищӀыӀумкӀэ	above
ӀэщӀыбым ит	abroad
щымыӀэн	absence
щымыӀэныгъэ	absence
щыӀэкъым	absent
пэждыду	absolutely
щӀэфын	absorb
гупсысэ	abstract
абзyрт	absurd
бэвыгъэ	abundance
щхьэмыжыбэ	abundance
бжыгъэ куэду	abundant
щӀэфын	abuse
щхьэхуахь	abuse
псэлъэкӀэ	accent
къэбдэн	accept
дэн	accept
кӀуэфын	access
лъэӀэсын	access
зэундэкӀын	accident
жьыхэуэн	accident
уилъын	accommodation
ущӀэсын	accommodation
къэлэжьын	accomplish
къэгъэхъэн	accomplish
къэгъэхъэнкӀэухын	accomplished
елъытауэ	according
епхауэ	according
аритметике	account
математике	account
етыжын	account
пэжыгъэ	accuracy
шэру	accurate
тэрэз	accurate
илажь	accused
дыджзэз	ache
къэгъэхьэн	achieve
къэгъэхъэн	achievement
дэн къэдэн	acknowledge
цӀыхугъэ	acquaintance
нэӀуасэ	acquaintance
зигъэӀэн	acquire
зыгъэӀэн	acquired
къэщэхун	acquisition
адрыщӀ	across
гъуэгум техьэн	act
шӀыкӀэ	act
хъеин	act
бырсырын	action
активный	active
лэжьэнхэр	activities
лъэкӀыныгъэ	activity
актер	actor
пэж	actual
щыпкъэ	actual
пэжыпӀэр	actual
пэжьыр	actually
жан	acute
егъэкӀун	adapt
хъэлъхь	add
фӀэлъхь	add
мыщхьэхуит	addicted
кӀэщӀэдзэу	addition
иризгъэкъуэу	addition
хэлъхьэн	additional
хэщӀапӀэ	address
ирикъунщ	adequate
зэгуэт	adjacent
плъыфацӀэ	adjective
гъэпсын теухуэн	adjust
гурыхьын	admire
дэщ	admit
быннэпӀэс къэщтэн	adopt
лъагъугъафӀэ	adorable
ипэкӀэ	advance
ипэдыдэ	advance
ипэ	advance
хэхъуа	advanced
ефӀэкӀуа	advanced
щхьапэ	advantage
текӀын	advantage
зекӀуэ	adventure
тхыгъалъэ	adverb
реклама	advertisement
реклама	advertising
еӀушын	advice
гъуэгугъэлъагъуэ	advise
ихъумакӀуэр	advocate
Черкес	Adyghe
екӀудахэ	aesthetic
дэхагъэ	aesthetic
зэпыщӀа	affair
гуауэхэ	affect
гухуабэ	affection
хурикъун	afford
иуасэр хъуну	affordable
хыщӀэн	afraid
штэн	afraid
шынэн	afraid
иужькӀэ	after
шэджагъуэужь	afternoon
итӀану	afterwards
иджири	again
аргуэру	again
къапэщыт	against
къыпэува	against
гъащӀэ	age
ныбжь	age
гуэукъэзыӀуатэ	agency
уэзгъащӀэ	agency
ӀуэтэжакӀуэ	agency
лӀыкӀуэ	agent
теуэр	aggressive
блан	agile
япэ	ago
ипэ	ago
дегъэщтэн	agree
хуэбдэн	agree
зэгурыӀуэн	agreement
мэкъумэш	agriculture
пэрыт	ahead
ипэ ит	ahead
дэӀэпыкъу	aid
гугъэ	aim
жьы	air
уафэ	air
чэф	air
кхъухьтедзапӀэ	airport
коридор	aisle
маржэ	alarm
уэхьэхьей	alarm
фадэ	alcohol
бжьэ	alcohol
мыбэлэрыгъ	alert
псэ зыхэт	alive
гуащӀэ	alive
псэу	alive
зэкӀэри	all
хъунщ	all right
фыгъэхуэхьубжэ	all the best
гъэхуитын	allow
хуитщӀа	allowed
хуитхъун	allowed
игъуэрыгъуэ	almost
изакъуэ	alone
зэдэщӀыгъуу	along
дауэрэми	already
хъуну	Alright
щхьэхуэу	also
хэдэфын	alternative
пэтырэ	although
зэпымыун	always
сысейщ	am
щӀагъуэ	amazing
узыгъэгъуащэ	amazing
мыгъэнэхуа	ambiguous
хъушышэ	ambition
хъушышэн	ambitious
къэтэмакъкӀэщӀ	ambitious
зэхъуэжын	amend
икум	amid
язэхуакум	among
фызэдэгъэты	among us
хуэдиз	amount
тӀэкӀу	amount
тхъэгъуэ	amusing
зы	an
зэхэхын	analysis
зэхэгъэкӀын	analysis
Tэтэжхьэр	ancestors
фӀанэ	anchor
пэсэрей	ancient
ипэм	ancient
икӀи	and
уэрынтӀэ	and you
мэлэӀич	angel
губжь	anger
къуапэпaгyэ	angle
губжьа	angry
ябгэ	angry
псэущхьэ	animal
хъэсэп	animal
лъэщхьэвэ	ankle
лъэдий	ankle
илъэсым зэ	anniversary
хуэгъэмахуэкӀын	anniversary
гъуогъэджэн	announcement
гъэтэмакъкӀэшын	annoy
тэмакъкӀэщӀын	annoyed
тэмакъкӀэщӀыгъэ	annoying
хуэӀэлын	annoying
илъэс къэс	annual
аноним	anonymous
адрейр	another
щхьэхуэ	another
жэуап	answer
пэгъуэкӀ	answer
пэджэж	answer
гъэпэсын	anticipate
гуныкъуэ	anxiety
гузэвэгъуэ	anxiety
пӀейтей	anxious
зыгуэр	any
икӀэмкъина	anymore
къела	anymore
дэтхэнэрамияз	anyone
сытдэтхэнэрэми	anything
дауэрэми	anyway
сытми	anyway
мыбдежым тетх	anyways
щхьэхуэ	apart
унэ	apartment
хъурей	apartment
гъэгъу	apologize
къысхуэгъэгъу	apologize
къэлъэгъуэнщ	apparent
къэлъагъуэрэмджэ	apparently
мыдэн	appeal
къэлъагьуэрэ	appear
теплъэкӀэ	appearance
утӀыкум кихьа	appeared
мэжэлӀэн	appetite
мы	apple
мые	apple
щӀын щӀэдзэн	application
чэнджэщ	apply
пӀалъэ	appointment
зэӀущӀэ	appointment
щытхъун	appreciate
щытхъу	appreciation
екӀуэлӀэн	approach
хуэфащэ	appropriate
игъуэ	appropriate
дэн	approval
игъуэу ӀэщӀэдзэн	approve
гъэда	approved
хуэпэблагъэу	approximately
игъунэгъуэу	approximately
мэлхуэгъуэ	april
чэфу	arbitrary
унэгъэпс	architect
гъэтхыкӀуэныгъэ	architecture
тхылъхъумапӀэ	archive
мыбыхэр	are
Уэрэ	are you
ухьэулея	are you busy
унагъуэ ухъуа	are you married
унагъуэ уиӀэрэ хьэмэрэ уиӀэкъэ	are you married or single
иджийабыутэ?	Are you still there?
уэабыушыӀэрэ	are you there
тафэ	area
Ӏэгъуэблагъуэ	area
зэныкъуэкъун	argue
тхылъгъэпэжын	argument
утӀыкум къихьэн	arise
гъэнэхун	arise
ӀэфракӀэ	arm
къуэпс	arm
блэгу	arm
дзэ	army
Ӏуфэлъафэ	around
Ӏэгъуэблагъуэ	around
зэгъэзэхуэн	arrange
гъэзэхуэн	arrangement
нэсын	arrival
къэкӀуэн	arrival
нэсын	arrive
къэса	arrived
къэкӀуа	arrived
пагэ	arrogant
шабзэщэ	arrow
ӀэдакъэщӀэкӀ	art
ӀэщӀагъэ	art
Ӏуэрытх	article
ӀэрыщӀ	artificial
эшӀагъакӀуэ	artist
хъуау	as
нэсфэкӀэ	as long as
къинэмыщӀу	as well
игъусу	as well as
яжа	ash
УкӀыта	ashamed
ЕупщӀ	ask
еупщӀа	asked
мэжей	asleep
лъэныкъуэ	aspect
гупэ	aspect
бгъу	aspect
Ассамсабзэ	Assamese
теуэ	assault
зэфӀэлъхьэн	assembly
хьэрхуэрын	assertive
хуэфащу зехьэн	assess
гъэлъэпӀэн	assess
гъэуэсэн	assess
гъэуэсэн	assessment
хущӀагъэ	asset
щыӀэн	asset
щыӀэпсори	asset
мылъкухэ	assets
тегъэхьэн	assign
къалэн	assignment
дэӀэпыкъун	assist
дэӀэпыкъуэгъу	assistant
дарэ	associate
Ӏыхьэгъу	associate
ещхь	associated
хуэгъунэгъу	associated
хасэтхьэмадэ	association
щыӀэуулъытэн	assume
щыӀэулъытэ	assumption
икӀуэцӀ	at
илъ	at
зикӀ мыхуми	at least
ишхащ	ate
плӀэпс	athlete
хэлъхьэн	attach
зэфэлъхьэн	attach
зэпыщӀа	attached
зэпыт	attached
пыт	attached
нэхъыфӀдыдэ	attachment
теуэ	attack
зэгъэпэщын	attempt
хэтын	attend
къыхэхьэн	attendance
хэхьэн	attendance
фымыбэлэрыгъ	attention
фысакъ	attention
хъущытыкӀэ	attitude
къызэтигъэнэцӀын	attract
гуапых	attraction
удэзыхьэх	attractive
екъурей	attractive
купщӀэгъу	attribute
еплъакӀуэ	audience
шышхьэӀу	august
анэшыпхъу	aunt
адэшыпхъу	aunt
адэшыпхъуцӀыкӀу	aunty
анэшыпхъуцӀыкӀу	aunty
аутентичный	authentic
тхакӀуэ	author
лъытэн	authority
гъэдэӀун	authority
бжьыхьэ	autumn
хуит	available
игъуэ	available
курыт	average
хуэсакъ	avoid
пэӀуувэ	avoid
мыжей	awake
къэуша	awake
саугъэт	award
гулъыта	aware
гулъытэныгъэ	awareness
пэжыжьэ	away
гъэщӀэгъуэн	awesome
шынагъуэ	awful
гугъу	awkward
Ӏэшмыгу	awkward
Аймарабзэ	Aymara
нану	baby
фызыншэ	bachelor
къэзмыша	bachelor
лӀыншэ	bachelor
щӀыбагъ	back
къэнэжа	back
нэгъуэщӀ	back
план щӀыб	background
Ӏей	bad
къэлътмакъ	bag
тхылъылъэ	bag
гъэӀэгъ	bait
Ӏус	bait
Ӏупхъэ	bait
гъэвэн	bake
хьэку	bakery
къэгъэпшаджабэ	baking soda
зэхуэфащ	balance
зэхуэтэрэз	balance
зэхуэдэ	balance
топ	ball
Ӏэщэщхуэ	ball
хъурей	ball
Бамбарабзэ	Bambara
Ӏэпэхэкъуэт	banana
бант	band
шызееутын	bang
банк	bank
къэфапӀэ	bar
ерагъпсэрагъу	barely
узэрыгурыӀуэ	bargain
фэ	bark
вэгъу	bark
хьэ	barley
хэкӀыпӀэншэ	barrier
нэхъмащӀэ	base
лъэгу	base
зикур	based
щӀытунэ	basement
хим	basic
лъапсэ	basic
лъабжьэ	basic
лъапсэмкӀэ	basically
фэслэгъэн	basil
зинэкӀэ къалъхуа	bastard
зэхуэхьэса	batch
зыгъэпскӀын	bath
зыгъэпскӀыпӀэ	bath
згъэпскӀыпӀэ	bathroom
згъэпскӀын	bathroom
батарей	battery
заyэ	battle
хьэгъэжь	bay
хытӀэкуэгъу	bay
шыӀ	be
зыхуэсакъыж	be careful
хы Ӏуфэ	beach
нэхубзий	beam
джэшхэ	beans
мыщэ	bear
жьакӀэ	beard
шэчын	bearing
псэрхэзых	beast
цӀыхушх	beast
хьэкӀэкхъуэкӀэ	beast
ӀэщэкӀэ еуэн	beat
убэрэжьын	beat
гъэсэбэн	beat
дахэ	beautiful
дахагъэ	beauty
псалъэдахэ	beauty
фафӀэ	beauty
пэжхъуа	became
жыпӀамэ	because
хъуафӀ	become
щӀыпӀэ	bed
пӀэ	bed
лэгъунэ пэш	bedroom
бжьэ	bee
былымыл	beef
шыӀа	been
пивэ	beer
япэ	before
ежьа	began
ежь	begin
хуежь	begin
пэщӀэдзэ	beginning
цӀэ хуэгъахьыгъэу	behalf
хуежьэн	behave
тэджын	behave
зэпэща	behave
щэныкӀэ	behavior
щэныкӀэ	behaviour
ищӀыбым	behind
хъун	being
мэхъу	being
шыӀэн	being
динфӀэщхъуныгъэ	belief
уифӀэщхъун	believe
ику	belly
ныбэ	belly
бынжэ	belly
ей	belong
къэшэн	beloved
щӀасэ	beloved
дотэ	beloved
ищӀагъ	below
бгырыпх	belt
телъхьэпӀэ	bench
щӀапӀэ	bench
ӀуэнтӀэн	bend
щӀэджэн	bend
ищӀагъ щӀэлъ	beneath
хэхъуэ	benefit
фӀагъэ	benefit
фӀыгъэ	benefit
щхьэпэнхэ	benefits
фӀагъэхэ	benefits
идей	beside
къинэмыщӀу	besides
щхьэхуэу	besides
нэхъыфӀ	best
яжэ	best of luck
ЛытэныгъэкӀэ	best regards
нэхъыфӀ	better
нэхъдэгъу	better
изэхуакум	between
ирафхэр	beverage
адреим	beyond
Бхуэжпурибзэ	Bhojpuri
дзыхьтемылъын	bias
епэгупсысэн	bias
гупшып	biased
лъэгургъажэ	bicycle
жеӀэн	bid
шхуэ	big
ин	big
лъэгургъажэ	bike
документ	bill
фипхын	bind
бзу	bird
къыщадхъуа махуэ	birthday
тӀэкӀу	bit
мащӀэ	bit
дзэкъапӀэ	bite
дыдж	bitter
вынд	black
фӀыцӀэ	black
сэмпӀaл	blade
сэ	blade
лажьэтеплъхьэн	blame
надэ	blank
нэщӀ	blank
нэд	blank
цытепхъуэ	blanket
Уэныгъ Зэгуэудыныгъ	blast
пӀэнкӀыныгъ	blast
гыкӀэпс	bleach
зэхалъхьар	blend
къеухъум	bless
еушиягъэ	blessed
хьэфиз	blind
нэф	blind
тхъэгъуэ	bliss
Блок	block
лъы	blood
къэгъэгъа	bloom
уӀэгъэ	blow
еундэкӀыгъэ	blow
щхъуантӀэ	blue
мыжан	blunt
цӀакуэ	blunt
гъэӀурыщӀэхэщӀыпщӀэ	board
кхъуафэжьей	boat
пкъы	body
къэвэн	boil
хъыжьэ	bold
Ӏув	bold
гъум	bold
зэпхыныгъэ	bond
зэпыщӀэныгъэ	bond
Ӏэрамэ	bond
къупщхьэ	bone
тхылъ	book
гъэгуащӀэн	boost
гъэлъэщын	boost
гуащӀэ хэзылъхьэр	booster
зыгъэлъэщыр	booster
лъыгъын	boot
шырыкъу	boot
къатыр	boot
къуфэжэй	boots
гъунэ	border
гъунапӀэ	border
гъунапкъэ	border
пхъэвылъэ	bore
гъуанэ	bore
къуий	bore
езэша	bored
бэмпӀэгъуэ	boring
шэчыгъуей	boring
къэхъун	born
къэхъуа	born
щӀыхуэ езыт	borrow
лэжьэпщ	boss
тӀури	both
пыӀэгъуэй	bother
бащырыбэ	bottle
лъабжьэ	bottom
щӀагъ	bottom
ищэхуа	bought
пкӀэн	bounce
дэлъеин	bounce
япха	bound
гъунапхъэхэ	boundaries
бзащӀэ	bow
Ӏэгубжэ	bowl
фалъэ	bowl
пхъуантэцӀыкӀу	box
щӀалэцӀыкӀу	boy
шӀалъэныбжэгъу	boyfriend
Ӏэпщэхъу	bracelet
куцӀ	brain
къудамэ	branch
нагъыщэ	brand
хъыжьэ	brave
хахуэ	brave
лӀыхъужь	brave
къутэ	breach
щӀакхъуэ	bread
псэхун	break
пщэдджыжышхэ	breakfast
быдз	breast
бгъэ	breast
бауэ	breath
жьыкъашэ	breathe
бауэ	breathe
лӀэужь	breed
лъэпкъ	breed
чырбыш	brick
нысэ	bride
лъэмыж	bridge
кӀэщӀу	brief
лыд	bright
лыд	brilliant
къэхьын	bring
къуэшцӀыкӀу	bro
куэд зэрыхуэ	broad
быхъу	broad
ин	broad
тедзэн	broadcast
къута	broke
пыупщӀа	broke
къута	broken
жыхапхъэ	broom
къуэш	brother
шыкъу	brother in law
къыхьа	brought
гъуатӀэ	brown
тхъунщӀ	brush
цейлъэщӀ	brush
пэгун	bucket
нэӀуасэ	buddy
хэхъуэ-хэщӀ	budget
хьэпӀацӀэ	bug
унэщӀын	build
зэтещӀыхьэн	build
унэ	building
унэщӀар	built
зэхуэхьэса	bulk
зэщӀэкъуа	bulk
шӀэбжэхуэн	bull
лӀыгъэхэзылъхьэ	bully
тыкъыр	bump
хъурей	bump
гъагъэӀэрамэ	bunch
пакет	bundle
хьэлъэ	burden
щӀэтӀагъ	buried
щӀэнэн	burn
исын	burn
зэгуэуда	burst
къэуа	burst
къэубэта	burst
щӀэтӀэн	bury
щӀэхъумэн	bury
автобус	bus
къуачэ	bush
Ӏуэху	business
теуэн	bust
унэхъун	bust
щхьэсын	bust
хьэулей	busy
ауэ	but
тхъу	butter
хьэндырабгъуэ	butterfly
щӀыӀу	button
къэщэху	buy
идежкӀэ	by
мы зэпыум	by the way
фӀыкӀэ	bye
къэбаскъэ	cabbage
пцӀы	cabinet
пхъуантэ	cabinet
хъар	cage
кек	cake
шкӀэ	calf
льыхъууэн	call
къысхутеу	call me
теуа	called
пыӀэгъуэ	calm
шыӀэныгъэ	calm
мамыр	calm
къэкӀуа	came
компани	campaign
щӀыфын	can
гъэкӀуэщӀын	can
щӀыфынкъым	can't
Ӏэтыжын	Cancel
узӀей	cancer
ӀэкӀуэлъакӀуэ	capable
ӀэпэӀэсэ	capable
кӀуэцӀыху	capacity
Ӏуэхуублэ ӀэпэщӀэгъэж	capital
щхьэрыхъуэн	caption
къэубыдын	capture
гу	car
щӀэныгъэлэжь	career
лэжьэнгъуэгу	career
мыбэлэрыгъ	careful
сакъу	carefully
хуэмысакъ	careless
еплъын	caring
пхъащӀэ	carpenter
алэрыбгъу	carpet
пхъы	carrot
здехьыкӀын	carry
зешэн	carry
гъэкӀуатэ	carry on
зэпымыу	carry on
кӀуэн	carry out
тхьэусыхэ	case
Ӏэрылъхь	cash
лӀэужьыгъуэ	cast
икӀутыгъэ	cast
лъэпкъ	cast
гъуэ	castle
3къалэ	castle
быдапӀэ	castle
махуэкъэс	casual
махуэен	casual
махуэрей	casual
джэду	cat
къэубыдын	catch
категори	category
былым	cattle
Къаубыда	caught
жыпӀамэ	cause
щхьэкӀэ	cause
фымыбэлэрыгъ	caution
фысакъ	caution
сакъу	cautious
щӀыунэ	cave
къэгъэувыӀэн	cease
унащхьэ	ceiling
нэхъыбэ	ceiling
ищхьэ	ceiling
ехъуэхъун	celebrate
уэтэ	cell
уатэ	cell
кузэку	center
лӀэщӀыгъуэ	century
илъэсищэ	century
хьэдзэ	cereal
мэш	cereal
хьэгъуэлӀыгъуэ	ceremony
гъэнэхуа	certain
шэчхэмылъу	certainly
документ	certificate
гъущӀкӀапсэ	chain
шэнт	chair
пэдысэн	challenge
еныкъуэкъун	challenge
насып	chance
зызхъуэжь	change
къызэӀахьэн	chaos
бырсыр	chaos
щэн	character
щхьэхуныгъэхэ	characteristics
игъэхъун	charge
фӀагъэм ехьылӀауэунэ	charity
узыӀэпишэн	charming
удэзыхьэх	charming
тхыгъэтеплъэ	chart
ехужэн	chase
уэршэр	chat
псэлъэкъуэн	chat
пуд	cheap
гъэпцӀэн	cheat
хэгъэзэрыхьын	cheat
гъэпцӀэншэпхуэ	cheating
тэтхыкӀыншэпхуэ	cheating
уукъагъэпцӀэн	cheating
пыплъэж	check
уплъэкӀуж	check
нэкӀу	cheek
гуфӀэн	cheer
хьэуэжьыуэ	cheerful
гуэхьуэхъу	cheers
узыншагъэмкӀэ	cheers
кхъуей	cheese
химия	chemistry
гъэлъэпӀэн	cherish
шахъмат	chess
бгъэ	chest
пӀытӀын	chew
хабзэрлъэгущӀэтщӀын	chew
гъэныщкӀун	chew
джэд	chicken
лэжьакӀуащхьэ	chief
Ӏэтащхьэ	chief
нану	child
цӀыкӀу	child
бын	child
нануугъуэ	childhood
цӀыкӀухэ	children
бынхэ	children
нанухэ	children
щӀыӀэ	chill
yэжэкъхэр	chimneys
жьэпкъ	chin
шоколад	chocolate
хэдзыгъуэ	choice
хэхыгъуэ	choice
хэхын	choose
цагэгавэ	chop
унагъуэ Ӏуэхухэ	chores
пшэр	chubby
чилисэ	church
тарчын	cinnamon
уэрдыхъу	circle
дымышкъы	circle
хъурей	circle
пэубыдхэ	circumstances
хэкуэгъу	citizen
къалэ	city
баз	claim
гъэнэхун	clarify
еджапӀэщ	class
еджапӀэпэш	class
щӀы	clay
щӀыгу	clay
къабзэ	clean
къабзэ	clear
къаргъуэ	clear
секретар	clerk
губзыгъэ	clever
щэхуакӀуэ	client
ехыгъуей	cliff
бгызадэ	cliff
гъэрыкӀуэ	climate
дыщеин	climb
дэпщын	climb
кӀэрыпщӀэрей	clingy
щхьэрыкӀуэ	clock
сыхьэт	clock
гъэбыд	close
пцӀы	closet
пхъуантэ	closet
щэкӀ	cloth
хъыдан	cloth
щыгъынхэр	clothes
пщэ	cloud
пщагъуэ	cloudy
ажэгъафэ	clown
узлъыхъуэлъагъуэ	clue
Ӏэшмыгу	clumsy
Ӏэтэ	cluster
гъэсакӀуэ	coach
фӀамыщӀ	coal
хыӀуфэ	coast
цакуэкӀэщӀ	coat
кофе	coffee
зэхэщӀыкӀэу	cognitive
къыпэщӀэхуэ	coincidence
къыӀущӀэ	coincidence
хуэзэ	coincidence
щӀыӀэ	cold
ухыгъэ	collapse
иухын	collapse
етӀысэхын	collapse
адрыщӀ	collar
пщампӀэ	collar
Ӏуэхугъу	colleague
лэжьэкӀуэгъу	colleague
язэдэщӀыгъу	colleague
зэӀуэхущӀэгъу	colleagues
зэхуэхьэсын	collect
зэщӀэкъуэн	collect
къэугъуэин	collect
колекция	collection
коледж	college
фэ	color
фэншэу фхъуантӀэ гупсысэхъэр губжьауэу жеихэщ	colorless green ideas slept furiously
фэ	colour
мывэпкъо	column
мажьэ	comb
зэхахь	combination
гъэзэгухэн	combine
КъакӀуэ	come
мыбдежкъакӀуэ	come here
къеблагъэ	come on
тынш	comfort
пыӀэгъуэ	comfortable
тынш	comfortable
къокӀуэ	coming
бэ темыщӀу	coming soon
дзэпщунафэщӀэт	command
теуэршэрыхь	comment
щэн-щэхуныгъ	commercial
Ӏыхьэ	commission
Ӏуэхупщэдэлъхьэ	commit
фӀылъэгъун	commitment
теубыдауэ иӀ	committed
зэрэкӀу	commodity
дарэ	common
Ӏыхьэгъу	common
гупсысэ зэддегъэщӀэн	communicate
ЗэдегъэщӀэн	communication
гупсысэхэр зэдегъэщӀэн	communication
жылэ зэхэт	community
зэхэт	community
кӀуэ нэкӀуэжын	commute
сымэджаплъ	companion
фирмэ	company
зэгъэпщэн	compare
егъэпщэн	compare
зэгъэпщэн	comparison
гущӀэгъу	compassion
гухуабэ	compassionate
къызэдиштауэ	compatible
зэдекӀуау	compatible
вэгъзэгъ	compatible
зэпеуэн	compete
ныкъуэкъуэн	compete
лъэкӀ зиӀэ	competent
зэпеуэн	competition
ныкъуэкъуэн	competition
ныкъуэкъуэкӀуэ	competitive
хуэтхьэусыхэн	complain
тхьэусыхэ	complaint
изыригъэкъу	complement
зэпсори	complete
зэкӀэри	complete
фӀэкхъыу	completely
зэхэлъэфагъ	complex
зэхэгъэкӀуэхьа	complex
зэзэгъын	compliance
зэгурыӀуэн	compliance
зэдебгъэштэн	compliance
зэхэлъэфа	complicated
зэхэгъэкӀуэхьа	complicated
едэхэщӀэн	compliment
зэтехуэн	comply
зэдегъэщӀын	comply
композиция	composition
Зэгуэт	compound
ЗэхэткӀухьа	compound
Зыхэхьа	compound
гурыӀуакӀэ	comprehension
быхъууэ	comprehensive
фэбгъуауэу	comprehensive
зэгурыӀуэн	compromise
егъэзыгъэ	compulsory
амалыншэ	compulsory
компутер	computer
щӀэныгъэгъэпс	computer
гугъэ елӀ	concentrate
егугъын	concentrate
хуэжыӀар	concept
гузэвэгъуэ	concern
пӀейтей	concern
гузэвэгъуэм зыхэтыр	concerned
пӀейтеин	concerned
концерт	concert
икӀэм	conclusion
икӀэ	conclusion
кӀэ	conclusion
лъэӀэсын	concrete
нэӀэсын	concrete
бетон	concrete
Ӏуэхур зытетыр	condition
фӀэкӀыпӀэншэ тхыгъэхэр	conditions
щэныкӀэ	conduct
яхэпсэлъыхьын	conference
яхуэпсэлъэн	conference
къэумысын	confess
Ӏуэтэн	confess
дзыхь	confidence
дзыхь зиӀэ	confidence
къэмылъагъуэ	confident
щэху	confident
ирамыгъащӀэ зищӀысырямыщӀэ	confident
дегъэщтэн	confirm
хуэбдэн	confirm
Зауэ	conflict
зэщыхьэ	conflict
Щхьэ зэӀэхьэн	confused
зэхэзэрыхьаныгъ	confusion
ехэӀуэхун	congrats
хуэгуфӀэ	congratulation
хуэщытхъу	congratulation
сынохъуэхъу	congratulations
хасэ зэӀущӀэ	conjunction
зегъэпхэнб	connect
зэпыщӀэн	connect
къэзэун	conquer
гупсысафӀэу	conscious
гупсысэкӀэ	consciousness
езэгъ	consent
дэн	consent
щӀэухыхэ	consequences
хъумэн	conservation
зыухъумэн	conservative
къыдэплытэн	consider
лъытэныгъэхуащӀа	considered
хэщӀыкӀ	consist
тещӀыкӀ	consist
техъукӀ	consist
таучэлыгъэ	consistency
зэтехуэныгъ	consistency
таучэл	consistent
мыхъей	constant
мыхъуэж	constant
зэпымыу	constantly
зыкӀуэцӀынэн	constipation
унэщӀын	construction
уухын	consume
ухын	consumption
ЗэпыщӀан	contact
гуэуж зэдегъэщӀэн	contact
узпышэ	contagious
узцӀалэ	contagious
дэтхэр	contain
итхэр	contain
изэхэлъ	contains
лъэхъэнэгъу	contemporary
ныбжьэгъу	contemporary
лэгъу	contemporary
зэфӀэмгъэшӀын	contempt
дэтхэр	content
итхэр	content
зэныкъуэкъу	contest
зэдэжэн	contest
зэпеуэ	contest
Ӏэрамэ	context
хытӀэ	continent
зэпымыгъэу	continue
кӀэлъыгъакӀуэ	continue
зэгурыӀуэтхьэпэ	contract
зэзэгъыныгъэ	contract
лыдыгъуэ	contrast
ифӀагъэ егъэкӀын	contribute
деӀэн	contribute
дэӀэпыӀэн	contribute
халъхьэ	contribution
уплъэкӀун	control
зэтемыхуэр	controversial
тыншагъэ	convenience
пэхъу	convenient
игъуэ	convenient
псалъэ	conversation
зэблэдзын	convert
хьын	convey
гъэӀэпхъуэн	convey
лъэгъэӀэсын	convey
къытегъэхьэн	convince
фӀэщщӀын	convince
къэгъэдэӀуэн	convinced
пщафӀэ	cook
пшэрэхьэн	cooking
щӀыӀэ	cool
зэдеа	cooperation
хуэлъэкӀын	cope
хурикъун	cope
гъуаплъэ	copper
икӀэ	core
жылэ	core
ику	core
нартыху	corn
дорэш	corner
шындэбзий	corner
къуапэ	corner
пэж	correct
захуэ	correct
тэрэз	correct
Зытрамылъха хьэпшып	cost
Хэхъуэр	cost
шыгъын	costume
гъэмахуэпсэуалъэ	cottage
бжьэхуц	cotton
гъуэлъыпӀэ	couch
псчэн	cough
хъуфынт	could
хасэ	council
лъытэн	count
щӀыхьхуэщӀын	count
адрыщӀ	counter
къыпэщыт	counter
гупэщыт	counter
хэгъэгу	country
губгъуэ	countryside
тӀурытӀ	couple
хъыжьэ	courage
лӀыхъужьыгъэ	courage
лӀыгъэ	courage
курс	course
джын	course
хей	court
щэныфӀагъэ	courtesy
къуэрылъху	cousin
пхъурылъху	cousin
щхьэтепӀэ	cover
тепӀэ	cover
жэм	cow
къэрабгъэ	coward
хьэгъапхъэ	coward
гухуабэ	cozy
къалыркъаш	crab
къутэ	crack
ӀэщӀагъэ	craft
мыхъумыщӀэныгъэ	crap
зэундэкӀын	crash
жьыхэуэн	crash
гукъэкӀ	craving
дэхьэх	craving
пщын	crawl
зыщыхуэн	crawl
щхьэзэ	crazy
гъэхъун	create
гъэщӀын	create
къэзыхутэ	creative
дзыхьӀэпэщӀэгъэж	credit
хьэпщхупщ	creep
хэщтыкӀыгъуэ	creepy
зезхуэгуп	crew
лажьэ	crime
ӀущтыкӀын	cringe
гууз	crisis
зэхэзэрыхьын	crisis
критер	criteria
тепсэлъыхьын	critical
тепсэлъыхьын	criticism
гъавэ	crop
мэшхэр	crops
гъавэхэр	crops
мет	cross
къуаргъ	crow
цӀыхуӀув	crowd
цӀыхуӀув	crowded
таж	crown
гъэлъэпӀэн	crucial
куэдууэим	crucial
гущӀэгъуншэ	cruel
кхъухь есыкӀыгъуэ	cruise
пӀытӀын	crush
гъы	cry
гъын	cry
нащэбэгу	cucumber
Ӏэплэ зэшэкӀын	cuddle
гъасэ	culture
губзыгъэ	cunning
Ӏэгубжьей	cup
ӀэгубжьэцӀыкӀу	cup
пцӀы	cupboard
пхъуантэ	cupboard
лъэсгъуэгу	curb
хэӀэзэн	cure
еӀэзэн	cure
удэкӀыну хунукъым	curfew
гуныкъуэ	curiosity
гуныкъуэрей	curious
тӀэрэза	curly
хъышэ загъуэ	currency
щыӀэр	current
иджыр	currently
идж	currently
бгэ	curse
Ӏупхъуэ	curtain
щхьэнтэ	cushion
хэха	custom
хухаха	custom
щхьэхуэ	custom
щэхуакӀуэ	customer
хэгъэгу икӀыпӀэхэ	customs
бзыхьын	cut
фӀэбзын	cut
пыупщӀын	cut
лъагъугъафӀэ	cute
къекӀуэкӀ	cycle
лъэгургъажэ	cycling
адэ	dad
адэцӀыкӀу	daddy
амахуэм	daily
махуэкъэс	daily
шатэтехыпӀэ	dairy
шэеуапӀэ	dairy
ӀууапӀэ	dam
псы пэрыуэ	dam
псыхъуэӀуфэ гъэбыда	dam
къутэн	damage
зэхэкъутэн	damage
бгэн	damn
ужэгъун	damn
псыӀэ	damp
цӀынэ	damp
къафэ	dance
шынагъуэ	danger
шынагъуэ	dangerous
псэзэпылъхьэ	dangerous
кӀыфӀ	dark
дотэнэху	darling
тхъигъэ	dash
щӀэн	data
махуэбж	date
хъыджэбз	daughter
пхъу	daughter
махуэ	day
лӀа	dead
яужьлъэхъэнэ	deadline
дэгу	deaf
жьажьэ	deaf
зэзэгъыныгъэ	deal
щӀасэ	dear
псори гупсэхэ	Dear All
псори щӀасэхэ	Dear All
дищэхуакӀуэ лъапӀэ	Dear Customer
анэадэлъапэхьэр	Dear Parents
сышӀэшлъапэ	Dear Sir
дотэнэкъу еджакъуэхьэр	Dear students
дотэнэкъукъyп	Dear Team
лӀэныгъэ	death
зэныкъуэкъу	debate
щӀыхуэ	debit
зэхэкъута	debris
щӀыхуэ	debt
илъэсипщӀ	decade
фын	decay
лӀа	deceased
гъэпцӀэн	deceive
дыгъэгъаз	december
фӀы	decent
щӀагъуэ	decent
унафэщӀын	decide
унафэящта	decided
унафэ	decision
кхъухь гущӀыӀу	deck
къехуэхын	decline
къезыхын	decline
хэщӀын	decrease
мащӀэн	decrease
тегугь	dedicated
зытегъэкӀуэдэн	dedication
зыщхьэмысыжын	dedication
Къэгъэхъэн	deed
ЗэгурыӀуэ тхыгъэ	deed
ЩэныкӀэ	deed
куу	deep
щыхь	deer
щыӀэулъытэн	default
къыптекӀуэ	defeat
къэухъумэн	defend
Ӏуэтэныгъэ	define
Ӏуэтэн	define
шэчхэмылъу	definitely
Ӏуэтэн	definition
зыпщ	degree
дэкӀуеипӀэ	degree
гувэн	delay
гувагъэу	delayed
гъэкъэбзэн	delete
лъэщӀын	delete
лъэсын	delete
ӀеягъэкӀэ ехын	deliberate
гумахэ	delicate
гущабэ	delicate
ӀэфӀыгъэ	delicious
гурыхь	delight
тхъэгъуэ	delight
чэф	delighted
етын	deliver
ӀэщӀэгъэхьан	deliver
иратыжа	delivered
нэбгъэсын	delivery
ӀэщӀэбгъахьэжын	delivery
Етыжын	delivery
хуей	demand
ихуейщ	demanding
демократие	democracy
ӀейцӀыхуӀей	demon
шейтӀан	demon
иблис	demon
егъэлъагъун	demonstrate
мыда	denied
куэдыгъэ	density
дзэ Ӏэзэ	dentist
гъэпцӀын	deny
Ӏуэхугуэш	department
икӀыжьын	departure
ӀукӀын	departure
мыщхьэхуит	depend
гъэшытын	deploy
дэлъ	deposit
далъхьа	deposit
гухуимыт	depressed
депрессия	depression
щыхьэкӀуэн	depression
кууагъ	depth
къэӀуат	describe
хэгъэгъуазэ	description
пшэхъуалъэ	desert
хуэфащэ	deserve
гъэпсыкӀэ къэгупсысэкӀэ	design
тегъэхьэн	designation
гугъэ	desire
лъэӀу	desire
Ӏэнэ	desk
хэкӀыпӀэншагъэ	despair
хэкӀыпӀэншэ	desperate
апхуэдэми	despite
пэтми	despite
ауэ сытми	despite
ӀэфӀы	dessert
нэшанэпӀэ	destination
гугъэкӀэ	destination
натӀэхъуар	destiny
гъэкӀуэдын	destroy
къэсэхыжын	destruction
кӀэрэкӀ	detail
зэхэдзхэ	details
гъэнэхун	detect
къызэщӀэмыкӀуэжын	determination
теубыдауэ	determination
гъэнэхуэн	determine
теубыдапӀэ зиӀэ	determined
къэкъутэнымнэса	devastated
хэбгъэхуэн	develop
хэхъуа	developed
хэхъуэн	development
инхъун	development
ефӀэкӀуэн	development
апарат	device
шейтӀан	devil
пэж	devoted
щыпкъэ	devoted
Дихиуэхибзэ	Dhivehi
ӀэфӀуз	diabetes
ныбажэ	diarrhea
цӀынкӀ	diarrhea
махуэтхылъ	diary
псэлъалъэ	dictionary
ищӀа	did
лӀэн	die
уджыжынтын	die
лӀа	died
узыншагъэшхын	diet
зэхэдз	difference
щхьэхуэ	different
гугъу	difficult
къин	difficult
ерагъ-псэрагъ	difficult
тӀын	dig
щӀыхъ	dignity
егугъугъэ	diligent
пщыхьэщхьэшхэ	dinner
егъэзыхэ	dip
занщӀабзу	direct
лъэныкъуэ	direction
гупэ	direction
бгъу	direction
лэжьапӀэнэхыщхьэ	director
фӀей	dirt
фӀей	dirty
гущӀэншэкъэгъан	disable
хахугъэ	disabled
хагъэкӀыжа	disabled
кӀуэдын	disappear
гу кӀуэдыныгъэ	disappointed
зэхэкъутэныгъэ	disaster
мышхьампэш	discard
гъэунэщӀын	discharge
захуэ зекӀукӀэ	discipline
гъэпудын	discount
къэгупсысын	discover
къэхутэн	discover
зэхэдзыныгъ	discrimination
зэныкъуэкъун	discuss
дэуэн	discuss
зэчэнджэщын	discussion
сымаджэныгъэ	disease
сымэджагъэхэр	diseases
теплъэ зэхъуэжын	disguise
гу зэӀызгъэхьэ	disgusting
фалъэ	dish
тхьэщӀынхэр	dishes
щӀэхун	dismiss
шэн	dispatch
гъэӀэпхъуэн	dispatch
Ӏэкран	display
гъэкӀуэдын	disposal
зэгурымыӀуа	dispute
яку	distance
зэхуаку	distance
щхьэху	distinct
зэхэгъэщэщэн	distinguish
зэхэбдзын	distinguish
зэхуэпхун	distinguish
бампӀэ	distress
яхуегъэхьын	distribution
гуэшын	distribution
Ӏэгъуэблагъуэ	district
ущыхьэн	disturb
пыӀэгъуеин	disturb
къуэ	ditch
къуэладжэ	ditch
къыфилъэдэн	dive
щхьэху	diverse
зэхуэщхьэхуныгъэ	diversity
зыгуэхын	divide
ищӀыкӀын	divide
гуэшын	divide
тхьэлъэӀу	divine
зэпыкӀыжын	divorce
сищхьэ мэуназэ	dizzy
щӀын	do
пщӀынурэ	do you
сэ фӀыуэ сыплъагъурэ	do you love me
Ӏэзэ	doctor
документ	document
щӀын	does
къым	doesn't
хьэ	dog
Догрибзэ	Dogri
йощӀы	doing
нысхъэпэ	doll
игуащӀэтафэ	domain
хуэунаи	domestic
теуэн	dominant
унажэ	dominant
умыщӀ	don't
умыгумэщӀ	Don't worry
умыгузавэ	Don't worry
хэлажь	donate
уха	done
хъуащ	done
шыды	donkey
тӀатӀий	dope
пкъыгъэдий	dope
хабзэ	dope
тӀурытӀ	double
шэч	doubt
гурыщхъуэ	doubt
тхьэв	dough
тхылъымпӀэграмаж	dough
ныкъуэжьэ	dough
ипщэ	down
икӀэ	down
лъабжьэ	down
ехьэх	download
егъэх	download
къехьэх	download
ипэрей план	draft
лъэфын	drag
хуит	drain
драма	drama
цӀэнтхъын	draw
къыдэгэжылъэ	drawer
итхъын	drawing
къэрабгъэ	dread
хьэгъапхъэ	dread
пщӀыхь	dream
пщӀыхьэпӀэ	dream
бзылхугъэфащэ	dress
сае	dress
бру	drill
ирафхэр	drink
узефэн	drink
зехуакӀуэ	drive
джэлэн	drop
къехуэхын	drop
уэскъесын	drop
къехуэхын	dropped
гъаблэ	drought
Ӏуриха	drunk
чэф	drunk
гъур	dry
гъущэ	dry
быбыщ	duck
синыбжэгъу	dude
папщӀэ	due
папщӀэкӀэ	due to
щхьэкӀэ	due to
бэмпӀэгъуэ	dull
шэчыгъуей	dull
Ӏулэ	dumb
тӀыгур	dumb
яжьалъэ	dump
пхъэнкӀий идзыпӀэ	dump
пӀалъэ	duration
ардыдэм	during
сабэ	dust
къалэн	duty
увыӀэн	dwell
пэплъэн	dwell
мылэжьэн	dwell
малӀэ	dying
дэтхэнэри	each
къэс	each
зыр зым	each other
хуэныкъуэ	eager
хуейр	eager
бгъэ	eagle
тхьэкӀумэ	ear
нэхь жьыӀуэ	earlier
жыӀуэ	early
хэгъэхъуэн	earn
тхьэкӀумэхэр	ears
щӀыналъэ	earth
щӀыхъурей	earth
щӀыгу	earth
щӀысыс	earthquake
щӀыхъей	earthquake
щӀыджыздж	earthquake
тыншагъэ	ease
псынщӀэуэу	easily
къуэкӀыпӀэ	east
тынш	easy
шхэ	eat
шхэн	eating
хэщӀыргъэмэщӀэн	economic
хэщӀыгъэншэ	economic
хэхъуэ-хэщӀыр къэщӀэн	economy
къегъэлын	economy
нэз	edge
гъунэ	edge
зэгъэзаху	edit
гъэсэныгъэ	education
гуащӀэ ехьэлӀэн	effect
лъэщы	effective
къызэрытыф	efficiency
къытекӀыфӀ	efficiency
бэвыгъэфӀ	efficient
егугъу	effort
джэдыкӀэ	egg
къэбыцӀ	eggplant
щхьэхуэфӀы	ego
зэзыпэсыж	ego
и	eight
пшыкӀуйи	eighteen
тӀокӀырэплъырэ	eighty
Сыту	either
Дэтхэнэрэ яз	either
е	either
егугъэурэ	elaborate
тегугъэхьэурэ	elaborate
ӀэфракӀэ зэрытыпӀэ	elbow
ныбжырнэхь йыны	elder
жьы	elderly
дахэкӀей	elegant
факътор	element
пыл	elephant
пщӀыкӀуз	eleven
хуэфащэ	eligible
пэхъу	eligible
игъуэ	eligible
утыкум Ӏэтыжын	eliminate
нэмыщӀ	else
нэгъуэщӀ	else
нэпэмыщӀ	else
укӀытагъэхъун	embarrassed
хьэйнапэ ехъулӀэн	embarrassed
напэтехын	embarrassing
хьэйнапэгъэ	embarrassing
ӀэплӀэ ешэкӀын	embrace
гъэнэхун	emerge
утӀыкумкъихьэн	emerge
гузэвегъуэ	emergency
гумах	emotional
Ӏэмрати	empathy
текъузэ	emphasis
къыхэгъэщ	emphasis
къыхэгъэщын	emphasize
лэжьакӀуэ	employee
лэжакӀохэр	employees
гуащӀэдэкӀ зыгъэлажьэ	employer
лэжьапӀэ зиӀэ	employer
Ӏуэху етын	employment
надэ	empty
нэщӀ	empty
нэд	empty
гъэхъу	enable
гъэлъэкӀ	enable
зэхуэз	encounter
зэӀущӀэ	encounter
зэпеуэ	encounter
къэуетын	encourage
икӀэ	end
иуха	end
шынагъуэмхэт	endangered
егугъу	endeavor
быдэныгъэ	endurance
бэшэчыгъэ	endurance
щӀэувэн	endure
пэрыувэн	endure
пэщӀэувэн	endure
жэгъуэгъу	enemy
бий	enemy
гуащӀэ	energy
уэз	energy
хьэулей	engage
ягъэунэхуа	engaged
гъэунэхугъэ	engaged
гъунэхуныгъэ	engagement
мотор	engine
инженер	engineer
инджылизыбзэ	English
хэбгъэхуэн	enhance
зыгъатхъэ	enjoy
зэмыгуш	enormous
ирикъунщ	enough
хуэгъэфащэн	ensure
хэлъхьэн	ensure
щӀыхьэн	enter
ихуэн	enter
хыхьэн	enter
XXXX	entertainment
гушхуэ	enthusiasm
хъий	enthusiasm
зищӀэшыгъуж	enthusiastic
псори	entire
зэкӀэри	entire
хуаусыгъэ	entitled
хущӀагъэ	entity
щыӀэн	entity
щыӀэпсори	entity
щӀэдзапӀэ	entrance
щӀыхьэпӀэ	entrance
зэгъэпэщакӀуэ	entrepreneur
тхыгъалъэ	envelope
Ӏэгъуэблагъуэ	environment
щӀэфыгъуэн	envy
фыгъуагъэ	envy
ӀуэрыӀуатэ	epic
лӀыхъужьыгъэм теухуа усэ	epic
уз цӀалэ	epidemic
зэхуэдэ	equal
Ӏэмэпсымэ	equipment
зэхуэдизын	equity
зэхуэдэн	equity
уасэ зэхуэдэ	equivalent
хьэфэлъэщӀ	eraser
пхэнж	error
къуаншэ	error
мыщӀэкӀэхъуа	error
щӀэпхъуэн	escape
щхьэхуэуэ	especially
rъэнэхун	essay
вагъэсеплъ	essay
шытыкӀэ	essence
икӀуцӀ	essence
пэжыр	essence
хуэныкъуэ	essential
ухуэн	establish
гъэӀа	established
гъэпса	established
псэуалъэ	estate
щӀыгу	estate
щӀапӀэ	estate
къэщӀэн	estimate
гургъуаз	estimated
абдежым	etc
ещхь	etc
хуэдэ	etc
иугъащӀэ	eternal
къэкъутэжыху	eternal
цӀыхумхэлъхабзэ	ethics
щэн	ethics
хуэфащу зехьэн	evaluate
гъэлъэпӀэн	evaluate
гъэуэсэн	evaluate
пщӀэхуэщӀын	evaluation
гъэуэсэн	evaluation
хуэфащу зехьэн	evaluation
занщӀэ	even
ари	even though
пщыхьэщхьэ	evening
къэхъукъэщӀа	event
ухыгъэм	eventually
икӀэжым	eventually
зикӀ	ever
дэтхэнэри къэс	every
псэуми	everybody
хэти	everybody
псэуми	everyone
хэти	everyone
зэкӀэри	everything
зэпсэуэри	everything
гъуазэ	evidence
тэрмэш	evidence
Ӏеягъэ	evil
зэхъуэжын	evolution
ехъулӀэн	evolve
Еуэбзэ	Ewe
жьы	ex
лыджэ	ex
фӀэкхъыу	exact
пэжудыду	exactly
екзамэн	exam
зэпыплъыхьын	examine
щапхъэ	example
щхьэкӀа	exceed
фӀыдыдэ	excellent
щӀыбым	except
хамэхэгъэгу	except
щӀыб	except
щхьэхуэ	exception
лей	excess
нэхъыбэ	excess
егъэлея	excessive
зызхъуэж	exchange
гузэва	excited
узгъэгузавэ	excited
гузэвэн	excitement
узгъэгузавэр	exciting
гузэвэгъуэ	exciting
хэха	exclusive
хухаха	exclusive
щхьэхуэ	exclusive
щхьэусыгъуэ	excuse
къысхуэгъэгъу	excuse me
хуитсыпщӀымэ	excuse me
зегъэкӀуэн	execute
къэдыгъун	execute
зегъэкӀуэн	execution
къэдыгъун	execution
унафэщӀ	executive
зыгъэухун	exercise
гъэсэн	exercise
экъсоз	exhaust
елӀа	exhausted
еша	exhausted
ӀэщӀагъэгъэлъэгъуапӀэ	exhibit
ӀэщӀагъэ гъэлъэгъуапӀэ	exhibition
къэхъуныгъэ	exist
ущыӀэн	exist
къыгъэщӀэныгъэ	exist
щыӀэн	existence
псэун	existence
шыӀэ	existing
икӀын	exit
гъэфамбгъуэн	expand
гъэбыхъун	expand
пэплъэн	expect
хунущытыр	expected
угугъэн	expected
хэшхэр	expenses
лъапӀэ	expensive
гъэнэху	experience
къагъэнэхуныгъ	experiment
Ӏуэхум иӀэзэ	expert
блэгъэкӀащ	expired
хэгъэгъуэзэн	explain
хэгъэгъуазэ	explanation
щхьэхуахь	exploit
къэхъут	explore
къэгъуэт	explore
къэгупсыс	explore
хьэпшып ишын	export
егъэлъагъун	expose
утыкумкъихьа	exposed
къыкъуэкӀа	exposed
упыщӀэхуэнын	exposure
нахуэ	express
жыӀэн	express
жыӀэкӀэ	expression
псэлъэкӀэ	expression
гъэкӀыхьын	extend
хуэшиин	extend
гъэфэбгъуагъэ	extended
хуэшиин гъэкӀыхьын	extension
зэлъиубыдырэ	extent
щӀыб	external
илъэпкъкӀуэда	extinct
нэхъыфӀдыдэ	extra
ихыгъэ	extract
хэхыгъэ	extract
гъэщӀэгъуэн	extraordinary
егъэлея	extreme
егъэлеяуэ	extremely
нэ	eye
нэхэр	eyes
щэкӀ	fabric
гъэщӀэгъуэн	fabulous
фӀыдыдэ	fabulous
щэдагъэ	face
гъэтыншын	facilitate
лъапсэхэ	facilities
зэтегъэпсыгъ	facility
зэфӀэкын	facility
пэж	fact
щыпкъэ	fact
пэжыпӀэр	fact
фактор	factor
фабрикэ	factory
шыпкъэныгъэхэр	facts
бауэ	fade
къэзмыгъэхъа	fail
къыхуэгъэхъакъым	failed
къэмыгъэхъэныгъэ	failure
бауэ	faint
зэхуагъэ	fair
нэхъыфӀ	fairly
тхьэӀухуд	fairy
динфӀэщхъуныгъэ	faith
пэж	faithful
щыпкъэ	faithful
нэпцӀ	fake
джэлэн	fall
къехуэхын	fall
уэскъесын	fall
пхэнж	false
цӀэрыӀуэ	fame
цӀыхугъэ	familiar
нэӀуасэ	familiar
унагъуэ	family
хьэдзэгъей	famine
гъаблэ	famine
уэгъу	famine
цӀэрыӀуэ	famous
гурыхь	fan
щӀэращӀэ	fancy
гупсысэмкъилъхуа	fantastic
къагупсыса	fantastic
жыжьэ	far
сэлам зэх	farewell
мэкъумэшыщӀапӀэ	farm
мэкъумэшыщӀэ	farmer
узыӀэпишэн	fascinating
удэзыхьэх	fascinating
модэ	fashion
хъуабжэ	fast
пшэр	fat
лӀэныгхэ зыхэлъ	fatal
натӀэхъуар	fate
адэ	father
ешагъэ	fatigue
пхэнж	fault
къуаншэ	fault
мыщӀэкӀэхъуа	fault
текӀуэфынур	favorite
нэхъыфӀыр	favorite
фӀыгъэ	favour
нэхъялъытэр	favourite
нэхъыфӀыр	favourite
шынэ	fear
гъэшхэн	feast
цы	feather
щхьэхуэн	feature
хэшыкӀын	features
унэягъэ	features
щхьэхуэныгъ	features
Мэзай	february
сезэша	fed up
пщӀэ	fee
уасэ	fee
гъашхэн	feed
егъэщӀэн хуэгъэзэж	feedback
зэхэщӀэн	feel
зэхэщӀэн	feeling
лъакъуэхэ	feet
къезыха	fell
къехуэха	fell
Ӏупэфэгъу	fellow
жэрэгъу	fellow
ныбжьэгъу	fellow
упщӀэ	felt
бзы	female
бзылъхугъэ	female
чий	fence
лъхуэрей	fertile
махуэхэха	festival
гъэпцӀэн	fetch
хэгъэзэрыхьын	fetch
плъыр-стыр	fever
мащӀэ	few
нэхъ мащӀэ	fewer
гъэунэхуа къэшэн	fiance
ихъуэхь	fiction
кхъухьлъатэтедзапӀэ	field
тафэ	field
хъыжьагъэ	fierce
пшыкӀутфы	fifteen
тхущӀ	fifty
зауэ	fight
зэуэн	fighting
теплъэ	figure
гурыӀуэн	figure out
тхыгъалъэ	file
игъэхъуэн	fill
изщӀын	fill
из	filled
филым	film
фӀей	filthy
икӀэм	finally
ӀэпэщӀэгъэжым къыкъуэтыр	finance
ӀэпэщӀэгъэжагъэ	financial
къэгъуэтын	find
зэгъэщӀэн	find out
фӀы	fine
дахэ	fine
пэж	fine
Ӏэпхъуамбэ	finger
ухыпӀэ	finish
зэрэух	finish
ухыж	finished
мафӀае	fire
фирм	firm
пэрий	first
ипэрацӀэ	first name
бдзэжьей	fish
хуэфащэ хуэхъун	fit
тху	five
гъэсэтеин	fix
зэгъэпэщыжын	fix
зэгъэзэхуэжын	fix
мыхъей	fixed
мыхъуэж	fixed
нып	flag
нэхугуащӀэ	flash
гъэщӀэгъуэн	flash
удэзыхьэх	flash
пӀащӀэ	flat
дзы	flaw
щагъуэ	flaw
губгъэн	flaw
зэтегъэпсэхьыгъ	flawless
дэкӀуэсэн	flee
пкъы	flesh
лъэта	flew
лалэ	flex
шэщӀыф	flex
шэщӀыфагъ	flexible
лалэгъ	flexible
лъатэ	flight
эпшэпэyэн	flip
щӀалэгъуалэгушыӀэ	flirt
къэшэн	flirt
псэлъыхъу	flirt
къэшэныгъэ	flirting
псышэрэб	float
псыдзэ	flood
псыхьэлыгъуэ	flood
унэ Зэтетыбэ	floor
хьэжыгъэ	flour
къиж	flow
гъагъэ	flower
пыхусыху	flu
къижу	fluent
паупшӀахоудэ	fluently
пшакъэӀучэрэфа	fluffy
къижыф	fluid
Лъэтэн	fly
пыкӀын	fly
нэӀа тегъэтын	focus
пшагъуэ	fog
пщагъуэ	foggy
уплӀэщӀын	fold
зэтелъхьэн	fold
лъэпкъ	folks
пхъэрын	follow
къыфэлъфын	follow up
пхъэракӀуэ	following
пхъэражэ	following
Шхэн	food
Ӏулэ	fool
тӀыгур	fool
Ӏулагъэ	foolish
лъакъуэ	foot
лъэ	foot
хьэфэджэгу	football
футбол	football
папщӀэ	for
щхьэкӀэ	for
Псалъэм папщӀэ	For example
гушӀэнпае	for instance
мардэншэ	for instance
уэ щхьэкӀэ	for you
хъункъым	forbidden
гуащӀэ	force
Ӏэпщэ	force
къэщӀэн	forecast
натӀэ	forehead
хамэ	foreign
мэз	forest
мыухнэсыхуэ	forever
щыгъупщэж	forget
хуэгъэгъу	forgive
сщыгъупща	forgot
гуахъуэ	fork
лъэныкъуитӀ	fork
гуахъуэхьэнцэ	fork
лӀэужьыгъуэ	form
хэгъэгуӀуэху	formal
ипэр	former
япэр	former
сытмий	fortunately
мылъку	fortune
плӀыщӀ	forty
плъыкӀтӀу	forty-two
ипэдыдэ	forward
ипэ	forward
нэпӀэс	foster
мылъ	foster
зауэ	fought
къэгъуэтын	found
къыхэгъэщын	found
фӀыгъуапӀэ	foundation
плӀы	four
пшыкӀуплъ	fourteen
бажэ	fox
гущабэ	fragile
гумащӀэ	fragile
къутэнщ	fragile
сурэтдэлъхьэпӀэ	frame
сурэтдэлъхьэпӀэ	framework
гъэпцӀакӀуэн	fraud
хьэкӀэхукӀэкӀуэн	fraud
наджэ-Ӏуджэ	freak
пщӀэншэ	free
уасэншэ	free
хуитыныгъэ	freedom
уасэмхамыгъэхъуэн	freeze
гъэщтын	freeze
фреканс	frequency
бэрэ	frequent
зэпыткъэс	frequently
зэлъыпыту	frequently
щӀалэ	fresh
щӀэ	fresh
Мэрем	friday
щӀыӀалъэ	fridge
Ӏупэфэгъу	friend
жэрэгъу	friend
ныбжьэгъу	friend
щӀасэурэ	friendly
ныбжэгъункӀэ	friendly
ныбжэгъухэ	friends
жэрэгъухэ	friends
ныбжьэгъугъэ	friendship
шта	frightened
шына	frightened
зыгъэшынэ	frightening
псэӀуху	frightening
хьэндыркъуакъуэ	frog
абыкӀэ	from
пэ	front
Ӏупэ	front
щта	frozen
пхъэщхьэмыщхьэ	fruit
губжа	frustrated
къэтэмакъкӀэщӀа	frustrated
фэтэгын	fuel
гъэсын	fuel
Фулфулдэбзэ	Fulfulde
изыбз	full
нэгу зегъэужь	fun
узыгъатхъэ	fun
къалэн	function
хим	fundamental
лъапсэ	fundamental
лъабжьэ	fundamental
хьэдэ	funeral
дыхьэшхэн	funny
джэдыгу	fur
губжьа	furious
ябгэ	furious
пхъэхэкӀхьэпшып	furniture
унэлъащӀэ	furniture
нэхъыбэ	further
къинэмыщӀу	furthermore
щхьэхуэу	furthermore
къыкӀэлъыкӀуэр	future
хэхъуэ	gain
джэгу	game
уэгу	gap
кумб	gap
гуэщ	garage
пхъэнкӀий	garbage
чымпэ	garbage
пхъэнкӀахуэ	garbage
хадэ	garden
бжьыныху	garlic
бжэ	gate
Къэгъуеин	gather
ЗэщӀэкъуэн	gather
зэӀуэщӀэ	gathering
зэхуэсы	gathering
Къэзыгъэлъагъуэ мастэ	gauge
итыгъ	gave
кӀыпхэдзэ	gear
дзэ зыӀут	gear
хъу-бзы	gender
псэури	general
псори	general
гупсысэпсори	general
зэпсэуэу	generally
гъэбэгъуэн	generate
щӀэблэ	generation
зи Ӏэгу Ӏэнэ	generous
губзыгъэ	genius
лӀэужьыгъуэ	genre
щэныфӀэ	gentle
пэж	genuine
щыпкъэ	genuine
пэжыпӀэр	genuine
игъуэфӀыщӀэ	gesture
къэщтэн	get
зышылъэн	get dressed
къэтэдж задэ	get up
фӀыхуежьэж	get well soon
щтэн	getting
къэщтэн Ӏыхын	getting
хьэдэкъэтэджыжа	ghost
гъэжэун	ghosting
иныжь	giant
тэн	gift
тыгъэ	gift
саугъэт	gift
гынплъыжь	ginger
хъыдэз	girl
хъыджэбз	girl
хыджэбз ныбжэгъу	girlfriend
етын	give
щӀэгъуэжын	give up
етыгъэ	given
гуапэ	glad
плъэн	glance
Ӏуплъэгъуэ	glance
абдж	glass
нэгъуджэхэ	glasses
нэӀатедзэн	glimpse
ифuтомпӀ	global
бампӀэ	gloomy
Ӏэлъэхэ	gloves
лыду	glow
цӀу	glow
къэцӀуун	glow up
лыдын	glow up
гъэпкӀалъ	glue
кӀуэ	go
кӀэлъыгъакӀуэ	go ahead
зыӀурегъэх	go away
пӀэм кӀуэ	go to bed
нэшанэпӀэ	goal
гугъэкӀэ	goals
бжэн	goat
тхьэ	god
тхьамкэрегъэгъун	god bless you
хэщӀ	goes
кӀуэн	going
кӀуакӀэ	going to
дыщэ	gold
кӀуащ	gone
сщӀынусокӀуэ	gonna
пщӀэрей	goo
фӀы	good
дахэ	good
пэж	good
шэджагъуэфӀ	good afternoon
гъуэгумахуэ	good bye
мэфэшъуыкъокӀуӀ	good day
пщыхьэщхьэ фӀыуэ	good evening
Ӏуэху дэгъу	good job
къэлъэгъуакӀэфӀ	good looking
теплъэфӀ	good looking
насыпыфӀ	good luck
пщэдджыжьыфӀ	good morning
пщэдджыжьыфӀ сифӀылъагъу	good morning my love
жэщ фӀыуэ	good night
гъуэгумахуэ	goodbye
жэщыфӀых	goodnight
Ӏэмэпсымэхэр	goods
гогыл	Google
Гооглэ зэдзэкӀын	Google Translate
къаз	goose
гъэщӀэгъуэн	gorgeous
бзэгузехьэ	gossip
бзэгуцэ	gossip
къищтэн	got
Щтэн	got
къызгурӀуа	got it
хэгъэгугъуэ	government
къэпхъуэтэн	grab
пыӀэзэфӀэхь	grab
зыпщ	grade
дэкӀуеипӀэ	grade
тӀэкӀутӀэкӀу	gradually
мащӀэмащӀ	gradually
ухын	graduate
жылэ	grain
етыпэн	grant
тыжа	granted
етыжа	granted
санэ	grapes
гурыӀуэн	grasp
удз	grass
гухуэфӀы	grateful
хуэраз	grateful
хуэфӀын	gratitude
хуэрэзэн	gratitude
фӀыгъэгупсысэн	gratitude
кхъэ	grave
яжьафэ	gray
щхъуафэ	gray
гъэщӀэгъуэн	great
нэпсеягъэ	greed
нэпсей	greedy
щхъуантӀэ	green
фӀэхъус зэхын	greet
фӀэхус ехын	greeting
фӀэхусхэ	greetings
яжьафэ	grey
щхъуафэ	grey
гъущӀхъар	grid
гуауэ	grief
хьэжэн	grind
убыдын	grip
щэхуапӀэ	grocery
тыкуэн	grocery
малъхъэ	groom
хэхъуэ-хэщӀ зэкӀэ	gross
щӀы	ground
щӀыгу	ground
гуп	group
зэщхьхэр	group
хэхъуэн	grow
инын	grow
инхъун	growth
инын	growth
гумызагъэ	grumpy
Гуаранибзэ	Guarani
гъэгугъэн	guarantee
плъыр	guard
гугъэн	guess
хьэщӀэ	guest
гъуэзэн	guidance
гъуэзагъэ	guidance
гъуазэ	guide
щагъуэ	guilty
губгъэн	guilty
лажьэ	guilty
лӀы	guy
нэӀуасэхэ	guys
ныбжьэгъухэ	guys
спортпэш	gym
есэн	habit
псэупӀэ	habitat
губгъуэ	habitat
фэху	habitat
иӀа	had
уэ	hail
уэф	hail
щхьэц	hair
ныкъуэ	half
пэш	hall
ӀэдакъэщӀэкӀ	hand
Ӏэ	hand
убыдыпӀэ	hand
къуэпс	handle
зэкӀужь	handsome
пылъэн	hang
кӀэлъыкӀуэн	hang out
фӀэнэн	hang out
къыфӀэнэн	hang out
ехъулӀэнщ	happen
пэжхъуа	happened
гуфӀэгъуэн	happiness
тхъэгъуэн	happiness
тхъэн	happy
укъыщыхъуа махуэмкӀэ сынохъуэхъу	happy birthday
yтхъэжу гъащӀэ	happy birthday to you
илъэсыщӀэ махуэ ухъу	happy new year
гугъу	hard
къин	hard
ерагъ-псэрагъ	hard
гугъу	hardly
къин	hardly
ерагъ-псэрагъ	hardly
нытӀэуий зымий	hardly ever
хэщӀ	harm
ягъэ	harm
иягъэ екӀын	harmful
къызэдищтэу	harmony
зэдекӀуу	harmony
быдэ	harsh
пхъашэ	harsh
ткӀий	harsh
мэшкъехьэлӀэжын	harvest
иӀэн	has
еин	has
гушыкӀ	hate
ей	have
махуэ фӀыуэ	have a good day
махуэфӀы куэду ухъу	have a nice day
пчэдийишхэшӀын	have breakfast
тхъэгъуэ куэду	have fun
пшхаурэ	have you eaten
зиерыгъ	having
риск	hazard
пщагъуэ	haze
абы	he
абы иӀэщ	he has
ар	he is
щхьэ	head
ситхьэкӀумэрмэузыр	headache
Ӏуэтэжын	heal
хъужын	heal
Ӏуэтэжын	healing
хъужын	healing
узыншагъэ	health
псэӀув	healthy
псэбыдэ	healthy
узыншэ	healthy
зэхэхын	hear
зэхэсха	heard
гу	heart
хуэбагъэ	heat
лыгъей	heat
жэнэт	heaven
гугъу	heavy
лъапӀэ	heavy
хьэлъэ	heavy
хьэжэпхъажэ	hectic
лъэгагъ	height
варис	heir
хъунщӀэ	heist
яубыдыр	held
хьэдрыхэ	hell
МахуэфӀ	Hello
махуэфӀ сипсэ	hello dear
фӀэхусдауэущыт	hello how are you
фӀэхус апщий дауэущыт	hello how are you doing
къаскъ	helmet
дэӀэпыкъу	help
дэӀэпыкъуэгъу	helpful
папщӀэкӀэ	hence
ей	her
Ӏэхъуэ	herd
зыкъом	herd
хъушэ	herd
мыбдеж	here
щӀэин	heritage
гуныкъуэ	hesitate
Ей	Hey
Еу	Hi
махуэфӀ дауэ ущыт	hi how are you
ФӀэхус	Hi there
къэмылъагъуэ	hidden
щэху	hidden
ирамыгъащӀэ	hidden
гъэпщкӀу	hide
щэху	hide
ӀэнатӀэ	hierarchy
лъагэ	high
Ӏэта	high
къыхэгъэщын	highlight
къэкӀохьэн	hike
тэлъхьа	hike
къэкӀухьын	hiking
дыхьэшхэн	hilarious
сэнтх	hill
ищхъэ	hill
бжэпэ	hill
ар	him
узлъыхъуэ лъагъуэ	hint
куэ	hip
кӀэдз	hip
пхэщхьэл	hip
кӀэдзхэр	hips
куэхэр	hips
бэджэнд	hire
Ӏуэхумхэпшэн	hire
Ӏуэхумкъэщтэн	hiring
еЕй	his
тхыдэ	history
еуэн	hit
епыджын	hit
Ӏыхьым	Hmm
ӀуэхущӀасэ	hobby
Ӏыгъын	hold
убыдын	hold
пэплъэ	hold on
пхъэвылъэ	hole
гъуанэ	hole
къуий	hole
зыгъэпсэхугъуэ	holiday
кӀуэцӀынэщӀ	hollow
унагъуэ	home
унэлэжьыгъэ	homework
Ипсалъэтет	honest
щэныфӀ	honest
ипсалъэтету	honestly
фо	Honey
лъытэ	honor
щэкӀув	hood
лъахъщ	hook
къэрмакъ	hook
къунжэ	hook
пкӀэн	hop
дэлъеин	hop
гугъэ	hope
сэгугъэ	hopefully
гугъуэншэ	hopeless
тэлъ	horizontal
бжьакъуэ	horn
шынагъуэ	horrible
шынэ	horror
Шы	horse
сымаджэщ	hospital
бысым хупхъэ	hospitality
бгъэхьэщӀэн	hospitality
бысым	host
гужьгъэжьу	hostile
хуабэ	hot
лыгъей	hot
хьэщӀэщ	hotel
ЩхьэрыкӀуэ	hour
сыхьэт	hour
сыхьэтхэ	hours
унэ	house
унэхьэпшып	household
дауэ	how
хъунущуэры	how about you
дауэущыт?	how are you
дауэ ущыт?	how are you doing
нобэ сыт пщӀэр?	how are you doing today
нобэ дауэ ущыт	how are you today
сыту пщӀэрэ	how do you do
дауэ	how is
дапщэ хъуар	how many
сыт хуэдиз	how much
сыт шэху	how often
уиныбжыр дапщэ?	how old are you
уимахуэр дауэщыта	how was your day
уи жэщыр дауэщыта	how was your night
мыбымрэ	however
ику	hub
ныбэ	hub
бынжэ	hub
а сищхьэгъусэщ	hubby
зешэкӀын	hug
иныж	huge
инышхуэ	huge
цӀыху	human
зыщымытхъужь	humble
псыӀэ	humid
цӀынэ	humid
псы зыщӀэт	humidity
щэ	hundred
мэлащӀэ	hungry
yэщӀ	hungry
къэщэкӀун	hunt
хьэжкурий	hurricane
щӀэгъэӀэн	hurry
зыгъэпсынщӀ	hurry up
гукъеуэн	hurt
щыхьэкӀуэн	hurt
лӀы	husband
щхьэгъусэ	husband
къэлъыбжэн	hustle
къэбжахьэн	hustle
унэцӀыкӀу	hut
къабзэныгъ	hygiene
сэ	I
Сэры	I am
сэ сыфӀщ	I am fine
сыщӀыфынщ	I can
сыщӀыфынукъым	I can't
сэ сыщӀынущ	I do
сэ сыщӀакъым	I do not know
къызгурыӀуэкъым	I do not understand
сщӀынукъым	I don't
сэ сщӀакъым	I don't know
КъызгурӀуакъым	I don't understand
жыӀпӀэну узхуеир къызгурӀуакъым	I don't understand what you mean
сэ укъызгурӀуакъым	I don't understand you
сыщӀакъым	I don’t know
къызгурыӀуэркъым	I don’t understand
къыcшыхъун	i guess
Сэси сиӀа шыӀа	I had
сэсиӀэщ	I have
зыпӀалъэр	I have been
сыгугъуапхуэдэ	I hope so
сощӀэ	I know
гурихьынсикӀас	I like
сигу урохь	I like you
фӀы солъагъу	I love
Си къуэш нэхъыжыр фӀыуэ солъагъу	I love my big brother
Си шыпхъу нэхъыжыр фӀыуэ солъагъу	I love my big sister
Си адэр фӀыуэ солъагъу	I love my father
Си къуэш нэхъыщӀэр фӀыуэ солъагъу	I love my little brother
Си шыпхъу нэхъыщӀэр фӀыуэ солъагъу	I love my little sister
Си анэр куэду фӀыуэ солъагъу	I love my mother
ФӀы узолагъу	I love you
куэду фӀыузолъагъу	I love you so much
сэри фӀыуэ узолъагъу	I love you too
жысӀэнусызхуеирмыращ	I mean
сыкъыпхуэзэша	I miss you
уэ куэдурэ сыкъыпхуэзэщ	I miss you so much
къызгуроӀэ	I see
сэрыкӀэ	I think
къызгуроӀэ	I understand
сыхуейщ	I want
услъагъунусыхуейщуэ	I want to see you
сыкъыпхуеищ	I want you
гъэ	I was
сыщӀыну	I will
сэшиӀэш	I would be
сэ	I'm
СыфӀщ	I'm fine
сэ сыфӀыщ	I'm good
сэ мыбдежым	I'm here
къысхуэгъэгъу	I'm sorry
мыл	ice
щӀыӀагъэ	ice
шэӀумыл	ice cream
гупсысэ	idea
гугъэ	ideal
нэхъыфӀыр	ideal
зэшышыныгъ	identical
хуэӀуэтэн	identify
къэӀуэтэн	identify
щхьэтхылъ	identity
Ӏулэ	idiot
нэщӀэу	idle
нэду	idle
зыгуэрӀэ	if
темыплъэн	ignore
земыгъэлъэгъун	ignore
сымаджэ	ill
уз зиӀэ	ill
хабзэмкъемыкӀу	illegal
сымаджагъэ	illness
Ллосанобзэ	Ilocano
щымыӀэр щыӀэу плъэгъун	image
гугъэнэпцӀэн	imagine
гупсысэн	imagine
иджипсту	immediate
гузэвэгъуэу	immediately
инишхуэ	immense
гуащӀэ ехьэлӀэн	impact
зызмышыӀэф	impatient
щӀэдзэн	implement
щӀын	implement
ӀэщӀыб къиш	import
лъапӀэ	important
текъузэн	impose
зэфӀэмыкӀын	impossible
къэгъэдэӀуэн	impress
узыхэплъар	impression
гъэщӀэгъуэн	impressive
фӀыдыдэ	impressive
гъэхъужын	improve
гъэхъужын	improvement
икӀуэцӀ	in
дыпыту	in addition
хуэщхьэху	in addition
зытетыр	In fact
игупэ	in front of
ипэ	in front of
папщӀэ	in order to
щхьэкӀэ	in order to
пэмыхъун	inappropriate
дэщӀ	incentive
къэхъукъэщӀа	incident
мыхэращхэлъыхэр	include
кӀуэцӀ	including
икӀуэцӀым	including
хэхъуэ	income
пыӀэгъуеин	inconvenience
хэхъуэн	increase
хэхъуа	increased
ехъуа	increased
гъэщӀэгъуэну	incredible
пэжу	indeed
хуит	independent
ХЬиндистан	India
къэгъэнэхун	indicate
мыхамэ	indigenous
нэрыбгъэ	individual
минералым хьэпшып къыхэщӀыкӀын	industry
хуэмыхъу	inevitable
нану	infant
энфэкъсийон	infection
мыухыгъуэ	infinity
шынхъурэ	inflammation
ӀэпэщӀэгъэжым иуасэм хэщӀын	inflation
гуащӀэ ехьэлӀэн	influence
егъэщӀэн	inform
щӀэн	information
Ӏэмэпсымэхэ	ingredients
щӀэин	inheritance
пэщӀэдзэ	initial
зэгъэпэщын	initiative
уӀащ	injured
уӀэныгъ	injury
лажьэншэ	innocent
щӀэщӀыгъуэ	innovation
щӀэупщӀэн	inquiry
щхьэзафэ	insane
Ӏулафэ	insane
хьэпӀацӀэ	insect
зыщымыгугъыж	insecure
мыдзыхь	insecure
халъхэ	insert
икӀуэцӀ ис	inside
икӀуэцӀым	inside
гулъагъуэ	insight
лӀэгъэкӀэ	insist
хуэкъаигъ	insist
егъэзыгъэкӀэ	insist
жеиншагъэ	insomnia
гукъэкӀ	inspiration
гукъэзыгъэкӀ	inspire
изыщӀы	install
ищӀыхь	install
щапхъэ	instance
игъуэргъуэкӀэ	instant
ищӀыпӀэ	instead
абы папщӀэ	instead of
щӀэетыхэ	instructions
пшынэӀэмэпсымэ	instrument
гъэпудынпсалъэ	insult
лей ехын	insult
щхьэкӀуэ	insult
щхьэхъумэ	insurance
мыкъэгубжын	intact
псори	integrity
еджагъэшхуэ	intellectual
губзыгъагъэ	intelligence
губзыгъэ	intelligent
ущы	intelligent
гугъэ	intend
гугъэ елӀа	intended
куэд	intense
бэ	intense
гугъэ	intention
зэпыхын	interact
зэпыхьхъущыӀэ	interaction
зэхушытӀыкӀэ	interest
егугъа	interested
нэӀатигъэта	interested
ГъэщӀэгъуэн	interesting
Хэзэрыхьын	interfere
ку	intermediate
икӀуэцӀ	internal
хэгъэгухэр	international
зегъэсэныгъэ	internship
теуэршэрыхьын	interpret
псалъэурэ бзэгуэгъу	interpreter
бзыхьын	interrupt
фӀэбзын	interrupt
пыупщӀын	interrupt
еуэршылӀэн	interview
гухуабэ	intimate
икӀуэцӀы	into
егъэцӀыхъун	introduce
щӀэдзапӀэ	introduction
щӀыхьэпӀэ	introduction
икӀуэцӀыгъэза	introvert
гулъытэ	intuition
мыпхокӀыр	invalid
мыблэкӀыр	invalid
къэхутакӀуэ	invent
хьэпшып уасэхэр	inventory
хэлъхьэ лэжьын	invest
къэхутэн	investigate
еблагъэтхыгъэ	invitation
кӀэгъэлъыкӀуэн	invite
зэпымыгъэун	invite
фактур	invoice
къыхэпшэн	involve
къыхэбгъахьэн	involve
кӀуэцӀ	involved
икӀуэцӀ	involved
гъущӀ	iron
щ	is
хытӀыгу	island
изолэ	isolated
Ӏуэхулъэхъа	issue
Ӏуэхулъэхъахэ	issues
алоуэхь	it
Ӏэу	it
аращ	it is
апхуэда	it was
мыр	it's
Ӏуэхукъым	it's ok
зыри	it's ok
уэхукъым	It's okay
хэлъымяз	item
хэлъхэр	items
ей	its
сэсэры	I’m
цакуэкӀэщӀ	jacket
лъэхъуэщ	jail
Щылэмазэ	January
банка	jar
жьэпкъ	jaw
фыгъуэ	jealous
фӀеягъэ	jerk
налкъут-налмэс	jewelry
Ӏуэху	job
лэжьапӀэ	job
ӀэщӀагъэ	job
зэдэжэ	jogging
хэтын	join
дегъэщтэн	join
дарэ	joint
Ӏыхьэгъу	joint
гушыӀэ	joke
журналист	journalist
гъуэгурыкӀуэн	journey
гуфӀэн	joy
хеящӀэ	judge
пхъэщхьэмыщхьэпс	juice
Бэдзэуэгъуэ	july
пкӀэн	jump
дэлъеин	jump
Мэкъуэуэгъуэ	june
лапӀэншэ	junk
уасэншэ	junk
къудей	just
щӀыри хуну	just do it
хей	justice
захуэу къыщӀэкӀынщ	justify
Калааллисутыбзэ	Kalaallisut
жан	keen
убыдын	keep
Ӏыгъын	keep
ештау	keep it up
къаубыдащ	kept
гъэсырылъ	kettle
гъэвэгъалъ	kettle
ӀункӀыбзэӀух	key
фтырэ	kick
нану	kid
цӀыкӀу	kid
бын	kid
гушыӀэн	kidding
жьэжьей	kidney
наныухэр	kids
укӀын	kill
гъэлӀэн	kill
щэныфӀэ	kind
зыкъомыфӀ	kinda
щэныфӀэу	kindly
щэныфӀагъэ	kindness
пщышхуэ	king
ба	kiss
лэгъунэлей	kitchen
пщэфӀапӀэ	kitchen
къангъэлъатэ	kite
джэдушыр	kitten
лъэгуанжьэ	knee
зытын	knee
йощӀэнт	knew
сэмпӀaл	knife
сэ	knife
уэркъ	knight
щӀэн	know
щӀэн	knowledge
ящӀэр	known
Конканибзэ	Konkani
Криобзэ	Krio
тхыжьей	label
гуащӀэдэкӀ	labor
егугъын	labor
лэжьапщӀэ	labour
гуащӀэрыпсэуапщӀэ	labour
дзы	lack
щыщӀагъэ	lack
чэмыныгъэ	lack
пкӀэлъей	ladder
бзылъхугъэ	lady
гъэтӀысыгъэ	laid
псыхъурей	lake
щынэ	lamb
лъашэ	lame
щӀакъуэ	lame
уэздыгъэ	lamp
щӀы	land
щӀыгу	land
теплъэ	landscape
бзэ	language
ӀэплӀэ	lap
шхуэ	large
ин	large
Иужьрей	last
иужьрейдыдэщ ауэ мащӀэкъым	last but not least
унэгъуацӀэ	last name
гува	late
иужьрей лъэхъэнэхъэм	lately
нэхъ иужькӀэ	later
иужьрей	latest
яужьрей	latest
ятӀуэнэреир	latter
ауанщӀын	laugh
дыхьэшхын	laugh
тхъэн	laugh
ауанщӀын	laughing
дыхьэшхын	laughing
тхъэн	laughing
дыхьэшх	laughter
дзын	launch
жьыщӀыгъэщ	laundry
хабзэ	law
удз	lawn
хеижьэ	lawyer
гъуэлъын	lay
тегъуэлъхьэн	lay
хущӀэхьэн	lay
зэтепщӀ	layer
зэтекӀ	layer
къекӀу	layout
зегъэкӀуэн	layout
хабзэ	layout
щхьэхын	lazy
хуэмыху	lazy
гъуазэн	lead
гъуазэ	lead
пэрыт	leader
пашэ	leader
тхьэмпэ	leaf
тхьэмпэпӀащӀэ	leaf
тхылъымпӀэтхьэмпэ	leaf
къыщӀигъэжын	leak
пцӀанэ	lean
лъапцӀэ	lean
дэпкӀей	leap
зэгъащӀэ	learn
зэгъэщӀэн	learning
хьаху щ]ын	lease
нэхъмащӀэ	least
фэ	leather
ӀукӀын	leave
пщӀащэхэ	leaves
тхьампэхэ	leaves
папщӀэ	led
сэмэгу	left
лъэкӀампӀэ	leg
щӀэин	legacy
хеигъ хабзагъэ	legal
ӀуэрыӀуатэ	legend
еджэгъуафӀэ	legit
лъэхъэнлей	leisure
щӀыхуэ ептын	lend
кӀыхьагъ	length
нэхъмащӀэ	less
джын	lesson
пемыуэн	let
хуит	let
тхыгъэ	letter
блэудз	lettuce
лъытэн	level
лъагагъ	level
Ӏэтылъ	leverage
къэзыӀэтыр	leverage
пщэрилъхьэн	liability
хылъхъумапӀэ	library
ебзэин	lick
пцӀы	lie
пцӀыхэ	lies
гъащӀэ	life
псэуныгъэ	life
псэ зыхэт	life
удэзыгъэкӀуэен	lift
къэзыӀэтыр	lift
псынщӀэ	light
мыхьэлъэ	light
мыӀув	light
щыблэ	lightning
гурыхь	like
хъуфынщу	likely
зэрыкъабзу	likewise
зэрыщыту	likewise
зэлъынцӀа	line
итхъа	line
кусэ	line
Лингадабзэ	Lingala
зэгуэпхэн	link
мэзыхьэ	lion
псыбэ	liquid
табел	list
едэӀу	listen
гъэпсэху	listening
пэжыпӀэр	literally
тхыгъэбзэ	literature
пхъэнкӀий	litter
чымпэ	litter
пхъэнкӀахуэ	litter
кӀэщхъ	little
цӀыкӀу	little
псэун гъэщӀэн	live
тхьэмщӀыгъу	liver
псэуныгъэхэ	lives
гъащӀэхэ	lives
псэун	living
зэхэсыпӀэлэгъунэ	living room
шысыпӀэ	living room
хьамплъыж	lizard
хьэлъэ	load
уш	loaf
хьалпӀам	loaf
шхьакуцӀ	loaf
щӀыхуэ	loan
щӀым елъыта	local
ШытыкӀэ	location
ӀункӀыбзэ	lock
Ӏууэн	lockdown
егъэтын	lockdown
ентӀыр	log
дыхьэшх	lol
изакъуэ	lonely
кӀыхь	long
куэд щӀауэ укъэлъагъуэкъым	long time no see
плъэн	look
хэплъэн	look
теплъэн	look
къекӀуэкӀ	loop
лалэ	loose
кхъубыщ	loose
хъэрахъэ	loose
пщы	lord
уэркъ	lord
гъэкӀуэдын	lose
кӀуэдыгъэ	loss
кӀуэда	lost
куэд	lot
фӀэкхъу	lot
бэ	lot
макъышхуэкӀэ	loud
макълъагэкӀэ	loud
пэш	lounge
хьэщӀэщ	lounge
лагъуныгъэ	love
фӀыуэ узолъагъу	love you
лъагъугъуафӀэ	lovely
Ӏей	low
пуд	low
мыфӀ	low
нэхъ егъэзыха	lower
пэж	loyal
щыпкъэ	loyal
емыпцӀын	loyalty
насып	luck
насыпыфӀэ	lucky
Дугандабзэ	Luganda
хъуржын	luggage
тыкъыр	lump
хъурей	lump
шэджагъуэшхэ	lunch
тхьэмбылхэ	lungs
нэхъыфӀ	luxury
нэху	luxury
хуэпцӀын	lying
пцӀы усын	lying
маршынэ	machine
мыкӀэщӀущ	mad
къиун	mad
щхьэзэ	mad
бзылъхугъэ	madam
щӀыжа	made
щӀыжах	made
шӀэныгъэтхылъ	magazine
гъэщӀэгъуэн	magnificent
унэӀут	maid
пэжыпӀэр	main
ипэрауэ	main
хъумэн	maintain
еплъын	maintenance
Маитхилибзэ	Maithili
япэрауэ	major
нэхъыбэхэр	majority
щӀын	make
лэн	make up
цӀыхухъу	male
щэхуапӀэ	mall
лӀы	man
зешэн	manage
зегъэкӀуэн	manage
гъэӀурыщӀэн	manage
зешэн	management
зегъэкӀуэн	management
гъэӀурыщӀэн	management
лэжьапӀэнэхыщхьэ	manager
хэкӀыпэншэ	mandatory
хуэмыхъу	mandatory
манифесто	manifest
гъэзекӀуэн	manipulate
узхуеим къытегъэхьэн	manipulate
щэныкӀэ	manner
хъущытыкӀэ	manner
мануэл	manual
зыкъом	many
бэру бэру махуэ тхъагъуэх	many many happy returns of the day
Гъатхапэ	march
Ӏыхьэ	margin
бэзэрыпӀэ	market
зэрэгъэшэн	marriage
дэкӀуа	married
нэчыхь езгъэтха	married
къэзыша	married
маскэ	mask
мывэшхуэ	mass
ин	massive
пӀащэ	massive
Ӏэзэ	master
зэнэкъокъу	match
дарэ	mate
псэгъу	mate
Ӏэмэпсымэхэр	material
математике	math
пыбзыгъэ	matter
губзыгъагъэ	maturity
хъуфынщ	may
хъуфынщ	maybe
сысейщ	me
сэри	me too
шхэгъуэ	meal
гу илъын	mean
жыӀэн	mean
гугъэдэпщӀын	meaning
жыӀэнхуеир	meaning
къикӀыр	means
ЖаӀэр	meant
мы зэпыум	meanwhile
пщын	measure
гъэгъунэхэр	measures
Лы	meat
Ӏэзагъэ	medical
ӀэзагъэщӀэныгъэ	medicine
узыншагъэ	medicine
медитация	meditation
ку	medium
зэӀущӀэн	meet
Зэрэгъуэтын	meet
зэхуэс	meeting
зэӀущӀэ	meeting
Мейтедйоныбзэ	Meiteilon
ткӀугъэ	melt
гукъэкӀ	memories
щхьэбыдэ	memory
гурыхуныгъ	mental
тепсэлъыхьын	mention
тепсэлъыхьыныр	mentioned
гъуазэ	mentor
щакӀуэ	merchant
дэжыг	merchant
гущӀэгъу	mercy
къуэдейу	merely
илъэсыщӀэ махуэ ухъу	merry christmas
икъухьагъэ	mess
лейлэжьыгъэ	message
икъухьа	messy
гъущӀ	metal
щӀыкӀэ	method
дзыгъуэхэр	mice
ку ику	middle
жэщ ныкъо	midnight
хъуфынщ	might
гупсысэшабэ	mild
киломэтрэ мывэ	milestone
дзэм теухуауэ	military
шэ	milk
милйон	million
гурыхуэ	mind
гупсысэкӀэ	mindset
сысей	mine
хэзэрыхьын	mingle
кӀэщхъ	minor
цӀыкӀу	minor
дакъикъэ	minute
дакъикъахэр	minutes
гъэшӀэгъуэн	miracle
гъуджэ	mirror
лӀэужьыбэ	miscellaneous
бзаджэ	mischievous
щӀыкӀей	mischievous
егъу	mischievous
фейцей	miserable
тхьэмыщкӀэ	miserable
дэхуэха	miserable
тхьэмыщкӀагъэ	misery
дэхуэхыныгъэ	misery
гукъэкӀын	miss
пабгъэн	miss
сигуукъэкӀа	miss you
сыкъыпхуэзэща	miss you
щыщӀэн	missing
чэм	missing
къалэн	mission
пшагъуэ	mist
пхэнж	mistake
къуаншэ	mistake
мыщӀэкӀэхъуа	mistake
Мизобзэ	Mizo
мобил	mobile
нэпцӀ	mock
модел	model
щапхъэ	model
гупсысэшабэ	moderate
щӀэ	modern
зыщымытхъужь	modest
псыӀэ	moist
цӀынэ	moist
псы зыщӀэт	moisture
гъуатэ	mold
щӀыӀубэнэф	mole
анэцӀыкӀу	mom
нӀапӀэзыпӀэ	moment
Блыщхьэ	monday
нэгъэцӀу	money
ӀэпэщӀэгъэж	money
монитор	monitor
мамун	monkey
мазэ	month
гум изытет	mood
гукӀодыпхъ	moody
мазэ	moon
щэным елъыта	moral
нНэхъыбэ	more
хуэщхьэуэу	moreover
нэхъри	moreover
пщэдджыжь	morning
убыды	mortgage
нэхъыбэр	most
нэхъыбэрэмкӀэ	mostly
aнэ	mother
ны	mother
хъеин	motion
къэуетын	motivation
гугъэлъэщын	motivation
къущхьэ	mountain
дзыгъуэ	mouse
жьэ	mouth
згъэхъей	move
кӀуатэ	move
хъеин	movement
филым	movie
бзылъхугъэ	mrs
куэд	much
фӀэкхъу	much
бэ	much
ятӀэ	mud
куэзыр	mug
трамэ	mug
лыпцӀэ	muscle
музей	museum
хьау	mushroom
пшыналъэ	music
хъун хуейщ	must
щым	mute
макъыншэ	mute
дауншэ	mute
тезэрэху	mutual
сысейщ	my
Сипсэ закъуэ	My dear
си ныбжэгъу	my friend
си кхъуафэ пщыгъэр блэбдзэжеихэмкӀэ изэщ	My hovercraft is full of eels
сифӀылъагъу	my love
сэ сицӀэр	my name is
сэ щхьэкӀэ гуахь	my pleasure
сезыр	myself
щэхугъэ	mysterious
щхьэмкъимытӀэс	mystery
гурымыӀуэгъуэ	mystery
ӀуэрыӀуатэ	myth
Ӏунэ	nail
гукъабзэ	naive
гурылъыфӀ	naive
цӀэ	name
Ӏуэтэжын	narrative
жыӀэжын	narrative
зэв	narrow
фӀей	nasty
лъэпкъу	national
къэралыгъуэ	nationality
мыхамэ	native
щӀыуэп	natural
фэху	nature
щӀыуэпс	nature
гукъызэӀыхьэн	nausea
гъунэгъу	near
благъэ	near
благъэхэм	nearby
игъунэгъуу	nearly
елъытауэ	nearly
къабзэ	neat
хуэныкъуэ	necessary
пщэ	neck
бгъэпылъхьэ	necklace
шыгъэ	necklace
хуэныкъуэ	need
хъуныфэкъым	negative
Ӏэпэдэгъэлэл	neglect
узэрыгурыӀуэ	negotiate
гъунэгъу	neighbor
хьэблэ	neighborhood
сытми	neither
къуэрылъху	nephew
пхъурылъху	nephew
Ӏулэ	nerd
тэмакъкӀэщӀ	nervous
щэщӀа	nervous
унагъуэ	nest
абгъуэ	nest
нахуэ	net
хъар	network
хъы	network
нейтралный	neutral
зиикӀ	never
егъащӀэки зымытыж	never give up
иужь икӀ	never mind
иужь икӀ	nevermind
апхуэдэми	nevertheless
ауэ сытми	nevertheless
щӀэ	new
къабэрхэр	news
къыкӀэлъыкӀуэр	next
иужрейр	next
идей	next to
дахэ	nice
гурыхь	nice
дызэрыцӀыхъуам щхьакӀэ сигуапэщ	nice to meet you
къуэрылъху	niece
пхъурылъху	niece
жэщ	night
жэщтеу	nightmare
бгъу	nine
пщӀыкӀубгъу	nineteen
бгъущӀ	ninety
Хьауэ	No
уэхукъым	no problem
хъунукъым	no way
зыри	nobody
зэхэзэрыхьа	noise
Ӏэуэлъауэ	noise
зауэ	noise
зэхэзэрыхьа	noisy
Ӏэуэлъауэ	noisy
дым-сым	noisy
зырикӀ	none
шэджагъуэ	noon
хьэуэхъункъым	nope
сыту	nor
захуэ	normal
хъун	normal
ищхъэрэ	north
дыгъэмыхъуэ	north
пагэ	nose
пэ	nose
ипэ	nose
пэсэрей	nostalgic
къым	not
зыкӀи	not at all
уезэгъынщ	not bad
иджимыкъун	Not now
иджыкъым	not yet
хэгъэгъуазэ	note
нотщӀа	noted
зырикӀ	nothing
гулъытэн	notice
къэпщӀэн	notice
гуслъытагъ	noticed
цӀэ	noun
цӀэхэр	nouns
роман	novel
ЩэкӀуэуэгъу	november
иджипсту	now
мымахуэхэм	nowadays
бампӀэ	nuisance
надэ	null
нэщӀ	null
нэд	null
гумащӀэншэ	numb
гумахэншэ	numb
бжыгъэ	number
шыпхъу	nurse
сымаджэрыплъ	nurse
дэцӀыкӀу	nut
индиядэ	nutmeg
уагъэшхэн	nutrition
тхьэлъанэ	oath
тхьэрыӀуэ	oath
пщэрыгъэ	obesity
едэӀу	obey
едэӀуэн	obey
хьэпшып	object
гугъэ	objective
пщэрилъхьэн	obligation
мыгъэнэхуа	obscure
тэплъэкӀуэн	observation
хэплъэкӀуэн	observe
еплъэкӀуэн	observe
фӀэнапӀэхэлъ	obsessed
ерышэ	obsession
жьыхъуар	obsolete
хэкӀыпӀэншэ	obstacle
къызӀэщӀэгъэхьэн	obtain
акӀэхьан	obtained
нахуэу	obvious
адэ	obviously
Зэзэмызэ	occasionally
ӀэщӀагъэ	occupation
зэлъаубыдапэ	occupied
ихъуахь	occur
къохъуа	occurred
къохъур	occurs
къохъу	occurs
хьэдрам	ocean
Хэсэн Тесэн	october
зызакъуэ	odd
зэхуэгъадэ	odds
ей	of
адэ	of course
гъэбыда	off
теуэр	offensive
ЖыӀэн	offer
лэжьапӀэ	office
хэгъэгуӀуэху	official
бэкӀэ	often
нэхъыбэкӀэ	often
Еуэй	Oh
шыпкъэ?	oh really
дагъэ	oil
щӀыдагъэ	oil
тхъу	oil
хъунщ	ok
хунущсипсэ	ok dear
Хъуну сифо	ok honey
хунущ сифӀылъагъу	ok my love
хъунщ	okay
нтӀэ наныу	okay baby
хуну сипсэ	okay dear
хъуну сиӀэфӀ	okay honey
хунущ сифӀылъэгъу	okay my love
жы	old
тес	on
тет	on
телъ	on
Зэ	once
зы	one
егъащӀэки бзэ закъуэр ииркъунщкъым	one language is never enough
бжьын	onion
онлайн	online
къабзэ	only
зызакъуэ	only
ӀупщӀ	open
Ӏуха	open
ущӀа	open
операция	operation
зэрыплъэгъуф	opinion
гурылъ	opinion
игъуэхэ	opportunities
утеху	opportunity
игъуэ	opportunity
къыпэщыт	opposite
зигумыкӀуэд	optimistic
хэдэн	option
узэрыхуеиу	optional
е	or
плъыжьгъуэжьыфэ	orange
къэщэхупхъэхэр	order
пуд	ordinary
уасэншэ	ordinary
организация	organization
гъэгъуэзэн	orientation
хуэгъуэзэн	orientation
лъэпкъ	origin
ищыпкъэр	original
Оромозэ	Oromo
ибэ	orphan
адрей(р)	other
хьэмэ	otherwise
къинэмыщӀу	otherwise
егъэзыгъэныгъ	ought
дыдей	our
Дипщэдэлъыр: псоми дэнэ щыӀами дуней псэуныгъэр къагурыӀуэну икӀи бзэхэм язэхуаку зыкъаӀуэтэжыфын ядгъэлъэкӀынур аращ	Our mission: to enable everyone, everywhere to understand the world and express themselves across languages.
Дипщэдэлъыр: Дунейм щӀэныгъэхэ зэдгъэзэхуэну икӀи зэрыдунеир мыбы ӀущӀэфыну икӀи ягъэпсыфын ялъэкӀынур аращ	Our mission: to organize the world's information and make it universally accessible and useful.
щӀыбым	out
хамэхэгъэгу	out
Ӏуэгу	out
кӀэ икӀэ	outcome
щытӀэгъэн	outfit
щыгъын	outfit
кӀуар	outgoing
икӀын	outlet
пэжыртхыгъэхэр	outline
Ӏуэгумдэт	outside
щӀыбымкӀэ	outside
къохъущхьэкӀын	outstanding
гъэщӀэгъуэн	outstanding
хьэку	oven
ищӀу	over
абы шыт	over there
псэури	overall
псори	overall
гупсысэпсори	overall
ухурикъун	overcome
куэду гупсысэн	overthinking
гузэвэгъуэхэхуа	overwhelmed
бэуэ	overwhelming
хьэлъэу	overwhelming
фӀагъэ хуегупсысэн	owe
хуэразэхъун	owe
жьынду	owl
езыр	own
зей	owner
вы	ox
хуабжагъэ	pace
псынщӀагъэ	pace
пакет	pack
пакет	package
пщыныжа	paid
уз	pain
Лэ	paint
гъэлэн	painting
тӀурытӀ	pair
бауэ	pale
ӀэмыщӀэ	palm
унащхьэ	pan
нэхъыбэ	pan
ищхьэ	pan
нзцӀалэ	pandemic
хьэрпхъэр	panic
щхьэхьпсэхь	panic
гъуэншэдж	pants
тхылъымпӀэ	paper
жэнэт	paradise
зэбгъурилъытхъа	parallel
унапӀэ	parcel
къысхуэгъэгъу	pardon
анэ-адэ	parents
ны-ды	parents
гуэщ	park
бзупсалъэ	parrot
къунтхъурэй	parsley
бзыхьэхуэ	part
тыкъыр	part
цӀыкӀу	part
яхэхьан	participate
хэха	particular
гъэнэхугъэ	particular
хуэгъэзауэдыду	particularly
дарэ	partner
Ӏыхьэгъу	partner
парт	party
блэкӀа	pass
зэпырыкӀын	pass
блэкӀын	pass
блэкӀыпӀэ	passage
блокӀа	passed
гугъэ	passion
гу илъхэр	passion
дэхьэх	passion
дэхьэхыныгъ	passionate
пасиф	passive
хъуэрыбзэ	password
щӀагъыбзэ	password
къыкӀэрыхуа	past
блэкӀа	past
лъэхъэнэмкъыкӀэрыхуа	past
тедэ	patch
гъуэгу	path
гу егъуну	pathetic
тхьэмыщкӀэ	pathetic
зышыӀэ	patience
сымаджэ	patient
тхъыпхъэ	pattern
егупсысын	pause
лъэсгъуэгу	pavement
пщынын	pay
пщынын	payment
мамыр	peace
мамырын	peaceful
къыпцӀэ	peach
щхьэгъэ	peak
щхьэпэ	peak
кхъужь	pear
джэшхъурей	peas
гъэщӀэгъуэн	peculiar
гъутхьэн	pee
фэ	peel
вэгъу	peel
зэлэгъу	peer
лэгъу	peer
хасэжылагъэкъyп	peers
мыухпэрытх	pen
карандаш	pencil
пэт	pending
пэплъэщыт	pending
цӀыхухэр	people
шыбжий	pepper
зэхэщӀыкӀ	perceive
зэхэщӀык	perception
зыхэщӀэн	perception
фӀыдыдэ	perfect
къэгъэщыпкъэн	perform
пэжгъэхъун	perform
лъэкӀыр	performance
къэгъэхъэн	performance
хъуфынщми	perhaps
лъэхъэнэ	period
зэкӀэлъхьэужьу	permanent
мыухыжу	permanent
хуитыныгъэ	permission
хуитыныгъэ	permit
теубыдапӀэ зиӀэ	perseverance
къанэр	persistent
нэрыбгъэ	person
нэрыбгъэныр	personal
щэныгъэ	personality
къэлъэгъуакӀэ	perspective
хэплъэкӀэ	perspective
фӀэщщӀын	persuade
къытегъахьэн	persuade
еру	pervert
дэхыгъ	pervert
унэрыӀыгъ псэущхьэ	pet
теувэгъу	phase
феномен	phenomenon
дунейплъэкӀэ	philosophy
тхыдэркъэхутэн	philosophy
щыӀэныгъэркъэхутэн	philosophy
телэфон	phone
сурэт	photo
жыӀэкӀэ	phrase
псэлъэкӀэ	phrase
пкъымтеухуа	physical
хэх	pick
къыхэх	pick
щтэн	pick up
къэщтэн	pick up
къэщэхун	pick up
сурэт	picture
бзыхьэхуэ	piece
тыкъыр	piece
цӀыкӀу	piece
прыпкъэхэр	pieces
кхъуэ	pig
Тхьаркъуэ	pigeon
зэтелъ	pile
зыкъом	pile
Ӏэтэ	pile
щхьэнтэ	pillow
кхъухьлъатэ зыгъэлъатэ	pilot
шэрэз	pin
мастэ	pin
ананас	pineapple
тхьэмбылыфэ	pink
къургъакъ	pit
мащэ	pit
кумб	pit
тафэ	pitch
гущӀэгъу	pity
щӀыпӀэ	place
щӀы	place
тӀысыпӀэ	place
щӀыпӀэхэр	places
емынэ	plague
уэх	plain
ЗанщӀэ	plain
сэтей	plain
план	plan
кхъухьлъатэ	plane
къэкӀыгъэ	plant
кӀырхэр	plants
номер	plate
къэнжал	plate
платформ	platform
къафэн	play
джэгун	play
къафэн	playing
джэгун	playing
дахэ	pleasant
гурыхь	pleasant
кхъыӀэ	please
гуапэ	pleased
гурыхь	pleasure
тхъэгъуэ	pleasure
хулъхугъуэ	pledge
гъэр	pledge
куэду	plenty
бэрэу	plenty
кхъухьлъатэ зыгъэлъатэ	plot
иу	plug
пхъэгулъ	plum
сантехник	plumber
хэр куэдхэр	plural
нэтын занщӀэ	podcast
усэ	poem
усэ зэхэплъхьэн	poetry
точкӀэ	point
щхъухь	poison
полицэ	police
политикэ	policy
цӀыхупӀащӀэ	polite
фӀеягъэ	pollution
уалэ	pond
кхъухьщӀыжыпӀэ	pool
псызэрыува	pool
хьей	poop
дэхуэха	poor
тхьэмыщкӀэ	poor
газоз	pop
уон	pop
кӀэракъо	pop
цӀэрыӀуэ	popular
хэкуцӀыхухэр	population
кхъуэл	pork
зэнтх мырамысэ	porridge
кхъухъ ӀухьапӀ	port
ӀэнатӀэ	position
тетыгъуэ	position
хъуныфэщ	positive
ейин	possess
иӀэн	possess
зеин	possession
зей	possession
еиныгъ	possessive
хъуфынщ	possible
гъэхьын	post
егъэхьын	post
пӀалъэрхъуэжын	postpone
къантоф	potato
зэрылъэкӀ	potential
игуащӀэ	potential
лъэхъуэщ	pound
тхьэмыщкӀагъэ	poverty
гуащӀэ	power
уардэ	power
Ӏэпщэ	power
зипсалъэпхыкӀыр	powerful
бланэ	powerful
гуащӀэ зиӀэ	powerful
псынщӀэн	practical
щӀэдзэн	practice
щытхъу	praise
ӀукӀей-щӀыкӀейщӀын	prank
тхьэ елъэӀу	pray
лъапӀэ	precious
гумахэ	precise
гущабэ	precise
фӀэкхъыу	precisely
къэхъунур къэщӀэн	predict
узыхэдэр	prefer
хэдэ	preference
уэндэгъу	pregnant
лъэшыджэ	pregnant
япэгупсысэ	prejudice
мылъку	premises
ӀэпэщӀэгъэжлей	premium
узэдын	preparation
зэгъэпэщын	preparation
узэдын	prepare
зэгъэпэщын	prepare
зиузэда	prepared
щӀэнхуэщыӀ	preposition
хущӀагъэ	presence
щыӀэн	presence
щыӀэпсори	presence
иджыпсту	present
ехыныгъ	presentation
хуэшииныгъ	presentation
хъумэн	preserve
Ӏэтащхьэ	president
тхьэмадэ	president
тхьэм ида	president
журналистхэр	press
тедзакӀуэхэр	press
дэкъуза	pressure
хуежьэн	pretend
тэджын	pretend
зэпэща	pretend
лъагъугъуафӀэ	pretty
гъэувыӀэн	prevent
япэрейр	previous
щакӀуэ	prey
Ӏус	prey
ныш	prey
пщӀэ	price
уасэ	price
гушхуэ	pride
шогэн	priest
япэрейр	primary
япэрауэр	primary
ипэрауэ	prime
жангуащэ	princess
хабзэ	principal
нэхыщхьэ	principal
тхьэмадэшхуэ	principal
япэ	prior
ипэ	prior
нэхъэпагъэ	priority
лъэхъуэщ	prison
щэхуныгъэ	privacy
хэха	private
хухаха	private
щхьэхуныгъэ	privilege
саугъэт	prize
хъуфынщ	probably
зэхэзэрыхьа	problem
екӀу зекӀуакӀэ	procedure
зэпымыгъэу	proceed
гъэкӀуэтакӀэ	process
гъэбэгъуэн	produce
мэш	product
къэгъэкӀын	production
ӀэдакъэмщӀэкӀын	production
ӀэщӀагъэ	profession
хахуэ	professional
гупэ	profile
хэхъуэ	profit
фӀагъэ	profit
фӀыгъэ	profit
куу	profound
кӀуэтэн	progress
проект	project
зэгъэпэщын	project
ялъытар	prominent
нэхъэпагъэ	prominent
псалъэ етын	promise
пщэрилъхь	promote
къегъэхъуапсэн	promotion
къегъэнэцӀэн	promotion
псынщӀэ	prompt
хуабжэ	prompt
хуэхуабэхъун	prone
цӀэпапӀщӀэхэр	pronouns
псэлъэкӀэ	pronunciation
къэумысын	proof
хуэфащэ	proper
игъуэ	proper
мычэм	properly
хахуэ	properly
зэхуэдэ	properly
щхьэхуэхэ	properties
мылъку	property
жыӀэн	proposal
гугъэн	prospect
псэуныгъэфӀ	prosperity
псэуныгъэкӀафӀэ	prosperous
дахэ	prosperous
псэуныгъэдахэ	prosperous
хъумэн	protect
гушхуэ	proud
гъэпэжын	prove
ехын	provide
хуэшиин	provide
гъэхъуа	provided
къалэ	province
хейунафэ	provision
фэншэууз	puberty
жылэ	public
екъундей	pull
екъуф	pull
къаб ӀэфӀ	pumpkin
ичэзу	punctual
игъуэ	punctual
еджакӀуэ	pupil
нэджыдж	pupil
ягъасэр	pupil
къэщэхун	purchase
къабзэ	pure
фыхъуэплъ	purple
гугъэ	purpose
къэлътмакъ	purse
тхылъылъэ	purse
щэхуукӀэлъыпхъэрын	pursue
пхъэр	pursuit
едыркъын	push
гъэтӀылъ	put
ирикъунш	qualification
нэхъыфӀ	quality
хуэдиз	quantity
тӀэкӀу	quantity
къэхухьын	quarantine
дэмгъэкӀын	quarantine
зауэ	quarrel
плӀанэ	quarter
Куэщуабзэ	Quechua
гугуащэшхуэ	queen
Гъэунэхъун	queer
упщӀэ	query
упщӀэ	question
чэзу	queue
псынщӀэ	quick
хуабжэ	quick
псынщӀэурэ	quickly
щым	quiet
макъыншэ	quiet
дауншэ	quiet
шхыӀэн	quilt
щын	quit
икӀ	quit
нэхъыфӀ	quite
еупщӀын	quiz
хэхыгъэ	quotation
къыхэхыгъэ	quote
къытехыгъэ	quote
пыщыгъуэхэр хэхыхэр	quotes
тхьэкӀумэкӀыхь	rabbit
зэдэжэ	race
зэпеуэ	race
губжь	rage
уэшх	rain
дэкӀуэен	raise
ехъун	raise
гъэлъэга	raised
Ӏэта	raised
жа	ran
ухуэзэ	random
изхуаку	range
псынщӀэщ	rapid
хуабжэщ	rapid
хуабжагъэу	rapidly
зэрыз	rare
гъуэтыгъуэй	rare
зэзэмызэ	rarely
къэплъыжьыгъэ	rash
дзыгъуэ	rat
зэхуэгъадэ	rate
абы нэхъри	rather
зэхуэгъадэ	ratio
Ӏущыбж	rational
цӀыхӀув	raw
гуэбэн	raw
мыхъу	raw
щӀэрыщӀэ	re
нэсын	reach
лъэгъэщӀыхьэн	reached
нэса	reached
рэакъсийон	reaction
еджэн	read
джын	reading
хьэзыр	ready
зэпэща	ready
пэж	real
щыпкъэ	real
пэжыпӀэр	real
щыӀэхэр	reality
пэжхэр	reality
гулъытэн	realize
гулъитагъ	realized
пэжу	really
щӀыбагъ	rear
папщӀэ	reason
игъуэу	reasonable
къеджэжын	recall
джэжын	recall
тхылъыпӀэ	receipt
документ	receipt
щтэн	receive
къэщтэн	receive
къэщэхун	receive
Ӏыхыжа	received
яужьрей лъэхъэнэхэм	recent
иужьрэлъэхъэнэхэм	recently
хьэщӀэ щӀэтхапэ	reception
рецент	recipe
зэфӀимыгъэщӀын	reckless
къэцӀыхун	recognition
къэцӀыхун	recognize
къэщӀэн	recognize
хущытхъун	recommend
джэнджэн	recommended
итхэн	record
къегъэлын	recover
къегъэлын	recovery
плъэмие	rectangle
плъыжь	red
къегъэлын	redeem
къэнэӀужын	redemption
къелын	redemption
гъэмэщӀэн	reduce
хуэмыныкъуэн	redundant
шытхъуж	refer
шытхъу	reference
гъэцӀуун	reflect
къэцӀууж	reflection
ежьыуж	refrain
щӀыӀалъэ	refrigerator
егъэзэжьын	refund
етыжьын	refund
хьэуэ	refuse
уэмыдэн	refuse
хэyэ	refused
лъытэ	regard
пщӀэ	regard
щӀыхь	regard
хуэгъахьыгъэу	regarding
хуэгъунэгъу	regarding
сытхъунми ирэхъу	regardless
лъытэфэсэхы	regards
Ӏэгъуэблагъуэ	region
итх	register
щӀегъуэжыныгъэ	regret
занщӀабз	regular
захуэ	regular
тэрэз	regular
захуэу	regularly
мыдэн	reject
хуэгъунэгъу	relate
егугъын	related
хуэгъунэгъу	related
зэпыщӀа	relationship
елъытауэ	relative
унэкъуэщхэ	relatives
зыгъэлал	relax
зыгъэтынш	relax
гъэхуитын	release
хуитящӀа	released
ехьщ	relevant
хуэгъунэгъу	relevant
Дзыхь	reliable
зыгъэпсэхун	relief
гъэтыншын	relief
гъэтыншын	relieve
къэгупсэхуа	relieved
дин	religion
динымтеухуа	religious
хуэмей	reluctant
хуэмыныкъуэ	reluctant
щыгугъын	rely
дзыхьхуэщӀын	rely
къэнэн	remain
къэна	remaining
къэла	remaining
гъэщӀэгъуэн	remarkable
хэкӀыпӀэ	remedy
къэцӀыхуж	remember
уигукъэгъэкӀыжь	remember
гукъэкӀыжын	remind
гукъэгъэкӀыж	reminder
жыжэ	remote
пэжыжэ	remote
къэӀэт	remove
зэзгъэщэщэныр	render
бэджэнд	rent
щӀыж	repair
щӀыжын	repair
щӀэрыщӀэ	repeat
иджыри	repeat
эхъзуэжын	replace
къыпэджэж	reply
жэуапкъэт	reply
рапорт	report
лӀӀыкӀуэ	represent
дзыхь зыхуащӀ	reputation
хуей	request
лъэӀу	request
хуэныкъуэ	require
хуэныкъуэ	required
къегъэлын	rescue
хутэн	research
лъыхъуэн	research
зэщхь	resemble
зэхуэд	resemble
ябгагъэ	resentment
хухэхын	reservation
минерал щӀэлъыр	reserve
тӀыса	resident
хэкӀыжын	resign
шэщӀыфагъ	resilience
лалэгъ	resilience
пэувы	resilient
къыпэувын	resist
къыпэщӀэтын	resist
къыпэув	resistance
къыпэщӀэт	resistance
зэфӀэх	resolution
зэфӀэкӀын	resolution
зэхахун	resolution
тӀэтэн	resolve
къуаджэпсэху	resort
псынэхэ	resources
лъытэ	respect
пщӀэ	respect
щӀыхь	respect
пэгъуэкӀын	respond
пэджэжын	respond
пэгъуэкӀ	response
пэджэж	response
пщэдэлъ	responsibility
зипщъэдэлъ	responsible
зыгъэпсэхун	rest
тыншу ужеищ	rest in peace
шхапӀэ	restaurant
щӀыжын	restore
гъэщӀэкуэн	restrict
икӀэм	result
икӀэ	result
кӀэ	result
кӀэухыхэр	results
гъэкӀуат	resume
тучануасэ	retail
убыдын	retain
Ӏыгъын	retain
убыдын	retention
мылэжьэж	retired
къызэкӀэкӀуэн	retreat
къэщтэжын	retrieve
кӀэщэхужын	retrieve
къэгъэзэгъуэ	return
къикӀуэтыж	return
зэхэпхун	reveal
утӀыкумкъихьа	revealed
гъэнэхуа	revealed
лъыщӀэж	revenge
хэхъуэ	revenue
зэпыгъэза	reverse
пхэнж	reverse
щӀыб	reverse
уплъэкӀужьын	review
ухэплъэжьын	review
хэплъыхь	revise
рэвизйон	revision
зэкъуэкӀыныгъэшхуэ	revolution
саугъэт	reward
ритм	rhythm
цагэ	rib
пундж	rice
пурундж	rice
хуэщӀа	rich
къэнэӀужын	rid
яӀэщӀэкӀын	rid
къелын	rid
тетӀысхьэн	ride
шэсын	ride
дыхьэшхэныгъэ	ridiculous
ижь	right
иджипсту	right now
быдэ	rigid
уэрдыхъу	ring
дэгъэжэхын	rinse
бырсыр	riot
хача	rip
хэча	rip
тӀэпӀа	rip
хъуа	ripe
дэкӀуэен	rise
ехъун	rise
риск	risk
ныкъуэкъуэгъу	rival
псыхъуэ	river
гъуэгу	road
гъэвэн	roast
быдэ	robust
джей	rock
лулэ	rod
чы	rod
гъущӀыч	rod
зыщӀыкӀэ	role
зыщӀын	role
зэкӀуэцӀышыхьэ	roll
унащхьэ	roof
пкъы	roof
лэгъунэ	room
лъапсэ	root
лъабжьэ	root
кӀапсэшхуэ	rope
пцӀы	rotten
мыбыдэ	rotten
фа	rotten
пхъашэ	rough
пхъашэу	roughly
яе	round
хъурей	round
гъуэгухэха	route
зэрыкӀуэу	routine
чэзу	row
зэкӀэлъхьэужьу	row
щытӀэ	rub
резина	rubber
пхъэнкӀий	rubbish
чымпэ	rubbish
пхъэнкӀахуэ	rubbish
пхъашэ	rude
Алэрыбгъу	rug
зэхэкъута	ruin
хабзэ	rule
итхъыпхъэ	ruler
хабзэхэ	rules
жэ	run
лажьэрэ	running
губгъуэ	rural
згъэпсынщӀэ	rush
епӀэщӀэкӀын	rush
къэпыпхъэ	sack
лъапӀэ	sacred
емыблэжын	sacrifice
дзыхь телъ	safe
дзыхьу лъатэщ	safe flight
мышынагъуэ	safety
удз	sage
жыӀа	said
жьырыху	sail
хы гъуэгурыкӀуэ	sailing
гугъэ	sake
мэзапщӀэ	salary
улахуэ	salary
щэн	sale
зызыфӀэщӀыж	sale
аргъэй	salmon
шыгъу	salt
зещхь	same
зэхуэд	same
мыбдэж зэходэ	Same here
щапхъэ	sample
пшахъуэ	sand
Санскртыбзэ	Sanskrit
ауанщӀын	sarcastic
гушыӀэрилэ	sarcastic
дэгушыӀэн	sarcastic
щыкӀын	sassy
щыкӀей	sassy
еша	sat
гуапэныгъ	satisfaction
игуапэхъуар	satisfied
егъэдэн	satisfy
ирикъунщ	satisfying
Щэбэт	Saturday
сосис	sausage
тхьэмщӀыгъуныбэ	sausage
емлыдж	savage
къегъэл	save
идъэгъуа	saw
жыӀэ	say
щапхъэ	scale
гъэпцӀагъэ	scam
дыркъуэ	scar
зэрыз	scarce
гъуэтыгъуэй	scarce
шта	scared
шына	scared
щхьэтепхъуэ	scarf
гуих	scary
шынагъуэ	scary
икъухьа	scattered
къэфапӀэ	scene
джэгупӀэ	scene
теплъэ	scenery
мэ бамэ	scent
махуэбж	schedule
мазалъэ	schedule
егъэджапӀэ	school
щӀэныгъэ	science
щӀэныгъэлэжь	scientist
щӀэныгъэлэжьхэр	scientists
лэныстэ	scissors
ецӀэцӀэн	scold
зэлъиубыдырэ	scope
скор	score
Ӏэмэпсымэжь	scrap
зэхэкъута	scrap
иратхъа	scratch
итхьа	scratch
гуэун	scream
экран	screen
ӀутӀэ	screw
сенарйо	script
зигупсысэр зыхэлъ	script
хы	sea
тхыпкъэ	seal
зэпыу	search
зэхуаку	search
илъэс пкъыгъуэ	season
блыгу	seat
шэнтиуэ	seat
етӀанэрей	second
къэмылъагъуэ	secret
щэху	secret
ирамыгъащӀэ	secret
зэрыхуэхъулъыс	section
лъэныкъуэкъуапэ	section
дзыхьын	secure
мышынагъуэ	security
хы	see
дызэрылъэгъун	see you
итӀанэдызэрыдъэгъун	see you later
благъэм дызэрылъэгъунщ	see you soon
пшэдэй дызэрэлэгъун	see you tomorrow
хьэдзэ	seed
жылэ	seed
льыхъуэн	seek
къызэрылъагъуэрэмкӀэ	seem
къэлъагъуэщ	seems
ялъэгъуа	seen
къэлъэгъуа	seen
ӀэщӀэгэхьэн	seize
Ӏэрыгъэхьэн	seize
плъыр	seizure
зэзэмызэ	seldom
хэх хэдз	select
щхьэзыфӀэфӀ	self
езыр езыру зыгъэхъужын	self healing
зэзыпэсыжа	selfish
щэж	sell
щэ	sell
ныпыкъу	send
ныппкъо	send
мытэплъэм зыфӀимгъэшы егъэхьы	send me your picture
лъэгагъ	senior
лъагъун	sense
пымэн	sense
зэхэхын	sense
гупсысэм къекӀур	sensible
гумахэ	sensitive
гущабэ	sensitive
егъахьа	sent
гъахьа	sent
псалъэухуа	sentence
псалъэ зэхэтхэр	sentences
щхьэхуэ	separate
Сэпэдибзэ	Sepedi
ФокӀадэ	september
чэзу	sequence
зэкӀэлъыкӀуэхэ	series
пэж	serious
гушыӀэншэ	serious
лӀыпӀэзэрыт	serious
щыпкъэу	seriously
пэжу	seriously
Ӏуэху	serve
Ӏуэхутхьэбзэ	serve
Ӏуэху	service
Ӏуэхутхьэбзэ	service
зэхэсыгъу	session
теухуэн	set
гъэпсын	set
зэгъэзэхуэн	set up
вагъэсэплъ	setting
гъэпс	setting
теухуэ	setting
тӀысын	settle
тысыкӀын	settle
блы	seven
пщӀыкӀубл	seventeen
блыщӀ	seventy
зытӀущ	several
Зыбжанэ	several
хъыжьагъэ	severe
дын	sew
жау	shade
жьауэ	shadow
гъэсыс	shake
хъунущ	shall
шэд	shallow
чэнж	shallow
укӀытэ	shame
теплъэ	shape
Ӏыхьэ	share
жан	sharp
ар	she
а фызым иӀэщ	she has
а хыджэбз	she is
а фыз	she is
унэцӀыкӀу	shed
мэл	sheep
табел	sheet
бжыкъу	shelf
фэ	shell
вэгъу	shell
хъумапӀэ	shelter
псыгурдэнэ	shield
кхъухьплъыр	shift
пӀалъэрылажьэ	shift
лыдын	shine
кхъухь	ship
кхъухьджэ егъэшэн	ship
хьэлъэ зешэ	shipping
джанэщӀыӀутелъ	shirt
вакъэхэ	shoes
еуэ	shoot
щапӀэ	shop
тучан	shop
щэхуэн	shopping
адрыщӀ	shore
Ӏуфэ	shore
ныджэ	shore
кӀэщӀ	short
хьэдзэгъей	shortage
гъаблэ	shortage
уэгъу	shortage
уэн	shot
хуей	should
ищыщӀа	should
дамэ	shoulder
кӀиин	shout
гуоуэн	shout
къэгъэлъагъу	show
егъэшӀэ зыфӀимгъэшӀы	show me
зыгъэпскӀын	shower
зыгъэпскӀыпӀэ	shower
креветки	shrimp
гъэцӀыкӀун	shrink
гъэбыд	shut
зэӀун	shut up
уижьэ зэтелхь	shut up
укӀытэрей	shy
шыпхъу	sibling
къуэш	sibling
зэшыпхъухэр	siblings
зэкъуэшыэр	siblings
зэшыхэр	siblings
сымаджэ	sick
уз зиӀэ	sick
бгъунж	side
щэӀун	sigh
еплъыкӀэ	sight
плъагъун	sight
къэкӀухьын	sightseeing
гъэлъагъуэн	sign
нагъыщхьэ	sign
ду	sign
ӀэщӀэдзэ	signature
лъапӀэ	significant
макъыншэныгъ	silence
щым	silent
макъыншэ	silent
дауншэ	silent
щылэ	silk
данэ	silk
Ӏулэ	silly
дыжьын	silver
хуэдэ	similar
ещхь	similar
Ӏулэ	simp
тӀыгур	simp
къабзэ	simple
зыри зыхэмылъ	simple
нӀапӀэзыпӀэгъу	simultaneously
лъандэрэ	since
гухуабэ	sincere
гуэпагъэкӀэ	sincerely
уэрэд жыӀэ	sing
yэрэдаӀуэ	singer
къэзмыша	single
дэмыкӀуа	single
ӀэтхьэщӀыпӀэ	sink
хулъхугъуэ	Sir
шыпхъу	sister
Ӏэдэжэ	sister in law
щыкъухъыджэбз	sister in law
тӀыс	sit
къэтӀыс	sit
унэгуп зэхэт	site
сите	site
Ӏуэхур зытетыр	situation
хы	six
пщӀыкӀух	sixteen
хыщӀ	sixty
инагъ	size
Ӏэзагъэ	skill
Ӏэзагъэхэ	skills
фэ	skin
уэд	skinny
фагъуэ	skinny
епкӀэн	skip
кӀэпхын	skirt
кӀэдахъуэ	skirt
уэгу	sky
пщылӀ	slave
Жеин	sleep
мэжэй	sleeping
жеинапхъ	sleepy
ӀэфракӀэ	sleeve
къуэпс	sleeve
блэгу	sleeve
бзыгъэ	slice
ежэхылъ	slide
тӀэкӀу	slightly
мащӀэ	slightly
пӀащӀэ	slim
псыгъуэ	slim
ежэхын	slip
хуэсэныпэ	slope
пхъэвылъэ	slot
гъуанэ	slot
къуий	slot
щым	slow
хуэм	slow
мащӀэ	slow
щэхуу	slowly
хуэмцӀыкӀу	slowly
цӀыкӀу кӀэщхъ	small
губзыгъэ	smart
кӀэщӀущ	smart
бамэ	smell
мэ	smell
пыгуфӀыкӀын	smile
Ӏугъуэ	smoke
хахуэ	smooth
къабзэ	smooth
шхынтӀэкӀу	snack
нэшӀэпкӀэ	snail
блэ	snake
гъэмщӀанкӀ	snap
уэс	snow
мыст	so
лъагъугъуафӀэ	so cute
идж нэсу	so far
щӀэфын	soak
сабын	soap
зыщӀэж	sober
хьэфэджэгу	soccer
футбол	soccer
социялнэ	social
жылэ	society
лъэпэдхэ	socks
курбыш	soft
щабэ	soft
тхакӀэ	software
щӀы	soil
яща	sold
уха	sold out
заyэлӀ	soldier
зызакъо	sole
быдэ	solid
къэкъутэн	solution
къэщӀэн	solution
къэкъутэн	solve
зэхэпхун	solve
къэщӀэн	solve
зэзэмызэ	some
загъуэрэ	some
зыгуэрыхэ	somebody
зытэплъэ	somehow
абы ящыщу	someone
зыгуэр	something
зэзэмызэ	sometimes
уэрэд	song
гъунэгъуу	soon
лъэщыгъэ	sophisticated
куэду зэхэт	sophisticated
Соранибзэ	Sorani
жьанэ	sore
тэмакъ	sore
тэмакъуз	sore throat
гухэщӀ	sorrow
гукъеуэ	sorrow
нэщхъеягъуэ	sorrow
ГумащӀэ	Sorry
гъэчэзу	sort
зэгуэгъэв	sort
ялъыхъур	sought
псэ	soul
дэпсэуэгъу	soulmate
псэгъу	soulmate
макъ	sound
хьэнтхъупс	soup
гуащӀэ	sour
зыщыщыр	source
къызыхэкӀар	source
дыгъапӀэ	south
Уэгу	space
Зы	space
кумб	space
къылъэхэнэн	spam
быхъугъэ	span
испанйолыбзэ	Spanish
хэха	spare
лей	spare
гъэтӀылъа	spare
псэлъэн	speak
хэха	special
хухаха	special
щхьэхуэ	special
лӀэужьыгъуэхэр	species
зэхуэщхьэхухэр	species
щхьэху	specific
гъэщӀэгъуэн	spectacular
псэлъэн	speech
мыпсэлъэж	speechless
хуабжагъэ	speed
псынщӀагъэ	speed
екъуреин	spell
нэщӀэпхэ	spell
лъэхъэнэ	spell
щэн	spend
къэщэхун	spend
ягъэхьарджа	spent
сыру	spicy
щхьэмыжь	spike
къегъэкӀэрэхъуэкӀын	spin
къыхэгъэнэн	spin
къегъэзэн	spin
джэдз	spinach
псэ	spirit
убзытхэн	spit
гъэшӀэгъондыдэ	splendid
гуэш	split
зэрыпхъуэ	spoil
пхъуатэ	spoil
щыкӀын	spoiled
щыкӀей	spoiled
езыр езыру	spontaneous
бжэмышх	spoon
точкӀэ	spot
псэгъу	spouse
щхьэгъусэ	spouse
щэщэн	spread
зэхэщэщэн	spread
гъатхэ	spring
плӀимэ	square
къузын	squeeze
хузын	squeeze
шакъэбдзэжьей	squid
кальмар	squid
КӀэпхъ	squirrel
хэпыджэн	stab
кӀуэцӀыпыджэн	stab
теубыдагъэ зиӀ	stable
зэтелъ	stack
зыкъом	stack
Ӏэтэ	stack
лэжьакӀуэхэр	staff
къэфапӀэ	stage
джэгупӀэ	stage
бжыгъэ	stain
пкӀэлъейхэ	stairs
бжьэгъу	stake
убыдыпӀэ	stalk
къэувыӀэпӀэ	stall
нагъыщэ	stamp
Ӏуэхур Зытетыр	stand
теувапӀэ	stand
зэщхькъабзэ	standard
вагъуэ	star
пэщӀэдзэ	start
хуежьа	started
ежьа	started
гъаблэм игъэлӀэн	starving
хэгъэгу	state
хуэщӀа	state
ЗыӀуатэ	statement
хэгъэгъуазэ	statement
ЖызыӀэ	statement
къэхутапӀэ	station
лъыхъуапӀэ	station
мафӀэгукъэувыӀапӀэ	station
сын	statue
Ӏуэхур зытетыр	status
къанэ	stay
зыкъэухъум	stay safe
мыхъей	steady
мыхъуэж	steady
лыкъабзэ	steak
тхыцӀэл	steak
дыгъуэн	steal
ДыгъуакӀуэн	steal
бахъэ	steam
жыр	steel
дэгъэзэигъуэ	steep
задэдэкӀыгъуэй	steep
лъапсэ	stem
лъабжьэ	stem
лъэбакъуэчын	step
кӀэрыгъэпщӀэн	stick
щӀэгъэшхэн	stick
быдэ	stiff
пхъашэ	stiff
ткӀий	stiff
иджы	still
иджыпсту	still
тӀэкӀу ипэ	still
хэyэн	sting
Ӏэбыдэ	stingy
хьайнатӀэ	stingy
укхъуэжын	stir
уцэрэбын	stir
хьэпшыпыбэ	stock
нэгъуадж	stolen
шхалъэ	stomach
мыщӀэ	stone
мывэ	stone
лъэзэхэпхэ	stood
шэнтщхьэгуэ	stool
къэувыӀэ	stop
гуэнэщын	storage
туканышхуэ	store
уэлбанэ	storm
борэн	storm
къелын	storm
таурыхъ	story
хьэку	stove
собэ	stove
занщӀабз	straight
занщӀабзу	straightforward
къин ехъун	strain
ерагъэ	strain
хамэ	strange
хамэ	stranger
стратегия	strategy
хьэуазэ	straw
губгъуэмэракӀуэ	strawberry
зэдэува	streak
самыр	streak
бла	streak
къиж	stream
гъуэгуанэ	street
гуащӀэ	strength
Ӏэпщэ	strength
губжьуз	stress
къэщэщӀын	stretch
шэщӀын	stretch
быдэ	strict
мылэжьэн	strike
чэзу	string
щагъэ	strip
уагъэ	strip
кусэ	strip
гу етыгъэ	strive
чэнчэ	stroke
къебгъэуэн	stroke
зипсалъэпхыкӀыр	strong
бланэ	strong
гуащӀэ зиӀэ	strong
къауа	struck
псэуалъэ	structure
ебэнын	struggle
езэуэн	struggle
пэщӀэувен	struggling
гуцӀеин	stubborn
къанлын	stubborn
кудэн	stuck
зэхэӀувэн	stuck
еджакӀуэ	student
лажьэн	study
солажьэ	studying
Мыстхэ	stuff
щӀагъуэ	stunning
гъэщӀэгъуэн	stunning
Ӏулэ	stupid
щхьэдыкъ	stupid
щӀыкӀэ	style
гупсысэку	subject
фэшэен	submission
ныпыкъу	submit
ныппкъо	submit
пыбзыгъэ	substance
хэха	substitute
лей	substitute
гъэтӀылъа	substitute
пӀащӀэ	subtle
псыгъуэ	subtle
къэзгъэхъа	succeed
къэгъэхъэн	success
къэзгъэхъа	successful
мыпхуэдэу	such
псалъэм папщӀэ	such as
щӀэфын	suck
цакъ	sudden
зэуэ	suddenly
гуауэшэкӀын	suffer
гуауэн	suffering
гуузын	suffering
ирикъунщ	sufficient
фошыгъу	sugar
гъуэгу егъэлъагъун	suggest
гупсысэ ехын	suggestion
Фашэ	suit
екӀу	suitable
игъуэ	suitable
пхъуантэ	suitcase
зэхуэхэса	sum
гъэкӀэщӀа	summary
гъэмахуэ	summer
къуршпэнчӀыу	summit
дыгъэ	sun
дыгъэбзий	sun
тхьэмахуэ	sunday
дыгъэнэпс	sunny
дыгъэкъухьэгъуэ	sunset
дыгъэбзий	sunshine
фӀыдыдэ	super
текӀуэн	superior
нэхъыфӀ	superior
гъэлъэпӀэн	superior
еплъакӀуэ	supervisor
пщыхьэщхьэшхэ	supper
Зэгъэпэщ	supply
дэӀэпыкъу	support
пэщӀэсэ	support
щӀэгъакъуэ	support
щыӀэу дылъытэн	suppose
зэрыжаӀамкӀэ	supposed
хъунщ	sure
ищӀыӀу	surface
бырыбын	surge
къэукъубиин	surge
ябзын	surgery
унэгъуацӀэ	surname
гъэгуфӀэн	surprise
гуфӀэгъуэ	surprise
гъуэша	surprised
етын	surrender
зыт	surrender
къэшӀыхьан	surrounding
къыкъуэплъын	surveillance
щӀэупщӀэн	survey
къегъэлын	survive
гурыщхъуапхъэ	suspect
иджырикӀэ Ӏэтыжын	suspended
гурыщхъуапхъэ	suspicious
зэпымыгъэун	sustain
лъыгъэкӀуэтэн	sustain
зэпымыущӀыкӀ	sustainability
лъыбгъэкӀуэтэфынщ	sustainable
зэпыу имыӀу	sustainable
зэрыпхъуэ	swag
пхъуатэ	swag
пцӀащхъуэ	swallow
хъуэжын	swap
елъэӀун	swear
ехъуэнын	swear
пщӀэнтӀэпс	sweat
цыджанэ	sweater
пхъэнкӀын	sweep
ӀэфӀ	sweet
къумалэблэгуаплъэ	sweet dreams
цэӀэфӀщ	sweet tooth
сиӀэфӀ	sweetheart
гъэщӀэгъуэн	swell
пшын	swelling
есын	swim
есын	swimming
хъыринэ	swing
ӀункӀыбзэӀух	switch
пша	swollen
джатэ	sword
нагъыщэ	symbol
лъагъугъафӀ	sympathy
къыхэщыхэр	symptoms
гъэунэхуахэр	symptoms
щӀыкӀэ	system
зэхэлъыкӀэ	system
систем	system
Ӏэнэ	table
ебэнын	tackle
тхыжей	tag
КӀэ	tail
щтэ	take
хьын	take away
зэдэшэн	take away
Ӏэтын	take away
зыхуэсакъыжь	take care
тэджыкӀэ	take off
Ӏыха	taken
псалъэ	talk
псэлъэрей	talkative
кӀыхь	tall
лъагэ	tall
псынэӀункӀыбзэ	tap
бант	tape
нэшанэпӀэ	target
гугъэкӀэ	target
къалэн	task
ӀэфӀыгъэ	taste
ӀэфӀыдыдэ	tasty
егупсыса	taught
шей	tea
егъэсэн	teach
егъэщӀэн	teach
егъэджакӀуэ	teacher
гуп	team
фэилъхьэгъуэ	team
Ӏэмэпсымэхэр	team
нэпс	tear
нэпсыхэ	tears
къэгъэгубжьын	tease
текнологие	technology
щӀэныпхъэ	technology
дзэхэр	teeth
Дзэ	teeth
егъэцӀыху	tell
егъащӀэ	tell
жыӀэ	tell
сэ къызжеӀэ	tell me
щэнхабзэ	temper
хэлъхабзэ	temper
хуэбагъэ	temperature
лыгъей	temperature
тхьэлъэӀупӀэ	temple
куэд имыкӀун	temporary
пӀалъэпухыкӀа	temporary
пщӀы	ten
минипщӀ	ten thousand
бэджэндакӀуэ	tenant
хуеин	tend
игухуэхуэбэн	tend
фӀэфӀын	tend
хуеин	tendency
игухуэхуэбэн	tendency
фӀэфӀын	tendency
зэтех	tender
зэпеуэ	tender
щэщӀа	tense
къэтэмакъкӀэщӀа	tense
гумэщӀуз	tension
уэтэр	tent
пщыӀэ	tent
куэд имыкӀун	tentative
пӀалъэпухыкӀа	tentative
лъэхъэнэ	term
щӀапхъэхэр	terms
шынагъуэ	terrible
щӀагъуэдыдэ	terrific
Ӏэгъуэблагъуэ	territory
тест	test
гъэунэхун	test
тхыгъэ	text
елъыта	than
упсэу	thank
упсэу	thank you
Дэ кэвгъахьар дыуплъэкӀу пэтырэ зыдэфшыӀам щхьэкӀэ фыпсэу	Thank you for your patience while we investigate shipment
упсэушхуэ	thank you so much
упсэушхуэ	thank you very much
куэдуупсэу	thank you very much
упсэу	thanks
ди програмыр фыгъэсэкӀагъэм щхьэкӀэ фыпсэу	Thanks for using our app
мыр	that
мыст	that is
мырфӀы	that's good
мы	the
дыгъуакӀуэн	theft
яй	their
яй	them
гупсысэку	theme
езырхэ	themselves
итӀанэ	then
теория	theory
мобдеж	there
мобым	there
щыӀэ	there are
абдежым	there is
щыӀэ	there is
мыбы щхьэкӀэ	therefore
мыхэр	these
ахэр	they
ахэр	they are
Ӏув	thick
гъум	thick
Ӏэбэлъабэ	thief
къэдыгъун	thief
шхужь	thigh
пӀащӀэ	thin
псыгъуэ	thin
мыст	thing
мыстхэ	things
гупсысэн	think
ящэнэрей	third
псыхуэлӀа	thirsty
пщӀыкӀущ	thirteen
щэщӀ	thirty
мыр	this
мыр	this is
псори	thorough
куу	thorough
фӀыкӀай	thoroughly
мыхэр	those
сытми	though
гупсысэ	thought
гупсысафӀэ	thoughtful
гупсысэфӀ	thoughtful
гупсысэрей	thoughtful
гупсысэхэ	thoughts
мин	thousand
Ӏуданэ	thread
гъэшынэ	threat
гъэшынэн	threaten
щы	three
жэхафэ	threshold
щӀэдзапӀэ	threshold
жыхафэ	threshold
гузэва	thrilled
узгъэгузавэ	thrilled
хэхъуэныгъэ	thrive
тэмакъ	throat
пщэдыкъ	throat
иӀэпэӀэгъукӀэ	through
рену	throughout
Дзы	throw
Ӏэпхъуамбэшхуэ	thumb
щыблэгъуэгъуэн	thunder
Махуэку	Thursday
мыпхуэдэурэ	thus
бамыш	tick
игъакӀуэ	tide
хы къиж	tide
зыхуэгъэзар	tide
зэтегъэпсыхьыгъэ	tidy
хабзэхэлъу	tidy
зэпыщӀа	tie
пхэн	tie
зэгуэпхэн	tie
къэплэн	tiger
быдэу	tight
Тджринябзэ	Tigrinya
зэман	time
укӀытапхъ	timid
цӀыкӀунитӀэ	tiny
узлъыхъуэлъагъуэ	tip
узлъыхъуэлагъуэхэ	tips
хьэфэ	tire
еша	tired
зэрхъэгъ	tissue
щхьэрыхъуэн	title
м	to
папщӀэ	to
щхьэкӀэ	to
хъун	to be
мэхъу шыӀэн	to be
тост	toast
махуэрмахуэщӀын	today
лъэтеувэ	toddler
лъэпхъуамбэ	toes
зэгъусу	together
зэдэщӀыгъуу	together
псыунэ	toilet
жыӀа	told
тэмакъкӀыхь	tolerance
шэчыгъуей	tolerate
шэргъуб	tomato
пщэдей	tomorrow
бзэгу	tongue
бзэ	tongue
мы жэщым	tonight
куэд	too
бэ	too
къыщта	took
къыщэхуа	took
Ӏэмэпсымэ	tool
Ӏэмэпсымэхэр	tools
бжьыныхудзэ	tooth
пхъэхыдзэ	tooth
дзэ	tooth
Ищхьэрэ	top
ищӀыӀу	top
гущӀыӀу	top
гугъу	topic
зэӀытхъын	torn
чэтхъэн	torn
зэпытхъын	torn
лей ехын	torture
Зэхуэхьэса	total
Ӏэдэлъэн	touch
еӀусэн	touch
гугъу	tough
къежэкӀыгъуэ	tour
хуэзанщӀэ	toward
бгъумкӀэ	towards
лъэныкъуэмкӀэ	towards
напэӀэлъэщӀ	towel
къалэцӀыкӀу	town
щхъуэ зыхэлъ	toxic
лъэужь	trace
лъагъуэ	trace
бзыхьэхуэ	track
тыкъыр	track
цӀыкӀу	track
щэн-щэхун	trade
хабзэ	tradition
зэрыхабзэу	traditional
хабзэрей	traditional
маршынэгъуэгу	traffic
лъэужь	trail
лъагъуэ	trail
мафӀэгу	train
гъэсэн	training
щэн	trait
хуэгъэзагъэхьэр	traits
Ӏушын	transfer
гъахьын	transfer
блэкӀыпӀэ	transition
зэдзэкӀ	translate
узыкӀуэцырыплъ	transparent
зэшэ	transport
нэс	transportation
лъэщӀыхьэ	transportation
теуэ	trap
къапхъэн	trap
пхъэнкӀий	trash
чымпэ	trash
пхъэнкӀахуэ	trash
уӀэгъэ	trauma
къэкӀухьын	travel
щӀэт	tray
хэгъэгубанк	treasure
кӀэзонэ	treasure
дыщэгъэтӀылъа	treasure
зэпэща	treat
уежьэн	treat
еӀэзэ	treatment
еӀэзэн	treatment
жыг	tree
инышхуэ	tremendous
тренд	trend
rъэнэхун	trial
вагъэсеплъ	trial
гъэпцӀэн	trick
хэгъэзэрыхьын	trick
къэгъэнэхуа	tried
кӀакхъу	trigger
Зыгъэпс	trigger
унэлъэгу	trim
унэхьэпшып	trim
шэнтщабэ	trim
гъуэгурыкӀуэн	trip
Ӏуэхулъэхъа	trouble
гъуэншэджхэ	trousers
хьэлъэзещэ	truck
тэрэз	true
бгъэ	trunk
дзыхь	trust
дзыхь зиӀэ	trust
пэж	truth
щыпкъэ	truth
пэжыпӀэр	truth
уплъэкӀу	try
Цонгабзэ	Tsonga
туб	tube
гъубжь	Tuesday
еджэн	tuition
щӀэныгъэ	tuition
тыркуй	turkey
гуэгуш	turkey
зэрдэчал	turmeric
къэгъаз	turn
Зыгъазэ	turn
шылъэгу	turtle
егъэджакӀо	tutor
пщӀыкӀутӀ	twelve
тӀощӀ	twenty
тӀощ	twenty-one
Туибзэ	Twi
тӀуэ	twice
гъэӀуэнтӀа	twist
тӀу	two
лӀэужьыгъуэ	type
щӀыкӀэпэж	typical
Ӏей	ugly
быӀуэбышэ	ugly
къемыкӀу	ugly
кӀэкъинэ	ultimate
иужьрей	ultimate
жьауэ	umbrella
мыщӀыж	unable
анэш	uncle
адэш	uncle
гупсысэншэу	unconscious
ищӀагъым	under
икӀахэ	under
ишӀэгъ	underneath
зэфӀэмгъэшӀын	underrated
гурыӀуэн	understand
гурыӀуэгъуэщ	understood
хузфӀэмыкӀа	unfortunately
къысхъуэгъэгъу	unfortunately
щыгъын зэхуэдэх	uniform
зызакъуэ	unique
щапхъэ	unit
университет	university
еджапӀэ нэхъыщхьэ	university
ямыщӀэр	unknown
мыхъукъэс	unless
нэсыхуэ	until
гъэщӀэгъуэн	unusual
щхъэ	up
уэ къыпхуэнащ	up to you
нобэрейгуэу	update
щӀэрыщӀэу	update
гъэлъэгъэн	upgrade
теухуа	upon
телъхьа	upon
щӀыӀу	upon
гумащӀэ	upset
къалэщыӀакӀ	urban
гузэвэгъуэ	urge
гузэвэгъуэ	urgent
дыдей	us
зехьэн	use
зэрахьа	used
зехьэныфӀы	useful
гъэӀуэрыщӀэфӀы	useful
гупсэхукъым	useless
къохъу	usual
бэкӀэ	usually
нэхъыбэкӀэ	usually
ӀэпыӀэгъу	utility
зыгъэпсэхугъуэ	vacation
хэсыхьын	vaccination
хэсыхь	vaccine
жьыншэ	vacuum
мыгъэнэхуа	vague
пхокӀыр	valid
блэкӀыр	valid
къуэ	valley
жьанэ	valley
къуэкӀий	valley
ЛъапӀэ	valuable
хуэфащэ	value
цӀыхугъэ зыхэлъ	value
уасэ	value
лӀэужьыбэныр	variety
лӀэужьыбэ	various
щхьэху	vary
гъэгъалъэ	vase
гъунапӀэншэ	vast
хыку	vast
нэзыншэ	vast
хадэхэкӀ	vegetable
хадэхэкӀыхэ	vegetables
Ӏэмэпсымэ	vehicle
щакӀуэ	vendor
щхъухь	venom
зэгъэпэщын	venture
щӀыпӀэ	venue
хэщӀапӀэ	venue
гъэпэжын	verify
зэтегъэпсыхьыгъэ	versatile
версия	version
задэу	vertical
куэд	very
фӀэкхъу	very
бэ	very
фӀыдыдэщ	very good
дэгъудыдэщ	very good
кхъухь	vessel
лъынтхуэ	vessel
мкӀэ	via
кӀэ	via
кӀэзыз	vibe
гулъытэ	vibes
къышыхъу	vibes
бгъэ	vicious
ныш	victim
видео	video
теплъэкӀэ	view
къуажэ	village
лӀы бзаджэ	villain
фӀэӀупс	vinegar
санэлъэ къутэжьыгъуэ	vintage
хъыжьэ	violence
хъыжьэ	violent
уз зэпыхын	viral
хъыджэбзыщӀэ	virgin
гупсысэ	virtual
мыпэжу	virtual
хабзэфӀ	virtue
зэрыплъэгъуф	vision
хьэщӀагъэкӀуэн	visit
нэрылъэгъуэу	visual
елъыта	vital
гъащӀэмтеухуа	vital
псэ зыхэт	vivid
гуащӀэ	vivid
псэу	vivid
псалъэ псори	vocabulary
псалъэ зехьпсори	vocabulary
макъ	voice
мыпхокӀыр	void
мыблэкӀыр	void
мыкӀуэр	void
инагъ	volume
фӀэфӀу	volunteer
игуапэу	volunteer
игумкъыдэжу	volunteer
къэжын	vomit
гумахэ	vulnerable
гущабэ	vulnerable
лэжьапщӀэ	wage
лэжьапщӀэхэ	wages
бгы	waist
поплъэ	wait
бгъуэщӀэс	waiter
щхьэгъэрыт	waiter
поплъэ	waiting
къэушын	wake
къэуш	wake up
зекӀуэн	walk
лъэсэ	walk
шыкӀуэн	walking
блын	wall
ӀэпэщӀэгъэжылъэ	wallet
чысэ	wallet
нэгу зегъэужьын	wander
къэкӀухьын	wander
гъуэгургъэкӀыхьын	wander
сыхуейщ	wanna
хуеин	want
лъэӀуэн	want
хуэныкъуэн	want
ялъэхъу	wanted
зауэ	war
щыгъынылъ	wardrobe
щыгъынпхъуантэ	wardrobe
гуэнэщын	warehouse
хуабэ	warm
лыгъей	warm
гъэсакъын	warn
гъэмыбэлэрыгъын	warn
мыбэлэрыгъ	warning
зэуакӀуэ	warrior
апхуэда	was
жьыщӀэ	wash
тхьэщӀ	wash
лъэс	wash
пхъэнкӀий	waste
къела	waste
йоплъ	watch
псы	water
нащэ	watermelon
бырыб	wave
къэукъубий	wave
ауан	wave
гъуэгу	way
дэ	we
дэры	we are
дэ	we are
дыгъэкӀыощӀын	we can
уэд	weak
фагъуэ	weak
къуэгъу	weak
фэгъуагъэ	weakness
беиныгъэ	wealth
хуэщӀэныгъэ	wealth
хуэщӀа	wealthy
щытӀэгъэн	wear
феилъхьэн	wear
Зехуапэ	wearing
уафэ	weather
уэм изытет	weather
хьэгъуэлӀыгъуэ	wedding
Бэрэжьей	Wednesday
удз	weed
тхьэмахуэ	week
тхьэмахуэкӀэ	weekend
хьылъагъэ	weight
гъэщӀэгъуэн	weird
фӀэхъус апщий	welcome
псэуныгъэфӀ	welfare
фӀы	Well
дахэ	Well
пэж	Well
Ӏхуэху щӀагъуа	well done
кӀуэжащ	went
щыӀа	were
къухьэпӀэ	west
псыф	wet
джэн	whale
сыт	what
уэры адэ	what about you
сытпщӀэр	what are you doing
иджыпсту сыт пщӀэр	what are you doing now
иджипсту сыт пщӀэр	what are you doing right now
сыт пщӀэр	what do you do
уипсэуныгъэр дауэ къыбогъахъэрэ	what do you do for a living
жыпӀэну узхуеир сыт	what do you mean
узхуеир сыт	what do you want
сыткъэхъуар	what happened
сытщ	what is
мырсыт?	what is this
сыт уи Ӏуэхур	what is your job
уицӀэр сыт	what is your name
сытхъыбархэ	what's up
ye уицӀэр сыт	what's your name
сытхъуами	whatever
гуэдз	wheat
дамбырэ	wheel
щэрхъ	wheel
сытщыгъуэ	when
сытщыгъуэ	whenever
дэнэ	where
дэнэ ушыӀэ	where are you
дэнэ ушыщ?	where are you from
иджыпсту дэнэ ущыӀэ	where are you now
дэгэушыпсэурэ	where do you live
дэнэ	where is
ауэ	whereas
хъуар мыхъуар	whether
дэтхэнэр	which
пэтырэ	while
жаж	whisper
кӀэфий	whistle
хужь	white
хэт	who
ухэтуэ	who are you
хэт	who is
хэт мыр	who is this
псори	whole
хэт	whom
Хэтей	whose
сытпапщӀэ	why
сыт щхьэкӀэ мыхъунщ	why not
Ӏей	wicked
дей	wicked
куэд зэрыхуэ	wide
быхъу	wide
ин	wide
лӀыгъуабэ	widow
фызабэ	widow
быхъугъэ	width
фыз	wife
щхьэгъусэ	wife
емылыдж	wild
хъуну	will
хуэныкъуэ	willing
хуейр	willing
хэгъэхъуэн	win
жьы	wind
жьыбгъэ	wind
щхьэгубжэ	window
жьыбгъэлэ	windy
шагъыр	wine
щӀымахуэ	winter
лъэщӀын	wipe
налъэ	wire
телеграмэ	wire
гъущкӀапсэ	wire
щӀэрей	wisdom
Ӏушыщ	wise
сытягъэкӀынт	wish
сытхъунт	wish
фигу хуэдэ хъуну жизоӀэщ псори	wish you all the best
уд	witch
алмэсты	witch
зэдэ	with
зэдэщӀын	with
зэкӀэкӀуэн	withdraw
къызэщӀэкӀуэжын	withdrawal
икӀуэцӀ	within
илъ	within
ис	within
арыншу	without
дыхэмыту	without
шэсыпӀэ	witness
сэмэркъэуакъуэ	witty
дыгъужь	wolf
фызхэр	woman
бзылъхугъэхэр	woman
бзылъхъугъэ	women
цӀыхубз	women
текӀуа	won
хъункъым	won't
гуныкъуэн	wonder
гъэщӀэгъуэн	wonderful
пхъэбгъу	wood
цы	wool
псалъэ	word
псалъэхэ	words
къалэн	work
Ӏуэху	work
ӀэщӀагъэ	work
лэжьэн	work out
мэлажьэ	working
дуней	world
псори	world
щӀыб	world
хьэмбылу	worm
маркӀуэ	worm
тӀорысэхъуа	worn
гузэвэгъу	worried
гузэвэгъуэ	worry
пӀейтей	worry
нэхъ Ӏей	worse
динщӀыхуэпшынын	worship
тхьэлъэӀу	worship
нэхъ Ӏеир	worst
хуэфащэ	worth
цӀыхугъэ зыхэлъ	worth
уасэ	worth
мыбы екӀунщ	worth it
лъапэ	worthy
хъунт	would
уӀэгъэ	wound
Уау	Wow
шыхьа	wrap
губжь	wrath
Ӏэдий	wrist
тхэн	write
мыбдэжутхы	Write here
губгъуэ	writing
уэх	writing
тхы	writing
тхауэ	written
пхэнжыгъэ	wrong
щыуэ	wrong
итхащ	wrote
пщӀантӀэ	yard
фышхьан	yawn
НтӀэ	Yeah
гъэ	year
илъэс	year
йылъэсхьэр	years
лъэтэрыпс	yeast
гузэвэгъу	yeast
гушхуэ	yeast
гъуэгъ	yell
гъуэжь	yellow
НтӀэ	Yes
аращ наныу	yes baby
нтӀэ сипсэ	yes dear
нтӀэ сифо	yes honey
ртӀэ сифӀылагъу	yes my love
нтӀэ	yes of course
адэ	yes of course
дыгъуасэ	yesterday
иджы	yet
иджыпсту	yet
тӀэкӀу ипэ	yet
бэвыгъэ	yield
къытекӀэр	yield
уэ	you
уэ	you are
куэду удахэщ	you are beautiful
уэ куэду удахэщ	you are so beautiful
кхъыӀэ	you are welcome
пщӀыфынщ	you can
БощӀэ	You know
УэщӀэ	You know
уэри	you too
хэлъкъым	you're welcome
кхъыӀэ	you're welcome
ЕлъэӀун	you're welcome
щӀалэ	young
кӀащӀэ	young
ныбжьыщӀэ	young
уи	your
уэхъусыж	your welcome
фэхъусу	your welcome
фӀэхъусыж	your welcome
езыр	yourself
щӀалэгъуалэр	youth
щӀалэхэр	youth
щӀалагъэ	youth
щӀэлъэӀун	you’re welcome
ӀэфӀыдыдэ	yummy
зыри	zero
