kiñe	a
pichin	a little
kiñe wirkon	a lot
fentrenke	a lot of
tranakünun	abandon
elkunulelu	abandoned
püwül	abide
admümuwlu	ability
pepiluwün	able
feipingepel meu	about
wenu	above
wekun	abroad
mülenuel	absence
mülenulu	absent
rüf felefel	absolutely
ülutun	absorb
miyaupüdakelu	abstract
ngünkawun	absurd
pangu	abundance
fentren	abundant
awükan	abuse
acento	accent
llongeal	accept
konpeyel	access
katrütrekan	accident
umañün	accommodation
wechulel	accomplish
püwülün	accomplished
felerkeai mai	according
kullingekechi dungu	account
rüfenten	accuracy
rüf trürümel	accurate
dalluntukuel	accused
kutrantun	ache
topan	achieve
wewel	achievement
kimtun	acknowledge
kimelche	acquaintance
nün	acquire
yentukun	acquired
ngillangepel	acquisition
mew	across
femkünun	act
femün	action
külfünche	active
fillkeküzau	activities
deumangeal	activity
inaytundungukelu	actor
fantepu	actual
rüftun mew	actually
pichirumel	acute
wimtuwün	adapt
tukun	add
wimtulen	addicted
amulrakitun	addition
püñamtukun	additional
cheu ni puafel	address
kemeduamkelu	adequate
doy püllelelu	adjacent
chumngechingen	adjective
norümkünungeal	adjust
sakiñfal	admire
tangkün	admit
trokifiel	adopt
poyefal	adorable
wünelel	advance
amulniel	advanced
wunelelu	advantage
miyaukepel	adventure
adverbio	adverb
feipilen	advertisement
kimeldungun	advertising
ngülam	advice
ngülam	advise
inkachekelu	advocate
ayfiñtun	aesthetic
dungu	affair
felemkülewetual	affect
trükawün	affection
eldungulün	afford
fülngefal	affordable
llikantulen	afraid
fey wüla	after
nag antü	afternoon
fei wula	afterwards
ka kiñe chi	again
ngawin	against
tripantu	age
wülngekemum dungu	agency
kellupelu	agent
kewatufe	aggressive
yewmen	agile
furitu	ago
llonngepel	agree
kiñeldungu	agreement
nganküzau	agriculture
wünel	ahead
kellun	aid
zitun zungu	aim
kuruf	air
akukemüm müpükechimiyaupeyüm	airport
pichirumerüpü	aisle
lelpemütrümwe	alarm
pulku	alcohol
nepeduam	alert
mongelen	alive
kom engün	all
küme felei	all right
tañi zoy kümekezuam	all the best
pepi femal	allow
eluñmai	allowed
epe	almost
kizu	alone
alülechi mapu	along
feyürke	already
kümelkaley	Alright
ka fey	also
kakeume	alternative
fei	although
rumel	always
mülen	am
afmatufal	amazing
kimfalai	ambiguous
küngewün	ambition
nokelkaukelu	ambitious
nülkükünutun	amend
kompange	amid
engu	among
iñchiñ engun	among us
tunten ngen	amount
ashngelluwkülei	amusing
kiñe	an
inakintun	analysis
kuifikecheyem	ancestors
kültrünpüramün	anchor
kuifi	ancient
ka	and
ka eimi	and you
anchimallen	angel
illkun	anger
kiñeñpüle	angle
illkun	angry
kulliñ	animal
pallipalli	ankle
puwül antulen	anniversary
feipilendungu	announcement
illkün	annoy
illkUn	annoyed
ningayülünfe	annoying
fillke tripantun	annual
kimngenulu	anonymous
kangelu	another
lloudungun	answer
wünekünun	anticipate
fiñmawün	anxiety
fiñmawünkechi	anxious
tuchi rume	any
doy	anymore
tuchi rume	anyone
chem dungu rume	anything
kom felerpuafel	anyway
ka feleafel	anyways
püntü	apart
pichi ruka	apartment
dünguñpeñmawün	apologize
femngei reke	apparent
trokifiñ	apparently
fürenedüngun	appeal
weftui	appear
adngentun	appearance
wefpai	appeared
ngüñün	appetite
manshana	apple
ngillatun	application
tukungeael	apply
elantün	appointment
falin	appreciate
chem pilen	appreciation
chumamuleal	approach
kümedeungei	appropriate
felerpualu	approval
feleai	approve
felepe mai	approved
püllelepachi	approximately
afril küyen	april
nokelkawün	arbitrary
rukafe	architect
azümrukakepeyüm	architecture
elkünupeyüm wirin dungu	archive
ngeyngün	are
ngei mi	are you
püne lei	are you busy
kurengeymi	are you married
kuregeimi kam kurregelaimi	are you married or single
petu mülei feitimu	Are you still there?
müleimi feitimu	are you there
kiñe troy wellin	area
rekülduampel	argue
adümkünungepel	argument
wefpal	arise
lipang	arm
pu soltau	army
wallontu	around
küme elün	arrange
kiñeudungun	arrangement
akun	arrival
akun	arrive
akui	arrived
mallmachekawün	arrogant
waiki	arrow
adelün küzau	art
chemkün	article
rakash	artificial
ayiwulchekelu	artist
reke	as
felekellel	as long as
ka fei	as well
femngechi fel	as well as
trufken	ash
yewelei	ashamed
ramtun	ask
ramtui	asked
umautulei	asleep
külme	aspect
Assamese dungun	Assamese
wüleluwün	assault
trawün	assembly
küllün	assertive
ngünezuamülün	assess
inarumeküdaw	assessment
külfün	asset
yafüduamngey	assets
elelkünungel	assign
elungel	assignment
amuel	assist
kelluntukukelu	assistant
trafkon	associate
trafkon	associated
trokiñkeche	association
ñüminentuduamün	assume
trokifal	assumption
mew	at
fei rume	at least
ipey	ate
lefkelu	athlete
elfaltukun	attach
elfaltukun	attached
elfaltukun	attachment
malon	attack
azumazumtuafin	attempt
leliniengepel	attend
akunkechi	attendance
ngüneduam	attention
chumngen	attitude
küpayam	attract
ayifal	attraction
ayüfal	attractive
adngentun	attribute
allkütupeluengün	audience
agosto küyen	august
palu	aunt
palu	aunty
rüfngel	authentic
rüf deumalu	author
ngüneukülelu	authority
rimu	autumn
mulei	available
rangiñ entupel	average
kiñepülekünuwün	avoid
nepelen	awake
weufiel	award
kimkülelu	aware
ngünezuamün	awareness
alü mapu	away
afmatufali	awesome
trupefünfal	awful
kangentufal	awkward
Aymara dungun	Aymara
llushu	baby
wunechilkatuel	bachelor
inangechi	back
ponwitu	background
weza	bad
karpa	bag
yiwiñ	bait
horno meu afümel	bake
deumakofkepeyüm	bakery
fikarfonatu	baking soda
müyüdün	balance
pillma	ball
Bambara dungun	Bambara
banana	banana
trokiñülkantukel	band
tralof	bang
wanku	bank
pütukepeyüm	bar
epeke	barely
manelün	bargain
wankün	bark
kawella	barley
malal	barrier
anüntukuam	base
anümkünuel	based
rumül ruka	basement
wünetu	basic
basicamente	basically
tukukan	basil
wezakünuwün	bastard
trokiñtun	batch
müñetun	bath
tripatripatuwe	bathroom
bateria	battery
weichan	battle
yumen lafken	bay
femngen	be
kuñiutukunge	be careful
inaltu lafken	beach
deumange	beam
küllwi	beans
nünien	bear
payun	beard
metrül	bearing
newenman kulliñ	beast
wewün	beat
azngey	beautiful
ayifal	beauty
kümechekünuwün	became
fey mew	because
deyikoni	become
kawitu	bed
umautupeyüm	bedroom
diumeñ	bee
ilo waka	beef
chumlepel	been
kawellako	beer
kuyfi	before
llitui	began
llitun	begin
llitun	beginning
kelluntukungepel	behalf
chumyauken	behave
femken	behavior
chumyauken	behaviour
furitu	behind
ngeal	being
feyentun	belief
feyentun	believe
pütra	belly
tuwün	belong
poyefal	beloved
minchemu	below
trariwe	belt
wanku	bench
müchamün	bend
minche	beneath
kelluntukuwün	benefit
kelluntun	benefits
fei ñi inafül	beside
ka femngechi	besides
doy kümelu	best
kom kümeke suerte	best of luck
chalin	best regards
zoy küme	better
kompañe	between
pütokoyepel	beverage
doy üyew	beyond
Bhojpuri dungun	Bhojpuri
llumümel	bias
traumalewel	biased
cicleta	bicycle
manaldungu	bid
füta	big
cicleta	bike
ngillakanmeu wirin	bill
trapümün	bind
üñüm	bird
puwül tripantu	birthday
püchin	bit
ünatun	bite
füre	bitter
kurü	black
kuchillu	blade
molka	blame
lig	blank
pontro	blanket
troflu	blast
trufken	bleach
reyülün	blend
kümeduamalfiñ	bless
poyen ngechi	blessed
trauma	blind
ayiwunduam	bliss
katrütun	block
mollfüñ	blood
rayün	bloom
pawküm	blow
kallfü	blue
duamchekelai	blunt
trapüm	board
wampo	boat
kalül	body
wadkün	boil
yamchekenulu	bold
trarütrapümpeyüm	bond
foro	bone
lifru	book
pelükünun	boost
kellunewentuael	booster
fütake zumel	boot
fütapürake zumel	boots
üpel	border
afeluwün	bore
afzuamkülen	bored
afeluwün	boring
choyülu	born
arentun	borrow
ñidolkülelu	boss
mür	both
iñfitun	bother
fotella	bottle
nageltu	bottom
ngillay	bought
wiñoütrüftripatun	bounce
nüwkülelu	bound
puwkülel	boundaries
kompemüm	bow
rali	bowl
ngüdeftukupeyüm	box
pichi	boy
kulngen	boyfriend
yuwülkuwü	bracelet
müllo	brain
ka kiñe trokiñ	branch
üitun	brand
newengechiche	brave
puwulngenulu	breach
kofke	bread
wükürün	break
puliwen yafütun	breakfast
ñuke	breast
neyün	breath
neyen	breathe
tremumal	breed
kura ruka yael	brick
gapiñ	bride
kuikui	bridge
püchiñma	brief
wilüf	bright
wilüf	brilliant
küpalel	bring
peñi	bro
alüpue	broad
rulpadunguam	broadcast
wüküri	broke
wechod	broken
lepüwe	broom
peñi	brother
ngillan	brother in law
küpali	brought
kurükelü	brown
lipüm	brush
falti	bucket
afkadi	buddy
tunten kulliael nipel	budget
wedafemün	bug
dewumün	build
alhüpürachi ruka	building
deumngen	built
kütrüng	bulk
toro	bull
awükachekelu	bully
allwiñ	bump
düngko	bunch
kütrüng	bundle
fenentun	burden
rüngalkülei	buried
lüpüm	burn
trofün	burst
rüngalün	bury
winka kareta	bus
anümka	bush
ngillakandungu	business
moyo	bust
pünelelu	busy
welu	but
yiwiñ	butter
llampüzken	butterfly
foton	button
ngillakan	buy
püle	by
rupan	by the way
peukallal	bye
kolez	cabbage
ñidolkülelu dungu meu	cabinet
pichimalal	cage
kochi kofke	cake
pichi toro	calf
mütrüm	call
mütrümen	call me
doy weda	called
ñaufü	calm
pulku	came
trapümduamün	campaign
newen	can
pepil lafiñ	can't
kulliel	Cancel
kancer kutran	cancer
kimlu	capable
tunten ñi feykonken	capacity
kullin	capital
wentewirilel	caption
nüpeyel	capture
winka kareta	car
notulefün	career
kuñiutukufal	careful
ngüneduamkechi	carefully
kuñiutuwkenulu	careless
poyenchengei	caring
mamüllküdau	carpenter
pünokepel pontro	carpet
zanahoria	carrot
yen	carry
amulningeael	carry on
deumayel	carry out
dungu	case
kullin	cash
mufü che	cast
füta ülmen ruka	castle
kiñeke meu	casual
narki	cat
nüngelu	catch
küpalme	category
wewel	cattle
nütuel	caught
wepümuyieteu	cause
kuñiufal	caution
müte peufaluwkenulu	cautious
lolol	cave
fente künun	cease
wenu ruka	ceiling
ayiumandugu	celebrate
celúla	cell
rangiñ meu	center
kuifitu	century
fillke ketran	cereal
ceremonia	ceremony
feipikünuel	certain
rüfkünuel	certainly
pengelwirin	certificate
yuwülpeyüm	chain
wanku	chair
küpalechi duam	challenge
mangeluwpeyüm	chance
kakünun	change
reifütun	chaos
adentukakelu	character
fill adentu	characteristics
chechümün	charge
kelluntukun	charity
ngoymaduamelün	charming
meli nor ad	chart
inatun	chase
nütramkan	chat
müte falinun	cheap
ngünenkan	cheat
ngünenchekelu	cheating
ngüneniefal	check
ange	cheek
ayifal	cheer
ayüduamün	cheerful
tremolen	cheers
kesu	cheese
quimica	chemistry
azkintufali	cherish
ajedrez	chess
ruku	chest
ngawngawün	chew
achawall	chicken
lonko	chief
kempu	child
pichifal	childhood
pichi wentru	children
chiz	chill
kütraltupeyüm	chimneys
ketre	chin
kochi iyael	chocolate
zullitun	choice
zullingeal	choose
üpirün	chop
zuam	chores
rume motrin	chubby
iglesia	church
canela	cinnamon
chinküll	circle
rupal chi dungu	circumstances
zullintukelu	citizen
waria	city
mütrümuwün	claim
kümeadkünun	clarify
kimelken	class
rag	clay
lif	clean
lingar	clear
oficinista	clerk
kimünche	clever
ngillakelu	client
lilmapu	cliff
chumleken antü	climate
ekopüran	climb
pünagkelu	clingy
rakiantüpeyüm	clock
nürrüf	close
elngekepel takun	closet
pañu	cloth
takuluwün	clothes
tromü	cloud
tromülei	cloudy
ayelchekelu	clown
ellkadungu	clue
ñoi	clumsy
trokiñ che	cluster
kimeladümkelu	coach
kuyül	coal
lafken mapu	coast
takutupeyüm	coat
kolü	coffee
kimfe	cognitive
kiñentrür	coincidence
wutre	cold
apoluwi	collapse
pel	collar
trürümel kudawün meu	colleague
kiñel küdawün	colleagues
trapümün	collect
trapümduampen	collection
trürümel kudawün meu	college
adentu	color
chi karüke rakiduam illkunkechi umautuleingün	colorless green ideas slept furiously
adentu	colour
kudi foro	column
peyne	comb
reyülün	combination
reyulün	combine
küpal	come
küpange fau	come here
amuyiñ	come on
kümelepel	comfort
kümeduam	comfortable
ka küpalelu	coming
pürüm müten	coming soon
ngünel	command
dunguyel	comment
yallündungu	commercial
trokiñkeche	commission
wültükun ni dungu	commit
trarindugu	commitment
nüwkülechi duam meu	committed
deumankechi ngillafal	commodity
pekellel	common
amulfeipin	communicate
trafkonün dungun meu	communication
lof	community
negünüwün	commute
kompañtun	companion
afkadi	company
ngillakan	compare
trürümün	comparison
kuñülün	compassion
duamchekei	compassionate
trürfaluwal	compatible
kuden	compete
azümwkelu	competent
notukawün	competition
notukawküleingu	competitive
rungafütun	complain
weshanagün	complaint
kelluntukun	complement
puwülkülei	complete
komfelen	completely
ngellukechi	complex
wechuldungun	compliance
küzaufali	complicated
rüfkunulel	compliment
wechulün	comply
deumayel	composition
trapümel	compound
kimtukuniengel	comprehension
kompuwulkel	comprehensive
wültükundungu	compromise
ngeñintukun	compulsory
computadora	computer
rakiduamngeael	concentrate
nemel	concept
tügduamnun	concern
pellkelen	concerned
ayelkaülkantun	concert
wechulngechi duam	conclusion
müngel	concrete
felerken	condition
chumkünungeal	conditions
chumken	conduct
nütramkawün	conference
feipintukun	confess
maneluwün	confidence
rüf femün	confident
füngkulün	confirm
yafkandungu	conflict
weluñmalen	confused
keñawün	confusion
ayiwül	congrats
ayiwünngeaimi	congratulation
pentukuwün	congratulations
trawümel	conjunction
nülkükunuael	connect
dakeluwün	conquer
kimkülelu	conscious
kimtukuniel	consciousness
main ñi felerpuagel.	consent
chumlewetun dungu	consequences
nütramkawün	conservation
llaytucheken	conservative
trokitungel	consider
duamtueneu	considered
alüñmaley	consist
chumngechi deuken	consistency
norduamel	consistent
femekekel	constant
müchaikentu	constantly
ngütrafün	constipation
deumalel	construction
kom ingepel	consume
apümün	consumption
trafyewingu	contact
tupekei kake che	contagious
ngüneniepel	contain
yentukuniei	contains
fantepu	contemporary
illamün	contempt
mülepel	content
trawumchen	contest
wallmülekel	context
kiñe troy wallmapun	continent
amulepe	continue
ngilladuamwirin	contract
traftun	contrast
kelluntukun	contribute
kelluntukun	contribution
ngünewun	control
notukawün	controversial
mishawün	convenience
mülei taiñ	convenient
nütram	conversation
kakünual	convert
rulpadungun	convey
rulpazuamün	convince
yafüduamelün	convinced
deumaiyalün	cook
deumaiyalün	cooking
fiskü	cool
kelluwün	cooperation
notukawün	cope
kelüpañillwe	copper
matra	core
uwa	corn
ngañün	corner
rüfkünün	correct
tunten falin	cost
takun	costume
pichi lef rupan ruka	cottage
pañuz kal	cotton
anüpeyüm	couch
chafo	cough
femafun	could
ngülam	council
rakin	count
pengelpeyüm	counter
mapu	country
lelfün	countryside
trürwen	couple
konnewenün	courage
troy chilkatun	course
katrüntukun	court
tremümpel	courtesy
münawen	cousin
takukünün	cover
waka	cow
llükanchengel	coward
tragünfalfe	cozy
llashka	crab
triü	crack
fillke küzawün	craft
pekankadungu	crap
tronkün	crash
küpa	craving
winol	crawl
weluzuamche	crazy
deumayal	create
deumafe	creative
arentu kullin pekel	credit
winolkawün	creep
yañün ngen	creepy
fentrenche	crew
werineluwün	crime
yewelkawün	cringe
kuñiutukufalün	crisis
tañi feipin	criteria
dunguntukukelu	critical
chaftuwün	criticism
nganün	crop
nganün	crops
rumen	cross
kuru üñum	crow
yillümün	crowd
apolelu	crowded
trarilonko	crown
wechulkan	crucial
rume wezañma	cruel
nopeyüm	cruise
ngülümün	crush
ngüman	cry
pepino tukukan	cucumber
trununkünuwün	cuddle
az mongen	culture
ñiwa	cunning
taza	cup
elngekepeyüm takun	cupboard
fentekünun	curb
kümelaktun	cure
mülenagal	curfew
ramtudungufengel	curiosity
fiñma	curious
trintrilei	curly
kullin	currency
fantepu	current
fantenmu	currently
iñfitunduam	curse
reumelkünun	curtain
metrül	cushion
ka azkunuwün	custom
ngillakelu	customer
günezuamngekel che	customs
katrün	cut
azngey	cute
chum amuleken duam	cycle
cicletatun	cycling
chau	dad
chau	daddy
fillkeantü	daily
lichüiyael	dairy
katrün	dam
iñfi	damage
wechafeipin	damn
narfü	damp
pürün	dance
kuñiwün	danger
kuñiutukufal	dangerous
dumiñ	dark
poyefal	darling
ütrüf nagün	dash
konümpaelchi düngu	data
rakin antü	date
ñawe	daughter
antü	day
la	dead
puwül antün	deadline
pilu	deaf
azdungukünun	deal
poyen	dear
pu falintun che	Dear All
Ayifal cliente	Dear Customer
Falintufal pu chau	Dear Parents
Falintufal che	Dear Sir
Falintufal trokiñke chilkatufe	Dear students
Falintufal trokiñke che	Dear Team
lan	death
nütramkawün	debate
kullikepeyüm	debit
mutrüng	debris
kullinuel	debt
trokiñke tripantu	decade
kutranchengewen	decay
lai	deceased
ngünenkan	deceive
disiempüre küyen	december
norche	decent
wüldungun	decide
elkülechi duam	decided
eldungün	decision
wentelepeyüm	deck
famentun	decline
pichikünutuel	decrease
kudautuniekelu	dedicated
küdautufal	dedication
wiril	deed
ponwitu	deep
wemul	deer
wellngen meu	default
yerpun	defeat
inkawün	defend
chumkünual	define
wechulün	definitely
feipikünuel	definition
puwülniel	degree
alüñman	delay
alüñman	delayed
nentukutun	delete
fenfaluwün	deliberate
pelluf	delicate
illufali	delicious
ayiwulündaum	delight
ayiwkülei	delighted
wülün	deliver
wulkünuel	delivered
elfalün	delivery
tukudungulün	demand
dalluntukupelu	demanding
democracia	democracy
weküfü	demon
pengelfalün	demonstrate
entukünungepel	denied
fütarumen	density
lawentuforokelu	dentist
weriñmael	deny
pichi ruka	department
tripal	departure
müngeltun	depend
inüfün	deploy
wulkünun	deposit
llazkükutrankülei	depressed
llazkunkuran	depression
llüfü	depth
kimelupel	describe
chumlekel	description
üwe mapu	desert
kuñültufalün	deserve
wirikan	design
üitukünungelu	designation
duamün	desire
wirinkuzaukepeyüm	desk
awüngelan	despair
afduamkülei	desperate
felefule rume	despite
kochi iyael	dessert
admogen	destination
cheu puwal	destiny
teifükünun	destroy
tüyümün	destruction
kimeldungu	detail
trokiñtroy	details
pefiñ	detect
wuldungkünun	determination
azümkünungeal	determine
femkünuel	determined
awümewün	devastated
wünelerpual	develop
demangepel	developed
wünelerpuel dungu	development
trarüntukuniekelu dungu	device
weküfe	devil
ngealu	devoted
Dhivehi dungun	Dhivehi
kochümollfün kutran	diabetes
pechay	diarrhea
fillantü	diary
diccionario	dictionary
deumai	did
lan	die
lai	died
ingekepeyüm	diet
kangechileken	difference
kakerumey	different
küzaufali	difficult
rüngalün	dig
yamngepelduam	dignity
nekul	diligent
yafütun	dinner
salsa	dip
adkünuel	direct
cheu püwal	direction
ñidokülelu	director
podümün	dirt
pod	dirty
nentukunungepel	disable
kishupepiluwkenulu	disabled
ñamnawün	disappear
katrüduamkületun	disappointed
amultükun	disaster
ütrüfülün	discard
nakümün	discharge
norkechi amulel	discipline
püchifalitun	discount
kimeltükun	discover
üzenduam	discrimination
nütramkawün	discuss
yafkawün	discussion
kutran	disease
pu kutran	diseases
ellkawün	disguise
wedaduamfali	disgusting
rali	dish
pu rali	dishes
wüdachalin	dismiss
wuldungupeyüm	dispatch
pengelün	display
koküpü	disposal
düngutuwün	dispute
alutuwün	distance
kakewme	distinct
kangeltun	distinguish
llazkün	distress
wudamkan	distribution
trokiñ mapu	district
ngeñikawün	disturb
wifkon	ditch
llüfüwüyülfe	dive
itrofill	diverse
fillkeduam	diversity
wüdamün	divide
kallfüduam	divine
wüdawün	divorce
wüyün	dizzy
femün	do
eimi	do you
piukentunien	do you love me
lawentuchekepelu	doctor
wirin	document
zeumakey	does
no	doesn't
trewa	dog
Dogri dungun	Dogri
deumamekei	doing
ashngelluam	doll
ngüneniel	domain
rukaduamtun	domestic
ngünekafe	dominant
felelay	don't
pellkekilge	Don't worry
elun	donate
femngen	done
furriku	donkey
marihuana anümka	dope
epu rume	double
ramtuduam	doubt
mazan	dough
nageltu	down
nakümel	download
ñamümün	draft
wingüdün	drag
lefmau	drain
afkaduam	drama
wiritunad	draw
trapümkünu elngeken wezakelu	drawer
ñiminwirin	drawing
llükan	dread
peuma	dream
küpam	dress
wechodün	drill
pütokopel	drink
adelün	drive
lüykün	drop
trani	dropped
arkün	drought
ngollin	drunk
amküm	dry
wala	duck
newe feyentunun	dude
norümkülen	due
welu	due to
afduam	dull
llümü	dumb
ütrüfkoñküpüwe	dump
tunte ñi puwal	duration
petu tani femel	during
trufür	dust
mülei ñi femal	duty
mülekepeyüm	dwell
petu lan	dying
kake	each
fei engü	each other
rumeñma ayikei	eager
kalkin	eagle
allküwe	ear
doy liwen	earlier
liwen	early
weu	earn
pilun	ears
mapu	earth
füta neyün	earthquake
pepiluwpel	ease
ngeno küdawun	easily
tüfa	east
azumfali	easy
in	eat
imeken	eating
müte falinulu	economic
ngillakan duam	economy
iwall	edge
püwülwirinün	edit
kimeltuwün	education
felewel	effect
wüdamnentun	effective
külfünuwal	efficiency
amulküdaukülekelu	efficient
newentun	effort
kuram	egg
berenjena tukukan	eggplant
chumngen che	ego
pura	eight
mari pura	eighteen
pura mari	eighty
kam	either
deumayael	elaborate
trulitruli	elbow
wunen	elder
wünen	elderly
afmatufal	elegant
ñidolün	element
elefante	elephant
mari kiñe	eleven
dullifal	eligible
ütrüfnentun	eliminate
zoy	else
yeweley	embarrassed
niepüñeñfalei	embarrassing
pankolün	embrace
weftripan	emerge
lefkentu	emergency
poyefaluwkelu	emotional
trürümelduam	empathy
newenkechi wiñofeipin	emphasis
wiñofepitual	emphasize
kudaukelu	employee
pu küzaukepelu	employees
wulküzaukelu	employer
küdaupemum	employment
wellilei	empty
eluñmangepel	enable
pedan	encounter
yafülün	encourage
wechul	end
kuñiutukulei	endangered
elfaltukukünui	endeavor
yafüluwün	endurance
mülenagpel	endure
kaiñe	enemy
newenkechi	energy
wültükundungu	engage
wultukudungun	engaged
wül düngun	engagement
motor	engine
rakituküzaukelu	engineer
ingles dungu	English
kümelkatun	enhance
ayimal	enjoy
doyfütapürai	enormous
yochi	enough
testiko konün	ensure
konpuel	enter
ashngelluwpeyüm	entertainment
ayiwman	enthusiasm
konaluwtun	enthusiastic
kiñe felen	entire
niel norümdungu	entitled
chumlekel mongen dungu	entity
kompeyüm	entrance
wuneluwlu küzaumu	entrepreneur
wente	envelope
itrofillmonge	environment
ütrirün	envy
füta dunguyel	epic
wallpaiñfikutran	epidemic
trürad	equal
trokiñ che	equipment
trürfalün	equity
trütrümel	equivalent
ñamümwirinam	eraser
femnuafel	error
leftripan	escape
dullinduampel	especially
azumazumtun	essay
rüf femngen	essence
wünenfalfel	essential
mülewtundungu	establish
mülenagkünungei	established
niekapeyel	estate
poyewün	estimate
falintu	estimated
etc.	etc
afnuel	eternal
norduamngekel	ethics
chumlepel	evaluate
ngünezuamngeal	evaluation
kutü	even
felefule rume	even though
pun	evening
kawiñtun	event
felefule	eventually
kiñe chi	ever
mollkiñe	every
kom	everybody
kom müleyelu wallontu mapu meu	everyone
kom küme elkülei	everything
chumkünungel	evidence
weküfü	evil
doy amulngepel	evolution
amuleyepel	evolve
Ewe dungun	Ewe
kuifingel	ex
rüf feichi	exact
rüf feiti	exactly
ngünezuamngekepeyüm dungu	exam
ngüneduamün	examine
femngechi	example
doy amulel	exceed
Tutelu	excellent
wichuken	except
wichukünun	exception
rumel	excess
rumeñma	excessive
trafkintun	exchange
mutrirün	excited
ayiwünduamün	excitement
mutrirünfal	exciting
itroyefal	exclusive
dunguñpen	excuse
doy femlayan	excuse me
deumakünun	execute
deumayepel	execution
lonkowkülelu	executive
nengümkantupel	exercise
lef tripan	exhaust
rumeñma ükülechiche	exhausted
konkülel	exhibit
pengelniengelu	exhibition
mülen	exist
müleyen	existence
mülekelu	existing
tripapeyüm	exit
alükünuael	expand
üngüm	expect
üngümngepel	expected
kulliyepel	expenses
falin	expensive
azümniel	experience
müleumangen	experiment
doy kimnielu	expert
wewi	expired
feipikünuel	explain
trananetuyen dungu	explanation
trofi	exploit
ngüneytumapun	explore
amulkünun	export
kimfalün	expose
peufalelu	exposed
pengelün	exposure
feypin	express
fepiluwün	expression
lapümün	extend
lapüm	extended
tuntenün	extension
medipeyüm	extent
wekun küpal	external
ñamkonün	extinct
doy püchin	extra
nentungepel	extract
afmatungekel	extraordinary
doyelün	extreme
füchakünupel	extremely
kuralnge	eye
pu kuralnge	eyes
pañu	fabric
chüpey	fabulous
ange	face
arelün	facilitate
deumatukukunun	facilities
anümtukukunuel	facility
deumale	fact
llitupeyüm	factor
deumakepeyüm	factory
rupandungu	facts
weyfün	fade
dewmadüngun	fail
puwlai	failed
kimün	failure
newen ngenuchiche	faint
nor	fair
norkümelkan	fairly
hada	fairy
feyentun	faith
puwulfe	faithful
ngünenche	fake
ütrüfnagün	fall
ngünenkan	false
kimfal	fame
reñmawen	familiar
reñma	family
entriwün	famine
kimelche	famous
zakiñkelu	fan
peyküñtupeyüm	fancy
ellangechi	fantastic
alü mapu	far
wuda  chalin	farewell
malal kullin	farm
ketramapukelu	farmer
ngoymaduamelün	fascinating
asümel ad	fashion
lef	fast
motrin	fat
awüngen	fatal
cheu ñi puwal	fate
chau	father
ürkün	fatigue
weshalelu	fault
doy ayüntun	favorite
fürenen	favour
doy ayüntun	favourite
llikan	fear
füta ileluwün	feast
pichun	feather
adngen	feature
chumgen	features
fewreru küyen	february
fentren	fed up
kullingeael	fee
ileluwün	feed
yom zungun	feedback
kutranpiukeyen	feel
kimüñmael	feeling
namun	feet
llamkünagi	fell
afkadi	fellow
duamtui	felt
domo	female
füll	fence
mon	fertile
kawintun	festival
kintual	fetch
aling	fever
pichiken	few
doy püchin	fewer
wülkünuel	fiance
epeutun	fiction
lelfün	field
newenmankelu	fierce
mari kechu	fifteen
kechu mari	fifty
weichan	fight
weichalen	fighting
rakinentun	figure
duamtunien	figure out
mülekepel	file
apolün	fill
puwuluwün	filled
negümkechi adentun	film
podentu	filthy
deu welchulngechi dungu	finally
kullintu	finance
wülkelu kullin	financial
pedan	find
pengeltukudungun	find out
kümefelen	fine
chügall kuwü	finger
wechulün	finish
wechülún	finished
kütral	fire
newenkülel	firm
wünen	first
wünen üi	first name
challwa	fish
pepikantukun	fit
kechu	five
küme elkünün	fix
femkünungen	fixed
farapañu	flag
wilüf-wilüfün	flash
lafmapu	flat
kümewenulu	flaw
ellangechi	flawless
lefmawun	flee
ilo	flesh
müpüi	flew
müchamün	flex
üñad	flexible
müpün	flight
waichifnagpel	flip
dakelün	flirt
sakiñdungufal	flirting
kentrayün	float
mangiñ	flood
tafu	floor
rüngo	flour
amulel	flow
pezkiñ	flower
aling	flu
püshañko	fluent
ayliñdungun	fluently
pañud	fluffy
ko	fluid
müpün	fly
chum amuleal	focus
trukur	fog
tromülei	foggy
müchamün	fold
wenüi	folks
amulnien	follow
inageal	follow up
küpalelu	following
iyael	food
fofo	fool
noi	foolish
namun	foot
pelotatun	football
ngeam	for
femngechi	For example
famngechi	for instance
eimi ngealu	for you
eluñmangenulu	forbidden
newen	force
pelotun	forecast
tol	forehead
kakeche	foreign
mawizantu	forest
rumel gepe	forever
ngoimantukun	forget
rupallazkünman	forgive
ngoiman	forgot
wütrü	fork
fem	form
nor adngen	formal
uneltunmeu	former
awemngen	fortunately
ülmenngel	fortune
meli mari	forty
meli mari epu	forty-two
wunelealu	forward
püralduamtun	foster
weichai	fought
pei	found
base	foundation
meli	four
mari meli	fourteen
ngürü	fox
newenngelay	fragile
marco	frame
üpül	framework
ngünenkawün	fraud
kingenochi duam	freak
nei	free
müñalkünuel	freedom
fürkünapel	freeze
müchaike rupal	frequency
keñike mew	frequent
müchaike	frequently
füskün	fresh
fierne antü	friday
füshküm iyael peyüm	fridge
wenüi	friend
wenüifal	friendly
pu wenüi	friends
wenüikawün	friendship
pellkelen	frightened
trepeduamün	frightening
llündki	frog
rüfgel	from
tol	front
monkolpireley	frozen
fün	fruit
ngünamün	frustrated
combustible	fuel
Fulfulde dungun	Fulfulde
apon	full
ayelkanche	fun
chumkel	function
doy duamngekepel	fundamental
eluwün	funeral
ayelkafe	funny
trawa	fur
illkufe	furious
ruka weshakelu	furniture
zoy	further
ka fei	furthermore
küpalechi antü	future
wewün	gain
aukantu	game
duamfal	gap
cheu elngekel autu	garage
koküpü	garbage
wülngiñ rayen	garden
akuz	garlic
tripawe	gate
trapümün	gather
trawün	gathering
nüfkün	gauge
elui	gave
püron tukulechi duam	gear
género	gender
komngealu	general
femkel	generally
deumanentün	generate
inaleyel	generation
fürenechekelu	generous
chumduamngen	genius
género	genre
zuamchekelu	gentle
rüfngen	genuine
umertun	gesture
aretun	get
takuluwün	get dressed
witrapüran	get up
pürüm tremotuaimi	get well soon
aretun	getting
shechü	ghost
rakizuamnge inarumenke dungu	ghosting
fütrañma	giant
yewün	gift
jengibre	ginger
pichi	girl
ngapiñ	girlfriend
wülün	give
kiñepülekünuel	give up
elungelu	given
ayiwi	glad
lefkintupel	glance
vidrio	glass
doy pelopeyüm	glasses
leflelin	glimpse
wallpülelu	global
llaufeñngepel	gloomy
impolkuwükemum	gloves
wilüf	glow
küdenge	glow up
pünapünawe	glue
amun	go
wunelenge	go ahead
amutunge	go away
umautumeael	go to bed
duamtun	goal
küdautuduamün	goals
kapüra	goat
ngünechen	god
Dios elunieaeimukümeke dungu	god bless you
amuai	goes
amulen	going
amual meu	going to
milla	gold
kimkülenulu	gone
amualu meu	gonna
pünafemuwkei	goo
küme	good
mari mari	good afternoon
peukallal	good bye
mari mari	good day
pun mai	good evening
küme küdaw	good job
ellangechi wentru	good looking
küme püllü	good luck
mari mari	good morning
mari mari, piukeyen	good morning my love
pun may	good night
peukallal	goodbye
pun mai	goodnight
niepel	goods
kintuam dungu	Google
Google rulpankewünh	Google Translate
kanzu	goose
tutelu	gorgeous
dunguyewün	gossip
aretui	got
kimtukun	got it
ngüneniel	government
nün	grab
püralpeyüm	grade
pichikantu	gradually
doyeluwlu	graduate
ketran	grain
elufal	grant
elungei	granted
ofaz	grapes
kimtukuael	grasp
anümka	grass
mañumün	grateful
mañumtu	gratitude
eltuwe	grave
kazü	gray
küme zungu	great
nganngewün	greed
illka	greedy
karü	green
chaliwün	greet
chalin	greeting
pu chalin	greetings
kazü	grey
ñeweñ	grid
llazkün	grief
ngülum	grind
nün	grip
ngillakangekepeyüm iyael	grocery
kulnge	groom
kimelngenochiche	gross
femken	ground
trokiñ che	group
tremün	grow
tremüm	growth
würwürün	grumpy
guaraní dungun	Guarani
efaltukudungun	guarantee
kamañ	guard
feipinge chem ngen	guess
magel	guest
adümkünuel	guidance
inaniengeael	guide
molkantukulelu	guilty
reke	guy
trokiñkelel	guys
pepilkawün	gym
wimtulel	habit
mülekemüm	habitat
niefui em	had
piren	hail
kal lonko	hair
rangiñ	half
chilkatukepeyüm	hall
küwü	hand
adelün	handle
ellangechi az	handsome
pültrükünun	hang
rupal antün	hang out
rupal	happen
rupan dungu	happened
ayiwünduam	happiness
ayiwül	happy
ayiwün puwül tripantu	happy birthday
ayiwün puwul tripantu	happy birthday to you
ayiwun we tripantu nieaimi	happy new year
yafü	hard
rume küzaufali	hardly
rüf turpu	hardly ever
iñfitun	harm
weshalkakelu	harmful
poyenkechi meu	harmony
yafü	harsh
ramuwun	harvest
niei	has
üden	hate
nien	have
küme antü nieaimi	have a good day
kiñe ellangechi antü nieaimi	have a nice day
yafütun liwen meu	have breakfast
ayekantun	have fun
imi	have you eaten
nien	having
kuñiutukufal	hazard
trukur	haze
fey	he
fey niey	he has
fei ngei	he is
lonko	head
kutran lonko	headache
mongelün	heal
patiru	healing
kumefelen	health
chalifal	healthy
allkün	hear
allkütui	heard
piuke	heart
aren	heat
wenu mapu	heaven
fanelu	heavy
mülmülün	hectic
wuenulei	height
nürpualu	heir
weñen	heist
mongeltuniei	held
alünagkülechi kütral	hell
mari mari	Hello
mari mari, poyen	hello dear
mari mari, chumleimi	hello how are you
mari mari chumleimi	hello how are you doing
yafüchumpiru	helmet
kellun	help
pünengekel	helpful
fei meu mai	hence
tani	her
kechan	herd
fau	here
elürpuel	heritage
ramtuwkülewen	hesitate
eymi!	Hey
mari mari	Hi
mari mari, chumleimi	hi how are you
mar mari	Hi there
ellkaukülechi	hidden
ellkauwün	hide
ñidolkülechi	hierarchy
wenulei	high
wiñofeipitun	highlight
trekakantun	hike
namuntu rüpün	hiking
ayekantukelu	hilarious
pichüpüra wingkul	hill
fei ngel	him
cheupüle amuleal	hint
wentelli	hip
wentelli	hips
ngillafalün	hire
ngilladeuman	hiring
tañi	his
weupin	history
tralofün	hit
feleperkei mai	Hmm
rupal antün	hobby
rekül	hold
üngümün	hold on
wechod	hole
ürkutu antü peyüm	holiday
lolo	hollow
ruka	home
ruka küdau	homework
rüf rakiduamyefel	honest
rüngen	honestly
mishky	Honey
trokitun	honor
takuangepeyüm	hood
chokif	hook
rünkün	hop
üngümün	hope
peumangen	hopefully
epuduamtuwün	hopeless
kakülkülel	horizontal
bocina	horn
trupefüngen	horrible
trupefün	horror
kawellu	horse
lawentuwpeyün meu	hospital
llow witranfe	hospitality
witranmalu	host
kaiñetun	hostile
areley	hot
lelpeumapeyüm	hotel
rakin antü	hour
pu rakintun antü	hours
ruka	house
mülekepeyüm reñmawen	household
chumngechi	how
eimi kai	how about you
chumleymi am	how are you
chumleymi am	how are you doing
chumleymi fachi antü	how are you doing today
chumleimi fachantü	how are you today
chumleimi	how do you do
chumngechi ngei	how is
tunten	how many
tunten	how much
tunten kechi	how often
tunten tripantu nieymi	how old are you
chumlei tami antü	how was your day
chum muyawimi trafia	how was your night
welu may	however
rangiñ meu	hub
afkadiduam	hubby
panko	hug
doy fütrañma	huge
che	human
ñomzuamche	humble
narfün	humid
narfün	humidity
pataka	hundred
entrikawün	hungry
nünkepi	hunt
kürüftukumawün	hurricane
lefkentu	hurry
matukelnge	hurry up
allfülün	hurt
füta	husband
ürküduamün	hustle
lef rupan ruka	hut
lifkülen	hygiene
iñche	I
iñche ngen	I am
küme felen	I am fine
pepi femün	I can
pepi femlan	I can't
mai	I do
kimlan	I do not know
adümlafiñ	I do not understand
iñche no	I don't
kimlan	I don't know
azümlan	I don't understand
azumlan tami chem pin	I don't understand what you mean
azümlaeyu	I don't understand you
kimlan	I don’t know
azümlan	I don’t understand
felelu trokifiñ	i guess
niefun	I had
nien	I have
mülepufun	I have been
fei üngümnien	I hope so
kimnien	I know
ayifiñ	I like
ayinieyu	I like you
rume ayifiñ	I love
poyeken tañi wünen peñi	I love my big brother
poyeken tañi wünen zeya	I love my big sister
poyeken tañi chau	I love my father
poyeken tañi pichi peñi	I love my little brother
poyeken tañi pichi zeya	I love my little sister
poyeken tañi ñuke	I love my mother
piwkeyeyu	I love you
rume piukentukunieyu	I love you so much
iñche ka	I love you too
piukentukunieyu	I love you too
küpa feipin	I mean
weñankaduamkeyu	I miss you
rume weñankükeyu	I miss you so much
deu pen	I see
rakizuamün	I think
kintukunien	I understand
küpa	I want
küpa peeyu	I want to see you
duamnieyu	I want you
mülepun	I was
fema fiñ	I will
ngepefel	I would be
ngen	I'm
küme felen	I'm fine
küme felen	I'm good
fau mülen	I'm here
femnuafel	I'm sorry
pire	ice
fürkün	ice cream
duam	idea
femngeal	ideal
trürüwingu	identical
inüyngen	identify
kizu adngen	identity
fofonche	idiot
tünkülelu	idle
mai	if
zuamnon	ignore
kutrantu	ill
nortripanuel	illegal
kutran	illness
Ilocano dungun	Ilocano
adentun	image
trokitun	imagine
pürüm	immediate
pürüm pürüm	immediately
fütrañma	immense
küllefiñ	impact
nungayten	impatient
amuldeumakünun	implement
tukupafal	import
zuamfali	important
nokelkatukudungun	impose
pepilnun	impossible
afmatungeal	impress
afmatun	impression
afmatufalün	impressive
küme elün	improve
küme elfal	improvement
mew	in
ka fei	in addition
rüf feleken	In fact
wülngiñ meu	in front of
ngealu	in order to
welulei	inappropriate
ngüchalün	incentive
rupachidungu	incident
yom tukun	include
konkülel	including
kompeyel	income
kiñepülekünuwfali	inconvenience
zoyel	increase
rumel amulei	increased
feyentunufal	incredible
fey llemay	indeed
kishunguneukelu	independent
india	India
adkünun	indicate
wüne anüm mapu che	indigenous
kishutu	individual
deumangekepeyüm	industry
kiñepülekünufal lay	inevitable
pichi wentru	infant
trarün	infection
fillkeduam	infinity
mütrawün	inflammation
doy falitun	inflation
kellukonduam	influence
amulfeipin	inform
kimeleldungu	information
kiñentrür konkechi	ingredients
nüagel dungu	inheritance
llitufal	initial
llitun duam	initiative
allfün	injured
allfeñ	injury
molkanulu	innocent
wefpürachi dungu	innovation
ramtun	inquiry
wezwez	insane
ishiken	insect
maneluwfalai	insecure
tukun	insert
ponwi	inside
femngentufiñ	insight
pürümülün	insist
pepi aumautunun	insomnia
wechulpaneyen	inspiration
neyüntukun	inspire
tukukunuel	install
entuduamün	instance
müchai müten	instant
welu may	instead
feingeafel en	instead of
chumngechi femngeal	instructions
ayekawe	instrument
lukatun	insult
kuñiwtuwün ngelay	insurance
rüf felerpun	intact
wechulduamkelu	integrity
fucha kimlu	intellectual
kimünduam	intelligence
kimche	intelligent
duamtuniel	intend
uwümelfiñ	intended
rumeñmaduamtufal	intense
rakiduamngepel	intention
wiñodungwun	interact
nütramkamkawün	interaction
duamtun	interest
duamnielu	interested
ngünezuamfali	interesting
katrükonün	interfere
rangiñtukun	intermediate
ponwi	internal
kake mapun	international
rulpawitrantu	internship
lapümentun	interpret
rulpadungukelu	interpreter
katruntuküpel	interrupt
ramtukawün nütram	interview
trayay	intimate
mew	into
nüwfüntükun	introduce
llitupel duam	introduction
noywache	introvert
inaduamün	intuition
pepi lemüwnulu	invalid
wünen kimün	invent
wirintukurakin	inventory
kakekünun	invest
malün	investigate
mangelün	invitation
magelün	invite
ngillapeyüm wirin	invoice
nüdufduamkünün	involve
konkülen	involved
pañilwe	iron
fey ngey	is
wapi	island
kishuniengei	isolated
troydungu	issue
weshake zungu	issues
fey	it
ngei	it is
amui	it was
feiti	it's
küme feley	it's ok
küme feli	It's okay
tupeyüm	item
trokiñ	items
tañi	its
ngen	I’m
tuwpeyüm	jacket
cerantukungepeyüm ch	jail
enero küyen	January
taru	jar
tranga tranga	jaw
rümpelfe	jealous
witran	jerk
rütran küdau	jewelry
küzau	job
lefakantun	jogging
trawülün	join
trawün	joint
ayekantu	joke
ramtuyechekelu	journalist
nampül	journey
ayiwün	joy
norümdungukelu	judge
fün ñi ko	juice
julio küyen	july
rüngkün	jump
kunio küyen	june
koküpü	junk
puwel	just
deumafinge	just do it
nordungu	justice
eldungulun	justify
Kalaallisut dungun	Kalaallisut
poyewün duam	keen
mongeltuwün	keep
amulei	keep it up
mülenagniengel	kept
eñumkopeyüm	kettle
llafe	key
mankün	kick
pichi wentru	kid
ayekan	kidding
kuda kuda	kidney
pichikewentru	kids
lamngümün	kill
reke	kind
ka pichin	kinda
poyenkechi	kindly
kümeduamkechi	kindness
wunenkaulu wentru	king
tinku	kiss
truyu	kiss
deumaiyaelpeyüm	kitchen
ngaw	kite
pichi narki	kitten
luku	knee
kimfui	knew
katrüwe	knife
yamüchekelu	knight
kimel	know
kimün	knowledge
kingepel	known
Konkani dungun	Konkani
Krio dungun	Krio
pünantukuniel ni üi	label
küdau	labor
küzaupel küwü	labour
fillai	lack
pürapürawe	ladder
zomo	lady
femngechi elkünün	laid
pichi lafken	lake
pichi ufiza	lamb
ketro	lame
pelontupeyüm	lamp
mapu	land
admapun	landscape
dungun	language
yafülduampemum	lap
wif	large
inalechi	last
inankechi, welu ka femngechi falintun dungu	last but not least
künpemüi	last name
nag antü	late
inalechi duam	lately
doy nag antü	later
chi inalelu	latest
inan	latter
ayen	laugh
ayekan	laughing
ayekan	laughter
ütrüftun	launch
küchatupeyüm	laundry
norüm dungu	law
kachu	lawn
ingkañpefe	lawyer
tukun	lay
takuwpeyüm	layer
eluwül	layout
miyaukakelu	lazy
adümkünun	lead
ñidol	leader
Papeltükulechi adentun	leaf
lefmawün	leak
külürulün	lean
rünküi	leap
kimün	learn
azümfiel	learning
arengülüm	lease
rewall	least
trülke	leather
elkunun	leave
tapül	leaves
amulkünui	led
wele	left
chag	leg
elkünurpuelyem	legacy
nordungulel	legal
piam	legend
norümdungu	legit
kizungünew antu lel	leisure
arelen	lend
tunte ni puwülün	length
doy pichin	less
kimeltupel	lesson
elün	let
chilka	letter
lechuga tukukan	lettuce
tunten ñi fenten	level
ngenngeufe	leverage
puwelfalün	liability
mülekepeyüm lifru	library
küllman	lick
koilatun	lie
koilatun	lies
mongen	life
witrapüramün	lift
pelon	light
pelompeyüm	lightning
ayin	like
rüf felen	likely
femngechi llemai	likewise
wifwirin	line
Lingala dungun	Lingala
trawüwkülechi	link
pangi	lion
liukün	liquid
wirintukungekepeyüm	list
allkütun	listen
allkütun	listening
rüf fei ngen	literally
wiritun küdau	literature
kawitu	litter
pichi	little
mongen	live
ke	liver
pu mongen	lives
mongelen	living
müleyekepeyüm che	living room
kirke	lizard
chechum	load
kofke	loaf
arengülüm	loan
lof	local
cheu ni mülen	location
nürüf	lock
nürüftukulen	lockdown
wirintukulepeyüm	log
ayekawün	lol
kizulen	lonely
alütulu	long
Alün tripantu ñi penufiel	long time no see
lelin	look
nentutapon am	loop
weungeyel	loose
nor che	lord
rulpapüdai	lose
llamkümün	loss
ñuwin	lost
wirkon	lot
füta püra	loud
chilkatukemum	lounge
poyewün	love
ayieyu	love you
ayifal	lovely
nageltu	low
doy nageltu	lower
norche	loyal
norduamkel	loyalty
kümefemyawel	luck
fürenengekelu	lucky
Luganda dungun	Luganda
karpa	luggage
allwiñ	lump
yafütun	lunch
ponon	lungs
llifedün duam	luxury
mülelu feimu	lying
máquina	machine
wezwez	mad
chiñura	madam
deuman	made
wirin pengel dungu	magazine
doy ayifal	magnificent
kellukelu ruma küzau meu	maid
wünelelu	main
nierpün	maintain
ngünaytuningeam	maintenance
Maithili dungun	Maithili
wünelelu	major
müngel	majority
femün	make
deumafal	make up
wentru	male
cheu ngillakakemum	mall
wentru	man
ngünuniel	manage
kintukellün	management
wülnelkülelu	manager
duamfalel	mandatory
amul entun	manifest
trokitun	manipulate
chumngen	manner
kuwüdeumal	manual
fentren	many
Peumangen puwul nieaimi fentren tripantu	many many happy returns of the day
Mapudungun	Mapudungun
marzu küyen	march
tuten ñi puwal	margin
ngillakapeyümeu	market
mafün	marriage
kurengen	married
takuangepeyüm	mask
mazan	mass
rume	massive
kimelkelu	master
aukantu	match
afkadi	mate
wezakelu	material
rakitunduamün	math
tukupal	matter
füchan	maturity
pepi	may
feychita	maybe
iñche	me
iñche ka fey	me too
iyael	meal
rume	mean
feipilechidungu	meaning
wülzungu	means
küpa feipi	meant
petu ni femnun	meanwhile
nüfkün	measure
nüfkün	measures
ilo	meat
lawentuchekelu	medical
lawentun	medicine
ngüneltun	meditation
rangiñ	medium
trünkolün	meet
trawünche	meeting
Meiteilon dungun	Meiteilon
lliwümün	melt
tukulpan dungu	memories
lonkontukun	memory
pañillwe	mental
üytun	mention
üitungechi	mentioned
kimelkelu	mentor
fendekelu	merchant
fürenewün dungu	mercy
mupiñkechi	merely
ayiwün navidad	merry christmas
kewandungu	mess
werkündungu	message
reifülelu	messy
pañillwe	metal
ngünel	method
Zewü	mice
ragin	middle
rangipun	midnight
pepi femafui	might
pichintu müten	mild
amulechiduam	milestone
militar	military
lüchü	milk
mari pataka waranka	million
duamtun	mind
lonkontukuel	mindset
iñche tañi	mine
reyülün	mingle
inan	minor
minutu	minute
minutu	minutes
deumayen	miracle
komütuwe	mirror
reyün	miscellaneous
wezwezche	mischievous
rumeñmarükü	miserable
fillan	misery
weñankaduamün	miss
weñanküeyu	miss you
ñamümün	missing
chumpayal	mission
trukurün	mist
wedakünuel	mistake
Mizo dungun	Mizo
mütrümchepeyüm	mobile
inawentun	mock
adkünuel	model
katrütuwkelu	moderate
welel	modern
külmenche	modest
üdankülei	moist
narfün	moisture
perkani	mold
kütru	mole
ñuke	mom
müchay	moment
lunes antü	monday
ran	money
kimelkelu	monitor
mono kulliñ	monkey
küyen	month
yafülün	mood
wedaduamkülen	moody
küyen	moon
kumeduamche	moral
zoy	more
ka fei llemai	moreover
wüle	morning
potekakünun	mortgage
doy ngel	most
wünelechiduam	mostly
ñuke	mother
nengümun	motion
külfünduamün	motivation
mawizantu	mountain
dewü	mouse
wün	mouth
negümün	move
nengümün	movement
aukiñngepel adentu	movie
Zeñora	mrs
fentren	much
fotra	mud
charu	mug
fün	muscle
mülepeyüm kuifike wezakelu	museum
mapu küfüll	mushroom
ayekan	music
mülei ñi	must
nükümkünun	mute
epuñpüle	mutual
tañi	my
poyefal	My dear
tañi wenüi	my friend
tañi winüfpeyüm meu apolei challwa mu	My hovercraft is full of eels
tañi ayün	my love
tañi üi ngei	my name is
tutewün	my pleasure
iñche ngel	myself
kimfaluwkenulu	mysterious
kimfalnueldungu	mystery
epeutun	myth
wili	nail
werikenulu	naive
üi	name
wirintukulechi duam	narrative
pichi rume	narrow
üzefal	nasty
wallmapu	national
che tuwün	nationality
wünenkeche	native
mapunduam	natural
itro fill mongen	nature
ülngun	nausea
pülle	near
püllelechi	nearby
pülle meu	nearly
rumelifgey	neat
duamfali	necessary
pel	neck
yuwül pel	necklace
zuamniel	need
kayñetukelu	negative
upeduamün	neglect
dungtukünun	negotiate
karukatu	neighbor
pu karukatu	neighborhood
rumefel	neither
malle	nephew
chilkatufe	nerd
trafkantulei	nervous
zañe	nest
puwül	net
ñewiñ	network
konkenulu dungu mu	neutral
turpu	never
turpu kizukünulayaimi	never give up
dungu nu	never mind
dungu nu tati	nevermind
ka femngechi	nevertheless
we	new
dungu	news
küpalelu	next
engu	next to
azngey	nice
kümey tayu kimuwün	nice to meet you
mallewen	niece
pun	night
ngüken	nightmare
ailla	nine
mari ailla	nineteen
ailla mari	ninety
no	No
dungunufel	no problem
chumngechi nu rume	no way
ineinu	nobody
wakeñün	noise
ngoingoiyün	noisy
kiñenurume	none
rangi antü	noon
no	nope
feitinu	nor
wimtuniefal	normal
pikun	north
yu	nose
lladküluwün	nostalgic
felelai	not
dungunu	not at all
wezalelai	not bad
ngelayay	Not now
petu nu	not yet
wirintukukemum	note
wirintukulei	noted
chem nu rume	nothing
azkintun	notice
azkintui	noticed
mongewe	noun
sustantivo	nouns
afmatufal	novel
nofiemfre küyen	november
fewla	now
fachantü	nowadays
pekankan	nuisance
chemnu rume	null
umagelün	numb
rakitun	number
zachefe	nurse
tuerca	nut
nuez moscada	nutmeg
kümeiyael	nutrition
wuldungulün	oath
motrin	obesity
feyentun	obey
wezakelu	object
amulduamün	objective
trarüntükundungu	obligation
zumiñ	obscure
azkintun	observation
azkintun	observe
kishutu ngünelei	obsessed
yafüduam	obsession
penewenuel	obsolete
katrütuduamün	obstacle
elungelu	obtain
ditufiñ	obtained
rüf femngechi	obvious
rüf felerpual	obviously
kiñeke meu	occasionally
Püneluwün	occupation
pünelei	occupied
rupal chi dungu	occur
rupan dungu	occurred
femkei	occurs
lafken	ocean
oktufre küyen	october
kangentufal	odd
pepidemayafel	odds
ñi	of
feley	of course
chongümkülei	off
lukatun	offensive
maneldungu	offer
küzaupeyüm	office
üitukünuel	official
kiñeke mew	often
awem!	Oh
rüf dungu	oh really
yiwiñ	oil
feley	ok
felepe mai, poyen	ok dear
feleai, poyen	ok honey
felepe, poyen	ok my love
feley	okay
felepe mai, pichiche	okay baby
feley, poyen	okay dear
felepe mai, poyen	okay honey
feleia, poyen	okay my love
fücha	old
mew	on
kiñe chi	once
kiñe	one
kiñe dungun müten rumel feikelai	one language is never enough
cefolla	onion
noramulelu	online
kishu	only
nülaley	open
küdaumafiel	operation
zunguntukun	opinion
pepilkünun	opportunities
yafülduamkületun	opportunity
traftuwün dungu	opposite
ayiwünduamchengei	optimistic
pepi dullial	option
opcional	optional
kam	or
kelüchoz	orange
küme elün	order
fentrelekel	ordinary
trapümüwünche	organization
tripalündungu	orientation
tuwün	origin
rüfngel	original
Oromo dungun	Oromo
kuñifal	orphan
kangelu	other
felenufule	otherwise
mülefui tami	ought
taiñ	our
Taiñ duam: küme azumkünual kom che, ka wall püle, tañi kimtukunieal chi wallmapun ka ka pepi dungüal fill trokiñke dungun meu.	Our mission: to enable everyone, everywhere to understand the world and express themselves across languages.
Taiñ küzau: kümelkakünuael fillwallpadungu tañi pepi pengeael ka pepi pünengeael.	Our mission: to organize the world's information and make it universally accessible and useful.
wekun	out
nentulel	outcome
tukutun	outfit
tripalelu	outgoing
tripapeyüm	outlet
kimfaluwün	outline
wekun	outside
lliwatulel	outstanding
afümiyaelpeyüm	oven
wente	over
fey ti mu	over there
müchayke	overall
wewün	overcome
katrüduamKülekeyüm	overthinking
ponorkülen	overwhelmed
trañmanakümün 	overwhelming
tükuluwkülechi dungu meu	owe
killkill	owl
iñche tañi	own
ngengelu	owner
manzun	ox
rupan	pace
impolün	pack
kütrüng	package
kullilei	paid
kutrantun	pain
adentuel	paint
adentu	painting
trür	pair
chodwen	pale
palmera	palm
challa	pan
füta wallpakutran	pandemic
trupefün	panic
chiripa	pants
papil	paper
ellangechi mapu	paradise
mürlen	parallel
rukaupeyüm	parcel
naipikunungei	pardon
pu chau	parents
anüm mawiza	park
choroy	parrot
perejil tukukan	parsley
trokiñ	part
inkawen	participate
doykülerpuel	particular
müngelduam	particularly
kompañyefiel	partner
kawiñ	party
rupan	pass
rupai	passage
rupai	passed
witrantükuduamkülen	passion
sakifal	passionate
ñochiche	passive
ellkanemel	password
rupan	past
parchetun	patch
rüpü	path
yewengechi	pathetic
ñochi felekellel	patience
kutranche	patient
ñidolkülechiche	pattern
pichi felekellel	pause
wariarüpü	pavement
kullin	pay
kullingepel	payment
tüngduam	peace
ñochingel	peaceful
turango	peach
wechuñ wikul	peak
peraz	pear
pishkufal	peas
kishungel	peculiar
willitun	pee
trolüf	peel
trür	peer
mürwen	peers
elpeyüm wiriwe	pen
wiriwe	pencil
mülewel	pending
che	people
pimienta	pepper
ngüneduamün	perceive
trokitun	perception
ellangechilelu	perfect
deumapel	perform
tunte ni amulen	performance
feleai chey	perhaps
chumleken	period
rumelmüleael	permanent
rupachi	permission
rupachi	permit
yafülduamün	perseverance
trewün	persistent
che	person
iñche tañi duam	personal
chum che ngepel	personality
rakiduamkülen	perspective
rulpan züngu	persuade
ngoimalman	pervert
ruka kullin	pet
chumkülekepefel em	phase
wellngen	phenomenon
trokiñke duam	philosophy
mütrümtuwe	phone
adentun	photo
trokiñkedungu	phrase
kalül	physical
ñimitun	pick
yerpuan	pick up
adentun	picture
katrün	piece
umautupeyüm	pieces
sañwe	pig
paloma üñüm	pigeon
wirkon	pile
metrül	pillow
piloto	pilot
pichi pañilwe	pin
piña	pineapple
pezkiñ	pink
rüngan mapu	pit
rupay	pitch
kiñilün	pity
wue	place
trokiñke lelfün	places
wedakerupan	plague
laf	plain
chumküleafel	plan
müpünyechekelu	plane
anümka	plant
anümka	plants
chapüdpañilwe	plate
peufalukemüm	platform
aukantun	play
aukantukantu	playing
ayiwman	pleasant
füreneafen	please
ayiñmai	pleased
ayiwünpel	pleasure
feipinien	pledge
kake rume	plenty
kiñeke rume	plot
shüñülltrapüm	plug
ciruela	plum
küme elkelu witrukopeyüm	plumber
fill	plural
podcast	podcast
kumwirin	poem
kumwirin	poetry
wechul	point
füñapuwe	poison
soltau	police
adeluwün ngen	policy
norche	polite
podümel mapu	pollution
trapümkopeyüm	pond
winka mallin	pool
me	poop
pofre	poor
trofülün	pop
kimelchiche	popular
trünkon che	population
sañwe	pork
ngülümiyael	porridge
puwkemum wampo	port
chumlen	position
kümelkan	positive
niefal	possess
ningepel	possession
posesivo	possessive
pepifal	possible
nentufeipin	post
doy üyew künun	postpone
poñi	potato
elufalfel	potential
libra	pound
filla zungu	poverty
newen	power
newenche	powerful
asümfalfel	practical
deumadeumayekel	practice
sakingei	praise
ayekafal	prank
llellipun	pray
ellangechi	precious
küllekelu	precise
rüfeiti	precisely
kimeldüngun	predict
doyüm	prefer
dullifal	preference
niepüñeñkülei	pregnant
petu ñi kimngenun	prejudice
tukukününgeken	premises
weneldeuman	premium
pepikalün	preparation
pepikalün	prepare
pepikawün	prepared
wunelekelu	preposition
mülepel	presence
müley	present
kimfaluwün	presentation
inkayepel	preserve
lonkoluwkülelu	president
üfülün	press
müküfün	pressure
trokiukülei	pretend
azngey	pretty
petu ni rupanun	prevent
wünel	previous
katrün ilo	prey
falin	price
ülmenuwün	pride
patiru	priest
wunelkechi	primary
ñidol	prime
we üllcha	princess
doy wunel	principal
wünel	prior
doyümfal	priority
malaltukun	prison
kizuniel	privacy
kishitun	private
menaltun	privilege
wewelyewün	prize
felepellel	probably
füta duam	problem
chumamuleal	procedure
tuwun	proceed
chum amulekel	process
deumakünuel	produce
rokiñel	product
zuemapel	production
chemu küzaukepeyüm	profession
kimdumakelu ñi küzau	professional
pengelüwün	profile
wewpeyel	profit
ponwitu	profound
yomürpun	progress
felerpualduam	project
fütapüralu	prominent
eldungunkünun	promise
wenuñpüramün	promote
wünetuwlu	promotion
kümelkan	prompt
kuñiutulen	prone
üitufalfel	pronouns
dungulün	pronunciation
ramtuwünwirin	proof
norduamkelu	proper
kümefemngepel	properly
niepeyel	properties
ngenngel	property
manalün	proposal
kimfalkülechi dungu	prospect
küme felerpual	prosperity
küzaukechi wefpülu	prosperous
kuñiutukufal	protect
ülmenukawün	proud
kümenkümentun	prove
wülael	provide
pepikawun	provided
trokiñ wallmapu	province
pepikauküleaiñ	provision
wechengelmu	puberty
trawünche	public
ültren	pull
calabaza	pumpkin
akukel	punctual
chilkatufe	pupil
ngillakan	purchase
re	pure
koñoll	purple
duam	purpose
monedero	purse
kintun	pursue
kintupel	pursuit
ültren	push
tukulün	put
chumtripapel	qualification
kakewmen kümeke weshakelu	quality
tunten ngepel	quantity
melimarin	quarantine
notukawun	quarrel
külaküyen meu	quarter
quechua dungun	Quechua
wünenkaulu zomo	queen
kangechi	queer
ramtun	query
ramtun	question
külen	queue
matu	quick
pürüm	quickly
ñochi	quiet
pontro	quilt
elkunüel	quit
zoyüñmai	quite
pengelfalel	quiz
tute faliken	quotation
ramtun tunten falin	quote
tuntefalintulefel	quotes
koneku	rabbit
mollfün chengen	race
illkün	rage
mawün	rain
wenuntun	raise
doy ngetui	raised
lefi	ran
chuchi rume	random
tunte ni puwkülen	range
matu	rapid
müchaimüten	rapidly
kangechi	rare
müte kimngekelai	rarely
trofün	rash
dewü	rat
charu	rate
feillenoafel em	rather
kümelkaniewün	ratio
rakiduamfe	rational
karülelu	raw
konümpan	re
ziupayün	reach
püwüli	reached
yafüduamkünuwün	reaction
chilkatun	read
chilkatun	reading
eluwküleiñ	ready
rüfngen	real
rüf chumleken dungu	reality
kimtukun	realize
kimtukui	realized
rüftu	really
furitu	rear
kimtukuniepel	reason
ngopinkelu	reasonable
tukulpan	recall
llowün	receipt
llowün	receive
llowi	received
feula müten	recent
pichintunfeula	recently
llongekepeyüm	reception
ngünelkünupeyüm	recipe
welulelu	reckless
wiñokimngetuel	recognition
wiñokintutuel	recognize
chalintukun	recommend
feipikunuel	recommended
wirintukulen	record
wiñoltuel	recover
kümelkautun	recovery
rectángulo	rectangle
kelü	red
trafkintun	redeem
reküluwkemum	redemption
pichi	reduce
doyeluwi	redundant
nütramyen	refer
feingel reke	reference
aiywiñeluwpui	reflect
rakizuamün	reflection
kadilkünuwün	refrain
füshkümiyaelpeam	refrigerator
wiñoleltun	refund
wüñolngen	refuse
üzefal	refused
püllewen	regard
felechi meu	regarding
kizungüneukülekei	regardless
chalin	regards
trokiñ mapu	region
wirintukulepeyüm	register
wiñoduamtun	regret
felenfelen	regular
femkülekei	regularly
werin	reject
weupitun	relate
nütramkawkülelu	related
nütramuwkelu	relationship
kiñekemu	relative
reñmawen	relatives
tünkülechiche	relax
naipikünun	release
naipitripalu	released
ngüneduamfal	relevant
yafülduamfali	reliable
kümezuamtun	relief
pengelün	relieve
kümefeletun	relieved
feyentu	religion
müngeltun	religious
mupikenulu	reluctant
mangeluwün	rely
fillchumngentun	remain
mülewelu	remaining
trokingel	remarkable
kullingekepeyüm	remedy
tukulpan	remember
tukulpan	remind
tukulpadungun	reminder
wichul	remote
kañpülekünün	remove
arelün	render
ngillapünepel	rent
kümeltun	repair
wiñodungun	repeat
kangelutukutun	replace
lloudungun	reply
feipilen dungu	report
lonkoluwün	represent
üitufalngekelu	reputation
llellipual	request
zuamün	require
duamtun	required
kulliñmanentutun	rescue
inarume zungu	research
reke lei	resemble
illkutuniewün	resentment
echelkünuel	reservation
elkünupel	reserve
mülekelu	resident
welutripan	resign
newenpüllüngen	resilience
newentuwün	resilient
wemünentun	resist
yafüluwün	resistance
trapümduamün	resolution
küme elün	resolve
kuzaufali	resort
kullikepeyüm	resources
yamüwün	respect
lloudungun	respond
wüñolzungun	response
llowdüngufalün	responsibility
llowdüngufalün	responsible
ürkütun	rest
tüng kechi ürkütuaimi	rest in peace
cheu tani yafütuken che	restaurant
küme elngepel	restore
tuntekünungeam	restrict
puwülel	result
afpuwuldungu	results
pichikünun	resume
pichikentun	retail
niekallen	retain
niekapellel	retention
kullingekel füchachengenmu	retired
yemetun	retreat
wiñolngetun	retrieve
wiñolün	return
pegelün	reveal
pengeli	revealed
wiñowedafemün	revenge
weupeel	revenue
kañpülel	reverse
malütun	review
ngünezuamün	revise
ngünezuamün	revision
kakünutuel	revolution
weupel	reward
nengümüwpeyüm	rhythm
kadi foro	rib
arroz ipeel	rice
kümey	rich
napikünuel	rid
amülün	ride
wezwezduam	ridiculous
kümelkalen	right
feula meu	right now
yafün	rigid
yüwül changül kuwü	ring
ülpun	rinse
kümelkalenulu	riot
wechoz	rip
afün	ripe
wenuntun	rise
kuñiutufali	risk
kaiñe	rival
leufü	river
rüpu	road
kotün	roast
newenche	robust
rock ül	rock
wüllma	rod
falilün	role
trüko	roll
wenuruka	roof
umautupeyüm	room
folil	root
def	rope
funan	rotten
illkuduamün ngey	rough
epeke	roughly
chünküd	round
rüpü	route
femekekel	routine
wif	row
ngüñküdün	rub
ñamümwirin kelu	rubber
koküpü	rubbish
newenkechi	rude
lama	rug
teifünagchi	ruin
küyen kutran	rule
küyen kutran	ruler
itrolmau	rules
lefün	run
lefün	running
lelfün	rural
lefün	rush
karpa	sack
kallfüduam	sacred
fütakudaufal	sacrifice
rüfduam	safe
küme müpün	safe flight
kuñiutukuwpeyüm	safety
kimche	sage
feipi	said
nafitun	sail
wampotun	sailing
kümelkaleael	sake
kullingepel	salary
welulkan	sale
llollechallwa	salmon
chazi	salt
feiti reke	same
fau ka	Same here
pengelun	sample
kuyüm	sand
Sanskrit dungun	Sanskrit
ayentuchekepelu	sarcastic
yamchekenulu	sassy
anüi	sat
feyelüwün	satisfaction
wezan	satisfied
feyelün	satisfy
feyeluwün	satisfying
safado antü	Saturday
reltrüntukulei	sausage
auka	savage
llainakünuel	save
pei	saw
peipintukun	say
pürapürawe	scale
welulkan	scam
allfen em	scar
pekenuel	scarce
pellkelen	scared
takupelpeyüm	scarf
rumellükafal	scary
pachigduam	scattered
rupankechidungu	scene
pengelngekepeyüm dungu	scenery
numutun	scent
chum amuleal	schedule
chilkatuwe ruka	school
ciencia	science
cientifico	scientist
pu rüfdungupekelu	scientists
katrüpeyüm	scissors
mürilün	scold
ditun	scope
tunte ni nentuel	score
püneyel	scrap
ruefün	scratch
wirarün	scream
adkintungekemum che	screen
chiwüd rulpangekel	screw
wirilepel	script
lafken	sea
üituntukun	seal
kintun	search
pukeyüm	season
anüpeyüm	seat
epu troy	second
ellkaduamün	secret
nünüfpeyüm	section
reküluwfal	secure
füngkulün	security
pen	see
pewayu	see you
müchay peaeyu	see you later
pürüm peayu	see you soon
wüle peayu	see you tomorrow
fillke fün	seed
kintun	seek
reke lei	seem
rekelei	seems
pekünuel	seen
nün	seize
lalatun	seizure
kiñeke meu	seldom
zullitun	select
iñche tati	self
kizulawentuwün	self healing
rükünche	selfish
fenzen	sell
amulel	send
amultukulelen adentu	send me your picture
füchakeche	senior
elupiwken	sense
kutranduamfal	sensible
kutrankaduamuwkelu	sensitive
amülün	sent
ngillatu	sentence
pu ngellipun	sentences
wüdan	separate
Sepedi dungun	Sepedi
septiembre küyen	september
troytuamulel	sequence
yomürpun	series
ngünelche	serious
newenduameuma	seriously
serfitun	serve
puwunfal	service
trawün	session
femkünungel	set
wifkünungekepel	set up
wallrupal	setting
mülenagpalu	settle
regle	seven
mari regle	seventeen
regle mari	seventy
müfü	several
ülngumün	severe
ñüfüdün	sew
ñüküfnge	sh
aywiñ	shade
aywiñ	shadow
mütrowün	shake
amualu mew	shall
pichikoni	shallow
yawen	shame
ad	shape
kelluntukuwün	share
lliwatufe ngey	sharp
fei	she
fei niei	she has
feigei	she is
pu kulliñ ni ruka	shed
üficha	sheep
tapül	sheet
elngekepeyüm weshakelu	shelf
caparazón	shell
ellka	shelter
kuñiwtukuwpeyüm	shield
rakinamulekel	shift
wilüfün	shine
nafiw	ship
amulün	shipping
wentru tukuluwün	shirt
zumel	shoes
trakatun	shoot
ngillakawe ruka	shop
ngillakan	shopping
lafken mapu	shore
püchüy	short
fillan	shortage
ütrüfi	shot
müley ñi	should
llankaforro	shoulder
wirarün	shout
pengelün	show
pengelelen	show me
müñetupeyüm	shower
macheo	shrimp
nganchodün	shrink
serantukukunün	shut
dungukinulpe tami wün	shut up
llükacheken	shy
peñiwen	sibling
peñiwen	siblings
kutran	sick
inafull	side
afküduamün	sigh
lelin	sight
llallitun	sightseeing
wirintukun	sign
wirintukun	signature
duamtufal	significant
ñüküfduam	silence
ñochifalün	silent
serapañuz	silk
weluzuam	silly
lien	silver
rekeley	similar
fofo	simp
küzaungenochi	simple
müramulel	simultaneously
cheu meu	since
rüfduamche	sincere
rüfduamün	sincerely
ülkantun	sing
ülkantufe	singer
kastañpe	single
trapüm ko peyüm	sink
Wentru	Sir
zeya	sister
fillka	sister in law
anükunuwun	sit
lawün	site
duam	situation
kayu	six
mari kayu	sixteen
kayu mari	sixty
tunten	size
pepiluwün	skill
pepiluwün	skills
trawa	skin
trongli	skinny
malütun	skip
winka küpam	skirt
wenu mapu	sky
ngüneniengel	slave
umautun	sleep
umautulei	sleeping
küpaumagkiawlu	sleepy
kuwül	sleeve
katrun	slice
pingudün	slide
matukelpange	slightly
pichirumel	slim
melkayün	slip
petu pengenuel	slope
katrüwün	slot
ñochi	slow
ñochikechi	slowly
pichülu	small
ülmen kechi tukuwkülei
tükuwküle	smart
nümütun	smell
ayeñkülen	smile
pütremtun	smoke
pañuz	smooth
illufal	snack
chelliu	snail
füta filu	snake
añitun	snap
napür	snow
fey mew	so
müna küme ad	so cute
fütrakamapu	so far
üremün	soak
kafon	soap
chelei	sober
pillmakantun	soccer
ingkawpewün	social
kiñel trokin che	society
nüfkü	socks
pañuz	soft
software	software
pullü	soil
wültukun	sold
ürkülen	sold out
soltau	soldier
kiñel	sole
yafülechi	solid
kümel zungu	solution
küme elngepel	solve
kiñeke	some
kiñe che	somebody
chumngechi rume	somehow
inei chi	someone
chemkün	something
kiñeke meu	sometimes
ül	song
pürüm	soon
ellalkalekelu	sophisticated
Sorani dungun	Sorani
ponwiallfeñkutran	sore
kutran pel	sore throat
llazkün	sorrow
femnuafulu	Sorry
inayemtun	sort
kintuyawülün	sought
püllü	soul
küñepüllu	soulmate
dungulün	sound
korü	soup
kotrü	sour
rali	source
willi mapu	south
wellin	space
podke chilka	spam
tunteñman	span
winka dungun	Spanish
mülewel	spare
dungun	speak
falintufal	special
fillkemongen	species
dullintuel	specific
wenunpürafalchi	spectacular
dungun	speech
nienulu dungun	speechless
lepümün	speed
troitunemeltu	spell
rülün	spend
pünei	spent
füren	spicy
lonko kachilla	spike
chiwüdün	spin
espinaca tukukan	spinach
püllü	spirit
tofkün	spit
alofün	splendid
wüzamün	split
teifülün	spoil
katrüduamkülewetun	spoiled
kishuduamkelu	spontaneous
wütrü	spoon
puwül	spot
kurewen	spouse
wuzpün	spread
pewü	spring
meli wechun nielu	square
kütrürün	squeeze
llakoduamelün	squid
ardilla	squirrel
waria rüpü	st
chüngarün	stab
mülekel	stable
pila	stack
kishutun	staff
amuntroy	stage
podüm	stain
pu pürapürawe	stairs
konkülechi che	stake
lloftun	stalk
witrakünuwün	stall
adpünekepel chillka meu	stamp
mülenagpel	stand
femngelufel	standard
wangülen	star
llitun	start
llitui	started
entrirkawün	starving
chumlen	state
feipintukulen	statement
cheu puwken che	station
chemamüll	statue
chumlen	status
mülenagpel	stay
kuñiutukuniwal	stay safe
mülekakel	steady
katrün ilo	steak
weñen	steal
würwan	steam
yafü pañillwe	steel
wenunpüralechi	steep
tuwün	stem
trekan	step
wima	stick
yafü	stiff
petu	still
üpirün	sting
rükü	stingy
kañpülekünun	stir
mongewe	stock
weñen	stolen
pütra	stomach
kura	stone
yenierpui	stood
me	stool
fentekunün	stop
echeliyaelpeyüm	storage
yefalkünuel	store
kürüftuku	storm
kuifike dungu	story
eñumtukepeyüm	stove
reñmarpun	straight
noramulün	straightforward
winümuwün	strain
ka che	strange
kakeche	stranger
adümüwun	strategy
küna	straw
kelleñ	strawberry
wirin	streak
lolüm	stream
waria rüpü	street
yafüluwpeyüm	strength
ürkünduamün	stress
nükülün	stretch
kakunuduamfalai	strict
tükudüngulün	strike
pañilwedef	string
witrange	strip
weichan	strive
lefkontun	stroke
newenkechi	strong
traloftukuwlu	struck
fipipiel	structure
weichan	struggle
weichalen	struggling
ngeñikawün ngei	stubborn
tronkü	stuck
chilkatufe	student
chilkatun	study
chilkatun	studying
chemkün	stuff
afmatufal	stunning
weluzuam	stupid
adngel	style
nüwkülen	subject
amulün	submission
amultukun	submit
korü	substance
wentekonel	substitute
pellüf	subtle
rüf küme miyaupui	succeed
küme tripal	success
küme tripan	successful
ngepey	such
ka femngechi	such as
fochidün	suck
pürüm	sudden
lefkentu	suddenly
kutrankawün	suffer
kutrankawun	suffering
yochi	sufficient
kochilpeyüm	sugar
feipikunuafel	suggest
tükuduamün	suggestion
küpalün	suit
fürenefal	suitable
karpa	suitcase
doy tukulün	sum
afdüngu	summary
walüng	summer
wechuntu	summit
antü	sun
domingu antü	sunday
antülei	sunny
nagün antü	sunset
antü pelon	sunshine
ellangechi	super
ñidol	superior
doy wünelu	supervisor
yafütun	supper
elufal	supply
reküluwpekeyüm	support
trokintufiñ	suppose
trokintun	supposed
feipilelu	sure
püllü	surface
püramrumel	surge
allfeñkutran	surgery
chau üitun	surname
lloftunkechi	surprise
afmatulen	surprised
fentekünün	surrender
wallpülle düngu mew	surrounding
azkintuningen	surveillance
ramtuduamün	survey
mongeltun	survive
llüwaniefiñ	suspect
küllpüwkülen	suspended
kimngekelay	suspicious
nüniel	sustain
mongelepeyüm	sustainability
pürünngepel	sustainable
wewel kullin	swag
lümün	swallow
weluw elun	swap
akantun	swear
arof	sweat
chompa	sweater
lepün	sweep
kochi	sweet
kochike peuman	sweet dreams
illka	sweet tooth
poyen	sweetheart
künulpuran	swell
poypoyün	swelling
weyülün	swim
wuyülün	swimming
nengümpefiel	swing
kakünun	switch
poypoykülei	swollen
katrüwe	sword
wirinadentun	symbol
ngünayelün	sympathy
peufalkutran	symptoms
sistema	system
regtuwe	table
duamtungeal	tackle
üituntukun	tag
külen	tail
putü	take
yengekel	take away
kuñiutukuwün	take care
püntünentun	take off
nüniel	taken
dungun	talk
nütramkafe	talkative
füta püra	tall
paltrin	tap
pünawe	tape
duam	target
ruka küzau	task
kümentun	taste
kümentufali	tasty
kimeli	taught
té	tea
kimelün	teach
kimelfe	teacher
kelluwkechiche	team
külleñ	tear
külleñ	tears
piawülün	tease
tecnologia	technology
foro	teeth
feipin	tell
feypien	tell me
ñi femngekan	temper
chumlekel antü	temperature
trawupeyum che	temple
kürüftukumawünün	temporary
mari	ten
mari waranka	ten thousand
ngillapünenielu ruka	tenant
lapümün	tend
chum amulen	tendency
manaldungu	tender
yafüngechi	tense
trengkül	tension
winka küni	tent
ngünewün	tentative
nemel	term
püwülyepel	terms
llükafalün	terrible
ngünenad	terrific
mapu	territory
ramtunduam	test
wirintukun	text
chem	than
mañumtun	thank
chaltu may	thank you
mañumuyiwiñ tamü felen, fey petu iñ inatuzuamel ti elfan	Thank you for your patience while we investigate shipment
chaltu mai	thank you so much
chaltu mai	thank you very much
chaltu may	thanks
mañumuwiyiñ tamün pünefiel taiñ aplicación	Thanks for using our app
fey	that
feiti ngei	that is
küme felei	that's good
fey	the
weñengei	theft
tani pu	their
fei engün ngealu	them
troy	theme
fei engün müten	themselves
müchai	then
trokitunduam	theory
üyüw	there
mülei	there are
mülei	there is
fey mew	therefore
tüfa chi pu	these
feyengün	they
ngeingu	they are
fütarume	thick
weñefe	thief
llike	thigh
pichirume	thin
pu chemkün	thing
wezakelu	things
rakizuamün	think
külatroy	third
wüiwulechiche	thirsty
mari küla	thirteen
küla mari	thirty
tüfa	this
feita	this is
alüñmakelu	thorough
kuñiwünkecchi	thoroughly
tie chi pu	those
müchai	though
rakizuam	thought
rakiduamfe	thoughtful
rakizuam	thoughts
waranka	thousand
füw	thread
añelün	threat
añelün	threaten
küla	three
ülgiñ	threshold
rume ayïukülel	thrilled
wif amülün	thrive
pel	throat
fey mew	through
alütuwunmu	throughout
ütrüfentun	throw
changüll kuwü	thumb
tralkan	thunder
kueves antü	Thursday
famngechi	thus
wirintun	tick
wüyün	tide
kümelkakünul	tidy
puron	tie
nawel	tiger
norümkunuel	tight
Tigrinya dungun	Tigrinya
chumleken antü	time
yewenten	timid
prume püchilu	tiny
ngülam	tip
ngülamtun	tips
chünküd	tire
ürkün	tired
ngürekan	tissue
üitukunuel	title
meu	to
ngen	to be
kotün	toast
fachantü	today
pichi kona	toddler
changüll namun	toes
trawuleingün	together
tripatripawe	toilet
feipi	told
ñochiduamün	tolerance
küme yefalün	tolerate
tomaty	tomato
wüle	tomorrow
kewün	tongue
tüfa chi pun	tonight
feiti ka	too
nüi	took
küzaupeyüm	tool
küzaukepeyüm	tools
foro	tooth
wenu	top
dungu	topic
wechozün	torn
awükan	torture
kom	total
felman	touch
fanetufiñ	tough
miyauel	tour
püle	toward
üyew püle	towards
piwümüwpeyüm	towel
waria	town
ilelün	toxic
inantükun	trace
inapünon	track
fedengeken mu wezakelu	trade
rumel femngeken	tradition
kuifikimeluwün	traditional
apolechi rüpü	traffic
rüpü	trail
tren	train
kimelngepel	training
ad	trait
adngel	traits
elfaltuku kullinün	transfer
pichintuael	transition
rupadungun	translate
ailiñ	transparent
amupeyüm	transport
amupeyüm	transportation
wachi	trap
koküpu	trash
llükanchengewen	trauma
nampülkan	travel
füta rali	tray
ellkanfalin weshakelu	treasure
trafdünguntukünun	treat
adümkünulelel	treatment
aliwen	tree
fütrañma	tremendous
chum wechurpual	trend
azumazumtun	trial
ngünenkan	trick
küzautufui	tried
deumalel	trigger
katrüntukun	trim
nampülkan	trip
wesha zungu	trouble
chiripa	trousers
camión	truck
rüfke	true
pütrawün	trunk
manel	trust
rüfdungu	truth
rakiduamün ni femal	try
Tsonga dungun	Tsonga
rumekeyüm	tube
martes antü	Tuesday
wirintukukunün	tuition
pafu	turkey
cúrcuma	turmeric
müchamün	turn
peyu	turtle
ngünenielu	tutor
mari epu	twelve
epu mari	twenty
epu mari kiñe	twenty-one
Twi dungun	Twi
epu chi	twice
chiwüdün	twist
epu	two
reke	type
chumngen	typical
weda az	ugly
inalelu	ultimate
paraguas	umbrella
puwlai	unable
malle	uncle
kimwelan	unconscious
nageltu	under
miñche meu	underneath
falintunuel	underrated
kimtükun	understand
azümfiñ	understood
ngenopüda	unfortunately
trürüm takun	uniform
kiñel	unique
kiñewün	unit
füta chilkatuwe ruka	university
kimfalngelai	unknown
felenufule	unless
fentepun	until
pengekenuel	unusual
wenu	up
eimi tami piael	up to you
wengetual	update
külmelkatui	upgrade
wente	upon
weshaduamkületun	upset
wariache	urban
ngeñikawün ngen	urge
lelpe duam	urgent
iñchiñ ngeal	us
pünefal	use
deu pünengepel	used
duamyefalün	useful
ngenopüda	useless
fillkeantün	usual
felekefel düngu	usually
pünefal	utility
ürkütupeyüm antü	vacation
chikantulawenün	vaccination
pifwe tükun	vaccine
wellin	vacuum
küllikenulu	vague
fütaduampel	valid
laf mapu	valley
falintufel	valuable
falintu	value
itrofill	variety
müfü	various
ka künuwün	vary
tukungekemün pezkiñ	vase
ingaf	vast
tukukan	vegetable
tukukan	vegetables
miyaupeyüm	vehicle
wülniekelu chemkün	vendor
füñapuwe	venom
küzaukemum	venture
trünkolchepel	venue
pengelngeael	verify
fillke	versatile
versión	version
witral	vertical
rume	very
rume küme	very good
winka wampo	vessel
fei meu püle	via
rulpadungupeyüm	vibe
fillkenewen	vibes
wimtuwün	vicious
awukangeuma	victim
aukiñngechi ad	video
lelipeyüm	view
lofche	village
weda che	villain
kotrü chizko	vinegar
kuifi	vintage
kewan	violence
kewafe	violent
fillkepüle amulel	viral
welelu	virgin
peufalün	virtual
üitufalngen	virtue
pelon	vision
witran	visit
peufalün	visual
duamfali	vital
mongel	vivid
troyke nemel	vocabulary
dungun	voice
welli	void
alün	volume
kelluntukukelu	volunteer
rapitun	vomit
molkaluwfe	vulnerable
kullingeken	wage
kullingepel	wages
ankatrarituwe	waist
üngümün	wait
kona	waiter
üngümniel	waiting
nepen	wake
trepen	wake up
trekan	walk
trekalen	walking
chüfruka	wall
elküllinpeyüm	wallet
miaupüdan	wander
küpa	wanna
zuamtun	want
kintungepel	wanted
malon	war
elngekepeyüm takuluwün	wardrobe
tukungekemüm	warehouse
areley	warm
ngüneltun	warn
kimeldungun	warning
weichafe	warrior
amuy	was
küchatun	wash
ütrüfülün	waste
lelin	watch
ko	water
sandia	watermelon
rew	wave
chumleken	way
iñchiñ	we
ngeiñ	we are
pepi femaiñ	we can
newengelai	weak
ngewenngenuchi	weakness
ülmenngel	wealth
külfün	wealthy
püneael	wear
püneniel	wearing
chumleken antü	weather
mafün	wedding
miercoles antü	Wednesday
kachu	weed
semana	week
puwül chi semana	weekend
fanen	weight
kangentun	weird
küme akompayaimi	welcome
kümefeleael	welfare
Kümei	Well
küme femün	well done
amuy	went
mülepafui	were
gulümapu	west
kañkañkülel	wet
yene	whale
chem	what
chumimi am	what about you
chumpeymi	what are you doing
chumpeymi fewla	what are you doing now
chumekeimi feula	what are you doing right now
chumekeimi	what do you do
chumngechi mongeleimi	what do you do for a living
chem küpa pepi feipimi	what do you mean
chem duamimi	what do you want
chem dungu am	what happened
chem am	what is
chem anta tüfa	what is this
chemu küzaukeimi	what is your job
inei pingeimi	what is your name
chem dungu mülei	what's up
inei pingeimi	what's your name
chem rume fel	whatever
ketran	wheat
trünkai	wheel
chumül	when
chumül rume	whenever
chew	where
che müleimi	where are you
chew tuwüymi	where are you from
cheu müleimi feula	where are you now
chew müleimi	where do you live
cheu am	where is
petu	whereas
may	whether
chuchi	which
petu	while
wakeñün	whisper
wüikeñ	whistle
lig	white
inüy	who
inei am eimi	who are you
inei ngei	who is
inei ngei	who is this
kiñe kom	whole
inei ngeal	whom
inei ni chem	whose
chumngelu	why
chumngelu kai	why not
wechachegelu	wicked
müñan ngen	wide
lantun	widow
tunte rumen	width
kure	wife
awka	wild
pilen	will
fente ñi küpafemün	willing
wewael	win
kürüf	wind
kompapelonam	window
kürüftukün	windy
puku	wine
pukem	winter
liftun	wipe
maun	wire
kimün	wisdom
kim che	wise
küpa	wish
peumangen kümelkaleaimi	wish you all the best
kalku	witch
engu	with
nentukunutuael	withdraw
nentutun	withdrawal
ponwi	within
nienun	without
pentukulu dungu	witness
azümüluwkelu	witty
lame	wolf
domo	woman
domo	women
wewi	won
amulayai	won't
ramtuwün	wonder
afmatufali	wonderful
mamüll	wood
kallüfsha	wool
troy dungu	word
nemel	words
küzawün	work
zeumangeal	work out
küzaukülen	working
wallmapun	world
piru	worm
deu püneyel	worn
fiñmawkülen	worried
pellkelun	worry
wedakünuel	worse
doy kimlu	worship
ti zoy weza	worst
falilün	worth
ngüneduamfali	worth it
falintu	worthy
Zeumayafui	would
allfeñ	wound
awem	Wow
impolün	wrap
fofoillkun	wrath
yüwülkuwü	wrist
wiri	write
wiringe fau	Write here
wirin	writing
wirintukün	written
welunkan	wrong
wirintukui	wrote
wülngiñ	yard
üngapün	yawn
may	Yeah
tripantu	year
tripantu	years
levadura	yeast
wirarün	yell
choz	yellow
may	Yes
mai, pichiche	yes baby
mai, poyen	yes dear
may, poyen	yes honey
mai, tañi piukeyel	yes my love
mai, feleai	yes of course
wiya	yesterday
petu	yet
wülün	yield
eymi	you
eimi ngeimi	you are
ellangechi ngeimi	you are beautiful
ellangechi ngeimi	you are so beautiful
dungunufel	you are welcome
pepi deumaimi	you can
kimimi	You know
eimi ka	you too
zungu nu	you're welcome
weche	young
tami	your
dungunu	your welcome
eimi müten	yourself
wechengel	youth
dungu nu	you’re welcome
illufali	yummy
chem no rume	zero
