পৰিত্যাগ	abandon
সক্ষমতা	ability
সক্ষম	able
বিষয়ে	about
ওপৰত	above
অনুপস্থিতি	absence
অনুপস্থিত	absent
নিৰ্ঘাত	absolutely
বিমূৰ্ত	abstract
অযুক্তিকৰ	absurd
পৰ্যাপ্ত	abundance
প্ৰচুৰ	abundant
অপব্যৱহাৰ	abuse
উচ্চাৰণ	accent
প্ৰৱেশাধিকাৰ	access
দুৰ্ঘটনা	accident
বাসস্থান	accommodation
সম্পূৰ্ণ	accomplish
নিপুণ	accomplished
অনুসৰি	according
একাউণ্ট	account
শুদ্ধতা	accuracy
সঠিক	accurate
অভিযুক্ত	accused
বিষ	ache
প্ৰাপ্তি	achievement
আঁকুৱালি	acquire
অৰ্জিত	acquired
অধিগ্ৰহণ	acquisition
অভিনয়	act
সক্ৰিয়	active
কাৰ্যকলাপ	activities
কাৰ্যকলাপ	activity
অভিনেতা	actor
আচল	actual
আচলতে	actually
সূক্ষ্ম	acute
নিচাসক্ত	addicted
যোগ	addition
অতিৰিক্ত	additional
ঠিকনা	address
পৰ্যাপ্ত	adequate
পাৰ্শ্বৱৰ্তী	adjacent
বিশেষণ	adjective
মৰমলগা	adorable
আগতীয়া	advance
সুবিধা	advantage
এডভেঞ্চাৰ	adventure
বিজ্ঞাপন	advertisement
বিজ্ঞাপন	advertising
পৰামৰ্শ	advice
উকীল	advocate
বেপাৰ	affair
স্নেহ	affection
সুলভ	affordable
পাছত	after
আবেলি	afternoon
পাছত	afterwards
পুনৰ	again
বিৰুদ্ধে	against
বয়স	age
এজেন্সী	agency
এজেণ্ট	agent
আক্ৰমণাত্মক	aggressive
চঞ্চল	agile
আগতে	ago
সহমত	agree
চুক্তি	agreement
কৃষি	agriculture
সাহায্য	aid
লক্ষ্য	aim
বতাহ	air
বিমান-বন্দৰ	airport
সতৰ্কবাৰ্তা	alarm
সুৰা	alcohol
সতৰ্ক	alert
অলপমান	a little
জীৱন্ত	alive
আটাইবোৰ	all
প্ৰায়	almost
অকলশৰীয়া	alone
একেলগে	along
অনেক	a lot
বহুত	a lot of
ইতিমধ্যে	already
লগতে	also
বিকল্প	alternative
যদিও	although
সদায়	always
আশ্চৰ্যজনক	amazing
অস্পষ্ট	ambiguous
উচ্চাকাংক্ষা	ambition
সংশোধন	amend
মাজত	amid
মাজত	among
পৰিমাণ	amount
আমোদজনক	amusing
বিশ্লেষণ	analysis
পূৰ্বপুৰুষ	ancestors
লংগৰ	anchor
পৌৰাণিক	ancient
আৰু	and
পৰী	angel
খং	anger
কোণ	angle
খঙাল	angry
জন্তু	animal
গোৰোহা	ankle
বাৰ্ষিকী	anniversary
ঘোষণা	announcement
বিৰক্ত	annoy
আমনিদায়ক	annoying
বছেৰেকীয়া	annual
নামহীন	anonymous
উত্তৰ	answer
পূৰ্বানুমান	anticipate
উদ্বেগ	anxiety
উদ্বিগ্ন	anxious
যিকোনো	any
আৰু	anymore
যিকোনো	anything
পৃথক	apart
এপাৰ্টমেণ্ট	apartment
প্ৰতীয়মান	apparent
আপাতদৃষ্টিত	apparently
আপীল	appeal
ৰূপ	appearance
ভোক	appetite
আপেল	apple
দৰ্খাস্ত	application
সাক্ষাত্‍কাৰ	appointment
পদ্ধতি	approach
যথাযথ	appropriate
অনুমোদন	approval
অনুমোদন	approve
অনুমোদিত	approved
অনুমানিক	approximately
এপ্ৰিল	april
স্বেচ্ছাচাৰী	arbitrary
স্থপতিবিদ	architect
স্থাপত্য	architecture
পুৰালেখ	archive
এলাকা	area
তৰ্কাতৰ্কি	argument
উঠা	arise
বাহু	arm
আৰ্মি	army
চাৰিওফালে	around
সজোৱা	arrange
ব্যৱস্থা	arrangement
আগমন	arrival
আগমন	arrive
অহংকাৰী	arrogant
কাঁড়	arrow
কলা	art
অনুচ্ছেদ	article
কৃত্ৰিম	artificial
শিল্পী	artist
যেনেকৈ	as
ছাই	ash
সোধা	ask
সুধিছিল	asked
দিশ	aspect
অসমীয়া	Assamese
আক্ৰমণ	assault
সদন	assembly
নিশ্চয়াত্মক	assertive
মূল্যায়ন	assessment
সম্পত্তি	asset
সম্পত্তিসমূহ	assets
সাহায্য	assist
সহায়ক	assistant
সহযোগী	associate
সংস্থা	association
ধাৰণা	assumption
লগতে	as well
লগতে	as well as
খাইছিল	ate
ক্ৰীড়াবিদ	athlete
সংলগ্নক	attachment
আক্ৰমণ	attack
উপস্থিতি	attendance
আচৰণ	attitude
আকৰ্ষণ	attract
আকৰ্ষণ	attraction
আকৰ্ষণীয়	attractive
বৈশিষ্ট্য	attribute
দৰ্শক	audience
আগষ্ট	august
খুড়ী	aunt
খুড়ী	aunty
পেহী	aunty
মাহী	aunty
প্ৰামাণিক	authentic
লিখক	author
কতৃপক্ষ	authority
শৰত্‍	autumn
উপলব্ধ	available
গড়	average
পুৰস্কাৰ	award
জ্ঞাত	aware
সচেতনতা	awareness
আঁতৰত	away
বিস্ময়কৰ	awesome
ভয়াবহ	awful
আইমাৰা	Aymara
কেঁচুৱা	baby
পিছলৈ	back
পৃষ্ঠভূমি	background
বেয়া	bad
মোনা	bag
প্রলোভন	bait
সিজোৱা	bake
বেকাৰী	bakery
বল	ball
বংবাৰা	Bambara
কল	banana
বেণ্ড	band
ধমাকা	bang
বেংক	bank
বাৰ	bar
কোনোমতে	barely
বাকলি	bark
বাৰ্লী	barley
বাধা	barrier
ভেঁটি	base
ভিত্তিত	based
বেছমেণ্ট	basement
প্ৰাথমিক	basic
মূলতঃ	basically
তুলসী	basil
জাৰজ	bastard
বেটছ	batch
স্নান	bath
স্নানাগাৰ	bathroom
বেটাৰি	battery
যুদ্ধ	battle
উপসাগৰ	bay
হওক	be
আলোকৰশ্মি	beam
বীন	beans
ভালুক	bear
দাড়ি	beard
জন্তু	beast
ধুনীয়া	beautiful
সৌন্দৰ্য	beauty
হৈছিল	became
কাৰণ	because
হওক	become
বিছনা	bed
মৌমাখি	bee
গোমাংস	beef
বীয়েৰ	beer
আগতে	before
আৰম্ভণি	beginning
হৈ	behalf
আচৰণ	behave
ব্যৱহাৰ	behavior
আচৰণ	behaviour
পিছফালে	behind
বিশ্বাস	belief
বিশ্বাস	believe
পেট	belly
অন্তৰ্গত	belong
মৰমৰ	beloved
তলত	below
বেঞ্চ	bench
তলত	beneath
লাভ	benefit
লাভসমূহ	benefits
কাষত	beside
তাৰোপৰি	besides
সৰ্বোত্তম	best
শুভেচ্ছাৰে	best regards
উত্তম	better
মাজত	between
পানীয়	beverage
ভোজপুৰী	Bhojpuri
পক্ষপাত	bias
চাইকেল	bicycle
নিবিদা	bid
ডাঙৰ	big
মটৰচাইকেল	bike
বিল	bill
বন্ধা	bind
চৰাই	bird
জন্মদিন	birthday
কামোৰ	bite
তিতা	bitter
ক’লা	black
ব্লেড	blade
খালী	blank
কম্বল	blanket
ফুটা	blast
ব্লীচ	bleach
অন্ধ	blind
আশীৰ্বাদ	bliss
তেজ	blood
নীলা	blue
ভোটা	blunt
ব’ৰ্ড	board
নাও	boat
শৰীৰ	body
উতলোৱা	boil
সাহসী	bold
বান্ধোন	bond
হাড়	bone
কিতাপ	book
প্ৰচাৰক	booster
বুটজোতা	boot
বুটজোতা	boots
সীমান্ত	border
বিৰক্তিকৰ	boring
বছ	boss
উভয়	both
বটল	bottle
তলি	bottom
অনা	bought
জঁপিওৱা	bounce
বাধ্যতা	bound
সীমা	boundaries
ধেনু	bow
বাতি	bowl
বাকচ	box
ল’ৰা	boy
প্ৰেমিক	boyfriend
মগজ	brain
শাখা	branch
ব্ৰেণ্ড	brand
সাহসী	brave
উলংঘন	breach
লোফ	bread
ভঙা	break
বুকু	breast
উশাহ	breath
শ্বাস-প্ৰশ্বাস	breathe
বংশবৃদ্ধি	breed
ইটা	brick
কইনা	bride
সেঁতু	bridge
চমু	brief
উজ্বল	bright
উজ্বল	brilliant
অনা	bring
ভাই	bro
বহল	broad
সম্প্ৰচাৰ	broadcast
ভগা	broke
ভগা	broken
ঝাড়ু	broom
ভাই	brother
ভিনদেউ	brother in law
আনিছিল	brought
মটিয়া	brown
বাছ	brush
বাল্টি	bucket
সমনীয়া	buddy
বাজেট	budget
পোক	bug
নিৰ্মাণ	build
ভৱন	building
নিৰ্মিত	built
ষাঁড়	bull
উত্‍পীড়ন	bully
উখহা	bump
মুঠি	bunch
বাণ্ডিল	bundle
বোজা	burden
জ্বলা	burn
বিস্ফোৰণ	burst
পোতা	bury
বাছ	bus
জোপোহা	bush
ব্যৱসায়	business
বুকু	bust
ব্যস্ত	busy
কিন্তু	but
মাখন	butter
পখিলা	butterfly
বুটাম	button
দ্বাৰা	by
বিদায়	bye
বন্ধাকবি	cabbage
কেবিনেট	cabinet
সঁজা	cage
পিঠা	cake
শান্ত	calm
আহিছিল	came
অভিযান	campaign
পাৰে	can
কৰ্কট	cancer
নোৱাৰে	can't
সক্ষম	capable
ক্ষমতা	capacity
ৰাজধানী	capital
শিৰোনাম	caption
বাহন	car
কেৰিয়াৰ	career
সাৱধান	careful
সতৰ্কতাৰে	carefully
অসাৱধান	careless
কাঠমিস্ত্ৰী	carpenter
দলিচা	carpet
গাজৰ	carrot
কঢ়িওৱা	carry
ঘটনা	case
নগদ	cash
ঢলা	cast
দুৰ্গ	castle
নৈমিত্তিক	casual
মেকুৰী	cat
ধৰা	catch
শ্ৰেণী	category
গৰু	cattle
কাৰণ	cause
সাৱধান	caution
সতৰ্ক	cautious
গুহা	cave
সমাপ্তি	cease
চিলিং	ceiling
উদযাপন	celebrate
কোষ	cell
কেন্দ্ৰ	center
শতিকা	century
উপলক্ষ	ceremony
নিৰ্দিষ্ট	certain
নিশ্চিতভাৱে	certainly
প্ৰমাণপত্ৰ	certificate
শিকলি	chain
চকী	chair
প্ৰত্যাহবান	challenge
সুযোগ	chance
বিশৃংখলতা	chaos
চৰিত্ৰ	character
বৈশিষ্ট্যসমূহ	characteristics
চাৰ্জ	charge
পৰোপকাৰ	charity
কমনীয়	charming
তালিকা	chart
খেদা	chase
চাট	chat
সস্তীয়া	cheap
ঠগা	cheat
ঠগা	cheating
গাল	cheek
উল্লাস	cheer
হাঁহিমুখীয়া	cheerful
চীয়েৰ্ছ	cheers
চীজ	cheese
দবা	chess
বুকু	chest
চোবোৱা	chew
কুকুৰা	chicken
প্ৰধান	chief
শিশু	child
শিশুকাল	childhood
শিশু	children
ঠাণ্ডা	chill
চিমনি	chimneys
থুঁতৰি	chin
চকলেট	chocolate
পচন্দ	choice
কটা	chop
কাজকৰ্ম	chores
শকত	chubby
গীৰ্জা	church
দালচেনী	cinnamon
বৃত্ত	circle
পৰিস্থিতি	circumstances
নাগৰিক	citizen
চহৰ	city
শ্ৰেণী	class
পৰিষ্কাৰ	clean
পৰিষ্কাৰ	clear
পিয়ন	clerk
টেঙৰ	clever
গ্ৰাহক	client
শিল	cliff
জলবায়ু	climate
বগোৱা	climb
ঘড়ী	clock
বন্ধ	close
আলমাৰি	closet
পোছাক	cloth
কাপোৰ	clothes
ডাৱৰ	cloud
ডাৱৰীয়া	cloudy
বহুৱা	clown
সূত্ৰ	clue
অনাড়ম্বৰ	clumsy
গুচ্ছ	cluster
প্ৰশিক্ষক	coach
কয়লা	coal
উপকূল	coast
কোট	coat
কফি	coffee
জ্ঞানভিত্তিক	cognitive
কাকতালীয়	coincidence
ঠাণ্ডা	cold
কলাৰ	collar
সহকৰ্মী	colleague
সহকৰ্মীসকল	colleagues
সংগ্ৰহ	collect
সংগ্ৰহ	collection
মহাবিদ্যালয়	college
ৰং	color
ৰং	colour
স্তম্ভ	column
ফণী	comb
সংমিশ্ৰণ	combination
আহক	come
আৰাম	comfort
আৰামদায়ক	comfortable
আদেশ	command
মন্তব্য	comment
বাণিজ্যিক	commercial
অংগীকাৰ	commitment
প্ৰতিশ্ৰুতিবদ্ধ	committed
পণ্য	commodity
সাধাৰণ	common
যোগাযোগ	communicate
যোগাযোগ	communication
সমুদায়	community
অহাযোৱা	commute
সংগী	companion
কোম্পানী	company
কৰুণা	compassion
সহানুভূতিশীল	compassionate
উপযুক্ত	compatible
প্ৰতিযোগিতা	compete
সক্ষম	competent
প্ৰতিযোগিতা	competition
প্ৰতিযোগিতামূলক	competitive
গোচৰ	complaint
পৰিপূৰক	complement
সম্পূৰ্ণ	completely
জটিল	complex
অনুবৰ্তী	compliance
জটিল	complicated
প্ৰশংসা	compliment
সুৰ-ৰচনা	composition
যৌগ	compound
বোধগম্যতা	comprehension
বিস্তৃত	comprehensive
বাধ্যতামূলক	compulsory
কম্পিউটাৰ	computer
ধাৰণা	concept
উদ্বেগ	concern
চিন্তিত	concerned
সংগীতানুষ্ঠান	concert
উপসংহাৰ	conclusion
কংক্ৰিট	concrete
পৰিস্থিতি	condition
পৰিস্থিতি	conditions
ব্যৱহাৰ	conduct
সন্মিলন	conference
আত্মবিশ্বাস	confidence
আত্মবিশ্বাসী	confident
নিশ্চিত	confirm
বিবাদ	conflict
বিভ্ৰান্ত	confused
খেলিমেলি	confusion
অভিনন্দন	congrats
অভিনন্দন	congratulation
অভিনন্দন	congratulations
সংযোগ	conjunction
চেতনা	conscious
চেতনা	consciousness
অনুমতি	consent
পৰিণামবোৰ	consequences
সংৰক্ষণ	conservation
ৰক্ষণশীল	conservative
বিবেচিত	considered
গঠিত	consist
স্থিৰতা	consistency
অবিচলিত	consistent
নেৰানেপেৰা	constant
নিৰন্তৰ	constantly
কোষ্ঠকাঠিন্য	constipation
নিৰ্মাণ	construction
সেৱন	consumption
সংক্ৰামক	contagious
অন্তৰ্ভুক্ত	contain
সমসাময়িক	contemporary
অৱমাননা	contempt
বিষয়	content
প্ৰতিযোগিতা	contest
সন্দৰ্ভ	context
মহাদেশ	continent
চুক্তি	contract
বিষমতা	contrast
অৱদান	contribution
নিয়ন্ত্ৰণ	control
বিবাদগ্ৰস্ত	controversial
সুবিধা	convenience
সুবিধাজনক	convenient
কথা-বাৰ্তা	conversation
ৰূপান্তৰ	convert
ৰন্ধা	cook
ৰন্ধা	cooking
ঠাণ্ডা	cool
সহযোগ	cooperation
তাম	copper
মুখ্য	core
মাকৈ	corn
চুক	corner
শুদ্ধ	correct
খৰচ	cost
পোছাক	costume
কটেজ	cottage
কপাহ	cotton
শয্যা	couch
কাহ	cough
পৰিষদ	council
বিৰোধ	counter
দেশ	country
গ্ৰাম্যঅঞ্চল	countryside
দম্পতি	couple
সাহস	courage
ধাৰা	course
আদালত	court
ভদ্ৰতা	courtesy
পেহী	cousin
মামা	cousin
মাহী	cousin
আৱৰণ	cover
গাই	cow
ভয়াতুৰ	coward
আৰামদায়ক	cozy
কেঁকোৰা	crab
ফাঁট	crack
শিল্প	craft
বিষ্ঠা	crap
ভোক	craving
বলিয়া	crazy
সৃষ্টিশীল	creative
কৃতিত্ব	credit
অধম	creep
ভয়ংকৰ	creepy
দল	crew
অপৰাধ	crime
বিপদ	crisis
চৰ্ত	criteria
সমালোচনা	criticism
শস্য	crop
শস্য	crops
কাউৰী	crow
ভিৰ	crowd
মুকুট	crown
গুৰুত্বপূৰ্ণ	crucial
নিষ্ঠুৰ	cruel
ক্ৰুজ	cruise
কন্দা	cry
তিঁয়হ	cucumber
সংস্কৃতি	culture
টেঙৰ	cunning
কাপ	cup
আলমাৰী	cupboard
প্ৰতিবন্ধক	curb
আৰোগ্য	cure
অনুসন্ধিত্‍সা	curiosity
কৌতূহলী	curious
কেকোঁৰা	curly
মুদ্ৰা	currency
সোঁত	current
বৰ্তমান	currently
অভিশাপ	curse
পৰ্দা	curtain
কুশ্বন	cushion
গ্ৰাহক	customer
কটা	cut
মৰমলগা	cute
চক্ৰ	cycle
দেউতা	dad
দেউতা	daddy
দৈনিক	daily
দুগ্ধজাত	dairy
বাঁধ	dam
ক্ষতি	damage
সেমেকা	damp
নৃত্য	dance
বিপদ	danger
বিপদজনক	dangerous
অন্ধকাৰ	dark
মৰমৰ	darling
ছিটিকনি	dash
তথ্য	data
তাৰিখ	date
জীয়েক	daughter
দিন	day
মৃত	dead
সময়সীমা	deadline
বধিৰ	deaf
চুক্তি	deal
মৰমৰ	dear
মৃত্যু	death
তৰ্ক	debate
খৰচ	debit
ধ্বংসাবশেষ	debris
ধাৰ	debt
দশক	decade
মৃত	deceased
প্ৰতাৰণা	deceive
ডিচেম্বৰ	december
শালীন	decent
সিদ্ধান্ত	decision
ডেক	deck
নিম্নগামী	decrease
নিবেদিত	dedicated
একাগ্ৰতা	dedication
কৰ্ম	deed
গভীৰ	deep
হৰিণা	deer
ডিফল্ট	default
হৰুওৱা	defeat
প্ৰতিৰক্ষা	defend
নিশ্চিতভাৱে	definitely
সংজ্ঞা	definition
ডিগ্ৰী	degree
বিলোপ	delete
ইচ্ছাকৃত	deliberate
কোমল	delicate
সুস্বাদু	delicious
আনন্দ	delight
আনন্দিত	delighted
গণতন্ত্ৰ	democracy
ৰাক্ষস	demon
প্ৰদৰ্শন	demonstrate
ঘনত্ব	density
বিভাগ	department
প্ৰস্থান	departure
নিৰ্ভৰ	depend
জমা	deposit
উদাস	depression
গভীৰতা	depth
বিৱৰণ	description
মৰুভূমি	desert
প্ৰাপ্য	deserve
ডিজাইন	design
পদবী	designation
আকাংক্ষা	desire
ডেস্ক	desk
হতাশা	despair
হতাশ	desperate
সত্বেও	despite
মুখৰুচক	dessert
গন্তব্যস্থান	destination
ভাগ্য	destiny
ধ্বংস	destruction
বিৱৰণ	detail
সবিশেষ	details
সংকল্প	determination
নিৰূপিত	determined
বিধ্বস্ত	devastated
বিকশিত	developed
বিকাশ	development
ডিভাইচ	device
চয়তান	devil
সমৰ্পিত	devoted
দিৱেহী	Dhivehi
ডায়েবিটিছ	diabetes
ডায়েৰিয়া	diarrhea
ডায়েৰী	diary
অভিধান	dictionary
কৰিছিল	did
খাদ্য	diet
পাৰ্থক্য	difference
অন্য	different
কঠিন	difficult
মৰ্যাদা	dignity
পৰিশ্ৰমী	diligent
পোনপটীয়া	direct
দিশ	direction
নিৰ্দেশক	director
ময়লা	dirt
লেতেৰা	dirty
অক্ষম	disable
অদৃশ্য	disappear
নিৰাশ	disappointed
দুৰ্যোগ	disaster
নিয়মানুৱৰ্তিতা	discipline
ৰেহাই	discount
বৈষম্য	discrimination
আলোচনা	discussion
ৰোগ	disease
ৰোগসমূহ	diseases
ছদ্মৱেশ	disguise
ঘৃণা	disgusting
থালী	dish
কাঁহী	dishes
বৰ্খাস্ত	dismiss
পঠিওৱা	dispatch
প্ৰদৰ্শন	display
নিষ্পত্তি	disposal
বিতৰক	dispute
দূৰত্ব	distance
নিৰ্দিষ্ট	distinct
বেদনা	distress
বিতৰণ	distribution
জিলা	district
নলা	ditch
বিচিত্ৰ	diverse
অনৈক্য	diversity
আধ্যাত্মিক	divine
কৰক	do
ডাক্তৰ	doctor
নথিপত্ৰ	document
কৰে	does
নহয়	doesn't
কুকুৰ	dog
ডোগৰী	Dogri
পুতলা	doll
ডমেইন	domain
ঘৰুৱা	domestic
প্ৰভাৱশালী	dominant
গাধ	donkey
নকৰিব	don't
মূৰ্খ	dope
দুগুণ	double
সন্দেহ	doubt
তললৈ	down
ডাউনল’ড	download
খচৰা	draft
নলা	drain
নাটক	drama
অঁকা	draw
ড্ৰয়াৰ	drawer
ভয়	dread
সপোন	dream
পোছাক	dress
খন্দা	drill
চলোৱা	drive
টোপাল	drop
খৰ	drought
নিচাসক্ত	drunk
শুকান	dry
হাঁহ	duck
ল’ৰা	dude
দেয়	due
কাৰণে	due to
নিস্তেজ	dull
বোবা	dumb
ভাণ্ডাৰ	dump
সময়কাল	duration
ধুলি	dust
দায়িত্ব	duty
প্ৰতিটো	each
পৰস্পৰক	each other
আগ্ৰহী	eager
ঈগল	eagle
কাণ	ear
পূৰ্বতে	earlier
আগতীয়া	early
কাণ	ears
পৃথিৱী	earth
ভূমিকম্প	earthquake
সহজে	ease
সহজে	easily
পূব	east
সহজ	easy
খোৱা	eat
খোৱা	eating
অৰ্থনৈতিক	economic
অৰ্থনীতি	economy
প্ৰান্ত	edge
শিক্ষা	education
প্ৰভাৱ	effect
কাৰ্যকৰী	effective
দক্ষতা	efficiency
দক্ষ	efficient
চেষ্টা	effort
কণী	egg
বেঙেনা	eggplant
অহং	ego
আঠ	eight
ওঠৰ	eighteen
আশী	eighty
সম্প্ৰসাৰিত	elaborate
কিলাকুটী	elbow
জ্যেষ্ঠ	elder
জ্যেষ্ঠ	elderly
সুন্দৰ	elegant
উপাদান	element
হাতী	elephant
এঘাৰ	eleven
যোগ্য	eligible
নিষ্কাশন	eliminate
আবির্ভূত	emerge
জৰুৰীকালীন	emergency
আবেগিক	emotional
সহানুভুতি	empathy
কৰ্মচাৰী	employee
কৰ্মচাৰী	employees
নিয়োগকৰ্তা	employer
কৰ্মসংস্থান	employment
খালী	empty
সমাপ্ত	end
বিপন্ন	endangered
প্ৰচেষ্টা	endeavor
ধৈৰ্য	endurance
শত্ৰু	enemy
শক্তি	energy
জড়িত	engaged
ব্যস্ততা	engagement
ইঞ্জিন	engine
অভিযন্তা	engineer
ইংৰাজী	English
বৃহত্‍	enormous
পৰ্যাপ্ত	enough
বিনোদন	entertainment
উত্‍সাহ	enthusiasm
উত্‍সাহী	enthusiastic
সমগ্ৰ	entire
সত্তা	entity
প্ৰৱেশদ্বাৰ	entrance
উদ্যোগী	entrepreneur
খাম	envelope
পৰিৱেশ	environment
ঈৰ্ষা	envy
মহাকাব্য	epic
মহামাৰী	epidemic
সমান	equal
সঁজুলি	equipment
ন্যায়	equity
সমান্তৰাল	equivalent
ৰবৰ	eraser
আঁসোৱাহ	error
পলোৱা	escape
বিশেষকৈ	especially
ৰচনা	essay
সাৰাংশ	essence
আৱশ্যকীয়	essential
স্থাপিত	established
সম্পত্তি	estate
অনুমানিক	estimate
অনুমানিক	estimated
আদি	etc
চিৰদিনীয়া	eternal
নীতি	ethics
মূল্যায়ন	evaluation
যুগ্ম	even
সন্ধিয়া	evening
কাৰ্যক্ৰম	event
তথাপিও	even though
অৱশেষত	eventually
কেতিয়াবা	ever
প্ৰত্যেক	every
সকলো	everybody
সকলো	everyone
সকলো	everything
প্ৰমাণ	evidence
অশুভ	evil
এবৈ	Ewe
পূৰ্ব	ex
সঠিক	exact
পৰীক্ষা	exam
উদাহৰণ	example
ব্যতিক্ৰম	exception
অতিমাত্ৰা	excess
অতিৰিক্ত	excessive
বিনিময়	exchange
উত্তেজনা	excitement
ৰোমাঞ্চকৰ	exciting
একচেটিয়া	exclusive
কাৰ্যবাহী	executive
ব্যায়াম	exercise
নিষ্কাশন	exhaust
ক্লান্ত	exhausted
প্ৰদৰ্শন	exhibit
প্ৰদৰ্শনী	exhibition
উপলব্ধ	exist
অস্তিত্ব	existence
বিদ্যমান	existing
প্ৰস্থান	exit
খৰচ	expenses
দামী	expensive
অভিজ্ঞতা	experience
পৰীক্ষণ	experiment
বিশেষজ্ঞ	expert
ব্যাখ্যা	explanation
শোষণ	exploit
ৰপ্তানি	export
উন্মুক্ত	expose
উদঙোৱা	exposed
অনাবৃত	exposure
অভিব্যক্তি	expression
প্ৰসাৰিত	extend
বৰ্ধিত	extended
বিস্তাৰ	extension
বাহ্যিক	external
লুপ্ত	extinct
অতিৰিক্ত	extra
অসাধাৰণ	extraordinary
চৰম	extreme
অত্যন্ত	extremely
চকু	eye
চকু	eyes
ফেব্ৰিক	fabric
অবিশ্বাস্য	fabulous
চেহেৰা	face
সুবিধাসমূহ	facilities
সুবিধা	facility
তথ্য	fact
কাৰক	factor
ফেক্টৰী	factory
তথ্যসমূহ	facts
মেলা	fair
নিৰপেক্ষভাৱে	fairly
পৰী	fairy
ভৰসা	faith
বিশ্বাসী	faithful
ভুৱা	fake
মিছা	false
খ্যাতি	fame
চিনাকি	familiar
পৰিয়াল	family
দুৰ্ভিক্ষ	famine
বিখ্যাত	famous
পাংখা	fan
ফেন্সী	fancy
চমত্‍কাৰ	fantastic
দূৰ	far
বিদায়	farewell
খেতি	farm
খেতিয়ক	farmer
আকৰ্ষণীয়	fascinating
ফেশ্বন	fashion
বেগাই	fast
শকত	fat
প্ৰাণঘাতক	fatal
ভাগ্য	fate
পিতৃ	father
ভাগৰ	fatigue
দোষ	fault
প্ৰিয়	favorite
পক্ষপাত	favour
প্ৰিয়	favourite
ভয়	fear
ভোজ	feast
পাখি	feather
বৈশিষ্ট্য	feature
বৈশিষ্ট্যসমূহ	features
ফেব্ৰুৱাৰী	february
মাচুল	fee
ভোজন	feed
মতামত	feedback
অনুভৱ	feeling
ফুট	feet
সহকৰ্মী	fellow
মহিলা	female
বেৰা	fence
উৰ্বৰ	fertile
উত্‍সৱ	festival
জ্বৰ	fever
বাগদত্তা	fiance
কল্পকাহিনী	fiction
ক্ষেত্ৰ	field
ভয়ংকৰ	fierce
পোন্ধৰ	fifteen
পঞ্চাছ	fifty
কাজিয়া	fight
শৰীৰ	figure
ফাইল	file
পূৰ্ণ	fill
চলচ্চিত্ৰ	film
লেতেৰা	filthy
অৱশেষত	finally
বিত্ত	finance
অৰ্থনৈতিক	financial
জৰিমনা	fine
আঙুলি	finger
সমাপ্ত	finish
অগ্নি	fire
দৃঢ়	firm
প্ৰথম	first
মাছ	fish
পাঁচ	five
নিৰ্ধাৰিত	fixed
পতাকা	flag
চমক	flash
চেপেটা	flat
নিখুঁত	flawless
মাংস	flesh
নমনীয়	flex
নমনীয়	flexible
উৰাজাহাজ	flight
জোকোৱা	flirting
বানপানী	flood
মজিয়া	floor
ময়দা	flour
ফুল	flower
বাকপটু	fluent
সাৱলীলভাৱে	fluently
জুলীয়া	fluid
উৰা	fly
কুঁৱলী	fog
ভাঁজ	fold
বান্ধৱসকল	folks
নিম্নলিখিত	following
আহাৰ	food
মূৰ্খ	fool
মুৰ্খতা	foolish
ফুট	foot
ফুটবল	football
বাবে	for
নিষিদ্ধ	forbidden
বল	force
পুৰ্বানুমান	forecast
কপাল	forehead
বিদেশী	foreign
অৰণ্য	forest
চিৰদিন	forever
পাহৰা	forget
পাহৰিছিল	forgot
উদাহৰণস্বৰূপে	for instance
প্ৰপত্ৰ	form
আনুষ্ঠানিক	formal
পূৰ্বৰ	former
সৌভাগ্যক্ৰমে	fortunately
সৌভাগ্য	fortune
চল্লিশ	forty
বিয়াল্লিশ	forty-two
আগলৈ	forward
ভেঁটি	foundation
চাৰি	four
চৈধ্য	fourteen
শিয়াল	fox
ভঙ্গুৰ	fragile
ফ্ৰেম	frame
ফ্ৰেমৱৰ্ক	framework
প্ৰৱঞ্চনা	fraud
পাগল	freak
বিনামূলীয়া	free
স্বাধীনতা	freedom
ফ্ৰীজ	freeze
কম্পনাংক	frequency
সঘনাই	frequent
সঘনাই	frequently
সতেজ	fresh
শুক্ৰবাৰ	friday
ফ্ৰীজ	fridge
বন্ধু	friend
বন্ধুসুলভ	friendly
বন্ধুসকল	friends
বন্ধুত্ব	friendship
শংকিত	frightened
ভয়াৱহ	frightening
ভেকুলী	frog
পৰা	from
সন্মুখৰ	front
হিমায়িত	frozen
ফল	fruit
নিৰাশা	frustrated
ইন্ধন	fuel
ফুলফুল্দে	Fulfulde
সম্পূৰ্ণ	full
আনন্দ	fun
অনুষ্ঠান	function
মৌলিক	fundamental
জমনি	funny
নোম	fur
অগ্নিশৰ্মা	furious
আচবাব	furniture
আগলৈ	further
তদুপৰি	furthermore
ভৱিষ্যত	future
খেল	game
গেপ	gap
গেৰেজ	garage
আৱৰ্জনা	garbage
বাগিছা	garden
নহৰু	garlic
গেট	gate
গোটোৱা	gather
সমাবেশ	gathering
দিছিল	gave
গিয়েৰ	gear
লিংগ	gender
সাধাৰণ	general
সাধাৰণতে	generally
প্ৰজন্ম	generation
দয়ালু	generous
প্ৰতিভা	genius
ধাৰা	genre
ভদ্ৰ	gentle
প্ৰকৃত	genuine
ভংগীমা	gesture
পাওক	get
উঠা	get up
ভুত	ghost
দৈত্য	giant
উপহাৰ	gift
আদা	ginger
ছোৱালী	girl
প্ৰেমিকা	girlfriend
দিয়া	give
আনন্দিত	glad
দৃষ্টি	glance
গিলাছ	glass
চশমা	glasses
আভাস	glimpse
সাৰ্বজনীন	global
ডাৱৰীয়া	gloomy
হাতমোজা	gloves
উজ্জ্বলতা	glow
আঠা	glue
যাওক	go
আগবাঢ়ক	go ahead
লক্ষ্য	goal
লক্ষ্যসমূহ	goals
ছাগলী	goat
যোৱাগৈ	go away
ঈশ্বৰ	god
যায়	goes
গৈছে	going to
সোণ	gold
গ’ল	gone
গৈছে	gonna
ভাল	good
বিদায়	good bye
বিদায়	goodbye
সুপ্ৰভাত	good morning
শুভৰাত্ৰি	good night
শুভৰাত্রি	goodnight
বস্তু	goods
গুগল	Google
ৰাজহাঁহ	goose
ধুনীয়া	gorgeous
আড্ডা	gossip
পোৱা	got
চৰকাৰ	government
শ্ৰেণী	grade
স্নাতক	graduate
দানা	grain
অনুদান	grant
মঞ্জুৰ	granted
আঙুৰ	grapes
ঘাঁহ	grass
কৃতজ্ঞ	grateful
কৃতজ্ঞতা	gratitude
কবৰ	grave
ধূসৰ	gray
মহান	great
লোভ	greed
লুভীয়া	greedy
সেউজীয়া	green
শুভেচ্ছা	greetings
গ্ৰিড	grid
দুখ	grief
খুন্দা	grind
দৰা	groom
ভূমি	ground
গোট	group
বৃদ্ধি	growth
বদমেজাজী	grumpy
গুৱাৰানী	Guarani
গাৰাণ্টি	guarantee
আলহী	guest
নিৰ্দেশনা	guidance
দোষী	guilty
যুৱক	guy
ল’ৰাসকল	guys
জিম	gym
অভ্যাস	habit
বাসস্থান	habitat
আছিল	had
শিল-বৰষুণ	hail
চুলি	hair
আধা	half
হল	hall
হাত	hand
চম্ভালা	handle
দেখনিয়াৰ	handsome
ওলমা	hang
ঘটা	happen
ঘটিছিল	happened
সুখ	happiness
সুখী	happy
কঠিন	hard
কেতিয়াবাহে	hardly ever
ক্ষতি	harm
ক্ষতিকাৰক	harmful
সম্প্ৰীতি	harmony
কঠোৰ	harsh
আছে	has
থকা	having
বিপদ	hazard
কুঁৱলী	haze
তেওঁ	he
মূৰ	head
উপচাৰ	healing
স্বাস্থ্য	health
স্বাস্থ্যকৰ	healthy
শুনা	hear
শুনা	heard
হৃদয়	heart
তাপ	heat
স্বৰ্গ	heaven
গধুৰ	heavy
ব্যস্ত	hectic
উচ্চতা	height
উত্তৰাধিকাৰী	heir
ডকাইতি	heist
অনুষ্ঠিত	held
নৰক	hell
নমস্কাৰ	Hello
হেলমেট	helmet
সহায়	help
সহায়ক	helpful
সেয়েহে	hence
তাইক	her
জাক	herd
ইয়াত	here
ঐতিহ্য	heritage
হেৰা	Hey
নমস্কাৰ	Hi
অনুক্ৰম	hierarchy
ওখ	high
হাস্যকৰ	hilarious
পাহাৰ	hill
তেওঁক	him
ইংগিত	hint
কঁকাল	hip
কঁকাল	hips
নিয়োগ	hiring
তাৰ	his
ইতিহাস	history
মৰা	hit
নমস্কাৰ	Hi there
হমম	Hmm
ফুটা	hole
ফোঁপোলা	hollow
গৃহ	home
সত্‍	honest
সত্‍ভাৱে	honestly
মৌ	Honey
সন্মান	honor
ডকাইত	hood
হুক	hook
জঁপিওৱা	hop
আশা	hope
নিৰাশ	hopeless
অনুভূমিক	horizontal
শিঙ	horn
ভয়াৱহ	horror
ঘোঁৰা	horse
চিকিত্‍সালয়	hospital
আতিথ্য	hospitality
প্ৰতিকূল	hostile
গৰম	hot
হোটেল	hotel
ঘণ্টা	hour
ঘণ্টা	hours
ঘৰ	house
ঘৰুৱা	household
কেনেকৈ	how
অৱশ্যে	however
কেনেকৈ	how is
কিমানটা	how many
কিমান	how much
কেন্দ্ৰ	hub
পতি	hubby
আলিংগন	hug
প্ৰকাণ্ড	huge
মানৱ	human
নম্ৰ	humble
আৰ্দ্ৰ	humid
আৰ্দ্ৰতা	humidity
শত	hundred
ভোকাতুৰ	hungry
চিকাৰ	hunt
হাৰিকেন	hurricane
জল্দি	hurry
পতি	husband
হুলস্থূল	hustle
কুটি	hut
পৰিচ্ছন্নতা	hygiene
ম‍ই	I
ম‍ই	I am
বৰফ	ice
আইচক্ৰীম	ice cream
ধাৰণা	idea
আদৰ্শ	ideal
অভিন্ন	identical
পৰিচয়	identity
মূৰ্খ	idiot
যদি	if
বেমাৰী	ill
বেআইনী	illegal
ৰোগ	illness
ইলোকানো	Ilocano
ম‍ই	I'm
ম‍ই	I’m
ছৱি	image
ততালিকে	immediately
অপৰিসীম	immense
প্ৰভাৱ	impact
অধৈৰ্য	impatient
আমদানি	import
গুৰুত্বপূৰ্ণ	important
অসম্ভৱ	impossible
ছাপ	impression
প্ৰভাৱশালী	impressive
উন্নতি	improvement
ভিতৰত	in
তাৰোপৰি	in addition
অনুপযুক্ত	inappropriate
ঘটনা	incident
অন্তৰ্ভুক্ত	include
সাঙুৰি	including
উপাৰ্জন	income
অসুবিধা	inconvenience
অবিশ্বাস্য	incredible
সঁচাকৈয়ে	indeed
স্বাধীন	independent
ভাৰত	India
সংকেত	indicate
দেশী	indigenous
ব্যক্তিকেন্দ্ৰিক	individual
উদ্যোগ	industry
অনিবাৰ্য	inevitable
আচলতে	In fact
কেঁচুৱা	infant
অসীম	infinity
প্ৰদাহ	inflammation
মুদ্ৰাস্ফীতি	inflation
প্ৰভাৱ	influence
তথ্য	information
সন্মুখত	in front of
সামগ্ৰীসমূহ	ingredients
উত্তৰাধিকাৰ	inheritance
প্ৰাৰম্ভিক	initial
আঘাতপ্ৰাপ্ত	injured
আঘাত	injury
নিৰীহ	innocent
উদ্ভাৱন	innovation
কৰিবলৈ	in order to
অনুসন্ধান	inquiry
উন্মাদ	insane
পতংগ	insect
অসুৰক্ষিত	insecure
ভিতৰত	inside
অন্তৰ্দৄষ্টি	insight
অনিদ্ৰা	insomnia
প্ৰেৰণা	inspiration
উদাহৰণ	instance
ক্ষণ	instant
নিৰ্দেশনাসমূহ	instructions
সঁজুলি	instrument
অপমান	insult
বীমা	insurance
অক্ষত	intact
একতা	integrity
বুদ্ধিমান	intellectual
বুদ্ধিমত্তা	intelligence
বুধিয়ক	intelligent
অভিপ্ৰায়	intend
অভিপ্ৰেত	intended
তীব্ৰ	intense
অভিপ্ৰায়	intention
ভাৱ-বিনিময়	interaction
সুত	interest
আগ্ৰহী	interested
আকৰ্ষণীয়	interesting
হস্তক্ষেপ	interfere
অন্তৰ্বৰ্তী	intermediate
আভ্য়ন্তৰীণ	internal
আন্তৰ্জাতিক	international
ইণ্টাৰ্নশ্বিপ	internship
ব্যাখ্যা	interpret
ব্যাখ্যাকৰোতা	interpreter
সাক্ষাত্‍কাৰ	interview
অন্তৰংগ	intimate
পাতনি	introduction
অন্তৰ্মুখী	introvert
অন্তৰ্দৃষ্টি	intuition
অমান্য	invalid
উদ্ভাৱন	invent
আমন্ত্ৰণ	invitation
আমন্ত্ৰণ	invite
চালান	invoice
সাঙুৰা	involve
জড়িত	involved
লো	iron
দ্বীপ	island
বিচ্ছিন্ন	isolated
সমস্যা	issue
সমস্যা	issues
এইটো	it
সামগ্ৰী	item
সামগ্ৰী	items
এইটোৰ	it's
ইয়াৰ	its
জেকেট	jacket
কাৰাগাৰ	jail
জানুৱাৰী	January
জাৰ	jar
হনু	jaw
ঈৰ্ষান্বিত	jealous
জোকৰা	jerk
গহনা	jewelry
চাকৰি	job
গাঁঠি	joint
কৌতুক	joke
সাংবাদিক	journalist
যাত্ৰা	journey
উল্লাহ	joy
বিচাৰক	judge
ৰস	juice
জুলাই	july
জুন	june
আৱৰ্জনা	junk
মাত্ৰ	just
ন্যায়	justice
কলাল্লিসুত	Kalaallisut
আগ্ৰহী	keen
ৰাখক	keep
কেটলী	kettle
চাবি	key
কিক	kick
শিশু	kid
বৃক্ক	kidney
শিশু	kids
হত্যা	kill
দয়ালু	kind
দয়া	kindness
ৰজা	king
চুমা	kiss
পাকঘৰ	kitchen
চিলা	kite
আঁঠু	knee
জানিছিল	knew
কটাৰী	knife
ৰজা	knight
জনা	know
জ্ঞান	knowledge
জনাজাত	known
কোংকণী	Konkani
ক্রিযো	Krio
লেবেল	label
শ্ৰমিক	labor
পৰিশ্ৰম	labour
অভাৱ	lack
চিৰি	ladder
মহিলা	lady
পাৰিলে	laid
হ্ৰদ	lake
ভেড়া	lamb
পংগু	lame
লেম্প	lamp
ভূমি	land
ভূচিত্ৰ	landscape
ভাষা	language
কোলা	lap
ডাঙৰ	large
অন্তিম	last
উপাধি	last name
পলম	late
শেহতীয়াকৈ	lately
পাছত	later
শেহতীয়া	latest
পাছত	latter
হাঁহি	laugh
হাঁহি	laughter
আইন	law
ল’ন	lawn
উকীল	lawyer
স্তৰ	layer
গাঁথনি	layout
এলেহুৱা	lazy
নেতা	leader
পাত	leaf
ফুটা	leak
ক্ষীণ	lean
শিকা	learn
শিক্ষণ	learning
লীজ	lease
চামৰা	leather
যোৱা	leave
পাত	leaves
চালিত	led
বাওঁ	left
ভৰি	leg
উত্তৰাধিকাৰ	legacy
আইনী	legal
কিংবদন্তী	legend
বৈধ	legit
দৈৰ্ঘ্য	length
কম	less
পাঠ	lesson
চিঠি	letter
লেটুচ	lettuce
স্তৰ	level
উত্তোলন	leverage
দায়িত্ব	liability
পুথিভঁৰাল	library
চেলেকা	lick
মিছা	lie
জীৱন	life
ওঠোৱা	lift
পাতল	light
বিজুলী	lightning
সম্ভাৱনা	likely
তেনেদৰেই	likewise
ৰেখা	line
লিংগালা	Lingala
লিংক	link
সিংহ	lion
তৰল	liquid
সূচী	list
শুনক	listen
শুনা	listening
আক্ষৰিকভাৱে	literally
সাহিত্য	literature
লেতেৰা	litter
অলপ	little
যকৃত	liver
চৰা-ঘৰ	living room
জেঠী	lizard
ভাৰ	load
লোফ	loaf
ঋণ	loan
স্থানীয়	local
অৱস্থান	location
তলা	lock
লকডাউন	lockdown
কুণ্ডা	log
হা-হা	lol
নিৰ্জনতা	lonely
দীঘল	long
ৰূপ	look
খান্দৰি	loop
ঢিলা	loose
ঈশ্বৰ	lord
হৰা	lose
ক্ষতি	loss
হেৰাল	lost
বহুত	lot
ডাঙৰকৈ	loud
লাউঞ্জ	lounge
ভালপোৱা	love
ধুনীয়া	lovely
নিম্ন	low
তলৰ	lower
অনুগত	loyal
আনুগত্য	loyalty
ভাগ্য	luck
সৌভাগ্যশালী	lucky
লুগাণ্ডা	Luganda
পিণ্ড	lump
হাওঁফাওঁ	lungs
বিলাসিতা	luxury
যন্ত্ৰ	machine
পগলা	mad
মহোদয়া	madam
বনাইছিল	made
আলোচনী	magazine
চমত্‍কাৰ	magnificent
প্ৰধান	main
ব্যৱস্থাপনা	maintenance
মৈথিলী	Maithili
প্ৰধান	major
অধিকাংশ	majority
পুৰুষ	male
মল	mall
মানুহ	man
ব্যৱস্থাপনা	management
ব্যৱস্থাপক	manager
জৰুৰী	mandatory
ঘোষণাপত্ৰ	manifest
আচৰণ	manner
হাতপুথি	manual
অনেক	many
খোজকঢ়া	march
প্ৰান্ত	margin
বজাৰ	market
বিবাহ	marriage
বিবাহিত	married
মুখা	mask
ভৰ	mass
বিশাল	massive
মাষ্টৰ	master
সংগী	mate
সামগ্ৰী	material
অংক	math
বিষয়	matter
পৰিপক্কতা	maturity
হয়তো	may
হয়তো	maybe
মোক	me
আহাৰ	meal
অৰ্থ	mean
অৰ্থ	meaning
জোখ	measures
মাংস	meat
মেডিকেল	medical
দৰৱ	medicine
ধ্যান	meditation
মাধ্যম	medium
মীটিং	meeting
মৈতৈলোন	Meiteilon
গলা	melt
স্মৃতিসমূহ	memories
স্মৃতি	memory
মানসিক	mental
উল্লেখ	mention
গুৰু	mentor
ব্যৱসায়ী	merchant
দয়া	mercy
কেৱল	merely
অব্যৱস্থিত	mess
বাৰ্তা	message
খেলিমেলি	messy
ধাতু	metal
পদ্ধতি	method
ময়ো	me too
নিগনি	mice
মাজ	middle
মাজনিশা	midnight
মৃদু	mild
সৈনিক	military
গাখীৰ	milk
নিযুত	million
মন	mind
মানসিকতা	mindset
মোৰ	mine
নাবালক	minor
মিনিট	minute
মিনিটবোৰ	minutes
আইনা	mirror
সানমিহলি	miscellaneous
ক্ষতিকাৰক	mischievous
কৰুণ	miserable
দুখ	misery
হেৰাইছে	missing
উদ্দেশ্য	mission
কুঁৱলী	mist
ভুল	mistake
মিজো	Mizo
ম’বাইল	mobile
উপহাস	mock
মডেল	model
মধ্যমীয়া	moderate
আধুনিক	modern
বিনয়ী	modest
সেমেকা	moist
আৰ্দ্ৰতা	moisture
গঠন	mold
তিল	mole
মা	mom
মুহূৰ্ত	moment
সোমবাৰ	monday
ধন	money
বান্দৰ	monkey
মাহ	month
মেজাজ	mood
মেজাজ	moody
চন্দ্ৰ	moon
নৈতিক	moral
অধিক	more
তাৰোপৰি	moreover
পুৱা	morning
বন্ধক	mortgage
অধিকাংশ	most
অধিকাংশভাৱে	mostly
মা	mother
গতি	motion
প্ৰেৰণা	motivation
পৰ্বত	mountain
নিগনি	mouse
মুখ	mouth
বিপ্লৱ	movement
বোলছৱি	movie
শ্ৰীমতী	mrs
অনেক	much
বোকা	mud
মগ	mug
পেশী	muscle
সংগ্ৰাহালয়	museum
কাঠফুলা	mushroom
সংগীত	music
অৱশ্যেই	must
নিঃশব্দ	mute
উমৈহতীয়া	mutual
মোৰ	my
ৰহস্যময়	mysterious
ৰহস্য	mystery
নখ	nail
নিষ্পাপ	naive
নাম	name
বৰ্ণনা	narrative
ঠেক	narrow
অশ্লীল	nasty
ৰাষ্ট্ৰীয়	national
জাতীয়তা	nationality
স্থানীয়	native
প্ৰাকৃতিক	natural
প্ৰকৃতি	nature
কাষত	near
সমীপৰ	nearby
প্ৰায়	nearly
চাফা	neat
প্ৰয়োজনীয়	necessary
ডিঙি	neck
নেকলেচ	necklace
প্ৰয়োজন	need
ঋণাত্মক	negative
চুবুৰীয়া	neighbor
চুবুৰীয়া	neighborhood
ভতিজা	nephew
নিৰ্বোধ	nerd
স্নায়ৱিক	nervous
বাহ	nest
জাল	net
নেটৱৰ্ক	network
নিৰপেক্ষ	neutral
নতুন	new
বাতৰি	news
পৰৱৰ্তী	next
বঢ়িয়া	nice
ভতিজী	niece
নিশা	night
ন	nine
উনৈশ	nineteen
নব্বৈ	ninety
নহয়	No
হুলস্থূল	noise
হূলস্থুলীয়া	noisy
দুপৰীয়া	noon
নহয়	nope
স্বাভাৱিক	normal
উত্তৰদিশ	north
নাক	nose
নহয়	not
টোকা	note
জাননী	notice
নামবাচক	noun
বিশেষ্য	nouns
উপন্যাস	novel
নৱেম্বৰ	november
এতিয়া	now
আজিকালি	nowadays
উপদ্ৰৱ	nuisance
খালী	null
জঠৰ	numb
সংখ্যা	number
নাৰ্ছ	nurse
বাদাম	nut
জায়ফল	nutmeg
পুষ্টি	nutrition
শপত	oath
মেদবহুলতা	obesity
বস্তু	object
উদ্দেশ্য	objective
কৰ্তব্য	obligation
অস্পষ্ট	obscure
পৰ্যবেক্ষণ	observation
আবেশ	obsession
অপ্ৰচলিত	obsolete
বাধা	obstacle
স্পষ্ট	obvious
নিশ্চিতভাৱে	obviously
কেতিয়াবা	occasionally
বৃত্তি	occupation
অধিকৃত	occupied
ঘটে	occur
ঘটিছিল	occurred
ঘটিছে	occurs
মহাসাগৰ	ocean
অক্টোবৰ	october
অস্বাভাৱিক	odd
প্ৰতিকূলতা	odds
নিশ্চিতভাৱে	of course
আক্ৰমণাত্মক	offensive
অফাৰ	offer
কাৰ্যালয়	office
অনুষ্ঠানিক	official
প্ৰায়ে	often
অস	Oh
সঁচাকে	oh really
তেল	oil
বুঢ়া	old
ওপৰত	on
এবাৰ	once
এক	one
পিঁয়াজ	onion
অনলাইন	online
কেৱল	only
খোলা	open
সঞ্চালন	operation
মতামত	opinion
সুযোগ	opportunities
সুযোগ	opportunity
বিপৰীত	opposite
আশাবাদী	optimistic
বিকল্প	option
বৈকল্পিক	optional
অথবা	or
কমলা	orange
ক্ৰম	order
সাধাৰণ	ordinary
সংস্থা	organization
অভিবিন্যাস	orientation
মূলত	origin
মূল	original
ওৰোমো'	Oromo
অনাথ	orphan
অন্যান্য	other
অন্যথা	otherwise
লাগে	ought
আমাৰ	our
বাহিৰ	out
ফলাফল	outcome
পোছাক	outfit
বহিৰ্গামী	outgoing
ৰুপৰেখা	outline
বাহিৰত	outside
অ’ভেন	oven
ওপৰত	over
সামগ্ৰিক	overall
তাত	over there
অভিভূত	overwhelmed
অপ্ৰতিৰোধ্য	overwhelming
ফেঁচা	owl
নিজৰ	own
মালিক	owner
ষাঁড়	ox
গতি	pace
পেক	pack
পেকেজ	package
পৰিশোধিত	paid
দুখ	pain
চিত্ৰাংকন	painting
যোৰা	pair
শেঁতা	pale
তলুৱা	palm
কেৰাহী	pan
অতিমাৰী	pandemic
ত্ৰাস	panic
পেণ্ট	pants
কাগজ	paper
স্বৰ্গ	paradise
সমান্তৰাল	parallel
পাৰ্চেল	parcel
পিতৃ-মাতৃ	parents
উদ্যান	park
ভাটৌ	parrot
অংশ	part
অংশগ্ৰহণ	participate
নিৰ্দিষ্ট	particular
বিশেষকৈ	particularly
সংগী	partner
দল	party
উত্তীৰ্ণ	pass
পাঠাংশ	passage
উত্তীৰ্ণ	passed
আবেগ	passion
ভাবুকতা	passionate
নিষ্ক্ৰিয়	passive
পাছৱৰ্ড	password
অতীত	past
টুকুৰা	patch
পথ	path
কৰুণ	pathetic
ধৈৰ্য	patience
ৰোগী	patient
নমুনা	pattern
বিৰতি	pause
ফুটপাথ	pavement
পৰিশোধ	payment
শান্তি	peace
শান্তিপূৰ্ণ	peaceful
শৃংগ	peak
নাচপতি	pear
মটৰ	peas
আচৰিত	peculiar
বাকলি	peel
সহকৰ্মী	peer
সমনীয়া	peers
কলম	pen
পেঞ্চিল	pencil
লোক	people
জালুক	pepper
বুজা	perceive
ধাৰণা	perception
নিখুঁত	perfect
প্ৰদৰ্শন	performance
বোধকৰোঁ	perhaps
সময়কাল	period
স্থায়ী	permanent
অনুমতি	permission
অধ্যৱসায়	perseverance
অবিৰাম	persistent
ব্যক্তি	person
ব্যক্তিগত	personal
ব্যক্তিত্ব	personality
দৃষ্টিকোণ	perspective
বিকৃত	pervert
স্তৰ	phase
দৰ্শন	philosophy
ফোন	phone
ফটো	photo
বাক্যাংশ	phrase
শাৰীৰিক	physical
বাছক	pick
উঠাওক	pick up
ছৱি	picture
টুকুৰা	piece
টুকুৰাসমূহ	pieces
গাহৰি	pig
স্তূপ	pile
গাৰু	pillow
পাইলট	pilot
পিন	pin
আনাৰস	pineapple
গোলপীয়া	pink
গাঁত	pit
চূড়া	pitch
দয়া	pity
স্থান	place
স্থানসমূহ	places
সমতল	plain
পৰিকল্পনা	plan
বাহন	plane
উদ্ভিদ	plant
উদ্ভিদ	plants
কাঁহী	plate
প্লেটফৰ্ম	platform
খেলা	play
আনন্দদায়ক	pleasant
প্ৰসন্ন	pleased
সুখ	pleasure
শপত	pledge
পৰ্যাপ্ত	plenty
পটভূমি	plot
ছুপি	plug
বগৰী	plum
বহুবচন	plural
প’ডকাষ্ট	podcast
কবিতা	poem
কবিতা	poetry
বিন্দু	point
বিহ	poison
আৰক্ষী	police
নীতি	policy
ভদ্ৰ	polite
প্ৰদূষণ	pollution
পুখুৰী	pond
পুখুৰী	pool
বিষ্ঠা	poop
দুখীয়া	poor
প’প	pop
জনপ্ৰিয়	popular
জনসংখ্যা	population
বন্দৰ	port
অৱস্থান	position
ধনাত্মক	positive
পেছা	possession
স্ব-অধিকাৰ	possessive
সম্ভৱ	possible
ডাক	post
আলু	potato
সম্ভাৱনা	potential
পাউণ্ড	pound
দৰিদ্ৰতা	poverty
ক্ষমতা	power
শক্তিশালী	powerful
বাস্তৱিক	practical
অভ্যাস	practice
মূল্যবান	precious
সুনিৰ্দিষ্ট	precise
যথাযথভাৱে	precisely
অনুমান	predict
গৰ্ভৱতী	pregnant
পৰিসৰ	premises
প্ৰিমিয়াম	premium
প্ৰস্তুতি	preparation
অব্যয়	preposition
উপস্থিতি	presence
বৰ্তমান	present
প্ৰস্তুতি	presentation
সংৰক্ষণ	preserve
ৰাষ্ট্ৰপতি	president
টিপক	press
চাপ	pressure
মৰমলগা	pretty
পূৰ্ৱবৰ্তী	previous
চিকাৰ	prey
মূল্য	price
গৌৰৱ	pride
পূজাৰী	priest
প্ৰাথমিক	primary
মুখ্য	prime
ৰাজকন্যা	princess
প্ৰধান	principal
আগতে	prior
অগ্ৰাধিকাৰ	priority
কাৰাগাৰ	prison
গোপনীয়তা	privacy
ব্যক্তিগত	private
পুৰষ্কাৰ	prize
সম্ভৱতঃ	probably
সমস্যা	problem
পদ্ধতি	procedure
আগবাঢ়ক	proceed
প্ৰক্ৰিয়া	process
উত্‍পাদন	produce
সামগ্ৰী	product
উৎপাদন	production
পেছা	profession
পেশাদাৰী	professional
ৰূপৰেখা	profile
লাভ	profit
দৃঢ়	profound
প্ৰগতি	progress
প্ৰকল্প	project
বিশিষ্ট	prominent
প্ৰতিশ্ৰুতি	promise
প্ৰচাৰ	promotion
শীঘ্ৰে	prompt
উন্মুখ	prone
সৰ্বনাম	pronouns
উচ্চাৰণ	pronunciation
প্ৰমাণ	proof
যথাযথ	proper
সঠিকভাৱে	properly
ধৰ্ম	properties
সম্পত্তি	property
প্ৰস্তাৱ	proposal
সম্ভাৱনা	prospect
সমৃদ্ধি	prosperity
সমৃদ্ধ	prosperous
অহংকাৰী	proud
প্ৰদেশ	province
ব্যৱস্থা	provision
যৌৱন	puberty
ৰাজহুৱা	public
টনা	pull
ৰঙালাউ	pumpkin
সময়নিষ্ঠ	punctual
বিশুদ্ধ	pure
বেঙুনীয়া	purple
উদ্দেশ্য	purpose
অনুসৰণ	pursuit
ঠেলা	push
ৰখা	put
অৰ্হতা	qualification
গুণমান	quality
পৰিমাণ	quantity
কুৰেণ্টাইন	quarantine
কাজিয়া	quarrel
কেচুআ	Quechua
ৰাণী	queen
বিচিত্ৰ	queer
প্ৰশ্ন	query
প্ৰশ্ন	question
দ্ৰুত	quick
দ্ৰুততাৰে	quickly
নীৰৱ	quiet
লেপ	quilt
যথেষ্ট	quite
কুইজ	quiz
উদ্ধৄতি	quotation
উদ্ধৃতি	quote
উদ্ধৃতি	quotes
শহা	rabbit
জাতি	race
খং	rage
বৰষুণ	rain
উত্থাপিত	raised
দৌৰিছিল	ran
যাদৃচ্ছিক	random
পৰিসৰ	range
দ্ৰুত	rapid
দ্ৰুতগতিত	rapidly
বিৰল	rare
কাচিত্‍	rarely
চোকোৰা	rash
চিকা	rat
হাৰ	rate
বৰঞ্চ	rather
অনুপাত	ratio
যুক্তিকৰ	rational
কেঁচা	raw
NS	re
পালেগৈ	reached
প্ৰতিক্ৰিয়া	reaction
পঢ়া	read
সাজু	ready
বাস্তৱ	real
বাস্তৱতা	reality
উপলব্ধি	realize
সঁচাকৈ	really
পিছফালৰ	rear
কাৰণ	reason
যুক্তিসংগত	reasonable
ৰচিদ	receipt
পোৱা	receive
শেহতীয়া	recent
শেহতীয়াকৈ	recently
অভ্যৰ্থনা	reception
ৰেচিপি	recipe
বেপৰোৱা	reckless
স্বীকৃতি	recognition
পৰামৰ্শিত	recommended
নথিভুক্ত	record
পুনৰুদ্ধাৰ	recover
পুনৰুদ্ধাৰ	recovery
আয়ত	rectangle
ৰঙা	red
পাপমোচন	redemption
অপ্ৰয়োজনীয়	redundant
উল্লেখ	refer
সন্দৰ্ভ	reference
প্ৰতিফলন	reflect
প্ৰতিফলন	reflection
ৰেফ্ৰিজাৰেটৰ	refrigerator
সন্মান	regard
এইবিষয়ে	regarding
সন্মান	regards
অঞ্চল	region
নিয়মিত	regular
নিয়মিতভাৱে	regularly
প্ৰত্যাখ্যান	reject
সম্পৰ্কিত	related
সম্পৰ্ক	relationship
সম্পৰ্কীয়	relative
সম্বন্ধীয়	relatives
আৰাম	relax
মুক্তিপ্ৰাপ্ত	released
প্ৰাসংগিক	relevant
নিৰ্ভৰযোগ্য	reliable
অব্যাহতিপ্ৰাপ্ত	relieved
ধৰ্ম	religion
ধাৰ্মিক	religious
অনিশ্চুক	reluctant
ভৰসা	rely
প্ৰতিকাৰ	remedy
স্মাৰক	reminder
দূৰৱৰ্তী	remote
আঁতৰোৱা	remove
ভাড়া	rent
মেৰামতি	repair
পুনৰাবৃত্তি	repeat
প্ৰত্যুত্তৰ	reply
প্ৰতিনিধিত্ব	represent
খ্যাতি	reputation
অনুৰোধ	request
প্ৰয়োজন	require
প্ৰয়োজনীয়	required
উদ্ধাৰ	rescue
গৱেষণা	research
অসন্তুষ্টি	resentment
সংৰক্ষণ	reservation
সংৰক্ষণ	reserve
বাসিন্দা	resident
সহনশীলতা	resilience
প্ৰাণৱন্ত	resilient
সংকল্প	resolution
সমাধান	resolve
আশ্ৰয়	resort
সম্পদসমূহ	resources
সন্মান	respect
সঁহাৰি	respond
সঁহাৰি	response
দায়িত্ব	responsibility
দায়ী	responsible
ৰেষ্টুৰেণ্ট	restaurant
সীমাবদ্ধ	restrict
ফলাফল	result
ফলাফল	results
খুচুৰা	retail
অৱসৰপ্ৰাপ্ত	retired
পশ্চাদপসৰণ	retreat
উন্মুক্ত	revealed
প্ৰতিশোধ	revenge
ৰাজহ	revenue
বিপৰীত	reverse
পুনৰীক্ষণ	review
সংশোধন	revise
সংশোধন	revision
বিপ্লৱ	revolution
পুৰস্কাৰ	reward
তাল	rhythm
পাঁজৰ	rib
ভাত	rice
ধনী	rich
পৰিত্ৰাণ	rid
চলোৱা	ride
হাস্যকৰ	ridiculous
শুদ্ধ	right
এতিয়াই	right now
কঠোৰ	rigid
আঙুঠি	ring
পখালা	rinse
দাঙ্গা	riot
ফলা	rip
পকা	ripe
আশংকা	risk
প্ৰতিদ্বন্দী	rival
নদী	river
পথ	road
পোৰা	roast
মজবুত	robust
শিল	rock
ৰ’ড	rod
ভূমিকা	role
মেৰিওৱা	roll
ছাদ	roof
কোঠা	room
শিপা	root
ৰছী	rope
পচা	rotten
খহটা	rough
মোটামুটিকৈ	roughly
গোলাকাৰ	round
পথ	route
শাৰী	row
ঘঁহা	rub
ৰবৰ	rubber
আৱৰ্জনা	rubbish
ৰূঢ়	rude
পিঠিফালৰ	rug
ধ্বংস	ruin
নিয়ম	rule
শাসক	ruler
নিয়মসমূহ	rules
দৌৰা	run
দৌৰা	running
গ্ৰাম্য	rural
বস্তা	sack
ত্যাগ	sacrifice
সুৰক্ষিত	safe
সুৰক্ষা	safety
মুনি	sage
কৈছিল	said
পাল	sail
হেতু	sake
দৰমহা	salary
বিক্ৰী	sale
চালমন	salmon
নিমখ	salt
একেই	same
নমুনা	sample
বালি	sand
সংস্কৃত	Sanskrit
ব্যঙ্গাত্মক	sarcastic
অনাড়ম্বৰ	sassy
বহিছিল	sat
সন্তুষ্টি	satisfaction
সন্তুষ্ট	satisfied
সন্তোষজনক	satisfying
শনিবাৰ	Saturday
চ’চেজ	sausage
অসভ্য	savage
দেখিছিল	saw
কওক	say
মাপন	scale
কেলেংকাৰী	scam
দাগ	scar
দুৰ্লভ	scarce
গলাবান্ধ	scarf
ভয়ানক	scary
সিঁচৰতি	scattered
দৃশ্য	scene
দৃশ্য	scenery
সুগন্ধ	scent
অনুসূচী	schedule
বিদ্যালয়	school
বিজ্ঞান	science
বিজ্ঞানী	scientist
বিজ্ঞানী	scientists
কেঁচি	scissors
গালি	scold
পৰিসৰ	scope
মানংক	score
চিঞৰ	scream
স্ক্ৰীণ	screen
পেঁচ-গজাল	screw
চিত্ৰনাট্য	script
সাগৰ	sea
ছীল	seal
সন্ধান	search
ঋতু	season
আসন	seat
দ্বিতীয়	second
গোপনীয়	secret
শাখা	section
সুৰক্ষিত	secure
সুৰক্ষা	security
চোৱা	see
বীজ	seed
বিচৰা	seek
বাজেয়াপ্ত	seizure
কাচিত্‍	seldom
নিজক	self
স্বাৰ্থপৰ	selfish
পঠোৱা	send
জ্যেষ্ঠ	senior
জ্ঞান	sense
বুদ্ধিমান	sensible
সংবেদনশীল	sensitive
বাক্য	sentence
বাক্যসমূহ	sentences
পৃথক	separate
সেপেডী	Sepedi
ছেপ্টেম্বৰ	september
ক্ৰম	sequence
শৃংখলা	series
গহীন	serious
সেৱা	service
অধিৱেশন	session
ছেটিং	setting
সাত	seven
সোতৰ	seventeen
সত্তৰ	seventy
কেইবাটাও	several
অতিশয়	severe
চিলাই	sew
ছাঁ	shadow
কঁপা	shake
কৰিব	shall
ফোপোলা	shallow
লজ্জা	shame
আকাৰ	shape
চোকা	sharp
তাই	she
ভেড়া	sheep
চাদৰ	sheet
খলপ	shelf
খোলা	shell
আশ্ৰয়	shelter
ঢাল	shield
জিলিকা	shine
জাহাজ	ship
পঠিওৱা	shipping
চাৰ্ট	shirt
জোতা	shoes
দোকান	shop
দাঁতি	shore
চুটি	short
কান্ধ	shoulder
চিঞৰা	shout
প্ৰদৰ্শনী	show
শ্বাৱাৰ	shower
মিছামাছ	shrimp
সংকোচন	shrink
বন্ধ	shut
লাজকুৰীয়া	shy
সহোদৰ	sibling
ভাই-ভণ্টি	siblings
বেমাৰী	sick
এফালৰ	side
হুমুনিয়াহ	sigh
দৃষ্টি	sight
চহী	sign
চহী	signature
উল্লেখযোগ্য	significant
নীৰৱতা	silence
নীৰৱ	silent
ৰেশম	silk
নিৰ্বোধ	silly
ৰূপ	silver
একেধৰণৰ	similar
সহজ	simp
সাধাৰণ	simple
যিহেতু	since
গম্ভীৰ	sincere
বিনীতভাৱে	sincerely
গোৱা	sing
গায়ক	singer
একক	single
ডুবা	sink
মহোদয়	Sir
ভণ্টি	sister
নবৌ	sister in law
বহক	sit
স্থান	site
পৰিস্থিতি	situation
ছয়	six
ষোল্ল	sixteen
ষাঠি	sixty
আকাৰ	size
দক্ষতা	skill
দক্ষতাসমূহ	skills
ছাল	skin
খীণ	skinny
স্কাৰ্ট	skirt
আকাশ	sky
দাস	slave
টোপনি	sleep
টোপনি	sleepy
শ্লীভ	sleeve
টুকুৰা	slice
এফলীয়া	slide
অলপীয়াকৈ	slightly
পাতল	slim
পিছলা	slip
এঢলীয়া	slope
ছাঁদ	slot
সৰু	small
স্মাৰ্ট	smart
গোন্ধ	smell
হাঁহি	smile
ধোঁৱা	smoke
মসৃণ	smooth
শামুক	snail
সাপ	snake
ছৱি	snap
তুষাৰ	snow
তেন্তে	so
ডুবুওৱা	soak
চাবোন	soap
সংযত	sober
সামাজিক	social
সমাজ	society
মোজা	socks
কোমল	soft
ছ’ফ্টৱেৰ	software
মাটি	soil
চিপাহী	soldier
একমাত্ৰ	sole
গোটা	solid
সমাধান	solution
সমাধান	solve
কিছুমান	some
কোনোবাই	somebody
কেনেবাকে	somehow
কেতিয়াবা	sometimes
গান	song
সোনকালে	soon
অত্যাধুনিক	sophisticated
সোৰানী	Sorani
ঘাঁ	sore
বেজাৰ	sorrow
দুঃখিত	Sorry
সজোৱা	sort
আত্মা	soul
প্ৰাণপ্ৰিয়	soulmate
ধ্বনি	sound
ছু’প	soup
টেঙা	sour
উত্‍স	source
দক্ষিণ	south
স্থান	space
স্পাম	spam
সময়ছোৱা	span
স্পেনিছ	Spanish
অতিৰিক্ত	spare
বিশেষ	special
প্ৰজাতি	species
নিৰ্দিষ্ট	specific
বক্তৃতা	speech
নিৰ্বাক	speechless
বেগ	speed
বানান	spell
খৰচ	spend
মছলাযুক্ত	spicy
কাঁইট	spike
ঘূৰ্ণন	spin
পালেংশাক	spinach
আত্মা	spirit
চমৎকাৰ	splendid
স্বতস্ফূৰ্ত	spontaneous
চামুচ	spoon
স্থান	spot
বিয়পা	spread
বসন্ত	spring
বৰ্গ	square
স্কুইড	squid
কেৰ্কেটুৱা	squirrel
স্থায়ী	stable
স্তূপ	stack
কৰ্মচাৰী	staff
মঞ্চ	stage
দাগ	stain
চিৰি	stairs
অংশীদাৰী	stake
ঠাৰি	stalk
মোহৰ	stamp
মানদণ্ড	standard
তৰা	star
ৰাজ্য	state
বিবৃতি	statement
ষ্টেছন	station
মূৰ্তি	statue
স্থিতি	status
থকা	stay
স্থিৰ	steady
টুকুৰা	steak
চুৰি	steal
ভাপ	steam
তীখা	steel
থিয়	steep
কাণ্ড	stem
পদক্ষেপ	step
লাঠী	stick
টান	stiff
তথাপি	still
হুল	sting
কৃপণ	stingy
লৰোৱা	stir
ভঁৰাল	stock
পেট	stomach
শিল	stone
মল	stool
ৰ’ব	stop
সংৰক্ষণ	storage
দোকান	store
ধুমুহা	storm
কাহিনী	story
চৌকা	stove
পোন	straight
পোনপটীয়া	straightforward
চাপ	strain
আচৰিত	strange
অচিনাকি	stranger
কৌশল	strategy
ষ্ট্ৰ’	straw
ষ্ট্ৰ’বেৰী	strawberry
ধাৰা	streak
নিজৰা	stream
ৰাষ্টা	street
শক্তি	strength
চাপ	stress
কঠোৰ	strict
তাঁৰ	string
পট্টি	strip
আঘাত	stroke
শক্তিশালী	strong
গাঁঠনি	structure
সংগ্ৰাম	struggle
জেদী	stubborn
ছাত্ৰ	student
বস্তু	stuff
অঁকৰা	stupid
শৈলী	style
বিষয়	subject
পদাৰ্থ	substance
প্ৰতিস্থাপিত	substitute
সূক্ষ্ম	subtle
সফলতা	success
সফল	successful
তেনে	such
যেনে	such as
চুষক	suck
আকস্মিক	sudden
হঠাতে	suddenly
ভোগা	suffer
কষ্ট	suffering
পৰ্যাপ্ত	sufficient
চেনি	sugar
পৰামৰ্শ	suggestion
যোগ্য	suitable
চুটকেছ	suitcase
মুঠ	sum
সাৰাংশ	summary
গ্ৰীষ্ম	summer
সন্মিলন	summit
সূৰ্য	sun
দেওবাৰ	sunday
সূৰ্যাস্ত	sunset
ৰ’দ	sunshine
অতি	super
শ্ৰেষ্ঠ	superior
পৰ্যবেক্ষক	supervisor
যোগান	supply
সমৰ্থন	support
নিশ্চয়	sure
পৃষ্ঠ	surface
ঢৌ	surge
অস্ত্ৰোপচাৰ	surgery
উপাধি	surname
সমৰ্পণ	surrender
চাৰিওফালে	surrounding
নিৰীক্ষণ	surveillance
জৰীপ	survey
সন্দেহ	suspect
সন্দেহজনক	suspicious
স্থিৰতা	sustainability
বহনক্ষম	sustainable
লুট	swag
গিলা	swallow
অদলবদল	swap
শপত	swear
ঘাম	sweat
ছুৱেটাৰ	sweater
মিঠা	sweet
সোণজনী	sweetheart
সাঁতোৰ	swim
সাঁতোৰ	swimming
ঝুলা	swing
চুইচ	switch
তৰোৱাল	sword
চিহ্ন	symbol
সহানুভূতি	sympathy
লক্ষণ	symptoms
পদ্ধতি	system
মেজ	table
চম্ভালা	tackle
টেগ	tag
নেজ	tail
লোৱা	take
লোৱা	taken
কথকী	talkative
ওখ	tall
টিপক	tap
টেপ	tape
লক্ষ্য	target
কাৰ্য	task
সোৱাদ	taste
শিকাইছিল	taught
চাহ	tea
শিক্ষণ	teach
শিক্ষক	teacher
দল	team
চকুপানী	tear
চকুপানী	tears
জোকোৱা	tease
প্ৰযুক্তি	technology
দাঁত	teeth
কওক	tell
খং	temper
তাপমান	temperature
মন্দিৰ	temple
অস্থায়ী	temporary
দহ	ten
ভাড়াতীয়া	tenant
প্ৰৱণতা	tend
প্ৰৱণতা	tendency
নিবিদা	tender
কাল	tense
দুঃচিন্তা	tension
তম্বু	tent
সম্ভাব্য	tentative
কাল	term
চৰ্তাৱলী	terms
ভয়ানক	terrible
সাংঘাতিক	terrific
অঞ্চল	territory
পৰীক্ষা	test
পাঠ্য	text
ধন্যবাদ	thank
ধন্যবাদ	thanks
ধন্যবাদ	thank you
সেইটো	that
চুৰি	theft
তেওঁলোকৰ	their
তেওঁলোকক	them
বিষয়বস্তু	theme
তেতিয়া	then
তত্ত্ব	theory
তাত	there
সেয়েহে	therefore
এইবিলাক	these
তেওঁলোক	they
শকত	thick
চুৰ	thief
কৰঙন	thigh
পাতল	thin
বস্তু	thing
বস্তুবোৰ	things
তৃতীয়	third
তেৰ	thirteen
ত্ৰিশ	thirty
এইটো	this
এইটো	this is
পুংখানুপুংখ	thorough
ভালদৰে	thoroughly
সেইবিলাক	those
যদিও	though
ভাবিছিল	thought
বিচাৰশীল	thoughtful
চিন্তা	thoughts
এশ	thousand
সূতা	thread
ভাবুকি	threat
ভাবুকি	threaten
তিনি	three
দুৱাৰডলি	threshold
ৰোমাঞ্চিত	thrilled
নেলু	throat
মাজেদি	through
সৰ্বত্ৰ	throughout
দলিওৱা	throw
বজ্ৰপাত	thunder
বৃহস্পতিবাৰ	Thursday
গতিকে	thus
টিক্চিহ্ন	tick
চফা	tide
পৰিপাটি	tidy
বন্ধা	tie
বাঘ	tiger
টান	tight
টিগৰিন্যা	Tigrinya
সময়	time
ভয়াতুৰ	timid
ক্ষুদ্ৰ	tiny
কিটিপ	tip
কিটিপসমূহ	tips
ক্লান্ত	tire
ভাগৰুৱা	tired
টিছ্যু	tissue
অলপ	title
লৈ	to
ট’ষ্ট	toast
হ’বলৈ	to be
আজি	today
কেঁচুৱা	toddler
একেলগে	together
শৌচাগাৰ	toilet
কৈছিল	told
সহনশীলতা	tolerance
সহনশীল	tolerate
বিলাহী	tomato
কাইলৈ	tomorrow
জিভা	tongue
লগতে	too
লৈছিল	took
সঁজুলি	tool
সঁজুলি	tools
দাঁত	tooth
শীৰ্ষ	top
বিষয়	topic
ফটা	torn
নিৰ্যাতন	torture
মুঠ	total
স্পৰ্শ	touch
কঠিন	tough
যাত্ৰা	tour
দিশে	toward
টাৱেল	towel
চহৰ	town
বিষাক্ত	toxic
দাগ	trace
ট্ৰেক	track
বাণিজ্য	trade
পৰম্পৰা	tradition
পৰম্পৰাগত	traditional
ট্ৰেফিক	traffic
গমনপথ	trail
ৰেলগাড়ী	train
প্ৰশিক্ষণ	training
বৈশিষ্ট্য	trait
বৈশিষ্ট্যসমূহ	traits
স্থানান্তৰ	transfer
স্থানান্তৰ	transition
স্বচ্ছ	transparent
পৰিবহন	transport
পৰিবহন	transportation
ফান্দ	trap
আৱৰ্জনা	trash
ক্ষতি	trauma
ভ্ৰমণ	travel
ট্ৰে	tray
গুপ্তধন	treasure
উপচাৰ	treatment
গছ	tree
প্ৰচণ্ড	tremendous
পৰীক্ষণ	trial
কৌশল	trick
ট্ৰিগাৰ	trigger
যাত্ৰা	trip
সমস্যা	trouble
ট্ৰাউজাৰ	trousers
ট্ৰাক	truck
সঁচা	true
মূঢ়া	trunk
বিশ্বাস	trust
সত্য	truth
সোংগা	Tsonga
টিউৱ	tube
মঙ্গলবাৰ	Tuesday
টিউশ্যন	tuition
তুৰ্কী	turkey
হালধি	turmeric
কেঁকুৰি	turn
কাছ	turtle
টিউটৰ	tutor
বাৰ	twelve
বিশ	twenty
একৈশ	twenty-one
ট্বী	Twi
দুবাৰ	twice
পাক	twist
দুই	two
প্ৰকাৰ	type
সাধাৰণ	typical
কুত্‍সিত	ugly
চূড়ান্ত	ultimate
ছাতি	umbrella
অক্ষম	unable
খুড়া	uncle
মামা	uncle
অচেতন	unconscious
অধীনত	under
তলত	underneath
নিম্নদৰ	underrated
দুৰ্ভাগ্যবশতঃ	unfortunately
অনন্য	unique
একক	unit
বিশ্ববিদ্যালয়	university
অজ্ঞাত	unknown
নহ’লে	unless
যেতিয়ালৈকে	until
অসাধাৰণ	unusual
ওপৰত	up
নবীকৰণ	update
ওপৰত	upon
বিমৰ্ষ	upset
নগৰ	urban
তাড়না	urge
আমাক	us
ব্যৱহাৰ	use
ব্যৱহৃত	used
উপযোগী	useful
অদৰকাৰী	useless
সচৰাচৰ	usual
সাধাৰণতে	usually
ছুটী	vacation
টিকাকৰণ	vaccination
ভেকচিন	vaccine
তৰংগ	vague
মান্য	valid
উপত্যকা	valley
মূল্যৱান	valuable
মান	value
বৈচিত্ৰ্য	variety
বিভিন্ন	various
ভিন্ন	vary
ফুলদানী	vase
বিশাল	vast
শাক-পাচলি	vegetable
শাক-পাচলি	vegetables
বাহন	vehicle
বিক্ৰেতা	vendor
বিষ	venom
উদ্যম	venture
বহুমুখী	versatile
সংস্কৰণ	version
উলম্ব	vertical
অতি	very
পাত্ৰ	vessel
যোগেদি	via
অনুভূতি	vibe
অনুভূতি	vibes
দুষ্ট	vicious
চিকাৰ	victim
ভিডিঅ’	video
দৰ্শন	view
গাওঁ	village
খলনায়ক	villain
ভিনেগাৰ	vinegar
পুৰণিকালৰ	vintage
হিংসা	violence
হিংসাত্মক	violent
বিষাক্ত	viral
কুমাৰী	virgin
অপাৰ্থিৱ	virtual
গুণ	virtue
দৃষ্টি	vision
চাক্ষুষ	visual
গুৰুত্বপূৰ্ণ	vital
শব্দভাণ্ডাৰ	vocabulary
কণ্ঠ	voice
পৰিমাণ	volume
স্বেচ্ছাসেৱক	volunteer
বমি	vomit
দুৰ্বল	vulnerable
দৰমহা	wage
মজুৰি	wages
কঁকাল	waist
ৱেইটাৰ	waiter
জাগ্ৰত	wake
খোজকঢ়া	walk
দেৱাল	wall
বিচৰা	wanna
বিচৰা	want
বিচাৰিছিল	wanted
যুদ্ধ	war
আলমাৰি	wardrobe
গোদাম	warehouse
উষ্ণ	warm
সতৰ্কবাণী	warning
যোদ্ধা	warrior
আছিল	was
ধুৱা	wash
আৱৰ্জনা	waste
চোৱা	watch
পানী	water
তৰমুজ	watermelon
সোঁত	wave
পথ	way
আমি	we
দুৰ্বল	weak
দুৰ্বলতা	weakness
সম্পত্তি	wealth
সমৃদ্ধিশালী	wealthy
পিন্ধা	wear
বতৰ	weather
বিবাহ	wedding
বুধবাৰ	Wednesday
ঘাঁহ	weed
সপ্তাহ	week
সপ্তাহান্ত	weekend
ওজন	weight
অদ্ভুত	weird
স্বাগতম	welcome
কল্যাণ	welfare
বাৰু	Well
বঢ়িয়া	well done
গৈছিল	went
পশ্চিম	west
ভিজা	wet
কি	what
কি	what is
ঘেঁহু	wheat
চকা	wheel
কেতিয়া	when
যেতিয়াই	whenever
ক’ত	where
কোনটো	which
যেতিয়া	while
সুহুৰি	whistle
বগা	white
কোন	who
গোটা	whole
কাক	whom
কাৰ	whose
কিয়	why
দুষ্ট	wicked
বহল	wide
বিধৱা	widow
প্ৰস্থ	width
পত্নী	wife
বনৰীয়া	wild
জয়	win
বায়ু	wind
খিৰিকী	window
সুৰা	wine
শীতকাল	winter
মচা	wipe
তাঁৰ	wire
জ্ঞান	wisdom
জ্ঞানী	wise
ডাইনী	witch
সৈতে	with
প্ৰত্যাহাৰ	withdrawal
ভিতৰত	within
অবিহনে	without
সাক্ষী	witness
বিনোদ	witty
কুকুৰনেছীয়া	wolf
মহিলা	woman
মহিলা	women
জিকিছিল	won
আশ্চৰ্য	wonder
বঢ়িয়া	wonderful
নকৰিব	won't
কাঠ	wood
ঊল	wool
শব্দ	word
শব্দ	words
কাম	work
বিশ্ব	world
পোক	worm
উদ্বিগ্ন	worried
উপাসনা	worship
মূল্য	worth
মূল্যৰ	worth it
যোগ্য	worthy
ঘাঁ	wound
ৱাঃ	Wow
মেৰিওৱা	wrap
মণিবন্ধ	wrist
লিখা	write
লিখনি	writing
অশুদ্ধ	wrong
লিখিছিল	wrote
গজ	yard
হামিওৱা	yawn
হয়	Yeah
বছৰ	year
বছৰবোৰ	years
কিণ্ব	yeast
চিঞৰা	yell
হালধীয়া	yellow
হয়	Yes
কালি	yesterday
এতিয়ালৈকে	yet
আপুনি	you
যুৱ	young
আপোনাৰ	your
যুৱকাল	youth
আপুনিও	you too
সুস্বাদু	yummy
শূন্য	zero
প্ৰয়োজনতকৈ অধিক চিন্তা	overthinking
বিশেষ অধিকাৰ	privilege
লৈ অনা	fetch
উলিয়াই অনা	withdraw
গুগল অনুবাদ	Google Translate
মোৰ অনুমান	i guess
ইয়াক অব্যাহত ৰাখক	keep it up
জটিল অৱস্থা	critical
গোটেই অংশ	gross
গুৰুত্বপূৰ্ণ অংশ	highlight
বৰ্জিত অংশ	scrap
আপোনাক অশেষ ধন্যবাদ	thank you very much
বৈ অহা	flow
সান্ধ্য আইন বলবত্‍ হোৱা কাল	curfew
সময়তকৈ আগত	ahead
বুঢ়া আঙুলি	thumb
ভৰিৰ আঙুলি	toes
মোৰ আছিল	I had
এইটো আছিল	it was
মই আছিলোঁ	I have been
মই আছিলোঁ	I was
ঠিক আছে	all right
ঠিক আছে	Alright
আহি আছে	coming
আহি আছে	coming soon
মৰি আছে	dying
তেওঁৰ আছে	he has
মোৰ আছে	I have
ঠিক আছে	it's ok
ঠিক আছে	ok
ঠিক আছে	okay
খেলি আছে	playing
বাকী আছে	remain
তাইৰ আছে	she has
শুই আছে	sleeping
তাত আছে	there are
তাত আছে	there is
পিন্ধি আছে	wearing
ক’ত আছে	where is
আপুনি আছেনে	are you there
ঠিক আছে প্ৰিয়তম	ok dear
ঠিক আছে প্ৰিয়তম	ok honey
ঠিক আছে মোৰ প্ৰিয়তম	ok my love
ঠিক আছে সোণ	okay baby
ঠিক আছে সোণ	okay dear
কৰি আছো	doing
গৈ আছো	going
আমি আছো	we are
আপোনাৰ আজি কেনেকুৱা	how are you today
মোৰ আনন্দ	my pleasure
মেক আপ	make up
আৰু আপুনি	and you
নমস্কাৰ আপুনি কেনে আছে	hello how are you
ম‍ই আপোনাক চাব বিচাৰোঁ	I want to see you
ম‍ই আপোনাক বৰ ভাল পাওঁ	I love you so much
মই আপোনাক বুজি নাপাওঁ	I don't understand you
মই আপোনাক ভাল পাওঁ	I love you
ময়ো আপোনাক ভাল পাওঁ	I love you too
সোনকালেই আপোনাক লগ পাম	see you soon
নমস্কাৰ, আপোনাৰ কি খবৰ	hi how are you
আজি আপোনাৰ কেনে	how are you doing today
মোলৈ আপোনাৰ ছৱি পঠিয়াওক	send me your picture
নমস্কাৰ, আপোনাৰ ভাল নে	hello how are you doing
শুভ আবেলি	good afternoon
উৰিবলৈ আৰম্ভ কৰা	take off
সোনকালে আৰোগ্য হওক	get well soon
ইয়ালৈ আহক	come here
পুৱাৰ আহাৰ	breakfast
নৈশ আহাৰ	dinner
দুপৰীয়াৰ আহাৰ	lunch
লঘু আহাৰ	snack
আপোনালৈ ইমানকৈ মনত পৰে	I miss you so much
আপুনি ইমান ধুনীয়া	you are so beautiful
ম‍ই ইয়াত	I'm here
ম্যাদ উকলিছে	expired
জিলিকি উঠিব	glow up
অতি উত্তম	excellent
ধন উভতোৱা	refund
বিচাৰি উলিওৱা	find out
সুখেৰে এই দিনটো আকৌ উভতি আহে যেন	many many happy returns of the day
কিহবাৰ এক চতুৰ্থাংশ	quarter
প্ৰচলিত এক নতুন ধাৰা	trend
ইয়াত একেই	Same here
কোনো এজনে	anyone
কোনোবা এজনে	someone
অন্য এটা	another
যিকোনো এটা	either
কিবা এটা	something
আপুনি এতিয়াও আছেনে?	Are you still there?
আপুনি এতিয়া ক’ত আছে	where are you now
আপুনি এতিয়া কি কৰিছে	what are you doing now
আপুনি এতিয়া কি কৰিছে	what are you doing right now
আমাৰ এপসমূহ ব্যৱহাৰ কৰাৰ বাবে ধন্যবাদ	Thanks for using our app
কাৰোবাৰ ওপৰত চকু ৰখা	monitor
আপোনাৰ ওপৰতে	up to you
জন্মদিনৰ ওলগ জনালোঁ	happy birthday
মোক কওক	tell me
পাতলকৈ কটা	trim
খোজ কঢ়া	walking
লগত কঢ়িয়াই নিয়া সামগ্ৰী	luggage
আপুনি ক’ত আছে	where are you
আপুনি ক’ত থাকে	where do you live
মিছা কথা	lies
কল্পিত কথা	myth
কোনো কথা নাই	never mind
কোনো কথা নাই	nevermind
খুব কম	few
আগতকৈ কম	fewer
খুব কম	hardly
সবাতোকৈ কম	least
অতি কমেও	at least
প্ৰয়োগ কৰক	apply
বাতিল কৰক	Cancel
পৰীক্ষা কৰক	check
বাছনি কৰক	choose
স্পষ্ট কৰক	clarify
সংযুক্ত কৰক	connect
যোগাযোগ কৰক	contact
সম্পাদনা কৰক	edit
ফূৰ্তি কৰক	enjoy
যোগদান কৰক	join
আৰম্ভ কৰক	start
দাখিল কৰক	submit
অপেক্ষা কৰক	wait
আপোনাৰ ক’ৰ পৰা আহিছে	where are you from
পৰিত্যক্ত কৰা	abandoned
গ্ৰহণ কৰা	accept
প্ৰাপ্ত কৰা	achieve
স্বীকাৰ কৰা	acknowledge
কাৰ্য কৰা	action
যোগ কৰা	add
প্ৰশংসা কৰা	admire
প্ৰভাৱিত কৰা	affect
ভয় কৰা	afraid
প্ৰশংসা কৰা	appreciate
অভিমূল্যন কৰা	appreciation
তৰ্ক কৰা	argue
মূল্যাংকন কৰা	assess
নিযুক্ত কৰা	assign
ধাৰণা কৰা	assume
সংলগ্ন কৰা	attach
চেষ্টা কৰা	attempt
দৰদাম কৰা	bargain
ভাৰবহন কৰা	bearing
প্ৰহাৰ কৰা	beat
আৰম্ভ কৰা	begin
বেঁকা কৰা	bend
পক্ষপাত কৰা	biased
দায়ী কৰা	blame
আশীৰ্বাদ কৰা	bless
অৱৰুদ্ধ কৰা	block
প্ৰচাৰ কৰা	boost
ধাৰ কৰা	borrow
ক্ৰয় কৰা	buy
কল কৰা	call
বন্দী কৰা	capture
পালন কৰা	carry out
সলনি কৰা	change
স্নেহ কৰা	cherish
দাবী কৰা	claim
উত্‍সাহিত কৰা	come on
তুলনা কৰা	compare
তুলনা কৰা	comparison
অভিযোগ কৰা	complain
সম্পূৰ্ণ কৰা	complete
আপোচ কৰা	compromise
মনোনিবেশ কৰা	concentrate
স্বীকাৰ কৰা	confess
বিবেচনা কৰা	consider
গ্ৰাস কৰা	consume
ব্যক্ত কৰা	convey
হিচাপ কৰা	count
সৃষ্টি কৰা	create
গুড়ি কৰা	crush
আলিংগন কৰা	cuddle
অনুকুলন কৰা	custom
অস্বীকাৰ কৰা	decline
সংজ্ঞায়িত কৰা	define
পলম কৰা	delay
বিলি কৰা	deliver
বিলি কৰা	delivery
দাবী কৰা	demand
প্ৰত্যাখ্যান কৰা	deny
নিয়োজিত কৰা	deploy
বৰ্ণনা কৰা	describe
ধ্বংস কৰা	destroy
চিনাক্ত কৰা	detect
নিৰ্দ্ধাৰণ কৰা	determine
বিকাশ কৰা	develop
খনন কৰা	dig
বৰ্জন কৰা	discard
আৱিষ্কাৰ কৰা	discover
আলোচনা কৰা	discuss
পাৰ্থক্য কৰা	distinguish
আমনি কৰা	disturb
ভাগ কৰা	divide
দান কৰা	donate
পান কৰা	drink
বাস কৰা	dwell
উপাৰ্জন কৰা	earn
বিব্ৰত কৰা	embarrassing
সক্ষম কৰা	enable
বিৰোধিতা কৰা	encounter
সহ্য কৰা	endure
বৰ্ধন কৰা	enhance
নিশ্চিত কৰা	ensure
প্ৰৱেশ কৰা	enter
স্থাপন কৰা	establish
মূল্যায়ন কৰা	evaluate
পৰীক্ষা কৰা	examine
কাৰ্যান্বিত কৰা	execute
কাৰ্যান্বিত কৰা	execution
সম্প্ৰসাৰণ কৰা	expand
আশা কৰা	expect
ব্যাখ্যা কৰা	explain
অণ্বেষণ কৰা	explore
প্ৰকাশ কৰা	express
নিষ্কাশন কৰা	extract
উপলভ্য কৰা	facilitate
অনুভৱ কৰা	feel
যুঁজ কৰা	fighting
নিৰ্ধাৰণ কৰা	figure out
সন্ধান কৰা	find
সমাপ্ত কৰা	finished
ঠিক কৰা	fix
ওলোটা কৰা	flip
অনুসৰণ কৰা	follow
ক্ষমা কৰা	forgive
লাভ কৰা	gain
সৃষ্টি কৰা	generate
অনুসৰণ কৰা	ghosting
পৰিত্যাগ কৰা	give up
সম্বোধন কৰা	greet
ৰক্ষা কৰা	guard
অনুমান কৰা	guess
আনন্দ কৰা	have fun
সংকোচ কৰা	hesitate
পৰ্বতাৰোহণ কৰা	hiking
ভাড়া কৰা	hire
সোনকাল কৰা	hurry up
চিনাক্ত কৰা	identify
অগ্ৰাহ্য কৰা	ignore
কল্পনা কৰা	imagine
প্ৰয়োগ কৰা	implement
আৰোপ কৰা	impose
প্ৰভাৱিত কৰা	impress
উন্নত কৰা	improve
বৃদ্ধি কৰা	increase
অৱগত কৰা	inform
প্ৰবিষ্ট কৰা	insert
জোৰ কৰা	insist
অনুপ্ৰাণিত কৰা	inspire
স্থাপন কৰা	install
ভাৱ-বিনিময় কৰা	interact
বিনিয়োগ কৰা	invest
অনুসন্ধান কৰা	investigate
ব্যায়াম কৰা	jogging
মাত্ৰ কৰা	just do it
ধেমালি কৰা	kidding
স্থাপন কৰা	lay
পচন্দ কৰা	like
নিৰ্মাণ কৰা	make
ব্যৱস্থাপনা কৰা	manage
মীমাংসা কৰা	negotiate
অনুভৱ কৰা	observe
প্ৰাপ্ত কৰা	obtain
বন্ধ কৰা	off
পৰিশোধ কৰা	pay
প্ৰস্ৰাৱ কৰা	pee
সম্পাদন কৰা	perform
অধিকাৰ কৰা	possess
প্ৰশংসা কৰা	praise
ধেমালি কৰা	prank
প্ৰাৰ্থনা কৰা	pray
পক্ষপাত কৰা	prejudice
প্ৰতিৰোধ কৰা	prevent
প্ৰচাৰ কৰা	promote
ৰক্ষা কৰা	protect
প্ৰমাণ কৰা	prove
প্ৰদান কৰা	provide
প্ৰদান কৰা	provided
ক্ৰয় কৰা	purchase
অনুসৰণ কৰা	pursue
বৃদ্ধি কৰা	raise
চিনাক্ত কৰা	recognize
ৰিডীম কৰা	redeem
হ্ৰাস কৰা	reduce
অস্বীকাৰ কৰা	refuse
পঞ্জীয়ন কৰা	register
অনুশোচনা কৰা	regret
সম্পৰ্কিত কৰা	relate
প্ৰৰ্তিস্থাপন কৰা	replace
অভিযোগ কৰা	report
বিৰোধ কৰা	resist
বিৰোধ কৰা	resistance
উদ্ধাৰ কৰা	retrieve
প্ৰকাশ কৰা.	reveal
খৰধৰ কৰা	rush
সন্তুষ্ট কৰা	satisfy
সঞ্চয় কৰা	save
জব্দ কৰা	seize
চয়ন কৰা	select
বিক্ৰী কৰা	sell
প্ৰেৰণ কৰা	sent
সেৱা কৰা	serve
স্থাপন কৰা	set
নিষ্পত্তি কৰা	settle
স্থাপন কৰা	set up
ভাগ-বতৰা কৰা	share
স্থানান্তৰ কৰা	shift
নিক্ষেপ কৰা	shoot
বজাৰ কৰা	shopping
নষ্ট কৰা	spoil
নষ্ট কৰা	spoiled
প্ৰসাৰিত কৰা	stretch
আঘাত কৰা	strike
চেষ্টা কৰা	strive
অধ্যয়ন কৰা	study
দাখিল কৰা	submission
আচৰিত কৰা	surprise
চিন্তা কৰা	think
অনুবাদ কৰা	translate
ব্যৱহাৰ কৰা	treat
চেষ্টা কৰা	try
বিকশিত কৰা	upgrade
সত্যাপন কৰা	verify
দৰ্শন কৰা	visit
সতৰ্ক কৰা	warn
বাঞ্চা কৰা	wish
ব্যায়াম কৰা	work out
চিন্তা কৰা	worry
উত্‍পাদন কৰা	yield
ছুৰিৰে কৰা আঘাত	stab
ঘৰত কৰা কাম	homework
আবণ্টন কৰা কাৰ্য	assignment
নিক্ষেপ কৰা কাৰ্য	shot
বিলি কৰা হ’ল	delivered
চেষ্টা কৰা হৈছিল	tried
সংলগ্ন কৰা হৈছে	attached
দাবী কৰা হৈছে	demanding
অস্বীকাৰ কৰা হৈছে	denied
আশা কৰা হৈছে	expected
আশা কৰা হৈছে	hopefully
লক্ষ্য কৰা হৈছে	noticed
প্ৰস্তুত কৰা হৈছে	prepared
উপলব্ধি কৰা হৈছে	realized
প্ৰাপ্ত কৰা হৈছে	received
অস্বীকাৰ কৰা হৈছে	refused
চুৰি কৰা হৈছে	stolen
ধাৰণা কৰা হৈছে	supposed
অনুগ্ৰহ কৰি	kindly
অনুগ্ৰহ কৰি	please
অতিক্ৰম কৰি অহা	overcome
অধ্যয়ন কৰি আছে	studying
অপেক্ষা কৰি আছে	waiting
কল কৰিছিল	called
অনুভৱ কৰিছিল	felt
উল্লেখ কৰিছিল	mentioned
প্ৰাপ্ত কৰিছিল	obtained
আৰম্ভ কৰিছিল	started
প্ৰাপ্ত কৰিছে	getting
অংকন কৰি থকা	drawing
সংগ্ৰাম কৰি থকা	struggling
কাম কৰি থকা	working
ক্ষমা কৰিব	excuse
ক্ষমা কৰিব	excuse me
ক্ষমা কৰিব	pardon
আপুনি কৰিব পাৰে	you can
মন কৰিবলগীয়া	remarkable
ম‍ই কৰিম	I will
ভাল কৰিলে	good job
আপুনি কৰে নে	do you
ম‍ই কৰোঁ	I do
মান্তি কৰোৱা	convince
চিনাকি কৰোৱা	introduce
মান্তি কৰোৱা	persuade
মোক কল কৰক	call me
নলাৰ কাম কৰা লোক	plumber
আপোনাৰ কামটো কি	what is your job
এয়া কি	what is this
তুমি কি ক’ব বিছাৰিছা মই বুজি পোৱা নাই	I don't understand what you mean
আপুনি কি কৰিছে	what are you doing
আপুনি কি কৰে	what do you do
আপোনাৰ কি খবৰ	how are you doing
যি কি নহওক	anyways
অন্তিম কিন্তু নহয়	last but not least
আপুনি কি বিচাৰে	what do you want
আপুনি কি বুজাইছে	what do you mean
আপোনাৰ কেনে	how are you
আপোনাৰ কেনে	how do you do
ধ্যান কেন্দ্ৰিত	focus
ভয়ত কোঁচ-মোচ খোৱা	cringe
শোৱনি কোঠা	bedroom
আপুনি কোন	who are you
এয়া কোন	who is this
কথা কোৱা	speak
ফুচফুচাই কোৱা	whisper
আপোনাৰ ক্ষেত্ৰত কি	how about you
প্ৰচণ্ড খং	wrath
কি খবৰ	what's up
আপুনি খাইছে নে	have you eaten
মাইলৰ খুঁটি	milestone
ছ’কাৰ খেল	soccer
খাপ খোৱা	adapt
খাপ খোৱা	adjust
ভয় খোৱা	sacred
ভয় খোৱা	scared
খাপ খোৱা	suit
উৰি গ’ল	flew
পোৱা গ’ল	found
প্ৰিয় গ্ৰাহক	Dear Customer
অলৌকিক ঘটনা	miracle
অদ্ভুত ঘটনা	phenomenon
মূৰ ঘুৰণি	dizzy
বেকিং চ’ডা	baking soda
শস্য চপোৱা	harvest
কপৌ চৰাই	pigeon
এৰাই চলক	avoid
মানি চলা	abide
মানি চলা	comply
মানি চলা	obey
চাইকেল চলোৱা	cycling
ঠাই চাই ফুৰা	sightseeing
কাঁটা চামুচ	fork
মৰমৰ চাৰ	Dear Sir
দন্ত চিকিত্‍সক	dentist
আত্মাই চিৰশান্তি লাভ কৰক	rest in peace
সম্ভাষণ জনোৱা	greeting
আপোনালৈ জন্মদিনৰ শুভ কামনা থাকিল	happy birthday to you
অতি জৰুৰী	urgent
ৰাতিপুৱাৰ জলপান খাওক	have breakfast
আপুনি জানে	You know
ম‍ই জানো	I know
পোহনীয়া জীৱ	pet
আপোনাৰ জীৱিকা কি	what do you do for a living
‘ জোৰ দিয়া	emphasize
ভাও জোৰা	pretend
চৰ্দি জ্বৰ	flu
মই ঠিকেই আছো	I am fine
বস্তুৰ তালিকা	inventory
সাগৰ তীৰ	beach
মই তোমাক পছন্দ কৰোঁ	I like you
মই তোমাক বিচাৰোঁ	I want you
মোৰ তোমালৈ মনত পৰিছে	I miss you
উচ্চাকাংক্ষা থকা	ambitious
উপস্থিত থকা	attend
ভিৰ থকা	crowded
ব্যস্ত থকা	engage
উপঙি থকা	float
লুকাই থকা	hidden
লুকাই থকা	hide
এনেই থকা	idle
হাঁহি থকা	laughing
জীয়াই থকা	live
জীয়াই থকা	living
মিল থকা	match
আবেশত থকা	obsessed
বাকী থকা	outstanding
বাকী থকা	pending
পিছুৱাই থকা	postpone
পঢ়ি থকা	reading
নকৰাকৈ থকা	refrain
বাকী থকা	remaining
মিল থকা	resemble
সন্ধানত থকা	sought
ভোকত থকা	starving
জীয়াই থকা	survive
উপঙি থকা	suspended
জিলিকি থকা	vivid
বতাহ থকা	windy
শুভেচ্ছা থাকিল	all the best
শুভেচ্ছা থাকিল	best of luck
শুভেচ্ছা থাকিল	good luck
অন্তৰ্ভুক্ত থাকে	contains
জীয়াই থাকে	lives
মথি থোৱা আটা	dough
মৰমৰ দল	Dear Team
শুভ দিন	good day
ছুটীৰ দিন	holiday
আপোনাৰ দিনটো কেনে আছিল	how was your day
বহু দিন দেখা হোৱা নাই	long time no see
যিমান দিন ধৰি	as long as
পৰামৰ্শ দিয়া	advise
অনুমতি দিয়া	allow
সন্মতি দিয়া	allowed
ধ্যান দিয়া	attention
ফুৱাই দিয়া	blow
অংগীকাৰ দিয়া	commit
বৰঙণি দিয়া	contribute
এৰি দিয়া	discharge
জাঁপ দিয়া	dive
জোৰ দিয়া	emphasis
উত্‍সাহ দিয়া	encourage
নিৰ্দেশনা দিয়া	guide
ন্যায্যতা দিয়া	justify
মুক্তি দিয়া	launch
নেতৃত্ব দিয়া	lead
ধাৰলৈ দিয়া	lend
কৰিবলৈ দিয়া	let
অনুমতি দিয়া	permit
অগ্ৰাধিকাদ দিয়া	prefer
এৰি দিয়া	quit
প্ৰস্তাৱ দিয়া	recommend
মুক্তি দিয়া	release
সকাহ দিয়া	relieve
যাঁচি দিয়া	render
ত্যাগপত্ৰ দিয়া	resign
উভতাই দিয়া	return
বাদ দিয়া	skip
ভগাই দিয়া	split
চেপি দিয়া	squeeze
পৰামৰ্শ দিয়া	suggest
ৰ’দ দিয়া	sunny
বাদ দিয়া হৈছে	dropped
এই দিশে	towards
ম‍ই দুঃখিত	I'm sorry
যিমান দুৰ	so far
কাইলৈ দেখা হ'ম	see you tomorrow
ম‍ই দেখিছোঁ	I see
মোক দেখুওৱা	show me
গেলামালৰ দোকান	grocery
সৰু দোকান	stall
অশেষ ধন্যবাদ	thank you so much
ধৈৰ্য ধৰক	hold on
লাগি ধৰা	clingy
খামুচি ধৰা	grab
খামুচি ধৰা	grasp
জোৰকৈ ধৰা	grip
লাগি ধৰা	stuck
আঁত ধৰোঁতা	host
ধীৰে ধীৰে	slowly
দেখিবলৈ ধুনীয়া	good looking
আপুনি ধুনীয়া	you are beautiful
কাপোৰ ধুৱা	laundry
চিন্তা নকৰিব	Don't worry
মই নকৰোঁ	I don't
শুভ নৱবৰ্ষ	happy new year
যিয়েই নহওক	anyway
যিয়েই নহওক	by the way
যিয়েই নহওক	nevertheless
যিয়েই নহওক	whatever
এটাও নহয়	neither
কেতিয়াও নহয়	never
কোনো নহয়	nobody
কোনোপধ্যে নহয়	not at all
বেয়া নহয়	not bad
এতিয়া নহয়	Not now
এতিয়ালৈকে নহয়	not yet
কিয় নহয়	why not
একো নাই	none
একো নাই	nothing
মই নাজানো	I do not know
ম‍ই নাজানো	I don't know
মই নাজানো	I don’t know
প্ৰথম নাম	first name
আপোনাৰ নাম কি	what is your name
আপোনাৰ নাম কি	what's your name
মোৰ নাম হৈছে	my name is
তেওঁলোকে নিজে	themselves
নিজে নিজে আৰোগ্য হোৱা	self healing
মই নিজেই	myself
আপুনি নিজেই	yourself
গুৰুত্ব নিদিয়া	neglect
ধ্যান নিদিয়াকৈ	regardless
টানি নিয়া	drag
আজি নিশা	tonight
আপোনাৰ নিশা কেনে আছিল	how was your night
হয় নিশ্চয়	yes of course
তুমি নে	are you
য’ত নেকি	whereas
মই নোৱাৰোঁ	I can't
মই পচন্দ কৰোঁ	I like
প্ৰাথমিক পছন্দ	preference
লানি পতা	queue
নিৰ্গমন পথ	outlet
ম্লান পৰা	fade
কম পৰা	shortage
ছাঁ পৰা ঠাই	shade
ইমূৰৰ পৰা সিমূৰলৈ	across
ছাঁ পৰা স্থান	shed
বাদ পৰি যোৱা	miss
ইয়াৰ পৰিৱৰ্তে	instead
বুজি পাইছিল	understood
এইটো পাইছো	got it
সাৰ পাই থকা	awake
ওকট পাকট লগা	nausea
আপোনাক পাছত লগ পাম	see you later
কথা পাতক	talk
হ’ব পাৰে	might
ম‍ই পাৰোঁ	I can
আমি পাৰোঁ	we can
আহি পালে	arrived
বৃদ্ধি পালে	increased
ইয়াৰ পিছত	next to
মৰমৰ পিতৃ-মাতৃসকল	Dear Parents
পোছাক পিন্ধক	get dressed
ধৰা পেলাইছিল	caught
পুতি পেলোৱা	buried
মনত পেলোৱা	recall
মনত পেলোৱা	remind
থু পেলোৱা	spit
আনুষ্ঠানিক পোছাক	uniform
লাজ পোৱা	ashamed
আমনি পোৱা	bother
বেয়া পোৱা	hate
লগ পোৱা	meet
ত্ৰাণ পোৱা	relief
দেখা পোৱা	seen
বুজি পোৱা	understand
সাৰ পোৱা	wake up
গৰু পোৱালী	calf
মেকুৰী পোৱালী	kitten
ভৰণ পোষণ কৰা	foster
এটা প্ৰকাৰৰ	kinda
কোনো প্ৰকাৰেই নহয়	no way
ইচ্ছা প্ৰকাশ কৰা	willing
উত্‍সাহ প্ৰদান	incentive
মিঠাৰ প্ৰৱণতা	sweet tooth
অধিকাৰ প্ৰাপ্ত	entitled
মোৰ প্ৰিয়	My dear
নমস্কাৰ প্ৰিয়তম	hello dear
মোৰ প্ৰিয়তম	my love
বাৰু প্ৰিয়তম	okay honey
হয় প্ৰিয়তম	yes dear
হয় প্ৰিয়তমা	yes baby
হয় প্ৰিয়ে	yes honey
ঘূৰি ফুৰা	wander
ফুল ফুলা	bloom
শৰীৰাংশ ফুলা	swelling
শৰীৰাংশ ফুলা	swollen
নৰা বগৰী	peach
ভাৰসাম্যতা বজাই ৰখা	balance
মোৰ বন্ধু	my friend
আপোনাৰ বয়স কিমান	how old are you
ধোঁৱা বৰণ	grey
শুভ বৰদিন	merry christmas
কামৰ বস্তু	utility
খুড়া বা জেঠাইৰ পুতেক বা জীয়েক	cousin
মাজতে বাধা দিয়া	interrupt
পতি বা পত্নী	spouse
আপোনাৰ বাবে	for you
সীমাৰ বাহিৰ কৰা	exceed
দেশৰ বাহিৰত	abroad
তাৰ বাহিৰে	beyond
ইয়াৰ বাহিৰে	else
ইয়াৰ বাহিৰে	except
ক্ৰমাগত বিকাশ	evolution
ক্ষমা বিচৰা	apologize
ম‍ই বিচাৰোঁ	I want
বিবাহ বিচ্ছেদ	divorce
ৰসায়ন বিদ্যা	chemistry
আপুনি বিবাহিত নে	are you married
আপুনি বিবাহিত নে অবিবাহিত	are you married or single
শুল্ক বিভাগ	customs
শুভ বিমানযাত্ৰা	safe flight
ৰোগ বিয়পা অৱস্থা	infection
পুডিং বিশেষ	porridge
ক্ৰিয়া বিশেষণ	adverb
মূৰৰ বিষ	headache
ডিঙি বিষ	sore throat
সৌন্দৰ্য বিষয়ক	aesthetic
আপোনাৰ বিষয়ে কি	what about you
মই বুজাইছোঁ	I mean
মই বুজি নাইপোৱা	I do not understand
মই বুজি পাইছোঁ	I understand
ম‍ই বুজি পোৱা নাই	I don't understand
ম‍ই বুজি পোৱা নাই	I don’t understand
স্মৃতিত বেদনাতুৰ	nostalgic
বৰ বেয়া	horrible
ইয়াতকৈও বেয়া	worse
আটাইতকৈ বেয়া	worst
চিনাকি ব্যক্তি	acquaintance
নিপূণতাৰে ব্যৱহাৰ কৰা	manipulate
আপুনি ব্যস্ত নেকি	are you busy
প্ৰেমৰ ভাও	flirt
কাৰ্যৰ ভাৰ দিয়া	commission
মোৰ ভাল	I'm good
বহুত ভাল	very good
সেইটো ভাল কথা	that's good
ম‍ই ভাল পাওঁ	I love
তোমাক ভাল পাওঁ	love you
মই ভালে আছোঁ	I'm fine
মোৰ ভাৱ হৈছে	I think
এটা ভাষা কেতিয়াও পৰ্যাপ্ত নহয়	one language is never enough
ঈশ্বৰে মংগল কৰক	god bless you
চকুৰ মণি	pupil
মিছা মতা	lying
আপোনালৈ মনত পৰিছে	miss you
মনে মনে থাক	shut up
ইমান মৰমলগা	so cute
খুন্দা মৰা	crash
ডুব মৰা	dip
জাপ মৰা	jump
জাপ মৰা	leap
তিমি মাছ	whale
আমাৰ মাজতে	among us
তাৰ মাজতে	meanwhile
আসনবোৰৰ মাজেৰে অহা-যোৱা কৰা ঠাই	aisle
বোকা মাটি	clay
অত্যাধিক মাত্ৰাত	bulk
গাহৰি মাংস	pork
আপুনি মোক ভাল পায় নে	do you love me
ধনৰ মোনা	purse
ধনৰ মোনা	wallet
মই মোৰ ডাঙৰ দাদাক ভাল পাওঁ	I love my big brother
মই মোৰ ডাঙৰ বাইদেউক ভাল পাওঁ	I love my big sister
মই মোৰ দেউতাক ভাল পাওঁ	I love my father
সুপ্ৰভাত মোৰ প্ৰিয়তম	good morning my love
হয় মোৰ প্ৰিয়তম	yes my love
মই মোৰ মাক ভাল পাওঁ	I love my mother
মই মোৰ সৰু ভণ্টিক ভাল পাওঁ	I love my little sister
মই মোৰ সৰু ভাইটিক ভাল পাওঁ	I love my little brother
বাৰু মোৰ সোণ	okay my love
জল যাত্ৰা	sailing
স্বাদ যুক্ত	tasty
অদ্ভূত যেন লগা	awkward
টুপনি যোৱা	asleep
মিলি যোৱা	blend
চুচৰি যোৱা	crawl
পচি যোৱা	decay
মৰি যোৱা	die
মূৰ্চা যোৱা	faint
পৰি যোৱা	fall
পৰি যোৱা	fell
বৈ যোৱা	flaw
পলাই যোৱা	flee
শুবলৈ যোৱা	go to bed
ভ্রমণত যোৱা	hike
ফুলি যোৱা	swell
লৈ যোৱা	take away
উঁৱলি যোৱা	worn
পাহৰি যোৱা লোক	fluffy
ধৰি ৰখা	hold
বজাই ৰখা	maintain
মনত ৰখা	remember
ধৰি ৰখা	retain
ধৰি ৰখা	retention
বজাই ৰখা	sustain
কঁকালৰ ৰচী	belt
অব্যাহত ৰাখক	carry on
অব্যাহত ৰাখক	continue
অব্যাহত ৰাখক	resume
প্লেগ ৰোগ	plague
যত্ন লওক	take care
আমাৰ লক্ষ্য: বিশ্বৰ তথ্য সংগঠিত কৰা আৰু ইয়াক সাৰ্বজনীনভাৱে উপলব্ধ আৰু উপযোগী কৰি তোলা	Our mission: to organize the world's information and make it universally accessible and useful.
আমাৰ লক্ষ্য: সকলোকে, সকলোতে বিশ্বখন বুজি পোৱাত সক্ষম কৰা আৰু ভাষাবোৰেৰে নিজকে প্ৰকাশ কৰা	Our mission: to enable everyone, everywhere to understand the world and express themselves across languages.
আপোনাক লগ পাই ভাল লাগিল	nice to meet you
আপোনাক লগ পাম	see you
আমনি লগা	bore
আঘাত লগা	hurt
ঘাঁ লগা	scratch
চকুত লগা	spectacular
আঘাত লগা	struck
চকুত লগা	stunning
পিয়াহ লগা	thirsty
ভাল লগা কাম	hobby
লগে লগে	immediate
যোৰা লগোৱা	combine
কাজিয়া লাগিছিল	fought
এনে লাগিছে	seem
যেন লাগিছে	seems
আশীৰ্বাদ লাভ কৰা	blessed
লাহে লাহে	gradually
লাহে লাহে	slow
ইয়াত লিখক	Write here
অবিবাহিত লোক	bachelor
শুহি লোৱা	absorb
মানি লোৱা	admit
তুলি লোৱা	adopt
যতন লোৱা	caring
সিদ্ধান্ত লোৱা	decide
আঁকোৱালি লোৱা	embrace
খতিয়ান লোৱা	follow up
জোখ লোৱা	gauge
উদ্যোগ লোৱা	initiative
জোখ লোৱা	measure
পদক্ষেপ লোৱা	move
জিৰণি লোৱা	rest
সিদ্ধান্ত লোৱা হ’ল	decided
টুকি লোৱা হ’ল	noted
ধানজাতীয় শস্য	cereal
পাৰ্ছলে শাক	parsley
মৰমৰ শিক্ষাৰ্থীসকল	Dear students
আপোনাক শুভকামনা জনাইছো	wish you all the best
দিনটো শুভ হওক	have a good day
দিনটো শুভ হওক	have a nice day
আমি শ্বিপমেণ্টটোৰ অনুসন্ধান কৰি থকাৰ সময়ত ধৈৰ্য ধৰাৰ বাবে আপোনাক ধন্যবাদ	Thank you for your patience while we investigate shipment
মৰমৰ সকলোবোৰ	Dear All
কিমান সঘনাই	how often
পুনৰ সঞ্চয় কৰা	restore
কুঁৱলী সনা	foggy
ৰং সনা	paint
শুভ সন্ধিয়া	good evening
বেয়া সপোন	nightmare
ধুনীয়া সপোন দেখা	sweet dreams
আজৰিৰ সময়	leisure
একেলগে সময় অতিবাহিত কৰা	hang out
সেই সময়ত	during
একে সময়তে	simultaneously
কোনো সমস্যা নাই	no problem
ঝাড়ুৰে সৰা	sweep
কিহবাৰ সলনি	instead of
অন্তিম সংস্কাৰ	funeral
গুৰুত্ব সহকাৰে	seriously
ঘৰুৱা সহায়িকা	maid
নৈশ সাজ	supper
কৰিবলৈ সামৰ্থ্য হোৱা	afford
নিত্য সূচী	routine
ঠিক সেইমতে	exactly
ৰংবিহীন সেউজীয়া ধাৰণাবোৰ খঙত শুই আছিল	colorless green ideas slept furiously
মই সেয়াই আশা কৰোঁ	I hope so
শূন্য স্থান	vacuum
নিৰ্দিষ্ট স্থান	venue
ৰিক্ত স্থান	void
উদাহৰণ স্বৰূপে	For example
আপোনাক স্বাগতম	you are welcome
আপোনাক স্বাগতম	you're welcome
আপোনাক স্বাগতম	you’re welcome
আপোনাক স্বাগতম	your welcome
সাৱধান হওক	be careful
ধৰা হওক	suppose
মোৰ হ’ভাৰক্ৰাফ্টখন ঈল মাছেৰে ভৰি আছে	My hovercraft is full of eels
মই হ'ম	I would be
এইটো হয়	it is
সন্তুষ্ট হ’ল	convinced
কৰা হ’ল	done
বিক্ৰী হ’ল	sold
থিয় হ'ল	stood
কি হ’ল	what happened
দহ হাজাৰ	ten thousand
এপাত হাতৰ অলংকাৰ	bracelet
কেতিয়াও হাৰ নামানিব	never give up
বিক্ৰী হৈ গ’ল	sold out
খৰচ হৈ গ’ল	spent
হাজিৰ হৈছিল	appeared
আৰম্ভ হৈছিল	began
ব্যৰ্থ হৈছিল	failed
দিয়া হৈছে	given
তেওঁ হৈছে	he is
ৰখা হৈছে	kept
অৰ্থ হৈছে	means
অৰ্থ হৈছে	meant
তাই হৈছে	she is
সেইটো হৈছে	that is
তেওঁলোক হৈছে	they are
যিজন হৈছে	who is
লিখা হৈছে	written
আপুনি হৈছে	you are
সংযুক্ত হৈ থকা	associated
বিস্তাৰ হৈ থকা	extent
পূৰ্ণ হৈ থকা	filled
সুৰক্ষিত হৈ থাকক	stay safe
অতিষ্ঠ হৈ পৰিছে	fed up
ঠিক হৈ যাব	It's okay
উন্নত হোৱা	advanced
বিৰক্ত হোৱা	annoyed
প্ৰকট হোৱা	appear
বিৰক্ত হোৱা	bored
জন্ম হোৱা	born
পতন হোৱা	collapse
জয়ী হোৱা	conquer
সমুখীন হোৱা	cope
পাৰ হোৱা	cross
পলম হোৱা	delayed
হতাশ হোৱা	depressed
মৃত্যু হোৱা	died
অক্ষম হোৱা	disabled
বিব্ৰত হোৱা	embarrassed
বিকশিত হোৱা	evolve
উত্তেজিত হোৱা	excited
ব্যৰ্থ হোৱা	fail
বিফল হোৱা	failure
যোগ্য হোৱা	fit
বিকশিত হোৱা	grow
আৰোগ্য হোৱা	heal
মিলন হোৱা	mingle
ঋণী হোৱা	owe
প্ৰস্তুত হোৱা	prepare
উপনীত হোৱা	reach
উদয় হোৱা	rise
থিয় হোৱা	stand
সফল হোৱা	succeed
আচৰিত হোৱা	surprised
সফল হোৱা	thrive
