а	a
чанго	a little
дагьаб	a little
дагь	a little
гӀемер	a lot
гӀемер	a lot of
рехун тезе	abandon
жахӀабго тезе	abandon
рехун тараб	abandoned
чӀунтизе тараб	abandoned
цӀунизе	abide
кӀванагӀан	ability
рес бегьарабгӀан	ability
кӀвейи	able
долда тӀасан	about
тӀад	above
къватӀисел улкабазда	abroad
гьечӀолъи	absence
ургъел гьечӀеб	absent
тӀубанго	absolutely
къурчӀизе	absorb
чӀван къотӀараб гуреб	abstract
абстрактный	abstract
магӀна гьечӀеб	absurd
тӀокӀлъи	abundance
гьарзаяб	abundant
бечедаб	abundant
инжит гьавизе	abuse
акцент	accent
босизе	accept
нух	access
ракӀалдаго гьечӀого ккей	accident
жинди-жиндир бакӀалда лъун рекъезаби	accommodation
тӀубазабизе	accomplish
кӀвараб	accomplished
рекъон	according
рикӀкӀен	account
хӀисаб	account
мухӀканлъи	accuracy
мухӀканлъи	accurate
гӀайиб гӀунтӀизабурав	accused
унти	ache
щвезе	achieve
щвей	achievement
бахин	achievement
бичӀчӀизе	acknowledge
лъай-хъвай	acquaintance
щвезе	acquire
гьабизе	acquire
щвараб	acquired
мустахӀикълъи	acquisition
букӀинаби	acquisition
щвей	acquisition
боси	acquisition
бати	acquisition
гьоркьосан	across
иш билълъинабизе	act
иш гьаби	action
активный	active
жигар	activities
хӀаракат	activities
жигарлъи	activity
хӀаракатчилъи	activity
хӀаракат бахъи	activity
актер	actor
хӀакъикъияб	actual
унго-унгояб	actual
битӀараб жо	actually
бегӀераб	acute
бухӀараб	acute
хисулел къватӀисел шартӀазде черх ругьунлъизабизе	adapt
жубазе	add
дагьабги базе	add
кьезе	add
рагӀиятлъиялда вукӀаго	addicted
тӀаде цӀикӀкӀинаби	addition
тӀаде жубай	addition
тӀадеги гьабулеб	additional
адрес	address
данд рекъон кколеб	adequate
мадугьалихъ бугеб	adjacent
прилагательное	adjective
нухда тӀами	adjust
низамалде ккезабизе	adjust
хӀайранлъизе	admire
гьабураб гӀаданлъи-лъикӀлъиялъул къимат лъай	admit
васлъун гьавизе	adopt
гьайбатаб	adorable
хӀайранлъизарулеб	adorable
цебетӀей	advance
бищунго гӀакъилаб	advanced
тӀокӀлъи	advantage
лъугьа-бахъараб иш	adventure
лъугьа-бахъин	adventure
наречие	adverb
реклама	advertisement
реклама	advertising
маслихӀат	advice
гӀакълу кьезе цӀодор гьавизе	advise
маслихӀатаб жо бицине	advise
судалъул ишалъе божилъи гьабурав чи	advocate
эстетический	aesthetic
роман	affair
зулму-хӀалалдалъун гьабизе тӀами	affect
тӀолареб гьудуллъи	affection
щулияб бухьен	affection
изну кьезе	afford
ихтияр кьезе	afford
ине нух бугеб	affordable
хӀинкъун	afraid
цинги	after
къалъулгӀуж	afternoon
цинги	afterwards
нахъа	afterwards
хадуб	afterwards
цӀидасан	again
дандбитӀун	against
сон	age
агентство	agency
агент	agent
тушманаб къасд букӀин	aggressive
квешаб	aggressive
бигьаго гьетӀизабизе кӀолеб	agile
хьетӀулеб	agile
нахъехун	ago
нахъе	ago
изну	agree
разилъи	agree
рекъей	agree
рекъезаби	agreement
данде ккезаби	agreement
росдал магӀишат	agriculture
цебе бугеб	ahead
цебе чӀараб	ahead
цебе чӀун бугеб	ahead
кумек	aid
ишан	aim
гӀуж	aim
гьава	air
аэропорт	airport
кьер	aisle
мухъ	aisle
ракӀхӀинкъи	alarm
рахӀатхвей	alarm
гӀаракъи	alcohol
ракӀхӀинкъи	alert
рахӀатхвей	alert
чӀагояб	alive
рухӀ бугеб	alive
сахабго	all
кинабго лъикӀ буго	all right
кинабниги лъикӀаб	all the best
изну кьезе	allow
ихтияр кьезе	allow
изну кьезе	allowed
гӀага-шагарго	almost
живго	alone
гӀебеде	along
цебего	already
агьа	Alright
гьебги	also
кӀиго хӀукмуялъул цояб бищичӀого чара гьечӀолъи	alternative
кин бугониги	although
кидаго	always
эм	am
гӀажаибаб	amazing
магӀна бахчараб	ambiguous
чӀухӀдари	ambition
цебе тӀамурав	ambitious
цо хӀалалдаса цогиялде унев	ambitious
битӀизабизе	amend
бакьулъ	amid
бакьулъ	among
нилъеда гъорлъ	among us
рикӀкӀен	amount
гъира ккезабулеб	amusing
эн	an
анализ	analysis
умумул	ancestors
лангар	anchor
некӀсияб	ancient
и	and
ва мунги	and you
малаик	angel
ццидаллъи	anger
цили	angle
ццидалав	angry
ццидалай	angry
ццидалаб	angry
рухӀчӀаголъи	animal
хӀайван	animal
анат. хӀатӀихинкӀ	ankle
лъагӀел тӀубай	anniversary
игӀлан	announcement
баян кьей	announcement
лъазаби	announcement
рахӀат хун лъугьине	annoy
ццин бахъарав	annoyed
ццин бахъинабизе	annoying
щибаб лъагӀалилаб	annual
санайилаб	annual
анонимияб	anonymous
цогияб	another
жаваб	answer
цебеккунго лъазе	anticipate
рахӀат гьечӀого	anxiety
рахӀат хвараб	anxious
бокьараб	any
цӀикӀкӀун	anymore
гӀемер	anymore
бокьараб	anyone
щибниги гуро	anything
кинбугонаниниги	anyway
кин бугониги	anyways
батӀаго	apart
батӀа тӀун	apart
квартира	apartment
тӀаса лъугьине	apologize
берда бихьулеб	apparent
якъинаб	apparent
дагӀба гьечӀеб	apparent
батила	apparently
буссинаби	appeal
хьвадизаби	appeal
баккизе	appear
тӀасияб рахъ	appearance
къватӀисеб рахъ	appearance
сипат	appearance
тӀаде балагьун бихьулеб рахъ	appearance
куц	appearance
баккана	appeared
кваниде хьул	appetite
квен бокьи	appetite
кваниде гъира	appetite
гӀеч	apple
баян кьей	application
хӀалтӀизабизе	apply
тӀамизе	appointment
къимат кьола	appreciate
къимат лъай	appreciation
рекъей	approach
рекъолеб	appropriate
лъикӀаблъун	approval
битӀараблъун рикӀкӀин	approval
тасдикъ гьабизе	approve
ритӀухъ гьабизе	approve
къабул гьабизе	approve
лъикӀаблъун	approved
мисалияб куцалъ	approximately
апрель	april
эркенаб	arbitrary
проект бахъулев специалист	architect
архитектура	architecture
идара	archive
буго	are
мун?	are you
нуж регӀун руги?	are you busy
мун росасе ун йигейи-for girls	are you married
дуца чӀужу ячун йигейи -for boys	are you married
мун рукъалда вусун вуги или жеги мунгойищ вуге	are you married or single
мун жеги гьениваищ?	Are you still there?
мун гъоваищ	are you there
бутӀа	area
дагӀбадизе	argue
къацандизе	argue
далил	argument
хӀужжа	argument
баккизе	arise
квер	arm
армия	army
серун бугеб	around
гӀуцӀизе	arrange
гьабизе	arrange
къотӀи-къай	arrangement
бачӀин	arrival
тӀаде щвей	arrival
бачӀине	arrive
бачӀине	arrived
гӀамал кӀодолъи	arrogant
чӀорил сурат	arrow
гьунар	art
махщел	art
макъала	article
тӀубазабулев чи	artificial
суратал рахъулев чи	artist
эз	as
гьабсагӀат	as long as
гьединго	as well
гьединго	as well as
мухӀур	ash
нечон вуго	ashamed
гьикъизе	ask
гьикъана	asked
кьижараб	asleep
бербалагьи	aspect
Ассамес	Assamese
гьужум гьабизе	assault
сундениги тӀаделъизе	assault
бакӀари	assembly
дандбай	assembly
таваккалаб	assertive
багьа чӀезабизе	assess
багьа гьаби	assessment
багьа чӀезаби	assessment
къимат кьей	assessment
хӀажатаб	asset
гьечӀого гӀолареб	asset
къваригӀараб	asset
ресурсы	assets
хъвайзе	assign
чӀезаби	assignment
кумек гьабизе	assist
кумекчи	assistant
хурхен бугеб	associate
хурхен букӀине	associated
цого тайпаялъул хӀалтӀул гӀадамазул цолъи	association
ракӀалда букӀине	assume
гьадин батилилан ракӀалъ хӀисаб гьаби	assumption
в	at
дагьго	at least
кванана	ate
даимго спорталда тӀад чӀарав чи	athlete
рекӀинабизе	attach
чӀвана	attached
тӀад лъей	attachment
гьужум	attack
жигар бахъизе	attempt
хӀал бихьизе	attempt
щвезе	attend
ине	attend
рачӀен	attendance
пикру кьей	attention
бербалагьи	attitude
привлекать	attract
аскӀове цӀай	attraction
ракӀ балеб	attractive
бихьизе берцинаб	attractive
ракӀ тӀаде цӀалеб	attractive
атрибут	attribute
халкъ	audience
август	august
ункъгӀал	aunt
тетка	aunty
аутентичный	authentic
автор	author
авторитет	authority
хасалихълъи	autumn
кӀолеб	available
авар мацӏ	Avar
гьоркьобисеб	average
цӀунизе	avoid
кьижичӀого чӀун вугев	awake
шапакъат	award
лъай букӀин	aware
баян букӀин	aware
лъалеб букӀин	awareness
баян букӀин	awareness
добегӀан	away
цӀакъ лъикӀ	awesome
хӀинкъизабулеб	awful
санагӀат гьечӀлъи	awkward
Эймара	Aymara
лъимер	baby
болозан	bachelor
лъади ячинчӀев чи	bachelor
нахъе	back
тӀон	background
фон	background
квешаб	bad
сумка	bag
къвача	bag
приманка	bait
выпекать	bake
пекарня	bakery
кванил сода	baking soda
баланс	balance
торгӀо	ball
Бамбара	Bambara
банан	banana
ъокъа	band
тӀелr	band
къвагьизе	bang
банк	bank
бар	bar
хӀалица	barely
багьакъадаралъул къотӀи-къай гьабизе	bargain
хӀапдезе	bark
пурчӀун	barley
чали	barrier
къед	barrier
архит. кьучӀ	base
эхебе	based
гӀодобе	based
гъоркье	based
подвал	basement
аслияб	basic
хӀакъикъаталсан	basically
бэзил	basil
угъраш	bastard
партия	batch
ванна	bath
ванна	bathroom
батарея	battery
рагъулаб	battle
мацӀ	bay
ралъдал квачӀ	bay
йигоӀвуго	be
цӀодор вукӀа	be careful
ралъдал рагӀлад	beach
чӀор	beam
бобы	beans
if it is animal it is - ци	bear
if it means to bear - ккойзе	bear
мегеж	beard
босулеб	bearing
жанавар	beast
бергьине	beat
берцинавӀберцинай	beautiful
берцинлъи	beauty
лъана	became
щайгурелъидал	because
лъугьана	become
манги	bed
тах	bed
кьижулеб рукъ	bedroom
най	bee
панзил гьан	beef
букӀана	been
пиво	beer
цебе	before
байбихьи	began
байбихьизе	begin
жубай	beginning
цӀаралдасан	behalf
хьвада-чӀвади	behave
гӀамал	behavior
хьвада-чӀвади	behaviour
нахъа	behind
биинг	being
ракӀчӀей	belief
божел	belief
божи	belief
божи	believe
чехь	belly
бетӀергьанаблъун букӀине	belong
бокьулеб	beloved
гъоркьа	below
рачел	belt
гьитӀинаб тукен	bench
к	bend
ич	bend
изабизе	bend
под	beneath
тӀокӀлъи	benefit
тӀокӀлъи	benefits
аскӀоб	beside
гьеб хутӀизегӀан	besides
бищунго лъикӀаб	best
сахлъи	best of luck
лъикӀаб гьаригун	best regards
лъикӀ гьаби	better
гьоркъоблъи	between
гьекъолеб	beverage
нахъа	beyond
Бовджпури	Bhojpuri
цебеккун	bias
сундулгунниги-лъилгунниги лъай-хъвай гьабилалде	bias
хӀакъикъиял хӀужжабиги хӀисабалде росичӀого	bias
бижараб пикру	bias
мекъав вугониги жиндие вокьулесул рахъ кколев	biased
хӀатӀимашин	bicycle
гьоркьоб жо лъезе	bid
кӀудияб	big
хӀатӀимашин	bike
рикӀкӀен	bill
хӀисаб	bill
бухьине	bind
хӀинч	bird
гьаби	birthday
бутӀа	bit
хӀанчӀизе	bite
кьогӀаб	bitter
чӀегӀераб	black
бал	blade
гӀайиб чӀвазе	blame
чӀобогояб	blank
юргъан	blanket
кьвагьизаби	blast
кьвагьун щущазаби	blast
кьвагьи	blast
хъахӀ гьабизе	bleach
жуба-гъубзе	blend
пурман кьей	bless
изну	bless
Алагьасде аманат	blessed
канлъи бихьуларев	blind
бецав	blind
тӀубараб талихӀ	bliss
блок	block
би	blood
тӀегьазе	bloom
пузе	blow
хъахӀилаб	blue
бал хвараб	blunt
свараб	blunt
тӀехӀараб	blunt
къоно	board
хъарщи	board
гама	boat
къаркъала	body
гьалдезабизе	boil
тӀехӀаб	bold
бухьен	bond
хурхен	bond
ракьа	bone
тӀехь	book
гӀилла-сабаб букӀина	boost
кумекжо	booster
лъит	boot
чакмаби	boots
гӀурхъи	border
бухъизе	bore
бизарлъизе	bored
чӀалгӀараб	boring
вижарав	born
тӀад гьабизе	borrow
бекӀеда къезе	borrow
босс	boss
кӀиябго	both
рахӀат хвезабизе	bother
шиша	bottle
тӀину	bottom
босана	bought
кӀанцӀезе	bounce
гӀурхъи	bound
гӀурхъи	boundaries
бетӀер къули	bow
икрам гьаби	bow
суркӀа	bowl
къали	box
гъутухъ	box
вас	boy
гьудулав чи	boyfriend
браслет	bracelet
гӀадалнах	brain
гӀаркьел	branch
гӀаламат	brand
маркӀа	brand
гӀуж	brand
бахӀарчияв	brave
бер къаларев	brave
къвакӀарав	brave
биххизаби	breach
хвезаби	breach
чед	bread
бекана	break
радалквен	breakfast
керен	breast
хӀухӀел цӀазе	breath
хӀухьел цӀазе	breathe
тайпа	breed
кирпич	brick
бахӀарай	bride
кьо	bridge
къокъаб	brief
гвангъараб	bright
кунчӀараб	brilliant
гвангъараб	brilliant
босе	bring
вацако	bro
гӀатӀидаб	broad
гӀебаб	broad
транслировать	broadcast
векарав	broke
бекана	broken
жул	broom
вац	brother
чӀужуялъул вац	brother in law
босана	brought
сурмияб	brown
щетка	brush
ведро	bucket
гьудул	buddy
бюджет	budget
хатӀа	bug
гъалатӀ	bug
гӀуцӀизе	build
мина	building
ригь	building
гӀуцӀи	built
шгӀемераб	bulk
оц	bull
зулмуялдалъун	bully
гучалдалъун хӀинкъи кьезе	bully
кьабизе	bump
бухьин	bunch
квацӀи	bundle
бакӀаб юк	burden
букъизе	buried
цӀа рекӀине	burn
къваизе	burst
букъизе	bury
автобус	bus
хьуй	bush
хъарахъ	bush
Бизнес	business
щущазабизе	bust
гъуризе	bust
гъуризабизе	bust
noun -керен	bust
бекизабизе	bust
verb -  бекизе	bust
тӀетӀезабизе	bust
регӀел гьечӀо	busy
амма	but
масло	butter
кӀалкӀучӀ	butterfly
кнопка	button
босизе	buy
бай	by
кинбугонаниниги	by the way
къо-мех лъикӀ	bye
капуста	cabbage
кабинет	cabinet
хьури	cage
торт	cake
гӀакаялъул тӀинчӀ	calf
бече	calf
къуризе	call
ахӀизе	call
диде кьуре	call me
кьурана	called
сабру	calm
вачӀине	came
кампания	campaign
кӀола	can
кӀуларго	can't
къайзе	Cancel
ралъдал гарц	cancer
бажари	capable
гъварилъи	capacity
капитал	capital
гъолбас гьаби	caption
ккойзе	capture
машина	car
карьера	career
цӀодорав	careful
цӀодорго	carefully
ургъел гьечӀеб	careless
ургъел гьабулев	caring
цӀулал устар	carpenter
тӀанса	carpet
ламадур	carrot
ккой	carry
иш чӀезе течӀого яги заманалдасан цебе бачине	carry on
гьабизе	carry on
тӀубазе	carry out
лъугьа-бахъин	case
наличные	cash
речӀчӀизе	cast
хъала	castle
щулалъи	castle
чӀараб	casual
ругьунаб	casual
кидаго гӀадаб	casual
кету	cat
ккуна	catch
категория	category
чӀегӀербоцӀи	cattle
ккуна	caught
гӀилла	cause
цеве валагьи	caution
цӀодорлъи	caution
дица балагьула буго	cautious
нохъо	cave
къотӀизабизе	cease
мокърукьбакӀ	ceiling
байрам гьабизе	celebrate
хьури	cell
бакьулъбакӀ	center
гӀасру	century
нусго сон	century
тӀоролал	cereal
могьолал	cereal
церемония	ceremony
къвакӀго	certain
узухъда	certainly
сертификат	certificate
шагьатнама	certificate
синжир	chain
рахас	chain
бакӀу	chair
хӀал бихьи	challenge
шартӀ	chance
хисизе	change
дунялалъул низам биххи	chaos
кинабго жо жуба-гъубан	chaos
персонаж	character
гӀамал	character
хасият-гӀамал бихьизаби	characteristics
цӀезе	charge
кумек гьаби	charity
хӀикмалъизаризе гьабулеб	charming
хӀайранлъизаризе	charming
план	chart
хадулъизе	chase
гаргадулеб бакӀ	chat
учузаб	cheap
хисизабизе	cheat
хӀалихьалъи	cheating
нахъегӀанлъи	cheating
къадарлъи	cheating
гьерсихъанлъи	cheating
цӀех-рехизе	check
кӀаркьен	cheek
рохел	cheer
ракӀ гӀанчӀав	cheerful
ракӀ регьарав	cheerful
аваданав	cheerful
сахлъиялъе	cheers
хӀан	cheese
химия	chemistry
багьа чӀвазе	cherish
шахматал	chess
керен	chest
чӀамизе	chew
гӀанкӀу	chicken
аслияб	chief
бетӀераб	chief
лъимер	child
лъимерлъи	childhood
гьитӀинаб мех	childhood
лъимераб гӀуж	childhood
лъимал	children
квачан	chill
кӀкӀуй унеб труба	chimneys
нилъу	chin
шоколад	chocolate
тӀаса бищи	choice
бищизе	choose
къотӀ-къотӀизе	chop
рокъосеб хӀалтӀи	chores
гургинаб гьумералъул	chubby
церковь	church
корица	cinnamon
дарчин	cinnamon
гор	circle
шартӀ	circumstances
хӀужжа	circumstances
гражданин	citizen
шагьар	city
ракӀ чӀезабизе	claim
баян гьабизе	clarify
сорт	class
хӀатӀракь	clay
хӀатӀ	clay
бацӀадаб	clean
бацӀцӀадаб	clear
офисалъул хӀалтӀукъан	clerk
гӀакълуяв	clever
гӀакълуяй	clever
гӀакълуяб	clever
жо босулев чи	client
утес	cliff
гьава-бакъ	climate
рахине	climb
рекӀун чӀолеб	clingy
сагӀат	clock
къай	close
шкаф	closet
ххам	cloth
ретӀел	clothes
накӀкӀ	cloud
зобал накӀкӀаз рациялъул даража	cloudy
клоун	clown
кӀичӀ	clue
гъармахъ	clue
гъанца	clue
тантрахъаб	clumsy
кластер	cluster
тренер	coach
тӀурччи	coal
рагӀаллъи	coast
рагӀал	coast
пальто	coat
къагьва	coffee
кофе	coffee
лъазе рес бугеб	cognitive
нахъгӀунтӀулеб	cognitive
дандеккей	coincidence
цадахъ ккей	coincidence
квачараб	cold
биххи	collapse
воротник	collar
цого махшелалъул чи	colleague
хӀалтӀухъаби	colleagues
бакӀаризе	collect
цого тайпаялъул къайи-къоно	collection
коллекция	collection
цӀалул бакӀал	college
кьер	color
кьер гьечӀел гӀурччинал идеяби кутакалда лъикй кьишун рукӀана	colorless green ideas slept furiously
кьер	colour
гъоркь-тӀад ругел мухъазул хӀуби	column
гьоркьо	comb
комбинация	combination
хасаб тартибалда лъезе	combine
цоцалъ жубазабизе	combine
данде ккезабизе	combine
рекъезабизе	combine
вачӀа	come
йячӀа	come
гьаниве вачӀа	come here
жубазе	come on
санагӀалъи	comfort
рахӀат	comfort
квегӀенлъи	comfort
санагӀатаб	comfortable
вачӀунев	coming
хеккого	coming soon
кватӀичӀого	coming soon
буюрухъ	command
комментарий	comment
коммерческий	commercial
комиссия	commission
гьаби	commit
тӀадебоси	commitment
чара гьечӀого	commitment
кьуричӀого тӀубазабизе кколеб къотӀи	commitment
ритӀухъав	committed
ракӀ-ракӀалъ мутӀигӀав	committed
къайи	commodity
тӀолазего	common
гаргадизе	communicate
бухьен букӀине	communicate
гьоркьоблъи	communicate
гьоркьоблъи	communication
сообщество	community
щезе	commute
къайицадахъ	companion
компания	company
гьоркьоб бикьи	compare
дандекквей	comparison
ракӀунти	compassion
гурхӀел	compassion
гурхӀулев	compassionate
гурхӀел бугев	compassionate
цадахъ букӀине бегьулеб	compatible
цадахъ букӀине рес бугеб	compatible
чем къец базе	compete
сундулниги хӀакъалъулъ гӀураб лъай гьечӀев	competent
къец	competition
данде чӀезе кӀолев	competitive
гӀарза кьезе	complain
гӀарз	complaint
зигарди	complaint
гӀарз бахъи	complaint
цӀезабизе	complement
лъугӀизабизе	complete
тӀубазабизе	complete
рагӀалде бахъинабизе	complete
тӀубанго	completely
тӀаса камичӀого	completely
захӀматаб	complex
тартиб цӀуни	compliance
захӀматаб	complicated
рецц-бакъ гьаби	compliment
тӀуразаризе	comply
чего гӀуцӀи	composition
гӀуцӀи	composition
гӀадатаб гуреб	compound
захӀматаб	compound
бичӀчӀин	comprehension
тӀолалго рахъал хӀисабалде росараб	comprehensive
кинабго рахъалъулаб	comprehensive
рекъел гьаби	compromise
маслихӀат	compromise
къотӀи ккей	compromise
кӀиябго рахъ разилъи	compromise
гьабизе тӀамизе	compulsory
хӀалалъ гьабизабизе	compulsory
компьютер	computer
бакӀарун данделъизе	concentrate
цо бакӀалде рачӀинесконцентрироваться	concentrate
цо бакӀалде данделъизе	concentrate
аслияб пикру	concept
хӀалбихьизе	concern
лъалев	concerned
концерт	concert
къватӀибе бачин	conclusion
чӀванкъотӀараб	concrete
шартӀ	condition
шартӀ	conditions
хьвада-чӀвади	conduct
вакилзабазул данделъи	conference
мукӀурлъи	confess
къвакӀи	confidence
къвакӀи	confident
уяблъизе	confirm
дагӀба-рагӀи	conflict
бигъараб	confused
жуба-гъубай	confusion
бада-гъудур	confusion
баркула	congrats
барки	congratulation
баркула	congratulations
жубазаби	conjunction
цолъизаби	conjunction
рекӀинабизе	connect
кквезе	conquer
ккун чӀезе	conquer
лъай	conscious
пикру бичӀчӀи	conscious
сознание	consciousness
щибниги жоялъул хӀакъикъат	consciousness
разилъи	consent
нахъалъун	consequences
цӀуни	conservation
консерватор	conservative
ургӀула	consider
лъугьун бугеб ахӀвал-хӀалги хӀисабалде босун	considered
данде гьабун букӀине	consist
тартиб буголъи	consistency
тартиб буголъи	consistent
гьоркьоса къотӀичӀеб	constant
гьоркьоса къотӀичӀого	constantly
рахай	constipation
гӀуцӀи	construction
сокӀкӀин	construction
пайда босизе	consume
хӀалтӀизабиз	consume
хӀалтӀизаби	consumption
бухьен	contact
бахунеб	contagious
жаниб букӀине	contain
ккола	contains
хьихьула	contains
жакъасеб	contemporary
гьабсагӀат бугеб	contemporary
гьанжесеб заманалъул	contemporary
рикӀкӀунгутӀизе мустахӀикъав	contempt
РакӀ чӀараб	content
къец	contest
магӀнаялъул рахъалъ щвалде щвараб тексталъул бутӀа	context
континент	continent
чӀезе течӀого цебе бачине	continue
къотӀи	contract
батӀалъи	contrast
кумек гьабизе	contribute
санагӀат гьабизе	contribute
санагӀалъи ккезабизе	contribute
сабаблъун ккезе	contribute
кому-чему квербакъи гьабизе	contribute
лъей	contribution
хал гьаби	control
тӀадкӀалъай бугеб	controversial
санагӀалъи	convenience
къагӀида рекъей	convenience
квегӀенлъи	convenience
санагӀатаб	convenient
ишалъулаб	conversation
цоцазулгун гьоркьоблъи	conversation
гьудуллъиялъулаб бухьен	conversation
конвертировать	convert
битӀизе	convey
кьезе	convey
божизавизе	convince
ракӀ чӀезабизе	convince
ракӀ чӀезабурав	convinced
квен гьабизе	cook
квен гьабизе	cooking
лъикӀин	cool
цадахъ хӀалтӀи	cooperation
кӀойзе	cope
пахь	copper
пахьул гӀарац	copper
аслияб	core
цӀорлъ	corn
цили	corner
битӀараб	correct
хвезаби	cost
костюм	costume
ретӀел	costume
коттедж	cottage
квасквас	cotton
диван	couch
ухӀуди	cough
куд	could
гӀакълу дандбай	council
гӀакълу	council
малълъи	council
маслихӀат	council
рикӀкӀине	count
тукада къайи лъолеб стол	counter
хӀукумат	country
росдал	countryside
росулъ вугев	countryside
кӀигояб	couple
жут	couple
бахӀарчилъи	courage
цӀали	course
суд	court
къокъаб	courtesy
яцгӀал - for girls  вацгӀал - for boys	cousin
тӀамизе	cover
гӀака	cow
цӀукӀа	coward
хӀинкъуч	coward
гӀанкӀиракӀ	coward
санагӀатаб	cozy
квегӀенаб	cozy
краб	crab
трескаться	crack
махшел	craft
пиша	craft
устарлъи	craft
ккал	crap
балагь	crash
талихӀ къараб иш	crash
кутакаб шавкъ бугев	craving
шуризе	crawl
хъурщизе	crawl
гӀадаллъарав	crazy
гӀадалав	crazy
лъугьинабизе	create
гьунаралъулаб	creative
кредит	credit
налъи	credit
слизняк	creep
квешаб	creepy
рокьукъаб	creepy
буюрухъ	crew
такъсир	crime
Нахъе кӀанцӀизе	cringe
захӀматаб гӀуж	crisis
бажарулареб	criteria
лъугьунареб	criteria
критикияб	critical
къимат кьеялъул	criticism
къотӀизе	crop
ругъун лъезе	crop
бачӀин	crops
гӀебса къотӀизе	cross
гъеду	crow
гури	crowd
халкъалъул руккел	crowd
гури	crowded
халкъалъул руккел	crowded
корона	crown
критикияб	crucial
раӀму гьечӀого	cruel
круиз	cruise
рейс	cruise
гъуризабизе	crush
гӀодизе	cry
охцер	cucumber
къвал базе	cuddle
культура	culture
оборлъи	cunning
сихӀирлъи	cunning
къотӀизе	cup
буфет	cupboard
мицӀир	curb
лъилъизавизе	cure
сахлъизавизе	cure
дару гьабизе	cure
командантасул сагӀат	curfew
ккараб	curiosity
лъугьараб	curiosity
рагӀараб рагӀа-ракьанде щун лъазе бугеб гъира	curiosity
кинабго лъазе гъира-шавкъ бугеб	curious
кӀургӀараб	curly
валюта	currency
хӀалтӀулеб	current
дагьаб цебегӀан	currently
нагӀана кьезе	curse
пардав	curtain
къандалъо	cushion
гӀадат	custom
бичун босулев чи	customer
гӀурхъи бахун	customs
къотӀизе	cut
вокьулевӀйокьулей	cute
къотӀел	cycle
цо чӀараб тӀел	cycle
хӀатӀимашина бачин	cycling
эмен	dad
дада	dad
дада	daddy
щибаб къоялъ	daily
рахьдал гьабураб	dairy
сангар	dam
зарал	damage
зиян гьаби	damage
нагӀана батаяб	damn
регьел бугеб	damp
рагьлилаб	damp
биччараб	damp
кьурди	dance
хӀинкъи	danger
хӀинкъи бугеб	dangerous
бецӀаб	dark
хирияв	darling
хирияй	darling
рехдезе	dash
заман	data
гӀуж	data
дандчӀвай	date
яс	daughter
къо	day
хвел	dead
ахирисеб заман	deadline
гӀинкъаб	deaf
къотӀи-къай гьабизе	deal
хириявӀхирияй	dear
киназего салам	Dear All
хӀурматияв босулев чи	Dear Customer
эбел-эмен	Dear Parents
хириял умумул	Dear Parents
хӀурмат бугев бетӀерчӀахъад	Dear Sir
хириял цӀалдохъаби	Dear students
хирияб команда	Dear Team
хвей	death
гӀажал	death
хвел	death
бахӀс	debate
дагӀба-къец	debate
налъи бихьизабулеб счет	debit
рекарал жал	debris
налъи	debt
анцӀго сон	decade
бутӀабазде бикьун ине	decay
парахатаб	deceased
гӀодобе биччараб	deceased
сабураб	deceased
гуккизе	deceive
декабрь	december
лъикӀаб	decent
рекъараб	decent
хӀукму гьабизе	decide
хӀукму гьаубраб	decided
гьаби	decision
гамил тӀасияб рахъ	deck
гьетӀизабизе	decline
нахъе цузе	decline
цояб рахъалде къазабизе	decline
гьитӀинабизе	decrease
ритӀухълъи	dedicated
ритӀухълъи	dedication
ракӀ-ракӀалъ мутӀигӀлъи	dedication
лъалаго гьабураб	deed
цо къасдалда гьабураб иш	deed
гъваридаб	deep
ритӀучӀ	deer
нахъ буссинабунгутӀи	default
кьунгутӀи	default
бецӀунгутӀи	default
къини	defeat
хьихьизе	defend
лъилниги рахъ кквезе	defend
чӀезабизе	define
дурусго	definitely
чӀезаби	definition
баянлъи	definition
степень	degree
даража	degree
батӀаго лъезе	delay
нахъе лъезе	delay
хадуб гьабизе тараб	delayed
рикӀкӀад гьабизе	delete
рикӀкӀалъизабизе	delete
бацӀине	delete
цебеккун ургъунго хӀадур гьабураб	deliberate
хӀеренаб	delicate
татуяб	delicious
рохел	delight
хӀайранлъи	delight
разияв	delighted
щвезабизе	deliver
щвезабураб	delivered
щвезаби	delivery
тӀалаб гьабизе	demand
кьварараб	demanding
тӀалаб бугеб	demanding
хӀукуматалъул ишал халкъалъ гьари	democracy
гӀиприт	demon
илбис	demon
бихьизабизе	demonstrate
берда бихьизе цебе лъезе	demonstrate
нахъе цуй	denied
щулалъи	density
цабзазул устар	dentist
гӀусазул тохтир	dentist
нахъчӀвараб	deny
разилъи гьечӀеб	deny
батӀалъизаби	department
ине	departure
бараблъун	depend
бичизе	deploy
лъураб гӀарац	deposit
ракӀ гӀодобчӀвай	depressed
депрессия	depression
гъварилъи	depth
сипат-сурат гьабизе	describe
хъвай	description
бицин	description
кутакалда гучаб	desert
цӀакъ кутакаб	desert
хаган хутӀизарулеб	desert
кӀудияб асар гьабулеб	desert
мустакълъизе	deserve
дизайн	design
къачӀай	design
гӀуж гьаби	designation
анищ	desire
мурад	desire
хӀалтӀул стол	desk
хьул къотӀи	despair
ракӀ буссин	despair
гьабулелде вачӀунарев	desperate
хадуб кколелъул пикру гьабуларев	desperate
кин бугонаниги	despite
десерт	dessert
чӀезаби	destination
мухӀканлъизаби	destination
бихьизаби	destination
къадар	destiny
къисмат	destiny
биххизе	destroy
биххизаби	destruction
бекизаби	destruction
чӀунтизаби	destruction
деталь	detail
подробности	details
батизе	detect
мухӀкан гьабун	determination
баян гьаби	determination
хӀукму гьабизе	determine
чӀван къотӀун	determined
риха-хочараб	devastated
цебе тӀезе	develop
ине	develop
тӀадегӀанаб даражаялде бахараб	developed
кутакалда цебетӀураб	developed
къвакӀизаби	development
кутак гьаби	development
кӀодо гьаби	development
гӀатӀид гьаби	development
конструкция	device
шайтӀан	devil
илбис	devil
ритӀухъав	devoted
ракӀ-ракӀалъ мутӀигӀав	devoted
Дгьивеи	Dhivehi
диабет	diabetes
диарея	diarrhea
дневник	diary
лфавиталда рекъон лъурал рагӀабазул гьебго мацӀалда магӀна кьураб яги цоги мацӀалде гьел руссинабураб тӀехь	dictionary
гьабуна	did
в	die
хвана	died
диета	diet
батӀалъи	difference
батӀибатӀияб	different
захӀмалъи	difficult
мун	dig
лъикӀаб рахъ	dignity
хӀаракат бахъулев	diligent
жигарав	diligent
боголиквен	dinner
къасиквен	dinner
биччайзе	dip
бадибе	direct
буссинаби	direction
балагьизаби	direction
битӀи	direction
учреждениялъул бетӀер	director
хӀарщ	dirt
чурукаб	dirty
тӀечго тезе	disable
гӀунгутӀи бугеб	disabled
щвалде щвечӀеб	disabled
мукъсанаб	disabled
тӀагӀине	disappear
билизе	disappear
цебеса хьвазе	disappear
пашман-лъизавизе	disappointed
кеп хвезабизе	disappointed
къварилъизавизе	disappointed
ракӀ гъанцӀизабулеб	disaster
гӀасияб	disaster
ракӀ хӀинкъизабулеб	disaster
ракӀ зунизабулеб	disaster
нахъчӀвазе	discard
инкар гьабун чӀезе	discard
хъамизе	discharge
гӀадлу-низам	discipline
дагьлъизаби	discount
тӀаса рехи	discount
батизе	discover
дискриминация	discrimination
кьезе гьоркьоб лъезе	discuss
далилал рачине	discuss
жиндирго пикру бицине	discuss
битӀараб къимат	discuss
гьоркьоб лъей	discussion
унти	disease
унтаби	diseases
ххвел гьаби	disguise
щибниги бахчизаби	disguise
цӀакъ квешаб	disgusting
квен	dish
тарелки	dishes
кколеб къимат кьунгутӀизе	dismiss
тӀубазабизе	dispatch
дисплей	display
пайда боси	disposal
гӀадада хвезе течӀого пайда боси	disposal
къец	dispute
дагӀба-къец	dispute
дагӀбади	dispute
манзил	distance
битӀухъаб	distinct
батӀалъи бихьизе	distinguish
балагь	distress
распределение	distribution
округ	district
гьоркьоб къотӀи	disturb
лъелрахъ	ditch
вукъун лъедезе	dive
вукъардизе	dive
батӀи-батӀияб	diverse
релълъинчӀеб жоялъул гӀемерлъи	diversity
бикьизе	divide
Аллагьияб	divine
динияб	divine
Аллагьасулаб	divine
жинди-жиндир бакӀалде ккезаби	divorce
бачин	divorce
бетӀер свери	dizzy
гьабе	do
дуца?	do you
дуе дун йокьули?	do you love me
тохтир	doctor
документ	document
даз	does
гьечӀо	doesn't
гуро	doesn't
гьой	dog
Догри	Dogri
гьабизе	doing
васикӀо	doll
ясикӀо	doll
домен	domain
рукъалъулаб	domestic
цӀикӀкӀунев	dominant
ууна	don't
горо	don't
гьечӀо	don't
ургъел гьабуге	Don't worry
кьезе	donate
лъугӀана	done
хӀама	donkey
мехтизавизе гьабулеб дару	dope
кӀигъатаб	double
щаклъи	doubt
ролъ	dough
буцараб гӀатӀ	dough
гъоркье	down
реххизе	download
бацӀцӀад гьабун хъвазелъун тӀоцебе хъвалеб щибниги жо	draft
баччизе	drag
бакъвазабизе	drain
драма	drama
сурат бахъизе	draw
ящикӀ	drawer
квералъ бахъараб сурат	drawing
карабиххи	dread
хӀинкъи	dread
анищ	dream
гурде	dress
борлъизе	drill
каратӀ бахъизе	drill
гьекъезе	drink
бачине	drive
бортизе	drop
бортараб	dropped
бакъвай	drought
ракъдаллъи	drought
бакъбухӀи	drought
мехтараб	drunk
бакъвараб	dry
ордек	duck
гьудул	dude
букӀине кколеб	due
гьедин бугелъул	due to
гьединлъидал	due to
гьавав	dull
гӀадбал	dull
гьагай	dull
гьагал	dull
гӀабдал	dumb
чӀухӀтӀи-къул балеб бакӀ	dump
халалъи	duration
халат бахъин	duration
лъугьунаго	during
хӀур	dust
тӀадаб иш	duty
бетӀербахъи гьабизе	dwell
гӀумру гьабизе	dwell
холев вугев	dying
щибаб	each
цуцал	each other
сабру гьечӀев	eager
яхӀ гьабизе	eager
чӀезе кӀоларев	eager
цӀум	eagle
гӀин	ear
цудунго	earlier
цебеккунго	earlier
ригьдаго	earlier
гӀуждаго	earlier
цудунго	early
мустахӀикълъизе	earn
гӀиндул	ears
земля	earth
ракь багъари	earthquake
бигьайлъи	ease
бигьаго	easily
бигьа	easily
тӀадагьго	easily
бакъбакк	east
бигьаго	easy
кваназе	eat
кваназе	eating
экономикияб	economic
магӀишатияб гӀуцӀи	economy
яшав	economy
рагӀал	edge
хисизабизе	edit
лъай кьей	education
цӀализари	education
кутакаб асар	effect
хӀасил бегеб	effective
асар гьаби	efficiency
хӀасил букӀин	efficiency
цӀакъ асар гьабулеб	efficient
ХӀалбахъи	effort
хоно	egg
баклажан	eggplant
его	ego
микьго	eight
анцӀила микьго	eighteen
ункъого	eighty
цинигимаб	either
тӀад хӀалтӀи гьабизе	elaborate
гӀункӀрукь	elbow
гӀумруялъ кӀудияв	elder
ригьдаса арав	elderly
бахӀарав гурев	elderly
херлъиялде варав	elderly
исбагьияб	elegant
узданаб	elegant
чӀурканаб	elegant
назукаб	elegant
щибниги жоялъул бутӀа	element
пил	elephant
анцӀила цо	eleven
ихтияр букӀин	eligible
тӀагӀинавизе	eliminate
цогияб	else
нечезавурав	embarrassed
нечолев	embarrassing
бичӀчӀизе	embrace
къабул гьабизе	embrace
лъазе	embrace
баккизе	emerge
нахъ тӀамун тезе бегьулареб	emergency
хехаб	emergency
хӀалакараб	emergency
нахъбахъулареб	emergency
гӀедегӀараб	emergency
рекӀел асар загьир гьабулев	emotional
ракӀунти	empathy
гурхӀел	empathy
акцент	emphasis
гурхӀизе	emphasize
ургъел гьабизе	emphasize
чияда ракӀ унтизе	emphasize
цадахъ хъулухъ гьабулев чи	employee
хӀалтӀухъаби	employees
хӀалтӀиде восулев чи	employer
хӀалтӀи	employment
чӀобогояб	empty
ихтияр	enable
изну	enable
данде чӀвазе	encounter
данде ккезе	encounter
данделъизе	encounter
ракӀ базе	encourage
рагӀал	end
кӀал	end
тӀогь	end
тӀагӀине бегьулеб	endangered
жигар бахъизе	endeavor
хӀаракат гьабизе	endeavor
лъадари	endurance
къохӀехьей	endurance
къвакӀи	endurance
хӀехьезе	endure
тушман	enemy
гуч	energy
къуват	energy
энергия	energy
мухьдахъ хасал шартӀазда кквезе	engage
помолвленный	engaged
лъади аби	engagement
лъадилъун гьари	engagement
яс аби	engagement
двигатель	engine
инженер	engineer
английский	English
кутаклъизабизе	enhance
кьвакӀизабизе	enhance
цӀикӀкӀинабизе	enhance
гучлъизабизе	enhance
гьабе лазат	enjoy
цӀакъ кӀудияб	enormous
гӀела	enough
божилъи кьезе	ensure
гъорлъе лъугьине	enter
жаниве лъугьине	enter
рахӀат гьаби	entertainment
ракӀ гъезаби	entertainment
энтузиазм	enthusiasm
жигар-къасд бугев гӀадан	enthusiastic
хӀаракатай гӀадан	enthusiastic
кинабго	entire
вакил	entitled
божилъи гьабурав чи	entitled
аслияб кӀвар буголъи	entity
жанибе лъугьин	entrance
дармилал бакӀазул бетӀергьан	entrepreneur
капиталист	entrepreneur
фабрик-заводазул	entrepreneur
бухча	envelope
сверухълъи	environment
жахӀда-хӀусуд ккезе	envy
эпосалда хурхараб	epic
эпосияб	epic
эпосалъул	epic
эпидемия	epidemic
цокӀалаб	equal
бащадаб	equal
къваригӀунеб тӀагӀел-гӀучӀ	equipment
капитал	equity
эквивалент	equivalent
резинка	eraser
хатӀа	error
гъалатӀ	error
тӀуризе	escape
хасго	especially
гьаби	essay
ургъун бахъи	essay
хъвай	essay
жинцаго ургъун бицин	essay
аслияб кӀвар буголъи	essence
аслияб	essential
тасдикъ гьабизе	establish
ритӀухъ гьабизе	establish
къабул гьабизе	establish
гӀуцӀараб	established
боцӀи	estate
чӀахъен	estate
буголъи	estate
бечелъи	estate
багьа чӀезабизе	estimate
къимат кьей	estimated
цогидалги	etc
кидагосеб	eternal
лъугӀи гьечӀеб	eternal
даимаб	eternal
мораль	ethics
адаб	ethics
гӀаданлъиялъул къагӀидабазул хӀакъалъулъ бугеб философияб гӀелму	ethics
хасият	ethics
къимат кьей	evaluate
багьа гьаби	evaluation
багьа чӀезаби	evaluation
къимат кьей	evaluation
кин бугониги	even
кинбугонаниги	even though
къасимех	evening
маркӀачӀумех	evening
лъугьа-бахъин	event
ахиралдаги	eventually
кидаго	ever
щибаб	every
киналго	everybody
киналго	everyone
сахабго	everything
хӀужжа	evidence
щетӀан	evil
дагь-дагьккун цо хӀалалдаса цоги хӀалалде гӀодобе биччараб куцалда хиси	evolution
цебе тӀезе	evolve
хиси ккезе	evolve
Джю	Ewe
вукӀарав	ex
битӀараб	exact
битӀун	exactly
хӀалбихьи	exam
цӀех-рех гьабизе	examine
мисал	example
тӀадегӀанлъи	exceed
цӀакъго лъикӀ	excellent
гьоркьоб тун	except
рехи	exception
нахъе рехи	exception
тӀокӀлъи	excess
къваригӀунелдаса цӀикӀкӀараб	excessive
тӀокӀаб	excessive
хисизе	exchange
бихха-хочараб	excited
тамашалъизаве дун	excitement
бихха-хочараб	exciting
релълъечӀеб	exclusive
тӀаса лъугьаян гьаризе	excuse
тӀаса лъугьин	excuse
тӀаса лъугьа	excuse me
тӀубайзабизе	execute
тӀубазаби	execution
тӀубазабиялъулаб	executive
билълъанхъизабиялъулаб	executive
хӀалтӀи	exercise
газ къватӀибе унеб труба	exhaust
хӀал дагьлъи	exhausted
рухӀ лъугӀи	exhausted
экспонат	exhibit
цебе лъей	exhibition
гӀумру гьабизе	exist
бетӀербахъи	existence
бугеб	existing
къватӀибе нух	exit
гӀатӀилъизабизе	expand
балагьунчӀейи	expect
балагьун чӀей	expected
харж гьаби	expenses
багьалъи	expensive
хӀалбихьи	experience
гӀелмияб хӀалбихьи	experiment
эксперт	expert
ун лъугӀараб	expired
баян гьабизе	explain
бичӀчӀизабизе	explain
бичӀчӀизаби	explanation
баян гьаби	explanation
пайда босизе	exploit
хӀалтӀизабизе	exploit
лъазабизе	explore
улкаялдаса къватӀибе баччи	export
тӀатинавизе	expose
хьихьичӀеб	exposed
къвагьизе	exposure
бихьизабизе	express
аби	expression
загьирлъи	expression
бицин	expression
загьир гьаби	expression
лъазаби	expression
гӀатӀилъизабизе	extend
гӀатӀид гьабизе	extend
гӀатӀилъараб	extended
гӀатӀилъизабураб	extended
гӀатӀид гьабизе	extension
кӀодо гьабизе	extension
даража	extent
къватӀисеб	external
хун лъараб	extinct
тӀагӀараб	extinct
тӀадеги гьабулеб	extra
къватӀибе бахъизе	extract
батӀияб	extraordinary
рикӀкӀадисеб	extreme
бищун рагӀалда бугеб	extreme
кутакалда	extremely
бер	eye
берал	eyes
ххам	fabric
тамашаяб	fabulous
гӀажаибаб	fabulous
гӀадан виххун хутӀулеб	fabulous
гьумер	face
квербакъи гьабизе	facilitate
къваригӀунеб тӀагӀел	facilities
гӀамал	facility
къагӀида	facility
чара	facility
тадбир	facility
куц	facility
хӀужжа	fact
кӀвар бугеб лахӀза	factor
фабрика	factory
битӀараб жо	facts
кьер хвезе	fade
кьерукълъизе	fade
бецӀлъизе	fade
кьер свине	fade
бортизе	fail
битӀ ккечӀеб	failed
нахъчӀвай	failure
кьер тӀурав	faint
битӀун	fair
цӀакъ	fairly
маргьабазулаб	fairy
маргьадулаб	fairy
божи	faith
дин	faith
ритӀухъаб	faithful
рекӀкӀ гьечӀеб	faithful
мутӀигӀаб	faithful
гьереси	fake
бортана	fall
гьереси	false
цӀар	fame
ругьунаб	familiar
хъизан	family
ракъи	famine
цӀар ини	famous
машгьурлъи	famous
цӀакъ кутакалда цо иш бокьулев	fan
назукаб	fancy
исбагьияб	fancy
чӀурканаб	fancy
тӀаса бищараб	fancy
чӀухӀараб	fancy
букӀунареб жо	fantastic
добегӀан	far
тӀасса лъугьин	farewell
ферма	farm
фермер	farmer
хӀайбатаб	fascinating
мода	fashion
хехаб	fast
къаралъи	fat
къисматалъулаб	fatal
къадар	fate
къисмат	fate
дада	father
свак	fatigue
свакай	fatigue
гъалатӀ	fault
бокьулеб	favorite
къарзалъ кьей	favour
кумек гьаби	favour
гӀаданлъи	favour
бищунго бокьулеб	favourite
хӀинкъи	fear
байрам	feast
милъир	feather
хӀули	feather
гӀамал	feature
сипат-сурат	features
февраль	february
щокъронибе щвезегӀан гӀорцӀун вуго	fed up
хӀалтӀухъ кьолеб мухь	fee
кваназавизе	feed
кваназабизе	feed
кваназайизе	feed
нахъе ахӀи	feedback
хӀалалда бихьизе	feel
хӀалалда бичӀчӀун букӀине	feeling
хӀатӀал	feet
бортана	fell
вас	fellow
хӀалалде бихьана	felt
чӀужугӀадан	female
забор	fence
лъикӀ жо бижулеб	fertile
фестиваль	festival
босизе	fetch
цӀа	fever
багӀари	fever
чанго	few
дагьав	fewer
бахӀарав	fiance
гьереси	fiction
авлахъ	field
ццин бахъараб	fierce
анцӀила щуго	fifteen
кӀикъоялда анцӀго	fifty
рагъизе	fight
рагъда гьоркьор гӀахьаллъизе	fight
къеркьей	fighting
фигура	figure
бичӀчӀизе	figure out
иш	file
цӀезабизе	fill
цӀараб	filled
кино	film
фильм	film
чороклъараб	filthy
хъубаб	filthy
гъизараб	filthy
хъублъараб	filthy
чорокаб	filthy
ахир-къадги	finally
финансал	finance
гӀарцулаб	financial
батана	find
якъинлъизабизе	find out
роцӀинабизе	find out
баянлъизабизе	find out
лъазабизе	find out
баян гьабизе	find out
якъин гьабизе	find out
лъикӀ	fine
килищ	finger
лъугьине	finish
тӀубараб	finished
лъугӀараб	finished
цӀа	fire
къвакӀараб	firm
тӀоцебесеб	first
тӀоцебесеб цӀар	first name
ччугӀа	fish
рекъон	fit
щуго	five
къачӀазе	fix
цо чӀизабураб	fixed
байрахъ	flag
цӀа пархи	flash
рукъ	flat
гӀунгутӀи	flaw
гьечӀолъи	flaw
багьана чӀвазе бегьулеб	flawless
бежать	flee
черх	flesh
къаркъала	flesh
роржанхъулаан	flew
роржен гьабулаан	flew
къичӀизе	flex
бигьаго гьетӀизабизе кӀолеб	flexible
хьетӀулеб	flexible
боржанхъи	flight
эхеде рехизе	flip
чалухлъизе	flirt
рокьи гьабизе	flirt
рокьи гьаби	flirting
чалухлъи	flirting
лъедезе	float
лъим ххазе	float
лъим кӀанцӀи	flood
пол	floor
рукъалъул чӀабар	floor
ханжу	flour
чвахизе	flow
тӀегь	flower
грипп	flu
лъутарав	fluent
гӀедегӀулаго	fluently
тӀаде квас бахъараб	fluffy
лъамалъи	fluid
лъамияб жо	fluid
роржанхъизе	fly
фокус	focus
накӀкӀ	fog
гӀодонакӀкӀ	fog
русулнакӀкӀ	fog
накӀкӀул	foggy
тӀатӀалъезе	fold
аскӀосел	folks
хадув ине	follow
хадув ине	follow up
хадусееб	following
бачӀунеб	following
квен	food
гӀабдал	fool
ахӀмакъ	fool
ахӀмакъаб	foolish
гӀантаб	foolish
гъоркьахӀетӀе	foot
футбол	football
гъолъие	for
масала	For example
масала	for instance
дуе	for you
бегьулареб	forbidden
хӀал	force
ундулниги ин цебеккунго бицин	forecast
нодо	forehead
къватӀисеб улкаялъул	foreign
рохь	forest
кидагоялъе	forever
тӀолабго гӀумруялъего	forever
миркалъго	forever
к	forget
очене	forget
тӀаса лъугьине	forgive
кӀочене	forgot
гӀучӀ	fork
форма	form
формальный	formal
вукӀарав	former
талихӀалъ	fortunately
икъбал	fortune
бергьенлъи	fortune
талихӀккей	fortune
битӀккей	fortune
кӀикъого	forty
кӀикъоя кӀиго	forty-two
Цебе- цебе	forward
гӀизаби	foster
кьабола	fought
батизе	found
кьучӀ	foundation
ункъо	four
анцӀила ункъо	fourteen
перен	fox
чӀимигӀаб	fragile
хехго бекулеб	fragile
гӀурхъи	frame
рамки	frame
къучӀ	framework
рама	framework
хӀалихьатаб	fraud
бетӀер сверарав	freak
гӀадалав	freak
гӀакълу гьечӀев	freak
эркенаб	free
эркенлъи	freedom
цӀорозабизе	freeze
гӀемерлъи	frequency
хӀалаб	frequent
тӀатӀала букӀунеб	frequent
гьарзаго	frequently
чанго нухалъ	frequently
гӀемерцӀул	frequently
ризго	frequently
гӀемер нухалъ	frequently
цӀияб	fresh
туричӀеб	fresh
цӀекӀлъичӀеб	fresh
ккалачӀеб	fresh
бечӀачӀеб	fresh
тӀабу-тӀинчӀеб	fresh
ахӀанже бетӀараб	fresh
махӀцинчӀеб	fresh
басралъичӀеб	fresh
бигинчӀеб	fresh
рузманкъо	friday
рузман	friday
холодильник	fridge
гьудул	friend
гьудуллъигун	friendly
гьалмагъзаби	friends
гьудуллъи	friendship
гьудул-гьалмагълъи	friendship
хӀинкъиви	frightened
хӀинкъизабулеб	frightening
къверкъ	frog
добаса	from
цебесеб	front
цебегӀан бугеб	front
цӀорозабураб	frozen
бакъвараб пихъ	fruit
пашманлъараб	frustrated
пашманаб	frustrated
цӀатӀари	fuel
Фулфулд	Fulfulde
цӀураб	full
рохел	fun
ихтилат	fun
ихтилат-кеп	fun
кеп	fun
аваданлъи	fun
ракӀгъей	fun
гьабулеб хӀалтӀи	function
тӀоцебусеб	fundamental
магӀирукъ	funeral
релъизарулеб	funny
цӀира	fur
квас	fur
ябагъи	fur
кутакалда ццин бахъараб	furious
ццидалаб	furious
ццин бахъараб	furious
къайи	furniture
цинги	further
гьелде тӀадеги	furthermore
букӀинесеб	future
бакӀаризе	gain
бахине	gain
хӀай	game
зазор	gap
гараж	garage
рищни	garbage
ах	garden
ражи	garlic
гъапу	gate
рагьу	gate
каву	gate
каваби	gate
бакӀаризе	gather
дандчӀвай	gathering
борцине	gauge
рикӀкӀалъизаби	gave
нахъбахъи	gave
жанисеб гӀуцӀи	gear
жинс	gender
бихьинлъи-цӀулъи	gender
сундуего гӀаммаб	general
сахго	generally
баккизабизе	generate
наслу	generation
сахаватаб	generous
гьунар бугев чи	genius
къагӀида	genre
куц	genre
хӀеренаб	gentle
хӀакъикъияб	genuine
квералъ	gesture
бетӀералъ гьабулеб ишара	gesture
щвана	get
ретӀел ретӀине	get dressed
вахъине	get up
хехго сахлъе	get well soon
щолев	getting
рухӀ	ghost
рухӀ	ghosting
залим	giant
сайигъат	gift
имбирь	ginger
яс	girl
гьудулай	girlfriend
кье	give
мукӀурлъизе	give up
къун чӀезе	give up
кьураб	given
рохел	glad
бер реччизе	glance
матӀу	glass
цӀороберал	glasses
лъайчӀгун бихьизе	glimpse
глобалияб	global
вигъарав	gloomy
кьерхарав	gloomy
гъванилав	gloomy
гӀунцарав	gloomy
гвадачал	gloves
квердаххелал	gloves
кунчӀкунчӀизе	glow
гвангъизе	glow
нур базе	glow
кенчӀезе	glow
кенчӀезе	glow up
сину	glue
ана	go
цебе	go ahead
а	go away
кьишизе вахине	go to bed
ишан	goal
гӀуж	goal
цели	goals
цӀе	goat
бетӀергьан	god
сахго рукӀа	god bless you
ина буго	goes
ина вугев	going
ракӀарула буго	going to
месед	gold
ана	gone
хӀурлъула вуго	gonna
ине	goo
вилъине	goo
лъикӀин	good
лъикӀаб къо	good afternoon
рихьила	good bye
лъикӀаб къо	good day
лъикӀаб къасимех	good evening
лъикӀаб хӀалтӀи	good job
лъикӀаб куц-бегӀалда вихьула	good looking
битӀккейги	good luck
радал лъикӏ	good morning
доброе утро,дир рокьи	good morning my love
сордо лъикӀ	good night
рихьила	goodbye
сордо лъикӀ	goodnight
культтоварал	goods
гугл	Google
гугл переводчик	Google Translate
хъаз	goose
чӀурканаб	gorgeous
марага	gossip
щвана	got
биччана	got it
хӀукумат	government
кквезе	grab
къимат кьей	grade
дагь-дагь ккун	gradually
цӀали тӀубан	graduate
къватӀиве виччалев чи	graduate
мугь	grain
мугьажир	grant
кьураб	granted
цӀибил	grapes
бичӀчӀизе	grasp
хер	grass
баркала лъалев	grateful
баркала	gratitude
хоб	grave
цӀахӀилаб	gray
лъикӀин	great
хъантӀи	greed
къарумлъи	greedy
гӀурччинаб	green
салам кьезе	greet
салам кьей	greeting
салам кьезе	greetings
цӀахӀилаб	grey
сетка	grid
гьин	grid
хьури	grid
къварилъи	grief
ургъел	grief
хъуризе	grind
ххине	grind
хантӀан босизе	grip
продуктал ричулеб тукен	grocery
бахӀарав	groom
хайир	gross
ракь	ground
къокъа	group
тӀел	group
бижизе	grow
бижи	growth
кӀудияб гӀей	growth
ццин бахъараб	grumpy
ццидахараб	grumpy
ццидалаб	grumpy
Гъварани	Guarani
букӀинаби	guarantee
чӀезаби	guarantee
жавабчилъи	guarantee
цӀунизе тӀаде боси	guarantee
жаваб кьей	guarantee
хъаравуллъи гьабизе	guard
лъана	guess
гьобол	guest
нухмалъи	guidance
бетӀерлъи гьаби	guidance
туристазда  нух бихьизабулев чи	guide
гӀайибаб	guilty
гӀолилав	guy
лъимал	guys
спортзал	gym
гӀамал	habit
хасият	habit
тӀабигӀияб сверун кквей	habitat
букӀана	had
горо	hail
горо-цӀер	hail
цӀер	hail
рас	hair
кӀийил бутӀа	half
бащалъи	half
бащдаб	half
зал	hall
квер	hand
низамалде ккезабизе	handle
нухда тӀамизе	handle
берцинав	handsome
берцинаб	handsome
берцинай	handsome
дализабизе	hang
кеп гьабизе	hang out
аваданлъи гьабизе	hang out
хӀанчӀизе	happen
лъугьине	happened
талихӀ	happiness
роххел	happy
баркула мун гьавурабӀгьаюраб къо	happy birthday
баркула дуда мун гьавураб къо	happy birthday to you
баркула цӀияб сон	happy new year
захӀмат	hard
тамашха	hardly
гӀага-шагарго киданиги	hardly ever
хвезабизе	harm
зарараб	harmful
зиянаб	harmful
гармония	harmony
кьварарав	harsh
бачӀин	harvest
Буго	has
бокьунгутӀизе	hate
буго	have
лъикӀаб къо	have a good day
гьарула дуе лъикӀаб къо	have a nice day
радал кваназе	have breakfast
аваданлъи гьабизе	have fun
гьабизе	have fun
мун кванари	have you eaten
букӀаго	having
хӀинкъи	hazard
накӀкӀ	haze
гӀодонакӀкӀ	haze
русулнакӀкӀ	haze
гъов	he
досул буго	he has
гьев вуго	he is
бетӀер	head
ботӀрол унти	headache
вусинавизе	heal
дару гьабизе	heal
сахлъизе	healing
сахлъи	health
сахаб	healthy
рагӀине	hear
рагӀизе	heard
ракӀ	heart
РакӀ	heat
алжан	heaven
захӀматаб	heavy
рихха-хочи	hectic
борхалъи	height
варис	heir
ирсилав	heir
инсухъачи	heir
талагъи	heist
талавур гьаби	heist
хъамал гьаби	heist
ккуна	held
жужахӀ	hell
ворчӀамиӀйорчӀами	Hello
йорчӀами хирияй- for girls, ворчӀами хирияв -for boys	hello dear
рорчӀами, мун щабула вугев	hello how are you
салам,щибула вугев	hello how are you doing
хасаб тӀагъур	helmet
кумек	help
кумекияб	helpful
гьедин бугелъул	hence
гьединлъидал	hence
долъул	her
рехьед	herd
доба	here
ирс	heritage
щаклъизе	hesitate
леӀйо	Hey
ворчӀамиӀйорчӀами	Hi
салам,кин вуге	hi how are you
киназего салам	Hi there
бахчун тараб	hidden
балъго гьабураб	hidden
бахчараб	hidden
бахчизе	hide
тӀадегӀанаб даражаялъулазе тартибалда гъоркьиял даражабазул мутӀигӀлъиялъулаб низам	hierarchy
борхалъи	high
батӀалъизе	highlight
цере ин	hike
лъелго ини	hiking
кеплъурав	hilarious
гохӀ	hill
досул	him
бичӀчӀизелъун абизе	hint
мачӀчӀ	hip
мачӀчӀаби	hips
хӀалтӀизе лъугьине	hire
налъи	hiring
досул	his
история	history
кьабизе	hit
Хм	Hmm
гьабизе бокьулеб жо	hobby
ккой	hold
борхун ккойзе	hold on
каратӀ	hole
байрам	holiday
чӀобогояб	hollow
рукъ	home
рокъобе хӀалте	homework
ритӀухъав	honest
намус бугев	honest
вацӀцӀадав	honest
ракӀ бацӀцӀадав	honest
витӀарав	honest
яхӀ-намусалда	honestly
гьоцӀо	Honey
яхӀ	honor
намус	honor
капюшон	hood
кӀич	hook
къокъ кӀанцӀи	hop
божи	hope
хьулгул	hopefully
безнадежный	hopeless
горизонталъул хӀуччалда битӀараб	horizontal
лълъар	horn
ракӀ гъанцӀизабулеб	horrible
гӀасияб	horrible
ракӀ хӀинкъизабулеб	horrible
ракӀ зунизабулеб	horrible
ужастик	horror
чу	horse
азархана	hospital
гьобол вокьи	hospitality
бетӀергьан чи	host
тушманлъиялъулаб	hostile
тушманаб	hostile
багӀари	hot
гостиница	hotel
сагӀат	hour
сагӀат	hours
рукъ	house
хъизан	household
кин	how
мун щабула?	how about you
мун щабула	how are you
мун щабула вугевӀйигей	how are you doing
мун щабула жакъа	how are you doing today
нуж жакъа кин руге	how are you today
щибула вуге	how do you do
кин	how is
кигӀан	how many
чан	how many
кигӀаналде	how much
кигӀан гӀемер	how often
дуе чан сон бугеб	how old are you
дур къо кин араб	how was your day
маркӀачумех книн араб	how was your night
амма	however
бакьулъбакӀ	hub
рос	hubby
къвал базе	hug
каранде къазе	hug
кӀудияб	huge
гӀадан	human
инсан	human
чи	human
нич бугеб	humble
регьел бугеб	humid
рагьлилаб	humid
биччараб	humid
хӀеккин	humidity
биччи	humidity
регьел букӀин	humidity
нусго	hundred
вакъи	hungry
чан гьабизе	hunt
чанаве хьвадизе	hunt
чанахъанлъи гьабизе	hunt
перен	hurricane
гӀедегӀизе	hurry
гӀедегӀизе	hurry up
унтана	hurt
рос	husband
гӀедегӀизе	hustle
хъошрукъ	hut
рацӀцӀалъи	hygiene
дун	I
дун	I am
дун лъикӀ вуго	I am fine
дида кӀола	I can
дида кӀоларо	I can't
дица гьабула буго	I do
дида лъаларо	I do not know
дида биччуна гьечӀо	I do not understand
дун горо	I don't
дида лъаларо	I don't know
дида расги бичӀинчӀо	I don't understand
дида биччуна гьечӀо дуца абула бугеб жо	I don't understand what you mean
дида вичӀчӀуна гьечӀо мун	I don't understand you
дида лъаларо	I don’t know
дида бичӀчӀинчӀо	I don’t understand
батила	i guess
дица абула букӀана	I had
дир буго	I have
дун вукӀана	I have been
дир талихӀ гьеб гьедин батиларо	I hope so
дида лъала	I know
дие данде ккола	I like
дие мун данде ккола	I like you
дие бокьула	I love
дике вокьула дирго кӀудияв вац	I love my big brother
дие йокьула дтрго кӀудияй яц	I love my big sister
дие вокьула дирго эмен	I love my father
дие вокьула дирго гьитӀинав вац	I love my little brother
дие йокьула дирго гьитӀинай яц	I love my little sister
дие йокьула дирго эбел	I love my mother
дин мун вокьулаӀйокьула	I love you
дие мун пасат йокьула	I love you so much
дие мун пасат вокьула	I love you so much
диеги мун вокьула	I love you too
дица абула букӀана	I mean
Дун урхъун йиго дуда	I miss you
дун урхъун вуго дуда	I miss you
дун духъа цӀакъ урхъун вуго	I miss you so much
дида бихьула	I see
дун ургъула вуго	I think
дида бичӀана	I understand
дие бокьун буго	I want
дие мун вихьизе вокьун вуго	I want to see you
дие мун вокьун вуго	I want you
дун вукӀана	I was
дун йикӀана	I was
дица гьабила	I will
дун вукӀунаан	I would be
дун	I'm
дун лъикӀ вуго	I'm fine
ниж лъикӀ руго	I'm fine
дун лъикӀ йиго	I'm fine
дун лъикӀ вуго	I'm good
дун гьанива вуго	I'm here
тӀаса лъугьа	I'm sorry
цӀер	ice
мороженое	ice cream
пикру	idea
цӀакъ лъикӀаб	ideal
цӀакъаб	ideal
хӀисаб гьечӀого	ideal
тӀубан релълъараб	identical
гьединабго	identical
цого гӀадаб	identical
лъазабизе	identify
чӀезабизе	identify
гӀадан	identity
инсан	identity
чи	identity
гӀабдал	idiot
кепалда гьабулеб	idle
хӀалтӀичӀого	idle
ани	if
сан гьабунгутӀизе	ignore
унтарав	ill
унтарай	ill
унтараб	ill
законалда гьечӀеб	illegal
законалда рекъолареб	illegal
законалдаса бахъараб	illegal
унти	illness
чорхол сахлъи хвей	illness
Илокано	Ilocano
бихьизаби	image
цебетӀезаби	imagine
нахътӀамичӀеб	immediate
хехаб	immediate
Хехго	immediately
цӀакъ кӀудияб	immense
асар гьабизе	impact
сабру гьечӀев	impatient
яхӀ гьабизе	impatient
чӀезе кӀоларев	impatient
тӀубазабизе	implement
къватӀиса къайи босие	import
кӀвар бугеб	important
бухьине	impose
бажарулареб	impossible
лъугьунареб	impossible
бихьизаби	impress
асар	impression
рекӀее асар гьабулеб	impressive
лъикӀлъизе	improve
лъикӀлъизаби	improvement
в	in
гурони	in addition
хӀакъикъаталда	In fact
цебе	in front of
лъие гӀоло	in order to
сурукъаб	inappropriate
къабихӀаб	inappropriate
рекъечӀеб	inappropriate
сабаблъун бугеб жо	incentive
гӀиллалъун	incentive
тунка-гӀуси	incident
гъалмагъир	incident
дагӀба-рагӀи	incident
биччазе	include
жувалаго	including
тӀаде бачӀунеб хайир	income
санагӀат гьечӀолъи	inconvenience
рекъонгутӀи	inconvenience
кӀодолъизе	increase
ворхана	increased
божизе захӀматаб	incredible
букӀине бегьулареб гӀадаб	incredible
битӀун	indeed
чияда бараб гьечӀолъи	independent
индия	India
бихьизабизе	indicate
бакӀалъулаб	indigenous
напсияб	individual
промышленность	industry
жиндаса рорчӀизе бакӀ гьечӀеб	inevitable
рес гьечӀеб	inevitable
чара гьечӀеб	inevitable
гьитӀинаб лъимер	infant
инфекциялъулаб унти	infection
лъугӀи гьечӀолъи	infinity
рагӀа-ракьан гьечӀолъи	infinity
гьорой	inflammation
цӀа-кан бахун	inflammation
гӀарцул къимат хвей	inflation
асар гьабизе	influence
лъазаби	inform
цӀех-рех гьаби	inform
хабар лъазаби	information
ингредиенты	ingredients
хварав чиясул бетӀергьанлъи гьесул ирсилазухъе бачӀин	inheritance
байбихьулаб	initial
бетӀераб	initial
байбихьи	initiative
зиян гьабизе	injured
зарал гьабизе	injured
перен. ругъун	injury
лъукъел	injury
гӀайиб гьечӀолъи	innocent
цӀи раккарал жал	innovation
гьикъизе	inquiry
гӀадаллъарав	insane
гӀадалав	insane
гьодал гьечӀел гӀисинал рухӀчӀаголъаби	insect
божи гьечӀев	insecure
квалквал гьабизе	insert
жаниб	inside
бичӀчӀи	insight
тӀад ччезе	insist
къишизе кӀунгуртӀи	insomnia
гъира-шавкъ	inspiration
шавкъ	inspiration
къасд ккей	inspiration
гъира	inspiration
хӀасрат гьабизе	inspire
лъезе	install
мисал	instance
цо параялъулаб	instant
цӀакъ хехаб	instant
гъолъул бакӀалда	instead
лъилниги бакӀалда	instead of
инструкции	instructions
тӀагӀел	instrument
къабихӀ гьави	insult
хӀакъир гьави	insult
инжит гьави	insult
цӀунизе	insurance
нетронутый	intact
ритӀухълъи	integrity
намус буголъи	integrity
ракӀбацӀцӀалъи	integrity
гӀакъилав чи	intellectual
гӀакълу	intelligence
пикру	intelligence
интеллигентлъи	intelligent
лъай	intelligent
культура буголъи	intelligent
ният гьаби	intend
ракӀалда букӀине	intended
къасд букӀине	intended
хиял	intended
хӀалуцун (кутакалда тӀаделъун) гьабулеб	intense
нигат	intention
цоцазе асар гьабизе	interact
цоцазе асар гьаби	interaction
ракӀбай	interest
сундулниги-лъилниги интерес гьабулев	interested
интересаб	interesting
гьоркьове жуваге	interfere
гьоркьохъеб	intermediate
жанисеб	internal
жанибехунисеб	internal
халкъазда гьоркъосеб	international
хӀалбихьиялъе хӀалтӀулеб заман	internship
баян кьезе	interpret
магӀна бичӀчӀизабизе	interpret
кӀалзул переводчик	interpreter
къотӀизе	interrupt
интервью	interview
къватӀиб лъазе биччалареб	intimate
напсалъе хасаб	intimate
рекӀелъ бахчараб	intimate
в	into
лъай-хъвай гьабизе	introduce
цеберагӀи	introduction
живго жиндаго вукӀунев чи	introvert
цӀодорлъи	intuition
унтарав	invalid
цӀияб жо ургъи	invent
магӀишат	inventory
гъарац лъезе	invest
цӀех-рех гьабизе	investigate
ахӀи	invitation
ахӀизе	invite
рикӀкӀен	invoice
хурхинаби	involve
гъорлъе цӀай	involve
хурхинабураб	involved
махх	iron
буго	is
чӀинкӀиллъи	island
батӀа тӀураб	isolated
суал	issue
суал	issues
гъоб	it
гьаб буго	it is
гьеб букӀана	it was
досул	it's
гьесул	it's
гъосул	it's
расги кквешаб жо гьечӀо	it's ok
кинабго лъикӀ буго	It's okay
гьитӀинаб нугӀ	item
жо	items
долъул	its
дун	I’m
куртка	jacket
туснахъ	jail
январь	January
банка	jar
чӀандеро	jaw
жахӀда	jealous
гӀабдал	jerk
ахӀмакъ	jerk
гӀарцул жал	jewelry
хӀалтӀи	job
ракьа хин гьаби	jogging
цолъизабизе	join
жубазабизе	join
жубазаби	joint
цолъизаби	joint
махсара гьабизе	joke
журналист	journalist
нух	journey
рохел	joy
диванбег	judge
судияв	judge
лъим	juice
июль	july
кӀанцӀезе	jump
июнь	june
басралъун хвараб къайи-матахӀ	junk
пайда гьечӀеб жо	junk
уже	just
просто гьабе гьеб жо	just do it
ритӀухълъи	justice
гӀадиллъи	justice
инсап буголъи	justice
щивниги ритӀухъавлъун вихьизавизе	justify
Калолжат	Kalaallisut
ракӀбараб	keen
ккой	keep
гьедин ккой	keep it up
ккун букӀана	kept
чайник	kettle
кӀул	key
цезе	kick
лъимер	kid
махсара гьабун	kidding
бекӀ	kidney
лъимал	kids
чӀвай	kill
чӀвай-хъвей	kill
тамахаб	kind
гьадин абуни	kinda
разиго	kindly
недегьго	kindly
хӀеренго	kindly
рекӀел лъикӀлъи	kindness
хан	king
къирал	king
уба гьабизе	kiss
богорукъ	kitchen
гьавадул борохь	kite
кето	kitten
наку	knee
лъалаан	knew
нус	knife
рыцарь	knight
лъала	know
лъай букӀин	knowledge
баян букӀин	knowledge
лъала	known
Конкани	Konkani
Крио	Krio
тӀад хъвай-хъвагӀай гьабураб кагъат	label
хӀалтӀи	labor
захӀмат	labor
хӀалтӀи	labour
захӀмат	labour
гӀунгутӀи	lack
мали	ladder
чӀужу	lady
бихьизабураб	laid
чӀезабураб	laid
хӀор	lake
кьагӀрил тӀинчӀ	lamb
рекъав	lame
чирахъ	lamp
ракь	land
пейзаж	landscape
мацӀ	language
накаби	lap
кӀудияб	large
ахирисеб	last
ахирисеб,амма гьединго къваригӀунеб	last but not least
ахирисеб цӀар	last name
отчество	last name
кватӀун	late
дагьаб цебегӀан	lately
цинги	later
тӀарамагъадисеб	latest
ахирияб	latest
ахирисеб	latest
тӀарамагъадисеб	latter
ахирияб	latter
ахирисеб	latter
релъ	laugh
велъулев	laughing
релъи	laughter
тадбир	launch
лъугьа-рихьи	launch
ретӀел чурулеб бакӀ	laundry
къанун	law
гьитӀинаб мечӀ	lawn
адвокат	lawyer
лъезе	lay
тӀамизе	lay
гъат	layer
модель	layout
кӀвахӀалав	lazy
кӀвахӀалал	lazy
кӀвахӀалаб	lazy
кӀвахӀалай	lazy
бетӀерлъизе	lead
цевехъан	leader
бетӀер	leader
нух бихьизабулев чи	leader
тӀамах	leaf
чвахун ин	leak
ваччизе	lean
халат кӀанцӀи	leap
лъазабизе	learn
лъай кьей	learning
цӀализари	learning
ижараялъ босизе	lease
гӀодобегӀан	least
бищунго дагь	least
хьвацӀилаб	leather
лакайдулаб	leather
ана	leave
тӀамхал	leaves
вачана	led
ана	left
хӀетӀе	leg
ирс	legacy
законияб	legal
таватур	legend
законияб	legit
регӀараб	leisure
хӀалтӀи гьечӀеб заман	leisure
паракъатаб гӀуж	leisure
бекӀеда кьезе	lend
халалъи	length
дагьаб	less
дарс	lesson
изну кьезе	let
ихтияр кьезе	let
хъвай-хъвагӀай	letter
кагъат	letter
латук	lettuce
тӀасияб рахъ	level
битӀун кколеб бакӀ	level
гьумер	level
битӀараб бакӀ	level
хӀалтӀизабизе	leverage
жавабчилъи	liability
библиотека	library
чӀикӀизе	lick
гьереси	lie
гьереси	lies
гӀумро	life
борхизе	lift
канлъи	light
пири	lightning
бокьана	like
букӀине бегьулеб	likely
гьединго	likewise
хӀучч	line
мухъ	line
Лингала	Lingala
бухьен	link
хурхен	link
гъалбацӀ	lion
лъамалъи	liquid
лъамияб жо	liquid
сияхӀ	list
гӀенеккизе	listen
гӀенеккун вуго	listening
литературно	literally
адабият	literature
чороклъи	litter
рищни-къул	litter
гьитӀинаб	little
чӀаголъи	live
тӀул	liver
гӀумри	lives
гӀумру	living
яшав	living
бетӀербахъи	living
гьоболасул рукъ	living room
кьинч	lizard
бакӀлъи	load
буханка	loaf
къарз	loan
цо бакӀалда бугеб	local
цо бакӀалъул	local
вугев бакӀ	location
хъала	lock
щулалъи	lock
карантин	lockdown
перен	log
велъанхъизе	lol
ялгъузаб	lonely
янгъизаб	lonely
халатаб	long
рихьичӀес гӀемер заман буго	long time no see
балагьизе	look
кӀичӀ	loop
эркенаб	loose
бетӀерчӀахъад	lord
билизе	lose
тӀагӀине	lose
били	loss
зарал ккей	loss
ками	loss
тӀагӀин	loss
билизе	lost
гӀемер	lot
кутакаб	loud
кӀудияб	loud
чӀезе	lounge
щибго гьабунгутӀизе	lounge
расги гьабичӀого	lounge
рокьи	love
дие мун вокьула	love you
дие мун йокьула	love you
рокьулцӀураб	lovely
дагьаб	low
лъухъаб	lower
гӀодобегӀанаб	lower
тӀуцаб	lower
божилъи цӀунараб	loyal
ритӀухълъи	loyalty
ракӀ-ракӀалъ мутӀигӀлъи	loyalty
икъбал	luck
бергьенлъи	luck
талихӀккей	luck
битӀккей	luck
талихӀав	lucky
Луганда	Luganda
багаж	luggage
къотӀел	lump
рекел	lump
бутӀа	lump
кесек	lump
гӀерекъ	lump
къаде кванай	lunch
гьуърул	lungs
чӀухӀи	luxury
бечелъи	luxury
гьереси бицунев	lying
аппарат	machine
гӀадаллъун	mad
хозяйка	madam
гьабуна	made
журнал	magazine
гьайбатаб	magnificent
цӀакъ берцинаб	magnificent
хъулухъчӀужу	maid
тӀоцебесеб	main
гьоркьоб къотӀизе тунгутӀизе	maintain
хвезе тунгутӀизе	maintain
къваригӀел тӀубазе	maintenance
хӀажалъи	maintenance
хъулухъ гьабизе	maintenance
Матили	Maithili
кӀвар бугеб	major
гӀемерал	majority
цӀикӀкӀараб бутӀа	majority
гьабуна	make
данде гьабизе	make up
гьабизе	make up
бихьинчи	male
даран-базаралъул	mall
дармил	mall
бичахисиялъул	mall
чи	man
зарал гьабизе	manage
производствоялъе нухмалъи гьабиялъул къагӀидаби	management
менеджер	manager
тӀадебоси	mandatory
чара гьечӀого	mandatory
кьуричӀого тӀубазабизе кколеб къотӀи	mandatory
манифест	manifest
манипулировать	manipulate
гӀадат	manner
нухмалъи	manual
бетӀерлъи гьаби	manual
гӀемер	many
гӀемер-гӀемер лъикӀал нахъе руссарал къоял	many many happy returns of the day
ине	march
низамалда хъвадизе	march
жаниве лъугьине изну	margin
базар	market
бертин	marriage
росасда йикӀине	married
хъизан гьабурав	married
тӀад хураб гьумер	mask
масса	mass
бакӀаб	massive
мазалияб	massive
кӀудияб	massive
мастер	master
къец	match
гьудул	mate
материал	material
математика	math
суал	matter
цӀубай	maturity
барщи	maturity
балагьунбихьила	may
балагьунбихьила	maybe
дие	me
дунги	me too
квен	meal
рекӀелъ букӀана	mean
магӀна	meaning
магӀна	means
кӀвар букӀине	means
рекӀелъ къарарлъизе	meant
гьеб заманалда	meanwhile
борцине	measure
меры	measures
гьан	meat
медицинаялъул	medical
унтабазул гӀелму	medicine
ургъун бихьи	meditation
эргъей	meditation
бакьулълъи	medium
бакьулъбакӀ	medium
дандечӀвана	meet
дандечӀвай	meeting
Мейтелон	Meiteilon
биине	melt
чапизе	melt
ракӀалде щварал жал	memories
ракӀалдачӀей	memory
ракӀцӀодорлъи	memory
психический	mental
рехсей	mention
ракӀалде щвезаби	mentioned
насихӀатчи	mentor
базарган	merchant
даранчи	merchant
грухӀел-рахӀму	mercy
бигьаго	merely
гӀадатго	merely
цӀияб соналдасан	merry christmas
бардак	mess
кагъат	message
бардак	messy
маххул квар	metal
къагӀида	method
гӀонкӀкӀолаб	mice
бакьулъбакӀ	middle
сордо бащалъараб заман	midnight
балагьунбихьила	might
гьоркьохъеб даражаялъул	mild
рекъараб	mild
гьоркьохъеб хӀалалъ бугеб	mild
хӀуби	milestone
зани	milestone
рагъулав	military
рахь	milk
миллион	million
пикрабазда	mind
гӀакълу боси	mindset
дир	mine
жубазе	mingle
дагьамакъаб	minor
дагьаб	minor
гьитӀинаб	minor
минута	minute
минутал	minutes
гӀаламалъи	miracle
гӀажаиблъи	miracle
гӀажаибаб жо	miracle
матӀу	mirror
батӀи-батӀияб	miscellaneous
кӀарчамав	mischievous
гогьав	mischievous
чанкӀкӀарав	mischievous
талихӀ къараб	miserable
захӀмалъаби	misery
къварилъаби	misery
тӀалихӀ къосин	misery
хьуллъун	miss
дун урхъун вуго	miss you
дун урхъун йиго	miss you
ургъел гьечӀеб	missing
цебеккунго гьабураб тӀадкъай, бихьизаби	mission
накӀкӀ	mist
гъалатӀ	mistake
Мизо	Mizo
мобильный	mobile
тӀад релъанхъизе	mock
мисал гьабизе	model
гьоркьохъеб хӀалалъ бугеб	moderate
роцада бугеб	moderate
жакъасеб	modern
гьабсагӀат бугеб	modern
гьанжесеб заманалъул	modern
гӀодове виччарав	modest
дагьалда разияв	modest
чӀухӀи гьечӀев	modest
хъантӀичӀев	modest
регьел бугеб	moist
рагьлилаб	moist
биччараб	moist
реччел	moisture
регьел	moisture
форма	mold
нухрагӀункӀкӀ	mole
эбел	mom
баба	mom
заман	moment
лахӀзат	moment
къокъаб заман	moment
итни къо	monday
гӀарац	money
экран	monitor
маймалак	monkey
моцӀ	month
рекӀел хӀал	mood
гогьаб	moody
барщарулеб	moody
моцӀ	moon
моралияб	moral
цоги	more
тӀадеги	moreover
рогьел	morning
мулк-ракь гъоркьлъалие лъун босулеб къарз	mortgage
бищунго	most
сахго босани	mostly
эбел	mother
багъа-бачари	motion
багъари	motion
мотивация	motivation
мегӀер	mountain
гӀункӀкӀ	mouse
кӀал	mouth
багъаризе	move
багъа-бачари	movement
багъари	movement
кино	movie
миссис	mrs
гӀемер	much
хӀарщ	mud
кружка	mug
ччобори	muscle
музей	museum
гӀурдахӀан	mushroom
кечӀ	music
ккейи	must
мацӀ лъаларев	mute
кӀиязулго цоцадехун бугеб	mutual
дир	my
дир хирияв	My dear
дир хирияй	My dear
дир гьудул	my friend
дир гама воздухалъуд падушкида угрябазул цӀун буго	My hovercraft is full of eels
дир рокьи	my love
дида цӀар буго	my name is
Не за что	my pleasure
жибго	myself
живго	myself
жийго	myself
жинцаго	myself
жалго	myself
нахъгӀунтӀулареб	mysterious
тамашаяб	mysterious
балъголъи	mystery
балъгояб иш	mystery
халкъияб бицен	myth
маргьадулаб	myth
малъ	nail
рекӀкӀ гьечӀев	naive
сундаго божулев	naive
цӀар	name
цо лъугьабахъиналъул хӀакъалъулъ	narrative
бицин	narrative
хадуб-цебе ккезабун	narrative
къваридаб	narrow
чӀедераб	narrow
тӀеренаб	narrow
рокьукъаб	nasty
миллияб	national
миллат	nationality
гӀагараб	native
тӀабигӀияб	natural
тӀабигӀаталъ	natural
тӀабигӀат	nature
ракӀ багъари	nausea
лагӀизе бачӀин	nausea
ракӀ свери	nausea
аскӀоб	near
гӀагардегӀан	nearby
гӀагарда	nearby
аскӀоб	nearby
хьолбохъ	nearby
аскӀоб	nearly
вакӀа-вахари	neat
рацӀцӀа-ракъалъи	neat
къачӀа-кӀатӀай	neat
чара гьечӀелъи	necessary
шекъер	neck
маргъалазул цӀал	necklace
къваригӀин	need
гӀаксаб	negative
мекъаб	negative
сан гьабунгутӀи	neglect
бачине	negotiate
кӀалъа-ралъай	negotiate
мадугьал	neighbor
мадугьаллъи	neighborhood
щибго	neither
кигӀан дагьабниги	neither
вацасул яс	nephew
яцалъул вас	nephew
вацасул  вас	nephew
зануда	nerd
нервазулаб	nervous
хӀанчӀибусен	nest
сеть	net
хьури	network
нейтралияб	neutral
киданиги	never
киданиги мутӀигӀлъуге	never give up
дие батӀалъи гьечӀо	never mind
кӀвар гьечӀого	nevermind
кин бугонаниги	nevertheless
цӀияб	new
цӀияб жо	news
хадусеб	next
гӀагардегӀан	next to
гӀагарда	next to
аскӀоб	next to
хьолбохъ	next to
лъикӀин	nice
лъикӀ буго  лъай-хъвай гьабизе	nice to meet you
яцалъул яс	niece
вацасул яс	niece
сордо	night
рокьукъаб макьу	nightmare
квешаб	nightmare
ичӀго	nine
анцӀила ичӀго	nineteen
ункъоялда анцӀго	ninety
ууна	No
проблема гьечӀо	no problem
киданиги	no way
щивниги	nobody
хъуй	noise
гъавгъа гӀемераб	noisy
щивниги	none
къалъулгӀуж	noon
гьечӀо	nope
гуро	nope
ни	nor
гӀадатаб	normal
букӀине кколеб гӀадаб	normal
севералъулаб рахъ	north
мегӀер	nose
ракьалда щолеб	nostalgic
ууна	not
махӀниги	not at all
кигӀанги	not at all
лъикӀ	not bad
квеш гьечӀого	not bad
хӀанчи гуро	Not now
жиги гьечӀо	not yet
баян	note
гуро	noted
расги гуро	nothing
халлъизе	notice
бихьана	noticed
предметияб цӀар	noun
существительные	nouns
роман	novel
ноябрь	november
гьанже	now
гьаб заман	nowadays
санагӀалъи гьечӀолъи	nuisance
къагӀида гьечӀолъи	nuisance
нолалъул	null
собозе	numb
рикӀкӀен	number
медсестра	nurse
цӀулакьо	nut
мускатный цӀулакьо	nutmeg
кванай	nutrition
гьеди	oath
тӀатӀи рекӀин	obesity
кьаралъи	obesity
кверщел гьабизе	obey
мутӀигӀ гьабизе	obey
кверщаликье бачине	obey
объект	object
ишан	objective
гӀуж	objective
тӀадаблъун бугеб	obligation
бецӀ гьабизе	obscure
халкквей	observation
балагьи	observation
хал кквезе	observe
сунцаниги жинда кверщел гьабурав	obsessed
кодове восарав	obsessed
кинаб бугониги хӀалалъ	obsessed
сунцаниги жинда кверщел гьабурав	obsession
кинаб бугониги хӀалалъ	obsession
нахъе ккараб	obsolete
басралъараб	obsolete
херлъараб	obsolete
квекӀен	obstacle
авара	obstacle
щвезе	obtain
осизе	obtain
щвараб	obtained
берда бихьулеб	obvious
якъинаб	obvious
дагӀба гьечӀеб	obvious
берда бихьулеб	obviously
якъинаб	obviously
дагӀба гьечӀеб	obviously
нагагьаб	occasionally
хӀалтӀи-пиша	occupation
профессия	occupation
хӀалтӀулев	occupied
машгъуллъарав	occupied
хӀалтӀи бугев	occupied
лъугьине	occur
лъана	occurred
ракӀалда букӀинчӀеб	occurs
океан	ocean
октябрь	october
хӀикматаб	odd
шансы	odds
оф	of
у	of course
чӀезабизе	off
гьоркьоб къотӀизабизе	off
хӀакъир гьавулеб	offensive
инжит гьавулеб	offensive
къабихӀ гьавулеб	offensive
цебе лъуна	offer
офис	office
официалияб	official
гьарзаго	often
о	Oh
унго	oh really
нах	oil
агьа	ok
агьа хирияв	ok dear
агьа ракӀалъ восулев	ok honey
агьа дир рокьи	ok my love
агьа	okay
агьа,лъимер	okay baby
агьа хирияв	okay dear
агьа хирияй	okay honey
агьа хирияв	okay honey
агьа дир рокьи	okay my love
хераб	old
тӀад	on
цоцӀо	once
цо	one
цо мацӀ киданиги букӀунаро гӀезегӀан	one language is never enough
пер	onion
в сети	online
цохӀо	only
рагьизе	open
операция	operation
пикру	opinion
рес	opportunities
хӀалкӀвейи	opportunity
дандбитӀун	opposite
оптимизмалъулаб	optimistic
къагӀида	option
тӀадаб гуреб	optional
тӀадаблъун гьечӀеб	optional
ва	or
апельсин	orange
тӀад къай	order
чӀараб	ordinary
ругьунаб	ordinary
кидаго гӀадаб	ordinary
орагнизация	organization
нух бахъизе лъай	orientation
рижи	origin
лъугьин	origin
бакки	origin
хӀакъикъияб	original
жиндирго квералъ хъвараб	original
оригиналияб	original
Оромо	Oromo
бесдал лъимер	orphan
Цогияб	other
батӀайиса	otherwise
ккола	ought
нижер	our
нилъер гӀумру гьабиялӀул магӀна:  сахазего киса -кибего рес къезе   дуниял бичӀчӀине ва жиндирго пикру загьир гьабизе батӀибатӀиял мацӀалда	Our mission: to enable everyone, everywhere to understand the world and express themselves across languages.
нилъер гӀумру гьабиялӀул магӀна: динялалъулго информация системалде ккезабизе ва сахалго гӀадамазе бичӀчӀине ва хӀалтӀизабизе  бигьаяблъун	Our mission: to organize the world's information and make it universally accessible and useful.
къватӀибе	out
къватӀире унеб бакӀ	outcome
къватӀибе нух	outcome
къваригӀунеб къайи-къоно	outfit
къватӀибе унеб	outgoing
биччай	outlet
рикӀкӀадасан бихьулеб къватӀисеб сипат	outline
тӀасан	outside
къватӀисан	outside
цӀар араб	outstanding
машгьураб	outstanding
печь	oven
тӀасан	over
доба	over there
лъоба	over there
гъоба	over there
сундуего гӀаммаб	overall
киназего	overall
гӀахьалаб	overall
къезабизе	overcome
къуркьизабизе	overcome
къуризабизе	overthinking
бихха-хочараб	overwhelmed
рахӀат хвараб	overwhelmed
баччизе кӀолареб	overwhelming
хӀехьезе	overwhelming
бетӀергьанлъи	owe
руз	owl
бетӀергьанлъи	own
бетӀергьан чи	owner
хважайин	owner
оц	ox
риччай	pace
пакет	pack
бухьа-къай	package
рекъезабун лъей	package
къураб	paid
бецӀцӀараб	paid
унти	pain
сурат	paint
ракӀ бацӀцӀадав	painting
кӀигоял	pair
кьер тӀураб	pale
хъат	palm
огъохъат	palm
хьаг	pan
цо улкаялде яги улкаялъул бутӀаялде цадахъ унтаби рахин	pandemic
рихха-хочи	panic
тӀажу	pants
кагъат	paper
алжан	paradise
параллелияб	parallel
посылка	parcel
тӀаса лъугьине	pardon
эбел-эмен	parents
умумул	parents
хьвадизе нухалги ругеб ах	park
гаргадулеб хӀинчӀ	parrot
петрушка	parsley
бутӀа	part
гӀахьаллъизе	participate
тӀокаб	particular
батӀаго	particularly
цӀакъго	particularly
дандеяв	partner
гӀодорчӀей	party
цӀадухъчӀей	party
ккезе	pass
къокъид нух	passage
цо бакӀ къотӀун унеб нух	passage
араб	passed
шавкъ	passion
кутакаб шавкъ бугев	passionate
кутакаб гӀишкъуялъул	passionate
гурхӀулев	passive
гурхӀел бугев	passive
пароль	password
цебесеб	past
араб	past
унтараб бакӀалда чӀвалеб ххамил чӀоло	patch
нух	path
гъаримав	pathetic
пакъирав	pathetic
язихъав	pathetic
сабру	patience
унтарав	patient
шаблон	pattern
лъалхъи	pause
тротуар	pavement
хӀазе	pay
мухь кьей	payment
гӀодобе биччай	peace
сасин	peace
рекъел бокьулел	peaceful
дагӀба-къец гьабуларел	peaceful
микьир	peach
бетӀер	peak
борхалъи	peak
тӀогь	peak
гени	pear
хилъало	peas
батӀияб хасияталъул	peculiar
кӀущизе	pee
бацӀцӀине	peel
кӀвар кьун балагьизе	peer
гӀел бащадав	peers
кьерилав	peers
кверкъел	pen
къалам	pencil
балагьун чӀей	pending
гӀадамал	people
пилпил	pepper
пучч	pepper
сангьавизе	perceive
лъай	perception
къабул гьаби	perception
бичӀчӀи	perception
нахъгӀунтӀи	perception
цӀакъ лъикӀаб	perfect
тӀубазабизе	perform
цеве вахъин	performance
цейе яхъин	performance
цере рахъин	performance
балагьунбихьила	perhaps
заман	period
гьоркьоса къотӀичӀеб	permanent
изну, ихтияр	permission
биччазе	permit
бегьизе	permit
тӀаса вичӀунгутӀи	perseverance
къвакӀун чӀей	perseverance
тӀаделъи	perseverance
жигараб	persistent
таваккалаб	persistent
тӀад чӀараб	persistent
гӀадан	person
инсан	person
чи	person
живго бетӀергьанаб	personal
напсияб	personal
жиндирго	personal
жинцаго гьабулеб	personal
гӀадан	personality
инсан	personality
чи	personality
цебе рехун бихьулеб сундулниги сурат	perspective
чӀезабизе	persuade
гьоркьоб къотӀизабизе	persuade
инкар гьабурав чи	pervert
рокъосеб хӀайван	pet
сундул бугониги цебетӀеялъулъ хиса-баси кколеб лахӀзат	phase
вачӀин	phenomenon
лъугьа-бахъин	phenomenon
инсаният	philosophy
тӀабигӀат	philosophy
гӀакълу цебетӀеялъул гӀаммал законазул хӀакъалъулъ гӀелму	philosophy
телефон	phone
сурат	photo
жугьа	phrase
калима	phrase
физическияб	physical
бичизе	pick
бича-хисизе	pick
даран гьабизе	pick
босизе	pick up
сурат	picture
рекъел	piece
бутӀаби	pieces
болъон	pig
микки	pigeon
гохӀ	pile
гъуни	pile
къандалъо	pillow
пилот	pilot
воржарухъан	pilot
рукӀкӀен чӀван	pin
щула гьабизе	pin
ананас	pineapple
розаялъул кьераб	pink
багӀарккараб	pink
тонкӀо	pit
майдан	pitch
гъаримав	pity
пакъирав	pity
язихъав	pity
бакӀ	place
чеспла	places
чума	plague
къавуда	plague
гӀадатаб	plain
план	plan
самолет	plane
хурдул	plant
хурдул	plants
суркӀа	plate
рекӀунеб-рещтӀунеб бакӀ	platform
хӀазе	play
хӀазе	playing
бегьулеб	pleasant
квегӀенаб	pleasant
рекъон кколеб	pleasant
дала кьегийин	please
рази гьавурав чи	pleased
лазат	pleasure
рахӀат	pleasure
присяга абизе	pledge
гӀемер	plenty
магӀна кьолел лъугьа-бахъинал	plot
къайзе	plug
кокон	plum
лъел нухъ къачӀалев чи	plumber
лъим бачунев	plumber
множественное число	plural
подкаст	podcast
кочӀол цо мухъ	poem
кочӀохъего хъварал асарал	poetry
бихьизабизе	point
нугӀлъи гьабизе	point
загьру	poison
полиция	police
сиясат	policy
адаб-хъатир буголъи	polite
хӀеренлъи	polite
чороклъи	pollution
хӀор	pond
бассейн	pool
вилъизе	poop
язихъав	poor
мискинав	poor
поп	pop
бичӀчӀулеб	popular
популяция	population
болъонил гьан	pork
хӀичи	porridge
карщ	porridge
гумул чӀезе гьабураб бакӀ	port
рагъулал ишал ругеб бакӀ	position
уяб	positive
дурусаб	positive
рекъараб	positive
битӀараб	positive
бетӀергьанлъи гьабизе	possess
бетӀергьанлъи	possession
притяжательный падеж	possessive
балагьун бихьила	possible
почта	post
нахъе лъезе	postpone
картошка	potato
букӀине бегьулеб	potential
фунт	pound
мискӀинлъи	poverty
гуч	power
къуват	power
хӀал	power
кутак	power
къуватаб	powerful
хӀал бугеб	powerful
гучаб	powerful
иш лъалев	practical
хӀалбихьи бугев	practical
хӀал бихьизе	practice
беццизе	praise
бергьинелъун хӀазе лъугьин	prank
дугӀа-алхӀам гьабизе	pray
как базе	pray
берцинлъи	precious
гьайбатлъи	precious
хӀайранлъи	precious
беричлъи	precious
дурусаб	precise
мухӀканаб	precise
гьеле гьедин	precisely
букӀинесеб цебеккунго бицине	predict
бокьи	prefer
тӀокӀаблъун рикӀкӀин	preference
цо жо цогидалдаса лъикӀаблъун	preference
къинай	pregnant
цебеккунго жиндилъ ракӀчӀей бижарав	prejudice
рукъ	premises
мина	premises
ригь	premises
лъикӀаб хӀалтӀухъ кьолеб гӀарац	premium
хӀадурлъи гьаби	preparation
хӀадурлъи гьабизе	prepare
хӀадураб	prepared
багьана	preposition
далил	preposition
сабаб	preposition
гӀилла	preposition
цо бакӀалда вукӀин	presence
сайигъат	present
бихьизаби	presentation
цӀунизе	preserve
президент	president
мерхьине	press
тӀадецуй	pressure
хӀалуцин	pressure
притворяться	pretend
гӀола	pretty
гьукъизе	prevent
цебесеб	previous
балагьи	prey
бахъи	prey
мухь	price
къимат	price
багьа	price
чӀухӀи	pride
кашиш	priest
тӀоцебесеб	primary
аслияб	prime
къираласул яс	princess
аслияб	principal
бетӀераб	principal
цебесеб	prior
некӀсияб	prior
тӀоцебесеблъи	priority
авалияблъи	priority
туснахъ	prison
бахчараб	privacy
жиндирабго	private
цогидазеялдаса цӀикӀкӀараб ихтияр	privilege
привилегия	privilege
шапакъат	prize
балагьунбихьила	probably
авари	problem
къагӀид	procedure
халат гьабизе	proceed
цебетӀей	process
биччазе	produce
нигӀмат	product
гьаби	production
пиша	profession
махщел	profession
пишаяб	professional
рикӀкӀадасан бихьулеб къватӀисеб сипат	profile
пайдаяб	profit
мунпагӀатаб	profit
хайираб	profit
гъваридаб	profound
цебетӀей	progress
проект	project
бихьулеб	prominent
рагӀи кьезе	promise
кӀодо гьавизе	promote
тӀадегӀанаб даражаялде вахинавизе	promote
даража борхизабизе	promote
цӀикӀкӀинаби	promotion
эхеде бахинаби	promotion
борхизаби	promotion
тӀадегӀан борхи	promotion
хехаб	prompt
распростертый	prone
склонный	prone
местоимения	pronouns
каламалъул гьаркьал абулеб къагӀида	pronunciation
гьаркьал рахъи	pronunciation
хӀужжа	proof
дурусаб	proper
битӀараб	proper
мухӀканго	properly
хасият-гӀамал бихьизаби	properties
бетӀергьанлъи	property
бокьун букӀин лъазаби	proposal
цебе рехун бихьулеб сундулниги сурат	prospect
тӀегьай	prosperity
тӀегьалев	prosperous
хьихьизе	protect
чӀухӀизе	proud
ритӀухълъи хӀужжабаздалъун чӀезабизе	prove
чӀезабизе	provide
цебе лъуна	provided
административияб бутӀа	province
чӀезаби	provision
хьезаби	provision
букӀинаби	provision
балухлъиялде вахин	puberty
гӀемерал гӀадамалги ракӀарун гьабулеб	public
цӀазе	pull
бухьине	pull
хъабахъ	pumpkin
дурусав	punctual
цӀалдохъан	pupil
къвачӀа	purchase
бацӀцӀадаб	pure
фиолетовый	purple
гӀуж	purpose
бухча	purse
хадув лъугьине	pursue
хадур лъугьин	pursuit
цуйзе	push
лъезе	put
махшел	qualification
гьунар	qualification
квалификация	qualification
устарлъи	qualification
хасият	quality
къадар	quantity
карантин	quarantine
къел кквезе	quarrel
дагӀбадизе	quarrel
къацандизе	quarrel
ункъил бутӀа	quarter
Кечуа	Quechua
къираласул чӀужу	queen
хӀикматаб	queer
тамашаяб	queer
гӀажаибаб	queer
цӀех-рех	query
суал	question
кьер	queue
мухъ	queue
хехав	quick
хехго	quickly
шурун	quiet
юргъан	quilt
ине	quit
гӀураб	quite
контролияб	quiz
халгьабиялъул гьикъи	quiz
щибго хисизабичӀого тексталдаса босараб кесек	quotation
щибго хисизабичӀого тексталдаса босараб кесек	quote
кавычкаби	quotes
рукъалъул гӀанкӀ	rabbit
рекеризе тӀами	race
ццидахин	rage
кутакаб ццин бахъин	rage
цӀад	rain
Борзизабизе	raise
борхараб	raised
векерана	ran
ракӀалда гьечӀого	random
чин	range
даража	range
категория	range
алхунареб	rapid
дурусаб	rapid
мухӀканаб	rapid
гӀужда гьабулеб	rapid
хехго	rapidly
лъедераб	rare
лъедераб	rarely
сыпь	rash
нука	rat
процент	rate
такрарлъи	rate
хехго	rather
бухьен	ratio
гьоркьоблъи	ratio
санагӀатаб	rational
мунпагӀатаб	rational
мустахӀикъаб	rational
гӀакълуялда рекъон кколеб	rational
регьел бугеб	raw
регьел хӀалаб	raw
рэ	re
гӀунтӀизе	reach
щвезе	reached
реакция	reaction
цӀале	read
цӀали	reading
хӀадураб	ready
гьанжесеб	real
хӀакъикъияб	reality
ургъун бахъичӀеб жо	reality
хӀакъикъат	reality
унгоунголъунги бугеб	reality
билълъинабизе	realize
тӀубараб	realized
унгозгийищ	really
нахъисеб	rear
гӀилла	reason
гӀакълу бугеб	reasonable
гӀакъилаб	reasonable
ракӀалде щвезабизе	recall
чек	receipt
тукадаса босараб къайиялъухъ гӀарац кьеялъул кагъат	receipt
щвезе	receive
босизе	receive
щвезе	received
босизе	received
дагьаб цебегӀан ккараб	recent
дагьаб цебегӀа	recently
разилъизе бегьулеб	reception
къабул гьабизе	reception
рецепт	recipe
ургъичӀого гьабураб	reckless
тохаб	reckless
ахӀмакъаб	reckless
пикру гьабичӀого гьабураб	reckless
рикӀкӀин	recognition
батӀа бахъизе лъазе	recognize
рекомендация	recommend
лъикӀаблъун рихьизарурал	recommended
хъвазе	record
цӀилъизе	recover
рукӀалиде ккезаби	recovery
бахъун чӀезаби	recovery
гъоркь букӀахъе ккезаби	recovery
бокӀонбитӀ	rectangle
багӀараб	red
бахъун чӀезабизе	redeem
рукӀалиде ккезабизе	redeem
гъоркь букӀахъе гьабизе	redeem
мунагь чури	redemption
тӀаса лъугьинави	redemption
гьитӀин гьабизе	reduce
къваригӀунелдаса цӀикӀкӀараб	redundant
гьарзаяб	redundant
гӀунги тӀокӀаб	redundant
гӀемераб	redundant
ссылка	refer
нугӀлъиялъе бачараб текст	reference
нахъе буссинаби	reflect
нахъчӀвай	reflection
кочӀол щибаб куплеталда хадуб хисичӀого ахӀулеб бутӀа	refrain
холодильник	refrigerator
нахъ буссинабизе	refund
нахъе кьезе	refund
бецӀизе	refund
нахъчӀвазе	refuse
инкар гьабун чӀана	refused
нахъчӀвана	refused
пикру кьей	regard
гӀахьалаб	regarding
гьелъухъ балагьичӀого	regardless
уважениегун	regards
регион	region
регистр	register
ракӀалда бухьана	regret
низамалда лъугьунеб	regular
тартибалда рекъон	regularly
жиндир гӀужда	regularly
нахъе цузе	reject
гӀагарлъи букӀине	relate
бухьараб	related
цоцадехун бугеб гьоркьоблъи (бухьен	relationship
хурхен)	relationship
гӀагарав чи	relative
гӀагарал	relatives
отдыхать	relax
борчӀизабизе	release
къватӀиве виччарав	released
рекъолеб	relevant
данде кколеб	relevant
битӀун кколеб	relevant
йигей	reliable
божи вугев	reliable
тӀадагьлъи	relief
тӀадагьлъизабизе	relieve
тӀадагь гьабизе	relieve
бигьалъигун	relieved
дин	religion
диналъул	religious
динияб	religious
дин гьабулеб	religious
чара гьечӀеб	reluctant
мугъ чӀвазе	rely
чӀезе	remain
хутӀарав	remaining
гьайбатаб	remarkable
машгьураб	remarkable
тадбир	remedy
гӀамал	remedy
къагӀида	remedy
чара	remedy
ракӀалда букӀине	remember
кӀочон тунгутӀизе	remember
ракӀалде щвезаби	remind
ракӀалде щвезаби	reminder
лъазаби	reminder
довегьанав	remote
бахъизе	remove
гьабизе	render
бахъизе	rent
къачӀай	repair
такрар гьабизе	repeat
хисизабизе	replace
жаваб кьезе	reply
отчет	report
вакиллъи	represent
сий	reputation
цӀар	reputation
къадру	reputation
тӀалаб	request
тӀалабалда рекъон	require
тӀад лъун бугеб	required
хвасар гьабизе	rescue
цӀех-рех гьабураб  хӀалтӀи	research
релълъенлъи букӀине	resemble
релълъараб букӀине	resemble
ццин бахъин	resentment
къвакӀгьаби	reservation
бронировать	reserve
ивниги гӀумру гьабун чӀарав чи	resident
гӀодов чӀейалъе заявка кьезе	resign
щулалъи	resilience
къвакӀи	resilience
хьвагӀолареб	resilient
чӀолеб	resilient
данде чӀезе	resist
дандечӀей гьаби	resistance
дандечӀей	resistance
ихтияр	resolution
изну	resolution
решать	resolve
пайда босизе	resort
ресурсы	resources
хӀурмат гьабизе	respect
жаваб кьезе	respond
жаваб	response
жавабчилъи	responsibility
жавабчилъи	responsible
хӀалчвайи	rest
халхъи гьабе гӀумригун	rest in peace
ресторан	restaurant
бахъун чӀезабизе	restore
рукӀалиде ккезабизе	restore
гъоркь букӀахъе гьабизе	restore
цӀикӀкӀине биччалареб алат	restrict
хӀасил	result
хӀасил	results
хӀасил	resume
бичари	retail
ккойзе	retain
кквей	retention
гьоркь кквей	retention
тӀаса кквей	retention
пенсиялде арав	retired
нахъе къай	retreat
босизе	retrieve
тӀадбуссинаби	return
нахъекьей	return
нахъбуссинаби	return
рагьизе	reveal
рагьараб	revealed
рецӀел	revenge
къисас	revenge
доход	revenue
харж	revenue
тӀаде бачӀунеб хайир	revenue
нахъехун балагьараб	reverse
бер щвезаби	review
балагьи	review
хал гьаби	review
битӀизабизе	revise
ревизия	revision
хисасвери	revolution
гӀуцӀиялда кколеб кӀудияб беки	revolution
шапакъат	reward
рекъей	rhythm
хьабалухъагӀучӀ	rib
дугу	rice
бечелъи	rich
хвасар гьаризе	rid
бачине	ride
гӀадаллъарав	ridiculous
гӀадалав	ridiculous
кванараб	right
хӀанч	right now
къвакӀараб	rigid
мургьо	ring
чуризе	rinse
багъа-бачари	riot
бихъизе	rip
барщараб	ripe
кодобе босизе	rise
хӀинкъи бугеб	risk
дандеяв	rival
гӀор	river
сапар	road
нух	road
бежизе	roast
щулияб	robust
къуватаб	robust
къвакӀараб	robust
гамачӀ	rock
мокъ	rod
роль	role
гури	roll
тӀох	roof
комната	room
кьибил	root
квар	rope
турараб	rotten
къвакӀго	rough
хъачӀго	roughly
адаб тун	roughly
гургинаб	round
маршрут	route
рутина	routine
очередь	row
лъулъайзе	rub
резина	rubber
чороклъи	rubbish
рищни-къул	rubbish
хъачӀго	rude
тӀанса	rug
магӀишат биххизаби	ruin
къагӀида	rule
хӀучч	ruler
мухъ	ruler
къагӀида	rules
рекери	run
рекери	running
росдал(аб)	rural
кого-что рещтӀинавизе	rush
къвачӀа	sack
таргьа	sack
динияб	sacred
бацӀцӀадаб	sacred
къурбан	sacrifice
хӀинкъи гьечӀолъи	safe
хӀинкъи гьечӀеб боржин	safe flight
паракъалъи	safety
хӀинкъи гьечӀолъи	safety
тӀадегӀанаб лъай бугев чи	sage
абуна	said
лъедезе	sail
парусияб спорт	sailing
гӀоло	sake
харж	salary
алапа	salary
захӀматхӀакъ	salary
бичизе	sale
лосось	salmon
цӀан	salt
чанго	same
гъобго жо	Same here
мисал	sample
тайпа	sample
сали	sand
Санскрит	Sanskrit
иришватлъи бугеб	sarcastic
инжит гьавулеб	sarcastic
тӀадрелъанхъи гьоркьоб бугеб	sarcastic
ццидалаб	sarcastic
нич гьечӀеб	sassy
нич тӀагӀараб	sassy
шамат къо	sat
рази гьави	satisfaction
разияв	satisfied
къабул гьабизе	satisfy
данде кколеб рекъолеб	satisfying
шамат къо	Saturday
колбаса	sausage
гӀалхулаб	savage
цӀунизе	save
бихьана	saw
абизе	say
шкала	scale
хӀалихьалъи	scam
нахъегӀанлъи	scam
къадарлъи	scam
гьерсихъанлъи	scam
ругънал хутӀараб гӀуж	scar
дагьаб	scarce
мискинаб	scarce
мукъсанаб	scarce
загӀипаб	scarce
хӀинкъизавурал	scared
хӀинкъизавурай	scared
хӀинкъизавурав	scared
габурбухь	scarf
хӀинкъи бугеб	scary
цояб цояздаса рикӀкӀадаб	scattered
сцена	scene
тӀабигӀаталъул сипатсурат	scenery
махӀ	scent
хъвараб заман	schedule
школа	school
гӀелму	science
гӀелму бугев чи	scientist
цӀаларал чагӀи	scientists
кӀвекьмахх	scissors
вагъизе	scold
объем	scope
рикӀкӀен	score
хӀисаб	score
хӀос	scrap
хъарсизе	scratch
чӀичӀиди	scream
гьаракь	scream
гӀергӀеди	scream
ахӀи	scream
экран	screen
бурав	screw
сценаялде рахъине кколеб низамги заманги бихьизабун пьесаялъул гӀахьалчагӀазе хъвараб сияхӀ	script
ралъад	sea
noun -ралъдал гьой	seal
verb - мугьру чӀвазе	seal
ралагьизе	search
лъагӀалил бутӀа	season
гӀодор чӀолеб бакӀ	seat
кӀиабилеб	second
балъголъи	secret
балъгояб жо	secret
раздел	section
бикьи	section
хӀинкъи гьечӀеб	secure
божилъи бугев	secure
паракъатаб	secure
охрана	security
бихьула	see
дида мун вихьула	see you
дагь нахъ ртхьила	see you later
рихьила	see you soon
метер рихьила	see you tomorrow
мугь	seed
балагьизе	seek
батизе	seek
ккана	seem
дида ккола	seems
берда бихьулеб	seen
тӀатараб	seen
бихьулеб	seen
бахъизе	seize
хӀалица бахъи	seizure
лъедераб	seldom
бищизе	select
живго	self
дунго	self
мунго	self
живго сах гьави	self healing
эгоистлъи	selfish
бичизе	sell
битӀизе	send
битӀе дие дурго сурат	send me your picture
гӀумруялъ кӀудияй	senior
кӀудияй	senior
магӀна	sense
гӀакъилаб	sensible
рекӀее бокьи	sensitive
битӀизе	sent
предложение	sentence
ккои	sentences
батӀа гьабизе	separate
бикьизе	separate
Сипиди	Sepedi
сентябрь	september
тартиб буголъи	sequence
къотӀел	series
цикл	series
кӀвар бугев	serious
унгоялъги	seriously
къваригӀел тӀубазе	serve
хӀажалъи	serve
хъулухъ гьабизе	service
гьоркьоб къотӀичӀого бихьизабулеб щибниги жо	session
сеанс	session
лъезе	set
гӀуцӀизе	set up
роценал	setting
решить	settle
анкьго	seven
анцӀила анкьго	seventeen
лъабкъоялда анцӀго	seventy
Чанго	several
захӀматаб	severe
букъизе	sew
сх	sh
батӀалъи	shade
рагӀад	shadow
кӀобокӀизе	shake
кӀутӀизе	shake
shall	shall
къокъаб	shallow
нич	shame
черх	shape
къаркъала	shape
бикьизе	share
бегӀераб	sharp
дой	she
долъул буго	she has
дой	she is
цӀулал рукъ	shed
кьегӀер	sheep
тӀамах	sheet
буцрал хъарщи	shelf
кьогъен	shelf
тахча	shelf
къотӀел	shelf
хъал	shell
гъат	shell
чӀезе бегьулеб бакӀ	shelter
хъалхъан	shield
бугелъуса багъаризаби	shift
канлъи кьезе	shine
гвангъизабизе	shine
нур кьезе	shine
гама	ship
къайи баччи	shipping
рубашка	shirt
хьитал	shoes
кьвагьизе	shoot
тукен	shop
бичун боси	shopping
рагӀал	shore
къокъаб	short
ками	shortage
гӀунгутӀи	shortage
кьвагьана	shot
шуд	should
гъеж	shoulder
ахӀдезе	shout
чӀичӀидизе	shout
бихьизабизе	show
дида бихье	show me
душ	shower
креветка	shrimp
гьитӀин гьаби	shrink
данде чӀвазе	shut
кӀал къай	shut up
нечезе	shy
вац	sibling
яц	sibling
яц-вац	siblings
унтун	sick
рахъ	side
хӀухьел цӀай	sigh
бихьун бажари	sight
бихьи	sight
машгьурал жал риккизе	sightseeing
гӀуж	sign
гъолбас гьаби	signature
хӀакъикъияб	significant
сихӀкъотӀи	silence
гӀодоцараб	silent
сасараб	silent
чиллайдул кьуричӀел рихьал	silk
гьавав	silly
гьагай	silly
гьагал	silly
гӀарац	silver
релъараб	similar
гӀабдал	simp
бигьаяб	simple
гӀадатияб	simple
цого заманалда байбихьизе	simultaneously
добасан	since
ракӀ бацӀцӀадав	sincere
битӀун	sincerely
ракӀ-ракӀалъ	sincerely
ракӀ бацӀцӀадго	sincerely
кечӀ ахӀизе	sing
кочӀохъан	singer
янгъизаб	single
раса	sink
ле	Sir
сэр	Sir
яц	sister
васасул лъади	sister in law
гӀодов чӀезе	sit
сайт	site
ахӀвал-хӀал	situation
анлъго	six
анцӀила анлъго	sixteen
лъабкъого	sixty
кӀодолъи-гьитӀинлъи	size
ругьунлъи	skill
кӀолеб жо	skills
тӀом	skin
тӀеренаб	skinny
къадараб	skinny
азараб	skinny
хӀалакъаб	skinny
биччазе	skip
юбка	skirt
зоб	sky
лагъ	slave
кьижизе	sleep
кьижизе	sleeping
макьу рекӀараб	sleepy
макьихараб	sleepy
къвал	sleeve
кусочек	slice
бакӀ хисизе	slide
цуйзе	slide
цо чанго	slightly
дагь	slightly
гьайбатаб	slim
чӀурканаб	slim
чергесаб лагаялъул	slim
лага-черх рекъараб	slim
хъищтизе	slip
гъвел	slope
хьибил	slope
цӀекӀлъи	slot
хӀенцав	slow
хьадарго	slowly
гӀодобе биччан	slowly
хӀинцго	slowly
гьитӀинаб	small
гӀакъилаб	smart
махӀ	smell
гьимазе	smile
кӀкӀуй	smoke
тамахаб	smooth
гьакълида цадахъ щибниги кванай	snack
цӀадалхӀама	snail
борохь	snake
тӀинкъи	snap
гӀазу	snow
и	so
берцинлъи	so cute
цъакъ добегӀан	so far
биччизабизе	soak
сапун	soap
мехтичӀев	sober
вигьарав	sober
футболалъул	soccer
гьезул гьоркьоблъиялда бухьараб	social
гӀадамазул гӀумруялда	social
рукӀа-рахъиналъул гӀаммал тарихиял шартӀаз данде гьарурал гӀадамазул цолъи	society
носки	socks
тамахаб	soft
программное обеспечение	software
рухӀ	soil
бичана	sold
бичун лъараб	sold out
бичараб	sold out
солдат	soldier
тӀикъва	sole
къвакӀараб	solid
хӀукму гьаби	solution
хӀукму гьабизе	solve
чанго	some
щив вугониги	somebody
кинали	somehow
цояв	someone
цо щибалиго	something
цо-цо мехалъ	sometimes
гьоркьо-гьоркьоб	sometimes
мех-мехалъ	sometimes
кечӀ	song
кватӀичӀого	soon
разиял	sophisticated
разияв	sophisticated
разияй	sophisticated
Сорани	Sorani
унтарав	sore
унтараб шекъер	sore throat
къварилъи	sorrow
пашманлъи	sorrow
тӀаса лъугьа	Sorry
къокъаб	sort
балагьула букӀана	sought
рухӀ	soul
кӀиабилеб рахъ	soulmate
гьаракь	sound
чурпа	soup
цӀекӀаб	sour
теориялъул тӀоцебесеб аслу	source
юг	south
космос	space
спам	spam
серун ккойзе	span
испанский	Spanish
чӀобогояб	spare
гаргадизе	speak
кӀалъазе	speak
хасаб	special
тайпа	species
хасиятаб	specific
кутакалда асар гьабулеб	spectacular
калам	speech
гаргар	speech
кӀалъай	speech
вуцӀцӀун чӀарав	speechless
кӀалъаларев	speechless
хехлъи	speed
сихӀрудугӀа	spell
сихӀру	spell
хвезабуна	spend
хвезабураб	spent
бухӀараб	spicy
заз	spike
серизабизе	spin
шпинат	spinach
рухӀ	spirit
тузе	spit
цӀакъ берцинаб	splendid
бикьизе	split
хвезе	spoil
хвараб	spoiled
хвезабураб	spoiled
жагъаллъараб	spoiled
жибго жиндасанго	spontaneous
балухъ	spoon
гъуд	spoon
бугьун	spoon
бакӀ	spot
рос	spouse
чӀужу	spouse
лъади	spouse
тӀибитӀизе	spread
их	spring
ункъбокӀон	square
мерхьине	squeeze
осьминог	squid
белка	squirrel
ст	st
къабизе	stab
щулияб	stable
цо хӀалалда чӀараб	stable
гохӀ	stack
гъуни	stack
хӀалтӀухъаби	staff
этап	stage
перен. тӀанкӀ	stain
болъо	stairs
мали	stairs
къадар	stake
хӀуби	stalk
гӀучӀ	stalk
гьитӀинаб тукен	stall
мугьру	stamp
бахъун чӀезе	stand
стандарт	standard
цӀва	star
байбихьизе	start
байбихьи	started
вакъарав	starving
хӀукумат	state
лъазаби	statement
станция	station
статуя	statue
халкъазда гьоркьосеб ихтияралда бугеб хӀал	status
чӀезе	stay
хӀинкъи гьечӀолъиялда вукӀа	stay safe
кидаго гӀадин	steady
бежараб гьан	steak
бикъизе	steal
хӀухьел	steam
чаран	steel
эхебе балагьараб	steep
кьибил	stem
гали	step
тӀил	stick
къвакӀарав	stiff
цоги	still
хеч	sting
бахилав	stingy
барахщарав	stingy
къарумав	stingy
багъаризе	stir
къайи	stock
бикъараб	stolen
бакӀвали	stomach
кванирукъ	stomach
гамачӀ	stone
чӀараб	stood
гӀемераб мех бараб	stood
бакӀу	stool
чӀа	stop
щибниги цӀунизе бараб бакӀ	storage
тукен	store
кутакаб гьуригун чвахунцӀад	storm
тарих	story
батарейка	stove
битӀараб	straight
гӀадатияб	straightforward
ругьунлъизе	strain
хӀикматаб	strange
тамашаяб	strange
гӀажаибаб	strange
лъаларев чи	stranger
стратегия	strategy
сум	straw
солома	straw
хьутӀ	straw
чӀахӀияб гӀодокари	strawberry
кверкъи	strawberry
чӀоло	streak
къезе	stream
биччазе	stream
къватӀ	street
хӀал	strength
стресс	stress
цӀан кӀодо гьабизе	stretch
битӀараб	strict
хӀалтӀи рехун тей	strike
забастовка	strike
чӀваби	string
чӀоло	strip
мухъ	strip
лъураб хӀалалъ церехун ине	strive
цо рахъалдехун ралагьун ине	strive
инсульт	stroke
гучаб	strong
кьабуна	struck
гӀуцӀи	structure
хӀаракат бахъизе	struggle
захӀмалъигун данде чӀваразе	struggling
тӀирарав	stubborn
мекъав	stubborn
тӀирун чӀарав	stubborn
мукӀурлъуларев	stubborn
жиндирабго ккун чӀарав	stubborn
къан хутӀизе	stuck
студент	student
цӀали	study
лъазаби	studying
цӀех-рех гьаби	studying
къайи	stuff
кутакалда гучаб	stunning
цӀакъ кутакаб	stunning
хаган хутӀизарулеб	stunning
кӀудияб асар гьабулеб	stunning
ахӀмакъаб	stupid
гӀантаб	stupid
къагӀида	style
куц	style
ГӀадан чи	subject
мутӀигӀ гьаби	submission
къезе	submit
жо	substance
бижи	substitute
кӀудияб гӀей	substitute
тӀеренаб	subtle
цере тӀезе	succeed
бажари	success
бажари бугеб	successful
гьадинаб	such
гьединав	such as
хахизе	suck
тохлъукье	sudden
нагагьаб	sudden
ракӀалда гьечӀого	suddenly
унтул гӀазаб тӀаде ккезе	suffer
рухӀел бихьи	suffering
гӀазаб-гӀакъуба	suffering
гӀураб	sufficient
гӀезесеб	sufficient
чакар	sugar
тӀаса бищизе рес кьезе	suggest
хал гьабизе	suggest
къасд букӀин	suggestion
ракӀалда букӀин	suggestion
костюм	suit
рекъолеб	suitable
чемодан	suitcase
гӀаммаб къадар	sum
хӀасил	summary
рии	summer
бетӀер	summit
борхалъи	summit
тӀогь	summit
бакъ	sun
воскресенье	sunday
бакъул	sunny
бакъ тӀерхьин	sunset
тӀерхьин	sunset
щинкӀи	sunset
бакъул канлъи	sunshine
цӀакъ лъикӀаб	super
бутӀрул	superior
хӀакимзаби	superior
начальникзаби	superior
нухмалъи гьабулев чи	supervisor
боголиквен	supper
хьезабизе	supply
рекъезабун лъезе	supply
лъезе	supply
тезе	supply
кверчӀвазе	support
ракӀалда букӀине	suppose
кколев	supposed
ракӀчӀей	sure
тӀасияб рахъ	surface
кӀодолъи	surge
гӀемерлъи	surge
цо тӀадкъаялда гьарулел рагъулал ишал	surgery
операция	surgery
фамилия	surname
ракӀалдаго гьечӀеб жо	surprise
ракӀалдаго букӀинчӀеб	surprise
гӀажаиблъи	surprised
амашалъи	surprised
риххун хутӀи	surprised
хӀайранлъи	surprised
хӀикмалъи	surprised
мукӀурлъичӀого вукӀине	surrender
мутӀигӀлъичӀого	surrender
сверун бугеб	surrounding
балагьи	surveillance
цӀех-рех	survey
хвечӀого хутӀизе	survive
щаклъизе	suspect
езавурав	suspended
ч	suspended
божи гьечӀеб	suspicious
гьоркьоб къотӀизе тунгутӀизе	sustain
хвезе тунгутӀизе	sustain
щулалъи	sustainability
къвакӀи	sustainability
хьвагӀолареб	sustainable
щулаго чӀолеб	sustainable
хьвагӀезе	swag
гьендезе	swag
къурчӀизе	swallow
хисизе	swap
вагъизе	swear
семизе	swear
хьандезе	swear
гӀетӀ	sweat
хьухьараб квасул гурде	sweater
лъухьизе	sweep
гьуинаб	sweet
гьуинаб макьу	sweet dreams
гьуинаб жо бокьулев чи	sweet tooth
хирияв	sweetheart
хирияй	sweetheart
лъадал тӀалъиялда гӀисинабго сорой	swell
гьорораб бак	swelling
лъедезе	swim
лъим ххазе	swim
лъим ххай	swimming
лъедей	swimming
кӀибикӀизе	swing
синабулеб жо	switch
лъадал	swollen
хвалчен	sword
ишара	symbol
ракӀунти	sympathy
гурхӀел	sympathy
гӀаламат къватӀибе загьирлъи	symptoms
низам	system
стол	table
кквезе	tackle
ккун чӀезе	tackle
дамгъа	tag
рачӀ	tail
босе	take
къватӀибе квен	take away
милат	take care
бахъизе	take off
босарав	taken
кӀалъай	talk
гӀемер кӀалъазе бокьулев	talkative
халатаб	tall
крант	tap
чалу	tape
гӀебаб чӀоло	tape
ишан	target
гӀуж	target
хӀалтӀи	task
тату	taste
тӀагӀам бугеб	tasty
тату бугеб	tasty
малъана	taught
чай	tea
малъизе	teach
мугӀалим	teacher
буюрухъ	team
магӀу	tear
магӀу	tears
валъаргъине	tease
технологии	technology
цаби	teeth
абизе	tell
абе диде	tell me
гӀамал	temper
температура	temperature
кӀалгӀа	temple
болжал цӀан	temporary
заманалъ	temporary
дагьаб мехалъ	temporary
анцӀго	ten
анцӀ-азарго	ten thousand
кибниги гӀумру гьабулев чи	tenant
мурад	tend
къасд	tend
мурад	tendency
къасд	tendency
тамахго	tender
хӀеренго	tender
цӀараб	tense
дугъдараб	tense
дугъдазаби	tension
хӀалуцинаби	tension
чадир	tent
хӀалбихьиялъе гьабураб	tentative
цӀараб мех	term
болжал	term
шартӀ	terms
ракӀ гъанцӀизабулеб	terrible
гӀасияб	terrible
ракӀ хӀинкъизабулеб	terrible
ракӀ зунизабулеб	terrible
кутакалда гучаб	terrific
цӀакъ кутакаб	terrific
ракь	territory
бакӀ	territory
тест	test
текст	text
цинги	than
баркала	thank
баркала	thank you
баркала дур сабруялъухъ нижеца цӀех-рахи гьабулеб заманаялда	Thank you for your patience while we investigate shipment
баркала дуе кӀудияб	thank you so much
кӀудияб баркала дуе	thank you very much
баркала	thanks
баркала нтжер приложение хӀалтӀизе гьабуралъухъ	Thanks for using our app
щиб	that
гьедин батани	that is
гьеб лъикӀ буго	that's good
зе	the
бикъи	theft
дозул	their
дол	them
тема	theme
жинцго жалго	themselves
цинги	then
теория	theory
доба	there
буго	there are
гьаниб	there is
гьдинлъидал	therefore
дол	these
гъол	they
гъол руго	they are
къарияб	thick
бицатаб	thick
цӀогьор	thief
мачӀчӀ	thigh
Азараб	thin
къайи	thing
жо	thing
къайи	things
ургъизе	think
лъабабилеб	third
къечей	thirsty
анцӀила лъабго	thirteen
лъеберго	thirty
гьаб	this
гьаб буго	this is
мухӀканаб	thorough
рагӀаракьанде щвараб	thorough
мухӀканго	thoroughly
камилго	thoroughly
рагӀаракьанде щун	thoroughly
тӀад чӀун	thoroughly
дозул	those
амма	though
пикра	thought
тӀад лъикӀ ургъулев	thoughtful
ургъи	thoughts
азарго	thousand
кун	thread
хӀинкъи	threat
хӀинкъи кьей	threat
хӀинкъизабизе	threaten
лъабго	three
кӀалтӀу	threshold
бихха-хочараб	thrilled
рахӀат хвараб	thrilled
цере тӀезе	thrive
щекъер	throat
гьоркьосан	through
гьоркьосан	throughout
речӀчӀизе	throw
кӀудияб килищ	thumb
зоб гъугъай	thunder
хамиз къо	Thursday
гьединлъидал	thus
ишара	tick
эхеде бахин	tide
мухӀканлъи	tidy
дуруслъи	tidy
галстук	tie
цӀиркъ	tiger
дугъдараб	tight
Тигринья	Tigrinya
заман	time
хӀинкъа-къарав	timid
нахъе къан чӀолев	timid
гьитӀинаб	tiny
чайдул гӀарац	tip
бигьалъи	tips
шина	tire
свакана	tired
квералрацӀцӀ	tissue
титул	title
хӀурматияб цӀар	title
в	to
букӀине	to be
лъилниги хӀурматалда гьабулеб кӀалъай	toast
лълъар борхулаго	toast
жакъа	today
илъанхъизу жубараб лъимер	toddler
хӀатӀазул килщал	toes
цадахъ	together
туалет	toilet
абуна	told
яхӀ гьабизе кӀвей	tolerance
къохӀехьей	tolerance
хӀехьезе	tolerate
сабру гьабизе	tolerate
яхӀ гьабизе	tolerate
помидор	tomato
метер	tomorrow
мацӀ	tongue
жакъа къасе	tonight
гьейги	too
гьевги	too
гьебги	too
дунги	too
мунги	too
босизе	took
тӀагӀел	tool
тӀагӀел	tools
гӀус	tooth
ца	tooth
тӀоцебесеб	top
бищунго лъикӀаб	top
тема	topic
бихъ-бихъараб	torn
тӀутӀураб	torn
гӀазаб кьей	torture
сундуего гӀаммаб	total
киназего	total
гӀахьалаб	total
гъвазе	touch
захӀматго	tough
цо свери	tour
тур	tour
к	toward
к	towards
гьумербацӀцӀ	towel
пригородалъул	town
рагӀалда бугеб	town
шагьаралда аскӀоб	town
загьруяб	toxic
лъакӀ	trace
хал кквезе	track
даран-базар	trade
гӀадат	tradition
гӀадатлъун билълъараб	traditional
трафик	traffic
бехъерхъизе	trail
поезд	train
хӀадурлъизе	training
хӀучч	trait
мухъ	trait
хаслъи	traits
батӀалъи	traits
трансфер	transfer
переход	transition
переводить	translate
гъорлъан канлъи бихьулеб	transparent
къайи ва гӀадамал раччулебщинаб жо	transport
гӀадамал раччулебщинаб жо	transportation
гьин	trap
къотен	trap
къор	trap
гудур	trap
чороклъи	trash
рищни	trash
тунки	trauma
жагъаллъи	trauma
беки	trauma
сапар бухьине	travel
дуниял сверизе ине	travel
тепси	tray
тӀибитӀараб гъадаро	tray
пандуз	tray
хазина	treasure
дару гьаби	treat
дару	treatment
гъветӀ	tree
цӀакъ кӀудияб	tremendous
мурад	trend
къасд	trend
суд	trial
махсараде кквезе	trick
рекӀкӀ гьабизе	trick
гуккизе	trick
свакарав	tried
багъаризабулеб	trigger
къокъ гьабизе	trim
сапар бухьине	trip
дуниял сверизе ине	trip
рагьизе кколеб теориялъулаб яги практикияб суал	trouble
тӀажу	trousers
грузовик	truck
битӀараб жо	true
рохти	trunk
божизе	trust
битӀараб жо	truth
къасд гьабизе	try
хӀал бихьизе	try
жигар бахъизе	try
Тцонга	Tsonga
рогӀоро	tube
труба	tube
талат  къо	Tuesday
лъай кьей	tuition
цӀализари	tuition
турция	turkey
куркума	turmeric
серизе	turn
щурункъверкъ	turtle
цӀалулъ нахъа хутӀараб лъимадуе кумек гьабулев	tutor
анцӀила кӀиго	twelve
къого	twenty
двадцать один	twenty-one
Тви	Twi
кӀицӀул	twice
кьуризабизе	twist
кьуризе	twist
хенезабизе	twist
сверизе	twist
сверизабизе	twist
кӀиго	two
тайпа	type
цого тайпаялъул	typical
сурукъаб	ugly
ахирияб	ultimate
ахирисеб	ultimate
чадир	umbrella
кувурев	unable
имгӀал	uncle
лъавудаса арав	unconscious
гъоркь	under
тӀину	underneath
сан гьавичӀев	underrated
бичӀине	understand
биччана	understood
талихӀкъини	unfortunately
ретӀел	uniform
нагагь гурони букӀунареб	unique
цойилаб	unit
цо	unit
университет	university
щибали лъалареб	unknown
гурони	unless
хутӀизегӀан	unless
до	until
гӀадатияб гуреб	unusual
тӀад	up
ножоц бище	up to you
цӀигьабизе	update
цӀилъизаби	upgrade
тӀасан	upon
къаридго	upset
шагьаралъул(аб)	urban
гъира базабизе	urge
нахъ тӀамун тезе бегьулареб	urgent
хехаб	urgent
хӀалакараб	urgent
нахъбахъулареб	urgent
гӀедегӀараб	urgent
ниж	us
хӀалтӀизабизе	use
хӀалтӀизабураб	used
хӀалтӀизабулеб	useful
пайда гьечӀеб	useless
ругьунаб	usual
гӀемерисеб мехалъ	usually
пайдаяб	utility
пайда бугеб	utility
хайир бугеб	utility
мунпагӀат бугеб	utility
каникулал	vacation
бацӀцӀин	vaccination
вакцина	vaccine
вакуум	vacuum
бичӀчӀулареб	vague
тӀокӀаб	valid
расалъи	valley
жаниблъи	valley
гӀурумухъ	valley
къиматаб	valuable
къимат гьабизе	value
релълъинчӀеб жоялъул гӀемерлъи	variety
батӀалъи	variety
батӀи-батӀияб	various
батӀалъи букӀине	vary
ваза	vase
кӀудияб	vast
овощ	vegetable
овощал	vegetables
транспорт	vehicle
вичарухъан	vendor
загьру	venom
хӀинкъи бугеб хӀалбихьи	venture
букӀине бугеб бакӀ	venue
хӀал бихьизе	verify
гӀемерал рахъал жанире рачунеб	versatile
версия	version
тӀаса гъоркье битӀараб	vertical
цӀакъ	very
кутакалда	very
кигӀан лъикӀ	very good
гама	vessel
кумекгун	via
энергетика	vibe
энергетика	vibes
рахӀму гьечӀеб	vicious
гурхӀел гьечӀеб	vicious
къурбанлъун ккарав	victim
къурбан	victim
видео	video
къватӀисеб сурат	view
сипат	view
росу	village
хӀарамзада	villain
квешлъи гьабулев чи	villain
къанцӀа	vinegar
винтаж	vintage
гӀакъуба	violence
зулму	violence
хӀал	violence
гурхӀел гьечӀев	violent
машгьурав	viral
васлъи хвечӀев	virgin
виртуальный	virtual
лъикӀаб рахъ	virtue
канлъи	vision
берзул нур	vision
бихьи	vision
канлъи бихьи	vision
щвезе	visit
берзулаб	visual
гӀумруялъе чара гьечӀеб	vital
гвангъараб	vivid
рагӀабазул нахъретел	vocabulary
гьаракь	voice
чӀобоголъи	void
объем	volume
кумекчи	volunteer
лагӀизе бачӀин	vomit
лагӀи	vomit
загӀипаб	vulnerable
хӀалтӀухъ мухь	wage
хӀалтӀухъ мухь	wages
Рачелкъай	waist
чӀа	wait
официант	waiter
квен кьолев чи	waiter
балагьун чӀезе	waiting
ккезабизе	wake
лъугьинабизе	wake
багъаризабизе	wake
бахъизабизе	wake
бижизабизе	wake
рахъине	wake up
йахъине	wake up
вахъине	wake up
илъанхъизе	walk
тира-сверизе илъанхъун	walking
къед	wall
кошелек	wallet
беччизе лъугьине	wander
бокьун буго	wanna
бокьун буго	want
бокьун букӀана	wanted
рагъ	war
общественниял рукъзабахъ рачӀарал гӀадамазул пальто	wardrobe
гардероб	wardrobe
тӀагъур ва ц. цӀунулеб хасаб рукъ	wardrobe
склад	warehouse
хин	warm
цебеккунго лъазаби	warn
цебеккунго лъазаби	warning
рагъухъан	warrior
солдат	warrior
аскарияв	warrior
ваз	was
чуризе	wash
хвезабизе	waste
балагьизе	watch
лъин	water
хъарпуз	watermelon
карачел	wave
нух	way
ниж	we
ниж	we are
нижеда кӀола	we can
тамахав	weak
кутак гьечӀолъи	weakness
загӀиплъи	weakness
хӀал гьечӀолъи	weakness
бечелъи	wealth
бечедаб	wealthy
рес бугеб	wealthy
ретӀизе	wear
хӀал дагьлъизабулеб	wearing
чӀалгӀинабулеб	wearing
рухӀ лъугӀизабулеб	wearing
бизараб	wearing
чӀамучӀаб	wearing
сваказабулеб	wearing
гьава-бакъ	weather
ригьин	wedding
арбагӀ къо	Wednesday
чӀар	weed
кутак гьечӀолъи	week
загӀиплъи	week
хӀал гьечӀолъи	week
выходные	weekend
бакӀлъи	weight
тамашаб	weird
лъик вусаравӀйюсарай	welcome
рес буголъи	welfare
буголъи	welfare
бечелъи	welfare
ну	Well
бахӀарчи	well done
битӀизе	went
вэ	were
бакътӀерхь	west
бакътӀерхьул рахъ	west
биччараб	wet
кит	whale
щиб я	what
дур щиб бугеб	what about you
мун щабула вугевӀйигей	what are you doing
мун щабула гьанже	what are you doing now
щанчи мун щиж гьабуле вугев	what are you doing right now
мун щижо гьабула вуге	what do you do
дуца гӀарац кин гьабулеб	what do you do for a living
мун щибин	what do you mean
дуе бокьун бугеб щиб?	what do you want
щиб ккараб	what happened
щиб лъугьараб	what happened
гьаб щиб	what is
гьеб щиб	what is this
мун щивлъун хӀалтӀула вугев	what is your job
дуда цӀар щиб	what is your name
щибула вуге	what's up
дуда цӀар щиб	what's your name
щиб бугонини	whatever
ролъ	wheat
милик	wheel
чарх	wheel
гьакибер	wheel
гьоко	wheel
кида	when
кид бокьаниги	whenever
киб	where
мун кив вуге	where are you
дун киса	where are you from
мун хӀанчи кий йигей	where are you now
мун хӀанчи кив вугев	where are you now
мун кив яшав гьабун вугев	where do you live
кибуге	where is
доб мехалъ	whereas
гьеб мехалъ	whereas
гъоб мехалъ	whereas
кин бугонини	whether
кинаб	which
гьабсагӀат	while
щурщуди	whisper
гьиштӀи	whistle
хъахӀаб	white
щал	who
мун щив	who are you
щив	who is
гьев щив?	who is this
сахабго	whole
лъие	whom
лъил	whose
сундул	whose
щай	why
щай гуре?	why not
хьвада – чӀвадиялъул тӀалабазда данде кколареб	wicked
адаб-хъатир гьечӀеб	wicked
къабихӀаб	wicked
гӀатӀидаб	wide
гӀебаб	wide
къоролай	widow
гӀебаб	width
чӀужу	wife
гӀалхулаб	wild
вил	will
бокьунбатани	willing
бергьине	win
гьури	wind
горду	window
гьоролаб	windy
чагъир	wine
хасел	winter
баццине	wipe
маххул квар	wire
бичӀчӀи буголъи	wisdom
гӀакълу	wisdom
гӀакъиллъи	wisdom
гӀакъилав	wise
гӀакъилай	wise
гӀакъилаб	wise
анищ	wish
мурад	wish
къасд	wish
гьарула нужее кинабго лъикъаб	wish you all the best
хъартай	witch
с	with
нахъе ахӀизе	withdraw
тасса бахъи	withdrawal
гьоркьоб	within
гьечӀого	without
нугӀ	witness
бегӀераб	witty
цӀодораб	witty
бацӀ	wolf
чӀужу	woman
чӀужугӀадан	woman
чӀужугӀадан	women
бергьана	won
букӀине гьечӀо	won't
гӀажаибго	wonder
гьайбатаб	wonderful
хӀайранлъизарулеб	wonderful
гъветӀ	wood
цӀира	wool
квас	wool
ябагъи	wool
дуниял	word
рагӀаби	words
хӀалтӀи	work
тренировка	work out
ругьун гьави	work out
хӀалтӀулев	working
дуниял	world
хӀапара	worm
борохь	worm
хӀутӀ	worm
къвекӀ	worm
хохораб	worn
басралъараб	worn
чӀикӀараб	worn
бихха-хочараб	worried
рахӀат хвараб	worried
ургъел гьабизе	worry
дагьабги квешаб	worse
бетӀер къули	worship
цӀакъго квешаб	worst
къимат	worth
стоило того	worth it
кколани	worth it
мустахӀикъаб	worthy
рекъараб	worthy
вуд	would
лъукъизе	wound
ругъун лъезе	wound
ваув	Wow
гуризе	wrap
ццин	wrath
кверзул рищи	wrist
хъвазе	write
гьаниба хъвай	Write here
кагъат	writing
хъвана	written
мекъаб	wrong
хъвана	wrote
гьитӀинаб байдан	yard
гьакӀкӀадизе	yawn
у	Yeah
сон	year
сонал	years
речче	yeast
мач	yeast
цӀекӀлъун бахъин	yeast
цӀекӀлъи	yeast
ахӀдезе	yell
чӀичӀидизе	yell
тӀугьилаб	yellow
у	Yes
у,лъимер	yes baby
у хирияв	yes dear
у,хирияй	yes honey
у дир рокьи	yes my love
у гьай-гьай	yes of course
сон	yesterday
еще	yet
гӀалах	yield
авлахъ	yield
мун	you
мун	you are
мун берцинав вуго	you are beautiful
дур берцинлъи	you are so beautiful
ю а велком	you are welcome
дуда кӀола	you can
дуда лъала	You know
мунги	you too
дур хӀалалалъе	you're welcome
гӀолохъанав	young
дур	your
мун вачӀине вокьарав вуго	your welcome
дуцго	yourself
мунго	yourself
гӀолохъанлъи	youth
пожалуйста	you’re welcome
тату бугеб	yummy
тӀагӀам гьечӀеб	yummy
ноль	zero
