شوية	a little
هلبا	a lot
هلبا من	a lot of
يسيّب	abandon
يهجر	abandon
مهجور	abandoned
يلتزم	abide
قدرة	ability
قادر	able
تقريبًا	about
بخصوص	about
حوالي	about
فوق	above
في الخارج	abroad
غياب	absence
غايب	absent
قطعا	absolutely
يمتص	absorb
ملخص	abstract
سخيف	absurd
كثرة	abundance
مهجور	abundant
سوء استعمال	abuse
تعسف	abuse
حركة	accent
لهجة	accent
نبرة	accent
يقبل	accept
نفاذ	access
يصل	access
ينفذ إلى	access
وصول	access
حادث	accident
سكن	accommodation
إقامة	accommodation
ينجز	accomplish
أنجز	accomplished
منجز	accomplished
حسب	according
حساب	account
دقة	accuracy
دقيق	accurate
متهم	accused
اتهم	accused
وجع	ache
يتوجع	ache
يحقق	achieve
إنجازات	achievement
يعترف	acknowledge
يقر	acknowledge
معارف	acquaintance
معرفة	acquaintance
يكتسب	acquire
يحصّل	acquire
اكتسب	acquired
مكتسب	acquired
اكتساب	acquisition
يعبر	across
يمثل	act
يخدم	act
فعل	action
إجراء	action
ناشط	active
نشاطات	activities
نشاط	activity
ممثل	actor
حالي	actual
واقعي	actual
في الحقيقة	actually
حاد	acute
عنده نظرة ثاقبة	acute
يتأقلم	adapt
يزيد	add
مدمن	addicted
زيادة	addition
إضافة	addition
إضافي	additional
عنوان	address
خطاب	address
كافي	adequate
مناسب	adequate
المتجاور	adjacent
القريب	adjacent
صفة	adjective
يعدّل	adjust
يعظّم	admire
يعجب ب	admire
يقبل	admit
يعترف	admit
يتبنى	adopt
محبوب	adorable
تقدم	advance
سلفة	advance
متطور	advanced
متقدم	advanced
ميزة	advantage
مغامرة	adventure
ظرف	adverb
حال	adverb
إعلان	advertisement
يعلن	advertising
نصيحة	advice
نصيحة	advise
محامي	advocate
يدافع على	advocate
يترافع على	advocate
جمالي	aesthetic
شأن	affair
قضية	affair
خيانة زوجية	affair
يأثر	affect
عاطفة	affection
يقدر يدفعه	afford
يعطي	afford
بسعر معقول	affordable
مقدور عليه	affordable
يخاف	afraid
بعد	after
بعد الظهر	afternoon
بعدها طول	afterwards
مرة ثانية	again
ضد	against
عمر	age
وكالة	agency
عميل	agent
وكيل	agent
عدواني	aggressive
عنيف	aggressive
رشيق	agile
فات	ago
من	ago
يتفق	agree
يوافق	agree
اتفاقية	agreement
زراعة	agriculture
أمام	ahead
مساعدة	aid
هدف	aim
هواء	air
مطار	airport
ممر	aisle
منبّه	alarm
إنذار	alarm
الكحول	alcohol
منتبه	alert
ينبّه	alert
حي	alive
كل	all
باهي تمام	all right
كل التوفيق	all the best
يسمح	allow
مسموح	allowed
على الأغلب	almost
بروحه	alone
على امتداد	along
على طول	along
سلفا	already
تمام	Alright
حتى	also
بديل	alternative
رغم أن	although
ديما	always
أنا	am
مدهش	amazing
غامض	ambiguous
طموح	ambition
طموح	ambitious
يعدّل	amend
وسط	amid
من بين	among
بيننا	among us
وسطنا	among us
كمية	amount
قيمة	amount
ممتع	amusing
يحلل	analysis
جدود	ancestors
مرساة	anchor
قديم	ancient
و	and
وأنت	and you
ملاك	angel
غضب	anger
زاوية	angle
غاضب	angry
حيوان	animal
كاحل	ankle
ذكرى سنوية	anniversary
إعلان	announcement
يزعج	annoy
متضايق	annoyed
يضايق	annoying
سنوي	annual
مجهول	anonymous
آخر	another
يجاوب	answer
إجابة	answer
يترقب	anticipate
يتوقع	anticipate
قلق	anxiety
قلق	anxious
أي	any
أي شيء ثاني	anymore
أي واحد	anyone
أي شيء	anything
على أي حال	anyway
على كل حال	anyways
بعيد	apart
منعزل	apart
منفصل	apart
شقة	apartment
يعتذر	apologize
واضح	apparent
الواضح إن	apparently
مطالبة	appeal
استئناف	appeal
يبان	appear
مظهر	appearance
بان	appeared
شهية	appetite
تفاحة	apple
تطبيق	application
طلب	application
يقدّم طلب	apply
موعد	appointment
يقدّر	appreciate
تقدير	appreciation
يقرّب	approach
طريقة	approach
مناسب	appropriate
اعتماد	approval
إثبات	approval
يعتمد	approve
يوافق	approve
يعتمد	approved
يثبت	approved
تقريبا	approximately
أبريل	april
اعتبطاي	arbitrary
مهندس معماري	architect
هندسة معمارية	architecture
أرشيف	archive
تكون	are
يكون	are
أنت هكي؟	are you
أنت مشغول؟	are you busy
أنت متزوج؟	are you married
أنت متزوج ولا أعزب	are you married or single
أنت قاعد غادي؟	Are you still there?
أنت غادي؟	are you there
منطقة	area
مساحة	area
يجادل	argue
حجّة	argument
نقاش	argument
ينوض	arise
يصير	arise
ذراع	arm
جماعة مسلحة	army
حول	around
حوالي	around
يرتب	arrange
تجهيزات	arrangement
ترتيبات	arrangement
وصول	arrival
يوصل	arrive
وصل	arrived
متكبر	arrogant
سهم	arrow
فن	art
مقال	article
اصطناعي	artificial
فنان	artist
زي	as
ما دام	as long as
حتى	as well
إلى جانب	as well as
رماد	ash
متحشّم	ashamed
يسأل	ask
سأل	asked
راقد	asleep
جانب	aspect
مظهر	aspect
الأسامية	Assamese
هجوم	assault
تجمع	assembly
جمعية	assembly
جازم	assertive
أكيد	assertive
يقيم	assess
تقييم	assessment
أصل	asset
أصول	assets
تعيين	assign
تكليف	assignment
مهمة	assignment
مساعدة	assist
مساعد	assistant
شريك	associate
زميل	associate
مرتبط بـ	associated
مؤسسة	association
يفترض	assume
افتراض	assumption
في	at
على الأقل	at least
كلي	ate
رياضي	athlete
يرفق	attach
مرفق	attached
مرفق	attachment
يهاجم	attack
يسعى	attempt
يحاول	attempt
يحضر	attend
حضور	attendance
انتباه	attention
سلوك	attitude
يجذب	attract
يشد الانتباه	attract
جاذبية	attraction
جذاب	attractive
ميزة	attribute
يوصف	attribute
جمهور	audience
أغسطس	august
عمة	aunt
خالة	aunt
خالتي	aunty
عمتي	aunty
أصلي	authentic
كاتب	author
سلطة	authority
خريف	autumn
متوفّر	available
متوسط	average
يتفادي	avoid
فايق	awake
مكافأة	award
جائزة	award
واعي	aware
وعي	awareness
إدراك	awareness
بعيد	away
رائع	awesome
شنيع	awful
صعب	awkward
محرج	awkward
الأيامارا	Aymara
طفل	baby
أعزب	bachelor
بكالوريوس	bachelor
خلف	back
ظهر	back
خلفية	background
سيء	bad
شنطة	bag
طُعم	bait
يطيّب الخبزة	bake
كوشة	bakery
بيكينج صودا	baking soda
رصيد	balance
توازن	balance
كورة	ball
بامبارا	Bambara
موز	banana
شريط	band
فرقة	band
يسكّر بقوة	bang
مصرف	bank
شريط	bar
بار	bar
بالسيف	barely
صفقة	bargain
يقشّر	bark
نباح	bark
ينبح	bark
قشرة	bark
شعير	barley
فاصل	barrier
حاجز	barrier
قاعدة	base
مبني على	based
قاعدة	basement
أساسي	basic
أساسي	basically
حبق	basil
نذل	bastard
دفعة	batch
بانيو	bath
حمام	bathroom
بطارية	battery
حرب	battle
خليج	bay
تكون	be
يكون	be
انتبه	be careful
رد بالك	be careful
شط	beach
شعاع	beam
عارضة	beam
فول	beans
فاصولياء	beans
يتحمل	bear
يقيم	bear
دُب	bear
لحية	beard
يتحمّل	bearing
وحش	beast
يغلب	beat
يضرب	beat
جميل	beautiful
جمال	beauty
بدي	became
ولّى	became
لأن	because
يولّي	become
سرير	bed
دار نوم	bedroom
نحلة	bee
لحم بقر	beef
كان	been
بيرة	beer
قبل	before
بدي	began
يبدأ	begin
بداية	beginning
نيابة عن	behalf
يتصرف	behave
سلوك	behavior
سلوك	behaviour
وراء	behind
إن يكون	being
اعتقاد	belief
إيمان	belief
يصدّق	believe
بطن	belly
ينتمي ل	belong
محبوب	beloved
تحت	below
سبتة	belt
كرسي طويل	bench
يعوّج	bend
تحت	beneath
فائدة	benefit
مصلحة	benefit
فوائد	benefits
بجانب	beside
زيد على هذا	besides
أفضل	best
بالتوفيق	best of luck
تحياتي	best regards
أفضل	better
بين	between
مشروب	beverage
خلف	beyond
بوجبوري	Bhojpuri
تحيز	bias
متحيز	biased
دراجة	bicycle
عطاء	bid
مناقصة	bid
كبير	big
دراجة	bike
موطو	bike
فاتورة	bill
مشروع قانون	bill
ربط	bind
طير	bird
عيد ميلاد	birthday
يعض	bit
عضة	bite
لدغة	bite
ساخر	bitter
مر	bitter
أسود	black
شفرة	blade
موس	blade
يلوم	blame
فارغ	blank
بطانية	blanket
انفجار	blast
مبيّض	bleach
يخلّط	blend
خليط	blend
بركة	bless
مبارك	blessed
كفيف	blind
النعيم	bliss
كتلة	block
حاجز	block
دم	blood
يزدهر	bloom
ينفخ	blow
أزرق	blue
متبلّد	blunt
مش حاد	blunt
لوحة	board
سبورة	board
قارب	boat
جسم	body
يسلق	boil
يغلي	boil
عريض	bold
علاقة	bond
سند مالي	bond
عظم	bone
كتاب	book
يحجز	book
يحفّز	boost
يرفع	boost
داعم	booster
بوت	boot
بوتات	boots
حدود	border
تجويف	bore
ممل	bored
ممل	boring
انولد	born
يتسلّف	borrow
يستعير	borrow
رئيس	boss
الزوز	both
يضايق	bother
شيشة	bottle
تحت	bottom
شري	bought
ضربة فجأة	bounce
يرجع	bounce
مقيد	bound
حدود	boundaries
قوس	bow
ينحني	bow
صونية	bowl
صندوق	box
ولد	boy
حبيب	boyfriend
حديدة	bracelet
عقل	brain
دماغ	brain
فرع	branch
ماركة	brand
شجاع	brave
يخالف	breach
مخالفة	breach
خبزة	bread
يكسّر	break
فطور	breakfast
صدر	breast
يتنفس	breath
يتنفس	breathe
تكاثر	breed
قرميد	brick
عروسة	bride
جسر	bridge
كوبري	bridge
مختصر	brief
لامع	bright
مضيء	bright
عبقري	brilliant
يجيب	bring
خوي	bro
واسع	broad
بث	broadcast
كسر	broke
مكسور	broken
مكنسة	broom
أخ	brother
نسيب	brother in law
سلف	brother in law
جاب	brought
قهوي	brown
فرشة	brush
سطل	bucket
صاحبي	buddy
ميزانية	budget
حشرة البق	bug
يبني	build
مبنى	building
بني	built
مبني	built
حجم كبير	bulk
ثور	bull
يتنمر	bully
كدمة	bump
عنقود	bunch
باقة	bunch
حزمة	bundle
حرج	burden
حمل	burden
عبء	burden
يدفن	buried
يحرق	burn
يتفجّر	burst
دفن	bury
باص	bus
شجرة صغيرة	bush
أعمال تجارية	business
صدر المرأة	bust
يكسّر	bust
إفلاس	bust
مشغول	busy
لكن	but
زبدة	butter
فراشة	butterfly
بطمة	button
يشري	buy
بواسطة	by
على فكرة	by the way
باي	bye
كرنب	cabbage
مجلس وزراء	cabinet
دولاب	cabinet
قفص	cage
كيكة	cake
عجل	calf
يتصل	call
دعوة	call
يدعو	call
اتصال	call
اتصل بيا	call me
نادى	called
اتّصل	called
هاديء	calm
جي	came
حملة	campaign
ممكن	can
يقدر	can
ما يقدرش	can't
يلغي	Cancel
سرطان	cancer
قادر	capable
سعة	capacity
قدرة	capacity
عاصمة	capital
رأسمال	capital
عنوان صورة أو منشور	caption
يلتقط صورة	capture
يقبض على	capture
سيارة	car
وظيفة	career
حريص	careful
بحرص	carefully
مش مهتم	careless
مهمل	careless
يهتم	caring
نجار	carpenter
سجادة	carpet
سفناري	carrot
يحمل	carry
يقيم	carry on
يستمر	carry on
ينفّذ	carry out
حالة	case
قضية	case
نقدي	cash
يرمي	cast
فريق العمل	cast
قلعة	castle
مش رسمي	casual
قطوس	cat
يشد	catch
فئة	category
المواشي	cattle
شد	caught
يتسبب	cause
سبب	cause
حذر	caution
حذر	cautious
كهف	cave
يوقّف	cease
سقف	ceiling
يحتفل	celebrate
خلية	cell
مركز	center
قرن	century
كورنفلكس	cereal
حفلة	ceremony
متأكد	certain
أكيد	certainly
شهادة	certificate
سلسلة	chain
كرسي	chair
تحدي	challenge
فرصة	chance
صدفة	chance
يغير	change
فوضى	chaos
شخصية	character
مميزات	characteristics
سمات	characteristics
يشحن	charge
صدقة	charity
ساحر	charming
جدول	chart
مخطط بياني	chart
يدوّر	chase
يلحق	chase
دردشة	chat
رخيص	cheap
يزور	cheat
يغش	cheat
غش	cheating
يفحص	check
يختبر	check
خد	cheek
تشجيع	cheer
تهليل	cheer
مرح	cheerful
نخبكم	cheers
هتافات	cheers
جبنة	cheese
كيمياء	chemistry
يهتم بحب	cherish
يتعلّق	cherish
شطرنج	chess
صدر	chest
يمضغ	chew
دجاج	chicken
رئيس	chief
عيّل	child
طفولة	childhood
صغار	children
قشعريرة	chill
برد	chill
مدخنات	chimneys
لحية	chin
شوكولاتة	chocolate
اختيار	choice
يختار	choose
يقطّع	chop
واجبات منزلية	chores
سمين	chubby
كنيسة	church
قرفة	cinnamon
دائرة	circle
ظروف	circumstances
مواطن	citizen
مدينة	city
يطالب	claim
يوضح	clarify
فصل	class
درجة	class
طين	clay
نظيف	clean
واضح	clear
موظف تسجيل	clerk
ذكي	clever
زبون	client
جرف	cliff
طقس	climate
يتسلق	climb
لزج	clingy
ساعة	clock
قريب	close
يسكّر	close
دولاب	closet
حوايج	cloth
حوايج	clothes
سحابة	cloud
مغيّم	cloudy
مهرج	clown
فكرة	clue
دليل	clue
مرتبك	clumsy
تجمّع	cluster
عنقود	cluster
مدرب	coach
فحم	coal
ساحل	coast
طبقة	coat
كبوط	coat
قهوة	coffee
ذهني	cognitive
مصادفة	coincidence
توافق	coincidence
مصقّع	cold
ينهار	collapse
رقبة الحوايج	collar
طوق	collar
زميل	colleague
زملاء	colleagues
يجمع	collect
مجموعة	collection
كلية	college
لون	color
الأفكار الخضراء اللي بلا لون ترقد متكنطية	colorless green ideas slept furiously
لون	colour
خانة	column
عمود	column
مشط	comb
مزيج	combination
مركب	combination
يجمع	combine
تعالى	come
تعال هنا	come here
تعالى	come on
هيا	come on
مريح	comfort
مريح	comfortable
جاي	coming
قريبًا	coming soon
أمر	command
تعليق	comment
تجاري	commercial
لجنة	commission
يغلط	commit
التزام	commitment
ملتزم	committed
سلعة	commodity
شائع	common
مشترك	common
يتصل	communicate
يتواصل	communicate
اتصال	communication
مجتمع	community
يخفف العقوبة	commute
يسافر كل يوم لعمله	commute
مرافق	companion
صاحب	companion
شركة	company
يقارن	compare
مقارنة	comparison
عطف	compassion
حنيّن	compassionate
متطابق	compatible
ينافس	compete
مختص	competent
منافسة	competition
تنافسي	competitive
منافس	competitive
يشكي	complain
شكوى	complaint
تكملة	complement
يكمل	complete
كليًا	completely
معقد	complex
مطاوعة	compliance
معقد	complicated
شكر	compliment
مجاملة	compliment
يطيع	comply
تركيب	composition
إنشاء	composition
مركب	compound
فهم	comprehension
شامل	comprehensive
يساوم	compromise
مساومة	compromise
إجباري	compulsory
كومبيوتر	computer
يركّز	concentrate
مفهوم	concept
يهتم	concern
اهتمام	concern
المعني	concerned
قلِق	concerned
حفلة موسيقية	concert
خلاصة	conclusion
نتيجة	conclusion
مادي	concrete
شمنت	concrete
حالة	condition
شرط	condition
شروط	conditions
سيرة	conduct
سلوك	conduct
مؤتمر	conference
يعترف	confess
ثقة	confidence
واثق	confident
يؤكد	confirm
عركة	conflict
حاير	confused
ارتباك	confusion
مبارك	congrats
التهنئة	congratulation
مبروك	congratulations
اقتران	conjunction
يربط	connect
يوصّل	connect
يسطو	conquer
يهزم	conquer
واعي	conscious
الوعي	consciousness
موافقة	consent
قبول	consent
عواقب	consequences
نتائج	consequences
محادثة	conservation
محافظ	conservative
يعتبر	consider
يعتبر	considered
يحتوى على	consist
يتكون من	consist
ثبات	consistency
تناسق	consistency
متناسق	consistent
ثابت	consistent
ثابت	constant
باستمرار	constantly
إمساك	constipation
بناء	construction
تركيبة	construction
يستهلك	consume
استهلاك	consumption
يتصل	contact
اتصال	contact
معدي	contagious
فيه	contain
يحتوي	contain
يشمل	contains
يحتوي	contains
معاصر	contemporary
احتقار	contempt
محتوى	content
منافسة	contest
سياق	context
قارّة	continent
يستمر	continue
يواصل	continue
عقد	contract
يتعاقد	contract
مقارنة بـ	contrast
اختلاف	contrast
يشارك	contribute
يساهم	contribute
مساهمة	contribution
مشاركة	contribution
سيطرة	control
تحكم	control
جدلي	controversial
مناسب	convenience
وقت مناسب	convenience
مريح	convenient
مناسب	convenient
محادثة	conversation
يتحوّل	convert
تحول	convert
يوصّل	convey
يقنّع	convince
اقتنع	convinced
التطييب	cook
يطيّب	cook
تطييب	cooking
مصقّع	cool
حلو	cool
بارد	cool
تعاون	cooperation
يتغلّب	cope
نحاس	copper
جوهر	core
لب	core
ذرة	corn
سبول	corn
زاوية	corner
صحيح	correct
تكلفة	cost
زي	costume
كوخ	cottage
قطن	cotton
كنبة	couch
كحة	cough
كان يقدر	could
ممكن	could
مجلس	council
يعد	count
بار المطبخ	counter
شباك موظف المصرف	counter
بلاد	country
الريف	countryside
زوجين	couple
شجاعة	courage
دورة	course
محكمة	court
مجاملة	courtesy
ولد عم	cousin
غطاء	cover
بقرة	cow
جبان	coward
مريح	cozy
باغلي	crab
شق	crack
كسر	crack
حرفة	craft
طيارة	craft
كلام فاضي	crap
يتكسر	crash
يتهشم	crash
شهية	craving
رغبة	craving
يزحف	crawl
مجنون	crazy
يخلق	create
ينشئ	create
مبدع	creative
دائن	credit
رصيد	credit
زحف	creep
مخيف	creepy
طاقم	crew
جريمة	crime
ينكمش	cringe
يتقلص	cringe
كارثة	crisis
معيار	criteria
نقدي	critical
محرج	critical
نقد	criticism
غلّة	crop
يقص الشعر	crop
محصول	crop
غلّة	crops
محصول	crops
يمر	cross
تقاطع	cross
الغراب	crow
زحمة	crowd
زحمة	crowded
تاج	crown
حاسم	crucial
قاسي	cruel
فظ	cruel
رحلة بحرية	cruise
يحطّم	crush
معجب	crush
يبكي	cry
خيار	cucumber
يحضن	cuddle
ثقافة	culture
داهية	cunning
طاسة	cup
دولاب	cupboard
رصيف	curb
دواء	cure
يداوي	cure
حظر تجول	curfew
فضول	curiosity
فضولي	curious
ملوي	curly
عملة	currency
حالي	current
تيار	current
حاليا	currently
بلاء	curse
لعنة	curse
ستار	curtain
وسادة	cushion
عادة	custom
جمارك	custom
زبون	customer
جمارك	customs
تقاليد	customs
يقطع	cut
لطيف	cute
دورة	cycle
دراجة	cycle
يركب الدراجة	cycling
بابا	dad
بابا	daddy
يوميا	daily
ألبان	dairy
سد	dam
تلف	damage
ضرر	damage
يتلف	damage
اللعنة	damn
رطوبة	damp
مبلول	damp
رقص	dance
خطر	danger
خطير	dangerous
ظلام	dark
داكن	dark
عزيزي	darling
انطلاق	dash
بيانات	data
تاريخ	date
موعد غرامي	date
ابنة	daughter
يوم	day
ميت	dead
موعد تسليم	deadline
أطرش	deaf
يتعامل	deal
عزيزي	dear
أعزائي جميعا	Dear All
عزيزى الزبون	Dear Customer
أعزائي الآباء	Dear Parents
سيدي العزيز	Dear Sir
أعزائي الطلبة	Dear students
أعزائي أعضاء الفريق	Dear Team
موت	death
مناظرة	debate
نقاش	debate
دين	debit
حطام	debris
دين	debt
عقد	decade
عشرة سنين	decade
متعفّن	decay
فاسد	decay
متوفى	deceased
يخدع	deceive
ديسمبر	december
مقبول	decent
محتشم	decent
يقرّر	decide
قرّر	decided
قرار	decision
يزيّن	deck
سطح قارب	deck
يرفض	decline
ينقّص	decrease
إهداء	dedicated
مخلص	dedicated
إهداء	dedication
التزام	dedication
شيك	deed
سند	deed
فعل	deed
عمل	deed
عميق	deep
داكن	deep
غزال	deer
تقصير	default
افتراضي	default
فشل	defeat
يفشل	defeat
هزيمة	defeat
يهزم	defeat
يدافع	defend
يحدد	define
يعرّف	define
بالتأكيد	definitely
تعريف	definition
درجة	degree
تأجيل	delay
تأخير	delay
متأجل	delayed
متأخّر	delayed
يمسح	delete
يحذف	delete
متعمد	deliberate
ناعم	delicate
حساس	delicate
لذيذ	delicious
فرح	delight
فرحان	delighted
يوصل	deliver
يسلم	deliver
يوصل	delivered
يسلم	delivered
توصيل	delivery
ولادة	delivery
تسليم	delivery
حاجة ملحة	demand
يطلب	demand
يطلب	demanding
متطلب	demanding
ديمقراطية	democracy
شيطان	demon
يشرح	demonstrate
يوضح	demonstrate
مرفوض	denied
نكر	denied
كثافة	density
دكتور أسنان	dentist
ينكر	deny
إدارة	department
قسم	department
دائرة	department
مغادرة	departure
يعتمد على	depend
ينشر الجنود	deploy
يودع	deposit
إيداع	deposit
محبط	depressed
اكتئاب	depression
عمق	depth
يوصف	describe
وصف	description
صحراء	desert
يستاهل	deserve
يصمم	design
تصميم	design
تعيين	designation
تسمية	designation
يرغب	desire
رغبة	desire
مقعد	desk
مكتب	desk
يأس	despair
فاقد الأمل	desperate
رغم أن	despite
حلويات	dessert
وجهة	destination
قدر	destiny
مصير	destiny
يدمّر	destroy
دمار	destruction
تفصيل	detail
بيان	detail
تفاصيل	details
يتتبع	detect
تحديد	determination
عزيمة	determination
يقرّر	determine
يحدّد	determine
يقرّر	determined
يحدّد	determined
دمر	devastated
يطوّر	develop
متطور	developed
تطوير	development
جهاز	device
شيطان	devil
مخلص	devoted
يخصّص لـ	devoted
الديفيهي	Dhivehi
مرض السكر	diabetes
إسهال	diarrhea
مذكرة	diary
قاموس	dictionary
دار	did
يموت	die
مات	died
ريجيم	diet
اختلاف	difference
مختلف	different
صعب	difficult
يحفر	dig
كرامة	dignity
مجتهد	diligent
عشاء	dinner
يغمر	dip
مباشر	direct
اتجاه	direction
مدير	director
وسخ	dirt
امسخ	dirty
يسبب إعاقة	disable
يسبب عجز	disable
عاجز	disabled
معاق	disabled
يختفي	disappear
محبط	disappointed
كارثة	disaster
يرمي	discard
يتجاهل	discard
فصل	discharge
خروج	discharge
انضباط	discipline
مجال	discipline
تخفيض	discount
يخصم	discount
يكتشف	discover
تمييز عنصري	discrimination
يناقش	discuss
نقاش	discussion
مرض	disease
أمراض	diseases
تنكر	disguise
تمويه	disguise
مقرف	disgusting
صونية	dish
صواني	dishes
رفض	dismiss
طرد	dismiss
إيفاد	dispatch
إرسال	dispatch
يعرض	display
تصرّف	disposal
تخلّص	disposal
خلاف	dispute
مسافة	distance
متميز	distinct
يميز	distinguish
محنة	distress
توزيع	distribution
منطقة	district
يزعج	disturb
خندق	ditch
قناة ضيقة	ditch
مجاري	ditch
يغطس	dive
تنوع	diverse
تنوع	diversity
يقسم	divide
سماوي	divine
إلهي	divine
طلاق	divorce
يطلّق	divorce
دايخ	dizzy
يدير	do
أنت هكي درت؟	do you
أنت تحبني؟	do you love me
دكتور	doctor
مستند	document
يدير	does
ما يديرش	doesn't
كلب	dog
دوجري	Dogri
يدير	doing
لعبة بنبلة	doll
نطاق	domain
مجال	domain
محلي	domestic
مسيطر	dominant
لا	don't
ما تدوّرش	Don't worry
يتبرع	donate
منجز	done
حمار	donkey
منشط	dope
مخدر	dope
مضاعف	double
يزدوج	double
مزدوج	double
يضاعف	double
يشك	doubt
شك	doubt
عجينة	dough
فلوس	dough
تحت	down
ينزل	download
مسودة	draft
يسحب	drag
يجر	drag
بالوعة	drain
دراما	drama
تمثيل	drama
يرسم	draw
قجر	drawer
درج	drawer
الرسم	drawing
مخيف	dread
يحلم	dream
حلم	dream
قفطان	dress
يحفر	drill
يشرب	drink
مشروب	drink
يسوق	drive
يطيح	drop
قطرة	drop
يقطّر	drop
طاح	dropped
جفاف	drought
سكران	drunk
سكر	drunk
جاف	dry
بطة	duck
صاحبي	dude
مستحق	due
بسبب	due to
بفضل	due to
ممل	dull
بكوش	dumb
أطرش	dumb
غبي	dumb
غبي	dump
مدة	duration
أثناء	during
غبرة	dust
واجب	duty
مهمة	duty
يسكن	dwell
الموت	dying
على فراش الموت	dying
كل	each
مع بعض	each other
حريص	eager
صقر	eagle
وذن	ear
بكري	earlier
بكري	early
يكسب	earn
وذان	ears
أرض	earth
زلزال	earthquake
يسهّل	ease
بسهولة	easily
شرق	east
سهل	easy
يأكل	eat
يأكل	eating
اقتصادي	economic
اقتصاد	economy
حافة	edge
يعدّل	edit
تعديل	edit
تعليم	education
أثر	effect
مؤثر	effective
كفاية	efficiency
كافي	efficient
فعال	efficient
جهد	effort
دحي	egg
باذنجال	eggplant
الأنانية	ego
ثمانية	eight
ثمنطاش	eighteen
ثمانين	eighty
يا أما	either
يشرح	elaborate
يطور	elaborate
مرفق	elbow
أكبر في السن	elder
كبير في السن	elderly
أنيق	elegant
عنصر	element
فيل	elephant
حداش	eleven
مؤهل	eligible
ينهي	eliminate
ثاني	else
آخر	else
محرج	embarrassed
محرج	embarrassing
يحضن	embrace
يطلع	emerge
يبان	emerge
طواري	emergency
حالة طارئة	emergency
عاطفي	emotional
تعاطف	empathy
تأكيد	emphasis
تركيز	emphasis
يشدد على	emphasize
يؤكد	emphasize
موظف	employee
موظفين	employees
صاحب عمل	employer
توظيف	employment
فاضي	empty
يمكّن	enable
يواجه	encounter
يشجع	encourage
نهاية	end
مهدد	endangered
معرض للخطر	endangered
يسعى	endeavor
محاولة	endeavor
تحمل	endurance
يتحمل	endure
عدو	enemy
طاقة	energy
يخطب	engage
ينشغل ب	engage
يخطب	engaged
ينخرط في	engaged
خطوبة	engagement
محرّك	engine
مهندس	engineer
الإنجليزية	English
يقوّي	enhance
يستمتع	enjoy
ضخم	enormous
يكفي	enough
يضمن	ensure
يؤكد	ensure
يدخّل	enter
يخش	enter
ترفيه	entertainment
حماس	enthusiasm
تعصب	enthusiasm
متحمس	enthusiastic
كامل	entire
كله	entire
مستحق	entitled
كيان	entity
جهة	entity
مدخل	entrance
مقاول	entrepreneur
ظرف	envelope
بيئة	environment
يحسد	envy
ملحمي	epic
بطولي	epic
وباء	epidemic
يساوي	equal
معدات	equipment
عدل	equity
ما يعادل	equivalent
محّاية	eraser
خطأ	error
يهرب	escape
خصوصًا	especially
مقال	essay
جوهر	essence
أساس	essence
أساسي	essential
يؤسس	establish
يؤسس	established
ملكية	estate
يقدّر	estimate
مقدر	estimated
إلخ	etc
داخلي	eternal
أخلاقيات	ethics
يقيّم	evaluate
تقييم	evaluation
حتى	even
رغم أن	even though
عشية	evening
حالة	event
حدث	event
مؤخرا	eventually
أبدا	ever
كل	every
كل الناس	everybody
كل الناس	everyone
كل شيء	everything
دليل	evidence
شر	evil
شيطان	evil
تطور	evolution
يطور	evolve
إيوي	Ewe
مثال	ex
حبيب قديم	ex
بالضبط	exact
دقيق	exact
بالضبط	exactly
امتحان	exam
يمتحن	examine
مثال	example
نموذج	example
يزيد على	exceed
ممتاز	excellent
ما عدا	except
استثناء	exception
فائض	excess
مبالغ فيه	excessive
تبادل	exchange
متحمس	excited
لهفة	excitement
حماس	excitement
حماسي	exciting
حصري	exclusive
يتعذر	excuse
عذر	excuse
اعذرني	excuse me
عفوًا	excuse me
ينفذ	execute
تنفيذ	execution
تنفيذي	executive
يتمرن	exercise
تمرين	exercise
استنزاف	exhaust
مرهق	exhausted
يعرض	exhibit
معرض	exhibition
فيه	exist
موجود	exist
وجود	existence
موجود	existing
خروج	exit
يمدد	expand
يوسع	expand
يتوقع	expect
متوقّع	expected
تكاليف	expenses
غالي	expensive
يجرب	experience
خبرة	experience
يختبر	experience
تجربة	experiment
خبير	expert
مختص	expert
منتهي الصلاحية	expired
يشرح	explain
شرح	explanation
توضيح	explanation
يستثمر	exploit
يستغل	exploit
يستكشف	explore
يبحث	explore
يستورد	export
يعرض	expose
معرض ل	exposed
تعرض	exposure
يعبّر	express
تعبير	expression
يمتد	extend
تمدّد	extended
تمديد	extension
وصلات شعر	extension
امتداد	extent
حد	extent
خارجي	external
منقرض	extinct
زيادة	extra
يستخرج	extract
استثنائي	extraordinary
متطرف	extreme
مبالغ فيه	extreme
لدرجة كبيرة	extremely
عين	eye
عيون	eyes
نسيج	fabric
خرافي	fabulous
خلاب	fabulous
وجه	face
يواجه	face
يسهل	facilitate
مرافق	facilities
منشأة	facility
تسهيل	facility
حقيقة	fact
عنصر	factor
عامل	factor
مصنع	factory
حقائق	facts
يختفي	fade
يتلاشى	fade
يفشل	fail
يسقط	fail
سقط	failed
فشل	failed
فشل	failure
خفيف	faint
يدوخ	faint
عادل	fair
معرض	fair
بالعدل	fairly
تماما	fairly
جنية	fairy
إيمان	faith
وفي	faithful
مقلد	fake
يطيح	fall
خطأ	false
شهرة	fame
مألوف	familiar
عيلة	family
مجاعة	famine
مشهور	famous
مروحة	fan
معجب	fan
فاخر	fancy
رائع	fantastic
بعيد	far
وداع	farewell
مع السلامة	farewell
مزرعة	farm
مزارع	farmer
مبهر	fascinating
موضة	fashion
سريع	fast
سمين	fat
مميت	fatal
قدر	fate
مصير	fate
أب	father
إرهاق	fatigue
عيب	fault
خطأ	fault
مفضل	favorite
فضل	favour
يساند	favour
مفضل	favourite
خوف	fear
وليمة	feast
عزومة	feast
ريشة	feather
ميزة	feature
مزايا	features
فبراير	february
طفح الكيل	fed up
رسوم	fee
يغذي	feed
تقييم	feedback
تعليق	feedback
يشعر	feel
إحساس	feeling
رجلين	feet
طاح	fell
زميل	fellow
حسّ	felt
أنثى	female
سياج	fence
سور	fence
مثمرة	fertile
خصبة	fertile
مهرجان	festival
يجيب معاه	fetch
بردة	fever
شوية	few
أقل	fewer
خطيب	fiance
خيالي	fiction
حقل	field
مجال	field
عنيف	fierce
خمسطاش	fifteen
خمسين	fifty
حرب	fight
يحارب	fighting
رقم	figure
شكل	figure
يكتشف	figure out
ملف	file
يعبّي	fill
عبّى	filled
فيلم	film
امسخة	filthy
أخيرا	finally
المالية	finance
تمويل	finance
مالي	financial
أوجد	find
يكتشف	find out
غرامة	fine
تمام	fine
بخير	fine
صُبع	finger
ينتهي	finish
تم	finished
كمّل	finished
نار	fire
حريقة	fire
حازم	firm
شركة	firm
يحسم	firm
أولا	first
الاسم الأول	first name
حوت	fish
مناسب	fit
خمسة	five
يثبت	fix
يصلح	fix
تصلّح	fixed
ثابت	fixed
علم	flag
ضي فلاش	flash
شقة	flat
مسطّح	flat
عيب	flaw
خلل	flaw
شق	flaw
بدون عيوب	flawless
هرب	flee
لحم	flesh
طار	flew
ثني	flex
مرن	flexible
رحلة	flight
يتشقلب	flip
يعاكس	flirt
يغازل	flirting
يطفو	float
فيضان	flood
أرضية	floor
طابق	floor
دقيق	flour
يجري	flow
يتدفق	flow
تدفق	flow
جريان	flow
وردة	flower
إنفلونزا	flu
طليق اللسان	fluent
بطلاقة	fluently
منفوش	fluffy
سائل	fluid
يطير	fly
تركيز	focus
يركز	focus
ضباب	fog
مضبّب	foggy
يثني	fold
يا ناس	folks
يتبّع	follow
يتابع	follow up
الجاي	following
ماكلة	food
مغفّل	fool
غبي	foolish
رِجِل	foot
كرة القدم	football
لأجل	for
لــ	for
مثلًأ	For example
مثلًا	for instance
ليك أنت	for you
ممنوع	forbidden
يجبر	force
قوة	force
تنبؤ	forecast
جبهة	forehead
أجنبي	foreign
غابة	forest
للأبد	forever
ينسى	forget
يسامح	forgive
يغفر	forgive
نسى	forgot
شوكة	fork
شكل	form
رسمي	formal
سابق	former
لحسن الحظ	fortunately
حظ	fortune
أربعين	forty
اثنين وأربعين	forty-two
إلى الأمام	forward
يعزّز	foster
حارب	fought
لقي	found
أساس	foundation
أربعة	four
أربعطاش	fourteen
ثعلب	fox
كسره سهل	fragile
هش	fragile
إطار	frame
إطار	framework
تزوير	fraud
احتيال	fraud
غريب الأطوار	freak
مجانا	free
حرية	freedom
يتجمد	freeze
تكرار	frequency
تردد	frequency
متكرّر	frequent
ديما يصير	frequent
هلبا مرات	frequently
طازج	fresh
الجمعة	friday
ثلاجة	fridge
صاحب	friend
ودي	friendly
صحاب	friends
صداقة	friendship
مرعوب	frightened
خايف	frightened
مخيف	frightening
ضفدع	frog
من	from
جبهة	front
القدام	front
متجمد	frozen
فاكهة	fruit
محبط	frustrated
وقود	fuel
فولفولدي	Fulfulde
معبّي	full
مرح	fun
وظيفة	function
مهمة	function
أساسي	fundamental
جنازة	funeral
مضحك	funny
فرو	fur
غاضب	furious
أثاث	furniture
أبعد	further
وزيد على هذا	furthermore
مستقبل	future
يكسب	gain
لعبة	game
فجوة	gap
قاراج	garage
كناسة	garbage
حديقة	garden
ثوم	garlic
بوابة	gate
يجمع	gather
يجمّع	gathering
يكيّل	gauge
قياس	gauge
عطي	gave
معدات	gear
بضاعة	gear
يجهّز	gear
نوع	gender
عام	general
عموما	generally
يولد	generate
توليد	generation
جيل	generation
كريم	generous
عبقري	genius
نوع	genre
لطيف	gentle
حقيقي	genuine
أصيل	genuine
إيماءة	gesture
إشارة باليد أو الرأس	gesture
يوصل	get
يحّصل	get
البس حوايجك	get dressed
نوض	get up
بالشفاء العاجل	get well soon
الحصول	getting
الوصول	getting
شبح	ghost
معاش يتواصل	ghosting
يختفي	ghosting
عملاق	giant
ضخم	giant
هدية	gift
زنجبيل	ginger
بنت	girl
حبيبة	girlfriend
يعطي	give
يستسلم	give up
معطي	given
سعيد	glad
لمحة	glance
نظرة	glance
مرش	glass
نظارات	glasses
لمحة	glimpse
عالمي	global
مُوحِش	gloomy
مظلّم	gloomy
قوانطيات	gloves
يلمع	glow
يوهّج	glow
يتغيّر للأحسن	glow up
لصقة	glue
يمشي	go
تفضّل	go ahead
كمّل	go ahead
ابعد	go away
يرقد	go to bed
هدف	goal
أهداف	goals
معزة	goat
رب	god
بارك الله فيك	god bless you
يمشي	goes
ماشي	going
ماشي لـ	going to
ذهب	gold
مشي	gone
حندير	gonna
لزج	goo
كويس	good
جيد	good
مساء الخير	good afternoon
مع السلامة	good bye
يوم جميل	good day
مساء الخير	good evening
عمل كويس	good job
شكله حلو	good looking
موفّق	good luck
صباح الخير	good morning
صباح الخير حبي	good morning my love
تصبح على خير	good night
مع السلامة	goodbye
تصبح على خير	goodnight
سلع	goods
غوغل	Google
ترجمة غوغل	Google Translate
وزة	goose
رائع	gorgeous
قرمة	gossip
حصّل	got
فهمت	got it
حكومة	government
يشد	grab
درجة	grade
تدريجيا	gradually
خرّيج	graduate
حبوب	grain
منح	grant
عطاء	grant
ممنوح	granted
عنب	grapes
يفهم	grasp
يشد	grasp
عشب	grass
ممتن	grateful
شاكر	grateful
عرفان بالجميل	gratitude
امتنان	gratitude
قبر	grave
رصاصي	gray
عظيم	great
جشع	greed
طمع	greed
طماع	greedy
أخضر	green
يحيّي	greet
تحية	greeting
تحيات	greetings
رصاصي	grey
شبكة	grid
حزن	grief
يرحي	grind
يقبض	grip
يشد	grip
محل مواد غذائية	grocery
عريس	groom
إجمالي	gross
أرضي	ground
مجموعة	group
ينمو	grow
نمو	growth
متعصّب	grumpy
غواراني	Guarani
ضمان	guarantee
حارس	guard
فكّر	guess
ضيف	guest
إرشادات	guidance
يقود	guide
دليل	guide
قيادة	guide
مذنب	guilty
شاب	guy
شباب	guys
صالة رياضة	gym
عادة	habit
بيئة	habitat
موطن	habitat
كان عنده	had
تبروري	hail
شعر	hair
نص	half
قاعة	hall
يسلم	hand
يد	hand
يشد بيده	handle
يعالج الموضوع	handle
وسيم	handsome
يعلق	hang
يشنق	hang
يشنق	hang out
يتسكع	hang out
يصير	happen
صار	happened
سعادة	happiness
سعيد	happy
عيد ميلاد  سعيد	happy birthday
كل عام وأنت بخير	happy birthday to you
سنة جديدة سعيدة	happy new year
صعب	hard
بالسيف	hardly
شبه مستحيل	hardly ever
يضر	harm
مؤذي	harm
مؤذي	harmful
انسجام	harmony
قاسي	harsh
حصاد	harvest
عنده	has
يكره	hate
يملك	have
استمتع بيومك	have a good day
استمتع بيومك	have a nice day
يُفطر	have breakfast
استمتع	have fun
أنت كليت؟	have you eaten
يأخذ	having
عنده	having
خطر	hazard
ضباب	haze
هو	he
هو عنده	he has
هو	he is
رأس	head
صداع	headache
يشفى	heal
شفاء	healing
صحة	health
صحي	healthy
يسمع	hear
سمع	heard
قلب	heart
يسخن	heat
حرارة	heat
السماء	heaven
الجنة	heaven
رزين	heavy
معبّي	hectic
ارتفاع	height
وريث	heir
خنبة	heist
شد	held
جهنم	hell
السلام عليكم	Hello
أهلا عزيزتي	hello dear
أهلين كيف حالك	hello how are you
أهلين كيف حالك	hello how are you doing
خوذة	helmet
يساعد	help
متعاون	helpful
فلهذا	hence
متاعها	her
قطيع	herd
هنا	here
ورثة	heritage
يتردد	hesitate
يا	Hey
أهلين	Hi
أهلا كيف حالك	hi how are you
أهلا بيكم	Hi there
مدسوس	hidden
مخفي	hidden
يخفي	hide
تسلسل هرمي	hierarchy
عالي	high
يأشر على	highlight
يضوّي	highlight
تنزه	hike
مشي	hike
تدهوير	hiking
مشي	hiking
مرح	hilarious
هضبة	hill
هو	him
تلميح	hint
إشارة	hint
الورك	hip
وركين	hips
يستأجر	hire
تأجير	hiring
يوظف	hiring
متاعه	his
تاريخ	history
يضرب	hit
اممم	Hmm
هواية	hobby
يشد	hold
يستمر	hold on
نقبة	hole
فتحة	hole
عطلة	holiday
مجوف	hollow
حوش	home
واجب منزلي	homework
صادق	honest
بصدق	honestly
حبيبى	Honey
عسل	Honey
شرف	honor
برنوص	hood
علّاق	hook
رقص	hop
ينقز برجل واحدة	hop
أمل	hope
يأمل	hope
متأمل	hopefully
ميؤوس منه	hopeless
أفقي	horizontal
قرن	horn
بوق	horn
مخيف	horrible
رعب	horror
حصان	horse
مستشفى	hospital
ضيافة	hospitality
يستضيف	host
مضيف	host
عدواني	hostile
حار	hot
فندق	hotel
ساعة	hour
ساعات	hours
حوش	house
منزلي	household
أهل الحوش	household
كيف	how
وأنت شن؟	how about you
كيف حالك	how are you
كيف حالك	how are you doing
كيف حالك اليوم	how are you doing today
كيف حالك اليوم	how are you today
كيف حالك أنت	how do you do
كيف  هو	how is
قداش	how many
قداش	how much
كم مرة	how often
كم عمرك	how old are you
كيف كان يومك	how was your day
كيف كانت ليلتك	how was your night
أما	however
مركز	hub
محور	hub
زوج	hubby
حضن	hug
ضخم	huge
إنسان	human
متواضع	humble
رطوبة	humid
رطوبة	humidity
مئة	hundred
جعّان	hungry
يصطاد	hunt
إعصار	hurricane
يستعجل	hurry
يستعجل	hurry up
بسرعة	hurry up
يجرح	hurt
زوج	husband
يسرّع	hustle
صخب	hustle
كوخ	hut
صحة	hygiene
أنا	I
أنا	I am
أنا بخير	I am fine
نقدر	I can
ما نقدرش	I can't
أنا ندير	I do
ما نعرفش	I do not know
ما فهمتش	I do not understand
أنا ما	I don't
ما نعرفش	I don't know
ما فهمتش	I don't understand
ما فهمتكش شن قصدك	I don't understand what you mean
ما فهمتكش	I don't understand you
ما نعرفش	I don’t know
ما فهمتش	I don’t understand
أعتقد	i guess
كان عندي	I had
عندي	I have
كنت	I have been
نتمنى هكي	I hope so
أنا نعرف	I know
أنا نحب	I like
أنا معجب بيك	I like you
أنا نحب	I love
نحب خوي الكبير	I love my big brother
نحب أختي الكبيرة	I love my big sister
نحب بوي	I love my father
نحب خوي الصغير	I love my little brother
نحب أختي الصغيرة	I love my little sister
نحب أمي	I love my mother
نحبك	I love you
نحبك هلبا	I love you so much
حتى أنا نحبك	I love you too
نقصد	I mean
استاحشتك	I miss you
استاحشتك هلبا	I miss you so much
نفهم	I see
نشوف	I see
أعتقد	I think
فهمت	I understand
أريد	I want
نبّي نشوفك	I want to see you
نبّيك	I want you
أنا كنت	I was
أنا حـ	I will
حنكون	I would be
أنا	I'm
أنا بخير	I'm fine
أنا بخير	I'm good
أنا هنا	I'm here
آسف	I'm sorry
ثلج	ice
جيلاطي	ice cream
فكرة	idea
مثالي	ideal
مطابق	identical
تمييز	identify
تعريف	identify
هوية	identity
غبي	idiot
بطالة	idle
إذا	if
يتجاهل	ignore
مريض	ill
مش قانوني	illegal
حرام	illegal
مرض	illness
إيلوكانو	Ilocano
صورة	image
يتخيل	imagine
فوري	immediate
حالا	immediately
ضخم	immense
يؤثر	impact
أثر	impact
مش صبور	impatient
ينفّذ	implement
يستورد	import
استيراد	import
مهم	important
يفرض	impose
مستحيل	impossible
تأثير	impress
انطباع	impression
رائع	impressive
يحسّن	improve
تحسين	improvement
فى	in
وفوق من هذا	in addition
في الحقيقة	In fact
قدام	in front of
مقابل	in front of
بقصد	in order to
بهدف	in order to
مش مناسب	inappropriate
حافز	incentive
حادثة	incident
يشمل	include
يشمل	including
دخل	income
مش مناسب	inconvenience
مش مريح	inconvenience
يزيد	increase
يزيد	increased
رائع	incredible
لا يصدق	incredible
بالحقا	indeed
بالفعل	indeed
مستقل	independent
الهند	India
يشير لـ	indicate
أصلي	indigenous
ولد البلاد	indigenous
فردي	individual
صناعة	industry
ما فيش منه مفر	inevitable
عيّل	infant
عدوى	infection
ما لا نهاية	infinity
التهاب	inflammation
تضخم	inflation
تأثير	influence
نفوذ	influence
يؤثر	influence
يعطي علم	inform
معلومات	information
مكونات	ingredients
ورثة	inheritance
مبدئي	initial
مبادرة	initiative
انجرح	injured
جرح	injury
بريء	innocent
اختراع	innovation
يستفسر	inquiry
يتحرى	inquiry
مجنون	insane
حشرة	insect
مش آمن	insecure
يدخل	insert
داخل	inside
حداقة	insight
يصر	insist
ينق	insist
أرق	insomnia
إلهام	inspiration
يلهم	inspire
يثبّت	install
يركّب	install
مثال	instance
نموذج	instance
فوري	instant
سريع	instant
في بدل	instead
بدلا من	instead of
في مكان	instead of
تعليمات	instructions
آلة	instrument
أداة	instrument
يسبّ	insult
يهين	insult
تأمين	insurance
سليم	intact
نزاهة	integrity
مفكّر	intellectual
مثقف	intellectual
ذكاء	intelligence
ذكي	intelligent
ينوي	intend
ينوي	intended
يقصد	intended
كثيف	intense
نيّة	intention
يتفاعل	interact
تفاعل	interaction
اهتمام	interest
مهتم	interested
ممتع	interesting
يتدخل	interfere
متوسط	intermediate
داخلي	internal
عالمي	international
امتياز الطب	internship
تدريب	internship
يفسّر	interpret
يترجم	interpret
مفسر	interpreter
مترجم فوري	interpreter
يعترض	interrupt
يقاطع	interrupt
مقابلة	interview
ودي	intimate
عاطفي	intimate
داخل	into
يعرض	introduce
يقدم	introduce
مقدمة	introduction
انطوائي	introvert
بديهة	intuition
حدس	intuition
منتهي الصلاحية	invalid
غير صالح	invalid
يخترع	invent
جرد	inventory
يستثمر	invest
يتحرّى	investigate
يحقّق	investigate
دعوة	invitation
يدير دعوة	invite
فاتورة	invoice
يشمل	involve
متورط	involved
مشارك	involved
حدّاد	iron
يحدّد	iron
حديد	iron
تكون	is
يكون	is
جزيرة	island
معزول	isolated
موضوع	issue
مشكلة	issue
أصدر	issue
مشاكل	issues
مواضيع	issues
هو	it
هى	it
هذا	it is
كان	it was
هذا	it's
تمام عادي	it's ok
باهي	It's okay
تمام	It's okay
عنصر	item
بند	item
بنود	items
عناصر	items
هو	its
أنا	I’m
جاكيت	jacket
حبس	jail
يناير	January
فازو	jar
فك	jaw
غيور	jealous
هزة	jerk
رعشة	jerk
مجوهرات	jewelry
وظيفة	job
تهرويل	jogging
ينضم	join
مشترك	joint
يوصّل	joint
نكتة	joke
بصارة	joke
صحفي	journalist
رحلة	journey
مرح	joy
قاضي	judge
يحكم	judge
عصير	juice
يوليو	july
ينقز	jump
يونيو	june
خردة	junk
حالًا	just
بس	just
غير أنت دير هكي	just do it
عدل	justice
يبرر	justify
كالاليسوت	Kalaallisut
قوي	keen
حريص	keen
احفظ	keep
استمر	keep it up
محفوظ	kept
دس	kept
غلاية	kettle
كتل	kettle
مفتاح	key
يدف برجله	kick
يركل	kick
عيّل	kid
يبصّر	kidding
كلية	kidney
صغار	kids
يقتل	kill
طيب	kind
نوعا ما	kinda
برفق	kindly
لطفًا	kindly
لطف	kindness
ملك	king
يبوس	kiss
مطبخ	kitchen
طيارة ورقية	kite
قطوسة صغيرة	kitten
ركبة	knee
عرف	knew
موس	knife
فارس	knight
يعرف	know
معرفة	knowledge
معروف	known
الكونكانية	Konkani
كريو	Krio
ملصق	label
عمل	labor
جهد	labor
وجع الولادة	labour
عمل	labour
جهد	labour
نقص	lack
سلوم	ladder
سيدة	lady
حط	laid
بحيرة	lake
حمل	lamb
أعرج	lame
عاجز	lame
لامبة	lamp
مهبط	land
يهبط	land
أرض	land
منظر طبيعي	landscape
صفحة بالأفقي	landscape
لغة	language
حِجر	lap
كبير	large
آخر	last
أخيرا وليس آخرا	last but not least
اللقب	last name
متأخر	late
مؤخرا	lately
مؤخرا	later
الأخير	latest
بعدين	latter
يضحك	laugh
ضحك	laughing
ضحكة	laughter
يبدأ	launch
غسيل	laundry
قانون	law
عشب	lawn
محامي	lawyer
يحط	lay
طبقة	layer
تخطيط	layout
تنسيق	layout
كسول	lazy
يقود	lead
قائد	leader
ورقة شجرة	leaf
تسرب	leak
يميل	lean
ضعيف	lean
يتّكى	lean
ينقز	leap
تنقيزة	leap
يتعلم	learn
يتعلم	learning
يأجّر	lease
إيجار	lease
الأقل	least
جلد	leather
المغادرة	leave
الإجازة	leave
أوراق	leaves
قاد	led
غادر	left
ساق	leg
ورثة	legacy
قانوني	legal
أسطورة	legend
شرعي	legit
قانوني	legit
وقت الفراغ	leisure
يسلّف	lend
طول	length
أقل	less
درس	lesson
يخلّي	let
حرف	letter
رسالة	letter
خس	lettuce
مستوى	level
تأثير	leverage
نفوذ	leverage
مسؤولية قانونية	liability
مكتبة	library
العربية الليبية	Libyan Arabic
يلحس	lick
يكذب	lie
يستلقى	lie
كذبات	lies
يكذب	lies
حياة	life
أصنصير	lift
يرفع	lift
ضوء	light
يضيء	light
مضيء	light
بسرعة زي البرق	lightning
برق	lightning
زي	like
محتمل	likely
نفس الشيء	likewise
خط	line
اللينغالا	Lingala
رابط	link
أسد	lion
سائل	liquid
قائمة	list
يسمع	listen
يسمع	listening
حرفيا	literally
أدب	literature
كناسة	litter
وسخ	litter
شوية	little
يعيش	live
كبد	liver
حياة	lives
هو يعيش	lives
أرواح	lives
معيشة	living
حياة	living
دار المعيشة	living room
سحلية	lizard
وزن	load
حمل	load
قطعة خبزة	loaf
قرض	loan
محلي	local
موقع	location
مكان	location
قفل	lock
يسكّر	lockdown
سجل	log
مضحك جدا	lol
بروحه	lonely
طويل	long
قداش ليا ما شفتكش	long time no see
يشوف	look
نظرة	look
ربطة	loop
حلقة	loop
فضفاض	loose
مرخي	loose
رب	lord
يفقد	lose
خسارة	loss
يفقد	lost
هلبا	lot
نصيب	lot
الصوت عالي	loud
يتكاسل	lounge
مكان استراحة	lounge
الحب	love
نحبك	love you
محبوب	lovely
منخفض	low
أقل	lower
لوطا	lower
ينقّص	lower
وفي	loyal
ولاء	loyalty
إخلاص	loyalty
حظ	luck
محظوظ	lucky
لوغندا	Luganda
شناطي السفر	luggage
كتلة	lump
غداء	lunch
رئتين	lungs
رفاهية	luxury
استلقاء	lying
يكذب	lying
ماكينة	machine
مجنون	mad
سيدة	madam
صنع	made
مصنوع	made
مجلة	magazine
عظيم	magnificent
ضخم	magnificent
شغّالة	maid
رئيسي	main
يصلح	maintain
صيانة	maintenance
المايثيلي	Maithili
رئيسي	major
تخصّص	major
أغلبية	majority
يصنع	make
يجمّل	make up
يصنع	make up
ذكر	male
مول	mall
راجل	man
يدير	manage
إدارة	management
مدير	manager
إلزامي	mandatory
واضح	manifest
معالجة	manipulate
طريقة	manner
يدوي	manual
هلبا	many
هلبا هلبا حاجات مفرحة لليوم	many many happy returns of the day
مارس	march
مسيرة	march
هامش	margin
سوق	market
زواج	marriage
متزوج	married
قناع	mask
كتلة	mass
ضخم	massive
رئيسي	master
ماجستير	master
مباراة	match
يماثل	match
صاحب	mate
مادة	material
رياضيات	math
موضوع	matter
يهتم	matter
نضج	maturity
ممكن	may
ممكن	maybe
أنا	me
حتى أنا	me too
وجبة	meal
يعنى	mean
معنى	meaning
يعني	means
كان يقصد	meant
مقصود	meant
في أثناء	meanwhile
قياس	measure
قياسات	measures
لحم	meat
طبي	medical
الطب	medicine
دواء	medicine
تأمل	meditation
وساطة	meditation
متوسط	medium
يتلاقى	meet
اجتماع	meeting
ميتيلون	Meiteilon
يذوب	melt
ذكريات	memories
ذاكرة	memory
عقلي	mental
يذكر	mention
ذكر	mentioned
مذكور	mentioned
شخص ناصح	mentor
مرشد	mentor
تاجر	merchant
رحمة	mercy
مجرد	merely
بس	merely
عيد ميلاد مجيد	merry christmas
فوضى	mess
رسالة	message
فوضوي	messy
معدن	metal
طريقة	method
منهج	method
فيران	mice
وسط	middle
نص الليل	midnight
ممكن	might
لطيف	mild
متسامح	mild
مَعلَم	milestone
ميل	milestone
عسكري	military
حليب	milk
مليون	million
عقل	mind
رأي	mind
عقلية	mindset
متاعي	mine
يخلّط	mingle
صغير	minor
ثانوي	minor
قاصر	minor
دقيقة	minute
دقايق	minutes
معجزة	miracle
مراية	mirror
متنوع	miscellaneous
مزعج	mischievous
مؤذي	mischievous
حزين	miserable
حزن	misery
يفقد	miss
استاحشتك	miss you
يفتقد	missing
مفقود	missing
مهمة	mission
ضباب	mist
غلطة	mistake
خطأ	mistake
الميزو	Mizo
موبايل	mobile
يهزى	mock
مثال	model
نموذج	model
معتدل	moderate
حديث	modern
متواضع	modest
رطب	moist
مندّي	moist
رطوبة	moisture
يشكل	mold
قالب	mold
شكل	mold
الخلد	mole
شامة	mole
أم	mom
لحظة	moment
الاثنين	monday
فلوس	money
شاشة مراقبة	monitor
يراقب	monitor
شاشة	monitor
قرد	monkey
شهر	month
مزاج	mood
مزاجي	moody
قمر	moon
أخلاقي	moral
أكثر	more
وزيد على هذا	moreover
صبح	morning
قرض عقاري	mortgage
أغلب	most
غالبا	mostly
أم	mother
حركة	motion
حافز	motivation
جبل	mountain
فأر	mouse
فأرة الكومبيوتر	mouse
فم	mouth
يتحرك	move
يتنقل	move
حركة	movement
فيلم	movie
سيدة	mrs
هلبا	much
طين	mud
مق	mug
عضلة	muscle
متحف	museum
فقاع	mushroom
موسيقى	music
لازم	must
كتم	mute
مشترك	mutual
متبادل	mutual
متاعي	my
عزيزي	My dear
صاحبي	my friend
الحوامة متاعي مليانة بثعابين البحر	My hovercraft is full of eels
حبي	my love
اسمي	my name is
سعيد بخدمتك	my pleasure
أنا	myself
نفسي	myself
غامض	mysterious
لغز	mystery
غموض	mystery
خرافة	myth
ظفر	nail
مسمار	nail
ساذج	naive
على نياته	naive
اسم	name
سرد	narrative
حكي	narrative
ضيق	narrow
مقرف	nasty
وطني	national
جنسية	nationality
مواطن	native
طبيعي	natural
طبيعة	nature
درهة كبد	nausea
تقزز	nausea
قريب	near
قريب	nearby
قريب	nearly
على وشك	nearly
مرتّب	neat
نظيف	neat
ضروري	necessary
رقبة	neck
سنسلة	necklace
يحتاج	need
حاجة	need
سلبي	negative
يتجاهل	neglect
يفاوض	negotiate
جار	neighbor
جيرة	neighborhood
حي	neighborhood
لا هذا ولا هداكا	neither
ولد الأخ	nephew
ولد الأخت	nephew
مغفل	nerd
متوتر	nervous
عش	nest
صافي	net
شبكة	net
شبكة	network
محايد	neutral
أبدا	never
ما تستسلمش أبدًا	never give up
ما تفكرش	never mind
ما تدوّرش	nevermind
ومع هذا	nevertheless
جديد	new
أخبار	news
الجاي	next
بجنب	next to
جميل	nice
تشرفت بمعرفتك	nice to meet you
بنة الأخ	niece
بنت الأخت	niece
ليل	night
كابوس	nightmare
تسعة	nine
طمنطاش	nineteen
تسعين	ninety
لا	No
ما فيش مشكلة	no problem
مستحيل	no way
ما حد	nobody
إزعاج	noise
مزعج	noisy
ولا شيء	none
ظُهر	noon
لا	nope
ولا	nor
عادي	normal
الشمال	north
خشم	nose
حنين	nostalgic
مش	not
لا	not
نهائيًا	not at all
مش سيء	not bad
مش توا	Not now
مازال	not yet
ملاحظة	note
مذكرة	note
معروف	noted
ملاحظ	noted
مذكور	noted
شيء	nothing
يلاحظ	notice
لاحظ	noticed
اسم	noun
أسماء	nouns
رواية	novel
نوفمبر	november
توا	now
في وقتنا هذا	nowadays
إزعاج	nuisance
باطل	null
مخدّر	numb
رقم	number
ممرض	nurse
بندق	nut
جوزة الطيب	nutmeg
تغذية	nutrition
حلف يمين	oath
سمنة	obesity
يطيع	obey
موضوع	object
يعترض	object
موضوعي	objective
غرض	objective
فرض	obligation
التزام	obligation
غامض	obscure
ملاحظة	observation
يلاحظ	observe
مهووس	obsessed
هوس	obsession
هاجس	obsession
مهمل	obsolete
قديم	obsolete
عائق	obstacle
مانع	obstacle
يحصّل	obtain
يحصّل	obtained
واضح	obvious
بوضوح	obviously
مرّات	occasionally
مهنة	occupation
احتلال	occupation
مشغول	occupied
محتل	occupied
يصير	occur
صار	occurred
يصير	occurs
محيط	ocean
أكتوبر	october
شاذ	odd
احتمالات	odds
ل	of
من	of
طبعًا	of course
إيقاف التشغيل	off
بعيد	off
عنيف	offensive
منح	offer
يعرض	offer
عرض	offer
يمنح	offer
مكتب	office
رسمي	official
غالبا	often
أه	Oh
آه بالحقا	oh really
زيت	oil
باهي	ok
تمام	ok
تمام يا عزيزي	ok dear
تمام حبيبي	ok honey
تمام حبي	ok my love
باهي	okay
تمام	okay
تمام حبيبي	okay baby
تمام يا عزيزي	okay dear
تمام يا حبيبي	okay honey
تمام يا حبي	okay my love
عجوز	old
قديم	old
على	on
لما	once
في مرة	once
مرة واحدة	once
واحد	one
لغة واحدة أبدًا ما تكفيش	one language is never enough
بصل	onion
متصل	online
بس	only
فتح	open
مفتوح	open
عملية	operation
فكرة	opinion
رأي	opinion
فرص	opportunities
فرصة	opportunity
عكس	opposite
متفائل	optimistic
خيار	option
اختياري	optional
أو	or
برتقال	orange
طلب	order
ترتيب	order
أمر	order
عادي	ordinary
منظمة	organization
توجه	orientation
أصل	origin
أصلي	original
الأورومو	Oromo
يتيم	orphan
آخر	other
غير هكي	otherwise
لازم	ought
متاعنا	our
مهمتنا: نخلّوا الناس في كل مكان يفهموا العالم ويعبروا على أنفسهم باللغات	Our mission: to enable everyone, everywhere to understand the world and express themselves across languages.
مهمتنا: تنظيم معلومات العالم ونخلوها مفيدة وسهلة الوصول ليها في العالم	Our mission: to organize the world's information and make it universally accessible and useful.
برا	out
النتيجة	outcome
لبسة	outfit
إطلالة	outfit
منفتح	outgoing
الصادر	outgoing
خارج	outgoing
منفذ	outlet
ملخّص	outline
خطوط رئيسة	outline
برا	outside
متميز	outstanding
كوشة	oven
فوق	over
أكثر	over
غادي	over there
إجمالي	overall
يغلب	overcome
تفكير زائد	overthinking
مغمور	overwhelmed
غامر	overwhelming
يدين	owe
بومة	owl
يمتلك	own
يملك	own
مالك	owner
ثور	ox
خطوة	pace
سرعة	pace
حزمة	pack
حزمة	package
باقة	package
مدفوع	paid
وجع	pain
زواق	paint
التزويق	painting
الرسم	painting
زوج	pair
شاحب	pale
نخلة	palm
كف اليد	palm
طاوة	pan
وباء	pandemic
رعب	panic
خلعة	panic
سروال	pants
ورقة	paper
فردوس	paradise
جنة	paradise
موازي	parallel
طرد	parcel
آسف	pardon
آباء	parents
بركيدجو	park
منتزه	park
ببغاء	parrot
معدنوس	parsley
جزء	part
يشارك	participate
خاص	particular
خاصة	particularly
شريك	partner
طرف	party
حفل	party
يمر	pass
ممر	passage
ناجح	passed
مرّ	passed
شغف	passion
شغوف	passionate
سلبي	passive
كلمة مرور	password
ماضي	past
رقعة	patch
بركة	patch
مسار	path
طريق	path
مسكين	pathetic
صبر	patience
الصبور	patient
المريض	patient
نمط	pattern
توقف	pause
رصيف	pavement
يدفع	pay
الدفع	payment
سلام	peace
آمن	peaceful
مسالم	peaceful
خوخ	peach
قمة	peak
ذروة	peak
نجاص	pear
بازيلاء	peas
مش مألوف	peculiar
يتبول	pee
يقشر	peel
نديد	peer
يشبح بصعوبة	peer
الند	peer
نداد	peers
بيرو	pen
قلم	pencil
معلّق	pending
الناس	people
فلفل	pepper
يدرك	perceive
يتصور	perceive
تصور	perception
إدراك	perception
ممتاز	perfect
ينفذ	perform
أداء	performance
ممكن	perhaps
مرّات	perhaps
فترة	period
مؤقت	permanent
إذن	permission
يعطي الإذن	permit
اجتهاد	perseverance
مواظبة	perseverance
مقاومة	persistent
شخص	person
شخصي	personal
شخصية	personality
نظري	perspective
منظور	perspective
يقنّع	persuade
شخص منحرف	pervert
تحريف	pervert
حيوان أليف	pet
مرحلة	phase
ظاهرة	phenomenon
فلسفة	philosophy
تلفون	phone
هاتف	phone
صورة	photo
جملة	phrase
مادي	physical
بدني	physical
يلتقط	pick
يختار	pick
يشد	pick up
ياخذ	pick up
صورة	picture
قطعة	piece
قِطع	pieces
خنزير	pig
حمامة	pigeon
بواسير	pile
كومة	pile
مخدة	pillow
طيار	pilot
شدادة	pin
دبوس	pin
أناناس	pineapple
وردي	pink
منجم	pit
حفرة	pit
رمية	pitch
درجة الانحدار	pitch
شفقة	pity
مكان	place
يحط	place
مكانات	places
وباء	plague
سهل	plain
عادي	plain
خطة	plan
طيارة	plane
مصنع	plant
نبات	plant
نباتات	plants
صونية	plate
منصة	platform
يلعب	play
يعزف	play
يلعب	playing
ممتع	pleasant
من فضلك	please
أرجوك	please
لو سمحت	please
فرحان	pleased
سعادة	pleasure
يوعد	pledge
يتعهد	pledge
كمية كبيرة	plenty
غزير	plenty
مؤامرة	plot
قطعة أرض	plot
سبينة	plug
عوينة	plum
سبّاك	plumber
جمع	plural
تدوين صوتي	podcast
شِعر	poem
شعر	poetry
يشير لـ	point
نقطة	point
سم	poison
الشرطة	police
سياسة	policy
مؤدب	polite
تلوث	pollution
بِرْكة	pond
حوض سباحة	pool
براز	poop
يتبرز	poop
فقير	poor
البوب	pop
الشعبي	pop
شائع	popular
سكان	population
لحم الخنزير	pork
مثرودة	porridge
عصيدة	porridge
ميناء	port
منصب	position
مكان	position
إيجابي	positive
يملك	possess
مِلك	possession
صيغة الملكية	possessive
متملّك	possessive
ممكن	possible
بريد	post
منصب	post
منشور	post
يؤجل	postpone
بطاطا	potato
احتمال	potential
جنيه	pound
فقر	poverty
طاقة	power
سلطة	power
قوة	power
قوي	powerful
عملي	practical
ممارسة	practice
يتدرب	practice
يمارس	practice
تدريب	practice
يمدح	praise
مقلب	prank
يصلي	pray
ثمين	precious
دقيق	precise
محدد	precise
بالتحديد	precisely
يتوقّع	predict
يفضل	prefer
تفضيل	preference
أولوية	preference
حامل	pregnant
تحيز	prejudice
تعصّب	prejudice
مقدمات منطقية	premises
مبنى شركة	premises
علاوة	premium
ممتاز	premium
تجهيز	preparation
يجهّز	prepare
جاهز	prepared
واتي	prepared
حرف جر	preposition
حضور	presence
وجود	presence
حاضر	present
حاليا	present
هدية	present
عرض تقديمي	presentation
يحافظ على	preserve
رئيس	president
صحافة	press
يضغط	press
ضغط	pressure
يتظاهر	pretend
يمثّل	pretend
جميل	pretty
جذاب	pretty
إلى حد بعيد	pretty
يمنع	prevent
سابق	previous
فريسة	prey
ضحية	prey
سعر	price
فخر	pride
قسيس	priest
مبدئي	primary
أساسي	primary
مبدئي	prime
رئيسي	prime
أميرة	princess
رئيسي	principal
قبل	prior
أولوية	priority
حبس	prison
خصوصية	privacy
خاص	private
حصانة	privilege
امتياز	privilege
جائزة	prize
احتمال	probably
مشكلة	problem
إجراء	procedure
يتابع	proceed
يتقدم	proceed
عملية	process
معالجة	process
ينتج	produce
منتج	product
إنتاج	production
مهنة	profession
حرفة	profession
محترف	professional
ملف شخصي	profile
ربح	profit
عميق	profound
تقدم	progress
تطور	progress
مشروع	project
مشهور	prominent
يوعد	promise
وعد	promise
يحفز	promote
ترقية	promotion
فوري	prompt
يستدعي	prompt
متعرض لـ	prone
منبطح	prone
ضمائر	pronouns
نطق	pronunciation
يثبت	proof
مناسب	proper
بصورة صحيحة	properly
ممتلكات	properties
خصائص	properties
ملكية	property
مقترح	proposal
عرض	proposal
احتمال	prospect
رفاهية	prosperity
مزدهر	prosperous
يحمي	protect
فخور	proud
يثبت	prove
يزوّد	provide
يوفّر	provided
بشرط أن	provided
مقاطعة	province
بند	provision
توفير	provision
بلوغ	puberty
حكومي	public
عام	public
يسحب	pull
قرعة	pumpkin
دقيق	punctual
طالب	pupil
يشري	purchase
صافي	pure
بنفسجي	purple
غرض	purpose
محفظة	purse
شنطة يد	purse
يتحرّى	pursue
يلحق	pursuit
يتبّع	pursuit
يدفع	push
يحط	put
مؤهل	qualification
جودة	quality
كمية	quantity
حجر صحي	quarantine
عركة	quarrel
ربع	quarter
الكيتشوا	Quechua
ملكة	queen
شخص مثلي	queer
شاذ	queer
غريب	queer
تساؤل	query
استفسار	query
مسألة	question
سؤال	question
طابور	queue
يصف طابور	queue
سريع	quick
بسرعة	quickly
هادئ	quiet
بهدوء	quiet
ورغان	quilt
بطانية	quilt
يستقيل	quit
كليًا	quite
تمامًا	quite
اختبار	quiz
عرض أسعار	quotation
اقتباس	quotation
سعر	quote
اقتباس	quote
أسعار	quotes
اقتباسات	quotes
أرنب	rabbit
سباق	race
سلالة	race
عرق	race
غيظ	rage
غضب	rage
مطر	rain
يرفع	raise
رفع	raised
جرى	ran
عشوائي	random
يتراوح	range
نطاق	range
سريع	rapid
بسرعة	rapidly
نادر	rare
نادرا	rarely
طفح جلدي	rash
متسرع	rash
فأر	rat
معدل	rate
في بدل	rather
معدل	ratio
عقلاني	rational
ني	raw
خام	raw
يكرر	re
يوصل	reach
وصل	reached
رد فعل	reaction
اقرأ	read
يقرأ	reading
مستعد	ready
جاهز	ready
حقيقي	real
واقعي	reality
يدرك	realize
فهم	realized
بالحقا	really
من التالي	rear
سبب	reason
منطقي	reasonable
معقول	reasonable
يتذكر	recall
يستدعي	recall
واصل	receipt
استلام	receipt
يستلم	receive
استلم	received
مؤخرا	recent
مؤخرا	recently
استقبال	reception
وصفة	recipe
متهور	reckless
تمييز	recognition
تعرف على	recognition
يميّز	recognize
يتعرّف	recognize
يوصي	recommend
ينصح بيه	recommended
تسجيل	record
يسجل	record
يرجّع	recover
يتعافى	recover
استعادة	recovery
مستطيل	rectangle
أحمر	red
يسترجع	redeem
يخلّص	redeem
التخليص	redemption
الفداء	redemption
ينقّص	reduce
مش لازم	redundant
زايد	redundant
يشير لـ	refer
مرجع	reference
يعكس	reflect
انعكاس	reflection
يمتنع	refrain
ثلاجة	refrigerator
يرجّع القيمة	refund
يرفض	refuse
رفض	refused
اعتبار	regard
بخصوص	regarding
بغض النظر	regardless
تحيات	regards
منطقة	region
يسجل	register
يندم	regret
عادي	regular
منتظم	regular
بانتظام	regularly
بشكل دوري	regularly
يرفض	reject
يتعلق بـ	relate
متعلق ب	related
علاقة	relationship
متعلق بـ	relative
نسبي	relative
أقارب	relatives
يسترخي	relax
إطلاق	release
حرّر	release
أطلق	release
تحرير	release
يحرّر	released
يطلق	released
مناسب	relevant
موثوق	reliable
إعفاء	relief
راحة	relief
يريّح	relieve
يخفّف	relieve
متطمن	relieved
مرتاح	relieved
عقيدة	religion
دين	religion
ديني	religious
متكاسل	reluctant
معارض	reluctant
يعتمد على	rely
يقعد	remain
الباقي	remaining
مميز	remarkable
يعالج	remedy
يتذكر	remember
يذكر	remind
تذكير	reminder
عن بعد	remote
ينحّي	remove
يحذف	remove
يخلّي	render
يقدّم خدمة	render
يستأجر	rent
يصلح	repair
يعاود	repeat
يبدّل	replace
رد	reply
يبلّغ	report
تقرير	report
يمثل	represent
سمعة	reputation
يطلب	request
يتطلب	require
مطلوب	required
ينقذ	rescue
بحث	research
يشبه	resemble
استياء	resentment
حجز	reservation
يحفظ	reserve
مقيم	resident
يستقيل	resign
مرونة	resilience
مرن	resilient
يقاوم	resist
مقاومة	resistance
دقة	resolution
يحل	resolve
يذوب	resolve
ملجأ	resort
منتجع	resort
مصادر	resources
موارد	resources
يحترم	respect
يجاوب	respond
يرد	respond
رد	response
إجابة	response
مسؤولية	responsibility
مسؤول	responsible
الباقي	rest
راحة	rest
الله يرحمه	rest in peace
مطعم	restaurant
يرجّع	restore
يقيّد	restrict
يحصر	restrict
نتيجة	result
نتائج	results
سيرة ذاتية	resume
ملخّص	resume
بيع قطاعي	retail
يحتفظ	retain
احتباس	retention
حفظ	retention
تقاعد	retired
ينسحب	retreat
نرجّع	retrieve
يرجع	return
يكشف	reveal
كشف	revealed
مكشوف	revealed
ثأر	revenge
ربح	revenue
يرجع التالي	reverse
يعكس	reverse
مراجعة	review
يراجع	review
يراجع	revise
مراجعة	revision
ثورة	revolution
مكافأة	reward
جائزة	reward
إيقاع	rhythm
ضلع	rib
أرز	rice
غني	rich
يحرّر	rid
يتخلّص من	rid
يركب	ride
سخيف	ridiculous
اليمين	right
صحيح	right
توا	right now
جامد	rigid
يابس	rigid
خاتم	ring
يمصمص	rinse
مضمضة فم	rinse
عصيان	riot
فوضى	riot
يمزّق	rip
طايب	ripe
ينوض	rise
يرتفع	rise
خطر	risk
منافس	rival
نهر	river
طريق	road
مشوي	roast
قوي	robust
صحي	robust
رشادة	rock
عصا	rod
صنارة	rod
دور	role
لفّة	roll
يلف	roll
سقف	roof
دار	room
جذر	root
حبل	rope
متعفّن	rotten
فاسد	rotten
قاسي	rough
بقسوة	roughly
تقريبا	roughly
دائري	round
جولة	round
مسار	route
روتين	routine
طابور	row
صف	row
يحُك	rub
مطاط	rubber
محّاية	rubber
كناسة	rubbish
كلام فاضي	rubbish
وقح	rude
سجادة	rug
يخرّب	ruin
قاعدة	rule
حكم	rule
مسطرة	ruler
حاكم	ruler
قواعد	rules
يجري	run
يشغّل	run
يجري	running
يشغل	running
ريفي	rural
يندفع	rush
كيسة	sack
مقدس	sacred
يضحي	sacrifice
آمن	safe
رحلة آمنة	safe flight
سلامة	safety
أمان	safety
حكيم	sage
قال	said
يبحر	sail
شراع	sail
رحلة بحرية	sailing
لمصلحة	sake
راتب	salary
تخفيض	sale
بيع	sale
سلمون	salmon
ملح	salt
نفسه	same
نفس الشيء هنا	Same here
عينة	sample
رملة	sand
السنسكريتية	Sanskrit
هازي	sarcastic
يتهكم	sarcastic
وقح	sassy
قعمز	sat
رضا	satisfaction
راضي	satisfied
يرضى	satisfy
مُرضي	satisfying
السبت	Saturday
مرقاز	sausage
همجي	savage
يحفظ	save
شاف	saw
يقول	say
حجم	scale
غش	scam
ندبة	scar
نادر	scarce
خايف	scared
وشاح	scarf
شال	scarf
مخيف	scary
مشرتع	scattered
مشهد	scene
منظر	scene
منظر طبيعي	scenery
ريحة	scent
يرتب	schedule
جدول زمني	schedule
مدرسة	school
علوم	science
عالم	scientist
علماء	scientists
مقص	scissors
يكشّخ	scold
نطاق	scope
مدى	scope
درجة	score
نتيجة	score
خردة	scrap
يخبّش	scratch
يعيّط	scream
شاشة	screen
دادو	screw
كتابة	script
سيناريو	script
بحر	sea
ختم	seal
يبحث	search
فصل	season
موسم	season
كرسي	seat
ثاني	second
سر	secret
قسم	section
قطاع	section
يضمن	secure
يأمن	secure
أمن	security
يشوف	see
نتلاقوا	see you
نتلاقوا بعدين	see you later
نتلاقوا قريبًا	see you soon
نتلاقوا غدوة	see you tomorrow
زريعة	seed
يدوّر	seek
وكأن	seem
شكله	seem
وكأن	seems
شكله	seems
شاف	seen
يقبض	seize
ينتهز	seize
استيلاء	seizure
نادر	seldom
يختار	select
نفس	self
شفاء ذاتي	self healing
أناني	selfish
يبيع	sell
يبعث	send
ابعتلي صورتك	send me your picture
كبير	senior
الأعلى منصبا	senior
حاسة	sense
إحساس	sense
رقيق	sensible
حساس	sensible
حساس	sensitive
بعث	sent
جملة	sentence
جمل	sentences
يفصل	separate
يفرق	separate
سيبيدي	Sepedi
سبتمبر	september
تسلسل	sequence
مسلسل	series
سلسلة	series
جدي	serious
بجديات	seriously
يخدم	serve
خدمة	service
جلسة	session
يعين	set
يحط	set
طقم	set
يثبت	set up
ضبط	setting
جلسة	setting
استقر	settle
حل	settle
سبعة	seven
سبعطاش	seventeen
سبعين	seventy
هلبا	several
حاد	severe
خياطة	sew
أص	sh
ظل	shade
ظل	shadow
يهز	shake
يخض	shake
حـ	shall
سطحي	shallow
أجوف	shallow
عار	shame
شكل	shape
هيئة	shape
يشارك	share
حاد	sharp
هي	she
عندها	she has
هي	she is
كوخ	shed
خروف	sheep
صحيفة	sheet
لوح	sheet
شيت	sheet
رف	shelf
صدفة	shell
قذيفة	shell
مأوى	shelter
درع	shield
ورديّة	shift
يحوّل	shift
مشرق	shine
سفينة	ship
شحن بحري	shipping
قميص	shirt
أحذية	shoes
يطلق طلقة	shoot
يصوب	shoot
يصور	shoot
محل	shop
تسوّق	shopping
شط	shore
قصير	short
نقص	shortage
يصور	shot
تجربة	shot
يجرب	shot
طلقة	shot
يطلق طلقة	shot
صورة	shot
لازم	should
كتف	shoulder
يعيّط	shout
عرض	show
يورّي	show
وريني	show me
دوش	shower
جمبري	shrimp
ينكمش	shrink
يسكّر	shut
اسكت	shut up
يتحشم	shy
خوت وخوات	sibling
خوت	siblings
مريض	sick
جانب	side
تنهيدة	sigh
رؤية	sight
مشهد	sight
زيارة المعالم السياحية	sightseeing
لافتة	sign
علامة	sign
توقيع	signature
ذو أهمية	significant
سكوت	silence
صامت	silent
حرير	silk
سخيف	silly
فضة	silver
شبيه	similar
مغفل	simp
بسيط	simple
تلقائي	simultaneously
بما إن	since
من هداكا الوقت	since
مخلص	sincere
بأمانة	sincerely
يغني	sing
مغنّي	singer
أعزب	single
يغرق	sink
غرق	sink
سيد	Sir
أخت	sister
حمي	sister in law
نسيبة	sister in law
يقعمز	sit
موقع	site
حالة	situation
موقف	situation
ستة	six
سطاش	sixteen
ستين	sixty
حجم	size
مهارة	skill
مهارات	skills
بشرة	skin
ضعيف	skinny
يتخطى	skip
قونة	skirt
سماء	sky
عبد	slave
يرقد	sleep
نوم	sleeping
نعسان	sleepy
كُم	sleeve
شريحة	slice
يشرّح	slice
تزلج	slide
يتزحلق	slide
طفيف	slightly
ضعيف	slim
يزلق	slip
ميل	slope
فتحة	slot
شق	slot
بطيء	slow
ببطء	slowly
صغير	small
ذكي	smart
يشم	smell
ريحة	smell
ابتسامة	smile
يبتسم	smile
دخان	smoke
سلس	smooth
ناعم	smooth
وجبة خفيفة	snack
بازوزي	snail
لفعة	snake
فرقعة	snap
صورة سريعة	snap
ثلج	snow
لذلك	so
لطيف جدًا	so cute
لتوا	so far
ينقّع	soak
صابون	soap
رزين	sober
كرة القدم	soccer
اجتماعي	social
مجتمع	society
جوارب	socks
ناعم	soft
برمجة	software
تراب	soil
انباع	sold
انباع	sold out
جندي	soldier
عسكري	soldier
بطن الرجل	sole
متماسك	solid
صلب	solid
محلول	solution
حل	solution
يحل	solve
يذوب	solve
بعض	some
شخص	somebody
بأي طريقة	somehow
شخص	someone
شيء	something
مرّات	sometimes
أغنية	song
قريبًا	soon
متطور	sophisticated
الكردي	Sorani
ملتهب	sore
يوجع	sore
التهاب حلق	sore throat
حزن	sorrow
أسف	sorrow
آسف	Sorry
نوع	sort
يفرز	sort
طلب	sought
بحث	sought
روح	soul
توأم الروح	soulmate
حبيب	soulmate
صوت	sound
شربة	soup
حامض	sour
مصدر	source
جنوب	south
فضاء	space
مكان	space
رسائل إلكترونية مزعجة	spam
امتداد	span
شبر	span
إسبانية	Spanish
احتياطي	spare
يتكلم	speak
خاص	special
أصناف	species
محدد	specific
مشهد رائع	spectacular
حديث	speech
كلام	speech
عاجز على الكلام	speechless
سرعة	speed
يتهجى	spell
يسحر	spell
ينفق	spend
يقضّي	spend
صرف	spent
قضّى	spent
حار	spicy
فيه بهارات	spicy
مسمار	spike
يلف	spin
ينسج	spin
سبانخ	spinach
روح	spirit
يدفل	spit
رائع	splendid
قسم	split
شق	split
يفسّد	spoil
غنيمة	spoil
مدّلع	spoiled
عفوي	spontaneous
تلقائي	spontaneous
كاشيك	spoon
نقطة	spot
بقعة	spot
زوجة	spouse
ينشر	spread
الربيع	spring
مربع	square
يعصر	squeeze
حبار	squid
سنجاب	squirrel
شارع	st
يطعن	stab
مستقر	stable
ثابت	stable
كومة	stack
مدخنة	stack
الموظفين	staff
منصة	stage
مسرح	stage
بقعة	stain
دروج	stairs
وتد	stake
ساق النبات	stalk
كشك	stall
يماطل	stall
ختم	stamp
منصة	stand
يوقف	stand
مقياس	standard
معيار	standard
نجمة	star
يبدأ	start
بدي	started
ميت بالجوع	starving
وضّح	state
ولاية	state
صرّح	state
إفادة	statement
محطة	station
تمثال	statue
حالة	status
يقعد	stay
خليك في أمان	stay safe
مستقر	steady
شريحة لحم	steak
يخنب	steal
بخار	steam
ستيل	steel
ينقّع	steep
انحدار	steep
ينبع	stem
جذع	stem
خطوة	step
عصا	stick
قاسي	stiff
يابس	stiff
ما زال	still
يلدغ	sting
عقرب	sting
يلسع	sting
بخيل	stingy
يقلب	stir
يحرك	stir
مخزون	stock
رصيد	stock
مخنوب	stolen
معدة	stomach
رشادة	stone
وقف	stood
مقعد	stool
براز	stool
توقف	stop
تخزين	storage
مخزن	store
محل	store
عاصفة	storm
قصة	story
غاز الكوشة	stove
مستقيم	straight
صريح	straightforward
سلالة	strain
غريب	strange
غريب	stranger
استراتيجية	strategy
مصاصة	straw
فراولة	strawberry
شريط	streak
أثر	streak
تدفق	stream
تيار	stream
شارع	street
قوة	strength
توتر	stress
ضغط	stress
يتمدد	stretch
متشدد	strict
يضرب	strike
خيط	string
شريط	strip
يتعرى	strip
يجرد	strip
يجتهد	strive
يسعى	strive
ضربة	stroke
سكتة دماغية	stroke
قوي	strong
صعق	struck
ضرب	struck
هيكلية	structure
مقاومة	struggle
كفاح	struggle
يكافح	struggle
يقاوم	struggle
يكافح	struggling
عنيد	stubborn
عالق	stuck
طالب	student
دراسة	study
يدرس	study
يقرا	studying
شيء	stuff
رائع	stunning
غبي	stupid
أسلوب	style
موضوع	subject
استسلام,تسليم	submission
يقدّم	submit
مادة	substance
جوهر	substance
بديل	substitute
بارع	subtle
دقيق	subtle
نجح	succeed
نجاح	success
ناجح	successful
زي	such
زي	such as
يرضع	suck
يمص	suck
فجأة	sudden
فجأة	suddenly
يعاني	suffer
يعاني	suffering
كافي	sufficient
سكر	sugar
يقترح	suggest
اقتراح	suggestion
مناسب	suit
مناسب	suitable
شنطة سفر	suitcase
مبلغ	sum
مجموع	sum
خلاصة	summary
صيف	summer
قمة	summit
شمس	sun
الأحد	sunday
مشمس	sunny
الغروب	sunset
الشروق	sunshine
ممتاز	super
أرقى	superior
متفوق	superior
مشرف	supervisor
عشاء	supper
يوفر	supply
يزوّد	supply
يدعم	support
يفترض	suppose
افترض	supposed
أكيد	sure
سطح	surface
موجة	surge
طفرة	surge
جراحة	surgery
اللقب	surname
مفاجأة	surprise
يفاجيء	surprised
يستسلم	surrender
محيط	surrounding
مراقبة	surveillance
استطلاع	survey
يقعد عايش	survive
مشبوه	suspect
معلّق	suspended
مشكوك فيه	suspicious
يتحمل	sustain
يحافظ على	sustain
استدامة	sustainability
مستدام	sustainable
صرّة حوايج	swag
مقدار	swag
غنيمة	swag
يبلع	swallow
تبادل	swap
يحلف	swear
يعرق	sweat
عرق	sweat
فانيليا	sweater
يكنس	sweep
حلو	sweet
أحلام سعيدة	sweet dreams
يحب الحلويات	sweet tooth
حبيبة	sweetheart
تضخم	swell
متورّم	swelling
يعوم	swim
عوامة	swimming
يتدرجح	swing
درجيحة	swing
تاكو	switch
يحول	switch
متورم	swollen
سيف	sword
رمز	symbol
رحمة	sympathy
عطف	sympathy
أعراض	symptoms
نظام	system
طاولة	table
يواجه	tackle
عدّة لمهمة معينة	tackle
بطاقة شعار	tag
يشير لـ	tag
ذيل	tail
يأخذ	take
يأخذ بعيد	take away
ياخذ الطلبية برا المطعم	take away
اهتم بــ	take care
يقلع	take off
يطير	take off
مأخوذ	taken
كلام	talk
يتكلم	talk
يدوي هلبا	talkative
طويل	tall
شيشمة	tap
اضغط	tap
شريط	tape
يهدف إلى	target
هدف	target
مهمة	task
ذوق	taste
يذوق	taste
لذيذ	tasty
طعمته حلوة	tasty
علّم	taught
شاهي	tea
يعلم	teach
يدرس	teach
أستاذ	teacher
فريق	team
يقطّع	tear
يمزق	tear
دموع	tears
يسلّك	tease
يغيظ	tease
تقنية	technology
أسنان	teeth
يقول	tell
قولّي	tell me
حِدّة	temper
مزاج	temper
خلوق	temper
درجة حرارة	temperature
معبد	temple
مؤقت	temporary
عشرة	ten
عشرة آلاف	ten thousand
مستأجر	tenant
يميل	tend
يصون	tend
ميول	tendency
حنون	tender
عطاء	tender
زمن الفعل	tense
متوتر	tense
توتر	tension
خيمة	tent
متردد	tentative
تجريبي	tentative
شرط	term
بنود	terms
رهيب	terrible
هائل	terrific
مخيف	terrific
أراضي	territory
منطقة	territory
يختبر	test
اختبار	test
نص	text
من غير	than
من	than
شكرا	thank
شكرا	thank you
شكرا على صبرك في وقت تفتيش الشحنة	Thank you for your patience while we investigate shipment
شكرا جزيلا	thank you so much
شكرا جزيلا	thank you very much
شكرا	thanks
شكرا لاستخدام تطبيقنا	Thanks for using our app
هداكا	that
إنّ	that
هديكا	that
هداكا	that is
هذا	that is
كويس	that's good
ال	the
خنبة	theft
متاعهم	their
هما	them
الفكرة	theme
الموضوع	theme
نفسهم	themselves
بعدين	then
نظرية	theory
غادي	there
فيه	there are
فيه	there is
فلهذا	therefore
هادم	these
هما	they
هما	they are
غليظ	thick
خانب	thief
فخذ	thigh
رقيق	thin
شيء	thing
حاجات	things
يفكّر	think
يعتقد	think
ثالث	third
عطشان	thirsty
ثلاثين	thirteen
ثلاثين	thirty
هذا	this
هذا	this is
شامل	thorough
عميق	thorough
تماما	thoroughly
هادم	those
رغم أن	though
فكر	thought
تفكيرعميق	thoughtful
مدروس	thoughtful
أفكار	thoughts
ألف	thousand
خيط	thread
تهديد	threat
يهدّد	threaten
ثلاثة	three
عتبة	threshold
يرعش	thrilled
يثير	thrilled
يكبر	thrive
ينمو	thrive
حلق	throat
من خلال	through
طوال	throughout
يرمي	throw
إبهام	thumb
رعد	thunder
الخميس	Thursday
فلهذا	thus
قراد	tick
مد وجزر	tide
مرتب	tidy
منظم	tidy
قرواطة	tie
يربط	tie
نمر	tiger
متماسك	tight
التيغرينيا	Tigrinya
وقت	time
خجول	timid
صغير	tiny
نصيحة	tip
طرف	tip
نصائح	tips
تعب	tire
تعبان	tired
نسيج	tissue
كلينكس	tissue
عنوان	title
لقب	title
إلى	to
يكون	to be
توست	toast
اليوم	today
عيّل	toddler
صوابع الرجلين	toes
مع بعض	together
حمام	toilet
قال	told
تسامح	tolerance
يسامح	tolerate
طماطم	tomato
غدوة	tomorrow
لغة	tongue
لسان	tongue
الليلة	tonight
أيضا	too
خذي	took
أداة	tool
أدوات	tools
سن	tooth
قمة	top
موضوع	topic
يمزّق	torn
تعذيب	torture
المجموع	total
يمس	touch
قاسي	tough
يابس	tough
دورة	tour
لفّة	tour
تجاه	toward
باتجاه	towards
فوطة	towel
مدينة	town
سام	toxic
أثر	trace
مسار	track
ممر	track
تجارة	trade
تقليد	tradition
تقليدي	traditional
حركة المرور	traffic
ذيل	trail
أثر	trail
قطار	train
تدريب	training
ميزة	trait
ميزات	traits
يرسل	transfer
يحول	transfer
نقل	transition
يترجم	translate
شفاف	transparent
صريح	transparent
نقل	transport
نقل	transportation
فخ	trap
كناسة	trash
فاجعة	trauma
صدمة	trauma
يسافر	travel
صونية	tray
كنز	treasure
يعامل	treat
يعالج	treat
علاج	treatment
معالجة	treatment
شجرة	tree
ضخم	tremendous
اتجاه	trend
محاكمة	trial
تجربة	trial
محاولة	trial
خدعة	trick
حاول	tried
يشعل	trigger
زند البندقية	trigger
يهذب	trim
يقص	trim
رحلة	trip
مشكلة	trouble
سروال	trousers
طانطة	truck
حقيقي	true
جذع	trunk
صندوق	trunk
يثق	trust
ثقة	trust
حقيقة	truth
يحاول	try
تسونجا	Tsonga
طوبو	tube
الثلاثاء	Tuesday
تدريس	tuition
ديك رومي	turkey
تركيا	turkey
كركم	turmeric
يدور	turn
سلحفاة	turtle
مدرس خصوصي	tutor
حداش	twelve
عشرين	twenty
واحد وعشرين	twenty-one
لهجة توي	Twi
مرتين	twice
يلوي	twist
يحرّف	twist
اثنين	two
نوع	type
مثالي	typical
نموذجي	typical
شين	ugly
نهائي	ultimate
أقصى	ultimate
سحابة	umbrella
مش قادر	unable
عم	uncle
خال	uncle
مش واعي	unconscious
تحت	under
تحت	underneath
مش واخذ حقّه	underrated
يفهم	understand
مفهوم	understood
للأسف	unfortunately
زي رسمي	uniform
مميز	unique
وحدة	unit
جامعة	university
مش معروف	unknown
إلا إذا	unless
حتى	until
مش عادي	unusual
فوق	up
زي ما تبي	up to you
تحديث	update
تحديث	upgrade
تطوير	upgrade
على	upon
منزعج	upset
حضري	urban
ينق	urge
نقّان	urge
مستعجل	urgent
نحن	us
يستخدم	use
استخدام	use
مستعمل	used
استعمل	used
مفيد	useful
بلا فائدة	useless
معتاد	usual
عادةً	usually
فائدة	utility
منفعة	utility
عطلة	vacation
إجازة	vacation
تطعيم	vaccination
تطعيمة	vaccine
مكنسة كهربائية	vacuum
فراغ	vacuum
مبهم	vague
غامض	vague
صالح	valid
وادي	valley
غالي	valuable
قيم	valuable
قيمة	value
تنوع	variety
متنوع	various
يتنوع	vary
يتغير	vary
مزهرية	vase
واسع	vast
خضرة	vegetable
خضروات	vegetables
عربة	vehicle
مركبة	vehicle
بائع	vendor
سم	venom
مغامرة	venture
مكان	venue
يؤكد	verify
يتأكد من	verify
متعدد الاستخدامات	versatile
نسخة	version
عمودي	vertical
هلبا	very
جيد جدا	very good
سفينة	vessel
عن طريق	via
بـ	via
اهتزاز	vibe
أجواء	vibes
وحشي	vicious
ضحية	victim
فيديو	video
يشوف	view
منظر	view
قرية	village
حقير	villain
شرير	villain
خل	vinegar
كلاسيكي	vintage
خمر	vintage
عنف	violence
عنيف	violent
منتشر	viral
عدوى فيروس	viral
بكر	virgin
عذراء	virgin
افتراضي	virtual
فضيلة	virtue
رؤية	vision
زيارة	visit
يزور	visit
مرئي	visual
حيوي	vital
فاقع	vivid
واضح	vivid
مفردات	vocabulary
صوت	voice
ملغي	void
حجم	volume
متطوع	volunteer
يرجّع	vomit
ضعيف	vulnerable
أجر	wage
رواتب	wages
خصر	waist
يستنى	wait
قرصون	waiter
يستنى	waiting
ينوض	wake
ينوض	wake up
يمشي	walk
يمشي	walking
حيط	wall
سور	wall
محفظة	wallet
تجول	wander
نبّي	wanna
يبّي	want
مطلوب	wanted
حرب	war
دولاب	wardrobe
مخزن	warehouse
يدفيء	warm
دافي	warm
يحذر	warn
تحذير	warning
محارب	warrior
كان	was
يغسل	wash
كناسة	waste
يضيّع	waste
يتفرج	watch
ماء	water
دلّاع	watermelon
موجة	wave
يحيي بيده	wave
طريقة	way
طريق	way
حني	we
حني	we are
نقدروا	we can
ضعيف	weak
ضعف	weakness
ثروة	wealth
غني	wealthy
يلبس	wear
يلبس	wearing
طقس	weather
زواج	wedding
الأربعاء	Wednesday
طحلب	weed
أسبوع	week
نهاية أسبوع	weekend
وزن	weight
يوزن	weight
غريب	weird
مرحبا	welcome
رعاية	welfare
كويس	Well
طايب كويس	well done
ممتاز	well done
مشي	went
كان	were
غرب	west
مبلول	wet
حوت	whale
شن	what
وأنت شن	what about you
شن تدير	what are you doing
شن تدير توا	what are you doing now
شن تدير توا	what are you doing right now
شن تدير	what do you do
شن تخدم؟	what do you do for a living
شن تقصد	what do you mean
أنت شن تبي	what do you want
شن صار	what happened
ما هو	what is
شن هذا	what is this
شن تخدم	what is your job
شن اسمك	what is your name
شن الجو	what's up
شن اسمك؟	what's your name
أي حاجة	whatever
قمح	wheat
عجلة	wheel
امتى	when
أي  وقت	whenever
وين	where
وين أنت؟	where are you
من وين أنت	where are you from
وين أنت توا	where are you now
وين تسكن؟	where do you live
وين	where is
في حين	whereas
سواء	whether
اللي	which
أما	which
في حين	while
يوشوش	whisper
صفارة	whistle
أبيض	white
من	who
من أنت	who are you
من هو	who is
من هذا	who is this
جميع	whole
من	whom
لمن	whose
اللي	whose
علاش	why
علاش لا	why not
خبيث	wicked
واسع	wide
أرملة	widow
عرض	width
زوجة	wife
همجي	wild
برّي	wild
رغبة	will
حـ	will
راغب	willing
يربح	win
ريح	wind
روشن	window
الجو ريح	windy
خمر	wine
شتاء	winter
يمسح	wipe
كلينكس	wipe
فوطة	wipe
سلك	wire
حكمة	wisdom
عاقل	wise
يرغب	wish
رغبة	wish
نتمنالك الأفضل	wish you all the best
سحّارة	witch
بـ	with
مع	with
يسحب	withdraw
يسحب	withdrawal
يتراجع	withdrawal
ضمن	within
بدون	without
شاهد	witness
يشهد	witness
ذكي	witty
ذيب	wolf
امرأة	woman
امرأة	women
ربح	won
مش حـ	won't
يتعجب	wonder
رائع	wonderful
لوح	wood
صوف	wool
كلمة	word
كلمات	words
يعمل	work
عمل	work
يتدرب	work out
يشتغل	working
يخدم	working
العالم	world
دودة	worm
لبس	worn
بايدة	worn
قالق	worried
قلق	worry
أسوأ	worse
يعبد	worship
يقدس	worship
أسوأ	worst
يستاهل	worth
يستاهل	worth it
يستاهل	worthy
يبّي	would
جرح	wound
ياله من!	Wow
لف	wrap
غلاف	wrap
غيظ	wrath
غضب	wrath
رسغ	wrist
يكتب	write
اكتب هنا	Write here
كتابة	writing
مكتوب	written
خطأ	wrong
كتب	wrote
جنان	yard
يتتاوب	yawn
إيه	Yeah
سنة	year
سنوات	years
خميرة	yeast
يعيّط	yell
أصفر	yellow
إيه	Yes
نعم حبيبي	yes baby
إيه يا عزيزي	yes dear
نعم حبي	yes honey
نعم حبي	yes my love
إيه أكيد	yes of course
أمس	yesterday
مازال	yet
لتوا	yet
المنتوج	yield
أنت	you
أنت	you are
أنت جميلة	you are beautiful
أنت حلوة هلبا	you are so beautiful
العفو	you are welcome
تقدر	you can
أنت تعرف	You know
حتى أنت	you too
العفو	you're welcome
صغير	young
شاب	young
متاعك	your
العفو	your welcome
نفسك	yourself
شباب	youth
العفو	you’re welcome
لذيذ	yummy
طعمته حلوة	yummy
صفر	zero
