бер аҙ	a little
күп	a lot
күп	a lot of
ҡалдырырға	abandon
ташландыҡ	abandoned
түҙергә	abide
йәшәргә	abide
һәләт	ability
булдыҡлы	able
турала	about
өҫтә	above
сит илгә	abroad
юҡлыҡ	absence
юҡлыҡ	absent
бөтөнләй	absolutely
һеңдерергә	absorb
абстракт	abstract
ҡыҫҡаса йөкмәтке	abstract
мәғәнәһеҙ	absurd
муллыҡ	abundance
мул	abundant
самаһыҙ файҙаланыу	abuse
самаһыҙ файҙаланырға	abuse
акцент	accent
килешергә	accept
инегә	access
инеү	access
бәлә-ҡаза	accident
урынлаштырыу	accommodation
ирешергә	accomplish
башҡарылған	accomplished
буйынса	according
аккаунт	account
иҫәп яҙмаһы	account
аныҡлыҡ	accuracy
теүәл	accurate
ғәйепләнеүсе	accused
ауыртыу	ache
ауырырға	ache
ирешергә	achieve
ҡаҙаныш	achievement
күнәтләргә	acknowledge
танышыу	acquaintance
ҡаҙанырға	acquire
һатып алынған	acquired
һатып алыу	acquisition
арҡыры	across
эш-ҡылыҡ	act
ғәмәл	action
иткер	active
эшмәкәрлек	activities
әүҙемлек	activity
актёр	actor
ысын	actual
фактик	actual
ысынбарлыҡта	actually
ныҡ	acute
ябайлаштырырға	adapt
ҡушырға	add
бәйле	addicted
өҫтәмә	addition
өҫтәмә	additional
адрес	address
адресларға	address
адекват	adequate
эргәләш	adjacent
сифат	adjective
килештерергә	adjust
һоҡланырға	admire
танырға	admit
балалыҡҡа алырға	adopt
һоҡланғыс	adorable
күтәрелеү	advance
алдағыртырға	advance
алдынғы	advanced
өҫтөнлөк	advantage
мажара	adventure
рәүеш	adverb
реклама	advertisement
реклама	advertising
кәңәш	advice
кәңәш бирергә	advise
яҡлаусы	advocate
яҡларға	advocate
эстетик	aesthetic
бәйләнеш	affair
эш	affair
йоғонтоларға	affect
зарарланыу	affection
эйәләшеү	affection
мөмкинлек бар	afford
арзан	affordable
ҡурҡыу	afraid
һуң	after
төштән һуң	afternoon
шунан	afterwards
тағы	again
ҡаршы	against
ҡартайырға	age
йәш	age
агентлыҡ	agency
агент	agent
баҫҡынсылыҡ	aggressive
теремек	agile
элек	ago
риза булырға	agree
килешеү	agreement
игенселек	agriculture
алда	ahead
ярҙам	aid
маҡсат	aim
һауа	air
аэропорт	airport
рәт араһы	aisle
уятҡыс	alarm
сигнализация	alarm
алкоголь	alcohol
уяу	alert
тере	alive
бөтә	all
ярай	all right
иҙге теләктәр	all the best
рөхсәт итергә	allow
рөхсәт ителгән	allowed
яҡын	almost
бер үҙе	alone
буйлап	along
инде	already
Ярай	Alright
шулайҙа	also
альтернатив	alternative
уға ҡарамаҫтан	although
һәр ваҡыт	always
ғәжәп	amazing
ике мәғәнәле	ambiguous
егәр	ambition
сәм	ambition
маҡсатҡа ынтылышлы	ambitious
төҙәтергә	amend
араһында	amid
араһында	among
беҙҙең арабыҙҙа	among us
һан	amount
ҡыҙыҡлы	amusing
анализ	analysis
ата-бабалары	ancestors
якорь	anchor
боронғо	ancient
һәм	and
һеҙгә лә	and you
фәрештә	angel
уҫаллыҡ	anger
мөйөш	angle
уҫал	angry
хайуан	animal
бәкәл	ankle
йыллығы	anniversary
иғлан	announcement
асыуландырырға	annoy
ярһыулы	annoyed
асыу килтергес	annoying
йыл һайын	annual
аноним	anonymous
икенсе	another
яуап бирергә	answer
яуап	answer
алдан күрергә	anticipate
шом	anxiety
борсоулы	anxious
теләһә ниндәй	any
башҡаса түгел	anymore
кем дә булһа	anyone
берәй нәмә	anything
һәр хәлдә	anyway
һәр хәлдә	anyways
айырым	apart
фатир	apartment
ғәфү үтенергә	apologize
ихтимал	apparent
моғайын	apparently
күңелгә ятырға	appeal
мөрәжәғәт итергә	appeal
күренергә	appear
килеү	appearance
ҡиәфәт	appearance
килеп сыҡҡан	appeared
кеүек күренгән	appeared
аппетит	appetite
алма	apple
приложение	application
ҡулланыу	application
ҡулланырға	apply
ғариза тапшырырға	apply
вазифаһына тәғәйенләү	appointment
күрешеү	appointment
ҡәҙерен белергә	appreciate
рәхмәт белдереү	appreciation
эргәгә килергә	approach
мөнәсәбәт	approach
тейешле	appropriate
хуплау	approval
раҫларға	approve
хупланған	approved
яҡынса	approximately
апрель	april
ирекле	arbitrary
архитектор	architect
архитектура	architecture
архив	archive
һин	are you
һин бушайыңмы	are you busy
һин өйләнгәнһеңме	are you married
һин өйләнгәнме әллә яңғыҙмы	are you married or single
Һин һаман ундамы?	Are you still there?
һин ундамы	are you there
ер	area
һүҙ көрәштергә	argue
бәхәс	argument
дәлил	argument
барлыҡҡа килергә	arise
ҡул	arm
ғәскәр	army
тирәләй	around
ойошторырға	arrange
урынлашыу	arrangement
килеү	arrival
килергә	arrive
килгән	arrived
тәкәббер	arrogant
уҡ	arrow
сәнғәт	art
мәҡәл	article
яһалма	artificial
рәссам	artist
һымаҡ	as
сөнки	as
шулай уҡ	as well
һәм . да	as well as
көл	ash
оялсан	ashamed
һорарға	ask
һораған	asked
йоҡоған	asleep
аспект	aspect
ассам теле	Assamese
һөжүм	assault
йыйылыш	assembly
раҫлаусы	assertive
баһалау	assess
баһалау	assessment
актив	asset
активтар	assets
тәғәйенләргә	assign
бирем	assignment
ярҙам итергә	assist
ярҙамсы	assistant
бәйләргә	associate
иптәш	associate
бәйләнгән	associated
ассоциация	association
берекмә	association
иҫәпләргә	assume
алдан самалау	assumption
һәр хәлдә	at least
ашанған	ate
спортсы	athlete
беркетергә	attach
йәбештерергә	attach
беркетеп ҡуйылған	attached
бәйлелек	attachment
һөжүм	attack
һынап ҡарарға	attempt
маташыу	attempt
килеп сығырға	attend
килеүселәр	attendance
иғтибар	attention
ҡараш	attitude
мөнәсәбәт	attitude
йәлеп итергә	attract
һөйкөмлөлөк	attraction
яғымлы	attractive
билдә	attribute
аныҡлаусы	attribute
аудитория	audience
август	august
апай	aunt
әбей	aunt
апаҡай	aunty
ысын	authentic
яҙыусы	author
хакимлыҡ	authority
көҙ	autumn
асыҡ	available
уртаса	average
ҡасырға	avoid
уянған	awake
бүләк	award
белеү	aware
белемлелек	awareness
ситкә	away
бик шәп	awesome
ҡот осҡос	awful
уңайһыҙ	awkward
аймара теле	Aymara
бала	baby
буйҙаҡ	bachelor
бакалавр	bachelor
арҡа	back
кире	back
ерлек	background
яман	bad
сумка	bag
тоҡ	bag
алдатҡыс	bait
бешерергә	bake
икмәкхана	bakery
аҙыҡ содаһы	baking soda
тигеҙлек тоторға	balance
тигеҙлек	balance
бейеу кисәһе	ball
туп	ball
бамбара теле	Bambara
банан	banana
таҫма	band
төркөм	band
һуғыу	bang
яр	bank
банк	bank
киҫәк	bar
бар	bar
рәшәткә	bar
саҡ ҡына	barely
сауҙалашырға	bargain
өрөргә	bark
өрөү	bark
арпа	barley
барьер	barrier
база	base
нигеҙләнергә	base
нигеҙләнгән	based
иҙән аҫты	basement
Башҡорт	Bashkir
башланғыс	basic
асылда	basically
базилик	basil
әҙәм аҡтығы	bastard
партия	batch
ванна	bath
ванна бүлмәһе	bathroom
батарея	battery
һуғыш	battle
ҡултыҡ	bay
булырға	be
һаҡ бул	be careful
яр	beach
балҡырға	beam
нур	beam
бөртөксәләр	beans
түҙергә	bear
айыу	bear
һаҡал	beard
сабырлыҡ	bearing
йөрөтөү	bearing
уңыш	bearing
йәнлек	beast
тибеш	beat
туҡмарға	beat
матур	beautiful
матурлыҡ	beauty
булған	became
сөнки	because
булырға	become
карауат	bed
йоҡо бүлмәһе	bedroom
бал ҡорто	bee
һыйыр ите	beef
булған	been
һыра	beer
башта	before
тиклем	before
башлаған	began
башларға	begin
баш	beginning
исеменән	behalf
үҙ-үҙеңде тоторға	behave
ҡылыҡ	behavior
тәртип	behaviour
артында	behind
булыу	being
иман	belief
ышанырға	believe
эс	belly
кемдерҙеке булырға	belong
һөйәр	beloved
аҫтында	below
билбау	belt
эскәмйә	bench
бөгөргә	bend
аҫтында	beneath
файҙа	benefit
файҙа алырға	benefit
файҙалары	benefits
эргәһендә	beside
башҡа	besides
иң яҡшыһы	best
уңыштар	best of luck
ихтирам менән	best regards
яҡшыраҡ	better
араһында	between
эсемлек	beverage
буйында	beyond
бходжпури теле	Bhojpuri
хөрәфәт	bias
яғымлы	biased
велосипед	bicycle
тәҡдим иткән хаҡы	bid
сауҙала ҡатнашырға	bid
ҙур	big
велосипед	bike
иҫәп	bill
бәйләргә	bind
ҡош	bird
тыуған көн	birthday
киҫәк	bit
киҫәк	bite
тешләргә	bite
асы	bitter
ҡара	black
йөҙ	blade
ғәйепләргә	blame
ғәйеп	blame
буш	blank
юрған	blanket
шартлау	blast
ағартыу	bleach
бергә ҡушырға	blend
фатиха бирергә	bless
фатиха алған	blessed
һуҡыр	blind
ләззәт	bliss
ҡамасауларға	block
ҡан	blood
сәскә атырға	bloom
өрөргә	blow
шартлатырға	blow
күк	blue
тупаҡ	blunt
таҡта	board
кәмә	boat
тән	body
ҡайнарға	boil
ҡыйыу	bold
бәйләнеш	bond
һөйәк	bone
бронләргә	book
китап	book
көсәйтеү	boost
көсәйтергә	boost
көсәйткес	booster
ботинка	boot
итек	boots
сик	border
бырауларға	bore
арыған	bored
ҡыҙыҡ түгел	boring
тыуған	born
бурысҡа алырға	borrow
етәксе	boss
икеһе лә	both
борсорға	bother
шешә	bottle
төп	bottom
һатып алған	bought
һикерергә	bounce
сик	bound
сиктәр	boundaries
ян	bow
баш эйергә	bow
сеүәтә	bowl
бокс	box
ҡумта	box
малай	boy
егет	boyfriend
беләҙек	bracelet
мейе	brain
ботаҡ	branch
марка	brand
тамға	brand
батыр	brave
тәртип боҙоу	breach
икмәк	bread
емерергә	break
тәнәфес	break
иртәнге аш	breakfast
түш	breast
тын	breath
тын алырға	breathe
тоҡом	breed
кирбес	brick
кәләш	bride
күпер	bridge
ҡыҫҡаса	brief
сағыу	bright
бик шәп	bright
ҡупшы	brilliant
килтерегә	bring
иптәш	bro
киң	broad
трансляция яһарға	broadcast
ярлы	broke
һынған	broken
һепертке	broom
ағай	brother
ҡусты	brother
ҡайнаға	brother in law
еҙнә	brother in law
бажа	brother in law
алып килгән	brought
көрән	brown
щётка	brush
эләктерергә	brush
биҙрә	bucket
дуҫ	buddy
бюджет	budget
ҡуңыҙ	bug
төҙөргә	build
бина	building
төҙөлгән	built
күпселек өлөшө	bulk
үгеҙ	bull
хулиган	bully
шешек	bump
тошоғорға	bump
бәйләм	bunch
шәлкем	bundle
ауырлыҡ һалырға	burden
ауырлыҡ	burden
ерләнгән	buried
яндырыға	burn
бешкән урын	burn
шартларға	burst
ерләргә	bury
автобус	bus
ҡыуаҡ	bush
бизнес	business
эш	business
бюст	bust
буш түгел	busy
бәлки	but
май	butter
күбәләк	butterfly
төймә	button
һатып алырға	buy
янында	by
әйткәндәй	by the way
хуш бул	bye
кәбеҫтә	cabbage
шкаф	cabinet
ситлек	cage
торт	cake
быҙау	calf
шылтырауы	call
шылтыратырға	call
шылтырат әле миңә	call me
шалтыратҡан	called
исемләргән	called
баҫалҡы	calm
килгән	came
кампания	campaign
оҫталыҡ	can
алырға	can
эшләй алмайым	can't
Юҡҡа сығарырға	Cancel
рак	cancer
һәләтле	capable
һыйымлыҡ	capacity
баш ҡалаһы	capital
яҙыу	caption
баҫып алырға	capture
автомобиль	car
карьера	career
һаҡ	careful
иғтибар менән	carefully
абайһыҙ	careless
хәстәрлекле	caring
балта оҫтаһы	carpenter
келәм	carpet
кишер	carrot
ташырға	carry
дауам итергә	carry on
яһарға	carry out
хәл	case
килеш	case
ҡулаҡса	cash
ташларға	cast
һарай	castle
көндәге	casual
бесәй	cat
тоторға	catch
категория	category
мал	cattle
тотҡан	caught
саҡырырға	cause
сәбәп	cause
һаҡлыҡ	caution
һаҡ	cautious
мәмерйә	cave
туҡтарға	cease
түшәм	ceiling
байрам итергә	celebrate
күҙәнәк	cell
ситлек	cell
үҙәк	center
быуат	century
ярма	cereal
ашлыҡ	cereal
тантана	ceremony
билдәле	certain
һис шикһеҙ	certainly
сертификат	certificate
сип	chain
ултырғыс	chair
ҡаршы сығырға	challenge
ҡаршы	challenge
өмөт	chance
ҡайтарылған аҡса	change
алмаштырырға	change
кейем алмаштырырға	change
хаос	chaos
холоҡ	character
персонаж	character
характеристикалар	characteristics
хаҡ	charge
етәкселек	charge
ғәйепләү ҡарары	charge
хәйриәт	charity
таң ҡалдырғыс	charming
диаграмма	chart
баҫтырырға	chase
һөйләшергә	chat
һөйләшеү	chat
осһоҙ	cheap
мутлашырға	cheat
хыянат итергә	cheat
алдау	cheating
хыянат итеү	cheating
тотҡарлыҡ	check
тикшерергә	check
яңаҡ	cheek
кәйефләндерергә	cheer
күңелле	cheerful
һеҙҙең һаулыҡ өсөн	cheers
сыр	cheese
химия	chemistry
ҡәҙерләргә	cherish
шахмат	chess
түш	chest
һандыҡ	chest
сәйнәргә	chew
тауыҡ	chicken
төп	chief
бала	child
бала саҡ	childhood
балалар	children
һыуытырға	chill
һалҡын	chill
ҡалтырау	chill
юллыҡтар	chimneys
шыйыҡса	chin
шоколад	chocolate
һайлау	choice
һайларға	choose
сабырға	chop
өй эштәр	chores
яңаҡлы	chubby
сиркәү	church
дәрсен	cinnamon
түңәрәк	circle
шарттар	circumstances
граждан	citizen
ҡала	city
талап	claim
талап итергә	claim
аңлатырға	clarify
синыф	class
дәрес	class
балсыҡ	clay
таҙа	clean
таҙартырға	clean
аяҙ	clear
аныҡларға	clear
клерк	clerk
аҡыллы	clever
клиент	client
ҡая	cliff
климат	climate
менергә	climb
бәйләнсек	clingy
сәғәт	clock
ябырға	close
яҡын	close
шкаф	closet
сепрәк	cloth
кейем	clothes
болот	cloud
болотло	cloudy
клоун	clown
тотҡарлыҡ	clue
килбәтһеҙ	clumsy
тупланма	cluster
тәлгәш	cluster
тренер	coach
өйрәтергә	coach
күмер	coal
яр буйы	coast
пальто	coat
кофе	coffee
когнитив	cognitive
тап килеүе	coincidence
һыуыҡ	cold
һалҡын тейеү	cold
ишелеп төшөргә	collapse
яға	collar
коллега	colleague
коллегалар	colleagues
йыйырға	collect
коллекция	collection
университет	college
төҫ	color
төҫһөҙ йәшел идеялар ярһып йоҡлай	colorless green ideas slept furiously
төҫ	colour
бағана	column
тараҡ	comb
комбинация	combination
берләштерергә	combine
килергә	come
кил бында	come here
әйҙә	come on
йыуаныс	comfort
уңайлыҡ	comfort
уңайлы	comfortable
килгән	coming
тиҙҙән буласаҡ	coming soon
команда	command
комментарий	comment
сауҙа	commercial
комиссия	commission
ҡылырға	commit
тоғролоҡ	commitment
йөкләмә	commitment
идеялы	committed
тауар	commodity
йыш осрай торған	common
аралашырға	communicate
аралашыу	communication
бергәлек	community
етергә	commute
иптәш	companion
компания	company
сағыштырырға	compare
сағыштырыу	comparison
шәфҡәтлелек	compassion
шәфҡәтле	compassionate
тура килә торған	compatible
ярышырға	compete
уҙ эшен белгән	competent
конкуренция	competition
ярыш	competition
конкурентлы	competitive
зарланырға	complain
зар	complaint
өҫтәмә	complement
өҫтәргә	complement
тулы	complete
тулыһынса	completely
ҡушма	complex
килешмәк	compliance
ҡатмарлы	complicated
маҡтау	compliment
үтәргә	comply
состав	composition
берләшмә	compound
аңлау	comprehension
комплекслы	comprehensive
компромисс	compromise
яманатлы итергә	compromise
мәжбүри	compulsory
компьютер	computer
йүнәлергә	concentrate
төшөнсә	concept
борсолоу	concern
ҡағылырға	concern
болоҡһотоҡ	concerned
концерт	concert
һөҙөмтә	conclusion
бетонларға	concrete
бетонлы	concrete
бетон	concrete
хәл	condition
шарт	condition
шарттар	conditions
үткәрергә	conduct
конференция	conference
иҡрар итергә	confess
ныҡлы ышаныс	confidence
ныҡлы	confident
иҫбатларға	confirm
конфликт	conflict
буталып киткән	confused
буталыш	confusion
ҡотлайым	congrats
ҡотлау	congratulation
ҡотлайым	congratulations
теркәүес	conjunction
тоташтырырға	connect
яулап алырға	conquer
аңлы	conscious
аң	consciousness
риза булырға	consent
ризалыҡ	consent
эҙемтәләр	consequences
һаҡлау	conservation
консерватив	conservative
иҫәпләргә	consider
иҫәпләгән	considered
торорға	consist
эҙмә-эҙлелек	consistency
тотороҡло	consistent
даими	constant
даими	constantly
эс ҡатыу	constipation
төҙөлөш	construction
ҡулланырға	consume
ҡулланыу	consumption
бәйләнешкә инергә	contact
контакт	contact
йоғошло	contagious
үҙ эсенә алырға	contain
составында бар	contains
хәҙерге	contemporary
нәфрәт	contempt
ҡәнәғәт	content
эстәлек	content
ярыш	contest
контекст	context
континент	continent
дауам итергә	continue
контракт	contract
контракт төҙөү	contract
ҡапма-ҡаршы булырға	contrast
ҡапма-ҡаршылыҡ	contrast
өлөш индерергә	contribute
өлөш	contribution
контроль	control
бәхәсле	controversial
уңайлыҡ	convenience
уңайлы	convenient
әңгәмә	conversation
әүерелдерергә	convert
әүерелдереү	convert
тапшырырға	convey
инандырырға	convince
инанған	convinced
ашнаҡсы	cook
әҙерләү	cook
бешереү	cooking
әҙерәк кенә	cool
шәп	cool
хеҙмәттәшлек	cooperation
еңеп сығырға	cope
баҡыр	copper
йәҙрә	core
кукуруз	corn
мөйөш	corner
дөрөҫ	correct
хаҡы	cost
торорға	cost
костюм	costume
коттедж	cottage
мамыҡ	cotton
тренер	couch
диван	couch
йүткерергә	cough
алған	could
совет	council
һанарға	count
прилавка	counter
ил	country
ауыл ере	countryside
ҡуш	couple
иш	couple
батырлыҡ	courage
бараһылыҡ	course
суд	court
әҙәплелек	courtesy
ике туған апай	cousin
ике туған ағай	cousin
ҡапларға	cover
һыйыр	cow
ҡурҡаҡ	coward
йәмле	cozy
диңгеҙ ҡыҫалаһы	crab
ярылырға	crack
ярыҡ	crack
һөнәрселек	craft
буҡ	crap
аварияға эләгергә	crash
авария	crash
нәфсе	craving
шыуышып барырға	crawl
алйот	crazy
барлыҡҡа китерергә	create
ижади	creative
күрһәткән хеҙмә	credit
боҫоп барырға	creep
ҡот осҡос	creepy
экипаж	crew
енәйәт	crime
ҡорошорған	cringe
ҡорошорға	cringe
көрсөк	crisis
критерий	criteria
тәнҡит	critical
тәнҡит	criticism
уңыш	crop
уңдырышлыҡ	crops
тәре	cross
ҡыйырға	cross
ҡарға	crow
төркөм	crowd
халҡы күп	crowded
таж	crown
мөһим	crucial
аяуһыҙ	cruel
круиз	cruise
ватылырға	crush
һәләк	crush
иларға	cry
ҡыяр	cucumber
ҡосаҡларға	cuddle
мәҙәниәт	culture
хәйләкәрлек	cunning
сынаяҡ	cup
кубок	cup
шкаф	cupboard
бордюр	curb
дарыу	cure
дауаларға	cure
комендант сәғәте	curfew
ҡыҙыҡһыныу	curiosity
ҡыҙыҡһыныусан	curious
бөҙрә	curly
валюта	currency
ағымдағы	current
хәҙерге ваҡытта	currently
һүгенес	curse
ҡарғыш	curse
пәрҙә	curtain
мендәр	cushion
йола	custom
клиент	customer
таможня	customs
ғөрөф-ғәҙәт	customs
ҡырҡырға	cut
киҫәләнте	cut
яғымлы	cute
цикл	cycle
велосипед йөрөүе	cycling
атай	dad
атай	daddy
көндәлек	daily
һөт	dairy
быуа	dam
зыян килтерергә	damage
зыян	damage
ҡәһәрле	damn
дымлы	damp
бейергә	dance
хәүеф	danger
хәүефле	dangerous
ҡаранғы	dark
ҡәҙерлем	darling
һыҙыҡ	dash
елдерергә	dash
мәғлүмәт	data
дата	date
осрашыу	date
ҡыҙ	daughter
кән	day
үлгән	dead
сикке ваҡыт	deadline
һаңғырау	deaf
алыш-биреш	deal
бәйләнеш тоторға	deal
ҡәҙерле	dear
бөтәгеҙгә ла хөрмәт	Dear All
Хөрмәтле клиент	Dear Customer
Хөрмәтле ата-әсәләр	Dear Parents
Хөрмәтле әфәнде	Dear Sir
Хөрмәтле студенттар	Dear students
Хөрмәтле команда	Dear Team
үлем	death
фекер алышырға	debate
дебет	debit
емереклектәр	debris
бурыс	debt
ун йыллыҡ	decade
тарҡалыу	decay
мәрхүм	deceased
алдарға	deceive
декабрь	december
арҙаҡлы	decent
ҡарар ҡабул итергә	decide
ҡарар иткән	decided
ҡарар	decision
палуба	deck
кире ҡағырға	decline
кәметергә	decrease
фиҙаҡәр	dedicated
тоғролоҡ	dedication
ҡылыҡ	deed
тәрән	deep
болан	deer
иғтибарһыҙлыҡ	default
еңергә	defeat
еңелеү	defeat
яҡларға	defend
билдәләргә	define
аныҡ	definitely
билдәләмә	definition
дәрәжә	degree
тотҡарлыҡ	delay
һуңыраҡҡа күсерергә	delay
кисектерелгән	delayed
бөтөрөргә	delete
алдан уйлап эшләнгән	deliberate
нәзәкәтле	delicate
бик тәмле	delicious
шатлыҡ	delight
ҡәнәғәтле	delighted
алып барырға	deliver
килтерелгән	delivered
алып барып ҡуйыу	delivery
һорау	demand
талап итергә	demand
талапсан	demanding
демократия	democracy
иблис	demon
күрһәтергә	demonstrate
баш тартҡан	denied
тығыҙлыҡ	density
стоматолог	dentist
баш тартырға	deny
бүлек	department
китеү	departure
буйһонорға	depend
йәйелдерергә	deploy
һаҡларға	deposit
депозит	deposit
баҫтырылған	depressed
депрессия	depression
тәрәнлек	depth
һүрәтләргә	describe
васиф	description
сүл	desert
атҡаҙанырға	deserve
дизайн	design
эшләп сығарырға	design
билдә	designation
көҫәргә	desire
көслө теләк	desire
өҫтәл	desk
өмөтһөҙлөк	despair
сая	desperate
ҡарамаҫтан	despite
десерт	dessert
тәғәйенләнгән урын	destination
яҙмыш	destiny
юҡ итергә	destroy
емерелеү	destruction
деталь	detail
тулыраҡ мәғлүмәт	details
табырға	detect
тәүәккәллек	determination
билдәлергё	determine
тәүәккәл	determined
ҡайғыға батҡан	devastated
үҫешергә	develop
үҫтерергә	develop
эшкәртелгән	developed
үҫеш	development
ҡоролма	device
иблис	devil
тоғро	devoted
дивехи теле	Dhivehi
шәкәр аурыуы	diabetes
диарея	diarrhea
көндәлек	diary
һүҙлек	dictionary
эшләне	did
үлергә	die
үлгән	died
диета	diet
айырма	difference
икенсе	different
ҡыйын	difficult
ҡаҙырға	dig
шәхсиәт дәрәжәһе	dignity
тырыш	diligent
киске аш	dinner
сумдырырға	dip
тура	direct
йүнәлеш	direction
директор	director
режиссёр	director
бысраҡ	dirt
бысраҡ	dirty
һүндерергә	disable
имгәтергә	disable
эшкә яраҡһыҙ	disabled
юҡ булырға	disappear
өмөтө өҙөлгән	disappointed
афәт	disaster
ризалашмаҫҡа	discard
сығарырға	discharge
тәртип	discipline
ташлама	discount
табып алырға	discover
дискриминация	discrimination
телгәрергә	discuss
телектереш	discussion
ауырыу	disease
ауырыуҙар	diseases
маскировать итергә	disguise
ерәнес	disgusting
тәрилкә	dish
ризыҡ	dish
ашамлыҡтар	dishes
эштән ебәрергә	dismiss
ебәрергә	dispatch
күрһәтергә	display
утилизация	disposal
бәхәс	dispute
дистанция	distance
айырым	distinct
төрлө	distinct
айырым алырға	distinguish
бәлә-ҡаза	distress
таратыу	distribution
район	district
бимазалау	disturb
соҡор	ditch
сумырға	dive
төрлө	diverse
төрлөлөк	diversity
бүлергә	divide
илаһи	divine
никахты тарҡатыу	divorce
никахты тарҡатырға	divorce
баш әйләндергес	dizzy
эшләргә	do
һин	do you
һин мине яратаңмы	do you love me
табип	doctor
документ	document
эшләй	does
-май	doesn't
эт	dog
догри теле	Dogri
эшләү	doing
ҡурсаҡ	doll
домен	domain
эске	domestic
йорт	domestic
өҫтөнлөклө	dominant
Борсолма	Don't worry
аҡса кертергә	donate
иғәнә бирергә	donate
эшләнгән	done
ишәк	donkey
наркотик	dope
икеләтеү	double
икеләтергә	double
шикләнергә	doubt
шик	doubt
ҡамыр	dough
аҫҡа	down
йөктәтергә	download
ҡаралама	draft
һыҙырға	draft
һөйрәтергә	drag
бушатырға	drain
киптерергә	drain
драма	drama
һөйрәтергә	draw
һүрәт төшөрөргә	draw
йәшник	drawer
һүрәт	drawing
ҡот осоу	dread
төш	dream
төш күрергә	dream
күлдәк	dress
бырауларға	drill
эсергә	drink
эсемлек	drink
йөрөтөргә	drive
төшөрөп ебәрергә	drop
кәмеү	drop
ташлаған	dropped
ҡоролоҡ	drought
иҫерек	drunk
ҡоро	dry
өйрәк	duck
егет	dude
өсөн	due
тейешле	due
өсөн	due to
эс бошорғос	dull
аңра	dumb
ташлау	dump
оҙайлыҡ	duration
ваҡытында	during
саң	dust
бурыс	duty
йәшәргә	dwell
үлеп барған	dying
һәр	each
бер-береһен	each other
дәртле	eager
бөркөт	eagle
ҡолаҡ	ear
элегерәк	earlier
иртә	early
аҡса эшләргә	earn
ҡолаҡтар	ears
ер	earth
ер тетрәү	earthquake
еңеллек	ease
анһат	easily
көнсығыш	east
еңел	easy
ашарға	eat
ашау	eating
бәрәкәтле	economic
иҡтисад	economy
сит	edge
төҙәтергә	edit
мәғариф	education
йоғомта	effect
һөҙөмтәле	effective
нәтижәлелек	efficiency
эффектив	efficient
тырышлыҡ	effort
йомортҡа	egg
баклажан	eggplant
эго	ego
һигеҙ	eight
ун һигеҙ	eighteen
һикһән	eighty
ул да	either
эшкәртергә	elaborate
терһәк	elbow
олорыраҡ	elder
оло йәштәгеләр	elderly
күркәм	elegant
элемент	element
фил	elephant
ун бер	eleven
йәтеш	eligible
бөтөрөргә	eliminate
тағы	else
асыулы	embarrassed
асыулы	embarrassing
ҡосаҡларға	embrace
килеп сығырға	emerge
ғәҙәттән тыш	emergency
эмоциональ	emotional
мәрхәмәт	empathy
баҫым	emphasis
айырып күрһәтергә	emphasize
эшсе	employee
хеҙмәттәштәр	employees
эш биреүсе	employer
эшкә урынлашыу	employment
буш	empty
ирек бирергә	enable
осрашырға	encounter
ҡыҙыҡһындырырға	encourage
бөтөргә	end
аҙаҡ	end
ҡурҡыныс аҫтында	endangered
көсөргәнеш	endeavor
сыҙамлылыҡ	endurance
түҙеп торорға	endure
дошман	enemy
энергия	energy
йәлеп итергә	engage
вәғәҙәләшкән	engaged
вәғәҙәләшеү	engagement
двигатель	engine
инженер	engineer
инглиз	English
булышырға	enhance
кинәнергә	enjoy
бик ҙур	enormous
еткәндәй	enough
тәьмин итергә	ensure
инергә	enter
күңел асыу	entertainment
күтәренкелек	enthusiasm
ялҡынлы	enthusiastic
бөтә	entire
исемдәге	entitled
ойошма	entity
инеү урыны	entrance
эшҡыуар	entrepreneur
конверт	envelope
тирә-яҡ мөхит	environment
көнләшеү	envy
эпик	epic
эпидемия	epidemic
тиң	equal
йыһазландырыу	equipment
тигеҙлек	equity
тиңдәш	equivalent
юйғыс	eraser
хата	error
ҡасырға	escape
айырыуса	especially
инша	essay
эссенция	essence
асыл	essence
иң мөһим	essential
билдәләргә	establish
барлыҡҡа килгән	established
милек	estate
баһа бирергә	estimate
баһаланған	estimated
һ. б.	etc
мәңгелек	eternal
этика	ethics
баһаларға	evaluate
баһа	evaluation
тигеҙ	even
хатта	even
хатта әгәр	even though
кис	evening
ваҡиға	event
ниһайәт	eventually
ҡасан да булһа	ever
һәр	every
барыһы ла	everybody
бөтә	everyone
бөтә	everything
дәлил	evidence
яман	evil
эволюция	evolution
үҫеш алырға	evolve
эве теле	Ewe
элекке	ex
йыйнаҡ	exact
теүәл	exactly
имтихан	exam
тикшеренергә	examine
миҫал	example
артыҡ булырға	exceed
бик яҡшы	excellent
башҡа	except
айырма	exception
артыҡ	excess
артыҡ	excessive
алмашыу	exchange
рухлы	excited
тулҡынланыу	excitement
күңел күтәрлек	exciting
эксклюзив	exclusive
аҡланырға	excuse
ғәфу ит мине	excuse me
язалап үлтерергә	execute
башҡарырға	execute
башҡарыу	execution
иғдам	execution
башҡарма	executive
күнегеүҙәр үткәрергә	exercise
күнегеү	exercise
бөтөрөргә	exhaust
йонсоторға	exhaust
бик арыған	exhausted
күрһәтергә ҡуйырға	exhibit
күргәҙмә	exhibition
булырға	exist
барлыҡ	existence
булған	existing
сығырға	exit
киңәйтергә	expand
көтөргә	expect
көткән	expected
сығымдар	expenses
ҡыйбат	expensive
емәнергә	experience
тәжрибә	experience
эксперимент	experiment
эксперт	expert
йылы тулған	expired
аңлатырға	explain
аңлатыу	explanation
иҙергә	exploit
эксплуатацияларға	exploit
тикшерергә	explore
экспорт	export
ситкә сығарырға	export
фашларға	expose
дусар ителгән	exposed
һаҡланмаған булыу	exposure
белдерергә	express
әйтем	expression
киңәйтергә	extend
киңәйтелгән	extended
киңәйтеү	extension
күләм	extent
тышҡы	external
ҡырылып бөткән	extinct
өҫтәмә	extra
өҙөмтә	extract
ташыртырға	extract
экстракт	extract
ғәҙәти булмаған	extraordinary
экстремаль	extreme
сиктән тыш	extreme
бик	extremely
күҙ	eye
күҙҙәр	eyes
туҡыма	fabric
иҫ киткес	fabulous
ҡаршыларға	face
бит	face
булышырға	facilitate
йыһазландырыу	facilities
объект	facility
факт	fact
фактор	factor
завод	factory
факттар	facts
шиңергә	fade
уңышһыҙлыҡҡа осрарға	fail
уңышһыҙлыҡ	fail
еңелгән	failed
уңышһыҙлыҡҡа осрау	failure
һуштан яҙырға	faint
ғәҙел	fair
аҡһыл	fair
урынлы	fairly
дөрөҫ итеп	fairly
әкиәттәге	fairy
фея	fairy
ышаныс	faith
тоғро	faithful
ялған	fake
йығылыу	fall
йығылырға	fall
ЯЛҒАН	false
дан	fame
таныш	familiar
ғәилә	family
аслыҡ	famine
билдәле	famous
елләткес	fan
һәүәҫкәр	fan
хыял	fancy
оҡшатырға	fancy
хыялый	fantastic
алыҫ	far
хушлашыу	farewell
ферма	farm
фермер	farmer
мауыҡтырғыс	fascinating
мода	fashion
тиҙ	fast
май	fat
һимеҙ	fat
үлемесле	fatal
яҙмыш	fate
атай	father
арыу	fatigue
ғәйеп	fault
иң яраткан	favorite
ярҙам	favour
яҡшы ҡарау	favour
яратҡан	favourite
ҡурҡырға	fear
ҡурҡыу	fear
мәжлес	feast
ҡауырһын	feather
сифаттар	feature
айырылып торорға	feature
сифаттар	features
февраль	february
туҡ	fed up
түләнес	fee
ашатырға	feed
һөрәнләнеш	feedback
һиҙергә	feel
тойғо	feeling
аяҡтар	feet
йығылып төшкән	fell
иптәш	fellow
һиҙгән	felt
ҡатын-ҡыҙ	female
ҡойма	fence
уңдырышлы	fertile
үрсеүгә һәләтле	fertile
фестиваль	festival
алып килтерергә	fetch
юғары температура	fever
аҙ	few
аҙыраҡ	fewer
кейәү	fiance
ялған	fiction
матур әҙәбиәт	fiction
даирә	field
ялан	field
ярһыу	fierce
ун биш	fifteen
илле	fifty
һуғыш	fight
һуғышырға	fight
һуғыш	fighting
фигура	figure
иҫәпләргә	figure
асыҡлап белергә	figure out
файл	file
тултырырға	fill
тултырылған	filled
төшөрөргә	film
фильм	film
бысраҡ	filthy
ахырҙа	finally
финанстар	finance
финанс	financial
табырға	find
асыҡларға	find out
яҡшы	fine
штраф	fine
бармаҡ	finger
тамамларға	finish
тамамланған	finished
ут	fire
ныҡ	firm
фирма	firm
беренсе	first
исем	first name
балыҡ	fish
тура килергә	fit
биш	five
төҙәтергә	fix
төҙәтелгән	fixed
флаг	flag
сатҡы	flash
момент	flash
фатир	flat
йәйпәк	flat
етешһеҙлек	flaw
мөнһөҙ	flawless
ҡасып ҡотолорға	flee
тән	flesh
осҡан	flew
бөгөргә	flex
һығылмалы	flexible
осош	flight
әйләндерергә	flip
ҡыйшанлау	flirt
ғишыҡ уйыны	flirting
йөҙөргә	float
ташҡын	flood
иҙән	floor
он	flour
ағым	flow
ағырға	flow
сәскә	flower
грипп	flu
иркен	fluent
иркен	fluently
ҡабарынҡы йөнлө	fluffy
шыйыҡса	fluid
осорға	fly
фокус	focus
иғтибарҙы тупларға	focus
томан	fog
томанлы	foggy
папка	fold
бөкләргә	fold
халыҡтар	folks
эйәрергә	follow
артынан эйәрерга	follow up
түбәндәге	following
аҙыҡ-түлек	food
алдарға	fool
алйот	fool
аҡылһыҙ	foolish
аяҡ	foot
футбол	football
өсөн	for
Мәҫәлән	For example
мәҫәлән	for instance
һинең өсөн	for you
тыйылған	forbidden
көс	force
алдан әйтеп ҡуйыу	forecast
маңлай	forehead
сит илдәге	foreign
урман	forest
мәңгелеккә	forever
оноторға	forget
ғәфү итергә	forgive
онотҡан	forgot
сәнске	fork
яһарға	form
форма	form
формаль	formal
элекке	former
бәхеткә ҡаршы	fortunately
уңыш	fortune
байлыҡ	fortune
яҙмыш	fortune
ҡырк	forty
ҡырҡ ике	forty-two
алға	forward
тапшырырға	forward
тәрбиәләп үҫтерергә	foster
һуғышҡан	fought
тапҡан	found
нигеҙ һалырға	found
фонд	foundation
нигеҙ	foundation
дүрт	four
ун дүрт	fourteen
төлкө	fox
мурт	fragile
рам	frame
структура	framework
мутлыҡ	fraud
нишана	freak
ирекле	free
түләүһеҙ	free
ирек	freedom
туңдырырға	freeze
йышлыҡ	frequency
йышлыҡ	frequent
аҙым һайын	frequently
яңы	fresh
йома	friday
һыуытҡыс	fridge
дуҫ	friend
күңелсәк	friendly
дуҫтар	friends
дуҫлыҡ	friendship
ҡурҡҡан	frightened
ҡурҡыныс	frightening
тәлмәрйен	frog
ал	front
туңдырылған	frozen
емеш-еләк	fruit
борсоулы	frustrated
яғыулыҡ	fuel
фула теле	Fulfulde
тулы	full
күңелле	fun
функция	function
эшләргә	function
нигеҙ һалыусы	fundamental
ерләү	funeral
ҡыҙыҡ	funny
йөн	fur
ярһыу	furious
мебель	furniture
ары	further
унан да бигерәк	furthermore
киләсәк	future
файҙа	gain
эшләп алырға	gain
уйын	game
бушлыҡ	gap
гараж	garage
суп сар	garbage
баҡса	garden
һарымһаҡ	garlic
ҡапҡа	gate
йыйынырға	gather
йыйылышыу	gathering
үлсәргә	gauge
биргән	gave
күсергес	gear
гендер	gender
дөйөм	general
генерал	general
ғәҙәттә	generally
етештерергә	generate
быуын	generation
етештереү	generation
йомарт	generous
даһи	genius
жанр	genre
яғымлы	gentle
ихлас	genuine
ым	gesture
булырға	get
алырға	get
кейенергә	get dressed
торорға	get up
тиҙерәк һауығығыҙ	get well soon
ала торған	getting
шәүлә	ghost
юҡ булыу	ghosting
гигант	giant
бүләк	gift
ерән	ginger
имбирь	ginger
ҡыҙ	girl
иптәш ҡыҙы	girlfriend
бирергә	give
бирешергә	give up
бирелгән	given
шат	glad
күҙ ташларға	glance
быяла	glass
стакан	glass
күҙлек	glasses
осҡон	glimpse
глобаль	global
ҡараңғы	gloomy
күңелһеҙ	gloomy
бирсәткәләр	gloves
яҡтырырға	glow
яҡтыртыу	glow
йәмләнергә	glow up
елем	glue
барырға	go
алға барырға	go ahead
китәле	go away
йоҡларға ятырға	go to bed
маҡсат	goal
маҡсаттар	goals
кәзә	goat
хоҙай	god
иҫән булығыҙ	god bless you
бара	goes
китеп бара	going
йыйылам	going to
алтын	gold
киткән	gone
йыйыла	gonna
йәбешкәк	goo
изгелек	good
һәйбәт	good
хәйерле көн	good afternoon
һау булығыҙ	good bye
хәйерле көн	good day
хәйерле кис	good evening
бик яҡшы	good job
сибәр	good looking
уңыштар	good luck
хәйерле иртә	good morning
хәйерле иртә һөйөүем	good morning my love
тыныс йоҡо	good night
хуш бул	goodbye
тыныс йоҡо	goodnight
тауарҙар	goods
Гугл	Google
Гугл Тәржемәсе	Google Translate
ҡаҙ	goose
һоҡланғыс	gorgeous
ғәйбәт	gossip
алған	got
аңланым	got it
хөкүмәт	government
ҡулға алырға	grab
дәрәжә	grade
аҡрынлап	gradually
тамамлаусы	graduate
иген	grain
грант	grant
бирелгән	granted
виноград	grapes
тоторға	grasp
үлән	grass
баяныслы	grateful
рәхмәт хисе	gratitude
ҡәбер	grave
етди	grave
һоро	gray
бик яҡшы	great
бөйөк	great
ҡомһоҙлоҡ	greed
ҡомһоҙ	greedy
йәшел	green
сэлэм әйтергә	greet
тәбрикләү	greeting
сәләмләү	greetings
һоро	grey
селтәр	grid
ҡайғы	grief
ваҡларға	grind
тоторға	grip
бакалея	grocery
кейәү	groom
тулайым	gross
нигеҙ	ground
ер	ground
төркөм	group
үҫергә	grow
үҫеү	growth
уғыр	grumpy
гуарани теле	Guarani
гарантия	guarantee
ҡарауылсы	guard
әйтеп ҡарарға	guess
ҡунаҡ	guest
етәкселәр	guidance
өгөтсө	guide
йүнәлтергә	guide
ғәйепле	guilty
егет	guy
егеттәр	guys
тренажер залы	gym
ғәҙәт	habit
йәшәү мөхите	habitat
булды	had
борсаҡ	hail
сәләмләргә	hail
сәс	hair
ярты	half
зал	hall
ҡул	hand
еңеп сығырға	handle
тотҡа	handle
матур	handsome
элергә	hang
һәптәнләп йөрөргә	hang out
килеп сығырға	happen
булған	happened
бәхет	happiness
бәхетле	happy
тыуған көнөң менән	happy birthday
тыуған көнөң менән	happy birthday to you
яңы йыл менән	happy new year
ҡаты	hard
ауыр	hard
саҡ ҡына	hardly
бик һирәк	hardly ever
зарар	harm
зарар итергә	harm
зарарлы	harmful
аһәңлелек	harmony
ҡаты	harsh
уңыш	harvest
бар	has
дошман күрергә	hate
бар	have
уңышлы көн һиңә	have a good day
көнөң яҡшы булһын	have a nice day
иртәнге ашты ашарға	have breakfast
күңел асырға	have fun
һин ашағаның бар мы	have you eaten
биләү	having
хәүеф-хәтәр	hazard
еңел томан	haze
ул	he
уныҡы бар	he has
ул	he is
баш	head
етәкселек итергә	head
баш ауыртыу	headache
именәйтергә	heal
төҙәлергә	heal
дауалау	healing
һаулыҡ	health
һау	healthy
ишетергә	hear
ишеткән	heard
йөрәк	heart
йылы	heat
именәйтергә	heat
йәннәт	heaven
ауыр	heavy
биҙгәк	hectic
буй	height
вариҫ	heir
талау	heist
тотҡан	held
тамуҡ	hell
Һаумыһығыҙ	Hello
һаумы ҡәҙерлем	hello dear
сәләм ни хәлдәр	hello how are you
һаумырығыҙ хэлдэрегеҙ нисек	hello how are you doing
шлем	helmet
ярҙам итергә	help
файҙалы	helpful
биннәтижә	hence
уны	her
көтөү	herd
бында	here
мираҫ	heritage
шикләнеү	hesitate
Сәләм	Hey
Сәләм	Hi
сәләм хәлдәр нисек	hi how are you
Сәләм	Hi there
йәшерелгән	hidden
йәшерергә	hide
иерархия	hierarchy
юғары	high
билдәләргә	highlight
походҡа барырға	hike
йәйәүле туризм	hiking
бик күңелле	hilarious
уба	hill
уны	him
ишара	hint
бот	hip
янбаш	hips
ялларға	hire
яллау	hiring
уның	his
тарих	history
һуғырға	hit
Хмм	Hmm
хобби	hobby
тоторға	hold
тороп тор	hold on
тишек	hole
байрам	holiday
эсе ҡыуыш	hollow
өй	home
өйгә эш	homework
намыҫлы	honest
намыҫлы	honestly
йөрәкәйем	Honey
Бал	Honey
ихтирам	honor
капюшон	hood
ырғаҡ	hook
һикерергә	hop
өмөтләнергә	hope
өмөт	hope
өмөт менән	hopefully
өмөтһөҙлөк	hopeless
горизонталь	horizontal
мөгөҙ	horn
ҡот осҡос	horrible
ҡурҡыныслыҡ	horror
ат	horse
дауахана	hospital
ҡунаҡсыллыҡ	hospitality
үткәрергә	host
хужа	host
дошманлыҡ	hostile
эҫе	hot
ҡунаҡхана	hotel
сәғәт	hour
сәғәт	hours
йорт	house
йорт хужалыҡ	household
нисек	how
һинең хаҡта	how about you
хәлдәр нисек	how are you
хәлдәр нисек	how are you doing
хәлдәрең нисек бөгөн	how are you doing today
һин бөгөн нисек	how are you today
хәл-әхүәлдәрең нисек	how do you do
нисек	how is
нисә	how many
күпме	how much
йыш мы	how often
һиңә нисә йәш	how old are you
көнөң нисек үтте	how was your day
төнөң нисек үтте	how was your night
әммә	however
хаб	hub
ирекаем	hubby
ҡосаҡлау	hug
ҡосаҡларға	hug
бик ҙур	huge
әҙәм	human
тыйнаҡ	humble
дымлы	humid
дымлылыҡ	humidity
йөҙ	hundred
ас	hungry
һунар	hunt
ҡойон	hurricane
ҡаваланырға	hurry
тиҙерәк	hurry up
бәлектергә	hurt
ир	husband
ығы-зығы килергә	hustle
ығы-зығы	hustle
бәләкәй өй	hut
гигиена	hygiene
Мин	I
мин	I am
Минең барыһы ла яҡшы	I am fine
мин алам	I can
мин алмайым	I can't
Эйе	I do
мин белмәйем	I do not know
Мин аңламайым	I do not understand
мин түгел	I don't
мин белмәйем	I don't know
Мин аңламайын	I don't understand
Һин нимә әйтергә теләгәнеңде мин аңламайым	I don't understand what you mean
Мин һине аңламайым	I don't understand you
мин белмәйем	I don’t know
мин аңламайым	I don’t understand
моғайын	i guess
Миндә булған ине	I had
миндә бар	I have
мин булдым	I have been
шулай булыр тип өмөтләнәм	I hope so
мин беләм	I know
Миңә оҡшай	I like
һин миңә оҡшайһың	I like you
мин яратам	I love
Мин ағайымды яратам	I love my big brother
Мин апайымды яратам	I love my big sister
Мин атайымды яратам	I love my father
Мин ҡустымды яратам	I love my little brother
Мин һеңлемде яратам	I love my little sister
Мин әсәйемде яратам	I love my mother
Мин һине яратам	I love you
мин һине шул тиклем яратам	I love you so much
мин дә һине яратам	I love you too
мин әйтергә теләйем	I mean
мин һине һағынғынмын	I miss you
мин һине бик һағынам	I miss you so much
күрәм	I see
тип уйлайым	I think
мин аңлайым	I understand
мин теләйем	I want
һине күргем килә	I want to see you
мин һине теләйем	I want you
мин булдым	I was
мин	I will
мин булыр инем	I would be
мин	I'm
минең барыһы ла яҡшы	I'm fine
минең барыһы ла яҡшы	I'm good
мин бында	I'm here
ғәфү ит мине	I'm sorry
боҙ	ice
туңдырма	ice cream
идея	idea
идеаль	ideal
берҙәй	identical
айыра сисергә	identify
шәхсиәт	identity
йүләр	idiot
һыбай	idle
әгәр	if
иғтибарһыҙ ҡалдырырға	ignore
сирле	ill
законһыҙ	illegal
ауырыу	illness
илокано теле	Ilocano
һүрәт	image
күҙ алдына килтерергә	imagine
хәҙер үк	immediate
шул уҡ саҡта	immediately
бик ҙур	immense
йоғонто	impact
тәьҫир итергә	impact
түҙемһеҙ	impatient
булдырырға	implement
сит илдән индереү	import
сит илдән индерергә	import
мөһим	important
мәжбүр итергә	impose
йонмауыҡ	impossible
хайран ҡалдырырға	impress
тәьҫорат	impression
тәьҫирле	impressive
яҡшыртырға	improve
яҡшыртыу	improvement
өҫтәүенә	in addition
Ысынбарлыҡта	In fact
алдында	in front of
өсөн	in order to
ярамаған	inappropriate
ҡылғатҡыс	incentive
этәргес көс	incentive
инцидент	incident
индерергә	include
шул иҫәптән	including
килем	income
уңайһыҙлыҡ	inconvenience
арттырыу	increase
арттырырға	increase
күбәйгән	increased
иҫ киткес	incredible
ысынлапта	indeed
бойондороҡһоҙ	independent
Һиндостан	India
күрһәтергә	indicate
аҫаба	indigenous
шәхси	individual
сәнәғәт	industry
ҡотолғоһоҙ	inevitable
яңы тыуған бала	infant
инфекция	infection
сикһеҙлек	infinity
шешеү	inflammation
инфляция	inflation
йоғонто	influence
тәьҫир итергә	influence
хәбәр итергә	inform
мәғлүмәт	information
ингредиенттар	ingredients
мираҫ	inheritance
иң тәүге	initial
инициатива	initiative
яраланған	injured
йәрәхәт	injury
яҙыҡһыҙ	innocent
инновация	innovation
тәфтишләү	inquiry
ахмаҡ	insane
бөжәк	insect
икеләнеүсән	insecure
ҡуйырға	insert
эстә	inside
башҡа уй төшөү	insight
ныҡышырға	insist
йоҡоһоҙлоҡ	insomnia
илһам	inspiration
дәртләндерергә	inspire
ҡуйырға	install
өлгө	instance
моменталь	instant
урынында	instead
урынына	instead of
инструкциялар	instructions
инструмент	instrument
мыҫҡыл итергә	insult
страхование	insurance
тейелмәгән	intact
бөтөнлөк	integrity
интеллектуаль	intellectual
разведка	intelligence
аҡыл	intelligence
аҡыллы	intelligent
ниәт итергә	intend
ниәтләнгән	intended
ныҡ	intense
ниәт	intention
үҙ-ара бәйләнешергә	interact
үҙ-ара бәйләнеше	interaction
мәнфәғәт	interest
ҡалаҡыҙыҡһынған	interested
ҡыҙыҡлы	interesting
буталырға	interfere
аралыҡ	intermediate
эске	internal
халыҡ-ара	international
стажировка	internship
интернатура	internship
телдән тәржемә итергә	interpret
телдән тәржемә итеүсе	interpreter
бүлдерергә	interrupt
интервью	interview
интим	intimate
эскә	into
таныштырға	introduce
инеш	introduction
интроверт	introvert
интуиция	intuition
ғәмәлдә түгел	invalid
уйлап табырға	invent
инвентаризация	inventory
аҡса һалырға	invest
тикшереү үткәрергә	investigate
саҡырыу	invitation
саҡырырға	invite
иҫәп-фактура бирергә	invoice
иҫәп-фактура	invoice
ылыҡтырырға	involve
тарттырылған	involved
үтектергә	iron
тимер	iron
утрау	island
айырым	isolated
сығарырға	issue
баҫма	issue
мәсьәләләр	issues
был	it
был	it is
булған	it was
был	it's
барыһы ла яҡшы	it's ok
Барыһы ла һәйбәт	It's okay
предмет	item
предметтар	items
уның	its
мин	I’m
куртка	jacket
төрмә	jail
ғинуар	January
банка	jar
яңаҡ һөйәге	jaw
көнсөл	jealous
ҡапыл хәрәкәт	jerk
иҫәр	jerk
биҙәүес	jewelry
эш	job
йүгереү	jogging
ҡатнашырға	join
уртаҡ	joint
быуын	joint
шаяртыу	joke
журналист	journalist
сәйәхәт	journey
шатлыҡ	joy
хөкөм итергә	judge
вәли	judge
һут	juice
июль	july
һикерергә	jump
июнь	june
иҫке-моҫҡо	junk
ғәҙел	just
эле генә	just
эшлә лә ҡуй	just do it
ғәҙеллек	justice
аҡларға	justify
калааллисут теле	Kalaallisut
дәртле	keen
һаҡларға	keep
ҡалдырырға	keep
артабан да шулай булһын	keep it up
тотҡан	kept
сәйгүн	kettle
төп	key
асҡыс	key
тибергә	kick
бала	kid
шаяртып	kidding
бөрө	kidney
балалар	kids
үлтерергә	kill
һәйбәт	kind
изге	kind
әйтерһең дә	kinda
һөйкөмлө	kindly
изгелек	kindness
король	king
үбергә	kiss
аш бүлмәһе	kitchen
осорғос	kite
бесәй балаһы	kitten
тубыҡ	knee
белгән	knew
бысаҡ	knife
рыцарь	knight
белергә	know
белем	knowledge
билдәле	known
конкани теле	Konkani
крио теле	Krio
этикетка һалыу	label
этикетка	label
хеҙмәт	labor
хеҙмәт	labour
етмәҫкә	lack
баҫҡыс	ladder
леди	lady
ханым	lady
һалынған	laid
күл	lake
бәрәс	lamb
аҡһаҡ	lame
лампа	lamp
ер өҫтөнә ҡунырға	land
ил	land
пейзаж	landscape
тел	language
итәк	lap
өлкән	large
дауам итергә	last
һуңғы	last
һуңғыһы, әммә мөһим	last but not least
фамилия	last name
һуң	late
был арала	lately
һуңыраҡ	later
иң һуңғыһы	latest
һуңғы	latter
көлөргә	laugh
көлөү	laughing
көлкө	laughter
осорорға	launch
кер йыуыу	laundry
закон	law
газон	lawn
юрист	lawyer
һалырға	lay
ҡат	layer
ойоштороу	layout
ялҡау	lazy
ҡурғаш	lead
алып барырға	lead
етәксе	leader
япраҡ	leaf
ағып кәмергә	leak
ябыҡ	lean
һикерергә	leap
өйрәнергә	learn
өйрәнеү	learning
ҡуртымға алыу	lease
иң аҙ	least
кәжән	leather
китергә	leave
ҡалдырыу	leave
китә	leaves
япраҡтар	leaves
алып килтергән	led
һулға	left
ҡалған	left
аяҡ	leg
мираҫ	legacy
законлы	legal
легенда	legend
законға ярашлы	legit
ял ваҡыты	leisure
бурысҡа бирергә	lend
оҙонлоҡ	length
аҙыраҡ	less
дәрес	lesson
бирергә	let
хат	letter
хәреф	letter
салат үләне	lettuce
кимәл	level
рычаг	leverage
яуаплылыҡ	liability
китапхана	library
яларға	lick
ялған	lie
ятырға	lie
буш һүҙҙәр	lies
ята	lies
тормош	life
мендерергә	lift
лифт	lift
ут	light
еңел	light
яндырырға	light
йәшен	lightning
яҡтылыҡ	lightning
оҡшатырға	like
моғайын	likely
шулай уҡ	likewise
һыҙыҡ	line
лингала теле	Lingala
һылтанма	link
арыҫлан	lion
шыйыҡса	liquid
күсермә	list
тыңларға	listen
тыңлау	listening
ысын мәғәнәһендә	literally
әҙәбиәт	literature
сүп сар	litter
бәләкәй	little
йәшәргә	live
тере тауыш	live
бауыр	liver
йәшәүсе	liver
йәшәй	lives
кешенең ғүмерҙәре	lives
йәшәү	living
ҡунаҡ бүлмәһе	living room
кеҫәртке	lizard
йөк	load
эшһеҙ тик йөрөргә	loaf
буханка	loaf
бурысҡа	loan
урындағы	local
урынлашыуы	location
бикләргә	lock
йоҙаҡ	lock
бөҙрә	lock
карантин	lockdown
бүрәнә	log
лол	lol
яңғыҙ	lonely
ынтылырға	long
оҙон	long
күптән күрешмәнек	long time no see
ҡараш	look
ҡарарға	look
элмәк	loop
көрпәк	loose
мөмкинлек бирергә	loose
хужа	lord
юғалтырға	lose
юғалтыу	loss
юғалған	lost
насип	lot
күп	lot
көслө	loud
ҡунаҡ бүлмәһе	lounge
яратырға	love
мөхәббәт	love
һине яратам	love you
йәмле	lovely
ләпәк	low
түбәнерәк	lower
тоғро	loyal
тоғролоҡ	loyalty
уңыш	luck
уңышлы	lucky
луганда теле	Luganda
багаж	luggage
киҫәк	lump
төшкө аш	lunch
үпкә	lungs
зиннәтлек	luxury
алдау	lying
ятҡан	lying
машина	machine
уҫал	mad
аҡылдан яҙған	mad
мадам	madam
эшләгән	made
журнал	magazine
магазин	magazine
мөһабәт	magnificent
хеҙмәтсе	maid
ҡыҙ	maid
төп	main
дауам итергә	maintain
хеҙмәтләндереү	maintenance
майтхили теле	Maithili
бөтәһенән бигерәк	major
майор	major
күпселек	majority
итергә	make
макияж	make up
килешергә	make up
ир кеше	male
сауҙа үҙәге	mall
кеше	man
булдыра алырға	manage
етәкселәр	management
менеджер	manager
мәжбүри	mandatory
беленергә	manifest
хәйлә ҡорорға	manipulate
рәүеш	manner
инструкция	manual
күп	many
был көндә иң изге теләктәремде еткерәм	many many happy returns of the day
март	march
маршта йөрөргә	march
һаҡлам	margin
баҙар	market
никах	marriage
никахта торған	married
битлек	mask
күп кеше ҡатнашҡан	mass
сикһеҙ	massive
белгес	master
әфәнде	master
ҡушланырға	match
шырпы	match
дуҫ	mate
материал	material
математика	math
йомош	matter
әһәмиәт тоторға	matter
өлгөргәнлек	maturity
май	may
мөмкин	may
ихтимал	maybe
миңә	me
мин дә	me too
ашамлыҡ	meal
яман	mean
ҡарау	mean
мәғәнә	meaning
йүн	means
күҙ уңында тотҡан	meant
шул арала	meanwhile
үлсәргә	measure
саралар	measures
ит	meat
медицина	medical
медицина	medicine
дарыу	medicine
медитация	meditation
уртаса	medium
осрарға	meet
осрашыу	meeting
манипури теле	Meiteilon
ирергә	melt
иҫтәлектәр	memories
хәтер	memory
психик	mental
телгә алырға	mention
телгә алынған	mentioned
остаз	mentor
сауҙагәр	merchant
шәфҡәтлелек	mercy
генә	merely
раштыуа байрам менән	merry christmas
бардак	mess
хәбәр	message
иптәлмәгән	messy
металл	metal
ысул	method
сысҡандар	mice
уртаса	middle
төн уртаһы	midnight
көс	might
күпшек	mild
этап	milestone
хәрби	military
һөт	milk
миллион	million
ҡаршы әйтергә	mind
аҡыл	mind
фекерләү образы	mindset
минеке	mine
шахта	mine
ҡушылырға	mingle
икенсе дәрәжәләге	minor
бәлиғ булмаған	minor
минут	minute
минуттар	minutes
мөғжизә	miracle
көҙгө	mirror
төрлө	miscellaneous
шаян	mischievous
ҡыҙғаныс	miserable
ҡайғы-хәсрәт	misery
ҡалдырырға	miss
һағынырға	miss
тейҙерә алмаҫҡа	miss
һине һағындым	miss you
юғалған	missing
миссия	mission
томан	mist
хата	mistake
мизо теле	Mizo
мобиль	mobile
мыҫҡыл итергә	mock
модель	model
уртаса	moderate
кәметергә	moderate
хәҙерге	modern
баҫалҡы	modest
дымландырырға	moist
еүешлек	moisture
формалаштырырға	mold
форма	mold
миң	mole
әсәй	mom
саҡ	moment
дүшәмбе	monday
аҡса	money
староста	monitor
күҙәтергә	monitor
маймыл	monkey
ай	month
кәйеф	mood
мыжыҡ	moody
ай	moon
әхлаҡи	moral
күберәк	more
ул ғына ла түгел	moreover
иртә	morning
ипотека	mortgage
күпселек	most
күпселек	mostly
әсәй	mother
хәрәкәт	motion
мотивация	motivation
тау	mountain
сысҡан	mouse
ауыҙ	mouth
ҡуҙғалырға	move
хәрәкәт	movement
кино	movie
миссис	mrs
йәбештерергә	mrs
күп	much
бысраҡ	mud
көрөшкә	mug
мускул	muscle
музей	museum
бешмәк	mushroom
музыка	music
тейеш	must
кәрәклек	must
тауышһыҙ	mute
үҙ-ара	mutual
минең	my
Ҡәҙерлем	My dear
дуҫым	my friend
Минең һауа карабым йыланбалыҡтар менән тулы	My hovercraft is full of eels
йәнем	my love
минең исемем	my name is
рәхәтләнеп	my pleasure
үҙемде	myself
серле	mysterious
сер	mystery
миф	myth
сөй	nail
тырнаҡ	nail
бер ҡатлы	naive
исем	name
хикәйә	narrative
тар	narrow
ерәнес	nasty
милли	national
милләт	nationality
туған	native
тәбиғи	natural
тәбиғәт	nature
күңел болғаныу	nausea
янында	near
яҡында	nearby
тиерлек	nearly
ипле	neat
кәрәк	necessary
муйын	neck
муйынсаҡ	necklace
кәрәк	need
мохтажлыҡ	need
тиҫкәре	negative
иғтибар итмәҫкә	neglect
фекер алышырға	negotiate
күрше	neighbor
өлөш	neighborhood
бер ниндәй ҙә	neither
бер туғандың улы	nephew
аҡыллы баш	nerd
ҡыҙыу	nervous
оя	nest
селтәр	net
селтәр	network
нейтраль	neutral
бер ҡасан да	never
бер ҡасан да бирешмә	never give up
мөһим түгел	never mind
мөһим түгел	nevermind
шулай булһа ла	nevertheless
яңы	new
яңылыҡтар	news
киләһе	next
эргәһендә	next to
һәйбәт	nice
танышыуыма бик шатмын	nice to meet you
бер туғандың ҡыҙы	niece
төн	night
төнгө кошмар	nightmare
туғыҙ	nine
ун туғыҙ	nineteen
туҡһан	ninety
Юҡ	No
ҡайғырма	no problem
бер ни өсөн дә	no way
бер кем дә	nobody
шау	noise
шаулы	noisy
бер кем дә	none
төш	noon
юҡ	nope
ғәҙәти	normal
төнъяҡ	north
танау	nose
ерһенмәү	nostalgic
түгел	not
бер нисек тә	not at all
арыу	not bad
Әле түгел	Not now
әлегә юҡ	not yet
иғтибар итергә	note
билдәләнгән	noted
бер нимә лә	nothing
иғтибар итергә	notice
күреп ҡалған	noticed
исем	noun
исемдәр	nouns
роман	novel
ноябрь	november
һәҙер	now
беҙҙең заманда	nowadays
күңелһеҙлек	nuisance
нуль	null
ҡатҡанлыҡ	numb
номер	number
һан	number
медсестра	nurse
сәтләүек	nut
мөшкәт	nutmeg
туҡланыу	nutrition
ант	oath
һимереү	obesity
буйһонорға	obey
объект	object
ҡаршы килергә	object
маҡсат	objective
йөкләмә	obligation
тоноҡ	obscure
күҙәтеү	observation
күҙәтергә	observe
йынғаныҡ	obsessed
мауығыу	obsession
иҫке	obsolete
ҡаршылыҡ	obstacle
ҡулға төшөрөргә	obtain
өлгәшкән	obtained
ап-асыҡ	obvious
моғайын	obviously
ҡайһы берҙә	occasionally
һөнәр	occupation
мәшғүл	occupied
барлыҡҡа килергә	occur
булған	occurred
килеп сыға	occurs
океан	ocean
октябрь	october
сәйер	odd
мөмкинлектәр	odds
әлбиттә	of course
һүндерелгән	off
кәмһетеүле	offensive
тәҡдим итергә	offer
тәҡдим	offer
офис	office
вазифалы кеше	official
рәсми	official
йыш	often
Уф	Oh
о, шулаймы ни	oh really
май	oil
ярай	ok
ярар, ҡәҙерлем	ok dear
ярай ҡәҙерлем минең	ok honey
ярай йөрәкәйем	ok my love
ярай	okay
ярай бәләкәсем	okay baby
ярай ҡәҙерлем	okay dear
ярай йәнем	okay honey
ярай йөрәкәйем	okay my love
ҡарт	old
иҫке	old
бер тапҡыр	once
бер	one
бер тел бер выҡытта ла етмәй	one language is never enough
һуған	onion
онлайн	online
генә	only
асыҡ	open
операция	operation
фекер	opinion
мөмкинлектәр	opportunities
мөмкинлек	opportunity
киреһенсә	opposite
оптимист	optimistic
вариант	option
ихтыяри	optional
йәки	or
ҡыҙғылт һары	orange
әфлисун	orange
тәртип	order
бойороҡ бирергә	order
ябай	ordinary
ойошма	organization
йүнәлеш алыу	orientation
сығыш	origin
үҙгәле	original
иң тәүге	original
оромо теле	Oromo
етем бала	orphan
икенсе	other
башҡаса	otherwise
тейеш	ought
беҙҙең	our
Беҙҙең миссия: һәр кемгә, ҡайҙа ғына булһа ла, донъяны аңларға һәм үҙенең фекерен төрлө телдәрҙә әйтергә мөмкинлек биреү.	Our mission: to enable everyone, everywhere to understand the world and express themselves across languages.
Беҙҙең миссия: донъя мәғлүмәтен системалаштырыу һәм уны дөйөм ҡулланылышлы һәм файҙалы итеү.	Our mission: to organize the world's information and make it universally accessible and useful.
тышта	out
һөҙөмтә	outcome
кейем-һалым	outfit
алсаҡ	outgoing
сығыш	outlet
контур	outline
тышта	outside
данлыҡлы	outstanding
духовка	oven
өҫтөндә	over
тегендә	over there
дөйөм алғанда	overall
еңеп сығырға	overcome
күп уйлау	overthinking
тетрәнгән	overwhelmed
өҫтөнлөк иткән	overwhelming
бурыслы булырға	owe
өкө	owl
биләргә	own
үҙенеке	own
хужа	owner
үгеҙ	ox
тиҙлек	pace
төргәкләргә	pack
төрөү материалы	package
түләүле	paid
ауыртыу	pain
буярға	paint
картина	painting
пар	pair
аҡһыл	pale
ус	palm
кәстрүл	pan
пандемия	pandemic
паника	panic
ыштан	pants
гәзит	paper
ҡағыҙ	paper
ожмах	paradise
параллель	parallel
посылка	parcel
ғәфү итергә	pardon
ата-әсә	parents
парк	park
торатырға	park
тутыйғош	parrot
петрушка	parsley
өлөш	part
ҡатнашырға	participate
айырым	particular
атап әйткәндә	particularly
партнер	partner
байрам	party
үтергә	pass
абзац	passage
үтеү	passage
үткән	passed
дәрт	passion
дәртле	passionate
пассив	passive
пароль	password
үткән	past
ямаулыҡ	patch
юл	path
меҫкен	pathetic
сабырлыҡ	patience
түҙемле	patient
пациент	patient
өлгө	pattern
пауза	pause
тротуар	pavement
түләргә	pay
түләү	payment
тыныс	peace
тыныс	peaceful
персик	peach
түбә	peak
груша	pear
борсаҡ	peas
үҙенсәлекле	peculiar
һейҙек	pee
һейергә	pee
әрсергә	peel
ҡабыҡ	peel
йәштәш	peer
ҡорҙаштер	peers
ручка	pen
ҡәләм	pencil
көтә-көтә	pending
кешеләр	people
борос	pepper
үҙләштерергә	perceive
зиһенгә алыу	perception
идеаль	perfect
башҡарырға	perform
тамаша	performance
ихтимал	perhaps
период	period
нөктә	period
даими	permanent
рөхсәт	permission
рөхсәт итергә	permit
ныҡышмалылыҡ	perseverance
сыҙамлы	persistent
кеше	person
шәхси	personal
шәхес	personality
ҡараш	perspective
ышандырырға	persuade
аҙғын кеше	pervert
йорт хайуаны	pet
фаза	phase
күренеш	phenomenon
философия	philosophy
телефон	phone
фото	photo
фраза	phrase
физик	physical
һайларға	pick
күтәрергә	pick up
рәсем	picture
киҫәк	piece
өлөштәр	pieces
сусҡа	pig
күгәрсен	pigeon
өйөм	pile
мендәр	pillow
летчик	pilot
төйрәүес	pin
ананас	pineapple
алһыу	pink
һөйәк	pit
соҡор	pit
ыҫмала	pitch
бирергә	pitch
йәлләү	pity
урын	place
ҡуйырға	place
урындар	places
чума	plague
ябай	plain
план	plan
самолет	plane
үҫемлек	plant
завод	plant
үҫемлек	plants
заводтар	plants
тәрилкә	plate
платформа	platform
спектакль	play
уйнарға	play
уйнау	playing
рәхәт	pleasant
кинәндерергә	please
рөхсәт	please
ҡәнәғәт	pleased
шатлыҡ	pleasure
вәғәҙә	pledge
күп	plenty
сюжет	plot
тығырға	plug
бөкө	plug
слива	plum
сантехник	plumber
күплек	plural
подкаст	podcast
шиғыр	poem
шиғриәт	poetry
мәрәй	point
нөктә	point
ағыу	poison
полиция	police
сәйәсәт	policy
ипле	polite
бысраныу	pollution
быуа	pond
бассейн	pool
ярау итергә	poop
ярлы	poor
поп	pop
шартларға	pop
танылған	popular
популяция	population
халыҡ һаны	population
сусҡа ите	pork
һоло бутҡаһы	porridge
порт	port
вазифа	position
позиция	position
ыңғай	positive
эйә булырға	possess
милек	possession
эйәлек	possessive
мөмкин	possible
һалырға	post
бағана	post
кисектерергә	postpone
картуф	potato
потенциаль	potential
фунт	pound
ярлылыҡ	poverty
көс	power
хакимлыҡ	power
көслө	powerful
ғәмәли	practical
практика	practice
күнегеүгә	practice
маҡтарға	praise
шаяртыу	prank
намаҙ уҡырға	pray
ҡиммәтле	precious
теүәл	precise
дөрөҫ	precisely
юрарға	predict
өҫтөнлөк бирергә	prefer
өҫтөнлөк	preference
йөклө ҡатын	pregnant
тиҫкәре мөнәсәбәт	prejudice
тәүшарттар	premises
юғары сорт	premium
әҙерлек	preparation
әҙерләнергә	prepare
әҙер	prepared
ярҙамсы һүҙ	preposition
препозиция	preposition
барлыҡ	presence
хәҙерге	present
бүләк	present
хәҙерге заман	present
презентация	presentation
һаҡлап ҡалырға	preserve
президент	president
баҫырға	press
баҫыу	press
баҫым	pressure
юрамал ҡыланырға	pretend
дәғүә итергә	pretend
матур	pretty
байтаҡ	pretty
булдырмарға	prevent
алдағы	previous
табыш	prey
хаҡ	price
ғорурлыҡ	pride
дин әһеле	priest
баш	primary
төп	prime
принцесса	princess
баш	principal
алдында	prior
өҫтөнлөк	priority
төрмә	prison
яңғыҙлыҡ	privacy
шәхси	private
айырым хоҡуҡ	privilege
приз	prize
моғайын	probably
мәсьәлә	problem
процедура	procedure
дауам итергә	proceed
эшкәртергә	process
процесс	process
етештерергә	produce
продукт	product
етештереү	production
һөнәр	profession
профессиональ	professional
профиль	profile
файҙа	profit
нигеҙле	profound
алға барырға	progress
прогресс	progress
проект	project
күренекле	prominent
вәғәҙә	promise
вәғәҙә итеү	promise
булышырға	promote
вазифаһын күтәреү	promotion
тиҙ	prompt
әүәҫ	prone
алмаштар	pronouns
әйтелеше	pronunciation
дәлил	proof
тейешле	proper
дөрөҫ	properly
үҙенсәлектәр	properties
милек	property
тәҡдим	proposal
перспектива	prospect
гөрләү	prosperity
хәлле	prosperous
яҡларға	protect
ғорур	proud
иҫбатларға	prove
тәьмин итергә	provide
тәҡдим ителгән	provided
провинция	province
тәьминәт	provision
енси өлгөргәнлек	puberty
йәмәғәт	public
тартырға	pull
ҡабаҡ	pumpkin
пунктуаль	punctual
уҡыусы	pupil
һатып алған эйбер	purchase
таҙа	pure
көрән күк	purple
маҡсат	purpose
аҡса янсығы	purse
артынан төшөргә	pursue
эҙәрләү	pursuit
этергә	push
һалырға	put
квалификация	qualification
сифат	quality
һан	quantity
карантин	quarantine
бәхәс	quarrel
бәхәсләшергә	quarrel
сирек	quarter
кечуа теле	Quechua
королева	queen
сәйер	queer
һорау	query
шикләнергә	question
һорау	question
сират	queue
сиратта торорға	queue
тиҙ	quick
тиҙ	quickly
тыныс	quiet
һырылған юрған	quilt
ташларға	quit
бөтөнләй	quite
күп	quite
викторина	quiz
цитата	quotation
өҙөмтә килтерергә	quote
өҙөмтә	quote
тырнаҡтар	quotes
ҡуян	rabbit
уҙыш	race
раса	race
ярһыу	rage
ямғыр	rain
күтәреү	raise
үҫтерергә	raise
күтәрелгән	raised
йүгергән	ran
осраҡлы	random
диапазон	range
тиҙ	rapid
шәп	rapidly
һирәк	rare
һирәк	rarely
сабыртҡы	rash
ҡомаҡ	rat
тариф	rate
тиҙлек	rate
мөнәсәбәт	ratio
рациональ	rational
сей	raw
тағы	re
етергә	reach
һуҙырға	reach
еткән	reached
тейелгән	reached
реакция	reaction
уҡырға	read
уҡыу	reading
әҙер	ready
ысын	real
ысынбарлыҡ	reality
аңларға	realize
аңлаған	realized
ысынлап та	really
артҡы	rear
аҡыл	reason
сәбәп	reason
төплө	reasonable
иҫләргә	recall
чек	receipt
алырға	receive
алған	received
күптән түгел	recent
күптән түгел	recently
ҡабул итеү	reception
рецепт	recipe
аҡылһыҙ	reckless
танылыу	recognition
танырға	recognize
кәңәш бирергә	recommend
кәңәш бирелгән	recommended
яҙымта	record
яҙырға	record
һауығырға	recover
тергеҙелеү	recovery
тура дүртмөйөш	rectangle
ҡыҙыл	red
түләп алырға	redeem
ҡотҡарыу	redemption
кәметергә	reduce
артыҡ	redundant
ебәрергә	refer
һылтанма	reference
көҙнәргә	reflect
сағылыш	reflection
тыйылырға	refrain
һыуытҡыс	refrigerator
аҡса кире бирергә	refund
кире ҡағырға	refuse
баш тартты	refused
ихтирам	regard
тураһында	regarding
бойондороҡһоҙ	regardless
ихтирам менән	regards
регион	region
теркәргә	register
үкенергә	regret
тигеҙ	regular
нормаль	regular
регуляр	regularly
кире ҡағырға	reject
ҡағылырға	relate
ҡағылышлы	related
бәйләнеш	relationship
туған	relative
сағыштырма	relative
ҡәрҙәштәр	relatives
ял итергә	relax
ебәрергә	release
сығарырға	release
ебәрелгән	released
тейешле	relevant
ышаныслы	reliable
еңеллек	relief
еңеләйтергә	relieve
еңеләйтелгән	relieved
дин	religion
динле	religious
теләмәгән	reluctant
ышанырға	rely
ҡалырға	remain
ҡалған	remaining
иҫ киткес	remarkable
сара	remedy
иҫтәргә	remember
иҫкә төшөрөргә	remind
иҫкәртмә	reminder
алыҫ	remote
сығарып алырға	remove
яһарға	render
ҡуртым	rent
йүнәтергә	repair
ҡабатларға	repeat
алмаштырырға	replace
яуап бирергә	reply
яуап	reply
доклад яһарға	report
отчет	report
күрһәтеү	represent
репутация	reputation
һорарға	request
һорау	request
кәрәк	require
биргеҙәм	required
ҡотҡарырға	rescue
ғилми хеҙмәт	research
иҫкәртергә	resemble
асыу	resentment
бронләү	reservation
иплелек	reserve
резерв	reserve
йәшәүсе	resident
отставкаға китергә	resign
һығылмалылыҡ	resilience
һығылмалы	resilient
ҡаршылыҡ күрһәтергә	resist
ҡаршылыҡ	resistance
ҡарар	resolution
ҡыйыулыҡ етергә	resolve
һыйыныр урын	resort
ҡулланырға	resort
курорт	resort
ресурстар	resources
хөрмәт	respect
хөрмәт итергә	respect
яуап бирергә	respond
яуап	response
яуаплылыҡ	responsibility
яуаплы	responsible
ял итергә	rest
башҡалар	rest
тупрағы еңел булһын	rest in peace
ресторан	restaurant
элекке хәленә ҡайтарырға	restore
сикләргә	restrict
һөҙөмтә	result
һөҙөмтәләр	results
яңыртырға	resume
ваҡлап һатыу	retail
тотоп торорға	retain
һаҡлап ҡалыу	retention
пенсияла	retired
сигенергә	retreat
сығарырға	retrieve
кире бирергә	return
кире барырға	return
фаш итергә	reveal
асыҡланған	revealed
үс алыу	revenge
һатыуҙан килгән аҡса	revenue
кире	reverse
байҡау яһарға	review
байҡау	review
яңынан ҡарарға	revise
ҡайтанан тикшереү	revision
инҡилап	revolution
награда	reward
ритм	rhythm
ҡабырға	rib
рис	rice
бай	rich
ҡотолорға	rid
йөрөргә	ride
сәфәр	ride
аҡылға һыймаҫлыҡ	ridiculous
уңға	right
дөрөҫ	right
шунда уҡ	right now
ҡаты	rigid
доңғолдарға	ring
балдаҡ	ring
йыуырға	rinse
бола	riot
өҙөк	rip
өҙөргә	rip
бешкән	ripe
күтәреү	rise
күтәрергә	rise
ҡурҡыныс	risk
ҡурҡыныс аҫтына ҡуйырға	risk
көнәркәш	rival
йылға	river
юл	road
ҡыҙҙырырға	roast
ныҡ	robust
таш	rock
рок	rock
сыбыҡ	rod
роль	role
ҡатлама	roll
төргәк	roll
ҡыйыҡ	roof
бүлмә	room
тамыр	root
бау	rope
серек	rotten
ҡытыршы	rough
тупаҫлы	roughly
яҡынса	roughly
түңәрәк	round
маршрут	route
рутина	routine
саф	row
ышҡырға	rub
юйғыс	rubber
резина	rubber
сүп сар	rubbish
тупаҫлыҡ	rude
балаҫ	rug
емереп бөтөрөргә	ruin
етәкселек итергә	rule
ҡағиҙә	rule
хаким	ruler
мистар	ruler
ҡағиҙәләр	rules
етәкселек итергә	run
йүгерергә	run
йүгереүсе	running
ауыл	rural
ашығырға	rush
ҡабаланыу	rush
тоҡ	sack
эштән сығарырға	sack
изге	sacred
ҡорбан	sacrifice
хәүефһеҙ	safe
хәйерле осоу	safe flight
хәүефһеҙлек	safety
тәрән аҡыллы	sage
әйткән	said
елкәнле карап менән һыуға сығырға	sail
елкән спорты менән шөғөлләнеү	sailing
өсөн	sake
эш хаҡы	salary
һатып бөтөрөү	sale
һөмбаш	salmon
тоҙ	salt
шундай уҡ	same
Шулай уҡ	Same here
өлгө	sample
ҡом	sand
санскрит теле	Sanskrit
саркастик	sarcastic
тәүәккәл	sassy
ултырған	sat
ҡәнәғәтләнеү	satisfaction
ҡәнәғәт	satisfied
ҡәнәғәтләндерергә	satisfy
ҡәнәғәтләнерлек	satisfying
шәмбе	Saturday
сосиска	sausage
вәхши	savage
ҡотҡарырға	save
бысҡы	saw
күрҙе	saw
әйтергә	say
мизан	scale
афера	scam
яра эҙе	scar
етер-етмәҫ	scarce
ҡурҡытылҡан	scared
шарф	scarf
ҡурҡыныс	scary
һибелгән	scattered
мәүкиғ	scene
күренеш	scene
пейзаж	scenery
еҫ	scent
теҙмә	schedule
билдәрергә	schedule
мәктәп	school
фән	science
ғалим	scientist
ғалимдар	scientists
ҡайсы	scissors
әрләргә	scold
масштаб	scope
иҫәп	score
киҫәк	scrap
бәшәк	scratch
ҡысҡырырға	scream
экран	screen
шөрөп	screw
сценарий	script
диңгеҙ	sea
мисәт	seal
тюлень	seal
эҙләргә	search
миҙгел	season
сезон	season
урын	seat
икенсе	second
секунд	second
йәшерен	secret
бүлек	section
хәүефһеҙ	secure
ышаныс биреү	security
һаҡ	security
хәүефһеҙлек	security
күрергә	see
күрешербеҙ	see you
һуңыраҡ күрешербеҙ	see you later
тиҙҙән күрешербеҙ	see you soon
иртәгә күрешербеҙ	see you tomorrow
орлоҡ	seed
эҙләргә	seek
күренергә	seem
күренә	seems
күргәне	seen
тотоп алырға	seize
алым	seizure
өйәнәк	seizure
һирәк	seldom
һайларға	select
үҙе	self
үҙ сәләмәтләнеү	self healing
эгоистик	selfish
һатырға	sell
ебәрергә	send
миңә үҙ фотоңды ебәр әле	send me your picture
өлкән	senior
тойғо	sense
аҡыллы	sensible
күренерлек	sensitive
ебәрелгән	sent
иректән мәхрүм итеү	sentence
һөйләм	sentence
һөйләмдәр	sentences
айырым	separate
сепеди теле	Sepedi
сентябрь	september
эҙмә-эҙлелек	sequence
киҙемтә	series
етди	serious
етди	seriously
хеҙмәт итергә	serve
хеҙмәтләндереү	service
сессия	session
йыйылма	set
асыҡларға	set
башларға	set up
параметр	setting
ҡунларға	settle
ете	seven
ун ете	seventeen
етмеш	seventy
бер нисә	several
ҡаты	severe
ауыр	severe
тегергә	sew
тс	sh
күләгә	shade
төҫмөр	shade
күләгә	shadow
һелкенергә	shake
булыр	shall
ваҡ-төйәк	shallow
хурлыҡ	shame
ҡалып	shape
акция	share
бүлешергә	share
киҫкен	sharp
ул	she
уныҡы бар	she has
ул	she is
һарай	shed
һарыҡ	sheep
ҡағыҙ	sheet
кәштә	shelf
ҡабырсаҡ	shell
һыйыныу	shelter
ҡалҡан	shield
күсеш	shift
смена	shift
яҡтырырға	shine
карап	ship
ташыу	shipping
күлдәк	shirt
аяҡ кейеме	shoes
төшөрөргә	shoot
атырға	shoot
магазин	shop
магазиндар буйлап йөрөү	shopping
яр	shore
ҡыҫҡа	short
етмәү	shortage
атырға	shot
атыу	shot
тейеш	should
ҡулбаш	shoulder
ҡысҡырырға	shout
күрһәтергә	show
күргәҙмә	show
күрһәтәле	show me
душ	shower
креветка	shrimp
бөршәйергә	shrink
ябырға	shut
ауыҙыңды яп	shut up
оялсан	shy
ҡәрҙәш	sibling
ағайҙары һәм апайҙары	siblings
ауырыу	sick
яҡ	side
тын алыу	sigh
күренес	sight
иҫтәлекле урындарҙы ҡарау	sightseeing
билдә	sign
ҡултамға	signature
мөһим	significant
тыныслыҡ	silence
тыныс	silent
ебәк	silk
ахмаҡ	silly
көмөш	silver
оҡшаған	similar
иҫәүән	simp
ябай	simple
бер үк ваҡытта	simultaneously
ихласлыҡ	sincere
ихлас күңелдән	sincerely
йырларға	sing
йырсы	singer
яңғыҙ	single
раковина	sink
батырға	sink
Сэр	Sir
апай	sister
һеңле	sister
килен	sister in law
еңгә	sister in law
ҡәйенбикә	sister in law
ултырырға	sit
урын	site
сайт	site
хәл	situation
алты	six
ун алты	sixteen
алтмыш	sixty
үлсәм	size
оҫталыҡ	skill
оҫталыҡтар	skills
тир	skin
ябыҡ	skinny
бармай ҡалырға	skip
итәк	skirt
күк йөҙө	sky
ҡоллоҡ	slave
йоктарға	sleep
йоклау	sleeping
йоҡоло	sleepy
еңдәр	sleeve
киҫергә	slice
киҫәк	slice
шыуырға	slide
аҙ ғына	slightly
ябыҡ	slim
хата	slip
шыуырға	slip
һөҙәклек	slope
ярыҡ	slot
яй	slow
яй	slowly
бәләкәй	small
зирәк	smart
еҫ	smell
йылмайырға	smile
йылмайыу	smile
төтөн	smoke
шыма	smooth
ашамлыҡ	snack
ҡусҡар	snail
йылан	snake
сиртергә	snap
ҡар	snow
шулай	so
шул тиклем һөйкөмлө	so cute
әлегәсә	so far
еүешләргә	soak
һабын	soap
айыҡ	sober
футбол	soccer
йәмәғәт	social
йәмғиәт	society
ойоҡбаштар	socks
йомшаҡ	soft
программа тәьминәте	software
тупраҡ	soil
һатылған	sold
һатылып бөткән	sold out
һалдат	soldier
табан	sole
берҙән-бер	sole
ҡаты	solid
сиселеш	solution
хәл итергә	solve
ҡайһы бер	some
кемдер	somebody
нисектер	somehow
бер кем	someone
нимәлер	something
ҡайһы берҙә	sometimes
йыр	song
тиҙҙән	soon
ҡатмарлы	sophisticated
сорани теле	Sorani
ауырыу	sore
йәрәхәт	sore
ауырыу тамаҡ	sore throat
ҡайғы	sorrow
Ғәфү ит	Sorry
төр	sort
сорттарға айырыу	sort
эҙләгән	sought
йән	soul
туғанлыҡ йәне	soulmate
яңғырарға	sound
тауыш	sound
аш	soup
әсе	sour
сығанаҡ	source
көнъяҡ	south
арауыҡ	space
йыһан	space
спам	spam
ара	span
Испан	Spanish
һаҡларға	spare
запас	spare
һөйләшергә	speak
айынсыҡ	special
төр	species
үҙгәлекле	specific
тәьҫирле	spectacular
һүҙ	speech
телдән ҡалған	speechless
тиҙлек	speed
арбау	spell
хәрефләп әйтергә	spell
үткәрергә	spend
тоторға	spend
тотоп бөтөргән	spent
әсе	spicy
сәнскәк	spike
өйрөлөргә	spin
шпинат	spinach
рух	spirit
төкөрөү	spit
бынамын тигән	splendid
айырыу	split
айырырға	split
боҙорға	spoil
боҙолған	spoiled
үҙенән-үҙе барлыҡҡа килгән	spontaneous
ҡалаҡ	spoon
урын	spot
тап	spot
иптәш	spouse
таратырға	spread
һикерергә	spring
яҙ	spring
майҙан	square
ҡыҫырға	squeeze
кальмар	squid
аҡһым	squirrel
сәнсергә	stab
тотороҡло	stable
ат һарайы	stable
өйөм	stack
эштәшлек	staff
сәхнә	stage
осор	stage
тап	stain
баҫҡыс	stairs
ҡаҙыҡ	stake
муйт	stake
аңдырырға	stalk
һабаҡ	stalk
кәртә	stall
оҙон-оҙаҡҡа һуҙырға	stall
тамға	stamp
стенд	stand
торорға	stand
стандартлы	standard
йондоҙ	star
башларға	start
башланған	started
аслыҡ	starving
дәүләт	state
белдерергә	state
белдереү	statement
станция	station
статуя	statue
статус	status
тормаҡ	stay
ҡалырға	stay
иҫән булып тор	stay safe
тотороҡло	steady
стейк	steak
урларға	steal
пар	steam
ҡорос	steel
текә	steep
һабаҡ	stem
баҫырға	step
аҙым	step
таяҡ	stick
йәбештерергә	stick
ҡаты	stiff
элеккесә	still
томроҡ	still
сағырға	sting
ярлы	stingy
һаран	stingy
болғарға	stir
мөгәзәй	stock
урланған	stolen
ашҡаҙан	stomach
таш	stone
торған	stood
артһыҙ ултырғыс	stool
туҡтарға	stop
һаҡлау	storage
һаҡлыҡҡа һалырға	store
дауыл	storm
хикәйә	story
мейес	stove
төҙ	straight
тура	straightforward
кирелеш	strain
сәйер	strange
ят	strange
таныш түгел кеше	stranger
стратегия	strategy
һалам	straw
ер еләге	strawberry
һыҙат	streak
ағыш	stream
урам	street
көс	strength
баҫым	stress
стресс	stress
һуҙылырға	stretch
ҡәтғи	strict
һуғырға	strike
эш ташлау	strike
еп	string
буй	strip
һыҙырырға	strip
тырышырға	strive
инсульт	stroke
көслө	strong
һуғылған	struck
структура	structure
көрәш	struggle
көрәшергә	struggle
ҡыйынлыҡтарға юлыҡҡан	struggling
тиҫкәре	stubborn
батып ҡалған	stuck
студент	student
уҡыусы	student
уҡырға	study
уҡыу	study
уҡыу	studying
нәмәләр	stuff
иҫ киткес	stunning
аҡылһыҙ	stupid
стиль	style
подданный	subject
дусар итергә	subject
фән	subject
буйһоноу	submission
буйһонорға	submit
ҡарауға ҡуйырға	submit
матдә	substance
алмаш	substitute
нескә	subtle
уңышҡа ирешергә	succeed
уңыш	success
уңышлы	successful
ундай	such
кеүек	such as
имергә	suck
ҡапыл	sudden
көтмәгәндә	suddenly
ғазапланырға	suffer
яфаланыу	suffering
етерлек	sufficient
шәкәр	sugar
тәҡдим итергә	suggest
тәҡдим	suggestion
тура килергә	suit
костюм	suit
килештерелгән	suitable
сумаҙан	suitcase
ҡушылдыҡ	sum
һығымта	summary
йәй	summer
илбаштар йыйыны	summit
түбә	summit
ҡояш	sun
йәкшәмбе	sunday
ҡояшлы	sunny
ҡояш быйыу	sunset
ҡояш нуры	sunshine
бик	super
өҫтөнөрәк	superior
күҙәтсе	supervisor
киске аш	supper
тапшырыу	supply
тәьмин итергә	supply
ярҙам	support
күтәремләргә	support
уйларға	suppose
күҙалланған	supposed
әлбиттә	sure
инаныулы	sure
өҫтө	surface
сәпелдәү	surge
хирургия	surgery
операция	surgery
фамилия	surname
көтөлмәгәнлек	surprise
аптыраған	surprised
бирешергә	surrender
тирәге	surrounding
күҙәтеү	surveillance
белем тикшереү	survey
байҡарға	survey
иҫән ҡалырға	survive
шикләнергә	suspect
шик	suspect
туҡтатып торолған	suspended
ялартҡыс	suspicious
бирешмәҫкә	sustain
тотороҡлолоҡ	sustainability
тотороҡло	sustainable
талап йыйылған эйбер	swag
ҡарлуғас	swallow
йоторға	swallow
алмашыу	swap
ант итергә	swear
һүгек һүгергә	swear
тирләргә	sweat
свитер	sweater
һеперергә	sweep
шәрбәт	sweet
тыныс йоҡо	sweet dreams
тәмлетамаҡ	sweet tooth
һөйгәнем	sweetheart
шешенергә	swell
шешлек	swelling
йөҙөргә	swim
йөҙөү	swimming
сайҡалырға	swing
бәүетергә	swing
һүндергес	switch
тоташтырырға	switch
шешенгән	swollen
ҡылыс	sword
символ	symbol
теләктәшлек	sympathy
симптомдары	symptoms
система	system
йәҙүәл	table
өҫтәл	table
хәл итергә	tackle
ярлыҡ	tag
ҡойроҡ	tail
алырға	take
алып китергә	take away
һаҡ бул	take care
сисергә	take off
алынған	taken
һөйләшергә	talk
һүҙ	talk
телсән	talkative
бейек	tall
баҫырға	tap
кран	tap
таҫма	tape
маҡсат	target
төҙәү	target
мәсьәлә	task
тәмләп ҡарарға	taste
тәм	taste
тәмле	tasty
өйрәткән	taught
сәй	tea
өйрәтергә	teach
уҡытыусы	teacher
команда	team
йыртырға	tear
йәш	tear
күҙ йәштәр	tears
ҡорсоторға	tease
технология	technology
тештәр	teeth
әйтергә	tell
эйтәле миңә	tell me
холоҡ	temper
температура	temperature
сикә	temple
ғибәҙәтхана	temple
ваҡытлы	temporary
ун	ten
ун мең	ten thousand
арендатор	tenant
ынтылырға	tend
үҫеш йүнәлеше	tendency
наҙлы	tender
заман	tense
ныҡ тартылған	tense
көсөргәнеш	tension
палатка	tent
алдан	tentative
сирек	term
срок	term
шарт	term
шарттар	terms
ҡот осҡос	terrible
иҫ киткес	terrific
территория	territory
тест	test
тест буйынса һынарға	test
яҙырға	text
текст	text
рәхмәт белдерергә	thank
рәхмәт	thank you
Беҙ һеҙҙең сабырлыҡҡа рәхмәтлебеҙ, һеҙ көткёнегеҙ өсөн, әлегә беҙ посылканы тикшерҙек	Thank you for your patience while we investigate shipment
ҙур рәхмәт	thank you so much
ҙур рәхмәт	thank you very much
рәхмәт	thanks
Беҙҙең приложение менән ҡулланғаны өсөн рәхмәт	Thanks for using our app
тип	that
йәғни	that is
яҡшы	that's good
урлау	theft
уларҙың	their
уларҙы	them
тема	theme
үҙ-үҙеңде	themselves
шунан	then
ул ваҡытта	then
тәғлимәт	theory
шунда	there
унда	there are
бында бар	there is
шуға күрә	therefore
был	these
улар	they
улар	they are
ҡуйы	thick
ҡараҡ	thief
мосай	thigh
йоҡаҡ	thin
нәмә	thing
эйберҙәр	things
уйларға	think
өсөнсө	third
һыуһаған	thirsty
ун өс	thirteen
утыҙ	thirty
ошо	this
был	this is
ентекле	thorough
ентекләп	thoroughly
шулар	those
ләкин	though
уй	thought
уйлаәған	thought
уйсан	thoughtful
фекерҙәр	thoughts
мең	thousand
еп	thread
хәүеф	threat
ҡурҡытырға	threaten
өс	three
тупһа	threshold
тулҡынланған	thrilled
уңышҡа өлгәшергә	thrive
тамаҡ	throat
аша	through
дауамында	throughout
бәрергә	throw
ҙур бармаҡ	thumb
күк күкрәү	thunder
кесаҙна	Thursday
шулай итеп	thus
билдә ҡуйырға	tick
текелдәү	tick
һыу ҡалҡыу	tide
таҙа	tidy
бәйләргә	tie
галстук	tie
юлбарыҫ	tiger
тығыҙ	tight
тигринья теле	Tigrinya
тапҡыр	time
ваҡыт	time
оялсан	timid
бәләкәй генә	tiny
ос	tip
кәңәштәр	tips
покрышка	tire
йонсоторға	tire
арыған	tired
туҡыма	tissue
исем	title
булырға	to be
киптерелгән икмәк киҫәге	toast
бөгөн	today
атлай алған бала	toddler
аяҡ бармаҡтары	toes
бергә	together
бәҙрәф	toilet
әйткән	told
толерантлыҡ	tolerance
түҙергә	tolerate
помидор	tomato
иртәгә	tomorrow
тел	tongue
бөгөн кис	tonight
шулай уҡ	too
алған	took
инструмент	tool
инструменттар	tools
теш	tooth
өҫтө	top
мәсьәлә	topic
өҙөлгән	torn
ғазап	torture
дөйөм	total
тейергә	touch
ҡаты	tough
тур	tour
табан	toward
ҡаршы	towards
таҫтамал	towel
ҡала	town
ағыулы	toxic
эҙ	trace
андып	track
сауҙа итергә	trade
сауҙа	trade
йола	tradition
традицион	traditional
хәрәкәт	traffic
эҙ	trail
күнегеү үткәрергә	train
поезд	train
күнегеүҙәр	training
характер һыҙаты	trait
шәхес һыҙаттары	traits
күсерергә	transfer
күсеү	transition
тәржемә итергә	translate
үтә күренмәле	transparent
транспорт	transport
йөк ташыу	transportation
тоҙаҡ	trap
сүп сар	trash
йәрәхәт	trauma
сәйәхәт итергә	travel
батмус	tray
хазина	treasure
тоторға	treat
һый	treat
мөнәсәбәт	treatment
ағас	tree
ғәйәт ҙур	tremendous
тенденция	trend
һынау	trial
мәхкәмә тәфтише	trial
хәйлә	trick
тырышҡан	tried
триггер	trigger
активацияларға	trigger
тигеҙләргә	trim
тәртипкә килтерергә	trim
сәфәр	trip
бәлә	trouble
салбар	trousers
йөк машина	truck
хәҡиҡәт	true
олон	trunk
ышанырға	trust
ышаныс	trust
дөрөҫлөк	truth
тырышырға	try
тсонга теле	Tsonga
торба	tube
шишәмбе	Tuesday
уҡытыу	tuition
уҡыу өсөн түләү	tuition
күркә ите	turkey
куркума	turmeric
борорға	turn
гөбөргәйел	turtle
тәрбиәсе	tutor
ун ике	twelve
егерме	twenty
егерме бер	twenty-one
чви теле	Twi
ике тапҡыр	twice
әйләндерергә	twist
ике	two
тип	type
баҫҡытырға	type
типик	typical
йәмһеҙ	ugly
һуңғы	ultimate
сатыр	umbrella
һәләтһеҙ	unable
ағай	uncle
бабай	uncle
һушһыҙ	unconscious
аҫтында	under
аҫтында	underneath
баһалап еткермәгән	underrated
аңларға	understand
аңлаған	understood
ҡыҙғанысҡа ҡаршы	unfortunately
униформа	uniform
уникаль	unique
берәмек	unit
университет	university
билдәһеҙ	unknown
түгел иһә	unless
тиклем	until
үҙенсәлекле	unusual
өҫкә	up
һинән тора	up to you
яңыртыу	update
яңыртырға	update
яңыртыу	upgrade
яңыртырға	upgrade
өҫтөндә	upon
боҙорға	upset
күңелһеҙ	upset
ҡала	urban
мәжбүр итергә	urge
нәфсе	urge
ашығыс	urgent
беҙҙе	us
файҙаланырға	use
файҙаланыу	use
ҡулланылған	used
файҙалы	useful
файҙаһыҙ	useless
ғәҙәти	usual
ғәҙәттә	usually
файҙалылыҡ	utility
ял	vacation
вакцинация	vaccination
вакцина	vaccine
вакуум	vacuum
тоноҡ	vague
йоғоносло	valid
ғәмәлдәк	valid
үҙән	valley
ҡиммәтле	valuable
баһа бирергә	value
байлыҡ	value
күплек	variety
төрлө	various
айырылырға	vary
ваза	vase
киң	vast
йәшелсә	vegetable
йәшелсә	vegetables
транспорт	vehicle
һатыусы	vendor
ағыу	venom
предприятие	venture
осрашыу урыны	venue
тикшерергә	verify
төрлө яҡлы	versatile
версия	version
вертикаль	vertical
бик	very
бик яҡшы	very good
судно	vessel
аша	via
вибрация	vibe
мөхит	vibes
аяуһыҙ	vicious
ҡорбан	victim
видео	video
күренеш	view
ауыл	village
яуыз	villain
һеркә	vinegar
иҫке модалағы	vintage
көс ҡулланыу	violence
көсләү	violent
вируслы	viral
ғиффәтле	virgin
ысын	virtual
изгелек	virtue
күреү	vision
визит	visit
килеп инергә	visit
визуаль	visual
тормошсан	vital
асыҡ	vivid
һүҙҙәр запасы	vocabulary
тауыш	voice
бушлыҡ	void
күләм	volume
ирекмән	volunteer
ҡоҫоҡ	vomit
ҡоҫорға	vomit
йомшаҡ	vulnerable
эш хаҡы	wage
эш хаҡы	wages
бил	waist
көтөргә	wait
официант	waiter
көтөү	waiting
уятырға	wake
уянырға	wake up
йөрөргә	walk
йөрөп килеү	walk
йөрөү	walking
стена	wall
янсыҡ	wallet
ҡыҙырырға	wander
теләргә	wanna
теләргә	want
эҙләнеүсе	wanted
теләгән	wanted
һуғыш	war
гардероб	wardrobe
склад	warehouse
йылытырға	warm
йылы	warm
иҫкәртергә	warn
иҫкәртеү	warning
яугир	warrior
булған	was
йыуырға	wash
буш юғалтыу	waste
юҡҡа эшләргә	waste
ҡарарға	watch
ҡул сәғәт	watch
һыу	water
ҡарбуз	watermelon
тулҡын	wave
юл	way
беҙ	we
беҙ	we are
беҙ эшләй алабыҙ	we can
көсһөҙ	weak
көсһөҙлөк	weakness
байлыҡ	wealth
хәлле	wealthy
кейергә	wear
арытҡыс	wearing
кейеп йөрөгән	wearing
һауа	weather
туй	wedding
Шаршамбы	Wednesday
ҡый үләне	weed
аҙна	week
ял көнө	weekend
үлсәргә	weight
ауырлыҡ	weight
сәйер	weird
рәхим итегеҙ	welcome
байлыҡ	welfare
ярҙам аҡса	welfare
Ярай	Well
Ҡоҙоҡ	Well
Шулай итеп	Well
афарин	well done
барған	went
булдылар	were
көнбайыш	west
дымлы	wet
кит	whale
нимә	what
ә һин	what about you
нимә эшләйһең	what are you doing
һәҙер һин нимә эшләйһең	what are you doing now
һин хәҙер нимә эшләйһең	what are you doing right now
Һин кем булып эшләйһең	what do you do
һин йәшәү өсөн нимә эшләйһең	what do you do for a living
һин нимә эйтергә теләйһең	what do you mean
һиң нимә кәрәк	what do you want
нимә булды	what happened
нимә ул	what is
был нимә ул	what is this
һеҙ кем булып эшләйһегеҙ	what is your job
һинең исемең нисек	what is your name
ниндәй яңылыҡтар бар	what's up
исемең нисек	what's your name
нимә генә булмаһа	whatever
бойҙай	wheat
тәгәрмәс	wheel
ҡасан	when
һәр тапҡыр	whenever
ҡайҙа	where
һин ҡайҙа	where are you
һин ҡайҙан	where are you from
һин хәҙер ҡайҙа	where are you now
һин ҡайҙа йәшәйһең	where do you live
ҡайҙа	where is
шул уҡ ваҡытта	whereas
ҡайһы	which
шул арала	while
бышылдау	whisper
һыҙғырырға	whistle
аҡ	white
кем	who
һин кем	who are you
кем	who is
был кем ул	who is this
бөтөн	whole
кемде	whom
кемдең	whose
нимәгә	why
ни өсөн	why
ниңә юҡ	why not
уҫал	wicked
киң	wide
тол ҡатын	widow
киңлек	width
ҡатын	wife
ҡыр	wild
ирек	will
әҙер	willing
еңеү яуларға	win
йел	wind
тәҙрә	window
елле	windy
шарап	wine
ҡыш	winter
һөртөргә	wipe
сым	wire
аҡыл	wisdom
аҡыллы	wise
теләк	wish
теләргә	wish
иң яҡшы теләктәр	wish you all the best
сихырсы	witch
менән	with
кире алырға	withdraw
кире алыу	withdrawal
эсендә	within
-һеҙ	without
шаһит	witness
шаһит булырға	witness
үткер аҡыллы	witty
бүре	wolf
ҡатын ҡыҙ	woman
ҡатын ҡыҙҙар	women
еңеү яулаған	won
булмаясаҡ	won't
ғәжәпләнергә	wonder
ғәжәп	wonderful
ағас	wood
йөн	wool
һүҙ	word
һүҙҙәр	words
эшләргә	work
эш	work
күнегеү	work out
эшләгән	working
донья	world
селәүсен	worm
туҙған	worn
болоҡһотоҡ	worried
борсолорға	worry
насарыраҡ	worse
табынырға	worship
иң насар	worst
лайыҡ	worth
иғтибарға лайыҡ	worth it
лайыҡ	worthy
ине	would
яра	wound
Вау	Wow
урарға	wrap
асыу	wrath
шаушаҡ	wrist
яҙырға	write
Бында яҙығыҙ	Write here
яҙыу	writing
яҙылған	written
дөрөҫ түгел	wrong
яҙған	wrote
ихата	yard
иҫнәү	yawn
иҫнәргә	yawn
Әйе	Yeah
йыл	year
йылдар	years
сүпрә бәшмәк	yeast
ҡысҡырырға	yell
һары	yellow
Эйе	Yes
эйе балаҡайым	yes baby
эйе ҡәҙерлем	yes dear
эйе йәнем	yes honey
эйе йөрәкәйем	yes my love
эйе әлбиттә	yes of course
кисэнге	yesterday
әле	yet
уңыш	yield
сығарырға	yield
һин	you
һин	you are
һин сибәр	you are beautiful
һин шундай матур	you are so beautiful
рәхим итегеҙ	you are welcome
һин алаң	you can
Беләһеңме	You know
һин дә	you too
рәхим итегәҙ	you're welcome
йәш	young
һинең	your
рәхим итегеҙ	your welcome
үҙен	yourself
йәш саҡ	youth
йәшлек	youth
рәхим итегеҙ	you’re welcome
тәмле	yummy
нуль	zero
