kadikit	a little
dakulon	a lot
dakol nin	a lot of
pabayaan	abandon
pabayaan	abandoned
utob	abide
kakayahan	ability
may kakayahan	able
manungod	about
itaas	above
ibang nasyon	abroad
mayo	absence
dai naglaog	absent
lubos	absolutely
nasopsop	absorb
abstrak	abstract
mayong katotoohan	absurd
abunda	abundance
abundansiya	abundant
pag-abuso	abuse
abuso	abuse
akuon	accept
aksidente	accident
dagusan	accommodation
magibo	accomplish
nagibo na	accomplished
oyon sa	according
eksakto	accuracy
tama	accurate
akusado	accused
kulog	ache
nagkukulog	ache
makamtan	achieve
nakamtan	achievement
minidbid	acknowledge
kamidbid	acquaintance
kua	acquire
nakua	acquired
nakua	acquisition
sa ibong	across
gibo	act
aksyon	action
aktibo	active
aktibidad	activities
aktibidad	activity
artista	actor
aktuwal	actual
sa totoo	actually
malala	acute
maki-angay	adapt
dagdag	add
sugapa	addicted
dagdag	addition
kadagdagan	additional
istaran	address
magtaram	address
sapat	adequate
kataed	adjacent
isaayos	adjust
hanga	admire
akuon	admit
kupkop	adopt
kagusto-gusto	adorable
masulong	advanced
bentaha	advantage
pamamasyar	adventure
anunsiyo	advertisement
anunsiyo	advertising
sadol	advice
payo	advise
nagtataguyod	advocate
tagapagtaguyod	advocate
estitiko	aesthetic
pangyayari	affair
apekto	affect
pagpahiling nin pagkamoot	affection
kayang bumakal	afford
abot-kaya	affordable
takot	afraid
pagkatapos	after
hapon	afternoon
pagkatapos	afterwards
giraray	again
kontra sa	against
edad	age
ahensiya	agency
ahente	agent
agresibo	aggressive
maliksi	agile
kaidto	ago
nagkasundo	agree
kasunduan	agreement
agrikultura	agriculture
naeenot	ahead
tabang	aid
katuyuhan	aim
hangin	air
eropuerto	airport
pasilyo	aisle
takot	alarm
alkohol	alcohol
alerto	alert
buhay	alive
gabos	all
gabos tama	all right
tugot	allow
tinugutan	allowed
halos	almost
solo	alone
sa gilid	along
tapos na	already
iyo man	also
alternatibo	alternative
maski	although
pirme	always
makangalas	amazing
bakong malinaw	ambiguous
ambisyon	ambition
ambisyoso	ambitious
binago	amend
sa tahaw	amid
sa mga	among
satuya	among us
halaga	amount
nakakaogma	amusing
sarong	an
analisar	analysis
mga ginikanan	ancestors
angkla	anchor
suanoy	ancient
asin	and
asin ika	and you
anghel	angel
kaangotan	anger
anggulo	angle
anggot	angry
hayop	animal
buol	ankle
anibersaryo	anniversary
anunsiyo	announcement
uyam	annoy
nauyam	annoyed
makauyam	annoying
taunan	annual
iba	another
magsimbag	answer
simbag	answer
antisipar	anticipate
nababahala	anxiety
nababahala	anxious
maski arin	any
pa	anymore
maski siisay	anyone
maski ano	anything
baga man	anyway
kunsabagay	anyways
bulag	apart
hagad tawad	apologize
hiling hiling	apparent
gari	apparently
apela	appeal
magbutwa	appear
itsura	appearance
nagbutwa	appeared
gana	appetite
mansanas	apple
aplikasyon	application
appointment	appointment
apresyar	appreciate
apresasyon	appreciation
magrani	approach
pagrani	approach
angay	appropriate
pag-oyon	approval
aprobar	approve
naaprubahan	approved
halos	approximately
abril	april
bakong makatwiran	arbitrary
arkitekto	architect
arkitektura	architecture
ika daw	are you
dakol kang gibo	are you busy
may agom kana	are you married
kasal ka o mayong agom	are you married or single
Yaon pa kamo diyan?	Are you still there?
yaon ka diyan	are you there
lugar	area
diskusyon	argue
argumento	argument
bangon	arise
takyag	arm
soldados	army
sa palibot	around
pakarhayon	arrange
kaayusan	arrangement
pag-abot	arrival
nag-abot	arrive
nag-abot	arrived
arogante	arrogant
pana	arrow
arte	art
artikulo	article
artipisyal	artificial
pintor	artist
arog kan	as
hanggang sa	as long as
iyo man	as well
siring man kan	as well as
abo	ash
supog	ashamed
hapot	ask
naghapot	asked
turog	asleep
aspeto	aspect
asunto	assault
asembleya	assembly
mapamirit	assertive
karkulo	assess
pagsadiri	asset
mga pagsadiri	assets
nag-asignar	assign
asignasyon	assignment
magtabang	assist
katabang	assistant
asosyar	associate
asosyado	associated
asosasyon	association
asumir	assume
paghuna	assumption
sa	at
minsan paano	at least
nagkaon	ate
atleta	athlete
kadukot	attach
nakadukot	attached
kadukot	attachment
atake	attack
binalo	attempt
pagbalo	attempt
atender	attend
pagdalo	attendance
atensyon	attention
aktitud	attitude
dagka	attract
atraksyon	attraction
magayon	attractive
atributo	attribute
mga naghihling	audience
agosto	august
inaon	aunt
tiyaon	aunty
awtor	author
awtoridad	authority
tigrakdag	autumn
igwa	available
likay	avoid
mata	awake
premyo	award
aram	aware
kaaraman	awareness
mayo digdi	away
makangangalas	awesome
nakakatakot	awful
bakong komportable	awkward
aki	baby
mayong agom na lalaki	bachelor
likod	back
dangog	background
maraot	bad
bag	bag
subad	bait
bakalan nin tinapay	bakery
timbang	balance
timbangon	balance
bola	ball
batag	banana
banda	band
banko	bank
bihira	barely
subasta	bargain
nagbabatok	bark
batok	bark
harang	barrier
base	base
base sa	based
sirong kan harong	basement
talaga	basically
bastardo	bastard
grupo	batch
karigusan	bath
karigusan	bathroom
baterya	battery
labanan	battle
magin	be
magin maingat	be careful
pampang nin dagat	beach
sinag	beam
gisantes	beans
tioson	bear
oso	bear
bigote	beard
nagdadara	bearing
hayop	beast
daog	beat
daogon	beat
magayon	beautiful
gayon	beauty
nagin	became
huli	because
naging	become
higdaan	bed
kwarto	bedroom
sugod	bee
karneng baka	beef
nagin	been
bago	before
nagpuon	began
magpuon	begin
kapinunan	beginning
sa pangaran ni	behalf
paghiro	behave
pag-uugali	behavior
pag-hiro	behaviour
likod	behind
pagkatawo	being
paniniwala	belief
tubod	believe
tulak	belly
kaiba	belong
namumutan	beloved
sa ibaba	below
paha	belt
tukawan	bench
tiko	bend
sa irarom	beneath
benepisyaran	benefit
benepisyo	benefit
mga benepisyo	benefits
sa gilid	beside
maliban sa	besides
pinaka	best
mas marahay	better
pag-ultanan	between
inumon	beverage
sa ibong kan	beyond
bakong pantay na trato	bias
igwa nin kinikilingan	biased
bisekleta	bicycle
dakula	big
bisekleta	bike
bayadan	bill
bugkuson	bind
bayong	bird
kumpleanyo	birthday
dikit	bit
kagaton	bite
kagat	bite
pait	bitter
itom	black
tarom	blade
pagbabasol	blame
basol	blame
blanko	blank
tamong	blanket
putok	blast
ikinula	bleach
maghalo	blend
bisa	bless
bendisyon	bless
benendisyunan	blessed
buta	blind
kaogmahan	bliss
harang	block
dugo	blood
namurak	bloom
huyop	blow
azul	blue
bakong mattarom	blunt
naglunad	board
bangka	boat
lawas	body
kalakaga	boil
huba	bold
agresibo	bold
bugkos	bond
tolang	bone
libro	book
magbunsod	boost
pagbubunsod	boost
pampakusog	booster
bota	boot
bota	boots
sagkodan	border
langkag	bore
langkag	bored
nalalangkag	boring
ipinangaki	born
suble	borrow
amo	boss
pareho	both
disturbuhon	bother
botelya	bottle
irarom	bottom
nagbakal	bought
talbog	bounce
pasiring	bound
sagkodan	boundaries
duko	bow
mangko	bowl
kahon	box
aking lalaki	boy
syota	boyfriend
pulseras	bracelet
hutok	brain
sanga	branch
maisog	brave
paglabag	breach
tinapay	bread
pahingalo	break
pasa	break
pamahawan	breakfast
dudo	breast
hinangos	breath
hangos	breathe
lahi	breed
laryo	brick
nobya	bride
tulay	bridge
halipot	brief
brip	brief
maliwanag	bright
matali	brilliant
magdara	bring
tugang na lalaki	bro
ha	broad
ibalingibog	broadcast
napasa	broke
pasa	broken
sigid	broom
tugang na lalaki	brother
bayaw	brother in law
nagdara	brought
de kape	brown
sipilyo	brush
balde	bucket
kurukaiba	buddy
badyet	budget
sublat	bug
magtindog	build
edipisyo	building
nagtindog	built
kadaklan	bulk
toro	bull
bunggo	bump
tumpok	bunch
bugkos	bundle
pagabat	burden
pasan	burden
ilubong	buried
sulo	burn
pagputok	burst
piglubong	bury
palungpong	bush
negosyo	business
dudo	bust
dakol na gibo	busy
pero	but
mantikilya	butter
alibangbang	butterfly
butones	button
magbakal	buy
paagi sa	by
maiba ako	by the way
paaram	bye
repolyo	cabbage
kabinet	cabinet
hawla	cage
keyk	cake
aki nin baka	calf
mag-apod	call
apod	call
apudan mo ako	call me
nag apod	called
kalmado	calm
nagdigdi	came
kampanya	campaign
makakagibo	can
lata	can
dai kayang gibuhon	can't
ikansela	Cancel
may kakayahan	capable
kapasidad	capacity
sentro	capital
kapital	capital
paliwanag	caption
nadakop	capture
awto	car
karera	career
maingat	careful
maingat	carefully
bakong maingat	careless
nagpapahalaga	caring
karpentero	carpenter
karpet	carpet
karot	carrot
darahon	carry
magpadagos	carry on
gibuhon	carry out
kaso	case
kwarta	cash
palayason	cast
kastilyo	castle
kaswal	casual
ikos	cat
dakop	catch
kategorya	category
bakahan	cattle
nakadakop	caught
kawsa	cause
magkawsa	cause
mag-ingat	caution
maingat	cautious
kweba	cave
nagpundo	cease
kisame	ceiling
selebrar	celebrate
sentro	center
Sentral Bikol	Central Bikol
siglo	century
seremonya	ceremony
nagkapira	certain
sigurado	certain
sigurado	certainly
sertipiko	certificate
kadena	chain
tukawan	chair
inangat	challenge
angat	challenge
tyansa	chance
magbago	change
karibukan	chaos
karakter	character
karakteristiko	characteristics
singil	charge
kawanggawa	charity
kaakit-akit	charming
tsart	chart
bukod	chase
mensahe	chat
pag-olay	chat
barato	cheap
magdaya	cheat
nandadaya	cheating
tsek	check
pisngi	cheek
mag ogma	cheer
masaling-gaya	cheerful
tagay	cheers
keso	cheese
pahalagahan	cherish
tses	chess
daghan	chest
nguya	chew
manok	chicken
hepe	chief
aki	child
pagkaaki	childhood
mga aki	children
lilipot	chill
lipot	chill
malipot	chill
tsimenea	chimneys
baba	chin
tsokolate	chocolate
pili	choice
pili	choose
tuktukon	chop
mga gibuhon sa harong	chores
simbahan	church
bilog	circle
mga sikumstansiya	circumstances
mamamayan	citizen
siyudad	city
kuanon	claim
habol	claim
klaruhon	clarify
klase	class
laboy	clay
malinig	clean
malinaw	clear
palinawon	clear
klerk	clerk
matali	clever
kliyente	client
bangin	cliff
klima	climate
sakat	climb
relo	clock
sarado	close
baduan	closet
tela	cloth
mga bado	clothes
panganuron	cloud
mapanganuron	cloudy
payaso	clown
malamya	clumsy
tumpok	cluster
magtokdo	coach
tagapagtokdo	coach
uring	coal
kosta	coast
pinahidan	coat
kape	coffee
kamalayan	cognitive
kaparehong pangyayari	coincidence
malipot	cold
nagaba	collapse
kwelyo	collar
kairiba	colleague
mga pag-iriba	colleagues
kolekta	collect
koleksyon	collection
letsugas	college
kolor	color
mayong kolor berde mga idea nagkaturog anggoton	colorless green ideas slept furiously
kolor	colour
kolum	column
sukray	comb
kombinasyon	combination
pagsalakon	combine
magdigdi	come
magdigdi ka	come here
magdigdi ka	come on
libang	comfort
komportable	comfortable
madigdi	coming
maabot na	coming soon
sugo	command
komento	comment
komersyal	commercial
komisyon	commission
komiter	commit
pangako	commitment
nagkasundo	committed
paninda	commodity
normal	common
kumonikar	communicate
komunikar	communication
kumunidad	community
naglunad	commute
kaibanan	companion
kumpanya	company
komparar	compare
pagkuumparar	comparison
pakikidamay	compassion
maheherakon	compassionate
bagay	compatible
nakipagkompetensiya	compete
may kakayahan	competent
kompetisyon	competition
kompetensiya	competitive
reklamo	complain
reklamo	complaint
komplemento	complement
kumpleto	complete
kompleto	completely
komplikado	complex
pagsunod	compliance
komplikado	complicated
komendasyon	compliment
sumunod	comply
komposisyon	composition
tambalan	compound
pang intindi	comprehension
komprehensibo	comprehensive
ikompromiso	compromise
kasunduan	compromise
sapiritan	compulsory
kompyuter	computer
konsentrar	concentrate
konsepto	concept
pagmamalasakit	concern
nababahala	concern
nababahala	concerned
konsyerto	concert
konklusyon	conclusion
sinisemento	concrete
kongkreto	concrete
kondisyon	condition
mga kondisyon	conditions
pag-uugali	conduct
komperensiya	conference
amin	confess
kompyansa	confidence
may kompyansa	confident
kumpirmahon	confirm
dai pagkakasinabutan	conflict
libong	confused
pagkalibong	confusion
pandugtong	conjunction
kumonekta	connect
sakop	conquer
may pakaisi	conscious
pakaisi	consciousness
pagtugot	consent
tugutan	consent
konsekwensiya	consequences
konserbasyon	conservation
konserbatibo	conservative
magkonsiderar	consider
kinunsiderar	considered
kaiba	consist
mayong pagbabago	consistency
dai nagbabago	consistent
padagos	constant
nagpapadagos	constantly
dai nakakaudo	constipation
konstruksiyon	construction
kunsumo	consume
konsumo	consumption
kontakon	contact
nakakaulakit	contagious
laog	contain
igwa nin	contains
kontemporaryo	contemporary
paghamak	contempt
laog	content
paurumbasan	contest
konteksto	context
kontinente	continent
magpadagos	continue
kontrata	contract
makipagkontrata	contract
pag-ibahon	contrast
kaibahan	contrast
magkontribwer	contribute
kontribusyon	contribution
kontrol	control
kontro	controversial
kombeniente	convenience
kombinyente	convenient
kombersasyon	conversation
kumberte	convert
kumbertihon	convert
ihatod	convey
kumbinsihon	convince
kumbinsido	convinced
tagapagaluto	cook
magluto	cook
nagluluto	cooking
malipot	cool
kooperasyon	cooperation
makaya	cope
tanso	copper
pusod	core
mais	corn
kanto	corner
tama	correct
danyos	cost
gastos	cost
bado	costume
kubo	cottage
koton	cotton
malumoy na tukawan	couch
ubo	cough
pwede	could
konseho	council
bilang	count
laban	counter
nasyon	country
kabukidan	countryside
mag-agom	couple
kusog nin buot	courage
kurso	course
korte	court
kortesiya	courtesy
pinsan	cousin
takop	cover
baka	cow
talaw	coward
maginhawa	cozy
kasag	crab
pasaon	crack
pasa	crack
mayong kwenta	crap
salpukan	crash
magbangga	crash
kamang	crawl
bua	crazy
maggibo	create
mapagimbento	creative
kredito	credit
gapang	creep
katakut-takot	creepy
grupo	crew
krimen	crime
krisis	crisis
kriterion	criteria
kritikal	critical
kritisismo	criticism
pananom	crop
mga pananom	crops
krus	cross
magbalyo	cross
uwak	crow
grupo nin tawo	crowd
pano	crowded
korona	crown
sobrang importante	crucial
maringis	cruel
layag	cruise
runuton	crush
pagrunot	crush
mahibi	cry
pipino	cucumber
kugos	cuddle
kultura	culture
tuso	cunning
kopya	cup
estante	cupboard
kurbada	curb
kurba	curb
bulongon	cure
bulong	cure
kuryusidad	curiosity
usyosero	curious
kurong	curly
kwarta	currency
kuryente	current
sa presente	current
sa presente	currently
sumpa	curse
kuritna	curtain
sapin	cushion
kustombre	custom
kustombre	customs
putol	cut
putulon	cut
siklo	cycle
pagbibisikleta	cycling
ama	dad
papa	daddy
aro-aldaw	daily
pagibuhan nin gatas	dairy
dike	dam
danyaran	damage
danyos	damage
dumog nin dikit	damp
bayle	dance
peligro	danger
delikado	dangerous
madiklom	dark
gatlang	dash
makipaghilingan	date
petsa	date
aking babaye	daughter
aldaw	day
gadan	dead
huring aldaw o oras	deadline
bungog	deaf
namumutan	dear
Gabos na namumutan	Dear All
Namumutan na Kustomer	Dear Customer
Namumutan na mga magurang	Dear Parents
Namumutan na	Dear Sir
Namumutan na mga estudyante	Dear students
Namumutan na team	Dear Team
kagadanan	death
debate	debate
utang	debit
basura	debris
utang	debt
dekada	decade
naglalapa	decay
nagadan	deceased
daya	deceive
disyembre	december
desente	decent
magdesisyon	decide
nagdesisyon	decided
desisyon	decision
alantaga	deck
sayumahan	decline
bawasan	decrease
didekado	dedicated
didekasyon	dedication
gibo	deed
hararom	deep
usa	deer
piniling opsyon	default
palya	default
nadaog	defeat
daog	defeat
ipaglaban	defend
tawan kahulugan	define
sigurado	definitely
kahulugan	definition
lebel	degree
atraso	delay
pahaluyon	delay
naabala	delayed
haleon	delete
sinadya	deliberate
maselan	delicate
masiram	delicious
ogma	delight
naogma	delighted
hatod	deliver
naipadara na	delivered
pagkakataram	delivery
padara	delivery
pangangaipo	demand
kaipuhan	demand
dakol na kahagadan	demanding
demokrasya	democracy
demonyo	demon
demonstrar	demonstrate
sinayumahan	denied
dentista	dentist
magsayuma	deny
departamento	department
paghale	departure
asa	depend
ipadara	deploy
ideposito	deposit
deposito	deposit
sonrang kamunduan	depressed
depresyon	depression
rarom	depth
iladawan	describe
deskripsiyon	description
disyerto	desert
magin karapat-dapat	deserve
idisenyo	design
disenyo	design
designasyon	designation
pagmawot	desire
nagmamawot	desire
lamesa	desk
desesperasyon	despair
desperado	desperate
sa ibong kan	despite
pandulse	dessert
destinasyon	destination
tadhana	destiny
raoton	destroy
pagkagaba	destruction
detalye	detail
mga detalye	details
naaraman	detect
determinasyon	determination
determinado	determine
determinado	determined
wasak	devastated
uswag	develop
pag-uswag	developed
pag-uswag	development
diablo	devil
debotado	devoted
dyabetes	diabetes
nagkukurso	diarrhea
diksyunaryo	dictionary
naggibo	did
magadan	die
nagadan	died
pagkakaiba	difference
magkaiba	different
dipisil	difficult
magkalot	dig
dignidad	dignity
mahigos	diligent
pamanggihan	dinner
piglublob	dip
direkta	direct
direksyon	direction
direktor	director
ati	dirt
maati	dirty
baldado	disable
baldado	disabled
nawara	disappear
bigo	disappointed
kalamidad	disaster
itapok	discard
nakaluwas	discharge
disiplina	discipline
diskubre	discover
diskriminasyon	discrimination
pag-olayan	discuss
talakayan	discussion
helang	disease
mga helang	diseases
magsagin-sagin	disguise
makauyam-uyam	disgusting
pagkaon	dish
mga plato	dishes
tapuson	dismiss
pinalarga	dispatch
pagtapok	disposal
iriwal	dispute
distansiya	distance
naiiba	distinct
ipahiling an kaibahan	distinguish
pagkabahala	distress
distribwir	distribution
distrito	district
distorbo	disturb
kanal	ditch
sisid	dive
dakol	diverse
iba-ibang klase	diversity
bangaon	divide
banal	divine
diborsiyo	divorce
nag-diborsyo	divorce
lula	dizzy
gibo	do
ika daw	do you
namumutan mo ako	do you love me
doktor	doctor
dokumento	document
gibo	does
dai	doesn't
ayam	dog
ginigibo	doing
munyeka	doll
domestiko	domestic
dominante	dominant
dai mo	don't
Dai maghandal	Don't worry
donar	donate
tapos na	done
asno	donkey
gago	dope
doble	double
doblehon	double
pagdududa	doubt
magduda	doubt
masa	dough
baba	down
burador	draft
iplano	draft
butungon	drag
halean tubig	drain
mag-drowing	draw
drowing	drawing
natatakot	dread
pangaturogan	dream
mangaturogan	dream
bado	dress
nagluho	drill
inumon	drink
mag-inom	drink
magmaneho	drive
tagdo	drop
nagtatagdo	drop
nahulog	dropped
turong	drought
burat	drunk
mamara	dry
pato	duck
lalaki	dude
dapat bayadan	due
dahilan sa	due to
mangurol	dull
patal	dumb
itambak	dump
kahaluyan	duration
mantang	during
alpog	dust
trabaho	duty
nag-istar	dwell
harani nang magadan	dying
kada saro	each
kada saro	each other
sabik	eager
agila	eagle
talinga	ear
subago	earlier
amay	early
kita	earn
talinga	ears
kinaban	earth
linog	earthquake
madali	ease
madali	easily
sirangan	east
pasil	easy
kaon	eat
nagkakakan	eating
ekonomiya	economic
ekonomiya	economy
gilid	edge
baguhon	edit
edukasyon	education
epekto	effect
epektibo	effective
kahusayan	efficiency
paghihingoa	effort
sugok	egg
talong	eggplant
pagkamakaako	ego
walo	eight
dise otso	eighteen
otsenta	eighty
maski arin	either
magdagdag nin mga paliwanag	elaborate
siko	elbow
gurang	elder
gurang	elderly
elegante	elegant
elemento	element
elepante	elephant
onse	eleven
karapat-dapat	eligible
eliminar	eliminate
iba pa	else
supog	embarrassed
makasusupog	embarrassing
kugos	embrace
nagbutwa	emerge
emerhensiya	emergency
emosyunal	emotional
makidamay	empathy
iduon	emphasis
iduon	emphasize
empleyado	employee
mga empleyado	employees
trabaho	employment
mayong laog	empty
paganahon	enable
nagkatagbo	encounter
dagkahon	encourage
katapusan	end
dikit na sana an buhay	endangered
pagsisikap	endeavor
tatag	endurance
magtios	endure
kaiwal	enemy
enehiya	energy
nagkasundo	engage
may kasunduan na magpakasal	engaged
kompromiso	engagement
makina	engine
inhenyero	engineer
Ingles	English
pahusayon	enhance
mag-ogma	enjoy
dakulaon	enormous
tama sana	enough
siguraduhon	ensure
maglaog	enter
aling-alingan	entertainment
entusiasmo	enthusiasm
entusiastiko	enthusiastic
gabos	entire
igwa nin karapatan	entitled
entidad	entity
laogan	entrance
envelop	envelope
kapalibutan	environment
ara	envy
halaba	epic
epidemya	epidemic
pantay	equal
kagamitan	equipment
kapantay	equivalent
pambura	eraser
sala	error
magdulag	escape
lalo na	especially
sanaysay	essay
esensya	essence
esensyal	essential
establisar	establish
establisar	established
pagsadiri	estate
karkulo	estimate
karkulo	estimated
mayong katapusan	eternal
etika	ethics
ebalwar	evaluate
ebalwasyon	evaluation
maski	even
minsan siring	even though
banggi	evening
okasyon	event
sa huri	eventually
kasuarin man	ever
kada	every
gabos na tawo	everybody
gabos	everyone
gabos na bagay	everything
ebidensiya	evidence
maraot	evil
ebolusyon	evolution
nagbago	evolve
eksakto	exact
eksakto	exactly
siyasaton	examine
halimbawa	example
nagsobra	exceed
mahusay	excellent
maliban sa	except
dai kabale	exception
sobra	excess
sobra-sobra	excessive
salida	exchange
naoogma	excited
nananabik	excitement
nakakapukaw	exciting
ekslusibo	exclusive
dahilan	excuse
maki-	excuse me
isagibo	execute
pagsagibo	execution
ehekutibo	executive
ehersisyo	exercise
mag-ehersisyo	exercise
ubuson	exhaust
pagalon	exhausted
eksibit	exhibit
eksibisyon	exhibition
eksister	exist
pagkabuhay	existence
yaon	existing
luwasan	exit
magpahiwas	expand
laom	expect
nilalaoman	expected
mga gastos	expenses
mahal	expensive
ranas	experience
eksperiensiya	experience
eksperimento	experiment
eksperto	expert
esplikar	explain
eksplenasyon	explanation
pagsamantalahan	exploit
magsiyasat	explore
ipabakal sa luwas nin nasyon	export
hayag	expose
hayag	exposed
pahiling	exposure
magsabi	express
ekspresyon	expression
iabante	extend
pinalaba	extended
pagpapadagos	extension
hiwas	extent
panluwas	external
mayo na	extinct
ekstra	extra
kua	extract
ekstra ordinaryo	extraordinary
sobra	extreme
sobra-sobra	extremely
mata	eye
mata	eyes
tela	fabric
pabuluso	fabulous
atubangon	face
pandok	face
padalion	facilitate
pasilidad	facilities
pasilidad	facility
totoo	fact
dahilan	factor
pabrika	factory
katotoohan	facts
napara	fade
ibagsak	fail
bagsak	fail
nabagsak	failed
kabiguan	failure
nadismayo	faint
patas	fair
maputi	fair
mayong kinakampihan	fairly
engkantada	fairy
pagtubod	faith
maimbod	faithful
peke	fake
pagkahulog	fall
nahulog	fall
SALA	false
kasikatan	fame
pamilyar	familiar
pamilya	family
taggutom	famine
sikat	famous
tagahanga	fan
pamaypay	fan
magustuhan	fancy
bakong kapanipaniwala	fantastic
harayo	far
pamamaaram	farewell
uma	farm
parauma	farmer
kahanga-hanga	fascinating
uso	fashion
maliksi	fast
taba	fat
nakakagadan	fatal
kapaladan	fate
ama	father
pagal	fatigue
sala	fault
paborito	favorite
pabor	favour
paborito	favourite
natatakot	fear
takot	fear
piyesta	feast
balukag	feather
tampok	feature
itinampok	feature
pebrero	february
pano na	fed up
bayad	fee
bahog	feed
mate	feel
pagmate	feeling
bitis	feet
nahulog	fell
kaibanan	fellow
namatean	felt
babaye	female
kudal	fence
sagana	fertile
piyesta	festival
kinua	fetch
kalintura	fever
dikit	few
mas dikit	fewer
nobyo	fiance
gibo-gibong estorya	fiction
inadalan	field
uma	field
maisog	fierce
kinse	fifteen
singkwenta	fifty
maglaban	fight
laban	fight
nakikipaglaban	fighting
ikorte	figure
pigura	figure
isipon an solusyon	figure out
dokumento	file
tapal	fill
puno	filled
sine	film
maati	filthy
Sa pinakang huri	finally
pinansyal	finance
pinansyal	financial
hanap	find
magdiskubre	find out
karahayan	fine
marhay	fine
tuldo	finger
tapos	finish
natapos	finished
kalayo	fire
matibay	firm
kompanya	firm
enot	first
pangaran	first name
sira	fish
lapat	fit
lima	five
irahayon	fix
nairahay	fixed
bandera	flag
pantay	flat
depekto	flaw
mayong depekto	flawless
tumakas	flee
laman	flesh
naglayog	flew
tikuon	flex
nakakaangay	flexible
paglipad	flight
pabaliktad	flip
ligaw-biro	flirt
naglalandi	flirting
magpalataw	float
baha	flood
salog	floor
arina	flour
pagbulos	flow
nagbubulos	flow
burak	flower
kalintura	flu
abituwado	fluent
matatas	fluently
mayumok	fluffy
likido	fluid
layog	fly
magpokus	focus
pokus	focus
alupuop	fog
maalupuop	foggy
tiklop	fold
kaparyentes	folks
sunod	follow
sinusunod	following
pagkaon	food
tanga	fool
lokohon	fool
loko	foolish
bitis	foot
para sa	for
Halimbawa	For example
halimbawa	for instance
para saimo	for you
bawal	forbidden
pwersa	force
hula	forecast
angog	forehead
bakong pamilyar	foreign
dayuhan	foreign
kadlagan	forest
mayong sagkod	forever
lingawan	forget
patawadon	forgive
nalingawan	forgot
tinidor	fork
iporma	form
porma	form
pormal	formal
dati	former
marhay sa na	fortunately
kayamanan	fortune
kwarenta	forty
kwarenta y dos	forty-two
padagos	forward
pauswagon	foster
nakipaglaban	fought
nasumpungan	found
pundasyon	foundation
apat	four
katorse	fourteen
delikado	fragile
ikuwadro	frame
porma	framework
panglalanse	fraud
pambihira	freak
libre	free
katalingkasan	freedom
patagason	freeze
kapirmehan	frequency
pirme	frequent
pirme	frequently
presko	fresh
biyernes	friday
amigo	friend
makiamigo	friendly
mga barkada	friends
pakikipagkaibigan	friendship
natakot	frightened
nakakatakot	frightening
talapang	frog
hale sa	from
atubangan	front
nagyelo	frozen
prutas	fruit
nabigo	frustrated
gatong	fuel
pano	full
maogma	fun
punsyunar	function
pundamental	fundamental
lubong	funeral
makangingisi	funny
balukag	fur
anggoton	furious
muwebles	furniture
kadagdagan	further
kadagdagan pa	furthermore
puturo	future
magkinabang	gain
pakinabang	gain
kawat	game
siwang	gap
garahe	garage
basura	garbage
hardin	garden
bawang	garlic
tarangkahan	gate
magtiripon	gather
pagtiripon	gathering
pansukol	gauge
nagtao	gave
kasarian	gender
pangkagabsan	general
kadalasan	generally
maggibo	generate
henerasyon	generation
matinao	generous
matalion	genius
dyanra	genre
banayad	gentle
totoo	genuine
hiro	gesture
kua	get
masangli	get dressed
magbuhat	get up
magparahay ka	get well soon
pigkukua	getting
multo	ghost
pigmumulto	ghosting
higante	giant
regalo	gift
laya	ginger
aking babaye	girl
kailusyon na babaye	girlfriend
tao	give
sumuko	give up
itinao	given
naoogma	glad
salimbad	glance
baso	glass
mga baso	glasses
antipara	glasses
salimbad	glimpse
pambilog kinaban	global
madulom	gloomy
gwantes	gloves
kinang	glow
nagkikinang	glow
naggayon	glow up
pasta	glue
magduman	go
maenot kana	go ahead
humale ka	go away
magkaturog na	go to bed
pasohan	goal
mga gustog abuton	goals
kanding	goat
diyos	god
bendisyunan ka nin diyos	god bless you
nagduman	goes
maduman	going
pasiring sa	going to
bulawan	gold
nawara	gone
maduman	gonna
karahayan	good
marhay	good
marhay na hapon	good afternoon
paaram na	good bye
marhay na aldaw	good day
marhay na banggi	good evening
matibay	good job
marahay paghilingon	good looking
marhay na aga	good morning
marhay na aga sakong namumutan	good morning my love
paninda	goods
ganso	goose
magayunon	gorgeous
tsismis	gossip
nakua	got
nakua ko na	got it
gobyerno	government
kuanon	grab
grado	grade
luway luway	gradually
gradweyt	graduate
tupasi	grain
itao	grant
itinao	granted
ubas	grapes
masabutan	grasp
duot	grass
mapagpasalamat	grateful
pasasalamat	gratitude
lubungan	grave
abon	gray
dakula	great
kasibaan	greed
paslo	greedy
berde	green
tino	greet
pagbati	greeting
pagbati	greetings
abon	grey
giling	grid
kamunduan	grief
giling	grind
pagkakapot	grip
groseri	grocery
nobyo	groom
maati	gross
kabilogan	gross
daga	ground
grupo	group
tubo	grow
pagdakula	growth
pirmeng sinusumpong	grumpy
garantiya	guarantee
gwardiyahan	guard
gwardiya	guard
maghula	guess
bisita	guest
paggiya	guidance
igiya	guide
giya	guide
may sala	guilty
lalaki	guy
ugali	habit
istaran	habitat
nagkaigwa	had
uran na may yelo	hail
buhok	hair
kabanga	half
bulwagan	hall
kamot	hand
kaputan	handle
manehar	handle
gwapo	handsome
bitay	hang
nangyari	happen
nangyari	happened
kaogmahan	happiness
maogma	happy
manigong bagong taon	happy new year
matagas	hard
garu bako	hardly
bakong kadalasan	hardly ever
danyos	harm
danyusan	harm
nakakaraot	harmful
pagkakasundo	harmony
malupit	harsh
ani	harvest
igwa	has
uyam	hate
igwa	have
magkaigwa nin marhay na aldaw	have a good day
magkaigwa nin marhay na aldaw	have a nice day
magpamahaw na	have breakfast
mag-ogma	have fun
nagkakan ka na	have you eaten
igwa	having
peligro	hazard
manipis na panganuron	haze
siya	he
igwa siya	he has
siya	he is
payo	head
kulog payo	headache
bulungon	heal
nabubulong	healing
salud	health
marhay an salud	healthy
dangog	hear
nadangog	heard
puso	heart
magpainit	heat
init	heat
langit	heaven
magabat	heavy
dipisil	hectic
langkaw	height
tagapagmana	heir
kinaputan	held
imperno	hell
hello kumusta ka	hello how are you
kumusta	hello how are you doing
helmet	helmet
tabang	help
matinabang	helpful
kaya	hence
siya	her
kawan	herd
digdi	here
minana	heritage
nagduduwa-duwa	hesitate
Uy	Hey
kumusta ka na	hi how are you
natatago	hidden
magtago	hide
herarkiya	hierarchy
halangkaw	high
sakat	hike
pagtukad	hiking
makangirit	hilarious
bulod	hill
siya	him
ideya	hint
piad	hip
piad	hips
arkila	hire
nag-aako	hiring
saiyang	his
kasaysayan	history
tamaan	hit
Umm	Hmm
libangan	hobby
kaputan	hold
maghalat	hold on
luho	hole
buwang	hollow
harong	home
aisgnasyon	homework
onesto	honest
may pagka-onesto	honestly
Honey	Honey
Dugos	Honey
onra	honor
talukbong	hood
kawit	hook
lukso	hop
nag-aasa	hope
pag-asa	hope
sana	hopefully
mayong pag-asa	hopeless
pahigda	horizontal
busina	horn
sungay	horn
nkakatakot	horrible
makatakot	horror
kabayo	horse
ospital	hospital
marhay na pag-ako	hospitality
palaban	hostile
mainit	hot
hotel	hotel
oras	hour
mga oras	hours
harong	house
pamilya	household
pano	how
ika	how about you
kumusta ka	how are you
kumusta ka	how are you doing
kumusta ka ngonyan	how are you doing today
kumusta ka ngonyan	how are you today
kumusta ka na	how do you do
pano an	how is
pira	how many
gurano	how much
gurano kaparate	how often
pirang taon kana	how old are you
kumusta an aldaw mo	how was your day
Kumusta ang banggi mo	how was your night
minsan siring	however
agom	hubby
kugos	hug
kuguson	hug
dakulaon	huge
tawo	human
mapakumbaba	humble
mahalumigmig	humid
kahalumigmigan	humidity
gatos	hundred
gutom	hungry
mang-ayam	hunt
bagyo	hurricane
dali dalian	hurry
dalian mo	hurry up
nakolgan	hurt
agom na lalaki	husband
magdalidali	hustle
paghidali	hustle
kubo	hut
pangangataman sa hawak	hygiene
Ako	I
Ako	I am
Marhay ako	I am fine
Kaya ko	I can
Dai ko kaya	I can't
Iyo	I do
Dai ko aram	I do not know
Dai ko maintindihan	I do not understand
Dai ko	I don't
Dai ko aram	I don't know
dai ko maintindihan	I don't understand
Dai ko naiintindihan an gusto mong sabihon	I don't understand what you mean
Dai taka maintindihan	I don't understand you
Dai ko aram	I don’t know
Dai ko maintindihan	I don’t understand
hula ko	i guess
Nagkaigwa ako	I had
Igwa ako	I have
Ako nagin	I have been
Nag-aasa ako	I hope so
Aram ko	I know
Gusto ko	I like
Gusto ta ka	I like you
Gusto ko	I love
Namumutan ko an sakong manoy	I love my big brother
Namumutan ko an sakong manay	I love my big sister
Namumutan ko an sakong ama	I love my father
Namumutan ko an sakong sadit na tugang na lalaki	I love my little brother
Namumutan ko an sakong sadit na tugang na babaye	I love my little sister
Namumutan ko an sakong ina	I love my mother
namumutan ta ka	I love you
Namumutan ta kang marhay	I love you so much
Namumutan ta ka man	I love you too
An buot sabihon	I mean
Nahiling ko	I see
iniisip ko	I think
Naintindihan ko	I understand
Gusto ko	I want
Gusto ko ikang mahiling	I want to see you
Gusto ta ka	I want you
Kaidto ako	I was
Gigibuhon ko	I will
Ako magigin	I would be
Ako	I'm
marhay ako	I'm fine
Marhay ako	I'm good
Yaon ako	I'm here
Naghahagad ako nin kapatawadan	I'm sorry
yelo	ice
sorbetes	ice cream
ideya	idea
perpekto	ideal
magkapareho	identical
midbidon	identify
midbidan	identity
patal	idiot
mayong gibo	idle
kun	if
pabayaan	ignore
may helang	ill
ilegal	illegal
kahilangan	illness
imahen	image
imahenar	imagine
dali-dali	immediate
tulos tulos	immediately
dakulaon	immense
mayong pasensya	impatient
isagibo	implement
mahalaga	important
magpataw	impose
imposible	impossible
mapabilib	impress
impresyon	impression
nakakadagka	impressive
uswag	improve
pag-uswag	improvement
sa laog	in
sa kadagdagan	in addition
Sa totoo	In fact
sa atubangan kan	in front of
tangani na	in order to
bakong tama	inappropriate
insentibo	incentive
insidente	incident
kaibanan	include
kaibanan an	including
kita	income
bakong kombeniente	inconvenience
pagtaas	increase
nagtataas	increase
nadagdagan	increased
dai kapanipaniwala	incredible
talaga	indeed
independiente	independent
India	India
ipahiling	indicate
katutubo	indigenous
indibiduwal	individual
industriya	industry
dai malilikayan	inevitable
aki na sadit	infant
impeksiyon	infection
mayong katapusan	infinity
paghubag	inflammation
pagtaas nin mga barakalon	inflation
mang-impluwensiya	influence
impluwensiya	influence
magsabi	inform
impormasyon	information
ingrediente	ingredients
mana	inheritance
patienot	initial
pagkukusa	initiative
nadanyusan	injured
lugad	injury
inosente	innocent
inobasyon	innovation
hapot	inquiry
bua	insane
insekto	insect
daing kasiguruhan	insecure
isaliot	insert
sa laog	inside
kaunawaan	insight
iinsister	insist
inspirasyon	inspiration
magtao nin inspirasyon	inspire
instilar	install
pagkakataon	instance
madalian	instant
imbes	instead
kesa kan	instead of
mga intruksiyon	instructions
instrumento	instrument
insulto	insult
seguro	insurance
mayong kulang	intact
integridad	integrity
intelektwal	intellectual
katalian	intelligence
intelehente	intelligent
tuyo	intend
tinuyo	intended
grabe	intense
intensiyon	intention
nakiestoryahn	interact
interaksiyon	interaction
interes	interest
interesado	interested
enteresante	interesting
papunduhon	interfere
intermediya	intermediate
sa laog	internal
international	international
interpretar	interpret
tagapag-interpretar	interpreter
makisabad	interrupt
interbiyo	interview
harani an buot	intimate
sa	into
ipamidbid	introduce
introduksiyon	introduction
intuwisyon	intuition
mayong bisa	invalid
imbento	invent
imbentaryo	inventory
mamuhunan	invest
imbestigar	investigate
imbitasyon	invitation
imbitahan	invite
kabale	involve
iiba	involved
plantsa	iron
plantsahon	iron
isla	island
iseparar	isolated
isyu	issue
nagtao	issue
mga problema	issues
ini	it
iyan an	it is
iyo idto	it was
Ini an	it's
ok lang	it's ok
okay lang	It's okay
aytem	item
mga aytem	items
an	its
Ako	I’m
presohan	jail
Enero	January
garapon	jar
panga	jaw
selos	jealous
makauyam na tawo	jerk
alahas	jewelry
trabaho	job
magdalagan	jogging
bale	join
dugtongan	joint
karaw	joke
periyodista	journalist
pagbyahe	journey
kaogmahan	joy
hukom	judge
hukoman	judge
hulyo	july
lukso	jump
hunyo	june
basura	junk
rasonable	just
lang	just
gibuhon mo sana	just do it
hustisya	justice
patunayan	justify
alisto	keen
taguon	keep
ipagpadagos mo yan	keep it up
sinaray	kept
kasirula	kettle
liyabe	key
sipa	kick
aki	kid
nagkakaraw	kidding
bato	kidney
mga aki	kids
gadan	kill
mabuot	kind
kabuotan	kind
medyo	kinda
paki-	kindly
kabuotan	kindness
hade	king
hadok	kiss
kusina	kitchen
buradol	kite
kuting	kitten
tuhod	knee
aram na	knew
kutsilyo	knife
kabalyero	knight
aram	know
kaaraman	knowledge
aram na	known
matatak	label
tatak	label
gibo	labor
gibo	labour
kulang	lack
hagdan	ladder
daraga	lady
linatag	laid
danaw	lake
karnero	lamb
pilay	lame
ilawan	lamp
daga	land
nag-abot	land
tanawon	landscape
lenggwahe	language
kulkol	lap
dakula	large
huri	last
ultimo pero importante	last but not least
apelyedo	last name
huri	late
kasuarin lang	lately
atyan	later
pinakahuri	latest
paghuri	latter
ngirit	laugh
nagngingirit	laughing
ngirit	laughter
ilunsad	launch
labahan	laundry
ley	law
natad	lawn
abogado	lawyer
ilaag	lay
patong	layer
ayos	layout
hugakon	lazy
mangenot	lead
lider	leader
dahon	leaf
nagtatakdo	leak
sandig	lean
lukso	leap
nanudan	learn
pag-aadal	learning
arkila	lease
pinakadikit	least
anit	leather
maghale	leave
magbakasyon	leave
mga dahon	leaves
pangenotan	led
wala	left
tabay	leg
pamana	legacy
legal	legal
uroestorya	legend
tunay	legit
oras na mayong gibo	leisure
suble	lend
laba	length
dikit	less
leksiyon	lesson
tugutan	let
surat	letter
paghiro	leverage
paninimbagan	liability
librarya	library
dilaan	lick
utik	lie
mag-utik	lie
mga utik	lies
buhay	life
elebeytor	lift
iangat	lift
ilawan	light
maliwanag	light
liwanag	light
kikilat	lightning
gusto	like
siring kan	like
siring	likely
siring man	likewise
linya	line
leon	lion
likido	liquid
listahan	list
magdangog	listen
nagdadangog	listening
literal	literally
literatura	literature
nagtapok	litter
sadit	little
buhay	live
mabuhay	live
atay	liver
nakaistar	lives
mga buhay	lives
nabubuhay	living
salas	living room
butiki	lizard
karga	load
tinapay	loaf
utang	loan
lokal	local
lokasyon	location
kandado	lock
kahoy	log
mamundo	lonely
halaba	long
haloy na kitang dai nagkahilingan	long time no see
paghiling	look
hiling	look
palibot	loop
turosan	loose
turos	loose
diyos	lord
nawaran	lose
kawaran	loss
nawara	lost
lote	lot
makusog	loud
pahingaloan	lounge
pagkamoot	love
namumuot	love
namumutan ta ka	love you
magayon	lovely
hababa	low
mas hababa	lower
maimbod	loyal
pagkamaimbod	loyalty
swerte	luck
maswerte	lucky
maleta	luggage
bukol	lump
pangudto	lunch
baga	lungs
luho	luxury
pag-utik	lying
makinarya	machine
anggot	mad
madam	madam
ginibo	made
magasin	magazine
nakapagayon	magnificent
katabang	maid
pangenot	main
mantenir	maintain
mantenir	maintenance
komandante	major
pangenot	major
mayoriya	majority
gibo	make
magkasundo	make up
lalaki	male
lalaki	man
manehar	manage
manehamento	management
namamahala	manager
kinakaipuhan	mandatory
magpahiling	manifest
manipular	manipulate
paagi	manner
manwal	manual
dakol	many
dakulon na maogmang pagbabalik sa mga aldaw	many many happy returns of the day
martsa	march
margin	margin
merkado	market
kasal	marriage
may agom	married
maskara	mask
dakol	mass
dakula asin magabat	massive
kagurangnan	master
labanan	match
maglaban	match
agom	mate
materyal	material
matimatika	math
bagay	matter
mahalaga	matter
pagkamaygurang	maturity
mayo	may
pwede daw	may
tibaad	maybe
ako	me
ako man	me too
pagkaon	meal
buot sabihon	mean
maraot	mean
buot sabihon	meaning
paagi	means
pakahulugan	meant
samantala	meanwhile
sukulon	measure
nagsukol	measures
karne	meat
medikal	medical
bulong	medicine
hararom na pag-iisip	meditation
tagbo	meet
pagtiripon	meeting
natunaw	melt
mga rumdumon	memories
memorya	memory
mental	mental
binanggit	mention
nabaggit	mentioned
tagapagtokdo	mentor
negosyante	merchant
herak	mercy
lang	merely
makalat	mess
mensahe	message
makalat	messy
metal	metal
paagi	method
mga kino	mice
tahaw	middle
matanga	midnight
posible	might
malumanay	mild
milyahe	milestone
militar	military
gatas	milk
milyon	million
isaisip	mind
isip	mind
kaisipan	mindset
sako	mine
minahan	mine
makihalubilo	mingle
minor	minor
minuto	minute
sadit	minute
mga minuto	minutes
milagro	miracle
salming	mirror
makaraw	mischievous
miserable	miserable
pagsakit	misery
nawawara	missing
misyon	mission
hamog	mist
sala	mistake
nahihiro	mobile
pag-ulog-olog	mock
paluyahon	moderate
katamtaman	moderate
moderno	modern
disente	modest
mamasa-masa	moist
halumigmig	moisture
alamag	mold
pormahon	mold
arong	mole
ina	mom
momento	moment
lunes	monday
kwarta	money
subaybay	monitor
ukay	monkey
bulan	month
pagmate	mood
sumpungin	moody
bulan	moon
moral	moral
dakol	more
liban pa kaiyan	moreover
aga	morning
sangla	mortgage
pinaka	most
kadaklan	mostly
ina	mother
hiro	motion
motibasyon	motivation
bulod	mountain
kino	mouse
ngimot	mouth
hiro	move
hiro	movement
pelikula	movie
misis	mrs
dakol	much
laboy	mud
tasa	mug
laman	muscle
museo	museum
kabute	mushroom
musika	music
kaipuhan	must
dapat	must
pula	mute
pareho an pagmate	mutual
sako	my
Sakong namumutan	My dear
sakong katood	my friend
Pano nin kasile an hovercraft ko	My hovercraft is full of eels
sakong namumutan	my love
an pangaran ko	my name is
ikinakaogma ko	my pleasure
saridi	myself
misteryoso	mysterious
misteryo	mystery
gibo-gibo	myth
kuko	nail
mayong aram	naive
pangaran	name
estorya	narrative
hayakpit	narrow
bastos	nasty
nasyunal	national
nasyu	nationality
katutubo	native
natural	natural
kapalibutan	nature
pagkalula	nausea
harani	near
harani	nearby
harani na	nearly
malinig	neat
kaipuhan	necessary
liog	neck
kulintas	necklace
pangangaipo	need
kaipuhan	need
negatibo	negative
pinabayaan	neglect
makipagkasundo	negotiate
kataed	neighbor
pagtaraed	neighborhood
arinman bako	neither
pamangkin na lalaki	nephew
nerbyos	nervous
salagan	nest
net	net
dai lamang	never
dai magsuko	never give up
dai na lugod	never mind
dai na lang	nevermind
baga man	nevertheless
bago	new
bareta	news
sunod	next
kataed kan	next to
marhay	nice
naoogma akong mabisto ka	nice to meet you
pamangkin na babaye	niece
banggi	night
bangungot	nightmare
siyam	nine
dise nwebe	nineteen
nubenta	ninety
Dai	No
mayong problema	no problem
mayong dalan	no way
taong mayong kwenta	nobody
ribok	noise
maribok	noisy
mayo	none
udto	noon
bako	nope
ni dai	nor
normal	normal
norte	north
dungo	nose
bako	not
dai talaga	not at all
bakong maraot	not bad
Bako ngonyan	Not now
dai pa	not yet
tandaan	note
tinandaan	noted
mayo	nothing
abiso	notice
nareparo	noticed
pangngaran	noun
pangaran	nouns
nobela	novel
nobyembre	november
ngonyan	now
ngonyan na mag aldaw	nowadays
istorbo	nuisance
mayong saysay	null
mayong pagmate	numb
numero	number
nars	nurse
nutrisyon	nutrition
sumpa	oath
sobrang katabaan	obesity
pagsunod	obey
bagay	object
katuyuhan	objective
obligasyon	obligation
nakatago	obscure
obserbasyon	observation
obserbar	observe
grabeng pagkagusto	obsessed
pagkagusto nin marhay	obsession
dai na ginagamit	obsolete
harang	obstacle
kua	obtain
nakua	obtained
hiling hiling	obvious
hiling hiling	obviously
paminsan-minsan	occasionally
trabaho	occupation
inukupar	occupied
nangyari	occur
nangyari	occurred
nangyari	occurs
kadagatan	ocean
oktubre	october
kakaiba	odd
kaulangan	odds
nin	of
syempre	of course
punduhon	off
nakakaraot buot	offensive
alok	offer
mag-alok	offer
opisina	office
opisyal	official
pirme	often
Ah	Oh
ow talaga	oh really
lana	oil
ok	ok
ok dear	ok dear
ok sakong namumutan	ok my love
okay	okay
okay baby	okay baby
okay honey	okay honey
okay sakong namumutan	okay my love
gurang	old
sa ibabaw	on
sarong beses	once
saro	one
bakong igo an sarong lenggwahe	one language is never enough
sibulyas	onion
iyo sana	only
bukas	open
operasyon	operation
opinyon	opinion
mga oportunidad	opportunities
oportunidad	opportunity
kabaliktaran	opposite
optimistiko	optimistic
opsyon	option
opsyunal	optional
o	or
kahel	orange
isugo	order
order	order
ordinaryo	ordinary
organisasyon	organization
oryentasyon	orientation
kapinunan	origin
orihinal	original
ilo	orphan
iba	other
sa ibang paagi	otherwise
kaipuhan	ought
sato	our
An samuyang misyon: tanganing tawan nin dalan an gabos, maski saen na maintindihan an kinaban asin ipahayag an saindang sadiri gamit an mga lenggwahe.	Our mission: to enable everyone, everywhere to understand the world and express themselves across languages.
An samuyang misyon: iyo an ayuson an impormasyon sa kinaban asin gibuhon ining na-aaccess asin kapaki-pakinabang sa gabos.	Our mission: to organize the world's information and make it universally accessible and useful.
luwas	out
resulta	outcome
bado	outfit
paluwas	outgoing
saksakan	outlet
balangkas	outline
luwas	outside
lataw	outstanding
pugon	oven
sa ibabaw	over
duman	over there
kabilugan	overall
napangganahan	overcome
sobrang pag-iisip	overthinking
nasobrahan	overwhelmed
napakadakula	overwhelming
utang	owe
kwago	owl
pagsasadiri	own
sadiri	own
tagsadiri	owner
liksi nin lakaw	pace
pakete	pack
ikahon	pack
pakete	package
binayadan	paid
kulog	pain
pinta	paint
pagpinta	painting
padis	pair
malungsi	pale
palad	palm
kawali	pan
pandemya	pandemic
taranta	panic
pantalon	pants
papel	paper
paraiso	paradise
pakiulit	pardon
mga magurang	parents
parke	park
loro	parrot
parte	part
magpartisipar	participate
partikular	particular
patikular	particularly
kapareha	partner
pagtiripon	party
ipasa	pass
sa susunod na lng	pass
agihan	passage
nakapasar	passed
madubdob	passionate
nakaagi	past
tapal	patch
dalan	path
kaherak-herak	pathetic
pasensya	patience
mapasensya	patient
pasyente	patient
pundo	pause
palitada	pavement
magbayad	pay
bayad	payment
katoninongan	peace
matoninong	peaceful
taas	peak
pear	pear
gisantes	peas
kakaiba	peculiar
ihi	pee
nag-iihi	pee
ubakan	peel
kabarkada	peer
mga pag-iriba	peers
pansurat	pen
lapis	pencil
dai pa tapos	pending
mga tawo	people
paminta	pepper
pakaintindi	perceive
pag-iisip	perception
perpekto	perfect
magsagibo	perform
pagsagibo	performance
siguro	perhaps
peryudo	period
tuldok	period
panahon	period
permanente	permanent
permiso	permission
permiso	permit
tiyaga	perseverance
mapirit	persistent
tawo	person
personal	personal
personalidad	personality
perspektibo	perspective
dagkahon	persuade
ataman na hayop	pet
hapulason	pet
parte	phase
tanda	phenomenon
pilosopiya	philosophy
telepono	phone
litrato	photo
prase	phrase
pisikal	physical
purot	pick
kuanon	pick up
litrato	picture
pidaso	piece
mga pidaso	pieces
orig	pig
salampati	pigeon
pagpatung-patungon	pile
ulunan	pillow
piloto	pilot
arpilier	pin
idukot	pin
pinya	pineapple
rosa	pink
kalot	pit
kalidad nin tunog	pitch
itindog	pitch
herak	pity
ilaag	place
lugar	place
mga lugar	places
linaag	places
salot	plague
simple	plain
plano	plan
eroplano	plane
magtanom	plant
mga pananom	plants
pagtanom	plants
plato	plate
pagkawat	play
magkawat	play
nagkakawat	playing
magayon	pleasant
paki	please
makisuyo	please
naogma	pleased
kaogmahan	pleasure
pangako	pledge
dakolon	plenty
estorya	plot
saksakan	plug
seregwelas	plum
tubero	plumber
tula	poem
mga tula	poetry
itokdo	point
tuldok	point
hilo	poison
pulis	police
polisiya	policy
magalang	polite
polusyon	pollution
danaw	pond
karigusan	pool
pag ibahon	pool
udo	poop
pobre	poor
naglataw	pop
popular	popular
populasyon	population
karne nin orig	pork
lanot	porridge
pier	port
posisyon	position
positibo	positive
igwa	possess
pagsadiri	possession
mapag-angkin	possessive
posible	possible
magpaskil	post
poste	post
napundo	postpone
patatas	potato
potensiyal	potential
pukpok	pound
kapobrehan	poverty
kuryente	power
kapangyarihan	power
makapangyarihan	powerful
praktikal	practical
sanayon	practice
kinasanayan	practice
omaw	praise
pamibi	pray
mahalaga	precious
eksakto	precise
eksakto	precisely
hula	predict
mas gusto	prefer
preperensiya	preference
bados	pregnant
baong marhay na opinyon	prejudice
palibot	premises
preparasyon	preparation
preparar	prepare
preparado	prepared
presensiya	presence
presente	present
regalo	present
presentasyon	presentation
preserbar	preserve
presidente	president
pinindot	press
pindot	press
pamumuwersa	pressure
magpanggap	pretend
magayon	pretty
medyo	pretty
pugulan	prevent
kan nakaagi	previous
dakop	prey
presyo	price
mapalangkaw	pride
padi	priest
pangenot	primary
pangenot	prime
prinsesa	princess
prinsipal	principal
bago pa man	prior
prayuridad	priority
presuhan	prison
pagkapribado	privacy
pribado	private
pribelihiyo	privilege
premyo	prize
baad	probably
problema	problem
proseso	procedure
magpadagos	proceed
proseso	process
iproseso	process
magbunga	produce
produkto	product
produksiyon	production
propesyon	profession
propesyunal	professional
tubo	profit
hararom	profound
uswag	progress
pag-uswag	progress
proyekto	project
prominente	prominent
pangako	promise
ipangako	promise
ilangkaw	promote
promosyon	promotion
madali	prompt
pirme	prone
pagsabi	pronunciation
patunay	proof
angay	proper
sa tama	properly
mga pagsadiri	properties
pagsadiri	property
suhestiyon	proposal
linalaoman	prospect
prosperidad	prosperity
mauswag	prosperous
protekta	protect
orgulyo	proud
patunayan	prove
magtao	provide
itinao	provided
probinsiya	province
probisyon	provision
pagdadaraga	puberty
publiko	public
butungon	pull
amay	punctual
estudyante	pupil
bakal	purchase
puro	pure
lila	purple
katuyuhan	purpose
pitaka	purse
magpadagos	pursue
mga inaabot	pursuit
ibusol	push
laag	put
kwalipikasyon	qualification
kwalidad	quality
kalidad	quality
kadakulan	quantity
seneparar	quarantine
iwal	quarrel
nag-iiwal	quarrel
unquarto	quarter
reyna	queen
nalilibong	queer
kahapotan	query
hapot	question
ipila	queue
pila	queue
madali	quick
dali-dali	quickly
silensyo	quiet
kubrekama	quilt
magpundo	quit
lubos	quite
halos	quite
iksamen	quiz
kotasyon	quotation
banggit	quote
binanggit	quote
kasabihan	quotes
kuneho	rabbit
lahi	race
anggot	rage
uran	rain
itaas	raise
umento	raise
itaas	raised
nagdalagan	ran
maski arin sana	random
madali	rapid
makaskas	rapidly
bihira	rare
bihira	rarely
kino	rat
kaysa	rather
proporsyon	ratio
maheherakon	rational
hilaw	raw
abot	reach
naabot	reached
reaksiyon	reaction
basa	read
nagbabasa	reading
handa	ready
tunay	real
realidad	reality
reyalisar	realize
reyalisar	realized
talaga	really
likod	rear
rason	reason
rasonable	reasonable
isipon giraray	recall
resibo	receipt
nakaresibe	receive
nag-ako	received
ngonyan pa sana	recent
kan suarin pa sana	recently
resepsyon	reception
daing ingat	reckless
pagkamidbid	recognition
mamibdidan	recognize
rinekomenda	recommend
irenerekomenda	recommended
listahan	record
rekord	record
mabawi	recover
pagrahay	recovery
rektanggulo	rectangle
pula	red
tubos	redeem
pagtubos	redemption
bawasan	reduce
pauro-utro	redundant
itukdo	refer
reperensiya	reference
ipahiling	reflect
aninag	reflection
magpugol	refrain
balik bayad	refund
habuan	refuse
sinayumahan	refused
konsideraron	regard
tungkol sa	regarding
manungod	regards
rehiyon	region
rehistro	register
nanghihinayang	regret
regular	regular
regular	regularly
sikwal	reject
konektar	relate
konektado	related
relasyon	relationship
paryentes	relative
may koneksyon sa	relative
partedaryo	relatives
pahingalo	relax
pagtao	release
itinao	release
pinalaya	released
may koneksiyon	relevant
maaasahan	reliable
kaginhawahan	relief
maginhawahan	relieve
naginhawahan	relieved
relihiyon	religion
relihiyoso	religious
nagduduwa duwa	reluctant
maglaom	rely
magdanay	remain
nawawalat	remaining
karepareparo	remarkable
solusyon	remedy
rumdom	remember
parumdumon	remind
pagirumdom	reminder
gamit pang kontrol nin TV	remote
harayo	remote
haleon	remove
magtao	render
renta	rent
irahayon	repair
uliton	repeat
salidahan	replace
simbagon	reply
simbag	reply
ipaisi	report
saysay	report
representar	represent
repustayon	reputation
kahagadan	request
maghagad	request
kahagadan	require
kaipuhan	required
paliligtas	rescue
pagsisiyasat	research
kapandok	resemble
raot nin buot	resentment
reserbasyon	reservation
reserba	reserve
residente	resident
naghale sa trabaho	resign
katatagan	resilience
matatag	resilient
labanan	resist
paglaban	resistance
resolusyon	resolution
masolusyunan	resolve
karigusan	resort
pinagkukuanan	resources
irespeto	respect
respeto	respect
simbag	respond
simbag	response
responsabilidad	responsibility
responsable	responsible
pahingalo	rest
nagpahingalo na	rest in peace
restawran	restaurant
ibalik	restore
higpitan	restrict
resulta	result
mga resulta	results
magpadagos	resume
tingi	retail
padanayon	retain
padanayon	retention
dai na nagtatrabaho	retired
suko	retreat
kinua	retrieve
ibalik	return
ibunyag	reveal
sabihon	revealed
paghihiganti	revenge
kita	revenue
baliktadon	reverse
ibahon	revise
rebisyon	revision
rebolusyon	revolution
premyo	reward
ritmo	rhythm
gusok	rib
maluto	rice
mayaman	rich
haleon	rid
sakay	ride
mag-sakay	ride
makangirit	ridiculous
too	right
tama	right
ngonyan	right now
matibay	rigid
singsing	ring
balnawan	rinse
iriwal	riot
gision	rip
gisi	rip
hinog	ripe
bumuhat	rise
pagbuhat	rise
isapeligro	risk
peligro	risk
ribal	rival
salog	river
tinampo	road
maglandag	roast
matipuno	robust
mahiwas	rock
gagampanan	role
ligid	roll
bubong	roof
kwarto	room
gamot	root
lubid	rope
lapa	rotten
garapgasapon	rough
halos	roughly
bilog	round
ruta	route
rutina	routine
linya	row
kuskos	rub
goma	rubber
basura	rubbish
bastos	rude
trapo	rug
destroso	ruin
regulasyon	rule
ruler	ruler
regulasyon	rules
magdalagan	run
nagdadalagan	running
maghidali	rush
paghidali	rush
sako	sack
banal	sacred
sakripisyo	sacrifice
ligtas	safe
ligtas na pagbyahe	safe flight
kaligtasan	safety
pantas	sage
sinabi	said
layag	sail
paglalayag	sailing
kapakanan	sake
sweldo	salary
pagpabakal	sale
asin	salt
pareho	same
Pareho digdi	Same here
sampol	sample
baybay	sand
sarkastiko	sarcastic
tukaw	sat
satispaksiyon	satisfaction
kontento	satisfied
kontento	satisfy
makakakontento	satisfying
Sabado	Saturday
tsoriso	sausage
maringis	savage
magtipon	save
nahiling	saw
sabi	say
timbangan	scale
peklat	scar
kakadikit	scarce
takot	scared
bandana	scarf
makatakot	scary
nagkalat	scattered
senaryo	scene
tanawon	scenery
parong	scent
iskedyul	schedule
iiskedyul	schedule
eskwelahan	school
siyensiya	science
siyentista	scientist
siyentista	scientists
gunting	scissors
anggotan	scold
sakop	scope
iskor	score
pinipidaso	scrap
kagaw	scratch
gasgas	scratch
kurahaw	scream
iskrip	script
dagat	sea
tatak	seal
maghanap	search
kapanahunan	season
tukawan	seat
ikaduwa	second
sekreto	secret
seksiyon	section
ligtas	secure
siguridad	security
hiling	see
maghilingan kita	see you
maghilingan kita atyan	see you later
maghilingan kita sa susunod	see you soon
maghilingan kita sa aga	see you tomorrow
pisog	seed
hanap	seek
gari	seem
gari	seems
nahiling	seen
kinua	seize
atake	seizure
bihira	seldom
magpili	select
sadiri	self
nagbubulong nin sadiri	self healing
makasadiri	selfish
magpabakal	sell
padara	send
ipadara mo sakuya an saimong litrato	send me your picture
gurang	senior
pagmate	sense
matino	sensible
sensitibo	sensitive
ipinadasa	sent
pagkasabi	sentence
mga tataramon	sentences
separado	separate
Setyembre	september
pagkakasunod-sunod	sequence
sunod-sunod	series
seryoso	serious
sa seryoso	seriously
serbi	serve
serbisyo	service
sesyon	session
ilaag	set
makakaibahan	set
mag tindog	set up
tagbo	setting
ayuson	settle
pito	seven
dise syete	seventeen
sitenta	seventy
nagkapira	several
malala	severe
tinahi	sew
lindong	shade
anino	shadow
lugoon	shake
dapat	shall
hababaw	shallow
kasusupgan	shame
porma	shape
parte	share
magtao	share
mapanas	sharp
siya	she
igwa siya nin	she has
siya	she is
nagrarakdag	shed
karnero	sheep
pidaso	sheet
estante	shelf
arikurong	shell
istaran	shelter
panangga	shield
sirang	shine
barko	ship
pagpapadara	shipping
bado	shirt
sapatos	shoes
badilon	shoot
tindahan	shop
mamakal	shopping
tampi nin dagat	shore
halipot	short
kakulangan	shortage
tira	shot
dapat	should
abaga	shoulder
kurahaw	shout
pasale	show
ipahiling	show
ipahiling mo sako	show me
pauranan	shower
hipon	shrimp
nagsadit	shrink
sarado	shut
dai na maggirong	shut up
supog	shy
tugang	sibling
mga tugang	siblings
may helang	sick
gilid	side
paghangos nin haramon	sigh
hiling	sight
pagturutanaw	sightseeing
senyales	sign
pirma	signature
mahalaga	significant
katoninongan	silence
silensyo	silent
luko-luko	silly
plata	silver
kapareho	similar
gago	simp
simple	simple
sabay-sabay	simultaneously
puon	since
sinsero	sincere
sinsero	sincerely
kanta	sing
parakanta	singer
mayong agom	single
naglubog	sink
lababo	sink
tugang na babaye	sister
hipag	sister in law
magtukaw	sit
lugar	site
sitwasyon	situation
anom	six
dise sais	sixteen
sisenta	sixty
sukol	size
kublit	skin
maniwang	skinny
laktaw	skip
palda	skirt
langit	sky
uripon	slave
turog	sleep
nagkakaturog	sleeping
pipirot	sleepy
manggas	sleeve
pidasuhon	slice
pidaso	slice
nadalinas	slide
bakong gayo	slightly
maniwang	slim
nadalinas	slip
bakilid	slope
ruwang	slot
maluway	slow
luhay luhay	slowly
sadit	small
matali	smart
parong	smell
magngirit	smile
ngirit	smile
aso	smoke
makinis	smooth
merindal	snack
kuhol	snail
halas	snake
biglaan	snap
niyebe	snow
kaya	so
sagkod ngonyan	so far
palbag	soak
sabon	soap
bakong burat	sober
sosyal	social
sosyodad	society
medyas	socks
malumoy	soft
daga	soil
ipinabakal	sold
ubos na	sold out
soldados	soldier
solo	sole
solido	solid
solusyon	solution
masolusyunan	solve
pira	some
sarong tawo	somebody
maski papano	somehow
sarong tawo	someone
ibang bagay	something
minsan	sometimes
kanta	song
harani na	soon
sopistikada	sophisticated
makulog	sore
lugad	sore
makulog na halunan	sore throat
kamunduan	sorrow
Pasensya na	Sorry
klase	sort
hinanap	sought
kalag	soul
tanog	sound
sabaw	soup
maalsom	sour
pinaghalean	source
timog	south
espasyo	space
lawig	span
Espanyol	Spanish
pansalida	spare
iligtas	spare
taram	speak
espesyal	special
espisipiko	specific
makangangalas	spectacular
pagtaram	speech
mayong masabi	speechless
liksi	speed
maggastos	spend
naggastos	spent
maharang	spicy
ispaik	spike
talibong	spin
kangkong	spinach
ispirito	spirit
lutab	spit
kahanga-hanga	splendid
pagbanga	split
bangaon	split
raot	spoil
panos na	spoiled
kusa	spontaneous
kutsara	spoon
lugar	spot
agom	spouse
ikalat	spread
burabod	spring
biglang hiro	spring
kwadrado	square
paga	squeeze
pusit	squid
saksak	stab
matatag	stable
pagpatung-patungon	stack
entablado	stage
mantsa	stain
hagdan	stairs
taya	stake
pagsubaybay na pasekreto	stalk
puwesto	stall
pantatak	stamp
selyo	stamp
tindog	stand
itindog	stand
standard	standard
bituon	star
puon	start
nagpuon	started
nagugutom	starving
sabihon	state
estado	state
pahayag	statement
istasyon	station
estatwa	statue
estado	status
pag-istar	stay
mag-istar	stay
padagos kang mag-ingat	stay safe
danay	steady
habas	steal
sangaw	steam
bakal	steel
matarik	steep
sanga	stem
lakdang	step
dukot	stick
matagas	stiff
daing hiro-hiro	still
pa man	still
kagat	sting
kuripot	stingy
kalikuton	stir
paninda	stock
hinabas	stolen
tulak	stomach
gapo	stone
nagtindog	stood
udo	stool
magpundo	stop
sarayan	storage
itago	store
tindahan	store
bagyo	storm
estorya	story
lutuan	stove
tulid	straight
prangka	straightforward
pagalon	strain
kakaiba	strange
estranghero	stranger
estratehiya	strategy
dagami	straw
kurit	streak
magdalan nin bidyo sa internet	stream
sapa	stream
kalye	street
kusog	strength
inat	stretch
istrikto	strict
pakulon	strike
welga	strike
lubid	string
haleon	strip
pagsisikap	strive
makusog	strong
pinatamaan	struck
istraktura	structure
kasakitan	struggle
magpakasakit	struggle
nadidipisilan	struggling
matagas an payo	stubborn
napundo	stuck
estudyante	student
pag-aadal	study
mag-adal	study
nag-aadal	studying
mga bagay	stuff
sobrang gayon	stunning
mangmang	stupid
istilo	style
tema	subject
pagsusumiter	submission
isumiter	submit
substansiya	substance
kasalida	substitute
banayad	subtle
kapangganahan	succeed
kapangganahan	success
mapanggana	successful
arog kan	such
siring kan	such as
supsop	suck
bigla	sudden
bigla	suddenly
magdusa	suffer
pagsakit	suffering
supesyente	sufficient
asukar	sugar
magsuhestiyon	suggest
suhestiyon	suggestion
ibagay	suit
kaso	suit
angay	suitable
bagahe	suitcase
total	sum
sumaryo	summary
tag-init	summer
tuktok	summit
saldang	sun
domingo	sunday
maaldaw	sunny
pagsolnop kan saldang	sunset
sirang nin aldaw	sunshine
pinakang	superior
supervisor	supervisor
pamanggihan	supper
suportaran	supply
panuporta	supply
nagsusuporta	support
suporta	support
ipamugtak	suppose
dapat	supposed
sige	sure
ibabaw	surface
daluyong	surge
pag-oopera	surgery
apelyedo	surname
surpresa	surprise
nasorpresa	surprised
suko	surrender
kapalibutan	surrounding
magdanay	survive
suspetsado	suspect
pagduda	suspect
suspendido	suspended
kadudaduda	suspicious
sustenir	sustain
kakayahan na magsustenir	sustainability
nasususteneran	sustainable
halon	swallow
ribay	swap
sumpa	swear
daplos	sweat
sigid	sweep
mahamis	sweet
mahilig sa hamis	sweet tooth
nagdakula	swell
namamaga	swelling
langoy	swim
naglalangoy	swimming
iduyan	swing
duyan	swing
magbalyo	switch
pindutan	switch
hubag	swollen
espada	sword
simbolo	symbol
simpatiya	sympathy
sintomas	symptoms
sistema	system
lamesa	table
talakay	tackle
pananda	tag
ikog	tail
kua	take
nakua	take away
mag-ingat ka	take care
haleon	take off
kinua na	taken
olay	talk
makipag-olay	talk
madaldal	talkative
halangkaw	tall
tapikin	tap
tapik	tap
teyp	tape
patamaan	target
target	target
gibuhon	task
namitan	taste
namit	taste
manamit	tasty
tinukduan	taught
tsaa	tea
tukdo	teach
paratokdo	teacher
luha	tear
mga luha	tears
suba	tease
teknolohiya	technology
ngipon	teeth
sabihon	tell
sabihon sako	tell me
init nin payo	temper
temperatura	temperature
templo	temple
temporaryo	temporary
dyes	ten
dyesmil	ten thousand
nag-aarkila	tenant
inataman	tend
tendensiya	tendency
mayumok	tender
nananagas	tense
tensiyon	tension
tolda	tent
pansamantala	tentative
tataramon	term
peryudo nin panahon	term
termino	term
kondisyon	terms
terible	terrible
mahusay	terrific
teritoryo	territory
binabalo	test
pagbalo	test
teksto	text
kesa	than
salamat	thank
salamat	thank you
Salamat sa saimong pasensya mantang iniimbestigaran niamo an kargamento.	Thank you for your patience while we investigate shipment
salamat nin marhay	thank you so much
salamat nin marhay	thank you very much
salamat	thanks
Salamat sa paggamit kan samuyang app	Thanks for using our app
iyan	that
iyo iyan an	that is
marhay yan	that's good
an	the
mahabon	theft
saindang	their
sinda	them
tema	theme
sinda	themselves
saka	then
teorya	theory
duman	there
igwa nin mga	there are
igwa nin	there is
kaya	therefore
An mga ini	these
sinda	they
sinda	they are
mahibog	thick
mahabas	thief
hita	thigh
manipis	thin
bagay	thing
mga bagay	things
mag-isip	think
pangatolo	third
paha	thirsty
trese	thirteen
trienta	thirty
ini	this
ini an	this is
lubusan	thorough
lubusan	thoroughly
mga idto	those
maski	though
kaisipan	thought
nag-iisip	thought
mapag-isip	thoughtful
mga iniisip	thoughts
mil syen	thousand
torsido	thread
pananakot	threat
bantaan	threaten
tolo	three
limitasyon	threshold
nagkukubog-kubog	thrilled
umuswag	thrive
halunan	throat
paagi sa	through
sa bilog na	throughout
itapok	throw
tanggurangan	thumb
daguldol	thunder
Webes	Thursday
kaya	thus
tsekan	tick
pagtaas nin tubig	tide
malinig	tidy
pagkakabugkos	tie
ibugkos	tie
tigre	tiger
piot	tight
oras	time
masusupgon	timid
saditon	tiny
puro	tip
goma	tire
pagal	tired
tisyu	tissue
titulo	title
pasiring	to
magin	to be
magtusta	toast
ngonyan	today
aking sadit	toddler
garamoy sa bitis	toes
magkairibanan	together
banyo	toilet
nagsabi	told
pagtogot	tolerance
tolerar	tolerate
kamatis	tomato
sa aga	tomorrow
dila	tongue
ngonyan na banggi	tonight
man	too
kinua	took
kagamitan	tool
mga kagamitan	tools
ngipon	tooth
taas	top
topiko	topic
gisi	torn
pasakit	torture
kabilugan	total
dutan	touch
matatag	tough
pasyar	tour
pasiring	toward
pasiring sa	towards
twalya	towel
banwa	town
nakakahilo	toxic
susog	trace
subaybayan	track
komersyo	trade
makipagnegosyo	trade
tradisyon	tradition
tradisyunal	traditional
trapiko	traffic
dalan	trail
tukdoan	train
tren	train
pagsasanay	training
katangian	trait
mga ugali	traits
lipat	transfer
transisyon	transition
tradusir	translate
silag	transparent
darhon	transport
transportasyon	transportation
silo	trap
basura	trash
magbyahe	travel
trey	tray
kayamanan	treasure
trato	treat
pagtrato	treatment
kahoy	tree
makangangalas	tremendous
uso	trend
purbar	trial
liksi nin kamot	trick
nagpurbar	tried
gatilyo	trigger
gatungan	trigger
putulan	trim
byahe	trip
gusto lang gibuhon na mayo nin rason	trip
ribok	trouble
pantalon	trousers
trak	truck
TOTOO	true
likod nin kotse	trunk
lawas nin kahoy	trunk
magtiwala	trust
tiwala	trust
katotoohan	truth
purbar	try
tubo	tube
Martes	Tuesday
matrikula	tuition
pabo	turkey
liko	turn
pagong	turtle
tagapagtokdo	tutor
dose	twelve
baynte	twenty
byante-uno	twenty-one
duwa	twice
biribidon	twist
duwa	two
klase	type
kaladasan	typical
makanos	ugly
panghuri	ultimate
payong	umbrella
dai kaya	unable
amaon	uncle
mayong malay	unconscious
irarom	under
sa irarom	underneath
maintindihan	understand
naintindihan	understood
uniporme	uniform
kakaiba	unique
yunit	unit
unibersidad	university
dai maaraman	unknown
maliban na sana kun	unless
sagkod sa	until
bakong ordinaryo	unusual
sa itaas	up
nasa saimo	up to you
sa	upon
anggot	upset
sulsolan	urge
sulsol	urge
dalian	urgent
kita	us
gamiton	use
paggamit	use
ginamit	used
kapaki-pakinabang	useful
mayong pakinabang	useless
kadalasan	usual
kadalasan	usually
bakasyon	vacation
pagbakuna	vaccination
bakuna	vaccine
bakong malinaw	vague
balido	valid
mahalaga	valuable
pahalagahan	value
kahalagahan	value
iba-ibang klase	variety
iba-iba	various
iba-iba	vary
laganan nin burak	vase
mahiwas	vast
gulay	vegetable
mga gulay	vegetables
behikulo	vehicle
paratinda	vendor
rara	venom
lugar	venue
biripikahon	verify
dakol na kayang gibuhon	versatile
bersyon	version
patindog	vertical
napaka	very
nakaparahay	very good
lunadan pandagat	vessel
paagi sa	via
may bisyo	vicious
biktima	victim
bidyo	video
hilingon	view
baryo	village
kontrabida	villain
suka	vinegar
luma	vintage
kadahasan	violence
madahas	violent
birhen	virgin
kabanalan	virtue
bisyon	vision
bisita	visit
bisitahon	visit
biswal	visual
importanteng marhay	vital
malinaw	vivid
bokabularyo	vocabulary
boses	voice
mayong bisa	void
dakol	volume
boluntaryo	volunteer
suka	vomit
nagsuka	vomit
maluya	vulnerable
sweldo	wage
sweldo	wages
iksan	waist
halat	wait
tubig	waiter
naghahalat	waiting
nagmata	wake
magmata	wake up
lakaw	walk
maglakaw	walk
naglalakaw	walking
lanob	wall
pitaka	wallet
lagaw-lagaw	wander
gusto	wanna
gusto	want
ginusto	wanted
giyera	war
aparador	wardrobe
bodega	warehouse
magpainit	warm
mainit-init	warm
balaan	warn
patanid	warning
gerero	warrior
laba	wash
basura	waste
ibasura	waste
dalan	watch
tubig	water
pakwan	watermelon
alon	wave
kaway	wave
dalan	way
kami	we
kami	we are
kaya ta	we can
maluya	weak
kaluyahan	weakness
yaman	wealth
mayaman	wealthy
sulot	wear
sulot	wearing
kamugtakan nin panahon	weather
kasal	wedding
Miyerkules	Wednesday
duot	weed
semana	week
katapusan in semana	weekend
gabat	weight
magpagabat	weight
kakaiba	weird
kapakanan	welfare
bueno	Well
matibay an pagkakagibo	well done
nagduman	went
solnopan	west
dumog	wet
balyena	whale
ano	what
ika	what about you
ano an piggigibo mo	what are you doing
ano an piggigibo mo ngonyan	what are you doing now
ano an ginigibo mo ngonyan	what are you doing right now
ano an ginigibo mo	what do you do
anong trabaho mo	what do you do for a living
ano an buot mong sabihon	what do you mean
ano an gusto mo	what do you want
anong nangyari	what happened
ano an	what is
ano ini	what is this
ano an trabaho mo	what is your job
ano an pangaran mo	what is your name
anong igwa	what's up
anong pangaran mo	what's your name
maski ano	whatever
trigo	wheat
ruweda	wheel
nuarin	when
nuarin man	whenever
saen	where
haen ka	where are you
taga saen ka	where are you from
haen ka ngonyan	where are you now
saen ka nakaistar	where do you live
saen an	where is
samantala	whereas
kun	whether
arin	which
mantang	while
hinghing	whisper
pito	whistle
puti	white
siisay	who
siisay ka	who are you
siisay an	who is
siisay ini	who is this
bilog	whole
para kiisay	whom
na an	whose
tano	why
tanu ta dai	why not
maraot	wicked
mahiwas	wide
balo	widow
lakbang	width
agom na babaye	wife
testamento	will
gusto	willing
manggana	win
duros	wind
bintana	window
madoros	windy
alak	wine
taglipot	winter
punas	wipe
kawad	wire
kadunungan	wisdom
madunong	wise
gusto	wish
gustuhon	wish
aswang	witch
kaiba	with
bawion	withdraw
pag-atras	withdrawal
sa laog nin	within
mayo	without
nakahiling	witness
nahiling	witness
matali	witty
lobo	wolf
babaye	woman
babaye	women
nanggana	won
dai	won't
nagngalas	wonder
kahanga-hanga	wonderful
kahoy	wood
lana	wool
tataramon	word
mga tataramon	words
trabaho	work
nagtatrabaho	work
tinatrabaho	work out
nagtatrabaho	working
kinaban	world
bulate	worm
sinulot	worn
nababahala	worried
hadit	worry
malala	worse
pagsamba	worship
malala	worst
halaga	worth
sulit	worth it
mahalaga	worthy
lugad	wound
Wow	Wow
nagpatos	wrap
kaanggotan	wrath
pulsohan	wrist
surat	write
Magsurat digdi	Write here
pagsurat	writing
nasusurat	written
sala	wrong
nagsurat	wrote
natad	yard
naghahagab	yawn
hagab	yawn
Iyo	Yeah
taon	year
mga taon	years
lebadura	yeast
suriyaw	yell
amarillo	yellow
Iyo	Yes
iyo baby	yes baby
iyo sakong namumutan	yes dear
iyo honey	yes honey
iyo sakong namumutan	yes my love
iyo syempre	yes of course
kasuhapon	yesterday
pa man	yet
nagtao	yield
ika	you
ika	you are
magayon ka	you are beautiful
magayonon ka	you are so beautiful
pwede kang	you can
Aram mo	You know
ika man	you too
aki pa	young
saimo	your
saimong sadiri	yourself
kabataan	youth
dagos tabi	you’re welcome
masiram	yummy
sero	zero
