ওগ্গো	a
এক্কানা গরি	a little
বউত	a lot
বউত	a lot of
ছাড়ি দন	abandon
পরি তাহন	abandoned
মানি চলন	abide
সক্ষমতা	ability
সক্ষম	able
সম্পর্কে	about
উরে	above
বিদেশ	abroad
অনুপস্থিতি	absence
নো আয়ি	absent
নিশ্চিতভাবে	absolutely
চুষি লন	absorb
অবাস্তব	abstract
যুক্তি নাই	absurd
বউত	abundance
বউদ	abundant
হারাফভাবে ইউজ গরন	abuse
অ্যাক্সেন্ট	accent
গ্রহণ গরা	accept
অনুমতি দিলাম	access
এক্সিডেন	accident
থাহার জায়গা	accommodation
ঠিকগরি গরন	accomplish
শেষ গরে ফেলন	accomplished
এইল্ল্যে	according
একাউন্ট	account
একুরেট	accuracy
একদম বরাবর	accurate
অভিযুক্ত	accused
ব্যাথা বেদনা	ache
অর্জন	achieve
অর্জন	achievement
স্বীকৃতি	acknowledge
জানাশোনা	acquaintance
দখল	acquire
অর্জন হইজ্জে	acquired
লইলন	acquisition
মাঝদি	across
আইন	act
হাম হরজ	action
ছালু	active
কার্যক্রম	activities
হাজকর্ম	activity
অভিনেতা	actor
আসল	actual
আচা হতা অইলজি	actually
খুব বেশি	acute
মানাই লন	adapt
যোগ গরি দ	add
নেশাটি	addicted
যোগ	addition
বউদ বেশি	additional
ঠিহানা	address
ফয্যাপ্ত	adequate
লাগাইন্যা	adjacent
বিশেষণ	adjective
এডজাস্ট	adjust
প্রশংসা গরন	admire
স্বীকার গরা	admit
লওন	adopt
আদইয্যা	adorable
আগে	advance
আগাম	advanced
সুবিধে	advantage
এডভেঞ্চার	adventure
বিশেষণ	adverb
এডভেটাইজ	advertisement
বিজ্ঞাপন দেওন	advertising
উপদেশ	advice
পরামর্শ	advise
ব্যরিস্টার	advocate
সুন্দর	aesthetic
বিষয়গান	affair
ক্ষতি	affect
ফ্রভাব ফেলন	affect
টান	affection
চেষ্টা	afford
হেডাম	afford
অস্তা	affordable
ডরন	afraid
পরে	after
বিয়েল বেলা	afternoon
পরে	afterwards
আবারো	again
বিরুদ্ধে	against
বয়স	age
এজেন্সি	agency
এজেন্ট	agent
আক্রমনাত্মক	aggressive
চঞ্চল	agile
আগে	ago
রাজি	agree
চুক্তি	agreement
কৃষি হাজ	agriculture
আগোদি	ahead
সাইয্যো	aid
লক্ষ্য	aim
বাতাস	air
বিমান বন্দর	airport
আইল	aisle
এলার্ম	alarm
মদ	alcohol
সতর্ক	alert
জ্যাঁতা	alive
বিয়াগ	all
বেগগুন	all
ঠিক আছে	all right
শুভ কামনা	all the best
অনুমতি	allow
মানি লই লন	allowed
প্রায়	almost
একা	alone
ফুঁয়ারে	along
ইতোমধ্যে	already
বিয়াগ ঠিক	Alright
এরজে	also
বিকল্প	alternative
যদিও	although
সবসময়	always
অইলাম	am
চমৎকার	amazing
অনিশ্চিত	ambiguous
বড় কিছু গরনের আশা	ambition
বড় কিছু গরিত ছায়	ambitious
ঠিকগরি লন	amend
মধ্যে	amid
মধ্যে	among
আঁরার ভিতরে	among us
পরিমান	amount
পরিমাণ	amount
মজালার	amusing
ওগ্গো	an
বিশ্লেষন	analysis
পূর্বপুরুষ	ancestors
উপস্থাপক	anchor
পুরন	ancient
এবং	and
আর অনে	and you
ফেরেশতা	angel
রাগ	anger
কোণা	angle
গোস্সা	angry
পশু	animal
গোরালি	ankle
বার্ষিক	anniversary
ঘোষণা	announcement
বিরক্ত গরন	annoy
বিরক্ত	annoyed
বিরক্তিকর	annoying
বার্ষিক	annual
অচিনা	anonymous
আরেক	another
উত্তর	answer
অনুমান গরন	anticipate
দুশচিন্তে	anxiety
চিন্তিত	anxious
যে কোনো	any
আর	anymore
যে কেই	anyone
হোনো কিছু	anything
যাইহোক	anyway
যাই অক	anyways
আলাদা	apart
বাসা	apartment
মাফ ছাওন	apologize
স্পষ্ট	apparent
ফরিষ্কার	apparently
গইত্তে হন	appeal
আচমকা উপস্থিত হন	appear
উপস্থিতি	appearance
আচমকা চলি আয়ুন	appeared
ভোগ লাইজ্ঞি	appetite
আপেল	apple
দরহাস্ত	application
আবেদন গরন	apply
এপয়েন্টমেন্ট	appointment
প্রশংসা গড়ি	appreciate
প্রশংসা	appreciate
প্রশংসা	appreciation
ইয়া কি চিন্তে হইজ্জুন	approach
একবেরে বরাবর	appropriate
পারমিশন	approval
অনুমতি	approve
অনুমোদন গরি গেইয়্যি	approved
আনুমানিক	approximately
আন্দাজে	approximately
এপ্রিল	april
ইচ্চেমত	arbitrary
ওয়তুনু	architect
আর্কিটেকচার	architecture
জমা রাহন	archive
অয়	are
অঁনে	are you
অনে কি বিজি	are you busy
অনে কি বিয়াইত্তে	are you married
অনে কি বিয়াইত্তে নাকি আবিয়াইত্তে	are you married or single
অনে কি এহনো এডে আছন্না?	Are you still there?
অনে কি এডে	are you there
এলাহা	area
তর্ক গরন	argue
যুক্তি দিওন	argument
বাড়ি ওডন	arise
ভাইরে	arm
আর্মি	army
চাইরপাশে	around
আয়োজন গরন	arrange
ব্যবস্থা	arrangement
আগমন	arrival
পৌছন	arrive
পোঁছন	arrived
বেয়াদব	arrogant
তীর	arrow
শিল্প	art
আর্টিকেল	article
নহল	artificial
কৃত্রিম	artificial
শিল্পী	artist
যেনডইল্লে	as
যতক্ষণ পযন্ত নো	as long as
সই	as well
আরও	as well as
ছাঁই	ash
সরমিন্দা	ashamed
পুছার লন	ask
পৌঁছার গরন	asked
ঘুম	asleep
দিক	aspect
আসামর	Assamese
বেইজ্জত	assault
এসেম্বলি	assembly
জেদী	assertive
পরিক্ষে গরন	assess
পরীক্ষে	assessment
সম্পদ	asset
সম্পত্তি	assets
হাজত লাগায় দন	assign
এসাইনমেন্ট	assignment
সাহায্য গরা	assist
এসিস্ট্যান্ট	assistant
লগোর	associate
সম্পর্কিত	associated
সংগঠন	association
মনে গরা	assume
ধৃষ্টতা	assumption
অবস্থিত	at
অন্তত	at least
খাইলাম	ate
খেলুয়াড়	athlete
এক্কানত গরন	attach
লাগাইন্নে	attached
লাগাইন্যা	attachment
আক্রমন গরন	attack
ছেষ্টা	attempt
যোগ দিয়ন	attend
আজির অন	attendance
মনোযোগ	attention
দৃষ্টিভঙ্গি	attitude
আটিটিউট	attitude
টানা	attract
টান	attraction
আকর্ষনীয়	attractive
বৈশিষ্ট্য	attribute
দর্শক	audience
আগস্ট	august
মামি	aunt
আন্টি	aunt
চাচি	aunt
ফু	aunty
হাঁটি	authentic
লেহখ	author
কর্তৃপক্ষ	authority
শরৎ কাল	autumn
এভেলেবল	available
আছে	available
এভারেজ	average
এড়ায় চলন	avoid
অজাগ	awake
ফুরুষ্কার	award
সচেতন	aware
সচেতনতা	awareness
দূরে	away
সেই	awesome
দারুণ	awesome
কুৎসিত	awful
পেরায়	awkward
আয়মারা	Aymara
পুয়া	baby
ব্যচলার	bachelor
ফিরি যা	back
পুরন ইতিহাস	background
হরাপ	bad
থইলে	bag
লোভ দেহন	bait
স্যাকন	bake
বেহারি	bakery
বেকিং সোডা	baking soda
ব্যালেন্স	balance
বঅল	ball
বাম্বারা	Bambara
কেলা	banana
ব্যন্ড	band
আঘাত গরন	bang
ব্যাংক	bank
বারো	bar
মাত্র	barely
মুলামূলি	bargain
বাকল	bark
মাঝে মইধ্যে	barley
বাধা	barrier
বেইস	base
ভিত্তিক	based
বেসমেন্ট	basement
একদম মেইন জিনিস	basic
আদতে	basically
পুদিনা	basil
জারগো	bastard
ব্যাচ	batch
গোছল	bath
বাথরুম	bathroom
ব্যাটারি	battery
যুদ্ধু	battle
সাগর	bay
অন	be
সতর্ক অই যন	be careful
সাগর ফার	beach
আলো	beam
মটরশুটি	beans
বইত পারা	bear
দাড়ি	beard
বহন গরা	bearing
জানোয়ার	beast
মারন	beat
সুন্দর	beautiful
সুন্দরয্য	beauty
অই গেইয়্যি	became
হারণ	because
হওয়া	become
বিছানা	bed
শুয়ার ঘর	bedroom
মৌমাছি	bee
গরুর গোস্ত	beef
বিয়ার	beer
আগে	before
শুরু	began
শুরু	begin
শুরু	beginning
পক্ষততুন	behalf
আচরণ গরন	behave
আচরণ	behavior
ব্যবয়ার	behaviour
আচরণ	behaviour
পিছে	behind
হওয়া	being
বিশ্বেস	belief
বিশ্বাস গরা	believe
ফেট	belly
থাহন	belong
আপন	beloved
নিচে	below
বেল্ট	belt
এজলাস	bench
বাঁক	bend
নিচে	beneath
সুবিধে	benefit
লাভ	benefits
হাছে	beside
ইয়ান ছাড়াও	besides
সেরা	best
শুভ কামনা	best of luck
শুভ কামনা	best regards
ভালা	better
মইধ্যে	between
পানীয়	beverage
ছাড়ায় জন	beyond
ভুজপুরি	Bhojpuri
ফক্ষ লওন	bias
পক্ষপাতি গরা	biased
সারকেল	bicycle
বিড	bid
বড়	big
বাইক	bike
বিল	bill
বাঁধা	bind
পাখি	bird
জন্মদিন	birthday
ইক্কিনি	bit
হও'ড়	bite
তিতে	bitter
কালা	black
ব্লেইড	blade
দোষ	blame
হালি	blank
হম্বল	blanket
বিস্ফোরণ	blast
ব্লিচ	bleach
মিইয়াই দন	blend
দুয়া	bless
দোয়া পওন	blessed
আন্ধা	blind
সুখ	bliss
ব্লক	block
রক্ত	blood
ফুটা	bloom
উরি যন	blow
নীল	blue
ভোঁতা	blunt
বোর্ড	board
নৌকৌ	boat
শরীল	body
ফুডান	boil
কড়া	bold
বন্ধন	bond
আঁড্ডি	bone
বই	book
ছড়ায় দন	boost
বুস্টার	booster
বুট জুতা	boot
হোটেলর চাহর	boots
বডার	border
বিরক্ত	bore
বিরক্ত	bored
বিরক্তিকর	boring
জন্ম	born
উদর লন	borrow
বস	boss
দুনুজন	both
বিরক্ত	bother
বোতল	bottle
তলা	bottom
কিনন	bought
বাউন্স	bounce
বাঁধা	bound
বাওয়ন্ডারি	boundaries
মাথানত গরা	bow
বাটি	bowl
বাক্সো	box
মরৎ ফুয়া	boy
বয়ফ্রেন্ড	boyfriend
ব্রেসলেইট	bracelet
মগজ	brain
শাখা	branch
ব্রেন্ড	brand
সাহসী	brave
লঙ্ঘন গরন	breach
রুটি	bread
ভাঙগন	break
বেয়াইন্না নাস্তা	breakfast
বুক	breast
নিয়েশ	breath
নিয়েশ	breathe
পুয়াঅন	breed
ইট	brick
নুয়া বউ	bride
ব্রিজ	bridge
সংক্ষেফে	brief
উজ্জল	bright
বুদ্ধিমান	brilliant
আনা	bring
বদ্দা	bro
পাতাজ্জে	broad
সম্প্ররচার গরন	broadcast
ভাঙ্গা	broke
ভাঙ্গা	broken
ঝাডা	broom
ভাই	brother
আলা	brother in law
আইন্নি	brought
বাদামী	brown
ব্রাস	brush
বালতি	bucket
দোস্ত	buddy
বাজেট	budget
ভুল	bug
তৈরি গরন	build
বিল্ডিং	building
তৈরি গরা	built
টাল	bulk
বিরিষ	bull
বুলি	bully
সন্ত্রাসী	bully
আতিক্কে	bump
গুছা	bunch
বান্ডেল	bundle
বোঝা	burden
গাড়াই ফেলা	buried
পোড়া	burn
ফাডি ফরা	burst
হবর দিয়ন	bury
বাস	bus
জওল	bush
ব্যবসা	business
বুক	bust
লালবাতি	bust
বিজি	busy
কিন্তু	but
মাখন	butter
ফদ্দাফতি	butterfly
বোতাম	button
কিনা	buy
দ্বারা	by
ইন বাদ দিয়ন	by the way
বাই	bye
বাধাহপি	cabbage
মন্ত্রীসভা	cabinet
ক্যাবিনেট	cabinet
খাঁচা	cage
কেক	cake
ছা	calf
ডাহন	call
কল	call
আঁরে ডাহন	call me
ডাকা অইয়ি	called
ঠান্ডা	calm
আইলো	came
ক্যাম্ফেইন	campaign
পাবলিশিটি	campaign
পারা	can
ন পারি	can't
ক্যান্সেল	Cancel
বাতিল গড়ন	Cancel
ক্যান্সার	cancer
সক্ষম	capable
হেডাম	capacity
মূলধন	capital
ক্যাপশন	caption
ধারণ হরন	capture
কার	car
ক্যারিয়ার	career
সাবধান	careful
সাবধানে	carefully
খিয়াল ন রাহা	careless
যত্নবান	caring
ফার্নিচের মিস্ত্রি	carpenter
কার্পেট	carpet
গাজর	carrot
হাদত লন	carry
চলাই যা	carry on
গরি ফেলান	carry out
কেইস	case
নগদ	cash
জাত পাত	cast
দূর্গ	castle
সাধারণ	casual
বিড়াল	cat
বিলাই	cat
ধরা	catch
ক্যাটাগরি	category
পাইল্লে পশু	cattle
কট ধরা	caught
ক্যাচ ধরা	caught
হারন	cause
সতর্ক গরন	caution
উশিয়ের	cautious
গুহা	cave
বন্ধ	cease
ছাঁদ	ceiling
উৎযাপন	celebrate
খুঁপরি ঘর	cell
কেন্দ্র	center
সেঞ্চুরি	century
চিরিয়াল	cereal
অনুষ্ঠান	ceremony
নিশ্চিত	certain
নিশ্চিতগরি	certainly
সার্টিফিকেট	certificate
চেইন	chain
ছিয়ার	chair
চ্যালেঞ্জ	challenge
চান্স	chance
পরিবর্তন	change
ঝামিলে	chaos
চরিত্র	character
হাইস্যুত	characteristics
চার্জ	charge
দান গরন	charity
সুন্দর	charming
চাট	chart
ইতেরে ধর	chase
চ্যাট	chat
সস্তা	cheap
বাটপারি	cheat
ধোঁকা দন	cheating
যাচাই	check
গাল	cheek
চিয়ার গীন	cheer
আনন্দিত ফওন	cheerful
চিয়ার্স	cheers
মাহন	cheese
রসায়ন	chemistry
উৎসাহ দিওন	cherish
দাবা খেলা	chess
বুক	chest
চাবান	chew
কুরা	chicken
কুরো	chicken
প্রধান	chief
গুরো ফুয়া	child
বাইল্যহাল	childhood
গুরাপুয়া	children
চিল	chill
চুঁয়ও	chimneys
তুথনি	chin
চাটগাঁইয়া	Chittagonian
চকলেট	chocolate
ফছন্দ	choice
পছন্দ	choose
হাডন	chop
হাজ কর্ম	chores
গোলগাল	chubby
গীর্জা	church
দারুচিনি	cinnamon
বৃত্ত	circle
অবস্থা	circumstances
নাগরিক	citizen
শহর	city
দাবি জানোন	claim
ফরিস্কার গরি হওয়া	clarify
ক্লাস	class
বিজবিজ্জা	clay
ক্লে	clay
ফরিস্কার	clean
ফরিস্কার	clear
কেরানি	clerk
চালাক	clever
ক্লাইয়েন্ট	client
হাস্টোমার	client
খাঁরা বাঁধ	cliff
জলবায়ু	climate
বাই উডন	climb
আঠাইল্লা	clingy
ঘড়ি	clock
বন্ধ	close
আলমারি	closet
হড়চোড়	cloth
কড়চোড়	clothes
মেগ	cloud
মেঘলা	cloudy
ক্লাউন	clown
উপায়	clue
আনাড়ি	clumsy
ক্লাস্টার	cluster
সুফা	coach
কয়লে	coal
সাগর পার	coast
কোট	coat
কফি	coffee
জ্ঞান বিষয়ক	cognitive
কাকতাল	coincidence
ঠান্ডা	cold
ভাংগি পড়া	collapse
কলার	collar
সহকর্মী	colleague
পোয়াজ্জে	colleagues
জমা গরন	collect
তোয়াই আনন	collection
কলেজ	college
রং	color
বেরঙিন সবুজ ছিন্তে ফলের ডইল্লে ঘুম যার	colorless green ideas slept furiously
রং	colour
খুঁডি	column
ফনি	comb
মিশ্রণ	combination
একগলে গড়ন	combination
এক্কফরে	combine
আয়	come
আসা	come
এডে আইয়ু	come here
ইক্কে আয়ু	come on
সান্তনা	comfort
আরাম	comfort
আরামদায়ক	comfortable
আইয়্যের	coming
জলদি আইয়্যের	coming soon
হাম আড়ন	command
মন্তইব্য	comment
বানিজ্যিক	commercial
কমিশন	commission
ওয়াদা গরন	commit
হতা দন	commitment
হতা দিয়্যি	committed
বাজার	commodity
মালামাল	commodity
সাধারণ	common
যুগাযোগ	communicate
যোগাযোগ	communication
সমাজ	community
বিনিময়	commute
অঙ্গী	companion
কোম্পানি	company
তুলনা গরন	compare
তুলনা	comparison
মায়া	compassion
দয়ালু	compassionate
উপযুক্ত	compatible
কম্পিটিশন গরা	compete
দক্ষ	competent
ফতিযোগিতা	competition
ফতিযোগিতামূলক	competitive
অভিযোগ গরন	complain
বিচের	complaint
পরিপূরক	complement
শেষ গড়ন	complete
শেষ	complete
গোডা	completely
জামিলার	complex
মত দেওন	compliance
বৎ প্যাঁচ	complicated
প্রশংসা	compliment
মানি ছলন	comply
গঠন	composition
জটিল	compound
বুঝি লন	comprehension
বিয়াজ্ঞিন মিলাইয়া	comprehensive
মিটমাট হরি ফেলা	compromise
বাধ্যতামূলক	compulsory
কম্পিটার	computer
মনযোগী অন	concentrate
ধারণা	concept
হুশিয়ের তাহন	concern
সজাগ	concerned
কনসার্ট	concert
শেষ হতা	conclusion
বাস্তব	concrete
অবস্থা	condition
অবস্থা	conditions
চালানো	conduct
সম্মেলন	conference
স্বীকার গরা	confess
আত্মবিশ্বাস	confidence
আত্মবিশ্বাসী	confident
কনফার্ম	confirm
নিশ্চিত গড়ন	confirm
ঝামিলা	conflict
গোলমাল লাগন	confused
বুঝিত ন পারন	confusion
শুভকামনা জানন	congrats
অভিনন্দন	congratulation
অভিনন্দন	congratulations
সংযোগ	connect
জয় গরা	conquer
সচেতন	conscious
হুঁশ	consciousness
অনুমতি	consent
পরিণতি	consequences
ফলাফল	consequences
হতাবার্তা	conservation
রক্ষণাত্মক	conservative
বিবেচনা	consider
বিবেচনা গরন	considered
ব্যেয়াক মিলাই	consist
ধারাবাহিক	consistency
রেগুলার	consistent
ধ্রুবক	constant
ছিড়েচিটে	constantly
কোষ্ঠকাঠিন্য	constipation
তৈরি গরা	construction
ব্যবহার গরন	consume
হরছ	consumption
ছুক্তি	contact
ছোয়াঁচে	contagious
ধারন গরন	contain
ধারণ গরন	contains
আতিক্কে বিতিক্কে	contemporary
উফেক্ষা গরন	contempt
কন্টেন্ট	content
প্রতিযোগিতা	contest
বিষয়	context
মহাদেশ	continent
চালায় যন	continue
চুক্তি	contract
বিফরিতে	contrast
অবদান	contribute
অবদান	contribution
কন্ট্রোল	control
বিতর্কিত	controversial
সুবিধে	convenience
সুবিধে	convenient
আলোচনা	conversation
হতা হন	conversation
পাল্টাইন্নে	convert
লই যন	convey
সন্তুুষ্ট	convince
রাজিগরি ফেলন	convinced
রান্না	cook
রাঁধন	cooking
ঠান্ডা	cool
সাহাইয্যু গরন	cooperation
সামলাইতে	cope
তামা	copper
মূল	core
ভুট্টা	corn
কোণা	corner
ঠিক	correct
হরছ	cost
কস্টিউম	costume
ফোশাক	costume
কুটির	cottage
তুলো	cotton
পালংক	couch
কফ	cough
ফাইরতাম	could
পরিষদ	council
গনা	count
কাউন্টার	counter
দেশ	country
গ্রামাঞ্চল	countryside
জোড়া	couple
সাহস	courage
ফথ	course
আদালত	court
ভদ্রতা	courtesy
চাচাতো ভাই	cousin
কাজিন	cousin
ঢাকি দন	cover
গরু	cow
কাপুরুষ	coward
আরামে থাহন	cozy
কেঁরা	crab
ক্রেক	crack
ফাডল	crack
হারিগরি হাজ	craft
কুরোর গু	crap
ফুডি গেইয়ি	crash
ক্ষিদে	craving
ক্রল	crawl
ফল	crazy
তৈরি গরন	create
ছতুর	creative
জমা	credit
ত্রিপ	creep
হাবিল	creepy
নাবিকঅল	crew
অফরাধ	crime
আনাড়ি	cringe
গাটতি	crisis
মানদণ্ড	criteria
নির্ণয়	criteria
চরম	critical
সমালোচনা গরা	criticism
ফসল	crop
দানা	crops
আগে যন গোয়	cross
হাউয়্যা	crow
ভীড়	crowd
ভীড়	crowded
মুকুট	crown
বেশি গুরুত্বপূর্ণ	crucial
নিষ্ঠুর	cruel
সাগরত বেরোন	cruise
ক্রাশ	crush
হান্দন	cry
খিরে	cucumber
বেড়ায় ধরন	cuddle
সংস্কৃতি	culture
ছতুর	cunning
কাফ	cup
আলমারি	cupboard
বেঁহা গরন	curb
ভালা অয় যন	cure
কারফিউ	curfew
কৌতূহল	curiosity
আগ্রহ	curious
কুকড়ানো	curly
টিয়্যা	currency
মুদ্রা	currency
বর্তমান	current
বর্তমানে	currently
বদ্দোয়া	curse
ফর্দা	curtain
বওনের জাগা	cushion
প্রথা	custom
কাস্টমার	customer
কাস্টমস	customs
হাডা	cut
আদইরজে	cute
সাইরকেল	cycle
সাইরকেল চলন	cycling
বাপ	dad
আব্বু	daddy
ফতিদিন	daily
দুগদো	dairy
গোদা	dam
খতি	damage
সেই	damn
ভিজে	damp
নাচ	dance
বিপদ	danger
বিপজ্জনক	dangerous
আঁধার	dark
প্রিয়া	darling
মারামারি	dash
ডেটা	data
তারিখ	date
মাইয়া	daughter
দিন	day
মরা	dead
লাস তারিখ	deadline
বরা	deaf
কারবার	deal
প্রিয়	dear
প্রিয় বিয়াগ্গুন	Dear All
প্রিয় কাস্টমার	Dear Customer
প্রিয় বাপ মা	Dear Parents
প্রিয় শিক্ষক	Dear Sir
প্রিয় ছাত্রছাত্রী	Dear students
প্রিয় দল	Dear Team
মওত	death
বিতর্ক	debate
হরচ	debit
ধবংস অনের ফরর অবস্থা	debris
হজ্য	debt
দশ বছর	decade
হয় গেইয়ি	decay
মরা	deceased
প্রতারণা গরা	deceive
ডিসেম্বর	december
ভদ্র	decent
সিদ্ধান্ত লন	decide
সিদ্ধান্ত লন	decided
সিদ্ধান্ত	decision
ডেক	deck
বাতিল গরি দিওন	decline
কমি যন	decrease
জান ফরান চেষ্টা	dedicated
উজাড় গরি দন	dedication
দলিল	deed
গভীর	deep
হরিণ	deer
যেইল্লে আছে এইল্লে	default
অডি যন	defeat
রক্ষা গরন	defend
মূল হতা হন	define
নিশ্চয়	definitely
সংজ্ঞা	definition
ডিগ্রী	degree
দেরি	delay
দেরি অই গেইয়্যি	delayed
হাডি দন	delete
ইচ্চে গরি	deliberate
কোনরহমে লাগি রইয়ি	delicate
ফুয়াৎ	delicious
আনন্দ	delight
আনন্দিত	delighted
বাডি	deliver
বিতরণ গরা	delivered
ডেলিভারি	delivery
চাহিদা	demand
চাইদে	demanding
গণতন্ত্র	democracy
জ্বিন	demon
দেহানো	demonstrate
মানি ন লওন	denied
ঘারু	density
দাঁতর ডাক্তর	dentist
ন মানন	deny
বিভাগ	department
ছওলি যওন	departure
নির্ভর গরা	depend
প্রয়োগ গরন	deploy
আমানত	deposit
বেজাড়	depressed
ডিপ্রেশন	depression
মানুসিক চাপ	depression
গভীরুত	depth
বর্ণনা হরন	describe
বর্ণনা	description
মরুভূমি	desert
ডিজার্ব	deserve
উপযুক্ত	deserve
ডিজাইন	design
টাইটেল	designation
চাওয়া	desire
ডেস্ক	desk
হতাশা	despair
মরিয়া	desperate
পরেও	despite
ইতা অওয়ার পরেও	despite
ডেজার্ট	dessert
গন্তব্য	destination
ভাইগ্য	destiny
নিশেষ	destroy
ধ্বংস	destruction
বিস্তারিত	detail
আগাগোড়া	details
চিহ্নিত গরি ফেলন	detect
সংকল্প	determination
চিন্নিত হরি রাহন	determine
চিনিত পারন	determined
ভাঙ্গি পড়া	devastated
উন্নতি	develop
উন্নতি	developed
উন্নয়ন	development
যন্ত্র	device
শয়তান	devil
জানপরান	devoted
দিবেহি	Dhivehi
ডায়বেটিস	diabetes
ডায়রিয়া	diarrhea
ডায়েরি	diary
ডিকশনারি	dictionary
গইজ্জিল	did
মরি যন	die
মরি গেইয়ি	died
ডায়েট	diet
ফার্থক্য	difference
নানাব	different
কঠিন	difficult
খুড়ন	dig
ইজ্জত	dignity
পরিশ্রমী	diligent
রাইতির হানা	dinner
চুবন	dip
সরাসরি	direct
দেহাই দিয়ন	direction
পরিচালক	director
হাচারা	dirt
হাঁচারা	dirty
অক্ষম	disable
অনড়	disabled
গায়েব অয় যন	disappear
নারাজ	disappointed
বিফদ	disaster
বাতিল গরি দন	discard
ছাড়ি দন	discharge
শৃংখলা	discipline
ছাড়	discount
আবিষ্কার গরা	discover
বৈষম্য	discrimination
আলোচনা গরন	discuss
আলাফ আলোছনা	discussion
অসুখ	disease
রোগ	diseases
বেশ ধরা	disguise
ফালতু	disgusting
বাসোন	dish
বাসন	dishes
বাদ দিয়ন	dismiss
পাঠন	dispatch
ডিসপ্লে	display
নিষ্পত্তি	disposal
ঝামেলা	dispute
দূরুত্ব	distance
আলাদা	distinct
আলাদা	distinguish
মনোর হষ্ট	distress
ভাগ গরি দন	distribution
জেলা	district
বিরক্ত গরন	disturb
গাতা	ditch
ফাল দিয়ন	dive
বিন্ন রহম	diverse
নানান কিছিম	diversity
ভাগ গরন	divide
শিক	divine
তালাক	divorce
মাথা হাজ ন গরন	dizzy
গর	do
অঁনে না	do you
ওনে আরে ভালবাসন না	do you love me
ডাক্তার	doctor
ডকুমেন্ট	document
হরা	does
ন গরের	doesn't
কুত্ত	dog
ডগ্রি	Dogri
গরির	doing
ফুতুল	doll
ডোমেইন	domain
ঘরর	domestic
জোর দেহন	dominant
ন গর	don't
চিন্তা ন গইজ্জু	Don't worry
দান গরন	donate
শেষ অইয়ে	done
শেষ	done
গাঁধা	donkey
মাদক জাতীয়	dope
ডাবল	double
সন্দেহ	doubt
ডাউট	doubt
ময়দা	dough
নিচ	down
ডাউন	down
ডাউনলোড গড়ইন	download
ডাউনলোড	download
খসড়া	draft
টান	drag
ড্রেইন	drain
নাটক	drama
ড্র	draw
ড্রয়ার	drawer
আহন	drawing
ডর	dread
স্বপন	dream
ড্রেস	dress
ডিল গরা	drill
খঅন	drink
ছালানো	drive
ফেলা	drop
পড়ি গেইয়ি	dropped
খরা	drought
পল	drunk
পুয়ানা	dry
আঁস	duck
বন্ধু	dude
হারণে	due
হারণে	due to
রুক্ষ	dull
বোকা	dumb
খালাস গরন	dump
হতদিন পযন্ত	duration
সময়ে	during
ধুলা	dust
ডিউটি	duty
দায়িত্ব	duty
থাহা	dwell
মরি যন	dying
একে একে	each
একজনে আরএকজনরে	each other
আগ্রহী	eager
ঈগল	eagle
হান	ear
আগে	earlier
সরে সরে	early
অর্জন গরন	earn
হান	ears
পৃথিবী	earth
ভুইছেল	earthquake
আরাম লাগন	ease
সজে	easily
ফুক	east
সহজ	easy
হাওয়া	eat
খার	eating
অর্থনৈতিক	economic
অর্থনীতি	economy
মাথা	edge
ইডিট গরা	edit
শিক্ষে	education
ফ্রভাব	effect
হাইয্যোহর	effective
দক্ষ	efficiency
হাবিল	efficient
চেস্টা	effort
আন্ডা	egg
বায়ুন	eggplant
ইগো	ego
দেমাগ	ego
আষ্ট	eight
আডারো	eighteen
আশি	eighty
ইবা নুঅইলি অইবা	either
বর্ণনা গরন	elaborate
হুনুই	elbow
বড়	elder
বুড়ো	elderly
মার্জিত	elegant
উপাদান	element
আঁতি	elephant
এগার	eleven
যোইগ্য	eligible
ইচন	eliminate
আরও	else
শরম ফাই যন	embarrassed
একডল্লে	embarrassing
মুকাবেলা গরা	embrace
আবির্ভূত	emerge
ইমাজ্জেন্সি	emergency
ইমোশনাল	emotional
সহমর্মিতা	empathy
জোর দিয়ন	emphasis
জোর দিয়ুন	emphasize
হর্মচারি	employee
হর্মচারী	employees
নিয়োগ লইন্নে	employer
হাজর ব্যবস্থা	employment
হালি	empty
সক্ষম	enable
মুকাবিলা	encounter
উৎসাহ দন	encourage
হালাস	end
বিফদো ফড়ি যন	endangered
চেষ্টা	endeavor
সইত পারে	endurance
ছবুর গর	endure
শত্রু	enemy
শক্তি	energy
জড়িত থাহন	engage
যুক্ত থাহন	engaged
যুক্ত থাহন	engagement
ইঞ্জিন	engine
ইন্জিনিয়ার	engineer
ইংরেজি	English
উন্নতি গরা	enhance
ফুর্তি গরন	enjoy
ফুর্তি গরো	enjoy
বউত	enormous
যথেষ্ট	enough
শিওর গরন	ensure
ভিতরে ডুক	enter
বিনোদন	entertainment
আনন্দ উৎসাহ	enthusiasm
হাজে আগ্রহী	enthusiastic
পুরা	entire
মালিক	entitled
পতিস্টান	entity
অস্তিত্ত্ব	entity
যাইবের পথ	entrance
ব্যাবসায়ী	entrepreneur
খাম	envelope
লেপোয়া	envelope
পরিবেশ	environment
হিংসে গরন	envy
মহাকাব্য	epic
মহামারী	epidemic
সমান	equal
যন্ত্রপাতি	equipment
ইকুইটি	equity
সমান	equity
পোয়ান্নে	equivalent
রবার	eraser
ভুল ত্রুটি	error
ফালাই যাওন	escape
স্পেশিয়ালি	especially
প্রবন্ধ	essay
নির্যাস	essence
উপকারী	essential
দরখারি	essential
ফতিষ্টা গরন	establish
প্রতিষ্ঠিত	established
জামিদারি	estate
আন্দাজ	estimate
আনুমানিক	estimated
বৎ কিছু	etc
চিরস্থায়ী	eternal
নীতি	ethics
পাত্তা দেয়া	evaluate
পাত্তা	evaluation
এনকি	even
এনকি	even though
আজইন্যে	evening
ঘটনা	event
প্রকৃতপক্ষে	eventually
কখনো	ever
পত্যেক	every
বেয়াজ্ঞুন	everybody
ফইতথেকে	everyone
বিয়াগ্গিন	everything
পমাণ	evidence
জারগো	evil
বিবর্তন	evolution
বিবর্তিত	evolve
ইউ	Ewe
আগের	ex
একদম ঠিক	exact
হবোহুপ	exactly
ফরীক্ষা	exam
ফরীক্ষা গরন	examine
উদাহরণ	example
ক্রস	exceed
বউত গম	excellent
ছাড়া	except
বেশকম	exception
অতিরিক্ত	excess
অতিরিক্ত	excessive
বদল গরন	exchange
উত্তেজিত	excited
উত্তেজনা	excitement
সেরা	exciting
এক্সক্লুসিভ	exclusive
হমা	excuse
মাাফ গরেন	excuse me
ফরিচালনা গরন	execute
পয়োগ	execution
যে পরিছালনা গরিবে	executive
বিয়াম	exercise
হয়রান	exhaust
ক্লান্ত	exhausted
দেহানো	exhibit
দেহানো	exhibition
থাহন	exist
অস্তিত্ত্ব	existence
বিদ্যমান	existing
বাহির	exit
ছড়াই দন	expand
আশা গরন	expect
যিয়ান মনো গজ্জিলাম ইয়েন	expected
হরচ	expenses
দামী	expensive
অভিজ্ঞতা	experience
ফরীক্ষা	experiment
হাবিল	expert
বাইর গরি দন	expired
ব্যাখ্যা গরন	explain
বর্ণনা গরা	explanation
চুঁই ফেলা	exploit
খুঁজন	explore
রপ্তানি	export
প্রকাশ গরি দন	expose
খোলামেলা	exposed
প্রকাশ পাই যও'ন	exposure
প্রকাশ গরন	express
ঢং	expression
মেলি ধরণ	extend
বাড়াই দেয়্যে	extended
বাড়ন	extension
পাতাজ্জে	extent
বহিরাগত	external
বিলুপ্ত অই যন	extinct
অতিরিক্ত	extra
মূল জিনিসগান	extract
অসাধারণ	extraordinary
চরম	extreme
বউত বেশি	extremely
চউক	eye
চোখ	eyes
ফেব্রিক	fabric
কল্পনা	fabulous
মুখ	face
সহজ গরি দন	facilitate
সুযোগ সুবিধে	facilities
সুবিধে	facility
ঘটনা	fact
ফ্যাক্টর	factor
হারহানা	factory
ঘটনা	facts
এব্বেরে চলি যাওয়া	fade
ফেইল গরন	fail
পারেনাই	failed
ফেইল মারন	failure
বিঁয়েশ	faint
হাটি	fair
মুটামুটি	fairly
পরী	fairy
বিশ্বাস	faith
বিশ্বস্ত	faithful
নহল	fake
পরি জন	fall
মিছে	false
সুনাম	fame
চিনা	familiar
ফরিবার	family
দুর্ভিক্ষ	famine
বিখ্যাত	famous
ভক্ত	fan
ভালা	fancy
বেশি সুন্দর	fantastic
দুরে	far
বিদায় অনুষ্ঠান	farewell
খামার	farm
কৃষক	farmer
বউত সুন্দর	fascinating
ফ্যাশন	fashion
তাড়াতাড়ি	fast
মোডা	fat
সিরিয়াস	fatal
ভাইগ্য	fate
আব্বু	father
হরান লাগা	fatigue
দোষ	fault
প্রিয়	favorite
ফক্ষফাত গরন	favour
প্রিয়	favourite
ডর	fear
খওন দওন	feast
ফইর	feather
বৈশিস্ট	feature
বৈশিষ্ট	features
ফেব্রুয়ারি	february
বিরক্ত	fed up
ফিস	fee
হাবন	feed
ফিডব্যাক	feedback
বুঝিত পারন	feel
ফিল গরন	feeling
ফা	feet
পইজ্জি	fell
পেলা	fellow
বুঝিত ফারোন	felt
মেইপুয়া	female
বেড়া	fence
তশ	fertile
উৎসব	festival
আনন	fetch
জ্বর	fever
অল্প	few
হম	fewer
ফিন্যান্স	fiance
ফিকশন	fiction
মাঠ	field
মারাত্মক	fierce
পো দরো	fifteen
পঞ্চাইশ	fifty
মারামারি	fight
হউজ্যে গরন	fighting
ফিগার	figure
বাইর গরন	figure out
ফাইল	file
পুরণ হরা	fill
মাড	filled
ছবি	film
হাঁচারা	filthy
শেষ ফইজ্জন্ত	finally
টিয়া দিওন	finance
টিয়া পয়সে	financial
খুঁজা	find
থুয়াই লন	find out
ভালা	fine
অউল	finger
সমাপ্তি	finish
শেষ	finished
অন	fire
কডিন	firm
ফইলে	first
নামের ফয়লা অংশ	first name
মাছ	fish
ফিট	fit
উপযুক্ত	fit
পাচ	five
ঠিক গরা	fix
স্থীর	fixed
পতাকা	flag
ঝলক	flash
ফ্লেট	flat
দোষ	flaw
ভুল ছাড়া	flawless
পালাই যন	flee
গোস্ত	flesh
উরিযন গুই	flew
বেঁহা গরি ফেলন	flex
নড়ন চড়ন গরন সোজা	flexible
ফ্লাইট	flight
টুকা দন	flip
ফ্লার্ট	flirt
ফাম দেওন	flirt
ফ্লার্ট গরা	flirting
ফাম দেওয়া	flirting
ভাইতাহন	float
বইন্যা	flood
মেডি	floor
ময়দা	flour
বই যাওন	flow
ফুল	flower
ফ্লু	flu
জ্বর	flu
একনাগাড়ে	fluent
বাজাবাজি ছাড়া	fluently
তুলতুইল্যা	fluffy
তরল	fluid
উড়ন	fly
লক্ষ্য হরন	focus
কুবা	fog
কুবা	foggy
ভাজ	fold
লোক	folks
ফলো গরন	follow
ফলো আফ	follow up
আবার	follow up
ফরের	following
হানা	food
গাধা	fool
বোকা	foolish
ঠ্যাং এর ফাতা	foot
ফুটবল	football
লাগি	for
উদারণস্বরূপ	For example
ইয়েনেল্লাই	for instance
অনর লাই	for you
নিষিদ্ধ	forbidden
জোর দিওন	force
আগাম জানাই দন	forecast
কুয়াল	forehead
বিদেশ	foreign
বন	forest
আজীবনরলাই	forever
ফউরি যন	forget
মাফ গরন	forgive
ফরি গেই	forgot
কেডা চামিচ	fork
ফরম	form
আনুষ্ঠানিক	formal
ফর্মাল	formal
আগের	former
পুরাকুআইল্লে	fortunately
বাইজ্ঞো	fortune
চল্লিশ	forty
বিয়াল্লিশ	forty-two
সামনে	forward
পাইল্লে	foster
যুদ্ধু গইজ্জি	fought
খুঁজি পন	found
বেইস	foundation
চাইর	four
চৌইদ্দো	fourteen
ইয়েল	fox
মেচমেইচ্ছে	fragile
ফ্রেইম	frame
ফ্রেইমওয়াক	framework
ধান্দাবাজ	fraud
ফলা	freak
মুক্ত	free
স্বাধীনতা	freedom
ঠান্ডা অয় যন	freeze
বার বার	frequency
প্রায়ই	frequent
ঘন ঘন	frequently
ততোজা	fresh
শুক্কুরবার	friday
ফ্রিজ	fridge
বন্ধু	friend
বন্ধু্ধুত্বপূর্ণ	friendly
বন্ধু বান্ধব	friends
বন্ধুত্ব	friendship
ডরোন	frightened
ডরাই	frightening
ব্যাঙ	frog
এডেত্তুন	from
সাম্মদি	front
জমি যন	frozen
ফল	fruit
হতাশ অয়যন	frustrated
জ্বালানি	fuel
ফুলাফুলডে	Fulfulde
গোডা	full
মজা	fun
অনুষ্ঠান	function
মৌলিক	fundamental
জানাজা	funeral
শেষকৃত্য	funeral
মজার	funny
লোম	fur
রাগ	furious
ফার্নিচের	furniture
আর	further
ফার্দার	further
আরো	furthermore
ভবিষ্যত	future
অর্জন	gain
গেইম	game
ফাঁক	gap
গ্যারেজ	garage
আবর্জনা	garbage
বাগান	garden
রসুন	garlic
গেইট	gate
এক্কানত অন	gather
এক্কানত অয়ি	gathering
গজ	gauge
মাফন	gauge
দিয়ি	gave
গিয়ের	gear
লিঙ্গ	gender
সাধারণ	general
সাধারণত	generally
উৎপন্ন গরন	generate
তইয়ার গরন	generate
প্রজন্ম	generation
নরম মনর	generous
গিয়ানী	genius
কিছিম	genre
নরম	gentle
আসল	genuine
ঢং	gesture
পওন	get
হড় ফরি ল	get dressed
উডন	get up
খুব তাড়াতাড়ি সুস্থ অয়যন	get well soon
পায়ুন	getting
ভুত	ghost
আ জির অন	ghosting
দীয়	giant
উপহার	gift
আদা	ginger
মেয়ে	girl
বান্দুবি	girlfriend
গার্লফ্রেন্ড	girlfriend
দিয়ন	give
ছাড়ি দন	give up
দি দন	given
খুশি	glad
এক নজর	glance
আনা	glass
চশমা	glasses
টের পওন	glimpse
বৈশ্বিক	global
আঁধাইর	gloomy
আত মজো	gloves
আভা	glow
ফর অয় যন	glow up
আঁঠা	glue
যা	go
আগাই যও	go ahead
বউদ দুরে যা	go away
গুমুইতো য	go to bed
লক্ষ্য	goal
গোল	goals
ছল	goat
আল্লাহ	god
আল্লাহ অনর ভালা গরক	god bless you
যাই	goes
যাইর	going
যাইজ্জি	going to
স্বন্ন	gold
চলি যন	gone
যার	gonna
গম	good
শুভ বিকাল	good afternoon
বিদায়	good bye
দিনগান ভালা হাডক	good day
শুভ সন্ধ্যা	good evening
ভালা গইজ্জু	good job
ভালা দেহার	good looking
শুভ কামনা	good luck
শুভ সকাল	good morning
শুভ সকাল প্রিয়	good morning my love
শুভ সকাল সোনা	good morning my love
শুভ রাত্রি	good night
বিদায়	goodbye
শুভ্র রাত্রি	goodnight
জিনিসপত্র	goods
গুগোল	Google
গুগল অনুবাদ	Google Translate
রাজহাঁস	goose
সেরা লার	gorgeous
গল্প গরন	gossip
ফাইয়ি	got
বুজ্জি	got it
সরকার	government
ধরি ফেলন	grab
শ্রেণি	grade
আস্তে আস্তে	gradually
বিউ	graduate
শস্য	grain
দিয়ন	grant
অনুমতি	granted
পারমিশন	granted
আঙ্গুর	grapes
ধরি রাহন	grasp
ঘাস	grass
খের	grass
কৃতজ্ঞ	grateful
কৃতজ্ঞতা	gratitude
কবর	grave
ছাই রঙ	gray
সেরা	great
লোভ	greed
লোভী	greedy
সবুজ	green
শুভেচ্ছা জানন	greet
স্বাগতম জানন	greeting
শুভেচ্ছা	greetings
ধুইসে	grey
গ্রিড	grid
দঃখ	grief
নিচে	grind
গ্রিপ	grip
বাজেমাল	grocery
জামাই	groom
হাঁটি	gross
মেডিত	ground
গ্রুপ	group
উইঠ্যি	grow
বাড়ান	growth
বদমেজাজি	grumpy
গুয়ারানি	Guarani
গ্যারেন্টি	guarantee
গার্ড	guard
মনে গরা	guess
মেহমান	guest
পরামর্শ দিয়ন	guidance
গাইড	guide
দোষী	guilty
মানুষ	guy
গাই	guy
বন্ধুরা	guys
জিম	gym
অভ্যেস	habit
থাহনের জাগা	habitat
আছিল	had
শিল ঝড়	hail
চুল	hair
আঁধা	half
অয়িনা	hall
হাত	hand
হ্যান্ডল	handle
হাতল	handle
যেই সুন্দর	handsome
ঝুলাই দন	hang
গোরন গারন	hang out
ঘটা	happen
ঘটিলো	happened
সুখ	happiness
খুশি	happy
শুভ জন্মদিন	happy birthday
অনেরে শুভ জন্মদিন	happy birthday to you
শুভ নববর্ষ	happy new year
কঠিন	hard
এব্বেরে হম	hardly
মাঝে মাঝে	hardly ever
হতি	harm
হতিকর	harmful
সম্প্রীতি	harmony
কঠিন	harsh
ফসল হাডন	harvest
খেত	harvest
আছে	has
দেইত ন ফারন	hate
আছে	have
অনর দিনগান ভালা হাডক	have a good day
অনর দিনগান গম যক	have a nice day
সকালের নাস্তা হায় ল	have breakfast
মজা হরো	have fun
অনে কি হাইয়ুন না	have you eaten
আছে	having
বিফদ	hazard
কুয়া	haze
ইতে	he
ইতের আছে	he has
ইতে অইলো	he is
মাথা	head
মাথাহরার	headache
ভালা অই যন	heal
ভালা অই যন	healing
স্বাস্থ্য	health
স্বাস্থ্যবান	healthy
শুনা	hear
ফুনন	heard
অন্তর	heart
গরম	heat
বেহেশত	heaven
ভারী	heavy
বউত ব্যস্ত	hectic
উচ্চতা	height
উত্তরাধিকারী	heir
ডাকাতি	heist
অনুষ্ঠিত	held
জাআন্নাম	hell
হ্যালো	Hello
ওগো	hello dear
অঁনে কেন আছেন	hello how are you
অনে কেন আছন	hello how are you doing
হেলমেট	helmet
সাইয্যু	help
সাইয্যুগরণ্যে	helpful
ইনেনল্লাই	hence
ইতির	her
পশুর ফাল	herd
এডে	here
ঐতিহ্য	heritage
দ্বিধা	hesitate
ওই	Hey
হাই	Hi
অন্নে কেন আছন	hi how are you
অই এডে	Hi there
গোফন	hidden
লুকি যন	hide
অনুক্রম	hierarchy
উচা	high
লক্ষণীয় করা	highlight
আঁডি যন	hike
লম্বা জাগা হাঁটন	hiking
হাইস্যকর	hilarious
টিলে	hill
ইতেরে	him
ইঙ্গিত	hint
ফুন্দ	hip
পোঁদ	hips
ভাড়া গরন	hire
ভাড়া গরন	hiring
ইতের	his
ইতিহাস	history
আঘাত	hit
হুমম	Hmm
অশ	hobby
ধরি রাখ	hold
থিয়েই তাহ	hold on
গারা	hole
ছুটি	holiday
ফাঁফা	hollow
ঘর	home
বাড়ির হাজ	homework
সৎ	honest
বেশি ভালা	honest
অনেস্ট	honest
সৎভাবে	honestly
ননাই	Honey
সম্মান	honor
ঘোমটা	hood
হুক	hook
খোড়ান	hop
আশা	hope
আশা ঘরি	hopefully
নিরাশ	hopeless
আড়াআড়ি	horizontal
শিং	horn
জঘইন্য	horrible
ডরাই যে এইল্লে	horror
ঘোড়া	horse
মেডিক্যাল	hospital
হাস্ফাতাল	hospital
মেহমানদারি	hospitality
আয়োজক	host
বাধা	hostile
গরম	hot
হোটেল	hotel
ঘন্টা	hour
ঘন্টার ফর ঘন্টা	hours
বাড়ি	house
পরিবার	household
কেনে	how
অনর কী অবস্থা	how about you
কেন আছো	how are you
কেনে চলর	how are you doing
তু্ঁই আজিয়ে কেন গইত্তে লাইগ্গুজে	how are you doing today
অনে আজিয়ে কেন আছন	how are you today
অনে কেনে গরন	how do you do
কেনে অয়	how is
হট্টা	how many
হত	how much
কি রহম ঘটে	how often
তোঁয়ার বয়স হত	how old are you
অনর দিন কেন হাইট্টিল	how was your day
রাতিয়ে কিভাবে আছিলিযি	how was your night
যিয়েন অইবো অক	however
কেন্দ্র	hub
সখ	hubby
বেরাই ধরন	hug
বুউত বড়	huge
মানুষ	human
ভদ্র	humble
ভিজে	humid
আর্দ্রতা	humidity
শত	hundred
ভোগ লাগন	hungry
শিয়ের গরা	hunt
ঝড়	hurricane
তাড়াতাড়ি	hurry
জলদি গর	hurry up
হস্ট	hurt
জামাই	husband
তাড়াহুড়া গরন	hustle
কুড়ে ঘর	hut
স্বাস্থবিধি	hygiene
আঁই	I
আঁই অইলাম	I am
আয় গম আছি	I am fine
আঁই ফারি	I can
আঁই ন পারির	I can't
আঁই গরি	I do
আঁই ন জানি	I do not know
আঁই বুঝিত ন পারির	I do not understand
আয় নো	I don't
আঁই ন জানি	I don't know
আঁই ন বুজির	I don't understand
অনে কি হইতে লাইজ্ঞোন আয় বুজিত নো পারির	I don't understand what you mean
আঁই অনর হতা ন বুঝির	I don't understand you
আঁই ন জানি	I don’t know
আঁই ন বুজিদ্দে	I don’t understand
আঁর মনে অয়	i guess
আঁর আছিল	I had
আঁর আছে	I have
আঁই আছিলাম	I have been
আর বউদ আশা	I hope so
আঁই জানি	I know
আঁই দেইত পারি	I like
আঁই অনেরে ফছন্দ গরি	I like you
আঁই ভালোবাসি	I love
আঁই আঁর বড় ভাইরে ভালোবাসি	I love my big brother
আঁই আঁর বড় বইনরে ভালোবাসি	I love my big sister
আঁই আঁর আব্বুরে ভালোবাসি	I love my father
আঁই আঁর ছোড ভাইরি ভালোবাসি	I love my little brother
আঁই আঁর ছোড বইনরে ভালোবাসি	I love my little sister
আঁই আঁর মা রে ভালোবাসি	I love my mother
আঁত্তুন অনারে গম লাগে	I love you
আঁয় তোয়ারে বৎ দেহিত পারি	I love you so much
আয় ও তোয়ারে ভালবাসি	I love you too
আঁই বুজায়তে চাইজ্জি	I mean
আঁত্তে ফেট পুরের	I miss you
আয় তোর অভাব বুজিত তাজ্জি	I miss you so much
আঁই দেহি	I see
আয় মনত গরি	I think
আঁই বুইজ্জি	I understand
আঁই চাই	I want
আঁই অনেরে দেইকতাম ছাই	I want to see you
আঁই তোঁয়ারে চায়	I want you
আঁই আছিলাম	I was
আঁই পাইজ্জুম	I will
আঁই অইতাম	I would be
আঁই অয়	I'm
আঁই গম আছি	I'm fine
আঁই ভালা আছি	I'm good
আঁই এন্ডে আছি	I'm here
আঁই দুঃখিত	I'm sorry
আঁই আসলেই দুঃখিত	I'm sorry
বরপ	ice
আইসক্রিম	ice cream
আইডিয়া	idea
আদর্শ	ideal
একডইল্লে	identical
খুজি লন	identify
পরিচয়	identity
বোকা	idiot
আলসিয়ে	idle
যদি	if
অবহেলা গরন	ignore
অসুস্থ	ill
বৈধ ন	illegal
ব্যারাম্মে	illness
ইলোকানো	Ilocano
ছবি	image
ভাবি চন	imagine
অতিসত্বর	immediate
জলদি	immediately
বউত	immense
প্রভাব	impact
অধীর	impatient
বাস্তবায়ন গরন	implement
আমদানি	import
গুরুত্বপূর্ণ	important
আরোপ গরা	impose
অসম্ভব	impossible
ইমপ্রেস	impress
আকর্ষণ	impress
ছাপ	impression
চমৎহার	impressive
উন্নতি	improve
উন্নতি	improvement
বিতরে	in
এয়িন ছাড়া ও	in addition
আসলে	In fact
সামনে	in front of
এনগরি	in order to
অনুপযুক্ত	inappropriate
উৎসাহো	incentive
ঘটনা	incident
অন্তরভুক্ত গরন	include
সয়	including
হামানো	income
অসুবিধে	inconvenience
বারি যন	increase
বাড়ি যন	increased
বেশি সেরা	incredible
আসলে	indeed
স্বাধীন	independent
ভারত	India
দেহায় দিয়ন	indicate
আদিবাসী	indigenous
নিজর	individual
হারখানা	industry
যিয়ান ঘটিবুই	inevitable
বাইচ্ছে	infant
ছড়ায় পড়ন	infection
যার হোনো সীমা নাই	infinity
জ্বালাফুড়া গরন	inflammation
মুদ্রাস্ফীতি	inflation
প্রভাব	influence
জানাইয়েন	inform
তইথ্য	information
উপাদান	ingredients
উত্তরাধিকার	inheritance
শুরুর দিক	initial
উদ্যোগ	initiative
আহত	injured
আঘাত	injury
নিস্পাপ	innocent
আবিস্কার গরন	innovation
খোঁজা	inquiry
ফল	insane
জীবাণু	insect
অনিরাপদ	insecure
সন্নিবেশ	insert
বিতুরি	inside
ভিতুরি	insight
জোর গরন	insist
রাইতজাগন	insomnia
পাম	inspiration
উৎসাহ দন	inspire
ইন্সটল	install
ইনস্টল গরন	install
দৃষ্টান্ত	instance
ফডাফড	instant
পরিবর্তে	instead
পরিবর্তে	instead of
দিকনির্দেশনা	instructions
যন্ত্রফাতি	instrument
অপমান গরা	insult
বীমা	insurance
নুয়া	intact
একলগে গরন	integrity
বুদ্ধিজীবী	intellectual
বুদ্ধি	intelligence
ছতুর	intelligent
অভিপ্রয়	intend
অভিপ্রেত	intended
বউত	intense
মতিগতি	intention
যোগাযোগ	interact
ছালচলন	interaction
আগ্রহ	interest
আগ্রহী	interested
মজা লার	interesting
হস্তক্ষেপ গরন	interfere
মাঝরদ্দি	intermediate
অভ্যন্তরীণ	internal
আন্তর্জাতিক	international
ইন্টার্নশীপ	internship
ব্যখ্যা গরন	interpret
অনুবাদক	interpreter
দুবাসি	interpreter
বাধা দেওন	interrupt
ইন্টারভিউ	interview
অন্তরঙ্গ	intimate
গোফন	intimate
বারেত্তুন ভিতুরে	into
পরিচয় হরায় দিওন	introduce
ফরিচয়	introduction
ভূমিকা	introduction
নিজোর মত হরি তাহা	introvert
স্বজ্ঞা	intuition
অবৈধ	invalid
কাম গড়ের ন	invalid
আবিস্কার	invent
ক্যাশ	inventory
বিনিয়োগ গরন	invest
তদন্ত গরন	investigate
দাওয়াত দন	invitation
দওত দিয়ন	invite
চালান	invoice
জড়িত থাহন	involve
যুক্ত থাহন	involved
লোআ	iron
অয়	is
দ্বীপ	island
আলাদা	isolated
ইস্যু	issue
ইস্যু	issues
ইয়েন	it
ইয়েন অইলজি	it is
ইয়েন আছিল	it was
ইয়েন	it's
আইচ্ছে ঠিক আছে	it's ok
ঠিক আছে	It's okay
আইটেম	item
ধরন	items
ইবের	its
আঁই	I’m
জ্যাগেট	jacket
জেলখানা	jail
জা্নুয়ারি	January
বইয়ম	jar
চোয়াল	jaw
হিংসুক	jealous
ঝাংগার	jerk
স্বর্ণের অলংকার	jewelry
হাজ	job
জগিং	jogging
যোগ দিয়ন	join
একলগে	joint
রসিকতা গরন	joke
সাংবাদিক	journalist
ভ্রমণ	journey
ফুর্তি	joy
জজ	judge
রস	juice
জুলাই	july
ফাল	jump
জুন	june
হাঁছারা	junk
জাস্ট	just
গরি ফেলা	just do it
ন্যায়বিচের	justice
বিচার গরন	justify
কালাআলিশুত	Kalaallisut
বউত আগ্রহী	keen
রাহা	keep
ইয়েন ধরি রাহো	keep it up
রাইলাম	kept
গরুছল	kettle
ছাবি	key
লাথি দন	kick
গুরো পুয়া	kid
দুস্টমি	kidding
কিন্নি	kidney
গুর পোয়া	kids
মারি ফেলা	kill
দয়ালু	kind
এনডইল্লে	kinda
দয়া গরি	kindly
দয়া	kindness
রাজা	king
চুম্মা	kiss
ফাকঘর	kitchen
ঘন্টি	kite
বিলের ছা	kitten
হাঁটু	knee
জাইন্তেম	knew
চুরি	knife
নাইট	knight
জানা	know
গিয়ান	knowledge
পরিচিত	known
কোনকানি	Konkani
ক্রিও	Krio
মারহা মারা	label
মিন্নোত	labor
ফরিশ্রম	labour
কমতি	lack
আউক্কো	ladder
মহিলা	lady
শুয়াই দিওন	laid
লেক	lake
ভেড়া	lamb
ল্যাঙ্গা	lame
ছেরাগ	lamp
জায়গা	land
দৃশ্য	landscape
ভাষা	language
ভাজ	lap
বড়	large
শেষ	last
শেষ কিন্তু শেষ ন	last but not least
লাস্টোর নাম	last name
দেরি	late
কিছুক্ষণ আগে	lately
পরে	later
এব্বেরে লাস্ট	latest
ফরে	latter
হাসা	laugh
হাস্যময়	laughing
আসি	laughter
দুইজ্জা হানা	launch
লন্ড্রি	laundry
আইন	law
উডন	lawn
উকিল	lawyer
রাখি দও'ন	lay
লেয়ার	layer
সেটাপ	layout
আলসিয়ে	lazy
নেতৃত্ত দিওন	lead
নেতা	leader
ফাতা	leaf
ফুডা	leak
হ্যাংলা	lean
লিপ	leap
শিখা	learn
শেখা	learning
লিজ	lease
হম	least
চামরা	leather
গেয়্যিগুই	leave
ফাতা	leaves
এলইডি	led
নেতামি	led
ছলি যন	left
ঠ্যাং	leg
উত্তরাধিকার	legacy
আইনী	legal
বৈদ	legal
লেজেন্ড	legend
হাটি	legit
অলস সময়	leisure
ধার দিওন	lend
দৈর্ঘ	length
অল্প	less
কম	less
পাঠ	lesson
যাইতে দ	let
চিডি	letter
লেটুস	lettuce
লেভেল	level
হাম হাসিল গরনের ফথ	leverage
দায় দায়িত্ব	liability
লাইব্বেরি	library
চাটা	lick
মিছে হতা	lie
মিছে	lies
জীবন	life
লিফট	lift
পাতল	light
ঠাডার পড়া	lightning
পছন্দ	like
সম্ভবত	likely
একই ডইল্যে	likewise
লাইন	line
লিঙ্গালা	Lingala
লিঙ্ক	link
শিংহ	lion
পাইন্নে	liquid
লিস্ট	list
ফুনা	listen
পুনা	listening
একবেরে	literally
সাহিত্য	literature
লিটার	litter
ছোড	little
সরাসরি	live
থাহা	live
হইলজে	liver
জীবন	lives
বাচি আছে	living
বইবের ঘর	living room
টিকটিকি	lizard
বুজা	load
গোডা পাউরুটি	loaf
লোন	loan
এস্থানীয়	local
অবস্থান	location
লক	lock
লকডাউন	lockdown
টাল	log
লল	lol
এহেলা	lonely
লম্বা	long
বউত দিন ধরি ন দেহির	long time no see
তাকানো	look
লুপ	loop
আলগা অয় যন	loose
প্রভু	lord
হারি যন	lose
হতি	loss
আজি যন	lost
বউত	lot
জোরে	loud
লাউঞ্জ	lounge
ভালবাসা	love
তোঁয়ারে ভালোবাসি	love you
সুন্দর লার	lovely
হম	low
নিচু	lower
বিশ্বস্ত	loyal
মাথানত	loyalty
ভাইজ্ঞু	luck
ভাইগ্যবান	lucky
লোগান্ডা	Luganda
ব্যাগ	luggage
দলা	lump
দুইজ্জের হানা	lunch
ফুসফুস	lungs
বিলাসিতা	luxury
মিছে হতা হওন	lying
মেশিন	machine
পল	mad
মেডাম	madam
বানাইয়ি	made
পত্রিকা	magazine
চিলিবিচিলি	magnificent
হামর মেয়ে	maid
প্রধান	main
ধরি রাখিত পারন	maintain
চায়চিতি রাহা	maintenance
মৈথিলি	Maithili
মেইন	major
মেজরিটি	majority
বানানো	make
মেকাপ	make up
মরৎ পুয়া	male
শপিং মল	mall
মানুষ	man
চালাইত পারন	manage
ফরিচালনা	management
ম্যানেজার	manager
আবশ্যক	mandatory
প্রচার	manifest
ম্যানিপুলেট	manipulate
ব্যবয়ার	manner
আচরণ	manner
ম্যানুয়াল	manual
বৎ	many
অনর জিবনত দিনগান বার বার ফিরি আইয়ুক	many many happy returns of the day
মার্চ	march
মার্জিন	margin
বাজার	market
বিয়ে	marriage
বিয়া	marriage
বিবাহিত	married
মুখোশ	mask
উজন	mass
বউত বড়	massive
মাস্টর	master
ম্যাচ	match
দোস্ত	mate
জিনিস	material
অংক	math
বিষয়	matter
পরিপক্কতা	maturity
অইত পারে	may
অইত পারে	maybe
আঁরে	me
আঁই ও	me too
হানা	meal
অর্থ	mean
মানে	meaning
মানুে	means
মানি	meant
ইক্কেদি	meanwhile
মাপা	measure
ফরিমাপ গরন	measures
গোশত	meat
মেডিকেল	medical
ওষুধ	medicine
দ্যান	meditation
যোগ ব্যায়াম	meditation
মাধ্যম	medium
দেহা গরন	meet
মিটিং	meeting
মেইটেইলন	Meiteilon
গলি যন	melt
স্মৃতিগিন	memories
স্মৃতি	memory
মানসিক	mental
উল্লেখ গরন	mention
উল্লেখ গরা	mentioned
মেন্টর	mentor
ব্যবসাই	merchant
দয়া দেহন	mercy
নিছক	merely
মেরি ক্রিসমাস	merry christmas
জামিলা	mess
ম্যাসেজ	message
অগোছানো	messy
ধাতু	metal
ফদ্ধতি	method
অন্ধুর	mice
মাঝামাঝি	middle
আঁধা রাইত	midnight
হয়তো	might
হম	mild
মাইলফলক	milestone
মিলিটেরি	military
দুধ	milk
মিলিয়ন	million
দশ লাখ	million
মন	mind
মানসিকতা	mindset
আঁর	mine
মিয়েই দন	mingle
ছোড	minor
মিনিট	minute
মিনিট	minutes
অলৌকিক ঘটনা	miracle
আনা	mirror
নানান কিছিমের	miscellaneous
ঝাড়গো	mischievous
করুন দশা	miserable
হস্ট	misery
ফেট পুরন	miss
তোঁয়ারলাই ফেট ফুরেজ্জে	miss you
পন ন জার	missing
মিশন	mission
কুয়াশা	mist
ভুল	mistake
মিজো	Mizo
মোবাইল	mobile
তামাশা গরন	mock
মডেল	model
মিডিয়াম	moderate
আধুনিক	modern
বিনয়ী	modest
ভিজে	moist
ভিজে অবস্থা	moisture
ছাঁচ	mold
তিল	mole
মা	mom
মুহূর্ত	moment
সোমবার	monday
টিয়া	money
মনিটর	monitor
ফর্যবেক্ষণ গরা	monitor
বাঁদর	monkey
মাস	month
মোড	mood
মনমরা	moody
ছান	moon
নৈতিক	moral
আরো	more
আরও	moreover
বিয়াইন্নে	morning
বাধা	mortgage
সবচাইতি	most
প্রায় বেয়াজ্ঞিন	mostly
মা	mother
গতি	motion
পাইন	motivation
পাড়	mountain
মাউস	mouse
মুখ	mouth
লড়াই ফেলা	move
আন্দোলন	movement
সিনেমা	movie
মিসেস	mrs
বৎ	much
পুট	mud
মগ	mug
গোস্তোর তুচ	muscle
যাদুঘর	museum
ব্যাংগের ছাতি	mushroom
গান	music
অবশ্যই	must
চুপচাপ	mute
মিলেমিশি	mutual
আঁর	my
আঁর প্রিয়	My dear
আঁর বন্ধু	my friend
আঁর হুভারক্রাফট গান ঈল দি ভরা	My hovercraft is full of eels
আঁর জানপাখি	my love
আঁর নাম	my name is
আর খুশি	my pleasure
আঁই নিজ	myself
রহইস্যজনক	mysterious
রইস্য	mystery
শ্রুতি	myth
নখ	nail
বকচুদ	naive
নাম	name
বর্ণনা	narrative
যেই গুর	narrow
হরাফ	nasty
জাতীয়	national
দেশত্তে	nationality
এস্থানীয়	native
ফাকৃতিক	natural
প্রকৃতি	nature
উডানি	nausea
হাছে	near
হাছের	nearby
হাচাহাচি	nearly
ফরিস্কার	neat
জরুরি	necessary
ঘেডি	neck
হার	necklace
প্রয়োজন	need
হরাফ	negative
নেগেটিভ	negative
হেলাপেলা	neglect
মিটমাট গরি ফেলন	negotiate
পারাইল্যে	neighbor
ফারাইল্লে অল	neighborhood
ইয়েন ও না অইয়েন ও না	neither
ভাইনে	nephew
ভাইনি	nephew
ঘরকুনো	nerd
নার্ভাস	nervous
পাখির বা	nest
নেট	net
নেটওয়ার্ক	network
নিরপেক্ষ	neutral
কখনো ন	never
হোনোদিন দিতাম নো	never give up
কিছু মনে ন হইজ্জু	never mind
কিচ্ছু মনে ন গইজ্জু	nevermind
তাছাড়াও	nevertheless
নয়া	new
হবর	news
ফরে	next
পরে	next to
সুন্দর	nice
অনের লয় হতা হই গম লাইজ্ঞি	nice to meet you
অনের লই দেহা হই গম লাইজ্ঞি	nice to meet you
ভাইনি	niece
রাইত	night
দুঃস্বপ্ন	nightmare
নয়	nine
উন্নিশ	nineteen
নব্বই	ninety
না	No
হনো সমস্যা নাই	no problem
হোনোরহমে নো	no way
কেই ন	nobody
আওয়াজ	noise
আওয়াজ	noisy
কিছু ন	none
দুইজ্জ্যা	noon
ন	nope
ন	nor
সাধারণ	normal
উত্তর	north
নাক	nose
পুরান স্মৃতি মনত পরন	nostalgic
না	not
এব্বেরে ন	not at all
হারাপ ন	not bad
এহন ন	Not now
এহনো ন	not yet
টীকা	note
বি দ্র	note
বিখ্যাত	noted
নাথিং	nothing
নোটিস	notice
বিজ্ঞপ্তি	notice
লক্ষ গরন	noticed
বিশেষ্য	noun
বিশেষ্য	nouns
উপন্যাস	novel
নভেম্বর	november
এহন	now
আজিয়ে হালিয়ে	nowadays
উপদ্রব	nuisance
হালি	null
সেন্স নাই	numb
সংখ্যা	number
নার্স	nurse
বাদাম	nut
জাইফল	nutmeg
ফুষ্টি	nutrition
শপথ	oath
মোডা	obesity
মানি ছলন	obey
জিনিস	object
উদ্যেশ্য	objective
বাইধ্যবাধকতা	obligation
কিলিয়ার ন	obscure
ভালা গরি চন	observation
চাই রাখন	observe
মগ্ন থাহন	obsessed
ঘোর	obsession
বেইল গেইয়্যি গুই	obsolete
বাধা	obstacle
অর্জন গরন	obtain
অর্জন গইরলো	obtained
একদম ফরিস্কার	obvious
অবশ্যই	obviously
মাঝে মইধ্যে	occasionally
পেশা	occupation
দখল অই গেয়্যি	occupied
ঘটা	occur
ঘইট্টি যে	occurred
ঘটে	occurs
বড় সাগর	ocean
অক্টোবর	october
কেনজানি	odd
ব্যাক ভিন্নমত	odds
এর	of
অবশ্যই	of course
বন্ধ	off
আক্রমণাত্মক	offensive
প্রস্তাব	offer
অফিস	office
দাপ্তরিক	official
প্রায়	often
ওহ	Oh
অহ আছা না	oh really
তেল	oil
আইচ্ছে	ok
আইচ্চে প্রিয়	ok dear
ঠিকাছে সোনা	ok honey
আইচ্ছে সোনা	ok my love
আইচ্ছে	okay
আচ্ছা সোনা	okay baby
আইচ্ছে সোনা	okay dear
ঠিক আছে সোনা	okay honey
ঠিক আছে জান	okay my love
পুরন	old
পুরান	old
উরে	on
এককালে	once
এক	one
ওগ্গো ভাষা কহনো যথেষ্ট ন	one language is never enough
পিয়েজ	onion
অনলাইন	online
শুধু	only
খোলা	open
অপারেশন	operation
মত	opinion
সুবিধে	opportunities
সুবিধে	opportunity
বিপক্ষে	opposite
আশাবাদী	optimistic
অপশন	option
অতিরিক্ত	optional
বা	or
হওলা	orange
আদেশ	order
অর্ডার	order
সাধারণ	ordinary
সংগঠন	organization
শুরু ওন	orientation
উৎস	origin
আসল	original
অরোমো	Oromo
চেজ্জে পোয়া	orphan
অন্যান্য	other
নুঅইলি	otherwise
দায়িত্ব	ought
আঁরার	our
আঁরার উদ্দেশ্য অইলো যে প্রত্যেকরে প্রত্যেক জাগাত বিভিন্ন ভাষায় পৃথিবীরে বুঝিত ফারিবের এবং নিজোরে প্রকাশ গরিবের ডইল্লে সক্ষম বানানো।	Our mission: to enable everyone, everywhere to understand the world and express themselves across languages.
আঁরার উদ্দেশ্য অইলো যে পৃথিবীর তথ্য এগিনরে এক্কানত গরন এবং এগিনিরে বিয়াগ্গনুর লাই ব্যাবহার গরিবের মতো গরি তৈরি গরন।	Our mission: to organize the world's information and make it universally accessible and useful.
বারে	out
ফল	outcome
ফোশাক আশাক	outfit
বহির্গামী	outgoing
শাখা	outlet
ছক	outline
বাইর	outside
অসাধারণ	outstanding
গরম গরনী	oven
ওভেন	oven
ওভার	over
বেশি	over
ওন্ডে	over there
বিয়াগ্গিন মিলায়	overall
হাডায় ওডা	overcome
অতিরিক্ত চিন্তে হরা	overthinking
বেশি গম লার	overwhelmed
বউত খুশি	overwhelming
দেনা	owe
পেঁচা	owl
নিজুর	own
মালিক	owner
বলদ	ox
গতি	pace
প্যাক গরন	pack
প্যাকেজ	package
দিয়া অই গেইয়্যে	paid
হস্ট	pain
রং গরা	paint
পেন্টিং	painting
জুটি	pair
ফ্যাকাশ্যে	pale
আতোর তালু	palm
কড়াই	pan
মহামারি	pandemic
আতঙ্কিত অই যন	panic
প্যান্ট	pants
হাগজ	paper
বিয়েস্ত	paradise
সমান্তরাল	parallel
পার্সেল	parcel
মাফ গরন	pardon
গার্জিয়েন	parents
পার্ক	park
টিয়া পাখি	parrot
লতা	parsley
ভাগ	part
অংশলন	participate
বিশেষ	particular
বিশেষ গরি	particularly
পার্টনার	partner
পার্টি	party
পাশ	pass
পাস গরি যন	passage
পাশ	passed
প্যাশন	passion
উৎসাহ	passionate
একটিভ ন	passive
পাসওয়ার্ড	password
অতীত	past
রিপু গরন	patch
ফথ	path
করুন	pathetic
ধৈয্য	patience
রোগী	patient
নমুনা	pattern
থামায় দিয়ন	pause
ফুটপাথ	pavement
বিল দিয়ন	pay
টেহা দন	payment
শান্তি	peace
শান্তিমতো	peaceful
পীচ	peach
আঁগা	peak
নাশপতি	pear
ডাইল	peas
অদ্ভুত	peculiar
মুতন	pee
চুলা	peel
লগর মানুষ	peer
বন্ধুবান্ধব এক ফরে	peers
হলম	pen
পেন্সিল	pencil
জুলন্ত	pending
মানুষজন	people
গোলমরিচ	pepper
বুজিত পারন	perceive
বুঝিত ফারন	perception
বউত গম	perfect
ভালাভাবে শেষ গরিত পারা	perform
পারফরম্যান্স	performance
সম্ভবত	perhaps
সময়	period
এস্থায়ী	permanent
অনুমতি	permission
অনুমতি	permit
ধৈয্য	perseverance
অটল	persistent
মানুষ	person
ব্যক্তিগত	personal
গেটাপ	personality
ছিন্তাধারা	perspective
বুঝাই হন	persuade
বিগড়ি গেইয়্যে	pervert
পুষা প্রাণী	pet
ধাপ	phase
ঘটনা	phenomenon
দর্শন	philosophy
পোন	phone
ফটো	photo
বুলি	phrase
শারীরিক	physical
বাছি নেওন	pick
তুলি লন	pick up
ছবি	picture
টুরঅ	piece
টুরো	pieces
শুয়োর	pig
হবুতর	pigeon
জমাগরি রাহন	pile
বালুশ	pillow
ফাইলট	pilot
বিমান চালাই	pilot
পিন	pin
আনারস	pineapple
গোলাপি	pink
গাঁরা	pit
পিচ	pitch
করুণ	pity
জাগা	place
জাগা	places
মহাামারি	plague
সিধে	plain
ফরিকল্পনা	plan
বিমান	plane
গাছ	plant
চারাগাছ	plants
প্লেইট	plate
প্ল্যাটফর্ম	platform
খেলা	play
খেলিজ্জি	playing
চমৎকার	pleasant
দয়া গরি	please
খুশি অন	pleased
আনন্দ	pleasure
বন্ধক	pledge
ওয়াদা	pledge
বৎ	plenty
প্লট	plot
চক্রান্ত	plot
প্লাগ	plug
বরই	plum
প্লাম্বার	plumber
ওগ্গততুন বেশি	plural
পডকাস্ট	podcast
হবিতা	poem
কবিতা	poetry
ফয়েন্ট	point
বিষ	poison
পুলিশ	police
নীতি	policy
নম্র ভদ্র	polite
দূষণ	pollution
পৈর	pond
পুল	pool
পোপ	poop
গরিব	poor
আচমকা	pop
জনপ্রিয়	popular
জনসংখ্যা	population
শুয়োরের মাংস	pork
জাউ	porridge
বন্দর	port
ফজিশন	position
গম	positive
পজিটিভ	positive
মালিকানায় থাহন	possess
দহলে থাহন	possession
অধিকার হাডন	possessive
সম্ভব	possible
পদ	post
বাদ গরি দিয়ন	postpone
আলু	potato
সম্ভাবনা	potential
পাউন্ড	pound
গরিব অবস্থা	poverty
শক্তি	power
ক্ষমতা ওয়ালা	powerful
ব্যবহারিক	practical
চর্চা গরা	practice
প্রশংসা গরন	praise
কৌতুক	prank
দুয়া গরন	pray
দামী	precious
এব্বেরে নির্দিষ্ট	precise
নির্দিস্ট গরি	precisely
আজিরে	predict
বেশি ভালা অয়	prefer
পছন্দ	preference
প্রেগনেন্ট	pregnant
কুসংস্কার	prejudice
উডোন	premises
প্রিমিয়াম	premium
প্রস্তুতি	preparation
তৈরি গরন	prepare
তৈরি গরন	prepared
সর্বনাম	preposition
উপস্থিত তাহন	presence
উপস্থিত তাহা	present
ফেজেন্টেশন	presentation
সংরক্ষণ গরন	preserve
রাষ্ট্রপতি	president
টিপুন	press
চাপ	pressure
অভিনয় গরা	pretend
সুন্দর	pretty
বাধাঁ দওন	prevent
আগর	previous
শিয়ের	prey
দাম	price
গর্ব	pride
পুরোহিত	priest
প্রাইমারি	primary
মেইন	prime
রাজকুমারী	princess
প্রিন্সিপাল	principal
আগে	prior
গুরুত্ব	priority
জেল	prison
গোপনীয়তা	privacy
ব্যক্তিগত	private
সুবিধে	privilege
পুরুস্কার	prize
সম্ভবত	probably
সমস্যা	problem
ফদ্ধতি	procedure
সামনে আগায় যন	proceed
তরিকা	process
বানায়	produce
পণ্য	product
তৈরি গরন	production
পেশা	profession
পেশাদার	professional
প্রোফাইল	profile
লাভ	profit
বেশি	profound
উন্নতি	progress
প্রজেক্ট	project
বিশিষ্ট	prominent
হতা দন	promise
প্রচার গরন	promote
প্রমোশন	promotion
জলদি	prompt
প্রবণ	prone
সর্বনাম	pronouns
ঊচ্চারণ	pronunciation
প্রমাণ	proof
ঠিকটাক	proper
ঠিক হরি	properly
সম্পত্তি	properties
সম্পত্তি	property
ফস্তাব	proposal
সম্ভাবনা	prospect
উন্নয়ন	prosperity
উন্নয়ন	prosperous
রক্ষা গরন	protect
গর্বিত	proud
প্রমাণ গরন	prove
সহায়তা গরন	provide
দিয়্যে	provided
প্রদেশ	province
বিধেন	provision
পোয়া ছ্যারা	puberty
সাধারণ মানুষ	public
টান দিয়ন	pull
কুমরা	pumpkin
সময়মানি চলা	punctual
ছাত্র	pupil
কেনা	purchase
হাঁটি	pure
বেগুনি	purple
উদ্দেশ্য	purpose
পার্স	purse
খুঁজা	pursue
ধ্যান গরা	pursuit
ধাক্কা	push
রাহা	put
যোগ্যতা	qualification
গুণ	quality
ফরিমান	quantity
কুয়ারাইন্টাইন	quarantine
হইজ্জ্যে গরা	quarrel
কোয়াটার	quarter
ক্যাচ্চো	Quechua
রানী	queen
কেন জানি	queer
প্রশ্ন	query
প্রশ্ন	question
লাইন গরি দিওন	queue
জলদি	quick
জলদি	quickly
নিজেব	quiet
ক্যাঁথা	quilt
চলি যন	quit
শান্ত	quite
হাসি তামাশা গরন	quiz
উদ্ধিত	quotation
হতা	quote
হতাগুলা	quotes
খরগোশ	rabbit
রেইস	race
রাগ	rage
বৃষ্টি	rain
উডা	raise
উতিথ	raised
দৌড়ে	ran
এলোমেলো	random
সীমা	range
জলদি	rapid
দ্রুত	rapidly
বিরল	rare
বিরল	rarely
ফুসকুড়ি	rash
অদুর	rat
দর	rate
বরং	rather
অনুপাত	ratio
যুক্তি দিয়ে	rational
কেঁচা	raw
সূত্র	re
পৌঁছা	reach
পৌইচ্চুননা	reached
ফতিক্রিয়া	reaction
পড়া	read
পড়ন	reading
তৈরি	ready
বাস্তব	real
বাস্তবতা	reality
বুজিত ফারন	realize
বুঝিত পারন	realized
আচা	really
ফিছন	rear
হারণ	reason
যুক্তিযুক্ত	reasonable
মনে গরা	recall
রিসিট	receipt
গ্রহণ গরা	receive
গ্রহন	received
এহন	recent
এহন	recently
বর্তমানপ	recently
রিসিপশন	reception
রাঁধনের উপায়	recipe
চুদবুদ নাই	reckless
স্বীকৃতি	recognition
চিনিত পারন	recognize
সুফারিশ গরন	recommend
সুপরিশ গরন	recommended
রেকর্ড গরন	record
রিকভার গরন	recover
অবস্থা ভালা অন	recovery
আয়ত	rectangle
লাল	red
হালাশ	redeem
মুক্তি	redemption
কমাই ফেলা	reduce
অদরহারী	redundant
উল্লেখ গরা	refer
রেফারেন্স	reference
পতিফলন গরা	reflect
ফতিবিম্ব গঠন গরন	reflection
চিন্তাভাবনা গরন	reflection
বন্ধ থাহন	refrain
রেফ্রিজারেটর	refrigerator
ফেরত	refund
ন মানন	refuse
ফত্যাক্কান গরা	refused
বিবেচনা হরা	regard
এই ব্যফারে	regarding
বাছ বিছার ন গরন	regardless
শুভেচ্ছা	regards
এলাহা	region
রেজিস্টার	register
হারাপ লাগা	regret
পতিদিন	regular
নিয়মিত	regularly
বাদ দিয়ন	reject
হয়ুচ	relate
সম্পর্কিত	related
সম্পর্ক	relationship
আত্মীয়	relative
আত্মীয় স্বজন	relatives
আরাম গরন	relax
ছারা পওন	release
ছাড়ি দেয়্যি	released
সম্পর্কিত	relevant
বিশ্বইস্থ	reliable
স্বস্তি	relief
ছাড়া ফওন	relieve
হাফ ছাড়ি বাঁছন	relieved
ধর্ম	religion
ধর্মীয়	religious
ইচ্ছে ন আছে	reluctant
নির্ভর গরা	rely
থাকা	remain
বাইক্কে	remaining
উল্লেখ গরিবার মত	remarkable
মুক্ত	remedy
মনত পড়া	remember
মনোত গরি চন	remind
রিমাইন্ডার	reminder
দুরুর	remote
সরায় ফেলন	remove
মজুরি দি দন	render
ভাড়া	rent
ঠিকগরি ফেলন	repair
আবার হন	repeat
পরিবর্তন গরন	replace
আবার হ	reply
রিফোট	report
উপস্থাপন গরন	represent
বিয়াগ্গুনি চিনে	reputation
অনুরোধ	request
দরহার	require
জরুরি	required
প্রয়োজন	required
উদ্ধার গরন	rescue
গবেষণা	research
অনুরূপ	resemble
ঘৃণা হরা	resentment
জমা গরি রাহা	reservation
সংচিতি	reserve
বাসিন্দা	resident
পদত্যাগ	resign
সহনশীল	resilience
আগর অবস্থাত ফিরি যন	resilient
ওডায় দিয়া	resist
প্রতিরোধ	resistance
সমাধান	resolution
সমাধান	resolve
রিসোর্ট	resort
সংস্থা	resources
সম্ফদ	resources
সম্মান	respect
অক্ষেপ	respond
সাড়া	response
দায়িত্ব	responsibility
দায়ী	responsible
বিশ্রাম	rest
বিস্রাম	rest
আল্লাহ অনরে বেহেশত নসিব গরুক	rest in peace
রেশ্টোরেন্ট	restaurant
ফেরাই লই আনন	restore
আটকাই রাহন	restrict
রেজাল্ট	result
রেজাল্ট	results
বাকি	resume
খুচরা	retail
রাখি দন	retain
ধরি রাক্কি	retention
অবসরপ্রাপ্ত	retired
ফিরি আইয়ুন	retreat
আবার উদ্দার	retrieve
ফেরত দন	return
প্রকাশ	reveal
প্রকাশিত	revealed
প্রতিশোধ	revenge
আয়	revenue
রেভিনিউ	revenue
বিপরীত	reverse
রিভিও	review
শুধরানো	revise
পুনায়র চেক গরন	revision
বিপ্লব	revolution
পুরুস্কার	reward
রিদম	rhythm
শিনের হাড্ডি	rib
চল	rice
ভাত	rice
ধনী	rich
মুক্তি	rid
চড়া	ride
হাইস্যকর	ridiculous
ঠিক	right
এহনই	right now
আলসিয়ে	rigid
আংটি	ring
ফাখলাইয়া ধোয়া	rinse
দাঙ্গা হাঙ্গামা	riot
আরাআইপি	rip
পাকা	ripe
ওঠা	rise
রিক্স	risk
বিপক্ষ	rival
নদী	river
রাস্তা	road
বেজ্জুত	roast
জোর ওয়ালা কন্ঠ	robust
রক	rock
ফাত্তর	rock
লোয়া	rod
ভুমিকা	role
রুল	roll
ছাদ	roof
রুম	room
ইঁউর	root
দড়ি	rope
পোঁছা	rotten
কড়া	rough
মোটামুটি	roughly
গোল	round
হারাপ	route
রুটিন	routine
সারি	row
ঘসা	rub
রবার	rubber
হাচারা	rubbish
দেমাগ বেশি	rude
হম্বল	rug
ধ্বংস	ruin
নিয়ম	rule
নেতা	ruler
নিয়োম	rules
দৌঁড় দ	run
রানিং	running
গেরাইম্যা	rural
তাড়া	rush
বস্তা	sack
পাক থাহন	sacred
বিলায় দিয়ন	sacrifice
নিরাপদ	safe
যওন নিরাপদ অক	safe flight
চয় দিয়ন	safety
বুজুর্গ	sage
হইলো	said
ফাল	sail
সাগরে যাত্রাগরন	sailing
হরচ	sake
মুজুরি	salary
বেচা	sale
সেল মাছ	salmon
লবন	salt
একই	same
একই অবস্থা	Same here
ছেম্ফল	sample
বালু	sand
সস্কৃত	Sanskrit
হাইস্যকর	sarcastic
বেহায়া	sassy
শনি	sat
সন্তুষ্টি	satisfaction
সন্তুুুষ্ট	satisfied
সন্তুষ্ট গরন	satisfy
সন্তুষ্টিজনক	satisfying
শনিবার	Saturday
সসেজ	sausage
অসভ্য	savage
সেইভ	save
দেহা	saw
হন	say
এস্কেল	scale
কেলেঙ্কারি	scam
ক্ষত দাগ	scar
বিরল	scarce
ডরান	scared
ওন্না	scarf
ডরায় ন	scary
ছড়াই ছিটাই	scattered
সিনারি	scene
সিনারি	scenery
গেরান	scent
শিডিউল	schedule
ইস্কুল	school
বিজ্ঞান	science
বিজ্ঞেনি	scientist
বিজ্ঞানী অল	scientists
ক্যাছি	scissors
গাঁইল দিওন	scold
সুযোগ	scope
স্কোর	score
ছুডো হাডো হইজ্যে	scrap
দাগ	scratch
চিক্কার মারা	scream
স্ক্রিন	screen
স্ক্রু	screw
লিপি	script
সাগর	sea
সীল মারা	seal
খুঁজন	search
সিজন	season
সিট	seat
দ্বিতীয়	second
গোপন	secret
অধ্যায়	section
নিরাপদ	secure
সিকুরিটি	security
দেহা	see
দেহা অইবু	see you
ফরে দেহা অইবু	see you later
জলদি আবার দেহা অইবু	see you soon
হালিয়ে দেহা অইবু	see you tomorrow
বিচি	seed
চন	seek
ফার লার	seem
মনে অয়	seems
দেক্কি	seen
আটকাইন্নে	seize
বন্দী	seizure
খুবই হম	seldom
নির্বাচন গরন	select
নিজর	self
নিজি নিজি গম অই যন	self healing
স্বার্থফর	selfish
বেছন	sell
পাঠন	send
আঁরে অনর ছবি পাডন	send me your picture
উরির	senior
সিনিয়র	senior
সেন্স	sense
বুদ্দিমান	sensible
সেন্সিটিভ	sensitive
পাডন	sent
বাক্য	sentence
বাক্যগুলা	sentences
আলাদা	separate
সেপেডি	Sepedi
সেপ্টেম্বর	september
সিরিয়াল	sequence
সিরিজ	series
মারাত্মক	serious
আছাচার	seriously
বারিদন	serve
সেবা	service
সেশন	session
সেট	set
সেটাপ	set up
সেটিং	setting
তাহা শুরু গরন	settle
সাত	seven
সতের	seventeen
সইত্তর	seventy
হয়েক ধরণর	several
বেশি হারাফ	severe
সিলেই হরা	sew
ছানি	shade
ছায়া	shadow
ঝাঁরন	shake
অইবু	shall
ঘোলা	shallow
শরম	shame
আহার	shape
শেয়ার	share
শেয়ার গড়	share
ছুক্কা	sharp
ইতি	she
ইতির আছে	she has
ইতি	she is
ছানি	shed
ভেড়া	sheep
শিট	sheet
তাক	shelf
শেল	shell
তাহিবের জাগা	shelter
রক্ষক	shield
শিফট	shift
চকচক গরে	shine
জও'জ	ship
পাডায় দন	shipping
শাট	shirt
জুতা	shoes
গুলি মারন	shoot
দোয়ান	shop
বাজার ঘরন	shopping
ফার	shore
বাইট্টে	short
হম	shortage
সট	shot
উচিৎ	should
হাঁদ	shoulder
চিক্কের	shout
দেহন	show
আরে দেহা	show me
গোছল	shower
ইছা মাছ	shrimp
চিয়ুন ওয়যন	shrink
বন্ধ	shut
চুপ গর	shut up
শর্মিদে	shy
ভাই বইন	sibling
ভাই বইন	siblings
অসুস্থ	sick
ফক্য	side
দীর্ঘশ্বাস	sigh
চোগোর জুতি	sight
ছাইবার ডইল্যে জায়গা	sightseeing
নমুনা	sign
সাইন গরন	signature
গুরুত্বপূর্ণ	significant
চুপ তাহন	silence
চুপচাপ	silent
রেশম	silk
ছুডু	silly
ফাল্তু	silly
রূয়ো	silver
একই	similar
স্পিম	simp
সোজা	simple
একপুয়ারে	simultaneously
যেত্তেত্তুন	since
দরদ	sincere
অন্তরত্তুন	sincerely
গান গন	sing
গায়ক	singer
সিংগেল	single
ডুবা	sink
সিঙ্ক	sink
স্যার	Sir
বইন	sister
আলি	sister in law
বয়ুন	sit
সাইট	site
অবস্থা	situation
ছয়	six
ষোল	sixteen
ষাইট	sixty
সাইজ	size
দক্ষতা	skill
হাবিলিয়ত	skills
গা	skin
পুয়ানা	skinny
বাদ দন	skip
স্কার্ট	skirt
আকাশ	sky
গোলাম	slave
ঘুমানো	sleep
ঘুমযার	sleeping
ঘুমইন্নে	sleepy
হাতা	sleeve
টুরো	slice
গরাই ফরন	slide
ইক্কিনি গরি	slightly
চিয়োন	slim
আছাড়	slip
ডাল	slope
হালি জাগা	slot
আস্তে	slow
আস্তে আস্তে	slowly
ছোডো	small
ইস্মার্ট	smart
গন্ধ	smell
হাসি	smile
ধুয়ো	smoke
ঝামিলা ছাড়া	smooth
নাস্তা	snack
উক	snail
আফ	snake
হাপ	snake
স্ন্যপ	snap
বরাফ	snow
এতেল্লাই	so
বউদ সুন্দর	so cute
যদদুর পইরযন্ত	so far
চুষি লন	soak
সাবান	soap
শান্ত	sober
ফুটবল খেলা	soccer
সামাজিক	social
সমাজ	society
মোজো	socks
নরম	soft
সপ্টওয়্যার	software
মেডি	soil
বেচা	sold
বেঁচা অই গেইয়ি	sold out
সৈনিক	soldier
মেইন	sole
আসল	solid
সমাধান	solution
সমাধান গরা	solve
কিছু	some
কোন একজন	somebody
যেকোনো ডইল্লে	somehow
যেকেই	someone
কোনোকিছু	something
মাঝেমইদ্ধে	sometimes
গান	song
জলদি	soon
বৎ ভদ্র	sophisticated
সোরানি	Sorani
ঘা	sore
গলাত দুক্কন	sore throat
দুখু	sorrow
দুঃখিত	Sorry
ধরন	sort
চন	sought
ফরান	soul
পরাণের পরাণ	soulmate
আওয়াজ	sound
স্যুুফ	soup
হরো	sour
উৎস	source
দইণ	south
জায়গা	space
স্প্যাম	spam
স্প্যান	span
স্পেনিশ	Spanish
অতিরিক্ত	spare
হতা হন	speak
স্পেশাল	special
কিছিম	species
নির্দিস্ট	specific
সুন্দর	spectacular
বক্তিতা	speech
হতা বন্ধ অয় যন	speechless
স্পিড	speed
বানান	spell
ব্যয় গরা	spend
ব্যয় গরা	spent
ঝাঁল	spicy
চোগা	spike
ঘুরন	spin
শাক	spinach
স্পিরিট	spirit
থুথু	spit
সেরা	splendid
ভাগ গরি ফেলা	split
নস্ট অয়ন	spoil
নষ্ট	spoiled
ভালাভাবে	spontaneous
চামিচ	spoon
জায়গা	spot
বউ	spouse
ছড়ায় পরন	spread
বসন্ত	spring
ছাইর কোনা	square
ছাপ দিওন	squeeze
স্কুইড	squid
ছুলা	squirrel
চুরি মারি দন	stab
থামি তাহন	stable
জমানো	stack
এস্টাফ	staff
মঞ্চ	stage
দাগ	stain
সিরি	stairs
ঝুকি লন	stake
ছই দন	stalk
স্টল	stall
এস্টাম্প	stamp
খাড়াই যন	stand
এসটান্ডার্ট	standard
তারা	star
শুরু	start
শুরু গইজ্জি	started
ক্ষুধার্ত	starving
অবস্থা	state
মত	statement
স্টেটমেন্ট	statement
স্টেশন	station
সালাম	statue
মর্যাদা	status
থাহা	stay
নিরাফদে তাহন	stay safe
আস্তে আস্তে	steady
স্টেক	steak
চুরি	steal
ধোঁয়ো	steam
স্টিল	steel
সোজা	steep
স্টেম	stem
পদক্ষেপ	step
লাগি থাহন	stick
শক্ত অই থাহন	stiff
এহনো পইর্যন্ত	still
হামড়	sting
ফুতা	stingy
থাইয়োজ্জব	stir
স্টক	stock
চুরি	stolen
ফেট	stomach
ফাত্তর	stone
তিয়াই	stood
গু	stool
থামা	stop
স্টেরেজ	storage
দোয়ান	store
ঝর	storm
গল্প	story
চুলো	stove
সোজাসুজি	straight
সোজাসুজি	straightforward
টান	strain
আজব	strange
নো চিনি	stranger
কৌশল	strategy
কের	straw
স্ট্রবেরি	strawberry
লাইন	streak
বই যন	stream
ফ'থ	street
শক্তি	strength
স্ট্রেস	stress
বাড়ায় দিয়ন	stretch
কড়া	strict
হরতাল	strike
রশি	string
ফল ফলা গরি হাডন	strip
চেস্টা গরন	strive
স্ট্রোক	stroke
শক্তিশালী	strong
শক্ত	strong
মাইজ্জি	struck
গঠন	structure
যে পরিমাণ হস্ট হইজ্জি	struggle
হষ্ট গরের	struggling
জেদী	stubborn
আটকি যাওয়া	stuck
ছাত্র	student
লেহাপড়া	study
পড়াত আছে	studying
জিনিস	stuff
সেরা লার	stunning
বোকা	stupid
স্টাইল	style
বিষয়	subject
জমা দিয়ন	submission
জমা দি দন	submit
জিনিস	substance
আরোজ্ঞো	substitute
ছোড ছোড	subtle
সফল	succeed
সফল অওন	success
সফল	successful
যেমন	such
যেন	such as
ছু্ঁই ফেলা	suck
আতিক্কে	sudden
আতিক্কে	suddenly
ভোগা	suffer
ভোগা	suffering
যথেষ্ট	sufficient
ছিনি	sugar
পরামর্শ	suggest
ফরামর্শ	suggestion
হাফে হাফ লাগা	suit
উপযুক্ত	suitable
স্যুটকেস	suitcase
যোগ গরন	sum
সংক্ষেপে হন	summary
গরমহাল	summer
আগা	summit
সুয্য	sun
রইবার	sunday
ফকফকা	sunny
আজইন্যা	sunset
রইদ	sunshine
সেরা	super
উরমিক্কে	superior
কর্মকর্তা	supervisor
রাইতির হানা	supper
দিওন	supply
সাহাইয্যো	support
মনে গরা	suppose
অনুমিত	supposed
নিশ্চিত	sure
শিওর	sure
উ'রে	surface
উৎসাহ	surge
অপারেশন	surgery
ফারিবারিক নাম	surname
অবাক অয় যন	surprise
অবাক হান্ড	surprised
সেরেন্ডার	surrender
চাইরপাশে	surrounding
নজরত রাহে	surveillance
জরিপ	survey
সমীক্ষা	survey
বাঁচি তাহন	survive
সন্দেহ	suspect
সাস্ফেন্ড গরা অইছে	suspended
থামি যন	suspended
সন্দেয়জনক	suspicious
টিকি থাহা	sustain
টিকি তাইবের হমতা	sustainability
টেকসই	sustainable
ছুরা জিনিস	swag
গিলি ফেলা	swallow
অদলবদল	swap
ওয়াদা গরা	swear
গাম	sweat
সেয়েটার	sweater
কুছাই লন	sweep
মিস্টি	sweet
সুন্দর স্বপ্ন	sweet dreams
দুঁদ দাঁত	sweet tooth
ফরানোর আদ্দান	sweetheart
ফুলাই ফেলা	swell
ফোলা	swelling
আছুরন	swim
আঁছুর	swimming
ঘুরি যওন	swing
সুইস	switch
স্ফীত	swollen
তলুয়ার	sword
চিহ্ন	symbol
সহানুভূতি	sympathy
লক্কন	symptoms
ফদ্ধতি	system
টেবিল	table
ট্যাকেল দন	tackle
ট্যাগ	tag
লেজ	tail
লন	take
লই য গুই	take away
চাই চিতি রাহন	take care
উরে উডন	take off
নিয়ন	taken
হতা হন	talk
বাচাল	talkative
লম্বা	tall
চাপ দিয়ন	tap
ফিতে	tape
লইক্ষ্য	target
হাজ	task
ফুয়াদ	taste
ফুইদ্যে	tasty
শিখন	taught
ছা	tea
শিক্ষা দন	teach
মাস্টর	teacher
দল	team
কান্না	tear
চুগোর ফানি	tears
বিরক্ত গরন	tease
ফযুক্তি	technology
দাঁত	teeth
হন	tell
আঁরে হন	tell me
মেজাজ	temper
তাপমাত্রা	temperature
মন্দির	temple
আফাদত	temporary
দশ	ten
দশ হাজার	ten thousand
প্রজা	tenant
চওন	tend
প্রবণতা	tendency
টেন্ডার	tender
ক্রিয়ার কাল	tense
চিনতে	tension
তাঁবু	tent
সম্ভাইব্য	tentative
শব্দ	term
শর্ত	terms
ভয়ংকর	terrible
ভয়ঙ্কর	terrific
এলাহা	territory
ফরিক্ষে	test
টেক্সট	text
চাইতি	than
ধইন্যবাদ	thank
অনেরে ধইন্যবাদ	thank you
অনেরে ধন্যবাদ	thank you
অনরে অনর ধৈর্যর লাই ধইন্যবাদ যেত্তে আঁরা শিপমেন্টের গবেষণালয় ব্যস্ত আছিলাম	Thank you for your patience while we investigate shipment
অনেরে বৎ ধন্যবাদ	thank you so much
অনেরে বৎ ধন্যবাদ	thank you very much
ধন্যবাদ	thanks
ধইন্যবাদ	thanks
আঁরার এ্যাপ ব্যাবার গরিবের লাই ধইন্যবাদ	Thanks for using our app
ওইয়েন	that
ওইয়ান	that is
ইবে ভালা	that's good
ইয়েন	the
চুরি গইরলু	theft
ইতেদের	their
ইতারার	them
থিম	theme
ইতারার	themselves
তারপর	then
তত্ত্ব	theory
ওডে	there
অডে	there are
এড়ে	there is
এতেল্লাই হইজ্জি	therefore
এগুন	these
ইতেরা	they
ইতেরা	they are
চিকন	thick
চুর	thief
রান	thigh
পাতল	thin
জিনিস	thing
জিনিস	things
চিন্তা গরা	think
তৃতীয়	third
পানির তিরেষ লাগা	thirsty
তেরো	thirteen
তিরিশ	thirty
ইয়েন	this
ইয়েন অইলো	this is
গডাগান	thorough
নিখুতভাবে	thoroughly
এগুন বিয়াগ্গুন	those
যদিও	though
ভাবি চন	thought
চিন্তাশীল	thoughtful
চিন্তা ভাবনা	thoughts
হাজার	thousand
সূত্র	thread
হুমকি দিয়ন	threat
হুমকি	threaten
তিন্ন	three
শুরুর জাগা	threshold
রোমাঞ্চিত	thrilled
সফল অন	thrive
গলা	throat
ভিতর দি	through
বিয়াগজায়গাৎ	throughout
ফালায় দে	throw
বুইজ্জা অল	thumb
টাডার	thunder
বিস্যিদবার	Thursday
এন ডইল্লে	thus
তীরচিহ্ন	tick
জোয়ার	tide
গুছাই রাহা	tidy
বাঁধন	tie
বাঘ	tiger
শক্ত গরি বাঁধা	tight
টাইগ্রিনিয়া	Tigrinya
সময়	time
ডরাইল্লা	timid
ছোড	tiny
বখশিশ	tip
টিপস্	tips
ফরামর্শ	tips
চাক্কা	tire
ক্লান্ত	tired
টিসু	tissue
শিরোনাম	title
তে	to
এয়ুত্তুন	to be
টোস্ট	toast
আজিয়ে	today
ল্যাদাফুয়া	toddler
ফার অল	toes
এক লগে	together
লেপ্টিন	toilet
হয়ি	told
সইত পারে	tolerance
শইজ্জু হরন	tolerate
হরো বাইয়ুন	tomato
আগামি হালিয়ে	tomorrow
জিব্বা	tongue
আজিয়্যা রাইত	tonight
ও	too
লয়	took
যন্ত্রফাতি	tool
টুলস	tools
দাঁত	tooth
উ'রে	top
বিসয়	topic
ছিঁড়ি ফেলন	torn
নির্যাতন গরা	torture
মোট	total
ধরন	touch
হঠিন	tough
ট্যুর	tour
দিকে	toward
ইক্কে	towards
তইলে	towel
শঅর	town
প্যাঁচ	toxic
বিষাক্ত	toxic
ট্রেস	trace
লাইনত	track
ব্যবসা	trade
ঐতিহ্য	tradition
ঐতিহ্যবাহী	traditional
ট্রাফিক	traffic
ট্রেইল	trail
ট্রেইন	train
ট্রেনিং	training
ভাবসাব	trait
আকৃতি	traits
বদল	transfer
স্থানান্তর	transition
অনুবাদ গড়ন	translate
ভাঙি দিয়ন	translate
স্বচ্ছ	transparent
যানবাহন	transport
গাড়ি	transportation
ফাদ	trap
ময়লা	trash
মানসিক হষ্ট	trauma
ভ্রমণ	travel
ট্রে	tray
সম্পত্তি	treasure
ব্যবার	treat
চিকিৎসা	treatment
গাছ	tree
অসাধারণ	tremendous
বাড়া	trend
বিছের	trial
ছালাকি	trick
চেষ্টা গইজ্জি	tried
ছেতি যন	trigger
ছাডি ফেলা	trim
বেড়াতো যন	trip
সমইস্যা	trouble
টাউজার	trousers
ট্রাক	truck
আছা	true
ফেটি	trunk
বিশ্বাস	trust
সইত্য	truth
চেস্টা	try
টসংগা	Tsonga
নল	tube
মঙ্গলবার	Tuesday
টিউশন	tuition
তুরস্ক	turkey
হলইদ	turmeric
পালা	turn
হচ্ছপ	turtle
মাস্টর	tutor
বারো	twelve
বিশ	twenty
একুইশ	twenty-one
দ্বি	Twi
দুইবার	twice
মুছর মারা	twist
দুই	two
পহার	type
সাধারণ	typical
আসুন্দর	ugly
ফাইনাল	ultimate
ছাতি	umbrella
অক্ষম	unable
চাচা	uncle
গিয়ান নাই	unconscious
নিচে	under
নিছদি	underneath
দাম হম ফন	underrated
বুজিত পারা	understand
বুঝন যাই	understood
দূর্ভাগ্যজনকভাবে	unfortunately
ইউনিফর্ম	uniform
আলাদা	unique
একক	unit
বিশ্ববিদ্যালয়	university
অজানা	unknown
যদি না	unless
যতক্ষন পইর্যন্ত না	until
স্বাভাবিক ন	unusual
উরে	up
অনর উর	up to you
আপডেট	update
নতুন অইয়ি	upgrade
ওরে	upon
বেজার	upset
শওরের	urban
অনুরোধ	urge
আর্জেন্ট	urgent
জরুরি	urgent
আঁরারে	us
ব্যবহার	use
ব্যবহার অই গেয়্যি	used
দরহারী	useful
অকেজো	useless
সাধারণ	usual
সাধারণত	usually
হার্জহারিতা	utility
ছুটি	vacation
টিগে মারন	vaccination
টিগে	vaccine
হালি জাগা	vacuum
ফরিষ্কার ন	vague
বৈধ	valid
উপত্যকা	valley
দামী	valuable
মূল্য	value
বৈচিত্র্য	variety
নানা	variety
নানা	various
বিভিন্ন	vary
ভিত্তি	vase
বউত বড়	vast
শাকসব্জী	vegetable
শাক সবজি	vegetables
গাড়ি	vehicle
ফেরিওয়ালা	vendor
ভেন্ডর	vendor
বিষ	venom
উদ্যোগ	venture
মাঠ	venue
যাচাই বাছাই	verify
বউদ মিক্কে	versatile
সংস্করণ	version
সুজাসুজি	vertical
বেশি	very
বৎ ভালা	very good
জাঝ	vessel
মাধ্যমে	via
ফরিবেশ	vibe
ফরিবেশ	vibes
দুষ্টুচক্র	vicious
শিয়ের	victim
ভিডিও	video
দিশ্য	view
গেরাম	village
গুন্ড	villain
ভিনেগার	vinegar
মদ	vintage
বরবর	violence
বউদ ঝাড়্গো	violent
জানি গেইয়ি	viral
আবিয়াতা	virgin
ভার্চুয়াল	virtual
ভালা গুণ	virtue
দৃষ্টি	vision
দেখি যন	visit
ভিজুয়াল	visual
চাক্ষুষ	visual
গুরুত্বপূর্ণ	vital
উজ্জ্বল	vivid
ভোকাবুলারি	vocabulary
কণ্ঠ	voice
হালি	void
ভলিউম	volume
হাম্মো	volunteer
বুমি গরন	vomit
করুণ	vulnerable
বেতন	wage
মজুরি	wages
কোমর	waist
অপেক্ষা গর	wait
ওয়েইটার	waiter
থিয়েই তাহন	waiting
উডি গেইয়ি	wake
গুমুত্তুন ওডা	wake up
হাঁটা	walk
আঁডের	walking
দেয়াল	wall
মানি ব্যাগ	wallet
পাইচারি গরন	wander
ছাই	wanna
চন	want
চাইলাম	wanted
যুদ্ধো	war
ওয়্যারড্রোব	wardrobe
গুদোম	warehouse
গরম	warm
সাবধান গরি দন	warn
সতর্কতা	warning
যোদ্দা	warrior
আছিলাম	was
দুয়ান	wash
বর্বাদ	waste
দেহা	watch
পানি	water
তরমুস	watermelon
ডেউ	wave
রাস্তা	way
আঁরা	we
আঁরা	we are
আঁরা পারি	we can
দুর্বল	weak
দুর্বলতা	weakness
সম্পদ	wealth
টিয়া ওয়ালা	wealthy
পরন	wear
গওদ্দন	wearing
আবহাওয়া	weather
মেদি অনুস্টান	wedding
বুধবার	Wednesday
গাঁজা	weed
সপ্তা	week
সপ্তার ছুটির দিন	weekend
ওজন	weight
কেন জানি	weird
স্বাগতম	welcome
কল্যাণ	welfare
ভালা	Well
গম	Well
সাবাশ	well done
গেইলো	went
আছিলাম	were
ফছিম	west
ভিজা	wet
তিমি মাছ	whale
কী	what
অনের ব্যাফার কী	what about you
অনে কিত্তে লাইজ্ঞুন যে	what are you doing
অনে এহন কিত্তে লাইজ্ঞুন যে	what are you doing now
অনে এহন কিত্তে লাইজ্ঞুন যে	what are you doing right now
অনে কি রন যে	what do you do
তোয়ার হাম কি	what do you do for a living
অনে কি বুঝাইতে চন	what do you mean
অনে কি চন	what do you want
কি অইলু	what happened
ইয়েন কি	what is
ইয়েন কি	what is this
অনে কি গরোন	what is your job
তোঁয়ার নাম কি	what is your name
কেন আছো	what's up
অনর নাম কি	what's your name
যাইহোক	whatever
গম	wheat
চাক্কা	wheel
হত্তে	when
যেত্তে	whenever
হডে	where
তুঁই হডে	where are you
অনে হডেত্তুন আইসসুন যে	where are you from
অঁনে এহন হন্ডে	where are you now
অনে হডে তাহন যে	where do you live
হন্ডে	where is
যেডে	whereas
নুঅইলি	whether
হন্নান	which
যহন	while
হানে হানে হয় দিওন	whisper
বাঁশি	whistle
সাদা	white
হন	who
অনে হন	who are you
ইবে হন	who is
ইবে হন	who is this
পুরা	whole
হারে	whom
হার	whose
কিল্লাই	why
কেনে ন	why not
জারগো	wicked
মোডা	wide
বিধবা	widow
ফাতাইয্যা	width
বউ	wife
জঙ্গলি	wild
ইচ্ছে	will
ইচ্ছা	will
ইচ্ছা আছে	willing
জিতন	win
বাতাস	wind
জানালা	window
ঝড়ো বাতাস	windy
মদ	wine
শীত	winter
মুছা	wipe
তার	wire
জ্ঞান	wisdom
গিয়ানী	wise
ইচ্ছে	wish
অনর লাই শুভ হামনা রইলো	wish you all the best
ডাইনী	witch
পঁরে	with
তুলি ফেলা	withdraw
উডোন	withdrawal
তারমদ্ধে	within
ছাড়া	without
সাক্ষী	witness
মজার	witty
ছিতে	wolf
বেডি	woman
বেডি মানুষ	women
জিতি গেয়্যে	won
অইতুনু	won't
আইশচাইর্য হতা	wonder
চমৎকার	wonderful
বেশি সেরা	wonderful
তক্তা	wood
উল	wool
শব্দ	word
শব্দগুলা	words
হাজ হর্ম	work
হাজঅই জন	work out
হাজ গরন	working
গোটা দুনিয়ে	world
দুনিয়া	world
কিরমে	worm
জীর্ণ	worn
ছিরা	worn
চিন্তিত অওন	worried
চিন্তে	worry
হারাফ	worse
দুয়া	worship
বেশি হারাফ	worst
মূল্য	worth
পোষায়	worth it
যোগ্য	worthy
পাইরতাম	would
হতো	wound
অউ	Wow
ফ্যাঁছাই রাহন	wrap
ক্রোধ	wrath
কব্জি	wrist
লেহা	write
এডে লেহ	Write here
লেহা	writing
লিখিত	written
ভুল	wrong
লেখিলো	wrote
ইয়াড	yard
অয়ো	yawn
হ	Yeah
বচর	year
বছর	years
ঈস্ট	yeast
চিক্কের গরন	yell
হলদ্দে	yellow
হ্যাঁ	Yes
আচ্ছা সোনা	yes baby
ওয় প্রিয়	yes dear
আইচ্ছে সোনা	yes honey
আইচ্ছে সোনা	yes my love
আইচ্চে টিক আছে	yes of course
গতহাইল	yesterday
তবুও	yet
নত অন	yield
ফলন	yield
অনে	you
অঁনে	you are
তঁই বউত সুন্দর	you are beautiful
অনে বউত সুন্দর	you are so beautiful
তোঁয়ারে স্বাগতম	you are welcome
অনে ফারোন	you can
অনে জানন	You know
অনেও	you too
অনেরে স্বাগতম	you're welcome
জোয়ান	young
তোঁয়ার	your
অনেরে স্বাগতম	your welcome
আরে	yourself
পোয়া চ্যারা	youth
ওনেরে স্বাগতম	you’re welcome
মজার	yummy
শইন্যু	zero
