ɖo aba	laid
anᴐ abe	approximately
wᴐ abe	pretend
dze abe	seems
xɔ abi	hurt
xɔ abi	injured
ŋutete	ability
ɖe abla	hurry
ablotsi	abroad
aƒetsitsi	absence
blibo	absolutely
no	absorb
totoɖeme	abstract
gbetete	accent
mᴐnu	access
afɔku	accident
nᴐƒe	accommodation
akᴐnta	account
ɖoɖonunɔnɔ	accuracy
de	accurate
sedzidala	accused
vevesese	ache
dzidzedzekpɔkpɔ	achievement
ƒle	acquire
xɔ	acquired
nuwɔwɔ	action
nuwɔnawo	activities
nuwɔna	activity
fefewɔla	actor
wɔ adã	fierce
trɔ	adapt
kpekpeɖeŋu	addition
adrɛs	address
da ade	hunt
nyaɖɔnya	adjective
xᴐ	admit
xɔ	adopt
ŋusẽkpᴐkpᴐ	advantage
numetoto	adventure
dɔwɔnyaɖɔnya	adverb
boblododo	advertisement
aɖaŋu	advice
nyaxɔɖeakɔla	advocate
ɖe adzɔgbe	pledge
ɖo aɖaŋu	advise
wɔa aɖaŋu	creative
ɖo aɖaŋu	recommend
dze aɖaʋa ɖe eme	obsessed
dze aɖaʋa	mad
le aɖe asi	keep
ele aɖe	delicious
ʋɛ aɖe	fewer
ame aɖeke o	nobody
ame aɖe	somebody
ame aɖe	someone
le aɖe	spicy
le aɖe	tasty
nye aɖi	toxic
tugbedzedze	aesthetic
nya	affair
lɔlɔ̃ɖeɖefia	affection
va afi	come here
èle afi ma	are you there
le afima	over there
Mele afi sia	I'm here
ɖo afɔ afɔta	warn
fia afɔɖoƒe	guide
do afɔ	follow up
tu afɔ	kick
vɔvɔm	afraid
emegbe	after
ŋdᴐ	afternoon
emegbe	afterwards
tsi aƒe	absent
ake	again
ɖe agba	discharge
dze agbagba	endeavor
dze agbagba	tried
dze agbagba	try
dze agbagba	venture
de agba	load
le agbe	alive
dɔ agbe	good night
dɔ agbe	goodnight
nɔ agbe	live
le agbe	lives
tsi agbe	survive
le agbe tim	thrive
do agbogbo	abundance
le agbɔsɔsɔ me	bulk
ƒe	age
alɔdze	agency
dɔla	agent
do age	score
zã	agile
dze aglã	arrogant
dze aglã	rude
dze aglã	stubborn
dze agᴐ	guilty
medze agᴐ	I'm sorry
nublabla	agreement
agbledede	agriculture
mu aha	drunk
da ahe	poor
wɔ ahiã	flirt
kpeɖeŋu	aid
taɖodzi	aim
ya	air
yameʋudzeƒe	airport
gawɔe ake	repeat
kpɔ aklama	lucky
le akogo	lonely
bu akɔnta	evaluate
de akpa ɖeka dzi	biased
le akpe dam	grateful
ƒe alafa ɖeka	century
le alakpa dam	lying
gbeɖiɖi	alarm
ahasesẽ	alcohol
ŋute	alert
zi ale si	as long as
ʋee	a little
katã	all
enyo	all right
kloẽ	almost
akogo	alone
geɖe	a lot
geɖe	a lot of
dɔ alɔ̃	asleep
le alɔ̃dɔm	sleeping
dᴐ alɔ̃	sleep
Enyo	Alright
hã	also
nye	am
didi	ambition
ba ame	cheat
kpɔ ame dzi	depend
xᴐ ame dzi se	loyal
abe ame ɖeka	particularly
wo ame eve la	both
ɖia ame nu	offensive
ɖia ame nu	tease
bua ame	polite
bu ame	respect
dze ame	seem
si ame sia ame xɔ	mutual
ɖia ame	stalk
wodome	amid
da ami	fat
nye amlima	mysterious
miadome	among us
home	amount
numedzodzro	analysis
tɔgbeawo	ancestors
seke	anchor
xoxo	ancient
kple	and
mawudɔla	angel
dziku	anger
gɔglɔƒe	angle
dze ani	decent
lã	animal
afɔkpodzui	ankle
dzigbezã	anniversary
gbeƒãɖeɖe	announcement
kuadzi	annoying
bubu	another
ŋuɖoɖo	answer
toa anukuarɛ	faithful
dzitsitsi	anxiety
aɖe	any
nɔ anyi	abide
manᴐ anyi adidi o	temporary
dze anyi	collapse
yi anyi	decline
yi anyi	decrease
nᴐ anyi didi	last
ɖoe anyi	establish
ɖoe anyi	established
dze anyi	fail
dze anyi	failed
dze anyi	fall
dze anyi	fell
ɖoe anyi	install
ɖoe anyi	launch
ɖoe anyi	lay
mlɔ anyi legbe	prone
tsi anyi	outstanding
tsi anyi	remain
nɔ anyi	sat
dze anyi	settle
ɖo anyi	set up
nɔ anyi	sit
nᴐ anyi	stay
xɔhaya	apartment
kukuɖeɖe	appeal
dze	appear
dzedzeme	appearance
dze	appeared
nudzroame	appetite
apel	apple
mᴐbibia	application
gbeɖoɖi	appointment
ŋudzedzekpɔkpɔ	appreciation
afɔfie	april
xɔtala	architect
xɔtata	architecture
nudzraɖoƒe	archive
enye	are
teƒe	area
èle	are you
nyahehe	argument
tso	arise
abɔ	arm
aʋakɔ	army
ɖo	arrange
ɖoɖo	arrangement
ɖoɖo	arrival
ɖo	arrived
aŋtrɔe	arrow
nutata	art
nu	article
nutala	artist
abe	as
dzofi	ash
kpla asi akᴐ	embrace
kplᴐ asi akᴐ	hug
ɖe asi	allowed
ƒo asi	bargain
da asi ɖe edzi	approve
da asi ɖe edzi	approved
xᴐ asi	expensive
ɖe asi	give up
ɖe asi le dɔ ŋuti	resign
ɖe asi le eŋu	allow
ɖe asi le eŋu	dismiss
ɖe asi le eŋu	ignore
ɖe asi le	release
ƒo asi	negotiate
le asinye	I have
mexᴐ asi o	cheap
xɔ asi	prime
ka asi	touch
xɔ asi	worth
bia	ask
bia	asked
akpa	aspect
Assamese	Assamese
ƒo	assault
ƒuƒoƒo	assembly
dodokpᴐ	assessment
nunɔamese	asset
nunɔamesiwo	assets
dᴐdeasi	assignment
kpeɖeŋu	assist
kpeɖeŋutɔ	assistant
habɔbɔ	association
bui	assume
hã	as well
le	at
ka atam	swear
ɖu	ate
si ate ŋu adzɔ	likely
si ate ŋu anɔ anyi	sustainable
duƒula	athlete
kpeɖeŋu	attached
de	attend
teƒedede	attendance
ŋuɖoɖo	attention
nɔnɔme	attitude
he	attract
nuhehe	attraction
ŋutinu	attribute
nuselawo	audience
dasiamime	august
tasi	aunt
tasi	aunty
atsiatsia	authentic
nuŋlɔla	author
ŋusẽ	authority
nuŋeɣi	autumn
eli	available
fa avi	cry
dze avu	attack
wᴐ avu	fight
le avu	resolve
le avu wɔm	hostile
wɔ aʋa	fought
nyɔ	awake
nunana	award
nya	aware
nyanya	awareness
na	away
ɖo awu	get dressed
de axa	adjacent
de axa	avoid
le aye me	subtle
dze ayɛ	cunning
Aymara	Aymara
ɖu azã	celebrate
nu babla	package
vidzĩ	baby
tre	bachelor
megbe	back
gbegblẽ	bad
kotoku	bag
ƒunulã	bait
me	bake
abolomeƒe	bakery
na	baking soda
bɔl	ball
Bambara	Bambara
de ba mo	disguise
akɔɖu	banana
hadziha	band
gadzraɖoƒe	bank
ahanoƒe	bar
wò	bark
na	barley
mɔxexe	barrier
teƒe	base
gɔmedzenu	basic
na	basil
gbɔmeya	bastard
hatsotso	batch
tsileƒe	bathroom
batri	battery
aʋa	battle
na	bay
enye	be
ƒuta	beach
togbɔ be	although
xɔgbãti	beam
ayi	beans
sisiblisi	bear
ge	beard
vevienyenye	bearing
gbemelã	beast
ƒo	beat
tugbedzedze	beauty
elabena	because
wᴐe be	cause
zu	become
aba	bed
xɔgãme	bedroom
anyi	bee
nyilã	beef
nye	been
biya	beer
togbɔ be	even though
ŋlᴐe be	forget
ŋlɔ be	forgot
gɔmedzedze	beginning
tsɔe be	granted
nuwᴐna	behavior
nuwɔna	behaviour
emegbe	behind
nenye be	if
mebui be	I think
dzixɔse	belief
ƒodo	belly
lɔlɔ̃tɔ	beloved
été	below
alidziblaka	belt
medi be makpɔ wò	I want to see you
enyo be míedo go	nice to meet you
dze be	must
zikpuilegbe	bench
bɔ	bend
viɖe	benefit
viɖe	benefits
Akpe be nègbɔ dzi ɖi na mí le esime míenɔ nugɔmekuku la wɔm	Thank you for your patience while we investigate shipment
Akpe be nèzã app sia	Thanks for using our app
si be	obscure
dze be	ought
kpɔe be	realize
nyuietᴐ	best
bui be	suppose
bui be	supposed
bui be	thought
titina	between
nunono	beverage
di be	wanna
Bhojpuri	Bhojpuri
le biabiam	demanding
gasɔ̃	bicycle
asidodo	bid
lolo	big
gasɔ̃	bike
febugbalẽ	bill
bla	bind
xe	bird
dzigbe	birthday
ɖu	bit
ɖu	bite
yibᴐ	black
nulãnu	blade
avɔtsɔtsɔ	blanket
le blanui	gloomy
le blanui	moody
gbã	blast
tsaka	blend
yra	bless
de blibo	comprehensive
de blibo	perfect
dzidzeme	bliss
ʋu	blood
kᴐ	blow
bluᴐ	blue
tɔdziʋu	boat
le boblodom	advertising
ŋutilã	body
fie	boil
kalẽtᴐe	bold
kpe	bond
ƒu	bone
agbalẽ	book
afɔkpa	boot
afɔkpawo	boots
liƒo	border
amegã	boss
atukpa	bottle
gᴐme	bottom
ƒle	bought
dzodzo	bounce
bla	bound
liƒowo	boundaries
bᴐbᴐ	bow
agba	bowl
aɖaka	box
ŋutsuvi	boy
nu bɔbɔ	common
nu bɔbɔe	cushion
si bɔbɔ	flexible
alɔnuga	bracelet
hɔhɔ̃	brain
alɔdze	branch
kalẽ	brave
abolo	bread
gbã	break
no	breast
gbɔgbɔ	breath
nyi	breed
kpe	brick
ŋgbɛtɔ	bride
agbasasã	bridge
kpuie	brief
klẽ	bright
keketa	broad
nyakaka	broadcast
ɖoko	broke
gbã	broken
xa	broom
nyo	brother in law
kɔdzẽ	brown
aɖuklɔnu	brush
nu bubu	alternative
kple bubuwo	etc
nu bubuwo	miscellaneous
tɔkpɔ	bucket
xɔ̃	buddy
gaɖaŋu	budget
nugbagbevi	bug
mɔkpɔkpɔ bu	hopeless
tu	build
xɔ	building
tu	built
nyitsu	bull
ŋutasẽla	bully
kpo	bump
kpo	bunch
babla	bundle
agba	burden
ɖi	buried
wo	burst
ɖi	bury
ʋugã	bus
gbeme	bush
dᴐwᴐna	business
akᴐta	bust
gake	but
bᴐta	butter
akpakpaluʋui	butterfly
awunugbui	button
ƒle	buy
na	cabbage
nudzraɖoƒe	cabinet
xadza	cage
akpɔnɔ	cake
nyivi	calf
yᴐ	call
yᴐ	called
yɔm	call me
va	came
gbeƒaɖeɖe	campaign
kansa	cancer
ŋutete	capacity
toxɔdu	capital
tanya	caption
le	capture
ʋu	car
dᴐwᴐna	career
ɖematsɔleme	careless
atikpala	carpenter
anyigbãvɔ	carpet
karɔt	carrot
tsᴐ	carry
wɔe	carry out
goe	case
ga	cash
da	cast
mɔ	castle
dadi	cat
lé	catch
hatsotso	category
nyiwo	cattle
lé	caught
ŋkumekaka	caution
agado	cave
tɔte	cease
agbakɛ	ceiling
gaxɔ	cell
titina	center
blinu	cereal
azãnuwɔna	ceremony
godoo	certainly
ɖasɛɖigbalẽ	certificate
kɔsɔkɔsɔ	chain
zikpui	chair
aklama	chance
trɔ	change
ʋunyaʋunya	chaos
nᴐnᴐme	character
nɔnɔmewo	characteristics
febubu	charge
dɔmenyo	charity
agbalẽgbadza	chart
amebaba	cheating
alɔgo	cheek
dzidzᴐkpᴐkpᴐ	cheers
notsibabla	cheese
kpɔdzidzɔ	cherish
na	chess
akᴐta	chest
ɖu	chew
koklo	chicken
fia	chief
ɖevi	child
ɖevinyenye	childhood
ɖeviwo	children
dzudzɔti	chimneys
glã	chin
tsokolɛti	chocolate
tiatia	choice
tia	choose
lã	chop
aƒemedɔ	chores
sɔleme	church
na	cinnamon
nᴐnᴐme	circumstances
dumevi	citizen
dugã	city
xɔ	claim
nusrɔ̃ƒe	class
anyi	clay
dzadzɛ	clean
klaki	clerk
asisi	client
kplekɔkɔ	cliff
na	climate
gaƒoɖokui	clock
tu	close
bebeƒe	closet
avɔ	cloth
nudodowo	clothes
lilikpo	cloud
fefewɔla	clown
dzesi	clue
ƒuƒoƒo	cluster
hehenala	coach
aka	coal
ƒuta	coast
dziwui	coat
kɔfi	coffee
nudzɔɖenunu	coincidence
fa	cold
kɔla	collar
hati	colleague
hatiwo	colleagues
lɔ	collect
nuƒoƒu	collection
kɔledzi	college
amadede	color
amadede	colour
akpa	column
ayiɖa	comb
nuƒoƒu	combination
ƒoƒu	combine
va	come
tso	come on
dzidzeme	comfort
dzidzeme	comfortable
gbɔna	coming
gbeɖeɖe	command
nutsotso	comment
nuʋuʋu	commission
ɖokuitsᴐtsᴐna	commitment
nudzadzra	commodity
nyatakaka	communication
hatsotso	community
kpeɖeŋutɔ	companion
hã	company
nusɔnu	comparison
dɔmenyo	compassion
nublanukpɔkpɔ	compassionate
ʋliho	compete
hoʋiʋli	competition
nyatoto	complain
nyatoto	complaint
kafukafu	complement
blibo	completely
sedziwᴐwᴐ	compliance
kafukafu	compliment
nuƒoƒu	composition
xɔxɔnu	compound
nugɔmesese	comprehension
kɔmpuita	computer
nunya	concept
dzitsitsi	concern
fefe	concert
nyanuwuwuw	conclusion
kɔkreti	concrete
nᴐnᴐme	condition
nɔnɔme	conditions
agbenᴐnᴐ	conduct
takpekpe	conference
kakaɖedzi	confidence
dzre	conflict
tᴐtᴐ	confused
tɔtɔ	confusion
dɔnɔɔ	congrats
dɔnɔɔ	congratulation
dɔnɔɔ	congratulations
nyatsyãnya	conjunction
doka	connect
ŋutenɔnɔ	consciousness
mᴐɖeɖe	consent
tɔtrɔgbela	conservative
edziedzi	constantly
miléle	constipation
xɔtutu	construction
ɖu	consume
kadodo	contact
vlododo	contempt
hoʋiʋli	contest
anyigbãga	continent
nubabla	contract
wɔƒe	contribution
dziɖuɖu	control
dzidzeme	convenience
dzeɖoɖo	conversation
nuɖaɖa	cooking
fa	cool
alɔdodo	cooperation
gadzẽ	copper
tometi	core
bli	corn
dzogoe	corner
de	correct
asixᴐxᴐ	cost
awu	costume
agblexɔ	cottage
ɖetsifu	cotton
kpe	cough
dudzikpɔha	council
xlẽ	count
nudaɖoƒe	counter
dukᴐ	country
kɔƒe	countryside
srɔ̃tɔwo	couple
dzideƒo	courage
mᴐ	course
ʋᴐnu	court
bubudeame	courtesy
nɔvi	cousin
akpa	cover
nyi	cow
vɔvɔnɔtɔ	coward
dzidzeme	cozy
agalã	crab
gbagbãƒe	crack
asinudɔ	craft
gbã	crash
te	crawl
wᴐ	create
gadodo	credit
dɔwɔha	crew
nuvɔ	crime
kuxigã	crisis
afɔɖeɖe	criteria
nyahehe	criticism
nuku	crop
nukuwo	crops
atitsoga	cross
akpavia	crow
ameha	crowd
fiakuku	crown
tsidzizɔzɔ̃	cruise
gbã	crush
na	cucumber
mimi	cuddle
dekᴐnu	culture
kplu	cup
agbalẽɖaka	cupboard
numekpɔkpɔ	curiosity
gɔdɔ	curly
ga	currency
fifia	current
fifi	currently
fiƒode	curse
xɔmetsovɔ	curtain
dekᴐnu	custom
asisi	customer
dekɔnuwo	customs
lã	cut
kpokploe	cute
gasɔ̃dodo	cycling
Melɔ̃ daanye	I love my big sister
papa	dad
asi dada ɖe nu dzi	approval
nu dada	hiring
papa	daddy
nyinotsi	dairy
dam	dam
nugbegblẽ	damage
ŋɔdzi	danger
dziŋᴐ	dangerous
Melɔ̃ danye	I love my mother
nyrɔ	dark
lᴐlɔ̃tᴐ	darling
fli	dash
na	data
ŋkeke	date
ŋkeke	day
ku	dead
si de	adequate
tokunɔ	deaf
nuɖoɖo	deal
lɔlɔ̃tɔ	dear
lɔlɔ̃tɔwo	Dear All
ku	death
nyahehe	debate
nugbegblẽ	debit
gbeɖuɖɔ	debris
fe	debt
nyinyɔ	decay
ble	deceive
dzome	december
ɖoe	decided
nyametsotso	decision
sãdzi	deck
tsɔtsɔdesi	dedication
le dedie	intact
mele dedie o	insecure
le dedie	safe
yameʋuɖoɖo dedie	safe flight
le dedie	secure
nɔ dedie	stay safe
tsɔ de dɔwɔwɔ me	implement
nuwɔwɔ	deed
mexɔe de eme	noted
goglo	deep
sẽ	deer
gᴐmedzeƒe	default
anyidzedze	defeat
kokooko	definitely
gɔmeɖeɖe	definition
ɖe de go	expose
ɖoƒe	degree
si de ha kple	associated
dzidzɔnu	delight
woɖee	delivered
vidzidzi	delivery
bia	demand
ablɔɖegbadza	democracy
gbɔgbɔvɔ̃	demon
toto	density
si de ŋgɔ wu	superior
dzodzo	departure
teteɖeanyi	depression
goglome	depth
ɖᴐ	describe
nuɖᴐɖᴐ	description
dzogbe	desert
aɖaŋudɔ	design
dzesidede	designation
dzimedidi	desire
kplᴐ	desk
dziɖeameƒo	despair
togbɔ	despite
numeɖenu	dessert
deƒe	destination
dzɔgbe	destiny
gblẽ	destroy
nugbegblẽ	destruction
emenuwo	detail
emenuwo	details
kutrikuku	determination
aɖoe	determine
ŋgᴐyiyi	development
mᴐ	device
abosaŋu	devil
Dhivehi	Dhivehi
suklidɔ	diabetes
dɔmetɔtrɔ	diarrhea
nuleɖigbalẽ	diary
nyadigbalẽ	dictionary
wᴐe	did
dome didi	apart
ɣeyiɣi didime	duration
le didim	keen
anyinɔnɔ didi	sustainability
ku	die
ku	died
vovototo	difference
sesẽ	difficult
bubu	dignity
tẽe	direct
mɔfiame	direction
dɔdzikpɔla	director
ɖi	dirt
bu	disappear
dzɔgbevɔ̃e	disaster
hehe	discipline
ɖedzi	discount
azitiazime	discrimination
numedzodzro	discussion
dᴐléle	disease
dɔlélewo	diseases
nyɔŋu	disgusting
nuɖuɖu	dish
nuɖaɖawo	dishes
dɔ	dispatch
nyahehe	dispute
didiƒe	distance
nuteɖeamedzi	distress
nuto	district
ʋe	ditch
vovovowo	diverse
vovototo	diversity
ma	divide
srɔgbegbe	divorce
wo di	wanted
Mele diwòm	I want you
wɔ	do
ŋɔ do	bore
ɖɔkta	doctor
agbalẽ	document
ku do	dig
ŋɔ do	drill
wᴐa	does
mewɔ	doesn't
avu	dog
Dogri	Dogri
esi do le emm	exception
si do le kpome	surprise
atividzĩ	doll
dziɖuƒe	domain
wo dome	among
ve dome	average
wo dome	within
tedzi	donkey
si do ŋgᴐ	previous
do do	out
movitɔ	dope
ɖikeke	doubt
amɔ	dough
anyi	down
elɔ̃a	do you
de dɔ asi	assign
de dɔ asi	deploy
de dɔ asi na	engage
nya dɔ	competent
yɔ dɔ	cure
Míaƒe dɔdeasi: míade xexeame nyadzɔdzɔwo ɖoɖo me aha wɔe be woanɔ alɔdzi ahaɖevi na ame sia ame si le xexeame.	Our mission: to organize the world's information and make it universally accessible and useful.
Míaƒe dɔdeasi: míana be ame sia ame, le afi sia afi nase xexeame gɔme eye woaƒonu be gbe bubu dolawo hã nase.	Our mission: to enable everyone, everywhere to understand the world and express themselves across languages.
wɔa dɔ	effective
yɔ dɔ	heal
le dɔ lém	sick
do dɔmedzui	rage
nyo dɔme	kind
nye dɔnuitɔ	stingy
to dɔ	snap
le dɔwɔm	active
le dɔ wɔm	busy
le dɔ wɔm	occupied
le dɔwɔm	working
wᴐ dᴐ ɖe edzi	affect
wᴐ dᴐ ɖe nu dzi	impact
wᴐ dᴐ ɖe nu dzi	influence
wᴐ dᴐ	function
le dᴐ lém	ill
wᴐ dᴐ nyuie	efficient
ƒe dᴐwᴐna	effect
he	drag
no	drain
fefe	drama
drɔ̃	drawer
nutata	drawing
drɔ̃e	dream
awu	dress
no	drink
ku droẽ viviwo	sweet dreams
ge	drop
kuɖiɖi	drought
ŋɔdzi drɔẽ	nightmare
ƒu	dry
kpakpaxe	duck
ame	dude
le du dzi	running
le du ƒum	jogging
syiɔ̃	dull
ƒu du	ran
ƒu du	run
si du	rush
ʋuʋudedi	dust
dᴐdeasi	duty
nɔ	dwell
le dzadzɛ	tidy
nu dzadzraɖo	maintenance
mo dzaka	bored
si dze	appropriate
ɖo dze	chat
si dze nyuie	ideal
esi dze ŋgᴐ	opposite
si dze	remarkable
de dzesi	acknowledge
de dzesi	detect
de dzesi	identify
kpɔ dzesi	noticed
de dzesi	realized
de dzesi	recognize
asinu dzesi	signature
dɔléle dzesi	symptoms
de dzesi	tick
si dzeti	rigid
ɖo dze	toast
dzᴐa dzi	admire
tsi dzi	anxious
wo dzi	born
lia dzi	climb
ɖu dzi	conquer
tsi dzi	desperate
kpɔ dzidzedze	succeed
kpɔ dzidzɔ	cheer
kpɔ dzidzɔ	delighted
kple dzidzɔ	enthusiastic
kpɔ dzidzɔ	excited
kpɔ dzidzɔ	have fun
le dzidzɔ kpɔm	cheerful
nye dzidzɔ	my pleasure
kpɔ dzidzɔ nyuie	enjoy
do dzidzɔ	thrilled
doa dzidzᴐ	exciting
de dzi ƒo	foster
de dziƒo	inspire
de dzi ƒo na	encourage
le dzigbɔɖi me	carefully
do dzi	hold on
kpᴐ dziku	angry
doa dziku	annoy
kpɔ dziku	annoyed
kpɔ dziku	furious
kpɔ dziku	upset
ata dzi	lap
kᴐe dzi	lift
trɔ dzime	convert
ɖu dzi	overcome
yi dzi	rise
yi dzi	surge
ɖu dzi	win
si dzi woɖo asi	suspended
si dzi womaxᴐ ase o	incredible
si dzi womeɖo kpee o	tentative
ɖu dzi	won
tsi dzi	worried
si dzi wotᴐ asi	specific
bi dzo	burn
klẽ dzo	glow
xᴐ dzo	hot
de dzo le eme	disable
xɔ dzo	warm
medi dzɔgbenyuie na wò	wish you all the best
si dzɔna ɖa	constant
si dzɔna	usual
xɔ dzudzɔ	retired
hee ɖa anyi	download
ɖe ɖa	delete
susu ɖaɖɛ	genius
ɖee ɖa	eliminate
ɖoe ɖa	export
doe ɖa	introduce
doe ɖa	recommended
ɖo ɖa	refer
ɖe ɖa	rid
agbaɖoɖo ɖa	shipping
doe ɖa	suggest
ɖee ɖa	withdraw
ku ɖe	about
Ŋlɔe ɖe afi sia	Write here
ɖe ɖe aga	exclusive
ɖe ɖe aga	isolated
ɖeɖe ɖe aga	quarantine
vevesese ɖe amebubu teƒe	empathy
kpe ɖe ame ŋu	helpful
de ɖe anyi	depressed
te ɖe anyi	press
da ɖe anyi	underrated
te ɖe	approach
lé ɖe asi	held
hekpe ɖe	as well as
ku ɖe	based
kᴐe ɖe dzi	raise
kɔ ɖe dzi	raised
nu ɖeɖe ɖe go	exhibition
te ɖeɖi	exhaust
te ɖeɖi	tire
ke ɖee	by the way
lɔ̃ ɖe edzi	accept
lɔ̃ ɖe edzi	agree
ka ɖe edzi	certain
sɔ ɖe edzi	compatible
ka ɖe edzi	confident
tsi ɖe edzi	developed
dzi ɖe edzi	increase
sɔgbɔ ɖe edzi	increased
woaka ɖe edzi	reliable
ka ɖe edzi	sure
ka ɖe edzi	trust
te ɖe egbɔ	reach
google ɖe egɔme	Google Translate
ŋe ɖe eme	cringe
ge ɖe eme	join
no ɖe eme	shrink
ƒoe ɖe enu	convince
ƒoe ɖe enu	convinced
kpee ɖe eŋu	add
le ɖe eŋu	attach
ke ɖe eŋu	find out
kpe ɖe eŋu	further
dae ɖe gbebugbe	postpone
ɖe ɖe go	exhibit
ɖe ɖe go	exposed
ɖeɖe ɖe go	exposure
yina ɖe	going to
ɖe ɖe go	reveal
do ɖe gota	hang out
wɔ ɖeka	associate
akpa ɖeka dzidede	bias
ame ɖeka ƒe nu	personal
dze ɖeka	handsome
ame ɖeka	individual
gbegbɔgblɔ ɖeka mede gbɛɖɛ o	one language is never enough
zi ɖeka	once
mɔ ɖeka toto	consistency
nu ɖeka	unit
ɖoɖo ɖe kɔkɔme nu	hierarchy
ɖe ɖe le eme	compromise
tsᴐ ɖe le eme	concerned
hehe ɖe megbe	delay
he ɖe megbe	delayed
he ɖe megbe	hesitate
gbetete ɖe nu dzi	emphasis
lele ɖe nu ŋu	attachment
lena ɖe nu ŋuti	clingy
ku ɖe nu ŋuti	hang
he ɖe ŋgɔ	extend
do ɖe ŋgɔ	promote
do ɖe ŋgɔ	upgrade
do ɖe ŋgᴐ	enhance
doe ɖe ŋgᴐ	update
le ɖe te	sustain
nye ɖevi	young
egᴐme ɖe	what do you mean
te ɖe wo nɔawo ŋu	intimate
ŋkɔwò ɖɛ	what is your name
ŋkɔwò ɖɛ	what's your name
gble ɖi	abandon
dae ɖi	deposit
ƒo ɖi	dirty
do ɖi	dive
dae ɖi	dropped
kᴐe ɖi	dump
gblɔe ɖi	forecast
nu ɖi gbɔlo	vacuum
yi ɖi me	faint
yi ɖime	unconscious
gblẽ ɖi	neglect
le ɖi	preserve
da ɖi	put
gbɔdzi ɖi	relax
le ɖi	retain
va ɖo	arrive
nu ɖoɖo	deliberate
nuɖuɖu ɖoɖo	diet
zi ɖoɖoe	mute
zi ɖoɖoe	quiet
zi ɖoɖoe	shut up
zi ɖoɖoe	silent
nu ɖoɖo	intention
nu ɖoɖo	organization
kplᴐe ɖo	follow
dzra ɖo	kept
tsɔ ɖokui na	volunteer
kpɔ ɖokuiwò dzi	be careful
dzrae ɖo	repair
dzrae ɖo	save
wɔ ɖɔɖɔɖo	adjust
aɖu ɖɔkta	dentist
nu ɖuɖu	consumption
si ɖu wo kata dzi	dominant
hɔ̃	eagle
to	ear
kaba	early
towo	ears
anyigba	earth
anyigbãʋuʋu	earthquake
bɔbɔe	ease
bɔbɔe	easily
ɣedzeƒe	east
bᴐbᴐe	easy
ɖu	eat
to	edge
le edim	interested
gblẽ edome	ruin
susᴐsrɔ̃	education
yi edzi	carry on
wɔ edzi	comply
yi edzi	continue
gbɔ edzi	exceed
kpɔ edzi	manage
yi edzi nenema	keep it up
wɔ edzi	obey
yi edzi	proceed
ɖe edzi	reduce
dze edzi	successful
ƒo edzi	tap
do eɖokui ɖe dzi	flex
ɖe eɖokui fia	manifest
bᴐbᴐ eɖokui	humble
tsɔ eɖokui na	committed
tsɔ eɖokui na	devoted
yɔadɔ eɖokui	self healing
le eɖokui si	independent
he eɖokui	strain
di eɖokui tᴐ	selfish
ŋtete	effort
hello efɔ̃a	hello how are you
hello efɔ̃a	hello how are you doing
aleke, efɔ̃a	hi how are you
tso egbɔ	due to
le egbɔ	next to
kpᴐ egbᴐ be	ensure
koklozi	egg
agbitsa	eggplant
amenyenye	ego
le egodo	external
dze egɔme	began
le egɔme	beneath
ɖe egɔme	define
dze egɔme	started
se egɔme	understood
dze egᴐme	begin
mese egᴐme	I understand
gadze egᴐme	resume
dze egᴐme	start
se egᴐme	understand
enyi	eight
wuienyi	eighteen
blaenyi	eighty
abɔkuglui	elbow
ametsitsi	elder
amegaxoxo	elderly
na	element
atiglinyi	elephant
wuiɖɛkɛ	eleven
bubu	else
to eme	across
ɖe eme	clarify
ʋu eme	confess
le eme	contain
le eme	contains
ato eme	cope
dee eme	dip
dzro eme	discuss
ɖe eme	elaborate
geɖe eme	enter
ɖe eme	explain
ɖe eme	express
dee eme	insert
geɖe eme	interfere
ɖe eme	into
le eme	involve
le eme	involved
to eme	pass
dzro eme	review
kpomenya	emergency
he eme	stretch
tutu eme	swap
to eme	through
to eme	via
dᴐwᴐla	employee
dɔwɔlawo	employees
dɔtɔ	employer
dɔwɔɖua	employment
ƒuƒlu	empty
gododo	encounter
nuwuwu	end
dzidodo	endurance
dodzi	endure
futɔ	enemy
ŋusẽ	energy
dzogoe ene	square
srɔɖeɖe	engagement
mɔ	engine
aɖaŋudɔwɔla	engineer
iŋlisi	English
ede	enough
modzakaɖeɖe	entertainment
dzidzɔkpɔkpɔ	enthusiasm
katã	entire
dɔwɔƒe	entity
mɔnu	entrance
asitsala	entrepreneur
wu enu	accomplish
le enu	according
wu enu	complete
tsi enu	curb
wu enu	finish
wu enu	finished
ble enu	persuade
le enu	regarding
le enu	valid
agbalẽkotoku	envelope
xexeãme	environment
ŋubiabiã	envy
lᴐlɔ̃tᴐ enyo	okay honey
le eŋu	along
kpeɖe eŋu	besides
gbɔ eŋu	beyond
bu eŋu	consider
bu eŋu	considered
bu eŋu	imagine
kpeɖe eŋu la	beside
kpeɖe eŋu la	furthermore
kpeɖe eŋu la	in addition
kpeɖe eŋu la	moreover
ɖo eŋu	reply
ɖo eŋu	respond
ɖo eŋu	solve
dɔtsatsa	epidemic
sɔ	equal
dᴐwᴐnu	equipment
sɔsɔ	equity
nuŋɔŋlɔtutunu	eraser
vodada	error
si	escape
menye esia o	neither
nᴐ esi	had
le esi	has
le esi	have
le esi	having
ele esi	he has
le esime	during
le esime esia le edzi yim la	meanwhile
le esi	own
le esi	she has
ne esɔ ko	provided
kã	especially
nyadutsotso	essay
veviẽnyenye	essence
aƒe	estate
bui	estimate
ʋli eta	justify
to eta	over
ɖe eteƒe	behalf
ɖe eteƒe	instead
ɖe eteƒe	instead of
ɖo eteƒe	replace
ɖoe eteƒe	restore
mavɔmavɔ	eternal
sedziwɔwɔ	ethics
nye etᴐ	belong
dodokpɔ	evaluation
le eve	double
hã	even
fiɛ̃	evening
nudzᴐdzᴐ	event
mlᴐeba	eventually
nu eve	pair
tegbe	ever
zi eve	twice
kpeɖodzi	evidence
vɔ̃	evil
tɔtrɔ	evolution
trɔ	evolve
Eʋegbe	Ewe
ƒe ewo	decade
akpe ewo	ten thousand
le ewɔm	doing
tututu	exact
tututu	exactly
dodokpɔ	exam
kpɔɖeŋu	example
ɖɔli	exchange
dzidzɔkpɔkpɔ	excitement
kukuɖeɖe	excuse
dɔwɔwɔ	execution
kplɔlawo	executive
kamedede	exercise
li	exist
anyinɔnɔ	existence
do	exit
le exɔm	getting
keke	expand
gagbegblẽ	expenses
nuteƒekpɔkpɔ	experience
kasakasa	experiment
nunyala	expert
numeɖeɖe	explanation
zã	exploit
nyagbɔgblɔ	expression
ɖoƒe	extent
dedzii	extra
ŋku	eye
ŋkuwo	eyes
le eyome	following
tsi eyome	pursue
ti eyome	pursuit
ti eyome	trace
avɔ	fabric
mo	face
kpeɖeŋu	facilitate
kpeɖeŋunuwo	facilities
nuwɔƒe	facility
memanu	factor
dɔwɔƒe	factory
nyateƒewo	facts
klo	fade
madzedzi	failure
ekɔ	fair
glĩmenɔla	fairy
xᴐse	faith
alakpanu	fake
alakpa	false
amenyenye	fame
ƒome	family
dɔwuame	famine
nyanyɛ	famous
papa	fan
atsyᴐnu	fancy
hedenyuie	farewell
agble	farm
agbledela	farmer
tsidzinu	fashion
kabakaba	fast
nyadzᴐɖeamedzi	fate
tᴐ	father
ɖeɖiteameŋu	fatigue
vodada	fault
amenuveve	favour
veviẽtɔ	favourite
vᴐvɔ̃	fear
azãɖuɖu	feast
xefu	feather
ŋutinu	feature
ŋutinuwo	features
dzodze	february
fe	fee
nutsotso	feedback
seselelãme	feeling
ka fee	prompt
afᴐwo	feet
le fefem	playing
fe fefe	play
xɔ̃	fellow
asi	female
kpɔtɔtɔ	fence
nyi fe	owe
xe fe	paid
xe fe	pay
azãɖuɖu	festival
ku	fetch
asrã	fever
ʋee	few
ɖe fia	demonstrate
ɖeɖe fia	display
ahiãvi	fiance
ɖeɖe fiã	reference
ɖe fia	show
nyakpakpa	fiction
gbadzaƒe	field
li fifia	actually
Menye fifia o	Not now
dze fifia	sweat
wuiatɔ̃	fifteen
blaatɔ̃	fifty
nu	figure
agbalẽ	file
yɔ	fill
yɔ	filled
sinii	film
ƒoɖi	filthy
mlᴐeba	finally
di	find
enyo	fine
asibidɛ	finger
dzo	fire
gbã	first
tɔmelã	fish
sᴐ	fit
atɔ̃	five
wɔ	fix
flaga	flag
dzokekle	flash
gbadza	flat
kpɔtsɔtsɔ	flaw
maɖifɔ	flawless
si	flee
ŋutilã	flesh
dzo	flew
Te fli ɖe eme	Cancel
dzodzo	flight
ahiãwɔwɔ	flirting
tsiɖᴐɖᴐ	flood
anyigbã	floor
wɔ	flour
si	flow
seƒoƒo	flower
wɔɖi	flu
memie	fluent
memie	fluently
futufutu	fluffy
dzo	fly
Melɔ̃ fofonye	I love my father
afu	fog
ŋe	fold
nɔviwo	folks
Melɔ̃ fonye	I love my big brother
nuɖuɖu	food
bometsila	fool
afᴐ	foot
bɔl	football
ŋusẽ	force
ŋgonu	forehead
duta	foreign
ave	forest
tegbee	forever
gaflo	fork
nᴐnᴐme	form
xoxo	former
blaene	forty
blaene-vɔ-eve	forty-two
ŋgᴐgbe	forward
kpᴐe	found
gɔmeɖokpe	foundation
ene	four
wuiene	fourteen
abei	fox
bu fɔ̃	blame
ati	frame
ɖoɖo	framework
adzodada	fraud
femaxe	free
ablɔɖe	freedom
fa	freeze
xexlẽme	frequency
edziedzi	frequent
edziedzi	frequently
fiɖa	friday
nufamɔ	fridge
xɔ̃	friend
xɔlɔ̃wo	friends
xɔlɔ̃wɔwɔ	friendship
vɔ̃	frightened
dziŋɔ	frightening
akpɔkplɔ	frog
tso	from
ŋgɔ	front
atikutsetse	fruit
ɖe fu	bother
ɖe fu	disturb
nake	fuel
le fu kpem	struggling
Fulfulde	Fulfulde
yᴐ	full
nukoko	fun
gɔmeɖonu	fundamental
tsyɔ̃	funeral
wᴐ funyafunya	abuse
lãfu	fur
nunᴐdzi	furniture
kpe fu	suffer
tamebubu fũu	overthinking
nunɔamesiwo ƒe agbalẽ	inventory
dɔwɔƒe ƒe alɔdze	department
nu ƒeƒle	acquisition
anyigbã ƒe kpɔkpɔme	landscape
xeƒonu ƒe nuɖuɖu	prey
ame ƒe nuwɔwɔ	artificial
si ƒe ŋkeke de	expired
le ƒo ɖim	satisfying
bɔl ƒoƒo	soccer
do ƒome	relate
do ƒome	related
ɖi ƒo	satisfied
ɖi ƒo	satisfy
si ƒo wo katã ta	overall
nye ƒu ɖeɖe	skinny
le ƒuƒlu	blank
ɖi ƒuƒlu	void
tsɔe ƒu gbe	discard
nu ƒugbe	disposal
da ƒu	miss
de ga dɔwɔna me	invest
kpᴐ ga	earn
nukpᴐkpᴐ	gain
mlɔetɔ gake menye gblɔetɔ o	last but not least
hoʋiʋli	game
nuwuwu game	deadline
le game dzi	punctual
gbugbɔ ga na	refund
memama	gap
ʋunɔƒe	garage
gbeɖuɖɔ	garbage
abɔ	garden
kpᴐ ga	rich
ayo	garlic
agbo	gate
ƒoƒu	gather
ƒuƒoƒo	gathering
akpa gãtɔ	majority
dzidzenu	gauge
na	gave
dzi gbã	disappointed
ati gbadza	board
agba gbadza	pan
teƒe gbadza	space
nu gbagbã	scrap
nu gbagbe	being
tata gbãtɔ	draft
ŋkɔ gbãtɔ	first name
do gbe ɖa	pray
te gbe ɖe edzi	emphasize
te gbe ɖe edzi	insist
ɖe gbe gɔme	translate
do gbe	greet
kaka gbe	litter
tso gbe me	savage
le gbe me	wild
Medo gbe na mi	Hi there
tagbᴐ gblẽ	insane
si gblẽ wu	worst
si gbɔ dzi dzi	remote
na gbɔɖeme	relieve
kpɔ gbɔɖeme	relieved
si gbɔ eme	excessive
si gbɔ eme	extreme
mele gbɔgblɔm be	I mean
si gbɔ medidi o	recent
xɔe gbɔ	recover
ele gbɔwò	up to you
si gbᴐ didi	far
trᴐ gbᴐ	return
giya	gear
zi geɖe	mostly
zi geɖe	usually
na	gender
gbadza	general
gbadzaa	generally
wɔ	generate
dzidzime	generation
ƒomevi	genre
bɔkɔ	gentle
atsiatsi	genuine
asidada	gesture
xɔ	get
tso	get up
ŋɔli	ghost
zãmenɔnɔ	ghosting
amedzɔtsu	giant
nunana	gift
gumetakui	ginger
nyᴐnuvi	girl
na	give
na	given
dzidzᴐ	glad
ahuhɔ̃e	glass
gaŋkui	glasses
ŋkulɔnu	glimpse
asiwuiwo	gloves
klẽ	glow up
si glɔ̃	steep
nulenu	glue
yi	go
age	goal
taɖodziwo	goals
gbɔ̃	goat
mawu	god
ʋu go	discover
miado go emegbe	see you later
dze go	emerge
yina	goes
yina	going
sika	gold
kpɔ gome	entitled
do go	meet
kpɔ gome	participate
dzo	gone
na	gonna
ade	goo
enyo	good
ŋdᴐ	good afternoon
fiɛ̃	good evening
ŋdi	good morning
nudzadzrawo	goods
Google	Google
gbekpakpaxe	goose
dzeani	gorgeous
miado go	see you
miado go	see you soon
amenya	gossip
xᴐ	got
see	got it
dziɖuɖu	government
sã gɔme	basement
si gɔme menyase o	absurd
le	grab
ɖoƒe	grade
blewu	gradually
nukui	grain
na	grant
aŋuti	grapes
le	grasp
gbe	grass
akpedada	gratitude
yɔdo	grave
fu	gray
ŋukeklẽ	greed
kleaŋu	greedy
gbemu	green
gbedoname	greeting
gbedoname	greetings
fu	grey
gaɖɔ	grid
avifafa	grief
tu	grind
le	grip
nuzazãwo	grocery
ŋugbɛtɔsrɔ̃	groom
agbɔsɔsɔ	gross
anyigbã	ground
ha	group
tsi	grow
tsitsi	growth
Guarani	Guarani
kakaɖedzi	guarantee
dzɔla	guard
bui	guess
amedzro	guest
mɔfiame	guidance
ɖekakpui	guy
nɔviwo	guys
kamedeƒe	gym
ɖu ɣe	dance
le ɣli dom	noisy
do ɣli	scream
do ɣli	shout
do ɣli	yell
numame	habit
nɔƒe	habitat
kafu	hail
ɖa	hair
si ha le eme	including
afa	half
xɔlegbe	hall
nye hã	me too
asi	hand
alᴐ	handle
gake hã	nevertheless
dzɔ	happen
dzidzɔkpɔkpɔ	happiness
sesẽ	hard
nuveviewɔme	harm
ɖekawɔwɔ	harmony
sesẽ	harsh
nuŋeŋe	harvest
dzi ha	sing
tsri	hate
wo hã	you too
ŋɔdzinu	hazard
afu	haze
e	he
si hea ame	attractive
ta	head
taɖuame	headache
dɔyɔyɔ	healing
lãmesẽ	health
see	heard
dzi	heart
dzoxᴐxᴐ	heat
dziƒo	heaven
kpekpem	heavy
ɖodɔ	hectic
nu hehe	extension
na hehe	train
kᴐkᴐme	height
domenyila	heir
enye	he is
adzodada	heist
dzomavᴐ	hell
Hello	Hello
gakuku	helmet
kpekpeɖeŋu	help
eƒe	her
lãha	herd
domenyinu	heritage
Hee	Hey
tɔ hɛ	stab
Alekee	Hi
si hiã enumake	urgent
si hiã	essential
si hiã	required
be	hide
kɔ	high
nyati	highlight
togbɛ	hill
nɛ	him
dzesidenu	hint
aklito	hip
gbi	hips
da	hire
eƒe	his
nyadzɔdzɔ	history
lᴐ	hit
tso hlolui	hustle
nye hlɔ̃nu	harmful
hmm	Hmm
modzakadɔ	hobby
ʋli ho	challenge
lee	hold
do	hole
mɔkeke	holiday
aƒeme	home
aƒemedɔ	homework
Anyitsi	Honey
bubu	honor
tatsɔnu	hood
ƒu	hook
dzo	hop
mɔkpɔkpɔ	hope
lãdzo	horn
ŋɔdzi	horror
sɔ̃	horse
kɔ̃dzi	hospital
amedzroxɔxɔ	hospitality
aƒetᴐ	host
amedzrodzeƒe	hotel
gaƒoƒo	hour
gaƒoƒowo	hours
aƒe	house
aƒekɔ	household
le ho ʋlim	competitive
alekee	how
efɔ̃a	how are you
nenie	how many
nenie	how much
nudeƒe	hub
ame	human
tsiƒoƒo	humidity
alafa	hundred
ahom	hurricane
ʋã	hurry up
agblegbadɔ	hut
ɖe hũu	sigh
dzadzɛnyenye	hygiene
Nye	I
menye	I am
tsikpe	ice
aiskrim	ice cream
susu	idea
dzeside	identity
movitɔ	idiot
Mewɔnɛ	I do
mebui	i guess
Mekpɔ	I had
Menɔ	I have been
Menya	I know
Melɔ̃	I like
dɔléle	illness
Ilocano	Ilocano
melɔ̃	I love
menye	I'm
Menye	I’m
nɔnɔmetata	image
mefɔ̃	I'm fine
mefɔ̃	I'm good
emumake	immediate
enumake	immediately
dzimagbɔɖi	impatient
nugɔmesese	impression
ŋgɔyiyi	improvement
eme	in
ŋusedoamenu	incentive
nudzɔdzɔ	incident
gakpɔkpɔ	income
dzimadzeme	inconvenience
India	India
fiã	indicate
anyigbatitɔ	indigenous
dɔ	industry
vifɛ̃	infant
dɔdzedze	infection
mavɔmavɔ	infinity
nutete	inflammation
dziyiyi	inflation
numeɖeɖe	information
nuɖanuwo	ingredients
domenyinu	inheritance
gɔmedzeƒe	initial
abixɔxɔ	injury
maɖifɔ̃	innocent
nutoto	innovation
nutabiabia	inquiry
nudzodzoe	insect
eme	inside
numesese	insight
ɣeyiɣi	instance
enumake	instant
sedede	instructions
mɔ	instrument
dzu	insult
insiɔrans	insurance
blibodede	integrity
nunyala	intellectual
aɖaŋudede	intelligence
ɖo	intend
sẽŋu	intense
dzeɖoɖo	interaction
didi	interest
vivi	interesting
dome	intermediate
dɔsɔsrɔ̃	internship
nyagɔmeɖela	interpreter
gbebiabia	interview
kpɔkplɔyiɖeme	introduction
amenikpĩ	introvert
seselelãme	intuition
kpekpe	invitation
kpe	invite
febugbalẽ	invoice
ga	iron
enye	is
mekpɔ	I see
ƒukpo	island
nya	issue
nyawo	issues
e	it
nu	item
nuwo	items
enye	it is
enye	it's
eƒe	its
enyo	it's ok
Enyo	It's okay
enye	it was
medi	I want
menye	I was
mawᴐe	I will
Maanye	I would be
awutitri	jacket
gaxɔ	jail
Dzove	January
zɔ	jar
glã	jaw
atsyɔɖonu	jewelry
dɔ	job
kpeƒe	joint
nukokoenya	joke
nyadzɔdzɔŋlɔla	journalist
mᴐzɔ̃zᴐ	journey
dzidzɔ	joy
atikutsetsetsi	juice
siamlɔm	july
dzokpo	jump
masa	june
gbeɖuɖɔ	junk
ko	just
nu ka dim nèle	what do you want
le kadzi	online
si kaɖe eme	fairly
nu kae dzᴐ	what happened
dɔ kae le asiwò	what is your job
afi kae nèle	where are you
ame kae nenye	who are you
afi kae nètso	where are you from
dɔ kae nèwɔna	what do you do for a living
nu kae nye esia	what is this
ame kae nye esia	who is this
nu kae nye	what is
ame kae nye	who is
afi kae	where is
afi kae wò aƒeme le	where do you live
ɣe ka ɣi	when
do ka	interact
nu kakɛ	piece
agbalẽ kakɛ	sheet
nu kakɛwo	pieces
na kaklã	inform
Kalaallisut	Kalaallisut
de kame	work out
afi ka nèle	where are you now
nu ka ta	why
ame ka tᴐ	whose
nu ka	what
afi ka	where
nu ka	which
ame ka	who
nu ka wɔm nèle fifia	what are you doing now
nu ka wɔm nèle fifia	what are you doing right now
nu ka wɔm nèle	what are you doing
dɔ ka wɔm nèle	what do you do
tsɔe ke	forgive
si keketa	immense
si keke	vast
suetᴐ kekiake	least
le keklem	bloom
ema ke	likewise
ema ke	same
tsiɖodzuinu	kettle
asafui	key
gbɔ̃vi	kid
beble	kidding
ayiku	kidney
ɖeviwo	kids
wu	kill
ƒomevi	kinda
dɔmenyotɔe	kindly
dɔmenyo	kindness
fia	king
dzodoƒe	kitchen
aʋako	kite
dadivi	kitten
le klalo	eager
klo	knee
nya	knew
hɛ	knife
asrafo	knight
sidzedze	knowledge
kpuie ko	basically
ɖe ko	except
wɔe ko	just do it
ɖi koke	hilarious
ɖi kokoe	amusing
ɖi kokoe	funny
ɖi kokoe	ridiculous
ʋee ko	merely
vie ko	nearly
Konkani	Konkani
vie ko	slightly
eme kɔ be	apparently
le kɔ dam	fighting
si kɔ dzi	acute
ƒo kɔ	pile
me kᴐ	clear
ƒo kᴐ	crowded
dzime kᴐ	generous
eme kᴐ	obviously
sa kᴐ	tie
si kpe ɖe eŋu	additional
ɖo kpe edzi	confirm
ɖo kpe edzi	prove
ɖo kpe edzi	verify
ŋu kpee	embarrassed
do kpe	frozen
sɔ kple wo nɔeawo	identical
ɖoe kplikpa	determined
tɔ kplo	stall
siwo kplɔ wo nɔewo ɖo	series
esi kplᴐe ɖo	next
tsi kpo	blunt
li kpo	calm
ti kpo	flip
si kpɔa dziku	grumpy
do kpɔ	assess
Le kpɔɖeŋu me	For example
le kpɔɖeŋu me	for instance
do kpɔ	examine
tɔ kpɔ ƒo xlã	protect
nu kpɔkpɔ	focus
nya kpɔ	magnificent
dzidzɔ kpɔm	happy
enya kpɔ	nice
nya kpɔ ŋutɔ	awesome
nya kpɔ	pretty
si kpɔtɔ	remaining
tee kpᴐ	attempt
ɖᴐe kpᴐ	taste
egbɔna kpuie	coming soon
Krio	Krio
si ku	deceased
ɖe kuku	apologize
le kukum	dying
ku kutri	diligent
fifi laa	right now
nuŋutigbalẽ	label
dɔwɔwɔ	labor
dɔwɔna	labour
manᴐanyi	lack
li	ladder
ɖetugbui	lady
gake la	however
tɔgbada	lake
le lalam	pending
le lalam	waiting
alẽvi	lamb
kpɔ lame	chubby
wò lãme nasẽ kaba	get well soon
le lãmesẽ me	healthy
akaɖi	lamp
anyigbã	land
gbegbᴐgblᴐ	language
lolo	large
emegbe	later
mlɔ̃etɔ	latest
megbetɔ	latter
nukoko	laughter
nunyaƒe	laundry
se	law
evᴐ la	whereas
gbemumu	lawn
senyala	lawyer
ɖoɖo	layer
nɔnɔme	layout
kuvia	lazy
ŋgɔnɔla	leader
aŋgba	leaf
Ega le afima?	Are you still there?
dzo le afima	go away
tsra	leak
blɔ	lean
tikpo	leap
nusɔsrɔ̃	learning
haya	lease
srɔ̃ le asiwò lo alo wò ɖeka koe li	are you married or single
lãgbalẽ	leather
aŋgba	leave
aŋgbawo	leaves
alilikpowo le	cloudy
kplɔ	led
si le dzodzom	outgoing
nukae le dzɔdzɔm	what's up
tsa le eme	explore
ɖe le eme	extract
aɖu le eme	fertile
si le eme	internal
do le eme	less
do le eme	quit
ɖee le eme	remove
ɖee le eme	take away
dodo le eme	transition
ɖe le eme	withdrawal
ɖe le eŋu	strip
si le eteƒe	represent
alɔ̃ le etsɔm	sleepy
ɖe le fu me	rescue
ata	leg
domenyinu	legacy
xɔmezikpui legbe	couch
ŋutinya legbe	epic
aɖaka legbee	rectangle
xɔmetsovɔ legbe	swag
kalẽtɔ	legend
si le ɣaɣlame	hidden
modzkaɖeɖe	leisure
si le kakam	viral
nya le kpɔkpɔm	good looking
se le lame	feel
se le lãme	felt
nu lele ɖi	conservation
didime	length
dzudzɔ le ŋutifafa me	rest in peace
da le se dzi	breach
si le se nu	formal
si le sɔsɔnu	parallel
nufiafia	lesson
si le sue	minor
si le sue	modest
do le suku	graduate
na	let
nane le	there is
mo le tɔtrɔm	dizzy
lɛta	letter
gbadzaa	level
zã	leverage
tsikɔ le wum	thirsty
dɔ le wuwum	starving
si le xaxa me	endangered
si le xexeame	global
fenyinyi	liability
to lialia	hiking
agbalẽdzraɖoƒe	library
ɖuɖɔ	lick
si li	due
alakpa	lie
alakpa	lies
si li	existing
agbe	life
si li fia	actual
kekeli	light
dzikedzo	lightning
di	like
fli	line
Lingala	Lingala
kadodo	link
dzata	lion
nuleɖi	list
toɖoɖo	listening
si li tegbee	permanent
nuxexlẽ	literature
wo li	there are
sue	little
aklã	liver
agbenɔnɔ	living
akpata	living room
adoglo	lizard
abolo	loaf
gadodo	loan
duametɔ	local
teƒe	location
tu	lock
agbotutu	lockdown
atikpo	log
na	lol
si lolo ŋutɔ	tremendous
didi	long
eya loo	either
kpᴐ	look
xatsa	loop
tu	loose
aƒetɔ	lord
bu	lose
nububu	loss
bu	lost
gbogbo	lot
sesiẽ	loud
dzudzɔƒe	lounge
lɔ̃	love
bᴐbᴐ	low
bɔbɔ	lower
nyateƒetoto	loyalty
Asisi lɔlɔ̃a	Dear Customer
Amega lɔlɔ̃a	Dear Sir
Dɔwɔha lɔlɔ̃	Dear Team
mele lɔlɔm o	reluctant
nye lɔlɔ̃tɔ	My dear
nye lɔlɔ̃tɔ	my love
enyo lɔlɔ̃tɔ	okay baby
enyo lɔlɔ̃tɔ	ok dear
enyo lɔlɔ̃tɔ	ok honey
ɛ̃ lɔlɔ̃tɔ	yes dear
Dzila lɔlɔ̃wo	Dear Parents
Nusrɔ̃la lɔlɔ̃wo	Dear students
Ele lɔ̃nyem mahã	do you love me
nye lᴐlɔ̃tᴐ enyo	okay my love
enyo lᴐlɔ̃tᴐ	okay dear
ɛ̃ lᴐlɔ̃tᴐ	yes honey
le lᴐlᴐm	willing
hello lᴐtɔ̃tᴐ	hello dear
dzɔgbenyuie	luck
Luganda	Luganda
agba	luggage
kɔ	lump
dzitodzito	lungs
mɔ	machine
aƒenɔ	madam
wᴐ	made
alɔ̃ madɔmadɔ	insomnia
nu maɖinu	crap
nyadɔdzɔgbalẽ	magazine
ɣe ma ɣi	then
nyɔnuvi	maid
ŋutᴐ	main
to	maintain
Maithili	Maithili
ŋutɔŋutɔ	major
wɔ	make
modzadzraɖo	make up
atsu	male
fiasegã	mall
nu mama	distribution
ŋutsu	man
dzikpɔkpɔ	management
dzikpɔla	manager
nɔnɔme	manner
geɖewo	many
axadzi	margin
asime	market
srɔ̃ɖeɖe	marriage
momo	mask
lolome	mass
sɔgbɔ	massive
aƒetɔ	master
hoʋiʋli	match
kpeɖeŋutɔ	mate
nye mate ŋui o	I can't
nu	material
akɔnta	math
nu ma	that
afi ma	there
nu	matter
tsitsi	maturity
ɖewohĩ	maybe
nye	me
dzi me	above
nuɖuɖu	meal
gɔmeɖeɖe	meaning
dzidze	measure
dzidzenuwo	measures
adelã	meat
si mebɔ o	scarce
si mede akpa aɖeke dzi o	neutral
ne mede kura o la	at least
si mede to o	casual
dɔyɔyɔ	medical
atike	medicine
ŋugbledede	meditation
si me do le	hollow
aƒe me	domestic
si medzᴐna edziedzi o	seldom
takpekpe	meeting
dzi megaɖe le ƒo wò o	never give up
nye mega kpᴐ wò kpᴐ o	I miss you
si megali o	ex
tsi megbe	late
yi megbe	retreat
yi megbe	reverse
de megbe	support
le megbe	trail
si me goglo	profound
Nye me	I don't
dzodeame me	inspiration
Meiteilon	Meiteilon
si me kakaɖedzi le	assertive
si me kɔ	apparent
si mekɔ nyuie	vivid
si me kɔ	pure
si me kɔ	transparent
si me kᴐ	obvious
si me kᴐ	plain
si mele dɔ wɔm o	idle
si mele ɖoɖonu o	random
mia me	left
mɔ meli o	no way
lolõ	melt
si me mekɔ o	ambiguous
si me mekɔ o	vague
susuwo	memories
susu	memory
ŋkekea me nenyo	good day
ŋkekea me nenyo	have a good day
ŋkekea me nenyo	have a nice day
yᴐ	mention
hehenala	mentor
si me nu geɖe le	complex
si me nu geɖe le	sophisticated
si me nuwo le fũu	complicated
Nye menya o	I do not know
nye menya o	I don't know
Nye menya o	I don’t know
ne menye nenem o la	otherwise
si menyo o	messy
si menyo o	negative
ŋutilã me	physical
asitsala	merchant
nublanuikpɔkpɔ	mercy
Nye mese egɔme o	I do not understand
Nye mese egɔme o	I don't understand
nye mese egɔme o	I don’t understand
Nye mese gɔwòme o	I don't understand you
Nye mese nu si gblɔm nèle la gɔme o	I don't understand what you mean
si mesẽ o	delicate
si mesɔ ɖe edzi o	inappropriate
gbegblẽ	mess
gbedeasi	message
si me susule	sensible
ga	metal
nuwɔmɔnu	method
katã me	throughout
si metsɔ ɖeke le eme o	passive
dzi me	up
ya me	weather
esi me	while
si me woɖe dzo le	disabled
si me wo he	extended
si mexɔ asi o	affordable
fa mia	chill
tsɔ míado go	see you tomorrow
afiwo	mice
titina	middle
agbadroƒekpe	milestone
asrafowo	military
notsi	milk
akpeakpe	million
susu	mind
susuɖoɖo	mindset
tɔnye	mine
habɔbɔ	mingle
aɖabaƒoƒo	minute
aɖabaƒoƒo	minutes
nukunu	miracle
ahuhɔ̃e	mirror
nuɖianu	mischievous
fukpekpe	misery
bu	missing
dɔdeasi	mission
afu	mist
vodada	mistake
Mizo	Mizo
si mlɔ anyi	horizontal
dze mo anyi	stable
ko	mock
kpɔɖeŋu	model
ƒo mo ɖe	creep
yametsi	moisture
nuto	mold
atɔ	mole
dada	mom
ɣeyiɣi	moment
dzoɖa	monday
ga	money
ɖia	monitor
kese	monkey
ɣleti	month
seselelãme	mood
dzinu	moon
nufiame	moral
gawu	more
ŋdi	morning
na	mortgage
kekiake	most
nᴐ	mother
zɔɖeɖe	motion
dzideƒo	motivation
to	mountain
afi	mouse
nu	mouth
zɔzɔ̃	movement
sinii	movie
gbedoxɔme mɔ	aisle
kpɔ mɔ	anticipate
xe mɔ	block
to mɔ ɖeka dzi	consistent
kpɔ mɔ	expect
le mɔkpɔkpɔ me	hopefully
le mɔkpɔm	optimistic
xe mɔ na	denied
ɖe mɔ	permit
xe mɔ	restrict
dze mɔ	take off
ɖe mɔ	tolerate
xe mᴐ	deny
ɖe mᴐ na	enable
xe mᴐ	prevent
zɔ̃ mᴐ	travel
aƒenɔ	mrs
sᴐgbᴐ	much
ba	mud
kplu	mug
le mumu	fresh
lãmeka	muscle
tsãnuwonɔƒe	museum
ŋɔlixexi	mushroom
hadzidzi	music
nye	my
xɔ̃nye	my friend
nuɣaɣla	mystery
amlima	myth
dze na ame	convenient
tsɔ na	commit
dze na	deserve
gatagbadzɛ	nail
ŋkɔ	name
ago nam	excuse me
yi namlɔ anyi	go to bed
gblᴐe nam	tell me
mese naneke gɔme o	naive
megblẽ naneke o	no problem
ele nane wɔm mahã	are you busy
leabe na nu	caring
tsɔ na	render
nyatoto	narrative
nyaŋu	nasty
dukɔmetɔ	national
dumevinyenye	nationality
dumetᴐ	native
dzᴐdzᴐme	nature
xeɖeɖe	nausea
medogbe na wò	best regards
akpe na wò kakaaka	thank you so much
akpe na wò kakaaka	thank you very much
blunya nawò	merry christmas
ŋdi na wò nye lɔlɔ̃tɔ	good morning my love
akpe na wò	thank you
bu nazã	suspect
egbᴐ	near
dza	neat
hiã	necessary
kɔ	neck
kɔga	necklace
hiã	need
aleke nèfɔ̃ egbe	how are you doing today
alekee nèfɔ̃ egbe	how are you today
aƒelika	neighbor
goloɔgui	neighborhood
Mebui nenema	I hope so
zi nenie	how often
ƒe nenie nèxɔ	how old are you
eme nenyo	all the best
eme nenyo	best of luck
nyruiyᴐvi	nephew
ametsibome	nerd
atɔ	nest
ɖɔ	net
kadodo	network
ɖagbe neva le ŋkeke sia me	many many happy returns of the day
gbɛɖɛ	never
yɛye	new
nyadzɔdzɔ	news
mawu neyra wò	god bless you
nyo nɛ	worth it
zã	night
asiɛkɛ	nine
wuiasiɛkɛ	nineteen
blaasiɛkɛ	ninety
Ao	No
fli nogo	circle
ɣli	noise
ŋdɔ	noon
gbeɖɛ	nope
alo	nor
dziehe	north
ŋɔti	nose
ŋkuɖodzi	nostalgic
o	not
gbɛɖɛ	not at all
kaklãnana	notice
nkɔnya	noun
ŋkɔnyawo	nouns
ŋutinyagbalẽ	novel
adamekpɔxɛ	november
fifia	now
wo nɔeawo	each other
susu nɔ nu ɖeka ŋuti	concentrate
Melɔ̃ nɔvinye nyɔnuvi	I love my little sister
Melɔ̃ nɔvinye ŋutsuvi	I love my little brother
wɔ nu	act
eɖu nua	have you eaten
ɖo nu ame dzi	impose
wɔ nublanui	devastated
wᴐ nublanui	miserable
wɔ nublanui	pathetic
do nu	borrow
nya nu	clever
tsidzi nu	contemporary
dzᴐ nu	contribute
mawume nu	divine
na nu	donate
ta nu	draw
agbadzi nudzadzra	retail
zi nu dzi	seize
nye nu ɖeka tɔ	peculiar
wɔ nu ɖe	treat
ŋdi nuɖuɖu	breakfast
fiɛ̃ nuɖuɖu	dinner
na nuɖuɖu	feed
ŋdᴐ nuɖuɖu	lunch
fiɛ̃ nuɖuɖu	supper
le nu ɖum	eating
tsi nu	fluid
abunɛ nu	foolish
dze nu gɔme	initiative
se nu gɔme	sober
se nu	hear
dɔ nu	import
duta nu	international
to nu	invent
fuɖename	nuisance
ɖuɖɔ nu	kiss
nya nu	know
le nu kom	laughing
ƒoa nukpoloe	talkative
wɔ nuku	amazing
wɔ nuku	fabulous
wᴐ nuku	stunning
wɔ nuku	surprised
wᴐ nuku	wonderful
ko nu	laugh
srɔ̃ nu	learn
do nu	lend
klɔ nu le nu ŋutsi	rip
tsi nu	liquid
ƒuƒlu	null
ga nu	luxury
zu numame	addicted
asi nu	manual
xexlẽdzesi	number
ku nu me	investigate
egbe nu	modern
dzɔdzɔme nu	natural
wu nu nu	accomplished
kukɔ nu ŋu	scratch
tre nu	patch
kpɔ nu	perceive
wᴐ nu	perform
subɔsubɔ nu	religious
dᴐnᴐdzikpᴐla	nurse
sea nu	sensitive
nye nu sesẽ	critical
se nu si wonye me	figure out
ƒo nu	speak
le nusrɔm	studying
srɔ̃ nu	study
kplɔ nu	sweep
azi	nut
ƒo nu	talk
doa nutami	ambitious
fia nu	taught
fia nu	teach
wᴐ nuteƒe	responsible
na	nutmeg
dekɔnu nu	traditional
xlɔ̃ nu	urge
nye nu vɔɖi wɔla	suspicious
nya nu	wash
nya nu	wise
eme nuwo	content
si nu womate ŋu asi le o	inevitable
le nuwuwu	ultimate
he nya	argue
gblɔ nya ɖi	predict
ga nya	economic
ku nya	fatal
ga nya	financial
le nyagbᴐgblᴐa nu	literally
wɔ nyamaa	clumsy
tso nyame	decide
ɖe nya me	interpret
geɖe nya me	interrupt
ƒe nyame sẽ	strict
si nya nu	brilliant
dzodzo nyanyanya	jerk
nya nyanya	vocabulary
ŋuti nya	profile
to nya	quote
ka nyata	communicate
o nyateƒea	oh really
toa nyateƒe	honest
le nyateƒe me	honestly
le nyateƒe me	indeed
le nyateƒe me	In fact
le nyateƒe me	sincerely
nye nyateƒe nu	legit
toa nyateƒe	sincere
dzidzᴐ nyawo	vibes
woawoe nye	consist
si nye dɔxɔleameŋu	contagious
si nye dzizizi nu	mandatory
ŋkɔ nyee nye	my name is
alekee nye	how is
dometᴐ nye	include
enyo nye lɔlɔ̃tɔ	ok my love
ɛ̃ nye lᴐlɔ̃	yes my love
egɔmee nye	mean
gᴐme nye	means
gɔme nye	meant
si nye nyahehe	controversial
eyae nye	she is
ema nye	that is
woawoe nye	they are
esia nye	this is
míawoe nye	we are
alekee nye wò dɔdɔ	how was your night
alekee nye wò ŋkekea	how was your day
si nyo	positive
si nyo	suitable
ema nyo	that's good
ahiãvi nyɔnu	girlfriend
vi nyᴐnu	daughter
nyruiyᴐvi nyᴐnu	niece
nᴐvi nyᴐnu	sister
srɔ̃ nyᴐnu	wife
eli nyuiea	how do you do
wɔ nyuie	behave
xede nyuie	bye
kpɔe nyuie	careful
de nyuie	goodbye
ewɔe nyuie	good job
dzᴐgbe nyuie	good luck
meli nyuie	I am fine
ʋɔnudɔdrɔ nyuie	justice
dzigbezã nyuie nawò	happy birthday to you
nu nyuie	virtue
ewɔ nyuie	well done
gbetsi nyui	fortune
hede nyui	good bye
ɖu ŋdi nu	have breakfast
de ŋgɔ	advanced
le ŋgɔ	ahead
do ŋgɔ	before
do ŋgɔ	earlier
yi ŋgɔ	go ahead
yi ŋgɔ	improve
le ŋgɔ	in front of
nɔ ŋgɔ	lead
nya ŋgɔnya	preposition
do ŋgɔ	prior
le ŋgɔ	prominent
dodoɖe ŋgɔ	promotion
do ŋgɔ xoxo	already
do ŋgᴐ	advance
yi ŋgᴐ	develop
le ŋkeke siawo me	lately
nudzadzra ŋkɔ	brand
ƒome ŋkɔ	last name
ŋlɔ ŋkɔ	register
ƒome ŋkɔ	surname
gbã ŋku	blind
da ŋku ɖe edzi	glance
le ŋku ɖe eŋu	check
le ŋku ɖe eŋu gbadza	survey
le ŋku ɖe eŋu	observe
lea ŋku ɖe nu me	curious
ɖo ŋku edzi	note
ɖo ŋku edzi	remember
ɖo ŋku edzi	remind
mesᴐ ŋku me o	awkward
wo ŋlɔ	written
do ŋɔdzi	dread
do ŋɔdzi	scary
yɔ ŋɔŋlɔdzesiwo	spell
te ŋu	able
mate ŋu adzɔ o	impossible
ate ŋu adzᴐ	possible
ate ŋu aƒle	afford
mate ŋu aƒo nu o	speechless
ate ŋu agbã bɔbɔe	fragile
ate ŋu	can
ate ŋu	capable
ɖa ŋu	cook
te ŋu	could
kpᴐ ŋudzedze	achieve
kpᴐ ŋudzedze	eligible
na ŋudzedze	impress
na ŋudzedzekpɔkpɔ	appreciate
kpɔ ŋudzedze	passed
kpɔ ŋudzedze	pleased
le ŋudzᴐ	ready
mate ŋu	I can
mate ŋui o	can't
mate ŋui o	unable
ʋã ŋu	jealous
si ŋu kpe	ashamed
nye ŋukpe	embarrassing
ate ŋu	may
ate ŋu	might
si ŋu mɔ mele o	forbidden
si ŋu ŋkɔ mele o	anonymous
si ŋu ŋudɔwɔnu aɖeke mele o	useless
ɖo ŋu	rely
kple ŋusẽ	aggressive
de ŋusẽ eme	boost
do ŋusẽ nu	strive
le ŋute	conscious
tea ŋu	tend
klɔ ŋuti	bleach
nuɖaɖa ŋuti ɖoɖo	recipe
le ŋutifafa me	peaceful
si ŋuti kɔ	sacred
nunyiame ŋuti nunya	nutrition
hakpanya ŋuti nunya	poetry
atike ŋuti nusɔsrɔ̃	chemistry
dzᴐdzᴐme ŋuti nusᴐsrɔ̃	science
ga ŋuti nya	economy
si ŋuti woɖe asi le	released
sẽ ŋu	tough
nyakpɔ ŋutɔ	charming
nyakpɔ ŋutɔ	elegant
veviẽ ŋutɔ	extremely
nyo ŋutɔ	fantastic
nyo ŋutɔ	great
sesẽna ŋutɔ	hardly
gã ŋutɔ	huge
nye ŋutɔ	myself
nua ŋutɔ	principal
ame ŋutɔ	self
nyakpɔ ŋutɔ	so cute
nyakpɔ ŋutɔ	splendid
nyo ŋutɔ	super
woawo ŋutɔ	themselves
nyo ŋutɔ	very good
wò ŋutɔ	yourself
nyo ŋutᴐ	adorable
hiã ŋutᴐ	crucial
lolo ŋutᴐ	enormous
enyo ŋutᴐ	excellent
ame ŋutᴐ ƒe	private
nyo ŋutᴐ	lovely
ahiãvi ŋutsu	boyfriend
nɔvi ŋutsu	bro
nᴐvi ŋutsu	brother
srɔ̃ ŋutsu	hubby
srɔ̃ ŋutsu	husband
nɔvi ŋutsu srɔ̃	sister in law
míate ŋu	we can
si ŋu womebu o	regardless
ate ŋu	you can
ake o	anymore
atam	oath
menyo o	awful
amidada	obesity
nu	object
taɖodzi	objective
nuteɖeamedzi	obligation
nukpɔkpɔ	observation
nudzeamedzi	obsession
mɔxenu	obstacle
xᴐ	obtain
xɔ	obtained
ɣeaɖewoɣi	occasionally
dɔwɔna	occupation
dzᴐ	occur
dzɔ	occurred
dzɔna	occurs
atsiaƒu	ocean
kele	october
na	odds
gawɔe o	don't
megali o	extinct
nyateƒee	of course
tsi	off
na	offer
dɔwɔƒe	office
dɔwɔla	official
often	often
O	Oh
medzɔna o	hardly ever
ami	oil
mesɔ o	invalid
Enyo	ok
enyo	okay
tsitsi	old
mesẽŋu o	mild
edzi	on
ɖeka	one
megatsidzi o	never mind
sabala	onion
ko	only
ɖeke o	none
megblẽ o	not bad
naneke o	nothing
haɖe o	not yet
mesᴐ o	odd
ʋu	open
nuwɔna	operation
tamesusu	opinion
mɔnukpɔkpɔwo	opportunities
mɔnukpɔkpɔ	opportunity
tiatia	option
alo	or
aŋuti	orange
mebᴐ o	rare
gbeɖeɖe	order
medidi o	recently
susutɔtrɔ	orientation
dzɔtsoƒe	origin
gbãtɔ	original
Oromo	Oromo
tsyɔẽvi	orphan
megoglo o	shallow
madidi o	soon
bubu	other
míaƒe	our
metsonu	outcome
awudodo	outfit
dodoƒe	outlet
ɖoɖo	outline
gota	outside
numekpo	oven
wui	overwhelmed
adzexe	owl
nutɔ	owner
maawɔe o	won't
mede o	wrong
tedzitsu	ox
haɖe o	yet
naneke o	zero
ɖiɖime	pace
ƒoƒu	pack
vevesese	pain
aŋɔ	paint
aŋɔsisi	painting
fu	pale
asiƒome	palm
dᴐxᴐtsatsa	pandemic
vɔvɔ̃	panic
godui	pants
pɛpa	paper
paradiso	paradise
nubabla	parcel
tsɔtsɔke	pardon
dzilawo	parents
gbadzaƒe	park
ako	parrot
na	parsley
akpa	part
ma	particular
hati	partner
dunyaheha	party
nuŋlɔɖi	passage
safuinya	password
tsã	past
afᴐmᴐ	path
dzigbᴐɖi	patience
dzigbɔɖi	patient
ɖoɖome	pattern
mɔtokpe	pavement
fexexe	payment
ŋutifafa	peace
na	peach
kɔkɔƒe	peak
pɛya	pear
ayi	peas
aɖuɖɔ	pee
kle	peel
hati	peer
hatiwo	peers
nuŋlɔti	pen
nuŋlɔti	pencil
amewo	people
atadi	pepper
nukpᴐkpᴐ	perception
dᴐwᴐwᴐ	performance
ɖewòhĩ	perhaps
ɣeyiɣi	period
mᴐɖeɖe	permission
kutrikuku	perseverance
edziedzi	persistent
ame	person
nukpɔkpɔ	perspective
ŋunyɔ	pervert
ameƒelã	pet
akpa	phase
nudzɔdzɔ	phenomenon
nunya	philosophy
kaƒomɔ	phone
foto	photo
nyatiatia	phrase
fɔ	pick
tsᴐe	pick up
nutata	picture
ha	pig
ahɔnɔe	pigeon
suɖi	pillow
yameʋukula	pilot
abui	pin
atɔtɔ	pineapple
dzẽ	pink
ʋe	pit
gbadzaƒe	pitch
nublanui	pity
teƒe	place
teƒewo	places
dɔxɔleameŋu	plague
ɖoɖo	plan
gbadza	plane
ati	plant
atiwo	plants
nuɖugba	plate
nugbadza	platform
taflatsɛ	please
dzidzᴐkpᴐkpᴐ	pleasure
sɔgbɔ	plenty
babla	plot
katsyiãnu	plug
atɔ	plum
tsidɔwɔla	plumber
agbɔsɔsɔ	plural
na	podcast
hakpanya	poem
asitɔƒe	point
aɖi	poison
kpovitɔ	police
ɖoɖo	policy
ɖiƒoƒo	pollution
mí	poop
pɔp	pop
nyanyɛ	popular
amehawo	population
halã	pork
dzogbɔ	porridge
ʋudzeƒe	port
ɖoƒe	position
lé	possess
nunɔamesi	possession
nutɔnyeye	possessive
dzɔƒe	post
nagoti	potato
ŋutete	potential
pɔŋ	pound
ahedada	poverty
ŋusẽ	power
ŋusẽtɔ	powerful
asidɔwɔwɔ	practical
kasa	practice
kafu	praise
amebeble	prank
tᴐxɛ	precious
tututu	precise
tututu	precisely
tiã	prefer
tiatia	preference
fɔfu	pregnant
nazã	prejudice
nyagɔmenya	premises
dzadzraɖo	preparation
dzrãɖo	prepare
dzraɖo	prepared
amegbɔnɔnɔ	presence
fifia	present
nunana	presentation
dukplɔla	president
nuteɖeamedzi	pressure
asi	price
dada	pride
trɔ̃nua	priest
gɔmedzeƒe	primary
fiavinyɔnu	princess
mɔ	prison
adzame	privacy
dziɖufiakuku	prize
ɖewòhĩ	probably
kuxi	problem
afᴐɖeɖe	procedure
nuwᴐna	process
wɔ	produce
nuwɔwɔ	production
dɔwɔwɔ	profession
dɔnyala	professional
viɖe	profit
ŋgᴐyiyi	progress
dɔwɔna	project
ŋgbedodo	promise
ŋkɔteƒenɔnyawo	pronouns
nyayɔyɔ	pronunciation
kpeɖodzi	proof
nyuietᴐ	proper
nyuie	properly
nunɔamesiwo	properties
nunᴐamesi	property
nyadoɖa	proposal
ŋgɔkpɔkpɔ	prospect
nudzedziname	prosperity
hotsuikpɔkpɔ	prosperous
dana	proud
na	provide
nutoga	province
nuhiahiawo	provision
ɖetugbivãvã	puberty
amedome	public
hee	pull
na	pumpkin
nusrɔ̃vi	pupil
ƒle	purchase
dzẽ	purple
taɖodzi	purpose
gakotoku	purse
tutu	push
ŋudzedzekpɔkpɔ	qualification
nyonyo	quality
agbɔsɔsɔ	quantity
dzre	quarrel
kuata	quarter
Quechua	Quechua
fianyɔnu	queen
biabia	query
biabia	question
fli	queue
kaba	quick
kaba	quickly
na	quilt
abe	quite
dodokpɔ	quiz
nyatoto	quotation
nyatotowo	quotes
fɔmizi	rabbit
ɖimekeke	race
tsidzadza	rain
kekeme	range
kabakaba	rapid
kabakaba	rapidly
ŋutsetsi	rash
alegeli	rat
asixᴐxᴐ	rate
boŋ	rather
ɖoɖo	ratio
mumu	raw
de	reached
ŋuɖoɖo	reaction
xlẽ	read
nuxexlẽ	reading
ŋutᴐ	real
nyateƒe	reality
nyateƒea	really
nyi	rear
susu	reason
gayɔ	recall
fexegbalẽ	receipt
xᴐ	receive
xᴐ	received
amexɔƒe	reception
maɖɔʋu	reckless
dzesidede	recognition
nyaleɖi	record
hayahaya	recovery
dzẽ	red
ɖe	redeem
ɖeɖekpɔkpɔ	redemption
klẽ	reflect
dzedze	reflection
dzudzɔ	refrain
nufamɔ	refrigerator
gbe	refuse
gbe	refused
kpɔ	regard
gbedoname	regards
nuto	region
edzidzi	regular
edziedzi	regularly
gbe	reject
ƒomedodo	relationship
ƒometɔ	relative
ƒometɔwɔ	relatives
gbᴐɖeme	relief
subɔsubɔ	religion
atike	remedy
ŋkuɖodzi	reminder
haya	rent
nutsotso	report
bubudede	reputation
bia	request
hiã	require
numekuku	research
ɖi	resemble
dɔmedzoedodo	resentment
megbedede	reservation
dumenɔla	resident
tenɔnɔ	resilience
gbe	resist
agladzedze	resistance
nuɖoɖo	resolution
amedzrodzeƒe	resort
nunɔamesiwo	resources
ŋuɖoɖo	response
dɔdeasi	responsibility
dzudzᴐ	rest
nuɖuƒe	restaurant
metsonu	result
metsonu	results
nuléleɖi	retention
xɔegbɔ	retrieve
teƒeɖoɖo	revenge
gakpᴐkpᴐ	revenue
ɖɔɖɔɖo	revision
fetu	reward
ʋugbe	rhythm
axadameƒu	rib
mᴐli	rice
ku	ride
nyui	right
asigɛ	ring
kpala	rinse
aglãdzedze	riot
ɖi	ripe
ŋɔdzi	risk
atsusi	rival
tɔsisi	river
mɔ	road
me	roast
ahliha	rock
kpo	rod
wɔƒe	role
mli	roll
xɔgbagbã	roof
xɔ	room
ke	root
ka	rope
gblẽ	rotten
ƒlatsa	rough
lɔƒo	roughly
nogo	round
mɔ	route
akpa	row
si	rub
aŋe	rubber
gbeɖuɖɔ	rubbish
ɖovu	rug
se	rule
dziɖula	ruler
sewo	rules
kɔƒeme	rural
kotoku	sack
vɔsa	sacrifice
dedienɔnɔ	safety
nunyala	sage
gblᴐ	said
ta	sake
fetu	salary
nudzadzra	sale
sama	salmon
dze	salt
kpɔɖeŋunu	sample
ke	sand
Sanskrit	Sanskrit
alɔmeɖenya	sarcastic
dzetugbe	sassy
ƒoɖiɖi	satisfaction
Memlɛɖa	Saturday
na	sausage
kpᴐ	saw
gblᴐ	say
dudanu	scale
adzodamɔnu	scam
abikukuteƒe	scar
vɔ̃	scared
taku	scarf
kaka	scattered
nukpɔkpɔ	scene
nukpɔkpɔ	scenery
ʋeʋe	scent
suku	school
dzɔdzɔmeŋutinunyala	scientist
dzɔdzɔmeŋutinunyalawo	scientists
sakisi	scissors
gbenya	scold
kekeme	scope
mɔxenu	screen
nuŋlɔɖi	script
atsyiaƒu	sea
nutrenu	seal
di	search
ɣeyiɣi	season
zikpui	seat
xᴐe se	believe
evelia	second
nuɣaɣla	secret
akpa	section
zã se	curfew
dedienɔnɔ	security
nye sedede	compulsory
va se ɖe fifia	so far
va se ɖe	until
kpɔ	see
nuku	seed
di	seek
kpɔ	seen
nudzisesẽ	seizure
tia	select
dzra	sell
dᴐ	send
ametsitsi	senior
susu	sense
dɔ	sent
nyagbe	sentence
nyagbewo	sentences
le senu	legal
mele se nu o	illegal
si seŋu	resilient
si sẽŋu	terrific
nya se ŋutɔ	impressive
Sepedi	Sepedi
nya se	pleasant
anyɔnyɔ	september
yomenuwo	sequence
moveviẽ	serious
veviẽ	seriously
si sẽ	robust
subɔ	serve
dɔ	service
ɣli sesẽ	bang
se seselelãme	emotional
kple seselelãme	passionate
seselelãme sesẽ	passion
nu sesẽ	solid
efɔ̃ sesiẽa	how are you doing
akpa	session
ɖoe	set
ɖoɖo	setting
adrẽ	seven
wuiadrẽ	seventeen
blaadrẽ	seventy
geɖe	several
seŋu	severe
tɔ	sew
na	sh
vɔvɔli	shade
vɔvɔli	shadow
ʋuʋu	shake
na	shall
ŋkpe	shame
dzedzeme	shape
ma	share
ɖaɖɛ	sharp
e	she
agbadɔ	shed
alẽ	sheep
agba	shelf
dzato	shell
bebeƒe	shelter
akpoxɔnu	shield
klẽ	shine
mɛli	ship
awu	shirt
afɔkpawo	shoes
da	shoot
fiase	shop
nuƒeƒle	shopping
tɔto	shore
kpuie	short
mademade	shortage
dada	shot
abɔta	shoulder
tsinyɔnyɔ	shower
fiam	show me
bɔlu	shrimp
tu	shut
ŋukpem	shy
ame sia ame	anyone
ame sia ame	everybody
ame sia ame	everyone
ɖe sia ɖe	each
ɖe sia ɖe	every
ɖe sia ɖe hã	anyways
ɖe sia ɖe ko	anyway
ƒe sia ƒe	annual
gbe sia gbe	daily
gbe sia gbe ƒe nu	normal
gbe sia gbe nu	ordinary
gbe sia gbe nuwɔna	routine
ɣe sia ɣi	always
ɣe sia ɣi	whenever
afi sia hã	Same here
afi sia	here
nu sia nu	anything
nu sia nu	everything
nu sia	this
fiɛ̃ sia	tonight
ŋkeke siawo me	nowadays
nu siawo	these
nɔvi	sibling
nᴐviwo	siblings
axa	side
nu si de megbe	background
nu si doa nu ɖe ŋgɔ	booster
ɖoɖo si dzi woazɔ	schedule
tsɔ si gbɔna	tomorrow
tsᴐ si gbᴐna	future
nukpᴐkpᴐ	sight
ŋkutsatsa	sightseeing
dzesi	sign
nu si le eteƒe	fact
ɖoɖoezizi	silence
nu si le veviẽ	priority
ɖetsi	silk
abunɛ	silly
klosalo	silver
ɖetugbui si menya ŋutsu o	virgin
sᴐ	similar
abunɛtɔ	simp
ɖagbuie	simple
enumake	simultaneously
hadzila	singer
ɖeka	single
nu si nɔa edzi yim	context
amega	Sir
teƒe	site
ame si trɔa susu kabakaba	freak
ɣeyiɣi	situation
tsᴐ si va yi	yesterday
ame si	whom
nu si wobu	assumption
ame si wodo goe	acquaintance
nu siwo ƒo xlã	surrounding
ale si wolɔ̃	arbitrary
ati si wotu	stake
nu si wowɔ	product
adẽ	six
wuiadẽ	sixteen
blaadẽ	sixty
lolome	size
aɖaŋuwɔwɔ	skill
aɖaŋuwɔwɔ	skills
ŋutigbalẽ	skin
siketi	skirt
yame	sky
kluvi	slave
awubɔ	sleeve
kpakpɛ	slice
ɖiɖi	slide
tsralɛ	slim
agbalẽvi	slip
aga	slope
nudeƒe	slot
blewu	slow
blewu	slowly
sue	small
zãzɛ̃	smart
ʋeʋẽ	smell
alɔgbɔnu	smile
dzudzɔ	smoke
zrɔ̃	smooth
numeɖenu	snack
abɔbɔ	snail
dã	snake
sno	snow
eyata	so
adzalẽ	soap
hame	social
du	society
afɔwui	socks
bᴐbᴐ	soft
sɔƒtwɛ	software
ke	soil
dzra	sold
asrafo	soldier
wodzrae	sold out
ɖeka	sole
ŋuɖoɖo	solution
ɖe	some
ɖewuiɖewui	somehow
nane	something
ɣeaɖewoɣi	sometimes
ha	song
Sorani	Sorani
abi	sore
vemexɔabi	sore throat
konyifafa	sorrow
Babaa	Sorry
ɖo	sort
di	sought
luʋɔ̃	soul
na	soulmate
gbeɖiɖi	sound
detsi	soup
dzᴐtsoƒe	source
anyiehe	south
tsɔe sɔ	compare
si sɔgbɔ	abundant
si sɔ kple	equivalent
si sɔ	uniform
na	spam
lũ	span
Spaniagbe	Spanish
kpeɖeŋu	spare
tᴐxɛ	special
ƒome	species
nukpɔla	spectacular
nuƒoƒo	speech
dusisi	speed
zã	spend
zã	spent
ŋu	spike
tro	spin
ama	spinach
gbɔgbɔ	spirit
ma	split
gblẽ	spoil
gblẽ	spoiled
enumake	spontaneous
gatsi	spoon
teƒe	spot
srɔ̃	spouse
kaka	spread
gagᴐdɔ̃e	spring
mía	squeeze
bosrã	squid
adɔ	squirrel
eɖe srɔ̃a	are you married
ɖe srɔ̃	married
amekɔkɔe	st
nuƒoƒu	stack
dᴐwᴐlawo	staff
fefewɔƒe	stage
ɖi	stain
trakpui	stairs
nutredzesi	stamp
tso	stand
dzidzenu	standard
ɣletivi	star
dukɔ	state
nyadu	statement
ʋuɖoƒe	station
kpetata	statue
ɖoƒe	status
dzɔ	steady
nyilãmeme	steak
fi	steal
dzudzɔ	steam
ga	steel
ati	stem
afɔɖeɖe	step
ati	stick
dzeti	stiff
kokooko	still
te	sting
blu	stir
asigba	stock
ƒodo	stomach
kpe	stone
tso	stood
zikui	stool
tᴐ	stop
nudzadzraɖo	storage
fiase	store
ahom	storm
ŋutinya	story
mlekpui	stove
dzɔ	straight
amedzro	stranger
ayɛ	strategy
gbekui	straw
na	strawberry
flitsotsowo	streak
tᴐsisi	stream
mɔdodo	street
ŋusẽ	strength
nuteɖeamedzi	stress
ƒo	strike
ka	string
gbagbãdᴐ	stroke
sẽ	strong
ƒo	struck
nɔnɔme	structure
ʋli	struggle
nusrɔ̃la	student
nuwo	stuff
abunɛ	stupid
atsyiã	style
nyati	subject
nu	substance
teƒenɔla	substitute
dzidzedzekpᴐkpᴐ	success
abe	such
abe	such as
no	suck
emumake	sudden
tete	suddenly
fukpekpe	suffering
de	sufficient
sukli	sugar
nudodoɖa	suggestion
dziwui	suit
potomato	suitcase
home	sum
totoɖeme	summary
dzomeŋɔli	summer
takpekpegã	summit
ɣe	sun
kɔsiɖa	sunday
ŋdɔkutsu	sunny
ɣetoɖoɖo	sunset
ɣedzedze	sunshine
dzikpɔla	supervisor
nunana	supply
ŋkume	surface
amekoko	surgery
gbetakpɔkpɔ	surveillance
ƒe susu ɖa	intelligent
le susume	cognitive
le susume	mental
le susunu	rational
le susu nu	reasonable
le susuwom	miss you
mi	swallow
vuvɔmewu	sweater
vivi	sweet
lɔlɔ̃tɔ	sweetheart
numevivi	sweet tooth
te	swell
tete	swelling
ƒutsi	swim
tsiƒuƒu	swimming
dayidagbɔe	swing
si	switch
te	swollen
yi	sword
dzesi	symbol
akɔfafa	sympathy
mɔnu	system
kplɔ̃	table
afɔdeme	tackle
ʋli ta	defend
dzesidekpe	tag
esia ta	hence
asikɛ	tail
tsɔ	take
lebenɛ	take care
tsɔ	taken
kᴐkᴐ	tall
se tame	cruel
megadee tame o	nevermind
gbemu tamesusuwo dɔ alɔ̃ kple adã	colorless green ideas slept furiously
bu tame	think
bua tame	thoughtful
nudzidzeka	tape
taɖodzinu	target
dɔ	task
ɖe ta	spit
na ta	surrender
eya ta	therefore
eya ta	thus
ɖo ta	toward
ɖo ta	towards
tii	tea
nufiala	teacher
dɔwɔha	team
aɖatsi	tear
aɖatsiwo	tears
le te	balance
mɔɖaŋu	technology
si teɖe mía gbɔ	nearby
ɖeɖi te eŋu	exhausted
ɖeɖi te eŋu	frustrated
ɖeɖi te eŋu	tired
yi tẽe	straightforward
aɖuwo	teeth
le teƒe ɖeka	fixed
tsi teƒe ɖeka	stuck
gblᴐ	tell
dziku	temper
dzoxɔxɔ	temperature
gbedoxɔ	temple
ewo	ten
xɔhayala	tenant
ŋutete	tendency
bᴐbᴐ	tender
kpɔ̃ɔ	tense
dzimaɖeɖi	tension
agbadɔ	tent
le tenu	firm
nya	term
ɖoɖowo	terms
anyigbã	territory
dodokpɔ	test
nuŋɔɖi	text
wu	than
akpe	thank
akpe	thanks
the	the
fififi	theft
woƒe	their
wo	them
nyati	theme
agbalẽmenya	theory
wo	they
tri	thick
fiafi	thief
atagba	thigh
lɛe	thin
nu	thing
nuwo	things
etɔ̃lia	third
wuietɔ̃	thirteen
blaetɔ̃	thirty
memie	thorough
memie	thoroughly
emawo	those
togbɔ	though
tamesusuwo	thoughts
akpe	thousand
ka	thread
ŋᴐdzidodo	threat
etɔ̃	three
kpui	threshold
vetome	throat
da	throw
degblefetsu	thumb
dziɖegbe	thunder
Yawoɖa	Thursday
le tiatia me	optional
ƒudada	tide
kpɔ̃	tiger
mía	tight
Tigrinya	Tigrinya
nu ti kɔ nɛ	fed up
ɣeyiɣi	time
vɔna	timid
sue	tiny
nunana	tip
aɖaŋuɖoɖowo	tips
ayi	tissue
zã titina	midnight
tanya	title
yi	to
nyenye	to be
egbe	today
vitata	toddler
trɔ to eme	manipulate
afɔbidɛ	toes
dzo to eta	skip
ɖekae	together
lia to	hike
afɔdzi	toilet
gblɔ	told
dzigbɔɖi	tolerance
ɖo to	listen
tomatre	tomato
aɖe	tongue
hã	too
tsᴐ	took
dɔwɔnu	tool
dɔwɔnuwo	tools
aɖu	tooth
dzi	top
nyati	topic
vuvu	torn
funyafunya	torture
yi to	sink
ƒuƒoƒo	total
gatagbadze totro	screw
tsaɖiɖi	tour
si to vovo	queer
si to vovo sã	extraordinary
papaŋu	towel
du	town
zɔ tɔdzi	sail
dzɔgbenyuie tɔe	fortunately
wɔ tɔtrɔ	amend
wɔ tɔtrɔ	edit
wɔ tɔtrɔ	revise
ame tɔxɛ	personality
mɔnukpɔkpɔ tɔxɛ	privilege
gbememᴐ	track
asitsatsa	trade
dekɔnu	tradition
trafik	traffic
hehe	training
nɔnɔme	trait
nɔnɔmewo	traits
ʋuɖoɖo	transportation
mɔ	trap
gbeɖuɖɔ	trash
vevesesegã	trauma
agbagbadzɛ	tray
kesinɔnu	treasure
dᴐyᴐyᴐ	treatment
ati	tree
dodokpᴐ	trial
ayɛ	trick
daƒe	trigger
ku trikpa	numb
lũ	trim
mᴐzɔ̃zᴐ	trip
kuxi	trouble
atalegbe	trousers
keke	truck
nyateƒe	true
nugo	trunk
nyateƒe	truth
si tsana	creepy
si tsana	mobile
le tsi	bath
ƒo tsi	damp
nɔ tsi dzi	float
Mega tsi dzi o	Don't worry
le tsi dzi	trend
le tsidzi zɔm	sailing
si tsi edzi	excess
si tsi edzi	redundant
ƒo tsi	humid
ƒo tsi	moist
de tsi	soak
tsi tsitre ɖe eŋu	against
tsi tsitre	vertical
ƒo tsi	wet
Tsonga	Tsonga
nu tsɔtsɔ yi	submission
ku tsu	crazy
nuto	tube
blãɖa	Tuesday
dze tugbe	beautiful
edze tugbe ŋutɔ	you are so beautiful
edze tugbe	you are beautiful
nufiafia	tuition
si tu	lame
dɔkɔ	turkey
na	turmeric
trᴐ	turn
klo	turtle
nufiala	tutor
aɖe tutu	dumb
wuieve	twelve
blaeve	twenty
blaeve-vɔ-ɖɛkɛ	twenty-one
Blugbe	Twi
tro	twist
eve	two
ƒomevi	type
ŋutɔŋutɔ	typical
vlo	ugly
xexi	umbrella
nyrui	uncle
egɔme	under
gɔme	underneath
dzᴐgbevᴐetᴐ	unfortunately
tɔxɛ	unique
yunivesiti	university
negbe	unless
na	upon
dugãme	urban
mí	us
zã	use
ŋudɔwɔnu	utility
tsᴐe va	brought
mᴐkeke	vacation
abuidodo	vaccination
abuitike	vaccine
bali	valley
asixᴐxᴐ	value
vovovowo	variety
vovovo	various
agba	vase
si va yi	ago
dzɔ va yi	happened
le vedome	medium
le ve dome	moderate
amagbewo	vegetable
amagbewo	vegetables
ʋu	vehicle
nudzrala	vendor
aɖi	venom
nuwɔƒe	venue
nukpɔkpɔ	version
ŋtᴐ	very
nugo	vessel
le vevem	bitter
le vevem	sour
se veve	regret
didi veviẽ	craving
le veviẽ	important
le veviẽ	relevant
le veviẽ	significant
le veviẽ	vital
tsɔe vɛ	bring
seselelãme	vibe
vɔɖi	vicious
fukpela	victim
video	video
kpᴐtᴐ vie ko	barely
tɔ vie	pause
kpᴐ	view
kɔƒe	village
amevɔ̃ɖi	villain
ahatsitsi	vinegar
ɛ̃ vinye	yes baby
avuwɔwɔ	violence
na	virtual
nukpɔkpɔ	vision
sasrã	visit
nukpɔkpɔ	visual
ɖe vi	useful
me vivim o	boring
gbeɖiɖi	voice
ɣlidodo	volume
to vovo	different
to vovo	distinct
mele vovome o	engaged
to vovo	separate
de vovototo	contrast
de vovototo	distinguish
to vovo	vary
to vovo	weird
wɔe vɔ	done
ɖi vɔvɔ̃	horrible
do vɔvɔ̃	threaten
metsonu vɔ̃wo	consequences
ɖi vᴐvɔ̃	terrible
le vᴐvᴐm	nervous
gbᴐdzᴐ	vulnerable
tsi ʋe	pond
dᴐ ʋᴐnu	judge
ɖo ʋu	commute
ku ʋu	drive
de ʋu	transport
fetu	wage
fetu	wages
ali	waist
lala	wait
subɔla	waiter
nyɔ	wake
nyɔ	wake up
zɔ̃	walk
glĩ	wall
gakotoku	wallet
tsa	wander
di	want
aʋa	war
awudzraɖoƒe	wardrobe
agbaxɔ	warehouse
kpɔnyuiedodo	warning
aʋawɔla	warrior
nye	was
gbeɖuɖᴐ	waste
kpɔ	watch
tsi	water
dzamatre	watermelon
ƒutsotsoe	wave
mᴐ	way
mí	we
gbᴐdzᴐ	weak
gbɔdzɔgbɔdzɔ	weakness
hotsuikpᴐkpᴐ	wealth
gatɔ	wealthy
do	wear
do	wearing
srɔ̃ɖeɖe	wedding
Kuɖa	Wednesday
gbe	weed
kᴐsiɖa	week
kɔsiɖanuwuwu	weekend
kpekpeme	weight
woezɔ̃	welcome
dedienɔnɔ	welfare
Vudo	Well
yi	went
wonye	were
ɣetodoƒe	west
boso	whale
lu	wheat
kekefɔti	wheel
ɖe	whether
dali	whisper
kpe	whistle
ɣi	white
blibo	whole
tagbɔsesẽtɔ	wicked
keke	wide
ahosi	widow
kekeme	width
lɔlɔ̃nu	will
ya	wind
fesre	window
wain	wine
vuvᴐŋᴐli	winter
tutu	wipe
galɛ	wire
nunya	wisdom
didi	wish
adzetɔ	witch
kple	with
manᴐmee	without
gbɔdzɔgbɔdzɔ	witness
nyanu	witty
kple wò	and you
be woanye	in order to
si wobu	estimated
si wobu fɔ̃	damn
si woda ɖi	reserve
si wodina	favorite
le wo dome	around
si woɖe ɖe go	revealed
Mekpɔ wò edidi	I miss you so much
mekpɔ wò edidi	long time no see
si wofi	stolen
na wò	for you
si wogblẽ ɖi	abandoned
Melɔ̃ wò	I like you
Melɔ̃ wò	I love you
melɔ̃ wò	I love you too
si wokpɔ mɔ na	expected
si wole dzadzram	commercial
amegaxi	wolf
lɔ̃ wò	love you
nyɔnu	woman
si womekpɔ kpɔ o	unusual
si womekpᴐ kpᴐ o	strange
nyɔnuwo	women
si womenya o	unknown
nukunu	wonder
ɖo wò nɔnɔmetata ɖem	send me your picture
si wonya	familiar
si wonya	known
esi wònye ko	whatever
esi wònye	since
Melɔ̃ wò ŋutᴐ	I love you so much
ati	wood
alẽfu	wool
nya	word
nyawo	words
dɔ	work
xexeame	world
ŋɔvi	worm
nyi	worn
dzitsitsi	worry
subɔsubɔ	worship
dze	worthy
si wotsᴐ na	dedicated
abi	wound
eii	Wow
si wowɔ na	intended
ke wò ya ɖɛ	how about you
ke wò ya ɖɛ	what about you
si woyɔ	mentioned
si woyra	blessed
si wozã	used
si wɔa nu geɖe	versatile
si wɔ avu	violent
tsɔ wɔ dɔ	execute
si wɔ nuku	fascinating
aleke wɔ	why not
le wɔwɔm nyuie	cautious
dɔ wɔwɔ nyuie	efficiency
wòe wɔ̃	your welcome
tsᴐe wᴐ dᴐ	apply
bla	wrap
adã	wrath
alɔnu	wrist
ŋlᴐ	write
nuŋɔŋlɔ	writing
ŋlɔ	wrote
si wu ale sidze	overwhelming
nyo wu	better
dɔ wum	hungry
gblẽ wu	worse
tsi xaxa	pool
afu xe	foggy
me xe	narrow
ɖe xe	vomit
do xoxo	obsolete
si xɔ asi	premium
si xɔ asi	valuable
wɔa xɔlɔ̃	friendly
si xɔ ŋkɔ	vintage
gbɔ ya	breathe
le ya ƒom	windy
dzidzenu	yard
haha	yawn
Ee	Yeah
ƒe	year
ƒewo	years
nuʋãnu	yeast
aŋgbaɖiɖi	yellow
Ɛ̃	Yes
tututu	yes of course
ƒe yeye na wò	happy new year
tɔtrɔ yeye	revolution
tsɔe yi	convey
tsɔ yi	deliver
tse	yield
si yina gagbɔna	cycle
te yi	shift
tsᴐe yi	submit
tsɔ yi teƒe bubu	transfer
ti yome	chase
wò	you
ènye	you are
wòezᴐ	you are welcome
Ènya	You know
wò	your
wòezɔ	you’re welcome
sɔhɛ	youth
vivi	yummy
dzigbe zã nyuie na wò	happy birthday
ga zazã	finance
medzᴐna zi geɖe o	rarely
ɖe zɔ̃	march
wòe zɔ	you're welcome
le zɔzɔm	walking
ɖe zᴐ	move
va zu	became
