a little	маҷк
a lot	арацәа
a lot of	ирацәаны
abandon	агәыгәҭажьра
abandoned	ихылаԥшыдоу
abide	ақәныҟәара
ability	абаҩхатәра
Abkhaz	Аҧсуа
Abkhaz	Аҧсшәа
able	алшара змо
above	аханы
abroad	нырцә
absence	аҟамзаара
absent	иҟам
absolutely	хымԥада
absorb	ахәлабгара
abstract	абстрактә
absurd	абсурдтә
abundance	амцхә
abundant	абеиа
abuse	аӷьра
accent	акцент
accept	адкылара
access	анеирҭа
accident	амашәыр
accommodation	анхарҭаҭыԥ
accomplish	анагӡара
accomplished	инҵәаз
according	ишаҳәо ала
account	аԥхьаӡара
accuracy	аиашаԥҵәара
accurate	аиқәҷаб
accused	аара адҵара
ache	ахьаа
achieve	азнеира
achievement	ақәҿиара
acknowledge	адырра
acquaintance	аибадырра
acquire	аиура
acquired	аиура
acquisition	арҳамҭа
acquisition	арҳара
across	аиасра
act	аусура
action	аусура
active	активтә
activities	аусушьа
activity	активра
actor	актер
actual	актуалра зцу
actually	ииашаҵәҟьаны
acute	аҵры
adapt	анраалара
add	ацҵара
addicted	ахьыԥшытә
addition	ацҵа
addition	ахарҭәаара
additional	инаццҵаны
address	адрес
adequate	иашьашәало
adjacent	агәыларатәи
adjective	аҟазшьарба
adjust	аиҿкаара
admire	ашанхара
admit	адырра
adopt	ԥас аҟаҵара
adorable	иблахкыгоу
advance	заа
advanced	аԥхьагыларатә
advantage	аԥыжәара
adventure	аҟала
adverb	ацынгыла
advertisement	аӡыргара
advertising	аӡыргара
advertising	аӡыргара ашьҭра
advice	алабжьара
advise	абжьагара
advise	иабжьеигеит
advocate	адукат
aesthetic	аестетикатә
affair	аус
affect	аннырра
affection	адҳәалара
afford	азин аҭара
affordable	имариоу
afraid	ашәара
after	ашьҭахь
afternoon	шьыбжьон
afterwards	пыҭрак ашьҭахь
again	даҽазнык
against	аҿагылара
age	ақәра
agency	агентра
agent	агент
aggressive	агрессиатә
agile	аихатыр
ago	шьҭахьҟа
agree	ақәшаҳаҭра
agreement	аиқәшаҳаҭхара
agriculture	ақыҭанхара
ahead	аԥхьа
aid	ацхыраара
aim	ахықәкы
air	аҳауа
airport	аҳаирбаӷәаза
aisle	ацәаҳәақәа рыбжьысра
alarm	агәҭынчымра
alcohol	алкоҳоль
alert	агәҭынчымра
alive	зыԥсы то
all	зегьы
all right	ибзиоуп
all the best	иреиӷьӡоу зегьы
allow	алшара аҭара
allowed	иҟалон
almost	зынӡаск
alone	ихала
along	иаваршәны
already	уаҳа
Alright	Ибзиоуп
also	иара убас
alternative	альтернативтә
although	аха
always	есымша
am	аҟазара
amazing	иџьоушьаша
ambiguous	ҩ-ҵакык змоу
ambition	амбициа
ambitious	амбициатә
amend	ариашара арчеира
amid	абжьара
among	агәҭаны
among us	ҳаҩныҵҟа
among us	ҳабжәара
amount	аԥхьаӡара
amount	аицҵалыҵ
amusing	агәмырҿыӷьга
analysis	аҭҵаара
analysis	анализ
ancestors	ҳазхылҵыз
anchor	аԥырсал
ancient	ажәытәтәи
and	иара убас
and you	уаргьы
angel	амаалықь
anger	ацәгьара
angle	амаалықь
angry	абааԥсы
animal	аԥстәы
ankle	ашьаҳәырӡыӡ
anniversary	ашықәсхыҵра
announcement	алаҳәара
annoy	аргәамҵра
annoyed	игәамҵуа
annoying	узыргәамҵуа
annual	есышықәсантәи
anonymous	анонимтә
another	егьы
answer	аҭак
answer	аҭак аҟаҵара
anticipate	аԥеиԥшбара
anxiety	агәҭынчымра
anxious	иҭынчым
any	иарбанзаалак
anymore	уаҳа
anyone	аӡәырҩы
anything	акагьы
anyway	захьынџьара
anyways	зеиԥш ыҟамзаргьы
apart	хазы
apartment	ауада
apologize	аҭамзаара аарҭшра
apparent	иубартәы иҟоу
apparently	акәхап
appeal	ахырхара
appear	ацәырҵра
appearance	аԥшра
appeared	ацәырҵра
appetite	аппетит
apple	аҵәа
application	арзаҳал
apply	ахархәара
appointment	аиԥылара
appreciate	пату ақәҵара
appreciation	аҭабура
approach	азнеишьа
appropriate	иақәшәо
approval	азыразра
approve	ашьақәырӷәӷәара
approved	азыразра
approved	иазыразхоу
approximately	иҿырԥшны
april	мшаԥымза
arbitrary	машәырлатәи
architect	архитектура
architecture	архитектура
archive	архив
archive	архив аҭагалара
are you	уара
are you busy	уеилахома
are you married	ԥҳәыс дааигахьома
are you married or single	ԥҳәыс даажәгахьома мамзаргьы шәхала шәыҟо
Are you still there?	Ара шәыҟоума?
are you there	уа уҟома
area	аҵакырадгьыл
argue	аимакра
argue	аимак-аиҿакра
argument	аҵаҵӷәы
arise	аизҳара
arm	анапы
army	аибашьратә
around	акәша-мыкәша
arrange	аиҿкаара
arrangement	аиқәшаҳаҭра
arrival	ааира
arrive	аара
arrived	сааит
arrogant	иԥагьоу
arrow	ахәымпал
art	аҟазара
article	ахәҭаҷ
article	астатиа
artificial	иԥсабаратәым
artist	артист
as	ас еиԥш
as long as	уи аамҭазы
as well	ишаҳәо ала
as well as	аиашазы
ash	ахәа
ashamed	иԥхашьаԥхаҵо
ask	азҵаара ақәыргылара
asked	сазҵааит
asleep	ацәара
aspect	аспект
Assamese	Ассамиз
assault	ақәылара
assembly	аизгара
assembly	аилазаара
assertive	зҽадызцалоу
assess	ахәшьара аҭара
assessment	ахәшьара аҭара
asset	аобиект
assets	аресурсқәа
assign	аҭара
assignment	адҵа
assist	ацхыраара
assistant	ацхырааҩ
assistant	ацхыраара
associate	адҳәалара
associated	изыдҳәалоу
association	ассоциациа
assume	агәаанагара аарԥшра
assumption	агәҭакы
at least	аҵыхәтәан
ate	исфеит
athlete	аспортсмен
attach	аидҳәалара
attached	еиду
attachment	агәылаҵа
attack	ажәылара
attempt	аҽазкра
attend	аҭаара
attendance	аҭаара
attention	азҿлымҳара
attitude	азнеишьа
attract	азааигәатәра
attraction	аттракцион
attractive	улаԥш зыдхало
attribute	атрибут
audience	ахәаԥшцәа
august	нанҳәа
aunt	саб иаҳәшьа
aunty	аб иаҳәшьа
authentic	аиашаҵәҟьазаара
author	автор
authority	амчра
autumn	ҭагалан
available	иахьауа
average	агәҭатәи
avoid	аҽацәыхьчара
awake	ааԥшра
award	аҳамҭа
aware	идырны
aware	аилкаара
awareness	адырра
away	наҟ
awesome	иџьоушьаша
awful	ҳаӷеимшхаратәи
awkward	еилҟьам
Aymara	Аимара
baby	амаалыкь
bachelor	абакалавр
back	абӷа
back	шьҭахьҟа аара
background	ақәыԥшылара
bad	ацәгьа
bag	амакәан
bait	ахьырԥшыга
bake	аџьра
bakery	ачаӡырҭа
baking soda	афатә иарҭо асода
balance	абаланс
balance	абаланс ашьақәыргылара
ball	ампыл
Bambara	Бамбара
banana	абанан
band	агәыԥ
bang	аҭҟәацра
bank	абанк
bar	абар
barely	аарла
bargain	аиқәшаҳаҭра
bark	ашра
barley	ақьар
barrier	абариер
base	ашьаҭа
based	ашьаҭа змоу
basement	афундамент
basement	аӷәраҵа
basic	ихадоу
basically	ҵакыла
basil	абазилик
bastard	агмыг
batch	апартиа
batch	агәыԥ
bath	аванна
bathroom	ванна
battery	абатареа
battle	аибашьра
bay	аӡыбжьаха
be	аҟазаара
be careful	згәы зҽану
beach	аплиаж
beam	ашәахәа
beans	аҟәыд
bear	амшә
bear	ахгара
beard	аԥаҵа
bearing	ачҳара
beast	ацәыршәага
beat	аисра
beat	ааха
beautiful	иԥшӡоуп
beauty	аԥшӡара
became	иҟалаз
because	избанзар
become	аҟалара
bed	аиарҭа
bedroom	ашьҭаларҭа
bee	ашьха
beef	ажәжьы
beer	ауараш
before	аԥхьа
began	салагахьан
begin	алагара
beginning	алагала
behalf	ахьӡала
behave	ахымҩаԥгашьа
behavior	ахымҩаԥгашьа
behaviour	ахымҩаԥгашьа
behind	ашьҭахь
belief	агәрагара
believe	агәра гара
belly	амгәа
belong	атәра
beloved	бзиа ирбо
below	аҵаҟа
belt	амаҟа
bench	аҟәардә
bend	архәара
beneath	аҵаҟа
benefit	ахашәала
benefits	ахашәала
beside	ааигәа
besides	уи адагьы
best	еиӷьӡоу
best of luck	аманшәалара
best regards	ҳаҭырла
better	еиӷьу
between	агәҭа
beverage	арыжәтә
beyond	ашьҭахь
Bhojpuri	Бипури
bias	анаскьагара
biased	ииашам агәаанагра змоу
bicycle	амаланыҟәа
bid	ахә ақәҵара
big	аду
bike	амаланыҟәа
bill	аԥхьаӡара
bind	алашәы
bird	аҵыс
birthday	амш ира
bit	маҷк
bit	ацҳара
bite	ацҳара
bitter	аша
black	аиқәаҵәа
blade	аԥаҵасага
blame	ахараҵара
blank	абланк
blanket	ахыза
blast	атҟәацра
bleach	аршкәакәара
blend	аиларԥсара
bless	аныҳәара
bless	ақәныҳәара
blessed	иныҳәо
blind	алашә
bliss	насыԥ амазаара
block	аблок
block	аблокада азура
blood	ашьа каҭәара
blood	ашьа
bloom	ашәҭкакаҷра
blow	аҭәҳәара
blue	жәҩангәыԥштәыла
blunt	абзамыҟә
board	анапхагара
board	аборт
boat	анышь
body	ацәеижь
boil	аиларшра
bold	апаш
bond	аидҿаҳәалара
bone	абаҩ
book	ашәҟәы
boost	аиҳаракра
booster	абустер
boot	аботинка
boots	аботинкақәа
border	аҳәаа
bore	агәҿыӷьра
bored	угәы зырҿыӷьуа
boring	угәы зырҿыӷьуа
born	аира
borrow	уаара агара
boss	анаԥхгаҩы
both	аҩбагьы
bother	аргәаҟра
bottle	аԥаҭлыка
bottom	ҵаҟа
bought	иааҳхәаз
bounce	аԥара
bound	аидҳәалара
bound	аибаркыра
boundaries	аҳәаақәа
bow	абант
bow	ахырхәара
bowl	асындықәра
bowl	аҿа
box	акәалаԥ
boy	аҷкәын
boyfriend	аӡәы иҷкәын
bracelet	анапхаҵа
brain	ахшыбаҩ
branch	аусхкы
branch	амахәҭа
brand	абренд
brave	агәымшәа
breach	аилагара
bread	ача
break	аангылара
break	аԥыхра
breakfast	шьыжьхьа
breast	агәы
breast	агәышԥы
breath	аҳауа агара
breathe	аԥсыԥ агара
breed	ажәла
brick	ақьырмыт
bride	хаҵа ицараны иҟоу
bridge	ацҳа
brief	иаазыркьаҿу
bright	алаша
brilliant	абриллиант
bring	аагара
bro	сашьа
broad	аборт
broad	анапхгара
broadcast	атранслиациа амҩаԥгара
broke	иԥҽыз
broken	иԥҽыз
broom	аҩмсаг
brother	аиашьа
brother in law	амаҳә
brought	иаазгаз
brought	аагара
brown	аҩабжьа
brush	арыцқьара
bucket	аведра
buddy	аҷкәын
budget	абиуџьет
bug	агха
bug	абжы
build	аргылара
building	ахыбра
built	аргылара
bulk	амасса
bull	ацә
bully	аршәара
bully	аҷырпаӷь
bump	акыдҟьара
bunch	ажьымжәа
bunch	анапаҟьа аҿаҳәара
bundle	анапаҟьа аҿаҳәара
burden	аидара ақәҵара
burden	аидара
buried	анышә иамадоу
burn	абылра
burst	атҟәацра
bury	анышә аҭара
bus	автобус
bush	ачықь
business	аус
bust	абиуст
bust	ажәра
busy	еилахоу
but	аха
butter	ахәша
butterfly	аԥарԥалыкь
button	аҳәынҵәра
buy	аахахәара
by	уаанӡа
by the way	мамзаргьы
bye	абзиараз
cabbage	акапуста
cabinet	ауада
cage	аҭра
cake	аторт
calf	аҳәыс
call	аҿыҭра
call me	исызҿыҭы
called	ахьӡ аҭан
calm	иҭынчу
came	сааит
campaign	агитациа азура
campaign	акампаниа
can	азыманшәалара
can't	алшара амамзаара
Cancel	Аԥыхра
cancer	акьыба
capable	аҟыбаҩ бзиа змоу
capacity	амчхара
capital	аҳҭнықалақь
caption	анапынҵа
capture	акра
car	амаланыҟәа
career	акариера
careful	зыхшыҩ азызышьҭуа
carefully	гәҽанызаарыла
careless	акы хьаас измам
caring	ахӡыӡаара здыруа
carpenter	амаӡаҩы
carpet	ауарҳал
carrot	аҷых
carry	агара
carry on	ацҵара
carry out	анагӡара
case	ахҭыс
cash	аԥара наԥынҵа
cast	аршәра
cast	анаршә
castle	аханбаа
casual	есымшатәи
cat	ацгәы
catch	акра
category	акатегориа
cattle	арахә рацәаны
caught	искит
cause	амзызс
caution	агәҽанызаара
cautious	згәы зҽану
cave	аҳаԥы
cease	аанкылара
ceiling	аҭуан
celebrate	аныҳәа амҩаԥгара
cell	аклетка
center	ацентр
century	ашәышықәса
cereal	аԥалқәа
ceremony	ацереммониа
certain	зыгәра угаша
certain	иашоуп
certainly	ҳәарада
certificate	асертификат
chain	аибаркыра
chair	аҟәардә
challenge	аԥышәара
chance	алшара
change	аԥсахра
chaos	аҩнытәи аусқәа
character	алеишәа
characteristics	аҟазшьарба
charge	аиҵаҵа
charity	агәыҳалалра
charming	убла хызкуа
chart	аграфик
chart	адиаграмма
chase	ашьҭазаара
chat	ачат
cheap	зыхә ҳаракым
cheat	амч аҳәара
cheating	амцҳәара
check	агәаҭара
cheek	аӡамҩа
cheer	агәырӷьара
cheerful	згәы ҭгәырӷьаауа
cheers	шәныҳәаз
cheese	ашә
chemistry	ахимиа
cherish	аҳаҭыр ақәҵара
chess	ашахмат
chest	агәышԥы
chew	ажаҳәара
chicken	акәҷышь
chief	ашеф
child	ахәыҷы
childhood	ахәыҷра
children	ахәыҷқәа
chill	ахьҭа
chimneys	алҩацарҭа
chin	ацламҳәа
chocolate	ашоколад
choice	алхра
choose	алхра
chop	аԥҟара
chores	аҩнытәи аус
chubby	аӡамҩа хыгьежьаа
church	ауахәама
cinnamon	акорица
circle	агьежь
circumstances	аҭагылазаашьа
citizen	анхаҩы
city	ақалақь
claim	аҭаххара
clarify	аилыркаара
class	акласс
clay	анышәаԥшь
clean	ацқьа
clear	аилкаара
clear	ацқьа
clerk	аусзуҩы
clever	аҟәыш
client	аклиент
cliff	аԥаҩ
climate	аклимат
climb	ахалара
clingy	иудҷабло
clock	ассаҭ
close	аркра
closet	ашьқьаԥ
cloth	амаҭәа
clothes	амаҭәа
cloud	аԥсҭҳәа
cloudy	аԥсҭҳәақәа
clown	аклоун
clue	ацаԥха
clumsy	еилҟьам
cluster	акластер
coach	азыҟаҵаҩ
coal	арацәа
coast	аԥшаҳәа
coat	апальто
coffee	акаҳуа
cognitive	акогнитивтә
coincidence	аиқәшәара
cold	ахьҭа
collapse	ахыбгалара
collar	ахәда
colleague	акколега
colleagues	аколлегацәа
collect	аизакра
collection	аколлекциа
college	аколледж
color	аԥштә
colorless green ideas slept furiously	аԥштәы змам ииаҵәоу аидеақәа гәеибаркырала ицәан
colour	аԥштәы
column	аколонка
comb	ахҳәа
comb	аҳәара
combination	аицааира
combine	аиԥшьра
come	аара
come here	араа уааскьеи
come on	ирлас
comfort	аманшәалара
comfortable	иманшәало
coming	аара
coming soon	уажәыҵәҟьа иҟало
command	акоманда
comment	акомментариақәа аҟаҵара
commercial	ареклама
commercial	акоммерциатә
commission	акомиссиа
commit	аҟаҵара
commitment	ахыдҵа
committed	иҟасҵеит
commodity	атоуар
common	иаабац
communicate	аиҿцәажәара
communication	аимадара
community	аилазаара
commute	анеира
companion	акомпанион
company	акомпаниа
compare	аҿырԥшра
comparison	аиҿырԥшра
compassion	арыцҳашьара
compassionate	арыцҳашьара злоу
compatible	еишьашәало
compete	аицлабра
competent	издыруа
competition	аицлабра
competitive	аконкуренциа злоу
complain	агәынамӡара
complain	агәынамӡара аарԥшра
complaint	ашшра
complement	акомплемент
complete	ахыркәшара
completely	зынӡаск
complex	ицәгьоу
compliance	аиқәшаҳаҭра
complicated	ауадаҩ
compliment	акомплимент
comply	анагӡара
composition	ахыҭҳәаа
compound	еилоу
comprehension	аилкаара
comprehensive	ганрацәалатәи
compromise	азааибагара
compulsory	мчылатәи
computer	акомпиутер
concentrate	аҽеизакра
concept	аконцепциа
concern	агәҭынчымра аарԥшра
concerned	ахьаакра
concert	аконцерт
conclusion	алкаа
concrete	хықәкылатәи
condition	аилаӡара
conditions	аилаӡара
conduct	анапхгара
conference	аконференциа
confess	аиашаҳәара
confidence	агәра зго
confident	агәра зго
confirm	ашьақәырӷәӷәара
conflict	аконфликт
confused	ииҳәо-ииуа иақәымшәо
confusion	аилаҩеиласра
congrats	адныҳәалара
congratulation	адныҳәалара
congratulations	адныҳәаларақәа
conjunction	аидҳәалага
connect	аидҵара
conquer	ампыҵахалара
conscious	ахдыр
consciousness	агәаҟәышра
consent	аиқәшаҳаҭхара
consent	ақәшаҳаҭра
consequences	аҭагылазаашьақәа
conservation	ахьчара
conservative	згәы зҽану
consider	агәаанагара
considered	иԥхьаӡоуп
consist	ашьақәгылара
consistency	аишьҭаргылашьа
consistent	аишьҭаргылашьатә
constant	есымшатәи
constantly	есымша
constipation	аимгәакра
construction	аконструкциа
construction	аргылара
consume	ахархәара
consumption	ахарџь
consumption	ахархәара
contact	аконтакт
contagious	иҿку
contain	алаҵара
contains	аҵанакра
contemporary	ҳаамҭазтәи
contempt	агәымхашьара
content	аконтент
contest	аицлабра
context	аконтекст
continent	аконтинент
continue	ацҵара
contract	аконтракт
contrast	аиԥшымзаара
contribute	алаҵара
contribute	алагалара
contribution	алагала
control	аконтроль азура
control	аконтроль
controversial	аимактә
convenience	агәраргара
convenient	аманшәала
conversation	аиҿцәажәара
convert	аконвертациа аҟаҵара
convey	ацҳара
convince	агәраргара
convince	агәра ахарҵара
convinced	агәраргара
cook	афатәҟаҵара
cooking	афатә аҟаҵара
cool	ибзиаӡоуп
cooperation	аусеицуура
cope	амч ақәхара
copper	абҩа
core	ихадоу
corn	аԥш
corner	акәакь
correct	ииашоуп
cost	ахәԥса
costume	акостиум
cottage	акоттедж
cotton	абамба
couch	атахта
couch	ақәҩара
cough	аимҳәа
could	сазыманшәалан
council	аилазаара
count	аԥхьаӡара
counter	адәқьанеишәа
country	ақалақь
countryside	ақыҳа
couple	ҩба
courage	агәымшәара
course	амзыз
court	акорт
court	аӡбарҭа
courtesy	аҳаҭырқәҵара
cousin	абиешьеиԥҳа
cover	ахҩара
cow	ажә
coward	ашәаргәында
cozy	аманшәала
crab	ашьышьыркьата
crack	аиҟәԥара
craft	анапҟазара
crap	агаӡабызшәа
crash	амашәыр
crash	абзиабара
craving	иӷәӷәаны аҭаххара
crawl	аҳәазара
crazy	ахага
create	аԥҵара
creative	икреативтәу
credit	акредит
creep	акамыртата
creepy	игәырхынҳәыгоу
crew	аекипаж
crime	ацәгьаҟаҵара
crime	акриминал
cringe	акриндж
crisis	акризис
criteria	акритериа
critical	критикала
criticism	акритика
crop	аԥҟара
crops	аҭоура
cross	аиасра
crow	аҟәраан
crowd	ауаажәларр
crowded	ихарҭәаау
crown	акорона
crucial	акрызҵазкуа
cruel	агәымбыл
cruise	акруиз
crush	аилырбгара
crush	абзиабара
cry	аҵәыуара
cucumber	анаша
cuddle	адырӷәӷәалара
culture	акультура
cunning	агызмалра
cup	аҭаҟә
cupboard	ашьқаԥ
curb	аанкылара
curb	абордиур
cure	ахәшәтәра
curfew	акоменданттә сааҭ
curiosity	адырраҭахра
curious	зегь здырыц зҭаху
curly	ахахәырфы
currency	аԥара
current	уажәтәи
currently	уажәазы
curse	ашәира
curtain	аԥарда
cushion	ахчы
custom	ашьцылара
custom	атрадициа
customer	аклиент
customs	ашьцыларақәа
customs	атрадициақәа
cut	аԥҟара
cute	ишԥабзиоу
cycle	амаланыҟәала аныҟәара
cycling	амаланыҟәара
dad	аб
daddy	папа
daily	есыҽнытәи
dairy	ахштә
dairy	амшынҵа
dam	аӡкыра
damage	ааха
damn	аҩсҭаа ихәхааит
damp	аԥсаҳәа
dance	акәашара
danger	ашәарҭара
dangerous	ашәарҭазаара
dangerous	ишәарҭоу
dark	аиқәаҵәа
darling	сыхазына
dash	атире
data	амш
data	аинформациа
date	амш
date	аиқәшәара
daughter	аӡӷаб
day	амш
dead	иԥсу
deadline	анҵәара аамҭа
deaf	адагәа
deal	аиқәшаҳаҭра абжьгара
dear	ҳаҭыр зқәу
Dear All	Ҳаҭыр зқу зегьы
Dear Customer	Ҳаҭыр зқәу аклиент
Dear Parents	Ҳаҭыр зқәу аҭаацәа
Dear Sir	Ҳаҭыр зқәу
Dear students	Ҳаҭыр зқәу астудентцәа
Dear Team	Ҳаҭыр зқәу акоманда
death	аԥсра
debate	аимак-аиҿак
debit	адебит
debris	аԥҽыхақәа
debt	ауал
decade	жәашықәса
decay	жәашықәса
deceased	иҿкоу
deceive	амц аҳәара
december	ԥхынҷкәын
decent	жәашықәса
decide	аӡбара
decided	иӡбоу
decision	аӡбара
deck	ахыӷәра
decline	агхара
decrease	агырхара
dedicated	азкызаара
dedication	гәык-ала азыҟалара
deed	аус
deed	ахымҩаԥгашьа
deep	аҵаула
deer	абнацә
default	амҳәара
defeat	аиааира
defeat	аиааира агара
defend	ахьчара
define	аилкаара аарԥшра
definitely	еилкаа
definition	аҵакы
definition	аанагара
degree	аҩаӡара
delay	ахырԥара
delayed	анаскьагара
delete	аныхра
deliberate	цасҳәа иҟаҵоу
delicate	иаамсҭашәоу
delicious	ихаау
delight	акы азы агәырӷьара
delighted	згәалаҟазаара бзиоу
deliver	азнагара
delivered	инагоу
delivery	азнагара
demand	адҵаҟаҵара
demanding	злеишәа цәгьоу
democracy	адемократиа
demon	аџьныш
demonstrate	аарԥшра
denied	иақәшаҳаҭымхаз
density	ажәпара
dentist	адантист
deny	мап акра
department	аҟәша
departure	ацара
depend	ахьыԥшызаара
deploy	аркәадара
deposit	адепозит
depressed	агәкаҳаратә
depression	агәкажьра
depth	аҵаулара
describe	ахцәажәара
description	ахцәажәара
desert	асакара
deserve	џьабаала ирҳау
design	арҿиара
design	адизаин
designation	ахҵара
designation	аанагара
desire	агәаҳәара
desk	аишәа
despair	агәы каҳара
desperate	згәы каҳау
despite	уи адагьы
dessert	асакара
destination	уахьнеиуа аҭыԥ
destiny	алахьынҵа
destroy	аилырбгара
destruction	аилырбгара
detail	адеталь
details	ахәҭаҷқәа
detect	аԥшаара
determination	агәыӷьра
determine	ашьақәыргылара
determined	ишьақәыргылан
devastated	ахьаацәгьа змоу
develop	арҿиара
developed	изҳазыӷьоу
development	арҿиара
device	адеваис
devil	аҩсҭаа
devoted	азкызаара
Dhivehi	Дивеи
diabetes	адиабет
diarrhea	адиареа
diary	амшынҵа
dictionary	ажәар
did	иҟасҵеит
die	аԥсра
died	иԥсыз
diet	адиета
difference	аиԥшымзаара
different	акы еиԥшым
difficult	ицәгьоу
dig	арашәара
dignity	ахаҭабзиара
diligent	згәы ақәызкуа
dinner	шьыбжьхьа
dip	аӡааҟәрылара
direct	ишиашо
direction	ахырхарҭа
director	анапхгаҩы
dirt	аҟьашьра
dirt	агәам
dirty	иҟашьу
disable	иззлымшо
disabled	аусура злымшо
disappear	аӡра
disappointed	агәы ахыршәара
disaster	арыцҳара
discard	мап ацәкра
discharge	аусура амхра
discipline	алеишәа
discount	агыжьра
discover	аарԥшра
discrimination	адискриминациа
discuss	ахцәажәара
discussion	алацәажәара
disease	ачымазара
diseases	ачымазарақәа
disguise	амаскировка азура
disgusting	алкаара
dish	афатәхкы
dish	асаан ду
dishes	асаанқәа
dishes	афатәхкқәа
dismiss	аушьҭра
dispatch	ашьҭра
display	адисплеи
disposal	ахархәара аҭара
dispute	аиқәшаҳаҭымхара
distance	абжьазаара
distinct	акы еиԥшым
distinguish	аиҩдыраара
distress	арыцҳара
distribution	аихшара
district	аокруг
disturb	ажәа аԥыҩлара
ditch	ажра
dive	аӡааҟәрылара
diverse	еиуеиԥшым
diversity	ахаҭабзиара
divide	ашара
divine	анцәа ишииҳәара
divorce	аилыҵра
dizzy	аблахаҵ гьыжьра
do	аҟаҵара
do you	уара
do you love me	бзиа сыубома
doctor	аҳақьым
document	адокумент
does	аҟаҵара
dog	ала
Dogri	Догри
doing	уажәы акы аҟаҵара
doll	акьанџьа
domain	адомен
domestic	аҩнытәи
dominant	адоминант
Don't worry	Умшәан
donate	аԥара азышьҭра
done	иҟаҵоуп
donkey	аҽада
dope	анаркотик
double	ҩбаны иҟоу
doubt	агәыҩбара
dough	амажәа
down	ҵаҟа
download	аҭгара
draft	аҿырԥштәы
draft	аиқәаҵәа
drag	ахара
drain	аҭарбара
drama	адрама
draw	асахьа аҭыхра
drawer	аидчаԥала
drawing	аҭыхра
dread	ашәара
dread	ашәарҭа
dream	агәаҳәара амазаара
dream	аԥхыӡ абара
dress	аҵкы
drill	парпантала акылҵәара
drink	ажәра
drive	амашьына ныҟәцара
drop	ампыҵшәара
dropped	ацәкаҳара
drought	аарҩара
drunk	ижәны иҟоу
dry	аба
duck	акәата
dude	аҷкәын
due	иҟаҵатәу
due to	уи инақәыршәаны
dull	агаӡа
dumb	агаӡҳәы
dump	агәамеизакырҭа
dump	аԥара
duration	акыраамҭа
during	уи аамҭазы
dust	асаба
dust	асаба арыцқьара
duty	ауал
duty	аԥхықәра
dwell	анхара
dying	иԥсуа
each	иарбанзаалак
each other	ҳара-ҳара
eager	азхьра
eagle	ауарба
ear	алымҳа
earlier	зааӡа
early	шаанӡа
earn	арҳара
ears	алымҳақәа
earth	адгьыл
earthquake	адгьылҵысра
ease	арласра
easily	имарианы
east	амраҭашәара
easy	имариоу
eat	акрыфара
eating	акрыфара
economic	аекономикатә
economy	аекономика
edge	акьыԥшь
edit	аредактура азура
education	аҵара
effect	аеффект
effective	ахырҳага
efficiency	алҵшәара
efficient	ахырҳага
effort	аҽазышәара
egg	акәтаӷь
eggplant	аҟандыл
ego	аего
eight	ааба
eighteen	жәаа
eighty	ԥшьынҩажәа
either	мамзаргьы
elaborate	архиара
elbow	амышьхәылҵ
elder	аиҳабра
elderly	еиҳабу
elegant	зычаԥашьа бзиоу
element	аелимент
elephant	аслан
eleven	жәеиза
eligible	иақәшәо
eliminate	аныхра
else	даҽакы
embarrassed	иԥхашьо
embarrassing	иԥхашьо
embrace	агәыдыҳәҳәалара
emerge	ацәырҵра
emergency	аҷыдалкаатә ҭагылазаашьа
emotional	аемоциатә
empathy	аицгәырҩара
emphasis	алкаара
emphasize	аҵышьра
employee	аусзуҩы
employees	аусзуҩцә
employer	аусураҭаҩ
employment	аусдкылара
empty	иҭацәу
enable	алшара аҭара
encounter	аинҟьара
encourage	агәазҭанаҵара
end	аҵыхәтәа
end	алгара
endangered	ианыӡаараны иҟоу
endeavor	аҽазышәара
endurance	анарха
endure	ачҳара
endure	ахгара
enemy	аӷа
energy	аенергиа
engage	ахгәарԥхара
engaged	иалархәу
engagement	аизҳәара
engagement	аҳәара
engine	амотор
engineer	аинџьныр
English	Англыз бызшәа
enhance	аиӷьтәра
enjoy	агәырӷьара
enormous	идуӡӡоу
enough	азхара
ensure	агәраргара
enter	аҩналара
entertainment	агәмырҿыӷьра
enthusiasm	аентузиазм
enthusiastic	игәырӷьаҵәа иҟоу
entire	зегьы
entitled	азин змоу
entity	аҵакы
entrance	аҩналарҭа
entrepreneur	анаплакҩы
envelope	аконверт
environment	акәша-мыкәша иҟоу
envy	ашьыцра
epic	аепикатә
epidemic	апандемикатә
equal	еицырзеиԥшу
equipment	амаҭәахә
equity	аҵабыргра
equivalent	аеквивалент
eraser	аныхга
error	агха
escape	аҽыҵәахра
especially	еиҳа
essay	ахыҭҳәаа
essence	аҵакы
essential	ихадоу
establish	ашьақәырӷәӷәара
established	ишьақәыргылоу
estate	амазара
estimate	ахәшьара аҭара
estimated	ахәшьара змоу
etc	уб егь
eternal	наунагӡатәи
ethics	аетика
evaluate	ахәшьара аҭара
evaluation	ахәшьара
evaluation	ахәшьара аҭара
even	уи адагьы
even though	аха
evening	ахәылԥаз
event	ахҭыс
eventually	акраҵанакуа
ever	ианакәзаалак
every	есымша
everybody	зегьы
everyone	дарбанзаалак
everything	зегьы
evidence	иубарҭоу
evil	абааԥсы
evolution	аеволиуциа
evolve	аҿиара
Ewe	Иуи
ex	уаанӡатәи
exact	ииашоу
exactly	иҵабыргыҵәҟьаны
exam	аԥышәа
examine	аԥышәара
example	аҿырԥштәы
exceed	аԥгара
excellent	ибзиаӡоуп
except	ада
exception	аҷыдалкаа
excess	амцхәра
excessive	иахырҟьоу
exchange	аиҭныԥсахлара
excited	згәы шьҭыҵуа
excitement	абыжкра
exciting	угәалаҟазаара шьҭызхуа
exclusive	зеиԥшыҟам
excuse	аҭамзаара
excuse me	саҭамыз
execute	анагӡара
execution	анагӡатәы
executive	анагӡаратә
exercise	азыҟаҵара
exercise	аҽаршьцылара
exhaust	амчыдатәра
exhausted	узырааԥсоу
exhibit	ацәыргақәҵара
exhibition	ацәыргақәҵа
exist	аҟазаара
existence	аҟазаара
existing	иҟаҵәҟьоу
exit	адәылҵырҭа
exit	адәылҵра
expand	аиҵыхра
expect	аԥеиԥшзаара
expected	узықәгәыӷуа
expected	узықәгәыӷуаз
expenses	ахарџь
expensive	зыхә ҳараку
experience	аԥышәа
experiment	аԥышәа
expert	аексперт
expired	анҵәара
explain	аилыркаара
explanation	аилыркаара
exploit	ахрхәара
explore	аҭҵаара
export	аекспорт ахь ашьҭра
expose	аҵхра
exposed	ихьчам
exposure	аекспозициа
express	арбара
expression	аҳәара
extend	арҭбаара
extended	еиҵыху
extension	арҭбаара
extent	арҭбаара
external	аҩныҵҟатҽи
extinct	иҟам ианыӡаахьоу
extra	ихарҭәаау
extract	алкаа
extraordinary	аҷыдалкаатә
extreme	аекстрим
extremely	иҷыданы
eye	ала
eyes	аблақәа
fabric	аба
fabulous	иџьашьахәу
face	аҿы
face	аинҟьара
facilitate	арманшәалара
facilities	аманшәалара
facility	ахархәага
fact	аҵабырг
factor	афактор
factory	азауад
facts	афактқәа
fade	аҩара
fail	аҵарбгара
failed	иуқәманшәалахаз
failure	аҭабгара
failure	аҭабгарҭа
faint	алаԥсра
fair	зыгәра угаша
fairly	даара
fairy	алакәтә
faith	ицқьоу
faith	ииашоу
faithful	агәакьа
fake	аԥаршеи
fall	акаҳара
FALSE	амц
fame	ахьӡ
familiar	изышьцылоу
family	аҭаацәа
famine	амлакра
famous	еицырдыруа
fan	аҿынҵәааҩы
fan	афен
fancy	агәаԥхара
fantastic	афантастикатә
far	ихараны
farewell	аиԥырҵра
farm	аферма
farmer	арахәааӡаҩы
fascinating	иблахкыгоу
fashion	амода
fast	ирласу
fat	ашәпа
fatal	аџьалтә
fate	алахьынҵа
father	аб
fatigue	ааԥсара
fault	ахара
favorite	бзиа избо
favour	амаҵзура
favourite	бзиа избо
fear	ашәара
feast	ачаражәра
feather	ахӡы
feature	аҷыдара
features	аҷыдарақәа
february	жәабранмза
fed up	акрысфацәеит
fee	ахәԥса ахшәаара
fee	ахә
feed	акраҿаҵара
feedback	аимадара
feel	анырра
feel	ацәанырра
feeling	ацәанырра аиура
feet	ашьаргәыҵа
fell	икаҳаит
fellow	арԥыс
felt	иснырит
female	аԥҳәыс
fence	аанда
fertile	иԥсылоу
festival	афестиваль
fetch	аагара
fever	арыхьҭашьра
few	маҷк
fewer	имаҷны
fiance	аԥҳәысҳәаҩ
fiction	амц
field	адәы
fierce	агәеибакратә
fifteen	жәохә
fifty	ԥшьынҩажәижәаба
fight	ақәԥара
fighting	еиқәԥоу
figure	аԥхьаӡац
figure	афигура
figure out	аилкаара
figure out	аԥхьаӡара
file	афаил
fill	ахарҭәаара
filled	ихарҭәаау
film	афильм
filthy	игәырхынҳәыгоу
finally	аҵыхәтәан
finance	афинансқәа
financial	афинанстә
find	аԥшаара
find out	аилкаара анарԥшра
fine	ибзиаӡоуп
finger	анацәкьара
finish	ахыркәшара
finished	изылгаз
fire	амца
firm	иӷәӷәоу
firm	афирма
first	актәи
first name	ахьӡ
fish	аԥсыӡ
fit	анаалара
five	хәба
fix	арӷәӷәара
fixed	азгәаҭара
flag	абираҟ
flash	ацәырҵра
flat	ауада
flaw	иагу
flawless	ахымкых
flee	аҩра
flesh	акәац
flew	сԥыруан
flex	ахарҟәалара
flexible	унапаҿы иааиуа
flight	аԥырра
flip	хыхьҟа аршәра
flirt	афлирт
flirting	афлирт
float	аӡсара
flood	афатә
floor	азхаз
floor	аихагыла
flour	ашыла
flour	ачашыла
flow	аҭәҳәара
flower	ашәҭ
flu	аимҳәа
fluent	ирласу
fluently	ирласны
fluffy	ихәымсысу
fluid	аӡшьар
fly	аԥырра
focus	ацентр
fog	анаҟәа
foggy	анаҟәа ахылара
fold	аиқәҵара
folks	азааигәара
follow	ашьҭанеира
follow up	ашьҭанеира
following	анаҩсан
food	афатә
fool	агаӡа
foolish	игаӡоу
foot	ашьапсыргәыҵа
football	афутбол
for	азы
For example	Ҿырԥштәыс иаагоуп
for instance	ҿырԥштәыс
for you	уара узы
forbidden	ақәиҭымтәра
force	амч
forecast	арбара
forehead	алахь
foreign	атәым
forest	абна
forever	наӡаӡа
forget	ахашҭра
forgive	аинаалара
forgot	исхашҭит
fork	ачқьыԥ
form	аформа
form	ашьақәыргылара
formal	иформалтәу
former	уаанӡатәи
fortunately	мышрақә
fortune	аманшәалара
forty	ԥшьынҩажҽа
forty-two	ԥшьынҩажҽи ҩба
forward	аԥхьаҟа
foster	арҽхәара
fought	еисит
found	исыԥшааит
foundation	ашьаҭа
four	ԥшьба
fourteen	жәыԥшь
fox	абгахәыҿы
fragile	аԥсыҽ
frame	адаԥа
framework	адаԥа
fraud	амцҳәара
freak	африк
free	хәыда-ԥсада
freedom	ахақәиҭра
freeze	аҵаара
frequency	алассы-лассра
frequent	илассу
frequently	лассы-лассы
fresh	ацқьа
friday	ахәаша
fridge	архьшәашәага
friend	аҩыза
friendly	аибаҭахрала
friends	аҩызцәа
friendship	аиҩызара
frightened	ишәо
frightening	аршәара
frog	адаӷь
from	уахьынтә
front	аԥхьа
frozen	иҵаау
fruit	ашәыр
frustrated	агәы архьра
fuel	абылтәы
Fulfulde	Фулфҩлд
full	иҭәу
fun	алахҿыхра
function	афункциа
function	аус аура
fundamental	ихадароу
funeral	аԥсыжра
funny	иччархәу
fur	ахәы
furious	агәеибакратә
furniture	аҩнымаҭәа
further	ихароу
furthermore	насгьы
future	иҟалаша
gain	аиура
game	ахәмарра
gap	абжьажь
garage	агараж
garbage	агәамсам
garden	абаҳча
garlic	аџыш
gate	агәашә
gather	аизакра
gathering	аҽеизгара
gauge	ашәара
gave	исҭеит
gear	амеханизм
gender	ажәла
general	еицырзеиԥшу
generally	инеидкыланы
generate	арҿиара
generation	абшьҭра
generous	агәыҭбаа
genius	агении
genre	ажанр
gentle	аамсҭашәа
genuine	аҵабырг
gesture	анапырхахара
get	анеира
get	аиура
get dressed	аҽеилаҳәара
get up	агылара
get well soon	агәабзиара шәоуааит
getting	аҟалара
ghost	аԥсыгага
ghosting	аԥсыгага
giant	адуӡӡа
gift	аҳамҭа
ginger	аимбир
girl	аӡӷаб
girlfriend	аӡәы иӡӷаб
give	аҭара
give up	аҽаҭара
given	иҭоу
glad	аигәырӷьара
glance	анахәаԥшра
glance	анаҿаԥшра
glass	асаркьа
glass	ацәца
glasses	абласаркьа
glimpse	алацәҟәра
global	аглобалтә
gloomy	илахьеиқәҵагоу
gloves	анапхаҵақәа
glow	алашара
glow up	алашара
glue	аклеи
go	ацара
go ahead	ԥхьаҟа ацара
go away	наҟ ацара
go to bed	аиарҭахь ацара
goal	ахықәкы
goals	ахықәкқәа
goat	аџьма
god	ҳазшаз
god bless you	анцәа дшәхылаԥшааит
goes	ацара
going to	акы аҟаҵара агәҭакра
gold	ахьы
gone	дцеит
gonna	сгәы иҭоуп
goo	ацара
good	ибзиоуп
good afternoon	мшыбзиа
good bye	абзиараз
good day	амш бзиа
good evening	хәлыбзиа
good job	аус бзиоуп
good looking	аԥшӡа
good luck	абзиара уақәшәааит
good morning	шьшьыбзиа
good morning my love	шьыжьыбзиа сылашара
good night	шәҵх аабзиахааит
goodbye	абзиараз
goodnight	шәҵх аабзиахааит
goods	атоуарқәа
Google	Google
Google Translate	Google Аиҭагара
goose	аҟыз
gorgeous	иџьоушьаша
gossip	уҳәан-сҳәан
got	иҳауз
got it	еилыскааит
government	аиҳабыра
grab	амҵасра
grade	ахәшьара
grade	ахәшьара аҭара
gradually	хәыҷы-хәыҷла
graduate	аушьҭымҭа
grain	арыц
grant	агрант
granted	азинс ишәыҭо
grapes	ажь
grasp	аилкаа аҟаҵара
grass	ашьац
grateful	иуџьызшьо
gratitude	аџьшьара
grave	анышәынҭра
gray	ахәаԥштәыла
great	идуӡӡоуп
greed	аԥсыцәгьа
greedy	аԥсыцәгьа
green	аиаҵәа
greet	аԥсшәаҳәара
greeting	аԥсшәаҳәара
greetings	аԥсшәаҳәара
grey	ахәаԥштәы
grid	асетка
grief	агәырҩа
grind	алагара
grip	амҵасра
grocery	абакалеа
groom	аԥҳәысҳәаҩ
gross	азеиԥш
ground	адгьыл
group	агәыԥ
grow	азҳара
growth	азҳара
grumpy	игәаау
Guarani	Гуарани
guarantee	агарантиа
guarantee	агарантиа аҭара
guard	ахьчара
guess	иаҳҳәап
guest	асас
guidance	анапхгара
guide	анаԥхгара
guide	аекскурсиамҩаԥгаҩ
guilty	ахара зхароу
guy	арԥыс
guys	арԥарцәа
gym	агимнастикатә зал
habit	ашьцылара
habitat	анызаарҭа
had	исыман
hail	ақырцх
hair	ахцәы
half	абжа
hall	аҩналарҭа
hand	анапы
handle	аркра
handsome	иԥшӡоу
hang	акнаҳара
hang out	аамҭа ибзианы амҩаԥгара
happen	ажәҩан
happened	иҟалаз
happiness	анасыԥ
happy	насыԥ змоу
happy birthday	амш иира шәыдысныҳәалоит
happy birthday to you	умш иира удысныҳәалоит
happy new year	ашықәс ҿыц шәадныҳәалаз
hard	икьакьоу
hardly	цәгьала
hardly ever	зынӡаск
harm	аԥырхага
harm	аԥырхага аҟаҵара
harmful	ацәгьа
harmony	абжьеиқәшәара
harsh	аџьбара
harvest	аҽаҩра
has	амазаара
hate	ацәымӷзаара
have	а́мазаара
have a good day	шәмш аабзиахааит
have a nice day	шәмш аабзиахааит
have breakfast	шьыжьхьафара
have fun	аччара-ахәмарра
have you eaten	акрыуфахьома
having	амазара
hazard	ашәарҭа
hazard	ашәарҭара
haze	анаҟәа
he	иара
he has	иара имоуп
he is	иара дыҟоуп
head	ахы
headache	ахыхь
heal	ахәшәтәра
healing	абзиахара
health	агәабзиара
healthy	згәы бзиоу
hear	аҳара
heard	исаҳаит
heart	агәы
heat	агәы
heaven	ажәҩан
heavy	ахьанҭа
hectic	иҭынчым
height	аҳаракыра
heir	ахҭылҵ
heist	ақәлара
held	акра
held	амҩаԥгара
hell	џьаҳаным
Hello	Бзиара умаз
hello dear	мшыбзиа сылашара
hello how are you	ушԥаҟоу
hello how are you doing	ушԥаҟо
helmet	алакҭаҩ
help	ацхыраара
helpful	ацхыраара иазхиоу
hence	убри азын
her	лара лтәы
herd	исаҳаит
here	абра
heritage	амалҭынха
hesitate	аҵысра
Hey	Еи
Hi	Бзиара умаз
hi how are you	мшыбзиа шәшԥаҟоу
Hi there	Мшыбзиа
hidden	иҵәаху
hide	аҵәахра
hierarchy	аиерархиа
high	иҳараку
highlight	аҵышьра
hike	аныҟәара
hiking	шьапыла аныҟәара
hilarious	алахҿых
hill	ахәы
him	иара изы
hint	ақәырԥшара
hip	авара
hips	аварақәа
hire	адкылара
hiring	аусурахь адкылара
his	иара итәы
history	ахҭыс
hit	асра
Hmm	Ҳмм
hobby	ахобби
hold	акра
hold on	аангылара
hole	акылҵәара
holiday	аԥсшьара амш
hollow	акгьы зҭам
home	аҩны
homework	аҩныҟатәи адҵа
honest	ииашоу
honestly	ииашацәҟьаны
Honey	Сыхазына
honor	апату аҳаҭыр
hood	акапиушон
hook	аҿаршә
hop	аԥара
hope	агәаанагара
hopefully	ақәгәыӷырала
hopeless	узықәгәыӷратә иҟам
horizontal	аиаалатә
horn	атәыҩа
horrible	ҳаӷеимшхаратәи
horror	акаамеҭ
horse	аҽы
hospital	ахәышәтәырҭа
hospitality	асасдкылара
host	анаԥхгаҩы
host	асасцәа рырԥылара
hostile	аиӷаратә
hot	ишоуроу
hot	ашоура
hotel	аотель
hour	асааҭ
hours	асааҭқәа
house	аҩны
household	анхара
how	ишԥа
how about you	уара угәаанагара
how are you	шәшԥаҟоу
how are you doing	шәгәалаҟазаара шԥаҟоу
how are you doing today	угәалаҟазаара шԥаҟоу иахьа
how are you today	ушԥаҟо иахьа
how do you do	ушԥаҟоу
how is	ишԥа
how many	заҟа
how much	изыԥсоузеи
how often	заҟа ирласны
how old are you	заҟа ухыҵуеи
how was your day	умш шԥацеи
how was your night	шәҵх шԥацеи
however	даҽакала
hub	ахаб
hubby	схаҵа
hug	агәыдыҳәҳәалара
huge	идуӡӡоу
human	ауаҩы
humble	ахӡырымгаҩ
humid	аԥсаа
humidity	ацәаакыра
hundred	шәкы
hungry	амлакра
hunt	ашәарыцара
hurricane	аԥшацәгьа
hurry	аццакра
hurry up	ирццак
hurt	ахьаа азнаагара
husband	аԥшәма
hustle	ашаҟь-шаҟьара
hut	аҩныжә
hygiene	агигиена
I	Сара
I am	Сара сыҟоуп
I am fine	Сара сыбзиоуп
I can	Сара исылшоит
I can't	Сара исзыҟаҵом
I do	Сара иҟасҵоит
I do not know	Сара исыздырӡом
I do not understand	Сара исзеилкаауам
I don't	Сара мап
I don't know	Сара исыздырӡом
I don't understand	Сара исзеилкаауам
I don't understand what you mean	Ишәҳәаз сзеилмыргеит
I don't understand you	Сара исзеилкаауам
I don’t know	Сара исыздырӡом
I don’t understand	Сара исзеилкаауам
i guess	сгәы иаанагоит
I had	Сара исыман
I have	Сара исымоуп
I have been	Сара сыҟан
I hope so	Ус ауп ҳәа сыҟоуп
I know	Сара исдыруеит
I like	Сара бзиа избоит
I like you	Сара узгәаԥхоит
I love	Сара уара бзиа узбоит
I love my big brother	Сашьеиҳаб бзиа дзбоит
I love my big sister	Саҳәшьеиҳаб бзиа дзбоит
I love my father	Саб бзиа дзбоит
I love my little brother	Сашьа бзиа дзбоит
I love my little sister	Саҳәшьа бзиа дзбоит
I love my mother	Сара сан бзиа дзбоит
I love you	Сара уара бзиа бзбоит
I love you so much	Сара уара даара бзиа узбоит
I love you too	Саргьа бзиа узбоит
I mean	Исҳәарц исҭаху
I miss you	Угәхьаазгоит
I miss you so much	Даара угәхьаазгоит
I see	Сара избоит
I think	Сара сгәы иаанагоит
I understand	Сара еилыскаауеит
I want	Сара исҭахуп
I want to see you	Узбар сҭахуп
I want you	Сара усҭахуп
I was	Сара сыҟан
I will	Сара сҟалоит
I'm	Сара сыҟоуп
I'm fine	Сыбзиоуп
I'm good	Сыбзиоуп
I'm here	Ара сыҟоуп
I'm sorry	Саҭамыз
ice	аҵаа
ice cream	аршәы
idea	аидеиа
ideal	аидеал
ideal	аидеалтә
identical	еиԥшу
identify	аидентификациа азура
identity	аиԥшра
idiot	аилымга
idle	азаҵә
if	ҟалозар
ignore	атәамбара
ill	ачымазара
illegal	азакәан иақәымшәо
illness	ачымазара
Ilocano	Иакано
image	асахьа
image	аимидж
imagine	ахахьы аагара
immediate	агәҭатәи
immediately	иаразнак
immense	идуӡӡоу
impact	агәылаҵара
impact	агәылаҵа
impatient	ачҳара згу
implement	анагӡара
import	аимпорт ахгара
important	акрызҵазкуа
impose	ишуҭахым аҭара
impossible	изыҟамло
impress	ахаҿы ааныжьра
impression	агәазнеира
impressive	ухы-угәаҿы иаанхо
improve	аиӷьтәра
improvement	аиӷьтәра
in	аҩныҵҟа
in addition	уи инацҵаны
In fact	Фактла
in front of	аԥхьа
in order to	уи азы
inappropriate	еиқәымшәо
incentive	гәарԥхаратә
incident	ахҭыс
include	аҵанакра
including	иаҵанакуа
income	ахашәала
inconvenience	аманшәаламра
increase	ацҵара
increased	аизырҳара
incredible	зеиԥш ыҟам
indeed	ииашаҵәҟьаны
independent	ихьыԥшым
India	Индиа
indicate	азгәаҭара
indigenous	аҭыԥантәи
individual	индивидуалтәу
industry	аиндустриа
inevitable	хырԥашьа змам
infant	ҿыц ииз
infection	аинфекциа
infinity	аҵыхәаԥҵәарадара
inflammation	ашәра
inflation	аинфлиациа
influence	анырра
inform	аинформациаҭара
information	аинформациа
ingredients	аингредиентқәа
inheritance	аҭынхара
initial	раԥхьаӡатәи
initiative	аинициатива
initiative	аинициатива аазырԥшуа
injured	ааха зауз
injury	ахәра
innocent	ак зхарам
innovation	ааԥхьара
inquiry	ажәанҵа
insane	аилага
insect	амаҵақәа
insecure	узқәымгәыӷуа
insert	алаҵара
inside	аҩныҵҟа
insight	аҳара
insist	атәы аргара
insomnia	азмыцәара
inspiration	агәышьҭыҵра
inspire	агәеизырҳара
install	аргылара
instance	аҿырԥштәа
instant	есымшааира
instead	аҭыԥан
instead of	уи аҭыԥан
instructions	аинструкциақәа
instrument	аинструмент
insult	ацәахыхра
insurance	аԥгаԥсаҟаҵара
intact	икьысым
integrity	ахә ҳаракы змо
integrity	ииашоу
intellectual	ахәыцратә
intelligence	аҟәышра
intelligent	аҟәыш
intend	аҽазкра
intended	идырны иҟаҵоу
intense	еибарххоу
intention	агәҭакы
interact	аицҟаҵара
interaction	аицҟаҵара
interest	аинтерес
interest	аинтерес аарԥшра
interested	аинтерес аарԥшра
interesting	аинтерес змоу
interfere	аҿаԥалара
intermediate	агәҭатәи
internal	аҩныҵҟатәи
international	жәларбжьаратәи
internship	аинтернатура
interpret	аилыркаара
interpreter	аиҭагаҩ
interrupt	аԥыхра
interview	аинтервиу
intimate	аинтимтә
into	аҩныҵҟа
introduce	алагалара
introduction	алагалара
introvert	аинтроверт
intuition	ацәанырра
invalid	ииашам
invent	арҿиара
inventory	аинвентарь
invest	алаҵара
investigate	аҭҵаара
invitation	ааԥхьара
invite	ааԥхьара
invoice	агәылаҵара
involve	аҽалагалара
involved	иалагалоу
iron	аиха
iron	ауанҭара
iron	ауанҭа
island	адгьылбжьаха
isolated	аҽацәахьчара
issue	азҵаара
issues	ауадаҩрақәа
it	иара
it is	иара ыҟоуп
it was	иара иҟан
it's	иара ыҟоуп
it's ok	акагьы аурым
It's okay	Акагьы ауры
item	аҭаҵа
items	агәылаҵа
its	иаратәы
I’m	Сара сыҟоуп
jacket	ажакет
jail	абахҭа
January	Ажьырныҳәа
jar	абанка
jaw	ацламкәагә
jealous	иҳалалу
jerk	агаӡа
jewelry	ахьымаҭәа
job	аусура
jogging	ирласны аныҟәара
join	ацлара
joint	аиԥшьра
joke	асамарҟәыл
journalist	ажурналист
journey	аныҟәара
joy	агәырӷьара
judge	аӡбаҩ
juice	ашәырӡ
july	ԥхынгәы
jump	аԥара
june	рашәарамза
junk	ажә-мыжә
just	абыржәыҵәҟьа
just do it	игәашәҭ
justice	аиаша
justify	ариашара
Kalaallisut	Калаалисут
keen	иаланахалаз
keep	ахьчара
keep it up	ус шәнеила
kept	искыз
kettle	ачаиршыга
key	ацаԥха
kick	асра
kid	ахәыҷы
kidding	алафҳәара
kidney	аҷаҷа
kids	ахәыҷқәа
kill	ашьра
kind	ақьиа
kinda	еиԥш
kindly	ҳаҭыр ақәҵо
kindness	аразра
king	аҳ
kiss	агәыдкылара
kitchen	ахәыҟаҵарҭа
kite	аҳауа иалоу амаҭ
kitten	ацыгәхәыҷы
knee	ашьамхы
knew	исдырит
knife	аҳәызба
knight	арыцар
know	адырра
knowledge	адырра
known	еицырдыру
Konkani	Канкани
Krio	Крио
label	ақәҷаб
labor	аус
labor	аусура
labour	аџьаа
lack	иамам
ladder	амардуан
lady	хаҵа имцац аӡӷаб
laid	иааныжьу
lake	аӡиа
lamb	асыс
lame	ацыркь
lamp	алампа
land	адгьыл
land	артәара
landscape	апеизаж
language	абызшәа
lap	ашьамхы
large	адуӡӡа
last	ииасхьоу
last but not least	аҵыхәтантәи аха акрызҵазкуа
last name	ажәла
late	ахьшәа
lately	аабыкьа
later	насшәа
latest	аҵыхәтәантәи
latter	аҵыхәтәантәи
laugh	аччара
laughing	аччара
laughter	аԥышәарччара
launch	адәықәҵара
laundry	аӡәӡәарҭа
law	азакәан
lawn	адәҳәыԥш
lawyer	адукат
lawyer	аиурист
lay	ақәҵара
lay	ашьҭалара
layer	аҽыҭ
layout	амакет
lazy	аашьаҩ
lead	анаԥгара
leader	анапхгаҩы
leaf	абӷьыц
leak	ацәцара
lean	алаҟәра
leap	аԥара
learn	аҵара
learning	аҭҵаара
learning	аҵара
lease	арентра агара
least	ашьҭахьтәи
leather	асахҭан
leave	ааныжьра
leaves	абыӷьқәа
led	напхгара азысуан
left	иаанижьит
leg	ашьапы
legacy	аҭынха
legal	азакәан инақәыршәаны
legend	алегенда
legend	еицырдыруа
legit	азакәан иақәныҟәо
leisure	аԥсшьара
lend	уаарас аҭара
length	аура
less	еиҵоу
lesson	аурок
let	ақәиҭтәра
letter	ашәҟәы
lettuce	алатук
lettuce	асалаҭ
level	аҩаӡара
leverage	арычагқәа рсистема
leverage	ахархәара
liability	ауал
liability	аԥхықәра
library	абиблиотека
lick	абызра
lie	ашьҭалара
lie	амцҳәара
lies	амц
lies	амцҳәара
life	аԥсҭазаара
lift	ашьҭыхра
lift	алифт
light	алашара
lightning	илашароу
like	агәаԥхара
likely	иҟалар ҟалоит
likewise	иара убас
line	ацәаҳәа
Lingala	Лингала
link	азхьарԥш
lion	алым
liquid	аӡшьар
list	ахьӡынҵа
list	ахҩылаа
listen	аӡырҩра
listening	аӡырҩра
literally	нбанла
literature	алитертура
litter	агәамсам
litter	агәамсам акажьра
little	ахәыҷы
live	анхара
liver	агәаҵәа
lives	анхара
living	зыԥсы ҭоу
living room	анхарҭатә уада
lizard	аинцәыш
load	аартра
loaf	ачахы
loan	аԥсахтә
local	аҭыԥантәи
location	иахьыҟоу аҭыԥ
lock	аркра
lockdown	алокдаун
lockdown	аркра
log	ақды
lol	иччарху
lonely	азаҵә
long	ау
long time no see	шәсымбеижьҭеи крааҵуеит
look	ахәаԥшра
loop	аиқәҳәала
loose	ацәыӡра
lord	аԥшәма
lose	ацәыӡра
loss	ацәыӡра
loss	ацәыӡ
lost	исцәыӡит
lot	ирацәаны
loud	абжьы ҭыган
lounge	амшгара
love	абзиабара
love you	бзиа узбоит
lovely	аԥшӡа
low	илаҟәу
lower	еиҳа илаҟәу
loyal	узықәгәыӷша
loyalty	аҵабыргра
luck	аманшәалара
lucky	насыԥ змоу
Luganda	Луганда
luggage	аидара
lump	агәал
lunch	шьыбжьхьа
lungs	арыԥҳақәа
luxury	амал
lying	ашьҭалара
machine	амашьына
mad	ахага
madam	амадам
made	иҟасҵеит
magazine	ажурнал
magnificent	иблахкыгоу
maid	ауадаеилыргаҩы
main	ихадоу
maintain	ацхраара
maintenance	аҵакы
maintenance	амаҵзура
Maithili	Маисили
major	еиҳа
majority	еиҳараӡак
make	аҟаҵара
make up	амеикап
make up	аиҿкаара
male	ахаҵа
mall	ахәаахәҭырҭа
man	ахаҵа
manage	анапхгараҭара
management	анапхгараҭара
management	анапхгара
manager	аменеџьер
mandatory	амчмырхаратә
manifest	аманифест
manipulate	анырра аҭара
manipulate	анырра
manner	аманера
manual	анапхгара
many	ирацәаны
many many happy returns of the day	абзиара шәахь игьыжьааит
march	аҭаалымҟаҵара
margin	анашьҭра
market	аџьармыкьа
marriage	ачара
married	хаҵа дрымоуп
mask	асабрада
mass	амасса
massive	имассивтәу
master	аԥшәма
match	аиқәыршәара
mate	аҩыза
material	иматериалтәу
material	аматериал
math	аматематика
matter	аус
matter	азҵаара
maturity	ашәра
may	иҟалар ҟалоит
may	лаҵарамза
maybe	иҟалар ҟалоит
me	сара
me too	саргьы
meal	афатә
mean	иаанагоит
meaning	аҵакы
means	иаанагоит
meant	иаанагон
meanwhile	уи аамҭазы
measure	ашәара
measures	ашәага-зага
meat	акәац
medical	амедицинатә
medicine	амедицина
meditation	амедитациа
medium	агәҭатәи
meet	аиқәшәара
meeting	аиԥылара
Meiteilon	Меитеилон
melt	аԥсасира
memories	агәаларшәарақәа
memory	агәынкылара
mental	ахшыҩтә
mention	агәаларшәара
mentioned	аӡбахә аҳәара
mentor	анапхгаҩы
merchant	ауаҷар
mercy	агәыҳалалра
merely	баша
merry christmas	ашықәс ҿыц шәадныҳәалаз
mess	агәам
message	ацҳамҭа
messy	еилыргам
metal	аметал
method	аметод
mice	аҳәынаԥқәа
middle	агәҭа
middle	агәҭатәи
midnight	ҵхабжьон
might	иҟаҵатәыз
mild	атаата
milestone	аҵәыш
military	аибашьратә
milk	ахш
million	амиллион
mind	ахшыҩ
mind	исҳәарц исҭаху
mindset	ахәыцра
mine	сара стәы
mingle	аилаԥсара
mingle	аилаҭәа
mingle	аилаҭәара
minor	ихәыҷу
minute	аминута
minutes	аминуҭқәа
miracle	анашана
mirror	асаркьа
miscellaneous	еиуеиԥшым
mischievous	аҳәатәхамҵа
miserable	анасыԥда
misery	агәаҟра
miss	азгәамҭара
miss	агәхьаагара
miss you	угәхьаазгоит
missing	иагу
mission	адҵа
mist	анаҟәа
mistake	агха
Mizo	Мизо
mobile	амобилтә ҭел
mock	ахыччара
model	амодель
moderate	арҟәымшәышәра
modern	ҳаамҭазтәи
modest	аԥхашьа
moist	аԥсаа
moisture	ацәаакыра
mold	аԥақәа
mole	ашьана
mom	ан
moment	абӷьааҳәа
monday	ашәахьа
money	аԥара
monitor	ацклаԥшра
monitor	амонитор
monkey	амаамын
month	амза
mood	агәалаҟазаара
moody	ақьынцыц
moon	амза
moral	ацәаҩашәатә
more	еиҳа
moreover	уи аамышьҭахьгьы
morning	ашьыжь
mortgage	аипотека
most	еиҳараӡак
mostly	еиҳараӡак
mother	ан
motion	аиҭаҵра
motivation	амотивациа
mountain	ашьха
mouse	аҳәынаԥ
mouth	аҿы
move	аиҭаҵра
movement	аҵысра
movie	акино
mrs	миссис
much	ирацәаны
mud	аҟьашь
mug	ацәца
muscle	ажьышәа
museum	амузеи
mushroom	акәыкәбаа
music	амузыка
must	аҟаҵарахәҭазаара
mute	абжьыда
mutual	еицырзеиԥшу
my	сара стәы
My dear	Сылашара
my friend	сҩыза
My hovercraft is full of eels	Сыӷба амаҭԥсыӡла иҭәуп
my love	сыхазына
my name is	сара исыхьӡуп
my pleasure	изхаҭабузеи
myself	сара схаҭа
mysterious	еилкаам
mystery	амаӡа
myth	амиф
nail	анацәхыԥ
naive	ҩба злаӡам
name	ахьӡ
narrative	ажәабжьҳәара
narrative	ажәабжь
narrow	аҭшәа
nasty	угәы зырхынҳәуа
national	амилаҭтә
nationality	амилаҭ
native	агәакьа
native	ахатәы
natural	иԥсабаратәу
nature	аԥсабара
nausea	агәырхынҳәра
nausea	агәырхынҳәыга
near	ааигәа
nearby	ааигәа
nearly	ааигәа
neat	агәахәара узҭо
necessary	иаҭаху
neck	ахәда
necklace	ахәдахаҵа
need	иаҭахуп
negative	анегативтә
neglect	атәамбара
negotiate	аиҿцәажәара
neighbor	агәыла
neighborhood	агәылара
neither	аӡәымзар
nephew	аиаҳәшьаԥа
nerd	аҟәыш
nervous	згәы хыҭхыҭуа
nest	аҵысҭра
net	аимадаратә ҳа
network	аҳа
neutral	инеитралтәу
never	ахаангьы
never give up	еснагь ԥхьаҟа
never mind	ахахьы амгара
nevermind	ахахьы амгара
nevertheless	уи адагьы
new	аҿыц
news	ахҭысқәа
next	анаҩсантәи
next to	ааигәа
nice	ибзиоуп
nice	иԥшӡоуп
nice to meet you	ҳаибадырра сеигәырӷьеит
niece	аиашьеиаԥҳа
night	аҵх
night	уахынла
nightmare	аԥхыӡ бааԥсы
nine	ажәбатәи
nineteen	зежә
ninety	ԥшьынҩажәижәаба
No	Мамоу
no problem	ауадаҩра ыҟам
no way	уи зыҟалом
nobody	аӡәгьы
noise	ашьҭыбжь
noisy	зыбжьы дуу
none	аӡәгьы
noon	шьыбжьон
nope	мап
normal	инормоу
north	жәҩанҵәырхара
nose	аԥынҵа
nostalgic	аностальгиатә
not	мамоу
not at all	изхаҭабузеи
not bad	ицәгьам
Not now	Уажәазы акәым
not yet	макьаназы
note	азгәаҭа
noted	иазгәаҭоу
nothing	акагьы
notice	агәаҭара
noticed	азгәаҭара
noun	ахьыӡҟа
nouns	ахьыӡҟақәа
novel	ановелла
november	абҵарамза
now	абыржәы
nowadays	уажәазы
nuisance	ауадаҩра
null	аноль
numb	аҿаҳа
number	аномер
nurse	амедиеҳәшьа
nut	араса
nutmeg	амускаттә раса
nutrition	акрыфара
oath	аҭоуба
obesity	аԥсылацәахара
obey	аххәыцра
object	амаҭәар
objective	ахықәкы
obligation	ахыдҵа
obscure	арлашьцара
observation	ацклаԥшра
observe	ацклаԥшра
obsessed	иханагалаз
obsession	аханагалара
obsolete	иажәхьоу
obstacle	аԥынгыла
obtain	аиура
obtained	ирҳау
obvious	илабҿабоу
obviously	акәхап
occasionally	зны-зынла
occupation	аусзкра
occupied	аҭыԥ аанызкылаз
occur	аакылҟьара
occur	ацәырҵра
occurred	ицәырҵит
occurs	ацәарҵра
ocean	аокеан
october	абҵарамза
odd	уамашәа иҟоу
odds	алшарақәа
of course	ҳәарада
off	ирцәоу
offensive	ахьымӡӷ узырго
offer	адгалара
office	аофис
official	иофициалтәу
often	лассы-лассы
Oh	Оҳ
oh really	иашаҵәҟьоума
oil	ахәша
ok	ибзиоуп
ok dear	ибзиоуп сыхазына
ok honey	ибзиоуп сыхаара
ok my love	ибзиоуп сыхазына
okay	ибзиоуп
okay baby	ибзиоуп сыԥшқа
okay dear	ибзиоуп сылашара
okay honey	ибзиоуп сыхаара
okay my love	ибзиоуп сыхазына
old	ажә
on	аханы
once	знык
one	акы
one language is never enough	бызшәак ахаан иузхаӡом
onion	аџьымшьы
online	онлаин
only	амацара
open	иаарту
open	аартра
operation	аоперациа
opinion	агәаанагара
opportunities	аҟыбаҩ
opportunity	алшара
opposite	аҿаԥхьатәи
optimistic	аоптимисттә
option	авариант
optional	иҟоумҵар ҟало
or	мамзаргьы
orange	апатырқалԥштәы
order	аҿаҵа
order	аҿаҵа аҟаҵара
ordinary	иаабац
organization	аиҿкаара
orientation	аориентациа
origin	ахыҵхырҭа
original	иоригиналу
Oromo	Оромо
orphan	аиба
other	егьы
otherwise	даҽакала
ought	аҟаҵатә
our	ҳара ҳтәы
Our mission: to enable everyone, everywhere to understand the world and express themselves across languages.	Ҳара ҳмиссиа: дарбанзаалак зегьы адунеи реилркаара дара реилибакаара абызшәақәа рхархәарала.
Our mission: to organize the world's information and make it universally accessible and useful.	Ҳара ҳмиссиа: адунеи аинформациа ашьақәыргылара уи иуниверсалраны аилкаара насгьы азнеира.
out	анҭыԥ
outcome	алҵшәа
outfit	амаҭәа
outgoing	знаалашьа бзиоу
outlet	аҭыжьра
outline	аконтур
outside	адәахьала
outstanding	иаалукааша
oven	аԥечка
over	аханы
over there	абна
overall	еицырзеиԥшу
overcome	аиааира
overthinking	иӷәӷәаны арҵәира
overwhelmed	ахьаацәгьа змоу
overwhelming	иаԥыжәоу
owe	амазара
owl	аты
own	изтәу
owner	аԥшәма
ox	ацә
pace	ашьаҿа
pack	апакет
pack	аҭра аҭаҵара
package	аҭра
paid	исшәеит
pain	ахьаа
paint	ашәра
painting	асахьа
painting	асахьа ҭыхра
pair	аихацалакы
pale	ацәыш
palm	апальма
pan	адырган
pandemic	апандемиатә
pandemic	апандемиа
panic	агәыҭҟьа-ԥсыҭҟьара
pants	аиқәа
paper	ақьаад
paradise	џьанаҭ
parallel	еицтәараны
parcel	ашьҭра
parcel	ашьҭымҭа
pardon	аҭамзаара
parents	изхылҵыз
park	парк
parrot	апарпар
parsley	ахәысхәа
part	ахәҭа
participate	алахәзаара
particular	хаҭала
particularly	акы иеиԥшымкәа
partner	алахәылаҩ
party	ахәылԥаз
pass	алсра
passage	абжьысра
passed	адунеи аԥсахра
passion	ацәанырра ӷәӷәа
passionate	ацәанырра ӷәӷәа зныԥшуа
passive	ипассивтәу
password	апароль
past	иаҳхысхьо
patch	ақәҵа
path	амҩахәасҭа
pathetic	арыцҳа
patience	ачҳара
patient	аԥшра
pattern	аҽырԥштәы
pause	ааҭгылара
pavement	атротуар
pay	ашәара
payment	ашәара
payment	ахәԥса
peace	аҭынчра
peaceful	аҭынчратә
peach	атама
peak	ашьха ақәцәа
pear	аҳа
peas	акарклаш
peculiar	ахатәҷыдаратә
pee	ачхәра
peel	ацәырԥссара
peer	цқьа ахәаԥшра
peers	аиқәылацәа
pen	акалам
pencil	акарандашь
pending	аамҭазы
people	ауаа
pepper	апырпыл
perceive	агәынкылара
perception	агәынкылара
perfect	ибзаӡоуп
perform	адгалара
performance	адгалара
performance	ақәгылара
perhaps	иҟалар ҟалоит
period	апериод
permanent	еснагьтәы
permission	азин
permit	азин аҭара
perseverance	зҽадызцало
persistent	есымшатәи
person	ауаҩы
personal	хаҭалатәи
personality	ахаҿра
perspective	еизҳауа
persuade	агәраргара
pervert	архәанча
pet	ааӡамҭа
phase	аетап
phenomenon	афеномен
philosophy	афилософиа
phone	аҭел
photo	асахьа
phrase	афраза
physical	афизикатә
pick	ашьҭыхра
pick up	ашьҭыхра
picture	асахьа
piece	аҭынчра
piece	аҟыра
pieces	аса
pig	аҳәа
pigeon	аҳәыҳә
pile	аиқәырчаҟәа
pillow	ахчы
pilot	апилот
pin	агәлаҵа
pineapple	ананас
pink	агәилтә
pit	ажра
pitch	аршәра
pity	агәы алсра
place	аҭыԥ
places	аҭыԥқәа
plague	амырза
plain	амариа
plan	апланҟаҵара
plan	аплан
plane	аҳаирплан
plant	аҵиаа алаҵара
plant	аҵиаа
plants	аҵиаақәа
plate	асаан
platform	аҭыԥ
platform	аплатформа
play	ахәмарра
playing	ахәмарра
playing	ихәмаруа
pleasant	агәахәара узҭо
please	аҳәара сымоуп
pleased	зхы згәы аху
pleasure	агәынаӡара
pleasure	агәахәара
pledge	аҭоуба ашьҭаҵара
plenty	ирацәаны
plot	асиужет
plug	арыԥҵә
plug	ахаџьгәара
plum	аҳәаса
plumber	аӡымҩангаҩы
plural	арацәа
podcast	аподкаст
poem	ажәынраала
poetry	апоезиа
point	аҭыԥ
point	аҩаӡара
poison	ашҳам
police	аполициа
policy	аполитика
polite	аамсҭашәа
pollution	аҟьашьра
pond	аӡҭакы
pool	аӡҭарчы
poop	аркарара
poor	аӷар
pop	апоп
popular	еицырдыруа
population	ауааԥсыра
pork	аҳәажьы
porridge	ақашь
port	апорт
position	аҭыԥ
positive	ипозитивтәу
possess	амазаара
possession	амазаара
possessive	амазаратә падеж
possessive	амазара
possible	иҟалар зылшо
post	аԥошьҭа
postpone	анаскьагара
potato	акартошка
potential	ипотенциалу
pound	афунт
poverty	аӷарра
power	амч
powerful	иӷәӷәоу
practical	аманшәала
practice	апрактика
practice	апрактика ахысра
praise	арҽхәара
prank	апранк
pray	анцәа иҳәара
precious	зыхә ҳараку
precise	аиқәҷаб
precisely	убасҵәҟьа
predict	иҟалаша аҳәара
prefer	аиӷьашьара
preference	аиӷьашьара
pregnant	аимгәадура
prejudice	амцхаҵара
premises	ауада
premium	апремиум
preparation	архиара
prepare	архиара
prepared	аиқәыршәара
preposition	аԥхьангыла
presence	аҟазаара
present	адгалара
present	аҳамҭа
presentation	азԥхьанагара
presentation	апрезентециа
preserve	ахьчара
president	апрезидент
press	апресса
press	ақәыӷәӷәара
pressure	ақәыӷәӷәара
pretend	аҽыргызмалра
pretty	иԥшӡоу
prevent	аԥырҟәҟәаара
previous	уаанӡатәи
prey	аԥшаах
price	ахә
pride	агәадура
priest	апап
primary	раԥхьаӡатәи
prime	ихадоу
princess	апринцесса
principal	ипринципалтәу
prior	уаанӡатәи
priority	раԥхьаӡатәи
prison	абахҭа
privacy	амаӡара
private	хаҭалатәи
privilege	аԥыжәара
prize	априз
probably	ԥсыхәа зламоу ала
problem	ауадаҩра
procedure	апроцедура
proceed	ацҵара
process	апроцесс
produce	анапы алакра
product	апродукт
production	алҵшәа
profession	апрофессиа
professional	азҟаза
profile	апрофиль
profit	ахашәала
profound	аҵаула
progress	апрогресс
project	апроект
prominent	еицырдыруа
promise	аргәыӷра
promote	анаскьагара
promotion	анахара
prompt	ирласу
prone	зхы хоу
pronouns	ахьӡынхәрақәа
pronunciation	ацәажәашьа
proof	ашьақәырӷәӷәара
proper	ииашоу
properly	ииашаны
properties	аҟазшьақәа
property	амазара
proposal	бсыцца ҳәа аҳәара
prospect	аперспектива
prosperity	ашәҭкакаҷра
prosperous	аизҳара
protect	ахьчара
proud	зхы ҳаҭыр ақәызҵо
prove	ашьақәырӷәӷәара
provide	адгалара
provided	адгалара
provided	иудгалоу
province	ақыҭа
provision	аҭагылазаашьа
provision	аиқәыршәара
puberty	асагәратә еизҳара
public	зегьы ишырбо-ишраҳауа
pull	ахара
pumpkin	аҟаб
punctual	апунктуалтә
pupil	аҵаҩы
purchase	аахәара
pure	ицқьоу
purple	адәыкрынԥштәы
purpose	амзыс
purse	аԥараҭра
pursue	ашьҭашәарыцара
pursuit	ашьҭазаара
push	агәыҵасра
put	ақәҵара
qualification	аквалификациа
quality	ахаҭабзиара
quantity	ахыԥхьаӡара
quarantine	акарантин
quarrel	аицәҳара
quarter	аԥшьбарак
Quechua	Кечуа
queen	аҳкәажә
queer	уамашәа иҟоу
query	агәазыҳәарақәа
question	азҵаара
queue	араан
quick	ирласу
quickly	ирласны
quiet	иахьауа
quilt	ақәыршә
quit	ааныжьра
quite	иазханы
quiz	аквиз
quotation	ацитата
quote	ацитата аагара
quote	ацитата
quotes	ахыцқәа
rabbit	ажьа
race	араса
race	ирласны аныҟәара
rage	агәеибакра
rain	ақәа
raise	азырҳара
raise	ааӡара
raised	ишьҭыху
ran	сыҩит
random	имашәыру
range	адиапазон
rapid	иаӷьу
rapidly	ирласны
rare	аӷа
rarely	шамахамзар
rash	акәыкәмасса
rat	аҳәынаԥ
rate	атариф
rather	еиҳа
ratio	аихьыԥшызаара
rational	ирационалтәу
raw	аӡа
reach	анеира
reached	инеиз
reaction	ареакциа
read	аԥхьара
reading	аԥхьара
ready	амазеи
real	уажәтәи
reality	алабҿабара
realize	аилкаара аарԥшра
realized	иазоушьҭу
really	ииашаҵәҟьаны
rear	зеиԥш маҷу
reason	амзыз
reasonable	аҭакзыԥхықәу
recall	архынҳәра
receipt	арецепт
receipt	аквитанциа
receive	аиура
received	иоуит
recent	аабыкьатәи
recently	аабыкьа
reception	адкылара
reception	адкыларҭа
recipe	арецепт
recipe	аҟаҵашьа
reckless	ихшыҩдоу
recognition	азхаҵара
recognize	адырра
recommend	арекомендациа
recommend	арекомендациа азура
recommended	арекоммендациа змоу
record	арекорд
record	аҭаҩра
recover	абзиахара
recovery	аиҭашьақәыргылара
rectangle	ԥшькәакь
red	аҟаԥшь
redeem	аҿыхра
redemption	ахҿыхра
reduce	армаҷра
redundant	имцхәу
refer	азхьарԥшра
reference	азхьарԥш
reflect	аныбаалара
reflection	анырҷҷалара
refrain	ахынкылара
refrain	априпев
refrigerator	архьшәашәага
refund	аԥара архынҳәра
refuse	мап ацәкра
refused	мап ацәкра
regard	аҭҵаара
regarding	аҵыхәала
regardless	хьаас имкыкәа
regards	ҳаҭырла
region	арегион
register	ашәҟәы аҭагалара
regret	агәалсра
regular	еиԥырҟьам
regularly	есымша
reject	мап ацәкра
relate	аҵанакра
related	иаҵанакуеит
relationship	аизыҟазаара
relative	акы иадҳәалоу
relative	ауа
relatives	ауацәа
relax	аԥсшьара
release	аушьҭра
released	иоужьҭу
relevant	иахәҭоу
reliable	зыгәра угаша
relief	армариара
relieve	аласхара
relieved	азоужьра
religion	анцәахаҵара
religion	адин
religious	адинтә
reluctant	акәанызанра
rely	агәрагара
remain	аанхара
remaining	иаанхаз
remarkable	зеиӷьыҟам
remedy	ахәшә
remember	агәалашәара
remind	агәалаҳәара
reminder	аргәаларшәага
remote	инаскьагоу
remove	аԥыргара
render	ацхраара
rent	арентла агара
repair	аремонт аҟаҵара
repeat	даҽазнык аҳәара
replace	аҭыԥ аԥсахра
reply	аҭак аҟаҵара
report	ацҳара
represent	аарԥшра
reputation	арепуиациа
request	азыҳәамҭа
require	агәазыҳәара
required	аҳәара
rescue	аиқәырхара
research	аҭҵаара
resemble	агәаларшәара
resentment	агәыԥжәара
reservation	аанкылара
reserve	арезерв аҟаҵара
reserve	арезерв
resident	анхаҩы
resign	амаҵура ааныжьра
resilience	аилаҟаҵара
resilient	иҭышәынтәалоу
resist	аиҿагылазаара
resistance	аҿагылара
resolution	аилыргара
resolve	аӡбара
resort	аԥсшьара
resort	аԥсшьарҭа
resources	аресурсқәа
respect	аҳаҭырбара
respond	аҭак ҟаҵара
response	аҭак ҟаҵара
responsibility	аҭакзыԥхықәу
responsible	аҭакзыԥхықәу
rest	аԥсшьара
rest in peace	џьанаҭ шәагмыз
restaurant	акрыфарҭа
restore	арҿыцра
restrict	аҳәаа аҭагӡазаара
result	алҵшәа
results	алҵшәа
resume	анаркьаҿ
resume	анаркьаҿ аҟаҵара
retail	азаҵәылаҭира
retain	ахынҳәра
retention	аанкылара
retired	атәанчахәытә
retreat	шьҭахьҟа цара
retrieve	агара
return	ахынҳәра
reveal	аарԥшра
revealed	иаарту
revenge	ашьоура
revenue	ахашәалахәы
reverse	аҿагыларатә
review	аиҭахәаԥшра
revise	ариашара
revision	аревизиа аҟаҵара
revolution	ареволиуциа
reward	аҳамҭа аҭара
rhythm	аритм
rib	аваҵкьара
rice	арис
rich	абеи
rid	аԥыргара
ride	ацара
ridiculous	арччага
right	ииашоуп
right now	абыржәыҵәҟьа
rigid	аџьбара
ring	амацәаз
rinse	аҵыршара
riot	аиларбгара
riot	абунт
rip	аԥыжәжәара
ripe	иҟалоу
rise	ашьҭыхра
risk	ашәарҭара
rival	аиндаҭлаҩ
rival	аиндаҭлара
river	аӡиас
road	амҩа
roast	аџьра
robust	икьакьоу
rock	ахаҳә
rod	аҵәгәыр
role	ароль
roll	арулет
roof	ахыб
room	ауада
root	адац
rope	ашаха
rotten	абаа
rough	ахжәа
roughly	имчны
round	агьыжь
route	амаршрут
routine	арутина
row	ацәаҳәа
rub	арыцқьара
rubber	аныхра
rubber	аныхга
rubbish	агәамсам
rude	ахжәа
rug	ауарҳал
ruin	аилырбгара
rule	аԥҟара
ruler	алинеика
rules	аԥҟарақәа
run	аҩра
running	аҩра
running	иҩуа
rural	ақыҭатә
rush	аццакра
sack	асакь
sacred	ишәаз
sacrifice	аӡхәы
safe	ишәарҭам
safe flight	ишәарҭам аиқәԥара
safety	ишәарҭам
sage	адыр аҟәыӷа
said	иҳәеит
sail	аӡсара
sailing	мшынлы аныҟәара
sake	азы
salary	ауалафахәы
sale	аҭиира
salmon	амлагәыр
salt	аџьыкхыш
same	иара аҩыза
Same here	Убасҵәҟьа абра
sample	аҿырԥштәы
sand	аԥслымӡ
Sanskrit	Санскрит
sarcastic	асаркастикатә
sassy	ахԥара
sat	стәан
satisfaction	агәахәара
satisfied	ицәгьам
satisfy	азырхара
satisfying	агәы иақәшәо
Saturday	Асабша
sausage	асосиска
sausage	аколбас
savage	абнатә
save	ахьчара
saw	избеит
say	аҳәара
scale	амҽхакрбага
scam	анапхыцәгьара
scar	ашәахсҭа
scarce	иӷару
scared	ишәо
scarf	ахәдакәырша
scary	ахлымӡаах
scattered	еиԥхьытта икаԥсо
scene	асцена
scene	ақәгылара
scenery	апеизаж
scent	аффыҩра
scent	аффҩы
schedule	аихшанҵа
school	ашкол
science	анаука
scientist	аҵарауаҩ
scientists	аҭҵааҩцәа
scissors	амаркатыл
scold	аӷьра
scope	амҽхак
score	асчет
scrap	алом
scratch	ацәҟьара
scream	аҳәҳәара
screen	аекран
screen	аскрин
screw	авинт
script	ақәныҟәа
sea	амшын
seal	атиулен
search	аԥшаара
season	асезон
seat	аҭыԥ
second	аҩбатәи
secret	амаӡа
section	ахәҭа
secure	узықәгәыӷуа
security	ахьчара
security	ахьчацәа
see	абара
see you	ҳаибабоит
see you later	ҳаибабоит насшәа
see you soon	ҳаибабоит ирласны
see you tomorrow	уаҵәынӡа
seed	ажәла
seek	аԥшаара
seem	ацәырҵра
seems	ацәырҵра
seen	избаз
seize	ампыҵахалара
seizure	асексуалтә азеилымкаара
seldom	шамахамзар
select	алхра
self	хаҭала
self healing	аҽыхәышәтәра
selfish	зхы бзиа избо
sell	аҭиира
send	ашьҭра
send me your picture	асахьа сзаашьҭ
senior	аиҳабы
sense	ацәанырра
sensible	зхы здыруа
sensitive	анырралшара змоу
sent	инасышьҭит
sentence	аҳәоу
sentences	аҳәоуқәа
separate	хазы иҟоу
Sepedi	Сепеди
september	цәыббрамза
sequence	аишьҭаргылашьа
series	аишьҭагыла
serious	аҭышәынтәалара
seriously	хъмаррада
serve	архиара
service	амаҵзура
session	асеанс
set	ақәыргылара
set	атәара
set up	ақәыргылара
setting	акәша-мыкәша
setting	ашьақәыргылара
settle	аангылара
settle	анхара
seven	бжьба
seventeen	жҽыбыжь
seventy	хынҩажәиажәаба
several	ԥыҭк
severe	ихьанҭоу
sew	аԥара
shade	ацәылаԥштәхәы
shadow	агага
shake	аршаҟьшаҟьра
shall	иҟалоит
shallow	ихәуҷу
shame	аԥхашьара
shape	аформа
share	ашара
sharp	аҵры
she	лара
she has	лара илымоуп
she is	лара дыҟоуп
shed	акаҭәара
sheep	ауаса
sheet	абӷьыц
shelf	ақәҵарҭа
shell	амыдаӷьцәа
shelter	аҽыҵәахырҭа
shield	аԥырак
shift	аиҭаҵра
shine	алашара
ship	аӷба
shipping	аӷбала ахгара
shirt	ашәҵатәы
shoes	аимаа
shoot	ахысра
shop	адәқьан
shopping	амаҭәаахәара
shore	аԥшаҳәа
short	акьаҿ
shortage	азымхара
shot	ахәыҷы
shoulder	ажәҩа
shout	аҿыҭра
show	арбара
show me	исырба
shower	адуш
shrimp	акреветка
shrink	армаҷра
shut	аркра
shut up	аҿы аркра
shy	аԥхашьаҩ
sibling	аиашьеи аиаҳәшьеи
siblings	аиаҳәшьеи аиашьеи
sick	згәы бзиам
side	аган
sigh	ақәыԥсычҳара
sight	алаԥш
sightseeing	аблахкыгарҭа
sign	анапынҵара
signature	анапынҵа
significant	инагоу
silence	аҭынчра
silent	иҭынчу
silk	абырфын
silly	агаӡа
silver	араӡын
similar	еиԥшу
simp	агаӡахәыҷы
simple	амариа
simultaneously	аамҭакала
since	аахыс
sincere	гәыкала иҟоу
sincerely	гәыкала
sing	ашәаҳәара
singer	ашәаԥәаҩ
single	аӡәы
sink	аҿыӡәӡәарҭа
Sir	Сер
sister	аиаҳәшьа
sister in law	анхәыԥҳа
sit	атәара
site	асаит
situation	аҭагылазаашьа
six	фба
sixteen	жҽаф
sixty	хынҩажәа
size	аразмер
skill	ашьцыларақәа
skills	аԥышәақәа
skin	ацәа
skinny	изгу
skip	аԥара
skip	абжьажьра
skirt	аиԥка
sky	ажәҩан
slave	атәитәых
sleep	ацәара
sleeping	ицәоу
sleeping	ацәара
sleepy	ацәа акра
sleeve	амаӷра
slice	аса
slide	ақәҟьара
slightly	хәыҷык
slim	аинаала
slip	ампыҵҟьара
slope	анаара
slot	аслот
slow	имыццакӡакәа
slowly	ԥшьаала
small	ахәыҷы
smart	аҟәыш
smell	афыҩра
smile	аԥышәырччара
smoke	аҭаҭын ахара
smoke	алҩа
smooth	аршша
snack	ахжәыла
snail	акамыршша
snake	амаҭ
snap	аҿақ аргара
snow	асы
so	убри азы
so cute	ишԥабзиоу
so far	уажәаанӡа
soak	арбааӡара
soap	асапын
sober	иашьым
soccer	ампыл асра
social	исоциалтәу
society	ауаажәларра
socks	ақалбадқәа
soft	атаата
software	апрограмматә еибыҭа
soil	адгьыл
sold	исҭиит
sold out	зегьы ҭиуп
soldier	аруаҩ
sole	ашьапаҵа
solid	акьакьа
solution	аҳасабра
solve	аӡбара
somebody	аӡәырҩы
somehow	акалашәа
someone	аӡәырҩы
something	изакәызаалак
sometimes	зны-зынла
song	ашәа
soon	уажәыҵәҟьа
sophisticated	абаа
Sorani	Сорани
sore	ичмазҩу
sore throat	ахәда ахьра
sorrow	алахьеиқәҵара
Sorry	Саҭамыз
sort	асорт
sought	иԥшаауан
soul	аԥсы
soulmate	сыбжа
sound	абжьы агара
sound	абжьы
soup	асуп
sour	аҵәыҵәы
source	ахыҵхырҭа
south	алада
space	акосмос
spam	аспам
span	арҵәиира
Spanish	Аиспантҽи
spare	арезервтә
speak	ацәажәара
special	ҷыдалатәи
species	аиԥшымзаара
specific	иҷыдоу
spectacular	ахәаԥшырҭатә
speech	ацәажәара
speechless	аҿымҭ
speed	аласра
spell	нбанла аҳәара
spend	аныхра
spend	аамҭа агара
spent	инысхит
spicy	аца
spike	аҟәымӷ
spin	аргьежьра
spinach	ашпинат
spirit	аԥсы
spit	акажьцәара
splendid	иблахкыгоу
split	аиҟәшара
spoil	абжьыхра
spoiled	иԥхасҭоу
spontaneous	ахала иҟалаз
spoon	амҳаҵә
spot	ашәыта
spot	ашьана
spouse	аԥшәма
spread	алаҵара
spring	ааԥын
square	акәакь
squeeze	арӷәӷәара
squid	акальмар
squirrel	аеш
stab	аиқәԥара
stable	иҭышәынтәалоу
stack	ачаҟәа
staff	аусзуҩцәа
stage	астадиа
stage	асцена
stage	ақәгылара
stain	ашәыта
stairs	аҿаԥса
stake	азыԥҵәа
stalk	ахәҵәы
stall	акиоск
stamp	акьыԥхь
stand	агылара
standard	астандарт
star	аиаҵәа
start	алагара
started	иалагеит
starving	амлаиакуа
state	аштат
state	аҟазшьа
statement	арзаҳал
station	астанциа
statue	аҳаҭәара
status	астатус
stay	аанкылара
stay safe	шәхы шәацклаԥш
steady	аҭышәынтәала
steady	ишьақәтәоу
steak	астеик
steal	аӷьычра
steam	афақь
steel	аџыр
steep	аҿҟьара
stem	адац
step	ашьаҿа
stick	акылахара
stick	алаба
stiff	агәымбыл
still	макьаназы
sting	ахы
stingy	акаҷбеи
stir	аиларҩынтра
stock	аҵәах
stolen	иӷьычу
stomach	аца
stone	ахаҳә
stood	сгылан
stool	аҟәардә
stop	аанкылара
storage	аҵәахырҭа
store	адәқьан
storm	ацәқәырԥара
story	ахҭыс
stove	аԥечка
straight	ииашоу
straightforward	амариа
strain	аибарххара
strange	уамашәа иҟоу
stranger	атәымуаҩ
strategy	астратегиа
straw	аҭәиц
strawberry	аҵыҵындры
streak	ацәаҳәа
stream	аӡыхь
stream	алеира
street	адәы
strength	амч
stress	астресс
stretch	анашьҭызаара
strict	алеишәацәгьа
strike	асра
string	арахәыц
string	ахаԥсара
strip	ацәаҳәа
strive	ашьҭазаара
stroke	ашьышьра
strong	аӷәӷәа
struck	иршанхоу
structure	аструкткра
struggle	ақәԥара
struggling	иқәԥо
stubborn	аӷәӷәа
stuck	алахара
student	астудент
study	аҵара
studying	аҵара
stuff	абаша
stunning	убла хызкуа
stupid	абзамыҟә
style	астиль
subject	амаҭәар
submission	анапаҿы аагара
submit	адкылара
substance	аҵакы
substance	амаҭәашьар
substitute	аиҭныԥсахлара
subtle	абаа
succeed	аизҳазыӷьара
success	аихьӡара
successful	ақәҿиара змоу
such	аҩыза
such as	абри аҩыза
suck	ацәацәара
sudden	иаалырҟьаны
suddenly	иаалырҟьаны
suffer	агәаҟра
suffer	аргәаҟра
suffering	игәаҟуа
sufficient	заҟа аҭаху
sugar	ашьақар
suggest	адгалара
suggestion	алагалара
suit	акостиум
suit	анналара
suitable	иақәшо
suitcase	ачемодан
sum	ацҵа
sum	ацҵара
summary	аҭакра
summer	аԥхын
summit	асаммит
sun	амра
sunday	амҽыша
sunny	амраԥхара
sunset	амара аҭашәара
sunshine	амра аԥхара
super	еиҷьӡоу
superior	анапхгара
supervisor	анапхгаҩы
supper	ауаххьа
supply	азнагара
support	адгылара
suppose	агәазҩара
supposed	угәы иззаанаго
sure	агәрагара
surface	ақәыԥшыра
surge	агәырҩара
surgery	аԥҟара
surname	ажәла
surprise	аршанхар
surprised	иџьоушьартә иҟоу
surrender	аҽаҭара
surrender	архынҳәтә
surrounding	акәша-мыкәша иҟоу
surveillance	ацклаԥшра
survey	аҿахәы аҿыхра
survey	азҵаара
survive	аиқәхара
suspect	гәҩарас аҟаҵара
suspended	аҭагылазаашьатә
suspicious	игәҩароу
sustain	ақәшаҳаҭхара
sustainability	аҭышәынтәалара
sustainable	аҭышәынтәала
swag	аԥшаара
swallow	ажәҵыс
swallow	албаадара
swap	аԥсахра
swear	ажәа аҭара
sweat	ахаа
sweater	асвитер
sweep	аԥссара
sweet	ихаау
sweet dreams	аҵх алыԥхаа
sweet tooth	ахаа бзиа избо
sweetheart	ахаара
swell	аԥшацәқәырԥа
swelling	акылчаа
swim	аӡсара
swimming	аӡсара
swing	ауаргьала
swing	арҵысра
switch	арцәара
swollen	иҭчаау
sword	аҟама
symbol	асимбол
sympathy	асимпатиа
symptoms	асимптомқәа
system	асистема
table	аишәа
tackle	аӡбара
tag	ақәҷаб
tail	аҵыхәа
take	ашьҭыхра
take away	наҟ агара
take care	ахӡыӡаара
take off	ашәыхра
taken	игаз
talk	ацәажәара
talkative	ацәажәара бзиа збо
tall	иҳараку
tap	акран
tape	аскотч
target	ахықәкы
task	адҵа
taste	агьама агәаҭара
taste	агьама
tasty	ихаау
taught	исирҵеит
tea	ачаи
teach	арҵара
teacher	арҵаҩы
team	акоманда
tear	алаӷырӡ
tears	алаӷырӡ
tease	аҵәы алаҵара
technology	атехнологиа
teeth	ахаԥыцқәа
tell	аиҭаҳәара
tell me	исаҳә
temper	алеишәа
temperature	атемпература
temple	ауахәама
temporary	аамҭалатәи
ten	жәаба
ten thousand	жәы нызықь
tenant	ауаданкылаҩ
tend	атенденциа аиура
tendency	атенденциа
tender	агәыбзыӷ
tense	аџьабаа ду зцу
tension	аибарххара
tent	атент
tentative	аԥышәаратә
term	атермин
term	асеместр
terms	аиқәшаҳаҭрақәа
terrible	ҳаӷеимшхаратәи
terrific	аџьшьахә
territory	аҳыԥ
test	атест
text	атекст
than	еиҳа
thank	ҭабуп аҳәара
thank you	иҭабуп
Thank you for your patience while we investigate shipment	Иҭабуп шәахьыԥшыз шәеидара гәаҳҭонаҵы
thank you so much	иҭабуп даараӡа
thank you very much	иҭабуп даараӡа
thanks	иҭабуп
Thanks for using our app	Иҭабуп ҳапродукт ахархәаразы
that	уи
that is	уи ыҟоуп
that's good	ари бзиоуп
theft	аӷьычра
their	дара ртәы
them	дара рзы
theme	атема
themselves	дара рхала
then	насшәа
theory	атеориа
there	уа
there are	уа иҟоуп
there is	иҟоуп
therefore	убри азын
these	арҭ
they	дара
they are	дара ыҟоуп
thick	ашәпа
thief	аӷьыч
thigh	ауаҭәа
thin	изгу
thing	акы
things	амаҭәарқәа
things	амаҭәақәа
think	ахәыцра
third	ахԥатәи
thirsty	ашабара
thirteen	ижҽаба
thirty	ҩыжәаба
this	абри
this is	ари
thorough	изыцклаԥшу
thoroughly	уацклаԥшуа
those	урҭ
though	аха
thought	азхәыцра
thoughtful	иҵауланы ихәыцуа
thoughts	ахәыцрақәа
thousand	нызықьк
thread	ашәарҭара
threat	ашәарҭара
threaten	ақәмақарра
three	хԥа
threshold	ашәхымс
thrilled	ибыжку
thrive	аӷьацара
throat	ахәламшәа
through	алсра
throughout	ахыҵра
throw	аршәра
thumb	анацәкьыс ду
thunder	адыд-мацәыс
Thursday	Аԥшьаша
thus	аха
tick	азгәаҭаҷа аҟаҵара
tick	азгәаҭаҷа
tide	ашьҭыҵра
tidy	арыцқьара
tidy	ацқьа
tie	ахәыдхаҵа
tie	аҿаҳәара
tiger	атигр
tight	ирххоу
Tigrinya	Тигриниа
time	аамҭа
timid	иԥхашьа-ԥхаҵо
tiny	ахәыҷӡа
tip	аԥарамҵаԥса
tips	аԥара мҵаԥса
tire	агьежьхарԥа
tired	иааԥсоу
tissue	аҿахьшьы
tissue	анапхьшьы
title	ахьӡ
to be	аҟазаара
toast	атост
toast	ача ӡны
today	иахьа
toddler	ахәыҷыԥшқа
toes	ашьацәкьарақәа
together	ҳаицны
toilet	ашьышьмаҭра
told	исҳәаз
tolerance	анычҳара
tolerate	ачҳара
tomato	апатырџьан
tomorrow	уаҵәы
tongue	абз
tonight	уаха
too	абригьы
too	уигьы
took	исгеит
tool	аинструмент
tools	аинструментқәа
tooth	ахаԥыц
top	ацәқәа
topic	атема
torn	иԥжәоу
torture	аргәаҟра
total	азеиԥш
touch	алакьысра
tough	иӷәӷәоу
tour	атур
toward	уи аганахь
towards	уи ахь
towel	ампахьшьы
town	ақалақь
toxic	ашҳам злоу
trace	ашьҭазааҩ
trace	ашьҭра
track	атрек
track	ашьҭра
trade	ахәаахәҭра
tradition	атрадициа
traditional	атрадициатә
traffic	атрафик
trail	ашьҭазаара
train	адәыӷба
training	азыҟаҵара
trait	аҷыдара
traits	аҷыдарақәа
transfer	аиагара
transition	аиасра
translate	аиҭагара
transparent	акеикеи
transport	атранспорт
transportation	атранспорт
trap	ацәҟьа
trash	агәамсам
trauma	атравма
travel	аныҟәара
tray	аподнос
treasure	амазара
treat	ахымҩаԥгара
treatment	ахәшәтәра
tree	аҵла
tremendous	идуӡӡоу
trend	атенденциа аарԥшра
trend	атенденциа
trial	ашьҭра
trick	атриук
trick	амцҳәара
tried	иааԥсоу
trigger	атриггер
trim	амхра
trip	аныҟәара
trouble	ауадаҩра
trousers	аиқәа
truck	аидарамҩангага
TRUE	ииашоу
trunk	ачемодан
trunk	ацбы
trust	агәрагара
truth	аиаша
try	аҽазкра
Tsonga	Тсонга
tube	аметро
Tuesday	Аҩаша
tuition	аҵара
turkey	ашәышәи
turmeric	акуркума
turn	ааҳәра
turtle	акәуа
tutor	арепетитор
twelve	жәаҩа
twenty	ҩажәа
twenty-one	ҩажәиак
Twi	Туи
twice	ҩынтә
twist	аргьежьра
two	ҩба
type	атип
type	акьыԥхьра
typical	иазҷыдоу
ugly	агмыг
ultimate	аҵыхәтәантәи
umbrella	аҳаргь
unable	иззыҟамҵо
uncle	саб иашьа
unconscious	зыхдырра зцәыӡыз
under	аҵаҟа
underneath	аҵаҟа
underrated	иҭәамшьоу
understand	аилкаара
understood	еилыскааит
unfortunately	гәаҟрыла
uniform	ауниформа
unique	ауникалра змо
unit	аиҟәшара
university	ауниверситет
unknown	еилкаам
unless	уаанӡа
until	уаанӡа
unusual	иаалукааша акы
up	хыхь
up to you	шәара ишышәҳәо
update	арҿыцра
upgrade	арҿыцра
upon	аханы
upset	абжьааԥны
urban	ақалақьтә
urge	агәарԥхара
urgent	иузахмырԥо
us	ҳара ҳзы
use	ахрахәара
used	ахархәара
useful	ихәарҭоу
useless	ихәарҭам
usual	иаабац
usually	абжьааԥны
utility	ахәарҭазаара
vacation	аԥсшьара
vaccination	авакцинациа
vaccine	авакцина аҟаҵара
vaccine	авакцина
vacuum	асабеизгага
vague	ибзианы иубарҭам
valid	аҵабырг
valid	аҵабыргылатә
valley	аԥшаҳәа
valuable	зыхә дуу
value	ахә
value	аҵакдура
variety	ахкы
various	еиуеиԥшым
vary	еиуеиԥшым
vase	аваза
vast	аҭбааҭыцә
vegetable	ауҭраҭыхқәа
vegetables	ауҭраҭыхқәа
vehicle	амашьына
vendor	аҭиҩы
venom	ашҳам
venture	ашәарҭа
venture	ашәарҭара аҭаргылара
venue	аибабара аҭыԥ
verify	арҵабыргра
versatile	ауниверсалтә
version	авариант
vertical	ивертикалтәу
very	зынӡаск
very good	ибзиаӡоу
vessel	аӷба
via	ацхыраарала
vibe	аваиб
vibes	аваиб
vicious	игәымбылџьбароу
victim	аӡхәы
video	авидео
view	асахьа
village	ақыҭа
villain	ацәгьауҩы
vinegar	абжьеи
vintage	авинтаж
violence	амч ахархәара
violent	адәыкрынԥштәы
viral	аԥсы зхоу
virgin	амыркыцра
virtual	ивиртуалтәу
virtue	ахаҭабзиара
vision	аблабара
visit	аҭаара
visual	лаԥшылатәи
vital	аԥсҭазааратә
vivid	еилҟьоу
vocabulary	ажәар
voice	абжьы
void	аҭацәыра
volume	амҽхак
volunteer	аволонтер
vomit	аҿыхра
vomit	аблаамӡ
vulnerable	узыргәаҭеиуа
wage	ауалафахәы
wages	ауалафахәы
waist	аӡара
wait	аԥшра
waiter	анаҳаҩ
waiting	аԥшра
wake	ааԥшра
wake up	аҿыхара
walk	аныҟәара
walking	аныҟәараан
wall	аҭӡы
wallet	аԥараҭра
wander	агәаразаара
wanna	аҭаххара
want	аҭаххара
wanted	исҭахын
war	аибашьра
wardrobe	ашьқьаԥ
warehouse	ашьҭаҵарҭа
warm	иԥхоу
warn	агәҽанҵара
warning	азаардырра
warrior	аибашьҩы
was	иҟан
wash	аӡәӡәара
waste	ус баша аамҭа агара
watch	ахәаԥшра
water	аӡы
watermelon	ашьынка
wave	ацәқәырԥа
way	амҩа
we	ҳара
we are	ҳара ҳаҟоуп
we can	ҳара иҳалшоит
weak	аԥсыҽ
weakness	аԥсыҽра
wealth	амал
wealthy	абеи
wear	аныҟәгара
wearing	ашәҵара
weather	амш зеиԥшроу
wedding	ачара
Wednesday	Ахаша
weed	аҳәира
week	амчыбжь
weekend	апсшьарамшы
weight	акапан
weird	уамашәа иҟоу
welcome	бзиала шәаабеит
welfare	амшхәыбзазара
Well	Нас
well done	ибзиаӡоуп
went	сцеит
were	иҟан
west	аӡара
wet	ибааӡоу
whale	акит
what	изакузеи
what about you	уара угәы ишԥаанаго
what are you doing	узҿуи
what are you doing now	иҟауҵои уажәы
what are you doing right now	узҿуи уажәы
what do you do	унапы злакуи
what do you do for a living	аԥара злашәырҳауеи
what do you mean	ишәҳәарц ишәҭахуи
what do you want	иуҭахузеи
what happened	иҟалазеи
what is	иарбану ари
what is this	ари закузеи
what is your job	узаанаҭузеи
what is your name	иухьӡуи
what's up	иҟалазеи
what's your name	иухьӡуи
whatever	иарбанзаалак
wheat	ачарыц
wheel	абарбал
when	ианба
whenever	ианакәызаалак
where	иаба
where are you	уабаҟо
where are you from	уабатәиу
where are you now	уабаҟо уажәы
where do you live	уабанхо
where is	иаьаҟо
whereas	уи аамҭазы
whether	мамзаргьы
which	иарбану
while	уи аамҭазы
whisper	ашәышәра
whistle	ашәышәра
white	ашкәакәа
who	дарбан
who are you	узусҭара
who is	дызусҭада
who is this	дызусҭада
whole	зегьы
whom	иззы
whose	изтәыда
why	избан
why not	избан мап
wicked	ибааԥсу
wide	аҭбаа
widow	аԥҳәыс емба
width	аҭбаара
wife	аԥҳәыс
wild	абнатә
willing	аҭахра
win	аиааира
wind	аԥша
window	аԥенџьыр
windy	аԥша асуеит
wine	аҩы
winter	аӡын
wipe	иҟалоу
wire	аҭел
wisdom	аҟәыӷара
wise	аҟәыӷара
wish	агәаҳәара
wish you all the best	абзиа шәзеиӷьасшьоит
witch	арупап
withdraw	аԥыхра
withdrawal	амхра
within	уи иалагӡаны
without	уи ада
witness	ашаҳаҭҩы
witty	абызҩыца
wolf	абга
woman	аԥҳәыс
women	аҳәса
won	саиааит
wonder	аџьашьахәы
wonder	аџьашьара
wonderful	убла хызкуа
wood	амҿымаҭәахә
wood	абна
wool	аласа
word	ажәа
words	ажәақәа
work	аусура
work out	аус аура
working	аусура
world	адунеи
worm	ахәаҷа
worn	ирхоу
worried	агәҭынчымра
worry	агәынгара
worse	еицәоу
worship	амҵахырхәара
worst	еицәоуп
worth	аԥсара
worth it	уи аҭсоуп
worthy	иаԥсоу
wound	ахәра
Wow	Уоу
wrap	аиларҳәра
wrath	агәеибакра
wrist	анапыхәда
write	аҩра
Write here	Абра ижәҩы
writing	аҩра
written	иҩу
wrong	ииашам
wrote	исҩит
yard	ашҭа амӡырха
yawn	аҿырҳара
Yeah	Ааи
year	ашықәс
years	ашықәсқәа
yeast	адрожь
yell	аҟаара
yellow	аҩежь
Yes	Ааи
yes baby	ииашоуп сыԥшқа
yes dear	ааи сыхазына
yes honey	ииашоуп сыхаара
yes my love	ааи сылашара
yes of course	ииашоуп
yesterday	иацы
yet	макьаназы
yield	аҳәҳәара
you	шәара
you	уара
you are	уара уҟоуп
you are beautiful	уԥшӡоуп
you are so beautiful	даараӡа быԥшӡоуп
you are welcome	бзиала шәаабеит
you can	уара иузыҟаҵоит
You know	Уара иудыруеит
you too	уаргьы
you're welcome	бзиала шәаабеит
young	ақәыԥш
your	уара утәы
your welcome	бзиала шәаабеит
yourself	ухала
youth	аҿара
you’re welcome	бзиала шәаабеит
yummy	ихаау
zero	ануль
