a	asiki
a little	abedik
a lot	akéh pesan
a lot of	liyu pesan
abandon	sing ngerunguang
abandoned	sing ade ngerunguang
abide	nuutin
ability	kamampuan
able	ngidaang
about	indik
above	beduur
abroad	dura negara
absence	ten hadir
absent	ten masuk
absolutely	pasti
absorb	nyerep
abstract	abstrak
absurd	ten masuk akal
abundance	liyuné
abundant	liyu pesan
abuse	ngina
abuse	nyiksa
accent	logat
accept	terima
access	akses
accident	kacelakaan
accommodation	genah nginep
accomplish	mencapai
accomplished	tercapai
according	manurut
account	akun
accuracy	katepatan
accurate	beneh gati
accused	kapituduh
ache	sakit
achieve	polih
achievement	prestasi
acknowledge	ucapan suksma
acknowledge	ngakuin
acquaintance	kenalan
acquire	ngemilikin
acquired	memperolih
acquisition	akuisisi
across	ring samian
act	ngalakuin
action	aksi
active	aktip
activities	kagiatan
activity	kagiatan
actor	aktor
actual	sané benehné
actually	sebenehne
acute	akut
adapt	menyesuaiang
add	nambahang
addicted	kacanduan
addition	tambahan
additional	tambahan
address	alamat
adequate	acukupan
adjacent	paek
adjective	raos sipat
adjust	nyesuaiang
admire	kagum
admit	ngakuin
adopt	ngadopsi
adorable	ngaé kagum
advance	mejalan maju
advance	maju
advance	ngarayu
advanced	sampun maju
advantage	kauntungan
adventure	patualangan
adverb	raos keterangan
advertisement	iklan
advertising	pariklanan
advice	pengajah
advise	saran
advocate	panyokong
aesthetic	estetik
affair	hubungan gelap
affair	urusan
affect	ngakibatang
affection	kasih
afford	ngidaang polih
affordable	dadi kapolihang
afraid	takut
after	usan
afternoon	sanja
afterwards	usan ipun
again	buin
against	ngelawan
age	yusa
agency	agénsi
agent	agén
aggressive	bes bani
agile	tangkas
ago	pidan
agree	setuju
agreement	kasepakatan
agriculture	pertanian
ahead	ring malu
aid	bantuan
aim	sasaran
aim	tatujon
air	angina
airport	bandara
aisle	gang
alarm	alarem
alcohol	alkohol
alert	paringatan
alive	idup
all	samian
all right	oké
all the best	dumogi beruntung
allow	ngijinang
allowed	baanga ijin
almost	ampir
alone	padidian
along	ring sapanjang
already	sampun
Alright	Nah
also	masi
alternative	alternatip
although	meskipun
always	terus
am	jani adalah
amazing	hebat
ambiguous	sipatné ambigu
ambition	ambisi
ambitious	merasa berambisi
amend	ngubah
amid	ring kalangan
among	ring antara
among us	ring antara ragané samian
amount	jumlah
amusing	ngranaang seneng
an	asiki
analysis	analisis
ancestors	keléwaran
anchor	jangkar
ancient	kuno
and	miwah
and you	lan idané
angel	malékat
anger	kapedihan
angle	sudut
angry	gedeg
animal	buron
ankle	gagelangan bais
anniversary	dina paringatan
announcement	pangumuman
annoy	ngranaang sebet
annoyed	gedeg
annoying	ngedegin
annual	sabilang warsa
anonymous	ten misi adan
another	ané besikan
answer	pasaut
anticipate	ngantisipasi
anxiety	masa cemas
anxious	jejeh
any	sinamian
anymore	buin
anyone	nyén dogén
anything	apapun
anyway	lamun kéto
anyways	lamun kéto
apart	mapisah
apartment	apartemén
apologize	ngidh pelih
apparent	ngenahné
apparently	ngenahné
appeal	menék banding
appeal	daya tarik
appear	ngenah
appearance	pangenah
appeared	ngenah
appetite	selera medaar
apple	apel
application	aplikasi
apply	nerapang
appointment	janji
appreciate	ngargain
appreciation	pengargaan
approach	ngemaakin
appropriate	ané genah
approval	persetujuan
approve	nyetujuin
approved	kasetujui
approximately	kuang lebih
april	bulan april
arbitrary	maubah-ubah
architect	arsiték
architecture	arsitéktur
archive	arsip
are	adalah
are you	apa idané
are you busy	idané sibuk
are you married	idané sampun ngantén
are you married or single	idané nu bajang utawi sampun ngantén
Are you still there?	Nu ditu?
are you there	idané derika
area	daerah
argue	miyegan
argument	gagerengan
arise	bangkit
arm	lengen
army	tentera
around	ring genah sekitar
arrange	ngatur
arrangement	pangaturan
arrival	katibaan
arrive	rauh
arrived	ampun rauh
arrogant	sombong
arrow	panah
art	seni
article	artikel
artificial	buatan
artist	seniman
as	sebagai
as	dugas
as long as	salama
as well	masi
as well as	né masi
ash	abu
ashamed	masa lek
ask	ngidih
ask	metakon
asked	metakon
asleep	pules
aspect	aspek
Assamese	Basa Assam
assault	serangan
assembly	paum gedé
assertive	teges
assess	ngenilai
assessment	panilaian
asset	asét
assets	asét
assign	nugasang
assignment	tugas
assist	nulung
assistant	asistén
associate	timpal kantor
associated	maubungan tekén
association	aosiasi
assume	nganggep
assumption	anggepan
at	ring
at least	satidakné
ate	medaar
athlete	atlit
attach	ngelampirang
attached	kalampirang
attachment	lampiran
attack	serangan
attempt	utsaha
attend	hadir
attendance	kahadiran
attention	perhatian
attitude	pawakan
attract	manarik
attraction	atraksi
attractive	ngenah menarik
attribute	atribut
audience	penonton
august	bulan agustus
aunt	bibik
aunty	bibik
authentic	oténtik
author	panulis
authority	sané berwenang
autumn	musim gugur
available	kari tersedia
average	rerata
average	biase
avoid	ngindarin
awake	tondén mesaré
award	pangargaan
aware	sadar
awareness	kasadaran
away	ngoyong joh
awesome	hebat
awful	berek gati
awkward	canggung
Aymara	Basa Aymara
baby	raré mare lekad
bachelor	nak muani bajang
back	kembali
background	latar belakang
bad	jelé
bag	tas
bait	umpan
bake	manggang
bakery	tukang ngae jaje
baking soda	bubuk pangembang jaje
balance	seimbang
Balinese	Basa Bali
ball	bola
Bambara	Basa Bambara
banana	biyu
band	grup musik
band	karét
bang	mekaplug
bang	keplugan
bank	bank
bar	genah minum
barely	ampir ten
bargain	nawah
bark	ngongkong
barley	gandum
barrier	pangalang
base	dasar
based	madasar ring
basement	ruang betén tanah
basic	dasar
basically	dasarné
basil	kemangi
bastard	bangsat
batch	angkatan
bath	kayeh merendem
bathroom	kamar mandi
battery	baturai
battle	pasiatan
bay	teluk
be	dadi
be careful	melahang
beach	panté
beam	tiang
beans	kacang
bear	beruang
bear	nahan
beard	jenggot
bearing	naanang
beast	makhluk serem tur buas
beat	irama
beat	ngelantig
beautiful	jegég
beauty	kajegégan
became	ampun dadi
because	kerana
become	dados dadi
bed	pesaréan
bedroom	kamar
bee	lebah
beef	bé sampi
beer	minuman bir
before	sebelum
began	nyumunin
begin	nyumu
beginning	pamulaan
behalf	atas nama
behave	metingkah
behavior	parilaku
behaviour	parilaku
behind	ring duri
being	mahluk
belief	keyakinan
believe	percaya
belly	basang
belong	gelahné
belong	termasuk ring
beloved	sané kesayangang
below	ring betén
belt	sabuk
bench	bangku
bend	méngkokang
beneath	ring betén
benefit	manpaat
benefits	manpaat
beside	ring samping
besides	di samping ento
best	sané paling melah
best of luck	dumogi beruntung
best regards	salam hormat
better	luwih becik
between	antara
beverage	minuman
beyond	ring luar jejujuhan
Bhojpuri	Basa Bhojpuri
bias	prasangka
biased	ngelah prasangka
bicycle	sepeda
bid	nawah
big	gedé
bike	sepeda
bill	tagihan
bind	ngiket
bird	kedis
birthday	wanti warsa
bit	nyegut
bite	nyegut
bitter	pait
black	selem
blade	tiuk
blame	melihang
blank	kosong
blanket	selimut
blast	keplugan
bleach	pemutih
bleach	mutihang
blend	campuran
blend	nyampur
bless	kaberuntungan
blessed	aget nasibné
blind	buta
bliss	kabagiaan
block	blokir
block	blok
blood	getih
bloom	mekar
blow	nyebul
blow	ngebug
blue	pelung
blunt	puntul
board	papan
board	déwan
boat	kapal cenik
body	awak
boil	ngelablab
bold	bani
bold	tebel
bond	iketan
bone	tulang
book	buku
boost	ningkatang
booster	paningkat
boot	sepatu but
boot	ngidupang ulang
boots	sepatu but
border	perwatesan
bore	ngranaang med
bored	med
boring	ngemedin
born	lekad
borrow	nyilih
boss	bos
both	kalihné
bother	répot
bottle	botol
bottom	ring paling betén
bought	meli
bounce	mantul
bound	maiket
boundaries	watesan
bow	busur
bow	nunduk ngemaang hormat
bowl	mangkok
box	kotak
boy	raré muani
boyfriend	kabak
bracelet	gelang
brain	otak
branch	cabang
brand	mérek
brave	bani
breach	ngelanggar
bread	ruti
break	marérén
breakfast	medaar semeng
breast	nyonyo
breath	angkihan
breathe	meangkihan
breed	nganakin
brick	citakan
bride	pengantén luh
bridge	jembatan
brief	kejep
brief	laporan singkat
bright	galang
brilliant	dueg pesan
bring	ngaba
bro	bli
broad	linggah
broadcast	siaran
broadcast	nyiarang
broke	pegat
broke	sing ngelah pis
broken	usak
broom	sampat
brother	nyama muani
brother in law	ipah muani
brought	ngaba
brown	cokelat
brush	sikat
bucket	émbér
buddy	timpal melah
budget	béa
bug	serangga
build	bentuk
build	ngewangun
building	gedung
built	negewangun
bulk	jumlah liu
bull	kebo
bully	ngarundung
bump	boncol
bump	boncolan
bunch	agerobag
bundle	pakétan
burden	tetegenan
buried	makubur
burn	makar
burn	berung krana mebakar
burst	mekeplug
bury	ngubur
bus	bis
bush	punyan semak
business	bisnis
bust	mergokin
busy	sibuk
but	sakéwala
butter	mentega
butterfly	kupu-kupu
button	tombol
buy	meli
by	olih
by the way	ngomong-ngomong
bye	dah
cabbage	kol
cabinet	kabinét
cage	kandang
cake	jaje keik
calf	betekan batis
call	manggil
call	nilpun
call me	telpun tyang
called	madan
calm	tenang
came	teka
campaign	kampanye
can	bise
can't	ten ngidaang
Cancel	Batalang
cancer	kanker
capable	ngidaang
capacity	kamampuan
capital	ibu kota
capital	hurup kapital
caption	judul gambar
capture	ngabadiang
car	mobil
career	karir
careful	ati-ati
carefully	ati-ati
careless	sing ati-ati
caring	meduliang
carpenter	tukang kayu
carpet	karpét
carrot	wortel
carry	ngaba
carry on	ngelanturang
carry out	ngelaksanayang
case	kasus
cash	pis kés
cast	ngentungang
cast	pameran
castle	kastil
casual	gaya biasa
cat	méong
catch	nangkep
category	kategori
cattle	buron ternak
caught	sampun nangkep
cause	sané ngeranayang
caution	waspada
cautious	waspada
cave	gowa
cease	merérén
ceiling	raab
celebrate	ngerayaang
cell	sél
center	pusat
century	satus tiban
cereal	séréal
ceremony	upakara
certain	pasti
certainly	pasti
certificate	sertipikat
chain	ranté
chair	korsi
challenge	tantangan
chance	peluang
change	ngubah
chaos	kacau
character	karakter
character	sipat
characteristics	cirin
charge	ngenain
charge	ngisi
charity	amal
charming	bagus ngenahné
chart	bagan
chase	nguberin
chat	metuturan
cheap	mudah
cheat	nipu
cheating	ngianatin
check	meriksa
cheek	pipi
cheer	nyemangatin
cheerful	liang
cheers	salam
cheers	semangat
cheese	keju
chemistry	kimia
cherish	ngarawat
chess	catur
chest	laci
chest	tangkah
chew	ngilag
chicken	buron siap
chief	pamimpin
child	raré
childhood	dugas cenik
children	raré
chill	tenang
chill	tis
chimneys	cerobong asep
chin	jagut
chocolate	cokelat
choice	pilian
choose	pilih
chop	motong
chores	gegaén
chubby	montok
church	gereja
cinnamon	kayu manis
circle	lingkaran
circumstances	kaadaan
citizen	warga nagari
city	kota
claim	ngakuin
clarify	nyelasang
class	kelas
clay	tanah liat
clean	kedas
clear	jelas
clear	terang
clerk	petugas
clever	pinter
client	klién
cliff	jurang
climate	iklim
climb	menékin
clingy	bes némpél
clock	jam
close	tutup
closet	klosét
cloth	kain
clothes	baju
cloud	awan
cloudy	misi awan
clown	badut
clue	patunjuk
clumsy	kabibil
cluster	klaster
coach	anak sané ngelatih
coal	batu bara
coast	pesisi
coat	mantel
coffee	kopi
cognitive	kognitip
coincidence	kabetulan
cold	dingin
collapse	ulung
collar	kerah
colleague	timpal megaé
colleagues	timpal kantor
collect	ngumpulang
collection	koléksi
college	perguruan tinggi
color	warnan
colorless green ideas slept furiously	ide gadang tan mawarna pules galak gati
colour	warnan
column	kolom
column	tiang
comb	suah
combination	gabungan
combine	nggabungang
come	teka
come here	mai alu
come on	mai
comfort	kanyamanan
comfortable	nyaman
coming	lakar teka
coming soon	lakar gelis hadir
command	perintah
comment	komentar
commercial	konersial
commission	komisi
commit	ngelah komitmen
commitment	komitmen
committed	makomitmen
commodity	komoditas
common	umum
communicate	makomunikasi
communication	komunikasi
community	masyarakat
commute	berangkat megaé
companion	pandamping
company	parusahaan
compare	bandingang
comparison	perbandingan
compassion	kasih
compassionate	rasa sayang
compatible	sané cocok
compete	bersaing
competent	beneh ngelah kemampuan
competition	macéntok
competitive	bisa bersaing
complain	mlungguhang
complaint	keluhan
complement	ngalengkapin
complete	pragat
completely	beneh-beneh
complex	komplek
compliance	kapatuhan
complicated	rumit
compliment	pujian
comply	nuut
composition	komposisi
compound	komplek
comprehension	pangertian
comprehensive	lengkap
compromise	ngranaang bahaya
compulsory	wajip
computer	komputer
concentrate	konsentrasi
concept	konsep
concern	kuatir
concerned	kuatir
concert	konsér
conclusion	kasimpulan
concrete	nyata
concrete	semén
condition	kondisi
conditions	kondisi
conduct	ngelakuin
conference	konperénsi
confess	ngakuin
confidence	kapercayaan diri
confident	percaya
confirm	konpirmasi
confirm	ngonpirmasiang
conflict	konplik
confused	paling
confusion	paling
congrats	selamet
congratulation	selamet
congratulations	rahayu
conjunction	konjungsi
connect	terubung
conquer	naklukin
conscious	sadar
consciousness	kasadaran
consent	persetujuan
consequences	akibatné
conservation	genah perlindungan
conservative	kolot
consider	pertimbangan
considered	kaanggap
consist	luir
consistency	konsisténsi
consistent	terus-terusan
constant	terus gén kéto
constantly	terus-terusan
constipation	ten bisa meju
construction	kosntruksi
consume	ngonsumsi
consumption	konsumsi
contact	ngenain
contact	kontak
contagious	manular
contain	misi
contains	misi
contemporary	kontemporér
contempt	manghina
contempt	panghinaan
content	isi
contest	lomba
context	kontéks
continent	benoa
continue	nerusang
contract	kontrak
contrast	kontras
contribute	maang kontribusi
contribution	kontribusi
control	kontrol
controversial	ngranaang kontropersi
convenience	praktis
convenient	praktis
conversation	omong-omongan
convert	ngubah
convey	ngungkapang
convince	ngeyakinin
convinced	keyakinang
cook	masak
cooking	nyakan
cool	kerén
cool	tis
cooperation	kerja sama
cope	ngatasin
copper	warnan tembaga
core	inti
corn	jagung
corner	bucu
correct	betul
cost	béa
costume	kostum
cottage	pondok
cotton	katun
cotton	kapas
couch	kursi males
cough	kokoan
could	nyidayang
council	déwan
council	parundingan
count	ngitung
count	jumlah
counter	konter
country	negara
countryside	desa
couple	pasangan
courage	kawanénan
course	kursus
court	lapangan
court	pengadilan
courtesy	persembahan
courtesy	kasopanan
cousin	misan
cover	tutup
cover	nutupin
cow	sampi
coward	anak getap
cozy	nyaman
crab	kepiting
crack	retak
craft	karajinan
crap	jelé
crash	nomplok
crash	ancur
craving	dot
crawl	magaang
crazy	buduh
create	ngaé
creative	kreatip
credit	kredit
creep	anak tawah
creep	nyeliep
creepy	serem
crew	kru
crime	kajaatan
cringe	mase sing juari
crisis	krisis
criteria	kritéria
critical	penting gati
criticism	kritik
crop	taneman
crops	panénan
cross	nyebrangin
cross	tanda salib
crow	kedis guak
crowd	anaké ramé
crowded	ramé gati
crown	makota
crucial	penting gati
cruel	corah
cruise	maplesir nganggé kapa
crush	kabak
cry	ngeling
cucumber	timun
cuddle	megelutan
culture	budaya
cunning	cerdik
cup	cangkir
cupboard	lemari bupet
curb	ngewatesin
curb	sisin margi
cure	nyegerang
curfew	wates jam peteng
curiosity	rasa dot nawang
curious	penasaran
curly	berit
currency	mata pipis
current	paling anyar
currently	jani
curse	ngomél
curtain	korden
cushion	bantal kursi
custom	adat
custom	kasesuaiang
customer	palanggan
customs	adat
cut	kene potong
cut	motong
cute	lucu
cycle	siklus
cycling	masepédaan
dad	bapa
daddy	pa
daily	sabilang dina
dairy	produk saking susu
dam	waduk
damage	kausakan
damn	mih déwa ratu
damp	agak belus
dance	ngigel
danger	bahaya
dangerous	berbahaya
dark	peteng
darling	ané kesayangang
dash	tanda ubung
data	data
date	korma
date	tanggal
daughter	panak luh
day	dina
dead	mati
deadline	wates waktu
deaf	bongol
deal	satuju
deal	kasepakatan
dear	sayang
dear	sané terhormat
Dear All	Semeton Sinamian Sané Terhormat
Dear Customer	Pelanggan Sané Terhormat
Dear Parents	Nak Tua Sané Terhormat
Dear Sir	Bapak Sané Terhormat
Dear students	Murid sinamian
Dear Team	Tim sinamian
death	kamatian
debate	debat
debit	debit
debris	puing
debt	utang
decade	dasa tiban
decay	dadi bosok
deceased	sampun mati
deceive	nipu
december	bulan desember
decent	layak
decide	ngamutusang
decided	ngamutusin
decision	kaputusan
deck	dék
decline	nolak
decrease	berkurang
dedicated	kusus
dedication	pangabdian
deed	perbuatan
deep	dalem
deer	rumput
default	depault
defeat	ngalahang
defend	méla
define	nentuang
definitely	sube pasti
definition	katerangan
degree	gelar
degree	darajat
delay	panundaan
delayed	matunda
delete	apus
deliberate	jelap
delicate	alus pesan
delicious	jaen
delight	kasenengan
delighted	girang pesan
deliver	ngatehin
delivered	kaanter
delivery	pangiriman
demand	permintaan
demanding	demen nuntut
democracy	démokrasi
demon	buta kala
demonstrate	demonstrasi
denied	sampun nolak
density	kapadatan
dentist	dokter gigi
deny	nolak
department	departemén
departure	kaberangkatan
depend	bergantung tekén
deploy	katugasang
deploy	kanggén
deposit	simpenan awal
depressed	masa tertekan
depression	depresi
depth	dalemné
describe	jelasang
description	panjelasan
desert	padang bias
deserve	pantes
design	rancangan
designation	sané katentuang
desire	hasrat
desk	meja
despair	ilang harapan
desperate	ten meduwé harapan
despite	yadiastun
dessert	daaran pencuci mulut
destination	tatujon
destiny	nasib
destroy	ngancurang
destruction	kaancuran
detail	parincian
details	parincian
detect	détéksi
determination	tekad
determine	nentuang
determined	matekad
devastated	sedih pesan
develop	ngembangang
developed	kakembangang
development	perkembangan
device	parangkat
devil	buta
devoted	penuh pengabdian
Dhivehi	Basa Dhivehi
diabetes	sakit gula
diarrhea	méncrét
diary	buku harian
dictionary	kamus
did	ngelakuin
die	mati
died	mati
diet	pola medaar
difference	perbédaan
different	lén
difficult	kéweh
dig	congcong
dignity	kawibawan
diligent	rajin megaé
dinner	medaar peteng
dip	nyelebang
direct	langsung
direction	arah mejalan
director	sutradara
director	direktur
dirt	kotoran
dirty	romon
disable	ngematiang pungsi
disabled	cacat
disappear	ilang
disappointed	kecewa
disaster	bencana
discard	ngutang
discharge	sané pesu
discharge	kalepasang
discipline	disiplin
discount	potongan harga
discover	nemuin
discrimination	perlakuan melénan
discuss	ngomongang
discussion	diskusi
disease	panyakit
diseases	kageringan
disguise	nyamar
disguise	panyamaran
disgusting	nyenebin
dish	hidangan
dishes	dedaaran
dishes	piring sendok
dismiss	ngapus
dismiss	ngusir
dispatch	ngirim
display	pangenahan
display	layar
disposal	genah ngutang
dispute	majugjagan
distance	jarak
distinct	sané paling lén
distinguish	medaang
distress	kasulitan
distribution	panyebaran
district	distrik
disturb	ngulgul
ditch	ngutang
dive	nyilem
diverse	macem-macem jenisné
diversity	kanekaragaman
divide	mecah
divine	katuhanan
divorce	mecerai
dizzy	uyun
do	kagaé
do	ngelakuin
do you	apa idané
do you love me	Idané tresna tekén tyang
doctor	dokter
document	dokumén
does	nglakuin
doesn't	sing
dog	kuluk
Dogri	Basa Dogri
doing	sedeng ngelakuin
doll	kemplong-kemplongan
domain	domain
domestic	domestik
dominant	sané dominan
don't	de
Don't worry	Ten perlu kuatir
donate	nyumbang
done	pragat
donkey	keledai
dope	kerén pesan
double	dobel
doubt	ragu
dough	adonan
down	betén
download	ngunduh
draft	rencana
drag	nyérét
drain	nguras
drama	drama
draw	ngambar
draw	ngedeng
drawer	laci
drawing	ngambar
drawing	gambaran
dread	takut tekén
dream	impian
dress	baju rok lantang
drill	bor
drill	latian
drink	minum
drink	wedangan
drive	nyetir
drop	ulung
drop	tétés
dropped	ngulungang
drought	musim tuh
drought	tuh
drunk	punyah
dry	tuh
duck	bebek
dude	bli
due	kerana
due to	kerana
dull	sing cerah
dull	ngemedin
dumb	lengeh
dump	ngutang
duration	durasiné
during	samekelo
dust	buk
duty	kawajipan
dwell	meneng
dying	sekarat
each	sebilang
each other	saling
eager	ngaat
eagle	kedis elang
ear	kuping
earlier	sabelumné
early	awal
earn	ngasilang
ears	kuping
earth	gumi
earthquake	gempa bumi
ease	kamudahan
ease	mudah carané
easily	aluh
east	kangin
easy	aluh
eat	medaar
eating	sedeng medaar
economic	ékonomis
economy	ékonomi
edge	ujung
edit	ngédit
education	pendidikan
effect	akibatné
effective	epektip
efficiency	kaepisiénan
efficient	episien
effort	utsaha
egg	taluh
eggplant	tuwung
ego	égo
eight	kutus
eighteen	lapan belas
eighty	lapan pulu
either	niki utawi nika
elaborate	nyelasang
elbow	sikut
elder	nak lingsir
elderly	nak lingsir
elegant	ngenah anggun
element	élemén
elephant	gajah
eleven	solas
eligible	menuin sarat
eliminate	ngapusang
else	lamun sing kéto
embarrassed	lek ati
embarrassing	ngaé lek
embrace	ngelut
emerge	timbul
emergency	gawat darurat
emotional	émosional
empathy	rasa milu ngasanin
emphasis	panekanan
emphasize	nekenang
employee	pegawé
employees	pegawé
employer	majikan
employment	kapegawéan
empty	kosong
enable	apang ngidaang
encounter	pertemuan
encourage	nyemangatin
end	pamuput
endangered	lakar punah
endeavor	upaya
endurance	katahanan
endure	nahanang
enemy	musuh
energy	bayu
engage	ngalibatang
engaged	milu terlibat
engaged	matunangan
engagement	pertunangan
engagement	katerlibatan
engine	mesin
engineer	anak sané megaé insinyur
English	Basa Inggris
enhance	ningkatang
enjoy	nganikmatin
enormous	gedé gati
enough	cukup
ensure	mastiang
enter	mecelep
entertainment	hiburan
enthusiasm	antusias
enthusiastic	mase semangat pesan
entire	samian
entitled	ngarasa meduwé hak
entity	éntitas
entrance	pintu mecelep
entrepreneur	anak sané wirausaha
envelope	amplop
environment	lingkungan
envy	iri
epic	épik
epidemic	épidémi
equal	pateh
equipment	peralatan
equity	kaadilan
equivalent	sané patuh
eraser	pangapus
error	éror
escape	ngalolosang iba
especially	kususné
essay	tulisan bawak
essence	intiné
essential	ésénsial
establish	ngediriiang
established	mantep
estate	harta
estimate	prakiraan
estimated	prakiraan
etc	muah sane lianan
eternal	abadi
ethics	étika
evaluate	ngépaluasi
evaluation	epaluasi
even	bahkan
even though	yadiastun punika
evening	peteng
event	acara
eventually	pamuputné
ever	taén
every	sabilang
everybody	samian manusané
everyone	semeton samian
everything	makejang
evidence	bukti
evil	buta kala
evolution	epolusi
evolve	makembang
Ewe	Basa Ewe
ex	mantan
exact	pas
exactly	ento sube
exam	ujian
examine	meriksa
example	conto
exceed	ngelebihin
excellent	hébat gati
except	kacuali
exception	pangecualian
excess	kalebian
excessive	melebian
exchange	pertukaran
excited	girang
excitement	rasa seneng pesan
exciting	ngaé girang
exclusive	sifatné eksklusip
excuse	ngijinang
excuse me	permisi
execute	ngelaksanayang
execution	palaksanaan
executive	sané paling duur posisiné
exercise	latian
exhaust	ngranaang leleh
exhaust	kipas nyedot
exhausted	kenyel
exhibit	mamérang
exhibition	paméran
exist	eksis
existence	eksistensi
existing	ada
exit	pesu
expand	ngeluasang genah
expect	ngarepang
expected	sane kaarepang
expenses	bea
expensive	mael
experience	pangalaman
experiment	pangalaman
expert	ahli
expired	sampun kedaluwarsa
explain	nyelasang
explanation	panjelasan
exploit	ngemanpaatang
explore	ngalihin
export	ékspor
expose	ngékspos
exposed	kaékspos
exposure	ekspos
express	nyataang
expression	ekspresi
extend	memperpanjang
extended	kaperpanjang
extension	perpanjangan
extent	johné
external	saking luar
extinct	punah
extra	ékstra
extract	nyemak
extract	ékstrak
extraordinary	luar biasa gati
extreme	ékstrim
extremely	sanget
eye	mata
eyes	peningalan
fabric	kain
fabulous	melah gati
face	mua
facilitate	ngemaang cara
facilities	pasilitas
facility	sarana
fact	pakta
factor	paktor
factory	paberik
facts	liu pakta
fade	ngilang
fail	ten berasil
failed	ten berasil
failure	sing berasil
faint	pingsan
fair	adil
fair	terang
fairly	sacara jujur
fairy	peri
faith	kapercayaan
faithful	setia
fake	palsu
fall	ulung
false	PELIH
fame	kakasuban
familiar	akrab
family	kaluarga
famine	kasedukan
famous	terkenal
fan	kipas angin
fan	penggemar
fancy	melah pesan
fantastic	luar biasa pesan
far	joh
farewell	parpisahan
farm	matani
farmer	petani
fascinating	ngaé kagum
fashion	gaya mebaju
fast	éncol
fat	mokoh
fatal	gawat gati
fate	takdir
father	bapa
fatigue	kenyel
fatigue	mase kenyel
fault	kasalahan
favorite	kademenan
favour	bantuan
favourite	paporit
fear	rasa takut
feast	pesta
feather	bulu
feature	nampilang
feature	pitur
features	pitur
february	bulan pebruari
fed up	sampun med
fee	biaya
feed	dérétan gatra
feedback	nasihat
feel	ngrasa
feeling	merasa
feeling	perasaan
feet	batis kedadua
fell	sampun ulung
fellow	rekan
felt	ngerasain
female	luh
fence	pager
fertile	subur
festival	péstipal
fetch	nyemput
fever	demam
few	baberapa
fewer	lewih bedik
fiance	tunangan
fiction	satua gaénan
field	lapangan
field	widang
fierce	ganas
fifteen	limang olas
fifty	lima pulu
fight	magerengan
fight	pasiatan
fighting	ngelawan
figure	manusa
figure	angka
figure out	ngalihin
file	pail
fill	ngisi
filled	sampun maisi
film	pélem
filthy	daki
finally	puputné
finance	kauangan
financial	kaadaan pipis
find	ngalih
find out	alih
fine	melah
finger	jeriji
finish	pragat
finished	suwud
fire	api
fire	kabakaran
firm	katos
firm	teguh
first	kapertama
first name	wasta arep
fish	nangkep bé
fish	bé
fit	cocok
fit	seger
five	lima
fix	menahin
fixed	ampun tetep
flag	bendera
flash	kilat
flat	rata
flaw	cacat
flawless	mulus
flee	melaib
flesh	daging
flew	mekeber
flex	mamérang
flexible	pleksibel
flight	megedi
flight	panerbangan
flip	malikang
flirt	ngoda
flirting	ngoda
float	ngambang
flood	blabar
floor	lantai
flour	tepung
flow	aliran
flower	bunga
flu	sakit pilek
fluent	ahli pesan
fluently	lancar pesan
fluffy	empuk
fluid	cair
fly	mekeber
focus	musatang keneh
fog	kabut
foggy	mekabut
fold	lipet
folks	nyama brayané
follow	ngikutin
follow up	tindak lanjut
following	ngikutin
food	dedaaran
fool	dongol
foolish	belog
foot	batis
football	sepak bola
for	untuk
For example	Contoné
for instance	misalné
for you	untuk idané
forbidden	melarang
force	maksaang
force	kakuatan
forecast	ngeramalang
forehead	jantuk
foreign	sing dikenal
forest	alas
forever	selaminé
forget	engsap
forgive	ngemaapang
forgot	engsap
fork	garpu
form	bentuk
formal	resmi
former	mantan
fortunately	untungné
fortune	nasib melah
forty	empat puluh
forty-two	empat puluh dua
forward	nerusang
forward	maju
foster	ngarawat
fought	miyegan
found	tepukin
foundation	dasar
foundation	alas pupur
four	papat
fourteen	empat belas
fox	rubah
fragile	aluh belah
frame	bingkai
framework	kerangka gaé
fraud	panipuan
freak	anak tawah
free	bébas
freedom	kabebasan
freeze	beku
frequency	frékuénsi
frequent	sesai
frequently	sering
fresh	seger
friday	sukra
fridge	kulkas
friend	timpal
friendly	ajer
friends	timpal-timpal
friendship	metimpalan melah
frightened	mase jejeh
frightening	nakutin
frog	dongkang
from	saking
front	bagian malu
frozen	beku
fruit	buah
frustrated	prustrasi
fuel	bahan bakar
Fulfulde	Basa Fulfulde
full	bek
fun	seru
function	kagunaan
function	acara
fundamental	mendasar
funeral	panguburan
funny	lucu
fur	bulu buron
furious	pedih gati
furniture	perabotan
further	lewih lengkap
furthermore	selanjutné
future	masa nyanané
gain	ngedapetang
game	permainan
gap	kasenjangan
garage	garasi
garbage	barang daki
garden	taman
garlic	suna
gate	pintu gerbang
gather	ngumpulin
gathering	pauman
gauge	ngukur
gave	ngemaang
gear	alat
gender	jenis kelamin
general	umum
generally	secara umumné
generate	ngasilang
generation	génerasi
generous	barés
genius	jénius
genre	jenis
gentle	lembut
genuine	tulus
gesture	sikap awak
get	polih
get	neked
get dressed	nyaluk panganggo
get up	metangi
get well soon	dumogi lekas kénak
getting	lakar ngedapetang
ghost	hantu
ghosting	ten maan kabar
giant	raksasa
gift	hadiah
ginger	jaé
girl	anak cenik luh
girlfriend	kabak
give	ngemaang
give up	nyerah
given	ngingetin
glad	bagia
glance	nyeledét
glass	kaca
glass	gelas
glasses	kacang
glimpse	nyingak akejep
global	samian guminé
gloomy	ten cerah
gloves	sarung tangan
glow	mekenyah
glow up	makenyah
glue	lém
go	lunga
go ahead	durusang
go ahead	majalan terus
go away	megedi
go to bed	lakar mesaré
goal	tatujon
goals	tetujon
goat	kambing
god	batara
god bless you	dumogi polih suweca saking batara
goes	magedi ka
going	sedeng memargi
going to	lakar
gold	emas
gone	ampun megedi
gonna	lakar
goo	kentel
good	becik
good afternoon	rahajeng sanja
good bye	pamit dumun
good day	éngken kabaré
good evening	rahajeng peteng
good job	gaén melah
good looking	bagus
good luck	dumogi berhasil
good morning	rahajeng semeng
good morning my love	rahajeng semeng sayangku
good night	rahajeng peteng
goodbye	pamit dumun
goodnight	rahajeng peteng
goods	akéh barang
Google	Google
Google Translate	Google Terjemahan
goose	angsa
gorgeous	jegég
gossip	gosip
got	maan
got it	ngerti
government	pamerintah
grab	ngébég
grade	nilai
gradually	alon-alon
graduate	lulus
grain	biji
grant	ngemaang
granted	kabaang
grapes	buah anggur
grasp	polih pangertian
grass	rumput
grateful	marasa bersyukur
gratitude	ngaturang sukur
grave	sétra
gray	warna abu
great	melah pesan
greed	loba
greedy	loba
green	gadang
greet	nyambut
greeting	sambutan
greetings	sambutan
grey	warna abu
grid	kotak-kotak
grief	duka
grind	nguyeg
grip	ngisiang tekek
grocery	bahan dedaaran
groom	pengantén muani
gross	romon
ground	tanah
group	kelompok
grow	tumbuh
growth	pertumbuhan
grumpy	ambul-ambulan
Guarani	Basa Guarani
guarantee	nyamin
guard	panjaga
guess	nebak
guest	tamu
guidance	tuntunan
guide	pamandu
guilty	masa bersalah
guy	nak muani
guys	timpal mekejang
gym	genah olahraga
habit	kabiasaan
habitat	genah idup
had	ngelah
hail	ngaukin
hair	bok
half	atenge
hall	balé banjar
hand	lima
handle	nanganin
handsome	bagus
hang	ngantung
hang out	negak santai
happen	terjadi
happened	ampun terjadi
happiness	kabagiaan
happy	bagia
happy birthday	rahajeng wanti warsa
happy birthday to you	rahajeng wanti warsa
happy new year	rahajeng warsa anyar
hard	kéweh
hard	katos
hardly	hampir ten
hardly ever	kapah gati
harm	ngelukain
harmful	ngranaang bahaya
harmony	kaselarasan
harsh	kasar
harvest	panén
has	ngelah
hate	sing demen gati
have	meduwé
have a good day	dumogi dinané rahayu
have a nice day	dumogi dinané rahayu
have breakfast	medaar semengan
have fun	maseneng-seneng
have you eaten	sampun ngajeng
having	sedeng
having	ngelah
hazard	marisiko bahaya
haze	kabut
he	ia
he has	ia ngelah
he is	ia adalah
head	sirah
headache	sakit sirah
heal	ngubadin
healing	ngubadin
health	kasehatan
healthy	seger
hear	ningeh
heard	ningeh
heart	ati
heat	kebus
heaven	swargan
heavy	baat
hectic	répot gati
height	tegehné
heir	ahli waris
heist	indik ngemaling
held	kaadaang
hell	naraka
Hello	Halo
hello dear	halo sayang
hello how are you	halo punapi gatra
hello how are you doing	halo punapi gatrané
helmet	hélem
help	nulungin
help	pitulungan
helpful	demen nulungin
hence	olih kerana punika
her	gelahné
herd	gerombolan
here	deriki
heritage	warisan
hesitate	ragu
Hey	Hai
Hi	Hai
hi how are you	hai punapi gatra
Hi there	Hai
hidden	mengkeban
hide	mengkeb
hierarchy	susunan jabatan
high	tegeh
highlight	sorotan
hike	mejalan menék
hiking	majalan menék
hilarious	ngranaang girang
hill	bukit
him	ia
hint	patunjuk
hip	engkog
hips	bangkiang
hire	nganggon dadi pegawé
hiring	ngajih
his	gelahné
history	riwayat
hit	kena
hit	mukul
Hmm	Hmm
hobby	hobi
hold	nahan
hold on	antosang
hole	bolongan
holiday	liburan
hollow	bolong tengahné
home	umah
homework	péér
honest	jujur
honestly	sacara jujur
Honey	Sayang
honor	kahormatan
hood	lingkungan
hook	kait
hop	loncat
hope	ngarepang
hopefully	dumogi
hopeless	ten wénten harapan
horizontal	horisontal
horn	kelakson
horrible	jelé pesan
horror	horor
horse	jaran
hospital	umah sakit
hospitality	karamahtamahan
host	sane ngadaang
hostile	sikap mamusuan
hot	kebus
hotel	otél
hour	jam
hours	jam
house	umah
household	umah tangga
how	kénkén
how about you	idané kéngkén
how are you	punapi gatra
how are you doing	punapi gatra
how are you doing today	punapi gatrané
how are you today	punapi gatra
how do you do	napi gatra
how is	kéngkén
how many	kudang
how much	akuda
how often	sesain apa
how old are you	kuda umur idané
how was your day	dinaé kénak
how was your night	éngkén ibi
however	sakéwala
hub	pusat
hubby	kurnan
hug	gelutan
hug	ngelut
huge	gedé pesan
human	manusa
humble	ten sombong
humid	lembap
humidity	kalembapan
hundred	satus
hungry	seduk
hunt	maburu
hurricane	angin badai
hurry	gelisin
hurry up	mai énggalin
hurt	sakit
husband	kurenan
hustle	sibuk megaé
hut	gubuk
hygiene	kabersihan
I	Tyang
I am	Tyang adalah
I am fine	Tityang becik
I can	Tyang bisa
I can't	tyang ten ngidaang
I do	Tyang bersedia
I do not know	Tityang ten uning
I do not understand	Tityang ten ngerti
I don't	tyang ten
I don't know	Tyang ten uning
I don't understand	Tyang ten paham
I don't understand what you mean	Tyang ten uning maksud idané
I don't understand you	tyang ten ngerti tekén idané
I don’t know	tyang ten uning
I don’t understand	tyang ten ngerti
i guess	tyang marasa
I had	Tyang ngelah
I had	Tyang sampun
I have	Tyang meduwé
I have	Tyang sampun
I have been	Tyang taén ka
I have been	Tyang sampun
I hope so	Dumogi kénten
I know	Tyang uning
I like	Tyang demen
I like you	tyang demen jak idané
I love	Tyang tresna tekén
I love my big brother	tyang sayang jak belin tyangé
I love my big sister	tyang sayang jak mbok tyangé
I love my father	tyang sayang jak bapan tyangé
I love my little brother	tyang sayang jak adin tyang ané muani
I love my little sister	tyang sayang jak adin tyangé ané luh
I love my mother	tyang sayang jak mémén tyangé
I love you	Tyang tresna tekén idané
I love you so much	Tyang tresna gati jak idané
I love you too	Tyang masi tresna ring idané
I mean	Maksud tyang
I miss you	Tyang iseng tekén idané
I miss you so much	tyang kangen san tekén idané
I see	Tyang ngerti
I think	Manurut tyang
I understand	Tyang ngerti
I want	Tyang dot
I want to see you	Tyang dot matepuk
I want you	tyang dot jak nyai
I was	Tyang pidan
I will	Tyang lakar
I would be	Tyang lakar
I'm	Tyang
I'm fine	Tyang becik
I'm good	Gatrane becik
I'm here	tyang deriki
I'm sorry	Tyang ngidih pelih
ice	és
ice cream	és krim
idea	idé
ideal	sané idéal
identical	care kembar
identify	nentuang
identity	pangenas
idiot	belog pesan
idle	mendep
if	lamun
ignore	sing ngerunguang
ill	gering
illegal	ten resmi
illness	gering
Ilocano	Basa Ilocano
image	gambar
imagine	mayangin
immediate	langsung
immediately	segera
immense	liyu gati
impact	dampak
impatient	ten sabaran
implement	nerapang
import	impor
important	penting
impose	ngenain
impossible	ten mungkin
impress	ngranaang berkesan
impression	kesan
impressive	berkesan gati
improve	menahin
improvement	perbaikan
in	ring tengah
in addition	miwah
In fact	sabenehne
in front of	ring arep
in order to	apang
inappropriate	ten pantes
incentive	insentip
incident	insiden
include	termasuk
including	termasuk
income	pamasukan
inconvenience	ngrasa sing nyaman
increase	ningkatang
increased	metambah
incredible	sing bisa kapercaya
indeed	beneh gati
independent	mandiri
India	Basa India
indicate	nunjukang
indigenous	aseli
individual	perorangan
industry	industri
inevitable	ten bisa kaindarin
infant	nak raré
infection	inpeksi
infinity	ten mebatas
inflammation	radang
inflation	inplasi
influence	pengaruh
inform	ngorain
information	inpormasi
ingredients	bahan
inheritance	pawarisan
initial	adan inisial
initiative	inisiatip
injured	matatu
injury	matatu
innocent	ten bersalah
innovation	panemuan
inquiry	pertanyaan
insane	buduh
insect	serangga
insecure	ten mase pracaya diri
insert	nyelipang
inside	di tengahné
insight	inpormasi
insist	kekeh
insomnia	kewéh pules
inspiration	inspirasi
inspire	maang inspirasi
install	nginstal
instance	cacontoan
instant	langsung
instead	sebalikné
instead of	daripada
instructions	patunjuk
instrument	instrumén
insult	ngina
insurance	asuransi
intact	nu utuh
integrity	integritas
intellectual	inteléktual
intelligence	kaduegan
intelligent	cerdas
intend	ngelah maksud
intended	katujuang antuk
intense	kuat
intention	maksud
interact	interaksi
interaction	interaksi
interest	minat
interested	duwé minat
interesting	melah
interfere	nganggu
intermediate	sampun tegeh pesan
internal	uli dalem
international	dura negara
internship	magang
interpret	ngartiang
interpreter	juru basa
interrupt	nganggu
interview	wawancara
intimate	akrab pesan
into	ke tengah
introduce	ngenalin
introduction	pangenalan
introvert	anak sané tertutup
intuition	kata ati
invalid	ten sah
invent	nepukin
inventory	daptar persediaan
invest	invéstasi
investigate	panyelidikan
invitation	undangan
invite	ngundang
invite	undangan
invoice	tagihan
involve	milu terlibat
involve	ngalibatang
involved	milu terlibat
iron	besi
is	adalah
island	pulau
isolated	maisolasi
issue	masalah
issues	isu
it	niki
it is	niki adalah
it was	nika pidan
it's	niki adalah
it's ok	ten masalah
It's okay	sing éngkén
item	aitem
items	barang
its	-né
I’m	Tyang adalah
jacket	jikét
jail	penjara
January	bulan Januari
jar	toplés
jaw	cadik
jealous	iri
jerk	angsuh
jerk	jlema ngedegin
jewelry	periasan
job	gaé
jogging	mejalan adéng
join	milu
joint	gabungan
joke	bebaudan
journalist	wartawan
journey	parjalanan
joy	kabagiaan
judge	maang nilai
judge	hakim
juice	jus
july	bulan juli
jump	makecog
june	bulan juni
junk	rongsokan
just	tuah
just do it	jeg maju gén
justice	kaadilan
justify	menehang
Kalaallisut	Basa Kalaallisut
keen	sumangat
keep	nyaga
keep it up	pertahanang
kept	nyagain
kettle	ketél
key	konci
kick	tanjungan
kick	nanjung
kid	raré
kidding	mecande
kidney	ginjal
kids	nak cenik
kill	ngematiang
kind	melah
kind	macemné
kinda	care
kindly	tulung
kindness	kabaikan ati
king	raja
kiss	niman
kiss	diman
kitchen	paon
kite	layangan
kitten	panak méong
knee	entud
knew	nawang
knife	tiyuk
knight	kesatria
know	uning
knowledge	pangetahuan
known	sampun tawangé
Konkani	Basa Konkani
Krio	Basa Krio
label	labél
labor	tenaga kerja
labour	buruh
lack	kuangan
ladder	jan
lady	gék
laid	ngejang
lake	danu
lamb	domba
lame	lemet
lame	sing mamuaskan
lamp	lampu
land	tanah
land	mandarat
landscape	lénskép
language	basa
lap	pinceran
lap	pangkuan
large	gedé
last	pamuput
last but not least	sané terakhir
last name	wastan kaluarga
late	peteng gati
late	telat
lately	belakangan né
later	nyanan
latest	sané teranyar
latter	sané belakangan
laugh	kedék
laughing	sedeng kedék
laughter	kakedékan
launch	ngaluncurang
launch	paluncuran
laundry	pantingan
law	hukum
lawn	padang
lawyer	pangacara
lay	nggenahang
lay	pules mabaring
layer	lapisan
layout	aturan letakné
lazy	lengit
lead	mimpin
leader	pamimpin
leaf	don
leak	bocor
lean	nyéndér
lean	langsing
leap	makecog
leap	kecogan
learn	malajahin
learning	malajah
lease	nyéwa
least	paling bedik
leather	kulit
leave	luas
leaves	dedonan
led	kapimpin olih
left	kébot
left	lunga
leg	cokor
legacy	paninggalan
legal	hukum
legend	legenda
legit	dados kapercaya
leisure	santai
lend	maang nyilih
length	lantangné
less	kuang
lesson	palajahan
let	depang
letter	surat
lettuce	selada
level	tingkat
leverage	pangaruh
liability	utang
library	perpustakaan
lick	nyilapin
lie	mebaring
lie	sing jujur
lies	mokak
life	idup
lift	lip
lift	ngangkat
light	iying
light	terang
lightning	kilat
like	care
likely	kamungkinané
likewise	patuh
line	mabaris
line	garis
Lingala	Basa Lingala
link	tautan
lion	singa
liquid	sané cair
list	daptar
listen	dingeh
listening	ningehang
literally	arti sujatiné
literature	susastra
litter	ngutang luwu
little	bedik
live	idup
live	langsung
liver	ati
lives	kaidupan
living	idup
living room	ruang tamu
lizard	lasan
load	muatan
loaf	kaluyuran
loaf	potongan ruti
loan	silihan
local	lokal
location	lokasiné
lock	konci
lockdown	ngonci wilayah
log	catetan
lol	kedek ngakak
lonely	kasepian
long	lantang
long time no see	mekelo ten metepuk
look	ningalin
loop	siklus
loose	goloh
lord	dewa
lose	kailangan
loss	karugian
lost	ilang
lot	liu
loud	uyut
lounge	genah bersantai
love	tresna
love you	tyang tresna
lovely	becik gati
low	éndép
lower	lebih éndép
loyal	setia
loyalty	kasetiaan
luck	untung
lucky	nasibné untung
Luganda	Basa Luganda
luggage	barang abaan
lump	benjolan
lunch	medaar tengai
lungs	paru
luxury	kaméwahan
lying	mauk
lying	mebaring
machine	mesin
mad	buduh
mad	galak
madam	ibuk
made	ngaé
magazine	majalah
magnificent	ébat pesan
maid	pembantu
main	utami
maintain	nyaga
maintenance	pameliharaan
Maithili	Basa Maithili
major	utami
majority	ampir samian
make	ngaé
make up	anggén mepayas
male	muani
mall	pusat pabelanjaan
man	manusa
manage	ngaturang sukur
management	pangelolaan
manager	sané ngelola
mandatory	wajib
manifest	ngenehang pawujudan
manipulate	ngemanipulasi
manner	parilaku
manual	cara manual
manual	buku petunjuk
many	liu
many many happy returns of the day	rahajeng wanti warsa
march	maret
march	mabaris
margin	kauntungan
margin	wates
market	peken
marriage	idup maumah tangga
married	ngantén
mask	topéng
mass	massa
massive	gedé pesan
master	ahli
match	cocok
match	korek
mate	pasangan
material	bahan
math	matematika
matter	kaindikan
maturity	kanasakan
may	dados
maybe	mungkin
me	tityang
me too	tyang masi
meal	ajengan
mean	arti
mean	beler
meaning	maksudné
means	sané kanggon
meant	katujuang antuk
meanwhile	sedekan kéto
measure	ukuran
measures	tindakan
meat	bé
medical	médis
medicine	ubad
meditation	méditasi
medium	parantara
meet	matepuk
meeting	paum
Meiteilon	Basa Meiteilon
melt	dadi éncéh
memories	kenangan
memory	ingetan
mental	méntal
mention	nyebutang
mention	panyebutan
mentioned	kasebutang
mentor	guru
merchant	dagang
mercy	ampunan
merely	hanya
merry christmas	rahajeng natal
mess	kacau
message	pesen
messy	meceradukan
metal	métal
method	metode
mice	bikul cenik
middle	tengah
midnight	tengah lemeng
might	hebat
might	gedé
mild	bélék
mild	alus
milestone	tonggak préstasi
military	militér
milk	susu
million	yuta
mind	keneh
mindset	pola makeneh
mine	gelah tyang
mingle	megabung
minor	cenik
minute	menit
minutes	menit
miracle	kaajaiban
mirror	kaca meka
miscellaneous	magenepan
mischievous	jail
miserable	keadaan kéweh
misery	panderitaan
miss	keliwatan
miss	iseng
miss you	kangen idané
missing	ilang
mission	tugas
mist	kabut
mistake	kapelihan
Mizo	Basa Mizo
mobile	hénpun
mobile	terus kemu mai
mock	ngéjék
model	modél
moderate	sedeng
modern	modéren
modest	polos
moist	lembap
moisture	kalembapan
mold	mentuk
mole	bikul tanah
mole	anak sané demen ngadu
mom	mé
moment	momen
monday	soma
money	pipis
monitor	mantau
monitor	layar
monkey	bojog
month	bulan
month	candra
mood	suasana atiné
moody	ngentah
moon	candra
moral	moral
more	luwih liu
moreover	selain nika
morning	semeng
mortgage	pinjeman cicilan umah
most	hampir mekejang
mostly	ampir samian
mother	mémé
motion	gerakan
motivation	motipasi
mountain	gunung
mouse	bikul
mouth	mulut
move	magerak
movement	gerakan
movie	pélem
mrs	nyonyah
much	akéh
mud	lumpur
mug	cangkir mok
muscle	otot
museum	muséum
mushroom	jamur
music	musik
must	harus
mute	ilangang munyiné
mutual	saling
my	tyangé
My dear	Sayangku
my friend	timpal raga
My hovercraft is full of eels	Kapal tyangé bek misi lindung
my love	kabak tyang
my name is	wastan tyangé
my pleasure	ampunang merasa sungkan
myself	tyang pedidi
mysterious	misterius
mystery	misteri
myth	mitos
nail	kuku
naive	sipatné polos
name	adan
narrative	satuané
narrow	cupit
nasty	kejem
nasty	jahat gati
nasty	jelék gati
national	nasional
nationality	kabangsaan
native	asli
natural	alami
nature	alam
nausea	mase seneb
near	paak
nearby	paek
nearly	ampir
neat	rapi
necessary	perlu
neck	baong
necklace	kalong
need	perlu
need	kaperluan
need	harus
negative	negatip
neglect	sing ngarunguang
negotiate	marunding
neighbor	pisaga
neighborhood	pisaga
neither	sing niki utawi nika
nephew	ponakan muani
nerd	nak kutu buku
nervous	sumangsaya
nest	sebun
net	jaring
net	bersih
network	jaringan
neutral	nétral
never	ten taén
never give up	ten dadi nyerah
never mind	buung be
nevermind	nah sing kenape
nevertheless	biarpun kéto
new	anyar
news	gatra
next	salanjutné
next to	di sampingné
nice	melah
nice to meet you	Liang atine makenalan tekén idané
niece	ponakan luh
night	peteng
nightmare	impian jelék
nine	siya
nineteen	sembilan belas
ninety	sembilan pulu
No	Ten
no problem	ten kenapi
no way	mbéh
nobody	ten besik pun jlemané
noise	munyi uyut
noisy	uyut
none	ten wénten
noon	tengai tepet
nope	sing kéto
nor	dong nika utawi niki
normal	normal
north	kaja
nose	cunguh
nostalgic	misi nostalgia
not	sing
not at all	sing kéngkén
not bad	lumayan melah
Not now	Ten jani
not yet	tondén
note	catetan
noted	mecatet
nothing	ten wénten napi
notice	pangumuman
notice	meratiang
noticed	kaperatiang
noun	siki raos benda
nouns	akéh raos benda
novel	buku novel
november	bulan nopmeber
now	jani
nowadays	janiné
nuisance	gangguan
null	nol
numb	ten ngidaang ngrasanin ape
number	nomer
nurse	perawat
nut	kacang
nutmeg	pala
nutrition	gizi
oath	sumpah
obesity	kamokohan
obey	nurutin
object	kaberatan
objective	tujon
obligation	kawajiban
obscure	ngranaang kabur
observation	pangamatan
observe	ngamatin
obsessed	demen pesan tekén
obsession	obsési
obsolete	sampun usang
obstacle	halangan
obtain	ngemolihang
obtained	sampun ngemolihang
obvious	jelas pesan
obviously	suba jelas
occasionally	kadang
occupation	pekaryan
occupied	répot
occur	terjadi
occurred	sané terjadi
occurs	terjadi
ocean	pasih
october	bulan oktober
odd	ganjil
odds	alangan
of course	sube pasti
off	mati
off	pesu
off	kelés
offensive	ngranaang tersinggung
offer	penawaran
offer	nawarang
office	kantor
official	resmi
often	pepes
Oh	Oh
oh really	oh saje
oil	lengis
ok	Inggih
ok dear	nggih sayang
ok honey	nah sayang
ok my love	oke sayangku
okay	Oke
okay baby	oké sayang
okay dear	nah sayang
okay honey	oke sayang
okay my love	oke sayangku
old	odah
on	ring
once	acepok
one	siki
one language is never enough	asiki basa manten ten cukup
onion	bawang
online	onlain
only	muah
open	mabuka
operation	operasi
opinion	pendapat
opportunities	liu kasempatan
opportunity	kasempatan
opposite	lawan
optimistic	masa optimis
option	pilihan
optional	opsional
or	utawi
orange	juwuk
orange	oranye
order	mesen
ordinary	biasa
organization	organisasi
orientation	orientasi
origin	asalné
original	aseli
Oromo	Basa Oromo
orphan	nak yatim piatu
other	sané lianan
otherwise	lamung sing kéto
ought	sepatutné
our	gelah ragané samian
Our mission: to enable everyone, everywhere to understand the world and express themselves across languages.	Tugas raga: ngaé apang samian manusa ring jagaté ngerti dunia tur bisa ngungkapang diri liwat basa.
Our mission: to organize the world's information and make it universally accessible and useful.	Tugas raga: ngatur inpormasine2 ring jagaté tur ngaé samian inpormasi aluh kaakses miwah maguna.
out	pesu
outcome	keluaran
outfit	panganggo
outgoing	anak sané santai
outlet	toko
outline	ringkesan
outside	diwangan
outstanding	luar biasa gati
oven	open
over	ring duuran
over	lebihan tekén
over there	ring derika
overall	kasamian
overcome	nagatsin
overthinking	keliunan mikir
overwhelmed	kawalahan
overwhelming	masa kawalahan
owe	ngelah utang
owl	kedis hantu
own	milik
owner	sané ngelah
ox	lembu
pace	kacepatan
pace	cara mejalan
pack	ngemas
package	pakét
paid	mebayah
pain	sakit
paint	cét
paint	ngecét
painting	lukisan
pair	pasang
pair	masangang
pale	pucet
palm	palem
palm	telapakan lima
pan	panci
pandemic	pandémi
panic	mrasa panik
pants	celana lantang
paper	kertas
paradise	swarga
parallel	mejéjér
parcel	hadiah parsel
pardon	nunas ampura
parents	nak tua
park	taman
parrot	kedis kakatua
parsley	péterséli
part	bagian
participate	milu
particular	kusus
particularly	kususné
partner	pasangan
party	pesta
pass	ngaliwat
passage	margin
passed	liwat
passed	sampun mati
passion	kainginan
passionate	mase semangat pesan
passive	ten aktip
password	kata sandi
past	sané sampun liwat
patch	pléstér
path	jalan cenik
pathetic	ngranaang pedalem
patience	kasabaran
patient	pasien
patient	sabar
pattern	pola
pause	merérén akejep
pavement	trotoar
pay	mayah
payment	pemayahan
peace	damai
peaceful	masa damai
peach	buah persik
peak	puncak
pear	buah pir
peas	kacang polongan
peculiar	melénan
pee	ngenceh
peel	melut
peer	timpal makarya
peers	timpal sejawat
pen	polpen
pencil	pensil
pending	matunda
people	jlema
pepper	mica
perceive	nganggep
perception	anggepan
perfect	paripurna
perform	ngelakuin
performance	perporma
perhaps	kéto mungkin
period	titik
permanent	saterusné
permission	ijin
permit	ijin
perseverance	kagigihan
persistent	teguh
person	jlema
personal	peribadi
personality	kapribadian
perspective	pandangan
persuade	ngesah
pervert	nak buang
pet	binatang piaraan
phase	tahap
phenomenon	pénoména
philosophy	pilosopi
phone	nelpun
phone	telpun
photo	potrékan
phrase	prase
physical	sané maubungan tekén pisik
pick	milih
pick up	nyemak
pick up	nyemput
picture	gambar
piece	potongan
pieces	potongan
pig	céléng
pigeon	kedis merpati
pile	tumpukan
pillow	bantal
pilot	sopir pesawat
pilot	conto
pin	nentuang genah
pin	besi anggon macek
pineapple	manas
pink	warna merah muda
pit	bolongan ring tanah
pitch	nada swara
pitch	panawaran
pity	pedalem
place	genah
place	ngenahang
places	tongos
plague	wabah
plain	polos
plain	ten mase
plan	ngae rencana
plan	rencana
plane	pasawat
plant	nanem
plant	tetaneman
plants	taneman
plate	piring
platform	platpom
play	muter
play	meplalianan
playing	meplalianan
pleasant	ngleganin
please	tulung
pleased	seneng
pleasure	kanikmatan
pledge	majanji satya
plenty	liu
plot	pejalan satuané
plug	genah colokan
plug	nyolokang
plum	buah plum
plumber	tukang menahin pipa
plural	raos jamak
podcast	podkés
poem	puisi
poetry	puisi
point	titik
poison	racun
police	pulisi
policy	kabijakan
polite	sopan
pollution	pancemaran
pond	kolam
pool	kolam
poop	meju
poop	tai
poor	lacur
pop	lagu pop
pop	mekeplug
popular	terkenal
population	jumlah wargané
pork	bé céléng
porridge	bubuh
port	pelabuan
position	posisi
positive	positip
possess	ngelah
possession	milik
possessive	sipat posesip
possible	bise gén
post	pos
post	genah mejaga
postpone	nunda
potato	kentang
potential	sané ngelah potensi
pound	pon
poverty	kalacuran
power	kakuatan
powerful	kuat pesan
practical	praktis
practice	latian
praise	muji
prank	ngolah
pray	ngaturang doa
precious	berharga
precise	presisi
precisely	pas gati
predict	ngeramalang
prefer	milih
preference	pilihan
pregnant	beling
prejudice	prasangka
premises	genah bangunan
premium	prémi
premium	sané premium
preparation	parsiapan
prepare	nyiapang
prepared	ampun siap
preposition	kata depan
presence	kehadiran
present	hadiah
present	jani
presentation	presentasi
preserve	nyaga
president	présiden
press	pérs
pressure	tekanan
pretend	nyaruang
pretty	jegég
prevent	nyegah
previous	sabelumné
prey	mangsa
price	harga
pride	kabanggaan
priest	pandita kristen
primary	sané utami
prime	prima
princess	pangéran
principal	kepala sekolah
principal	prinsip
prior	sabelumné
priority	sané paling utama
prison	tahanan
privacy	indik sané pribadi
private	peribadi
privilege	hak istimewa
prize	hadiah
probably	ulesné
problem	masalah
procedure	prosedur
proceed	lanjutang
process	proses
produce	ngasilin
product	produk
production	produksi
profession	karya
professional	propesional
profile	propil
profit	kauntungan
profound	dalem
progress	kamajuan
project	proyék
prominent	sané paling menonjol
promise	majanji
promise	janji
promote	ningkatang
promote	mromosiang
promotion	promosi
prompt	nganjurang
prompt	panduan wicara
prone	énggal ngranaang
pronouns	raos pangganti
pronunciation	cara ngucapang
proof	bukti
proper	cocok
properly	sepantesné
properties	properti
property	properti
proposal	panawaran
prospect	prospék
prosperity	kamakmuran
prosperous	makmur
protect	ngalindungin
proud	sombong
proud	bangga
prove	muktiang
provide	nyediaang
provided	mangingat
province	propinsi
provision	katentuan
puberty	pubertas
public	anak liu
pull	kedeng
pumpkin	waluh
punctual	tepat waktu
pupil	bola mata
pupil	murid
purchase	meli
pure	murni
purple	ungu
purpose	tetujon
purse	dompet
pursue	nguberin
pursuit	panguberan
push	norong
put	ngejang
qualification	menuin sarat
quality	kualitas
quantity	jumlah
quarantine	karantina
quarrel	pagerengan
quarter	aperapat
quarter	genah ngoyong
Quechua	Basa Quechua
queen	ratu
queer	tawah
query	partanyaan
question	pitaken
queue	ngantri
quick	gelis
quickly	énggalin
quiet	bedik munyi
quiet	suwung
quilt	selimut perca
quit	suud
quite	cukup
quiz	kuis
quotation	panawahan harga
quote	panawahan harga
quote	kutipan
quotes	kutipan
rabbit	kelinci
race	mebalapan
race	lomba
rage	mase pedih gati
rain	ujan
raise	ngajuang
raise	ningkatang
raised	kajuang
ran	melaib
random	sing maurutan
range	kisaran
rapid	cepet gati
rapidly	gelis
rare	kapah
rarely	kapah pesan
rash	genit
rat	bikul gede
rate	tarip
rather	lewih melah
ratio	rasio
rational	rasional
raw	utuh
raw	matah
re	indik
reach	neked
reached	ampun neked
reaction	réaksi
read	mace
reading	memaca
ready	siap
real	sajaan
reality	kanyataan
realize	nyadarin
realized	nyadarin
really	sanget
really	beneh
rear	duri
reason	alasan
reasonable	masuk akal
recall	ngingetang
receipt	bon
receive	nerima
received	sampun katerima
recent	mare-mare né
recently	mare né
reception	acara resépsi
reception	panerimaan
recipe	resep
reckless	ceroboh
recognition	pangakuan
recognize	ngenalin
recommend	nyaranang
recommended	kasaranang
record	ngerekam
record	rekaman
recover	pulih
recovery	pamulihan
rectangle	segi papat
red	barak
redeem	nebus
redemption	panebusan
reduce	nguangin
redundant	maulang buin
refer	maang saran
reference	reperensi
reflect	ngacerminang
reflect	ngenehang
reflection	répléksi
refrain	ten milu
refrigerator	kulkas
refund	nguliang pis
refuse	ten nerima
refused	sampun nolak
regard	salam
regard	indik
regarding	indik
regardless	yadiastun kéto
regards	salam
region	wilayah
register	catetan
register	daptar
regret	nyesel
regular	sane biasa
regularly	teratur
reject	barang matolak
reject	nolak
relate	sané maubungan
related	ada ubungan tekén
relationship	hubungan
relative	braya
relatives	nyama braya
relax	tenang
release	ngelésang
released	kalepas
relevant	sané maubungan
reliable	dados andelang
relief	lega
relieve	lega
relieved	masa lega
religion	agama
religious	indik kaagamaan
reluctant	ngekoh
rely	ngandelang
remain	tetep
remaining	sisané
remarkable	luar biasa pesan
remedy	panyembuhan
remember	inget
remind	panginget
reminder	pangingat
remote	jarak joh
remove	apus
render	ngaé dadi
rent	nyewa
repair	menahang
repeat	ngulangin
replace	ngantinin
reply	males
report	ngalaporang
report	laporan
represent	ngawakilin
reputation	reputasi
request	permintaan
require	perlu
required	wajib
rescue	nyelametang
rescue	panyelametan
research	panelitian
resemble	mesib
resentment	kabencian
reservation	pemesenan
reserve	mesen
resident	warga
resign	ngundurang diri
resilience	katahanan
resilient	tangguh
resist	nahanang
resistance	perlawanan
resolution	resolusi
resolve	ngamecahang
resort	panginepan liburan
resort	nyemak jalan
resources	sumber daya
respect	hormat
respect	ngormatin
respond	nanggepin
response	tanggapan
responsibility	tanggung jawab
responsible	matanggung jawab
rest	marérén
rest in peace	amor ring acintya
restaurant	umah makan
restore	mulihang
restrict	ngelarang
result	hasil
results	liu hasil
resume	lanjutang
retail	écéran
retain	nyimpen
retention	réténsi
retired	pensiun
retreat	waktu mesantai
retreat	mundur
retrieve	nyemak buin
return	balik
reveal	nunjukin
revealed	kaungkapang
revenge	males dendam
revenue	pamasukan
reverse	balikné
review	meriksa ulang
revise	menain
revision	perbaikan
revolution	repolusi
reward	imbalan
rhythm	ritme
rib	iga
rice	baas
rich	sugih
rid	ngilangang
ride	perjalanan
ride	ngemenékin
ridiculous	baud
right	saje
right now	jani
rigid	kekeh
ring	cincin
rinse	milasin
riot	karusuhan
rip	nguwékang
ripe	nasak
rise	terbit
rise	menék
risk	risiko
rival	saingan
river	tukad
road	margi
roast	manggang
robust	kuat
rock	batu
rod	batang kayu
role	peran
roll	ngulung
roof	raab
room	kamar
root	akah
rope	tali
rotten	bosok
rough	sing alus
roughly	kuang lebih
roughly	cara kasar
round	bulet
round	ronde
route	rute
routine	kagiatan rutin
row	baris
row	ndayung
rub	ngosok
rubber	karet
rubbish	mis
rude	ten sopan
rug	karpet
ruin	ngancurin
ruin	puing
rule	aturan
ruler	pangaris
rules	aturan
run	melaib
running	sedeng melaib
rural	perdesaan
rush	énggal-énggalan
sack	karung
sacred	suci
sacrifice	ngorbanang
safe	aman
safe flight	dumogi penerbangané selamet
safety	kaselamatan
sage	anak sané wicaksana
sage	taneman sage
said	kasambatang
sail	malayar
sailing	malayar
sake	kapentingan
salary	gajih
sale	obral
sale	ngadep
salmon	bé salmon
salt	uyah
same	patuh
Same here	Tyang masi patuh
sample	sampel
sand	bias
Sanskrit	Basa Sansekerta
sarcastic	sinis
sassy	megaya
sat	negak
satisfaction	kapuasan
satisfied	ngrasa puas
satisfy	muasang
satisfying	ngranaang puas
Saturday	Saniscara
sausage	sosis
savage	kejem
save	nyimpen
saw	ningalin
say	nutur
scale	ukuran
scale	ningkatang
scam	penipuan
scar	lad metatu
scarce	ten liu ada
scared	jejeh
scarf	saput baong
scary	nakutin
scattered	meberarakan
scene	adegan
scenery	pamandangan
scent	miik
schedule	jadual
school	sekolahan
science	ilmu pangetahuan
scientist	ilmuwan
scientists	ilmuwan
scissors	gunting
scold	nyentak
scope	cakupan
score	nilai
scrap	jumlah abedik
scrap	mongkar
scratch	ngésgés
scream	njerit
screen	layar
screw	sekrup
screw	ngranaang kacau
script	tetulisan
sea	pasih
seal	ségel
search	pancarian
search	ngalih
season	musim
seat	genah negak
second	nomor kalih
secret	rahasia
section	bagian
secure	aman
security	kaamanan
see	nyingak
see you	pamit dumun
see you later	Sampé jumpa
see you soon	Sampé jumpa
see you tomorrow	Metepuk buin mani nggih
seed	benih
seek	ngalih
seem	pangenahné
seems	ngenahné
seen	ngenah
seize	nyita
seizure	parampasan
seizure	kejet-kejet
seldom	kapah
select	milih
self	iba
self healing	ngubadin iba pedidi
selfish	egois
sell	ngadep
send	ngirim
send me your picture	kirimang potrék idané
senior	nak sané liyu pangalaman
senior	nak lingsir
sense	rasa
sensible	masuk akal
sensitive	sensitip
sent	makirim
sentence	kalimat
sentences	kalimat
separate	misahang
Sepedi	Basa Sepedi
september	bulan september
sequence	urutan
series	sérial
serious	serius
seriously	serius pesan
serve	ngalayanin
service	palayanan
session	sési
set	set
set up	ngatur
setting	pangaturan
settle	magenah
seven	pitu
seventeen	tuju belas
seventy	tuju pulu
several	makudang-kudang
severe	sanget
sew	nyait
shade	nuansa warna
shadow	lawat
shake	ngocok
shall	wajip
shall	lakar
shallow	dékén
shame	lek
shape	bentuk
share	magiang
share	bagi
sharp	mangan
she	ia
she has	ia ngelah
she is	Ia adalah
shed	gudang
shed	kelés
sheep	domba
sheet	lembar
sheet	sepréi
shelf	rak
shell	kulit katos
shelter	genah perlindungan
shield	taméng
shift	magésér
shift	giliran
shine	masinar
ship	kapal
ship	ngirim
shipping	pangiriman
shirt	baju kemeja
shoes	sepatu
shoot	némbak
shop	toko
shop	melanja
shopping	melanja
shore	pesisi
short	éndép
shortage	kuangan
shot	nembak
should	seharusné
shoulder	pala
shout	nyerit
show	nunjukang
show	acara
show me	nah coba tunjukin
shower	kayeh
shower	pancoran
shrimp	udang
shrink	anak sané ahli jiwa
shrink	nyenikang
shut	tekep
shut up	siep
shy	lek
sibling	nyama
siblings	nyama
sick	gelem
side	sisin
sigh	ngangsegang angkihan
sight	panyingakan
sightseeing	mejalan-jalan
sign	tanda
signature	tanda tangan
significant	penting pesan
silence	suwung
silent	siyep
silk	sutera
silly	lengeh
silver	selaka
similar	mesib
simp	nak belog
simple	sederhana
simultaneously	sarengan
since	uli
sincere	tulus
sincerely	salam hormat
sing	magending
singer	penyanyi
single	besik
single	bajang
sink	keleb
Sir	Bapak
sister	nyama luh
sister in law	ipah luh
sit	negak
site	genah
situation	kaadaan
six	nenem
sixteen	enem belas
sixty	enem pulu
size	ukuran
skill	katerampilan
skills	akeh katerampilan
skin	kulit
skinny	berag
skip	liwatin
skirt	rok
sky	langit
slave	budak
sleep	mesaré
sleeping	pules
sleepy	kiap
sleeve	lengen baju
slice	potong
slide	slaid
slightly	abedik pesan
slim	langsing
slip	meserod
slope	margi tuunan
slot	selot
slow	adéng
slowly	adéng-adéng
small	cenik
smart	dueg
smell	boné
smile	makenyem
smoke	asep
smoke	ngeroko
smooth	alus
snack	amikan
snail	siput
snake	lipi
snap	nengkik
snap	nyentil
snow	salju
so	apang
so cute	lucu pesan
so far	teked deriki
soak	rendem
soap	sabun
sober	sing punyah
soccer	sépak bola
social	sosial
society	masarakat
socks	kaos batis
soft	alus
software	sopwér
soil	tanah
sold	sampun maadep
sold out	telas madep
soldier	tentera
sole	asiki manten
solid	padet
solid	kompak
solution	solusi
solve	nyelesaiang
some	makudang-kudang
somebody	anaké sané
somehow	masi kéngken
someone	anak ané tusing katawang
something	sasuatu
sometimes	kadang
song	gendingan
soon	énggal
sophisticated	canggih
Sorani	Basa Sorani
sore	perih
sore throat	kolongan sakit
sorrow	kasengsaran
Sorry	Ampura
sort	jenis
sort	nyortir
sought	ngalih
soul	jiwa
soulmate	pasangan jiwa
sound	munyi
soup	sop
sour	masem
source	sumber
south	kaja
space	ruang
spam	sepam
span	jangka waktu
Spanish	Basa Spanyol
spare	cadangan
speak	nutur
special	kusus
species	spesies
specific	spesipik
spectacular	spéktakulér
speech	pidato
speechless	ten bisa ngomong
speed	kacepatan
spell	ngéja
spend	nelahang
spent	nelahang
spicy	lalah
spike	paku
spin	muter
spinach	jukut bayem
spirit	semangat
spit	makecuh
splendid	melah gati
split	kapisahang
spoil	ngemanjaang
spoiled	manying
spontaneous	cara sepontan
spoon	sinduk
spot	genah
spot	titik
spouse	kurenan
spread	nyebarang
spring	mekecog
spring	musim semi
square	lapangan
square	kotak
squeeze	bejek
squid	bé kenus
squirrel	semal
st	jl
stab	nusuk
stable	stabil
stack	numpukang
staff	stap
stage	tahap
stain	noda
stairs	jégjégan
stake	tohan
stalk	ngikutin
stall	marérén
stamp	perangko
stamp	setémpel
stand	genah medagang
stand	majujuk
standard	standar
star	bintang
start	nyumunin
started	sampun mulai
starving	kelaparan
state	kadaan
statement	pernyataan
station	stasiun
statue	togog
status	setatus
stay	ngoyong
stay safe	dumogi aman
steady	ten goyang
steak	daging mebakar
steal	ngemaling
steam	uap
steel	waja
steep	curem
stem	batang
step	langkah batis
stick	tungked
stick	némpél
stiff	kekeh
still	nu
still	ngoyong
sting	nyenget
stingy	demit
stir	ngadukang
stock	setok
stolen	kepaling
stomach	basang
stone	batu
stood	majujuk
stool	kursi tegeh
stop	setop
storage	genah nyimpen
store	toko
store	nyimpen
storm	bakungan
story	satua
stove	kompor
straight	lurus
straightforward	terus terang
strain	watesan
strange	solih
stranger	nak sing kenal
strategy	stratégi
straw	sedotan
strawberry	strobéri
streak	corét
stream	aliran
street	rurung
strength	kakuatan
stress	ngrasa setres
stretch	melar
strict	ketat
strike	gebugan
strike	ngebug
string	tali
strip	muka baju
strip	garis
strive	berjuang
stroke	setrok
stroke	serangan
strong	kuat
struck	kene gebug
structure	susunané
struggle	perjuangan
struggling	barusaha
stubborn	cengkal
stuck	sing bise maju
student	murid
study	malajah
studying	melajah
stuff	barang
stunning	ébat pesan
stupid	lengeh
style	gaya
subject	subjek
submission	pangiriman
submit	kirim
substance	substansi
substitute	pangganti
subtle	ten menonjol
succeed	berasil
success	kasuksesan
successful	sukses
such	misalné
such as	misalné
suck	nyesep
sudden	mendadak
suddenly	mendadak
suffer	ngalamin derita
suffering	ngraksa
sufficient	cukup
sugar	gula
suggest	nyaranang
suggestion	saran
suit	cocok
suit	setélan
suitable	cocok
suitcase	koper
sum	jumlah
summary	ringkesan
summer	musim kebus
summit	pertemuan
sun	surya
sunday	redité
sunny	galang matan ainé
sunset	matan ai keleb
sunshine	sinar matan ai
super	ébat gati
superior	super gati
supervisor	pengawas
supper	medaar peteng
supply	persediaan
support	dukungan
support	ngadukung
suppose	nganggep
supposed	seharusné
sure	nah
surface	permukaan
surge	muncul
surgery	operasi
surname	adan kaluarga
surprise	kejutan
surprised	tengkejut
surrender	nyerah
surrounding	sakitarné
surveillance	pangawasan
survey	surpei
survive	bertahan idup
suspect	nyangka
suspended	katangguhang
suspicious	curiga
sustain	ngapertaanang
sustainability	kaberlanjutan
sustainable	makalanjutan
swag	mamé rang gaya
swallow	kedis swalo
swallow	ngelekang
swap	nukar
swear	masumpah
sweat	peluh
sweater	baju anget
sweep	nyampat
sweet	manis
sweet dreams	dumogi melah impiané
sweet tooth	demen daaran manis
sweetheart	jantung ati
swell	beseh
swell	becik
swelling	beseh
swim	ngelangi
swimming	ngelangi
swing	mayunan
swing	ayunan
switch	matukar
swollen	beseh
sword	pedang
symbol	simbul
sympathy	rasa simpati
symptoms	gejalané
system	sistem
table	meja
tackle	nanggulangin
tag	tanda
tail	ikut
take	nyemak
take away	mungkus
take care	ati-ati
take off	ngelésang
taken	majemak
talk	nutur
talkative	demen nutur
tall	tegeh
tap	keran yeh
tap	ngetok
tape	rekaman
tape	selotip
target	sasaran
task	gaén
taste	rasa
tasty	jaen pesan
taught	ngajain
tea	teh
teach	ngajain
teacher	guru
team	tim
tear	yeh mata
tear	nguwekang
tears	yeh mata
tease	ngoda
technology	téknologi
teeth	gigi
tell	ngorahin
tell me	orahin tyang
temper	énggal galak
temperature	suhu
temple	pura
temporary	samentara
ten	dasa
ten thousand	sepulu ribu
tenant	panyewa
tend	cenderung
tendency	kacenderungan
tender	bélék
tender	panawahan
tense	tegang
tension	kategangan
tent	tenda
tentative	tondén pasti
term	masa
terms	istilah
terrible	jelék gati
terrific	luar biasa gati
territory	wilayah
test	tes
text	téks
than	daripada
thank	ngaturang suksma
thank you	Suksma
Thank you for your patience while we investigate shipment	Suksma untuk kasabaran idané ngantosang panyelidikan pangiriman niki.
thank you so much	suksma pesan
thank you very much	suksma dahat
thanks	suksma
Thanks for using our app	Suksa sampun nganggen aplikasi raga
that	nika
that is	nika
that's good	melah pun
theft	indik pemalingan
their	gelah idané samian
them	meréka
theme	tema
themselves	anaké samian ento
then	terus
then	pidan
theory	téori
there	derika
there are	wénten
there is	wénten
therefore	kerana nika
these	niki samian
they	ia makejang
they are	idané samian
thick	tebel
thief	maling
thigh	paan
thin	tipis
thing	unduk
things	prakara
think	mekeneh
third	kaping telu
thirsty	bedak
thirteen	telulas
thirty	telung dasa
this	niki
this is	niki madan
thorough	cermat
thoroughly	sacara saksama
those	nika samian
though	yadiastun
thought	mekeneh
thoughtful	misi pertimbangan
thoughts	pamikiran
thousand	siyu
thread	urutan topikné
thread	benang
threat	anceman
threaten	ngancem
three	telu
threshold	patokan
thrilled	semangat pesan
thrive	tumbuh makembang
throat	kolongan
through	ngaliwatin
throughout	sepanjang
throw	ngentungang
thumb	inan lima
thunder	grédég
Thursday	Wrespati
thus	kerana ipun
tick	nyéntang
tide	ombak pasang
tidy	apik
tie	negul
tie	dasi
tiger	macan
tight	tekek
Tigrinya	Basa Tigrinya
time	dina
timid	kalem
tiny	cenik pesan
tip	pis tip
tips	tips
tire	ngranaang kenyel
tire	ban
tired	kenyel
tissue	tisu
title	judul
to	antuk
to	lakar
to be	lakar dadi
toast	manggang
toast	roti mepanggang
today	dina jani
toddler	nak raré
toes	jerijin bais
together	sareng-sareng
toilet	genah ngenceh
told	orahina
tolerance	toléransi
tolerate	katoleransi
tomato	tomat
tomorrow	binmani
tongue	layah
tonight	nyanan peteng
too	masi
took	nyemak
tool	alat
tools	alat-alat
tooth	gigi
top	baduur
top	paling duur
topic	topik
torn	uwék
torture	nyiksa
total	samiané
touch	nyolek
tough	kuat
tour	jalan makeliling
toward	manuju
towards	manuju
towel	anduk
town	kota cenik
toxic	toksik
trace	ngalacak
track	jalan
track	gending
trade	madagang
trade	nukarang
tradition	kabiasaan
traditional	tradisional
traffic	lalu lintas
trail	jalur mejalan
train	sepur
train	ngelatih
training	pelatian
trait	sipat
traits	sipat
transfer	transper
transition	peralihan
translate	nerjemahan
transparent	ngenah bening
transport	mindahang
transportation	transportasi
trap	ngajebak
trash	sampah
trauma	trauma
travel	maplesiran
tray	talam
treasure	harta
treat	ngemerlakuin
treat	dedaaran
treatment	pangubadan
treatment	perlakuan
tree	punyan
tremendous	ebat gati
trend	tren
trial	parcobaan
trick	akal
tried	kenyel
trigger	ngranaang
trim	ngerapiang
trip	parjalanan
trouble	masalah
trousers	celana panjang
truck	trek
true	BENEH
trunk	kayun punyanan
trunk	bagasi mobil
trust	kapercayaan
truth	kabenehan
try	nyoba
Tsonga	Basa Tsonga
tube	tabung
Tuesday	Anggara
tuition	ongkos pangajahan
turkey	nagari turki
turkey	kalkun
turmeric	kunyit
turn	pengkolan
turn	giliran
turtle	penyon
tutor	pangajar
twelve	duang olas
twenty	duang dasa
twenty-one	duang dasa besik
Twi	Basa Twi
twice	ping pindo
twist	kejutan
twist	belokan
two	kalih
type	jenis
typical	sané biasa
ugly	bodo
ultimate	sané terakhir
umbrella	pajeng
unable	ten ngidaang
uncle	uwak
unconscious	ten sadar
under	ring betén
under	kuangan tekén
underneath	ring betén
underrated	karéméhang
understand	ngerti
understood	sampun ngerti
unfortunately	sayangné
uniform	baju seragam
unique	melénan
unit	unit
university	perguruan tinggi
unknown	sané ten kauningin
unless	kacuali
until	kanti
unusual	sing biasa
up	menék
up to you	terserah
update	pembaruan
update	gatra terbaru
upgrade	paningkatan
upon	dugasé
upset	kecewa
urban	parkotaan
urge	norong
urgent	genting
us	raga samian
use	nganggon
use	penganggon
used	lad manggo
useful	ngelah kagunaan
useless	tan ngelah kagunaan
usual	lumrah
usually	biasané
utility	kagunaan
vacation	liburan
vaccination	paksinasi
vaccine	paksin
vacuum	pakum
vague	sing jelas
valid	sah
valley	lembah
valuable	meduwé harga
value	nilai
variety	jenis
various	macem
vary	megenep macemné
vase	wadah bunga
vast	linggah sanget
vegetable	jukut
vegetables	jukut
vehicle	kendaraan
vendor	dagang
venom	racun
venture	ngadu nasib
venue	genah acara
verify	peripikasi
versatile	ngelah liyu kagunaan
version	pérsi
vertical	pertikal
very	gati
very good	becik pesan
vessel	kendaraan
via	liwat
vibe	suasanané
vibes	suasana
vicious	corah
victim	korban
video	pidio
view	pandangan
village	desa
villain	nak jahat
vinegar	cuka
vintage	modél kuno
violence	kakerasan
violent	parilaku keras
viral	dadi énggal terkenal
virgin	bajang
virtual	pirtual
virtue	kamelahan
vision	panyingakan
visit	nengokin
visual	pisual
vital	penting gati
vivid	jelas gati
vocabulary	kosakata
voice	munyi
void	widang kosong
volume	liun polume
volunteer	sukarela
vomit	muntah
vulnerable	sing kuat gati
wage	upah
wages	upah
waist	bangkiang
wait	antos
waiter	anak sané ngelayanin
waiting	ngantosang
wake	bangun
wake up	bangun
walk	mejalan
walking	mejalan
wall	tembok
wallet	dompet
wander	makelana
wanna	dot lakar
want	dot
wanted	sedeng aliha
war	perang
wardrobe	panganggo
warehouse	gudang
warm	anget
warn	ngingetin
warning	paringatan keras
warrior	kesatria
was	pidan adalah
wash	ngumbah
waste	luwu
watch	jam tangan
watch	mebalih
watch	awasin
water	yéh
watermelon	sumangka
wave	ombak
way	cara
we	iraga
we are	ragané
we can	ragané samian bisa
weak	lemet
weakness	kalemahan
wealth	kasugihan
wealthy	makmur
wear	nganggon
wearing	nganggé
weather	cuaca
wedding	pawiwahan
Wednesday	Rebo
weed	rumput
week	minggu
weekend	pamuput minggu
weight	baatné
weird	anéh
welcome	rahajeng rauh
welfare	kasejahteraan
Well	Becik
well done	gaé melah
went	lunga
were	pidan adalah
west	kauh
wet	belus
whale	bé paus
what	napi
what about you	lamun idané punapi
what are you doing	napi kegaé
what are you doing now	napi kegaé jani
what are you doing right now	napi kegaé jani
what do you do	mekarya napi
what do you do for a living	napi karyan idané
what do you mean	napi sané kamaksud
what do you want	napi sané kadotang
what happened	napi kejadiané
what is	napi
what is this	niki napi
what is your job	napi karyané
what is your name	napi wastan idané
what's up	napi kabaré
what's your name	napi wastan idané
whatever	apa gén
whatever	terserah gén
wheat	gandum
wheel	roda
when	dugasé
when	pidan
whenever	pidan gén
where	dija
where are you	dija idané
where are you from	saking napi
where are you now	dija idané jani
where do you live	ring dija ngoyong
where is	dija
whereas	padahal
whether	entah ento
which	sané
while	sambilanga
whisper	bisik-bisik
whistle	suwiran
whistle	mesuwir
white	putih
who	sira
who are you	idané sira
who is	nyén sané
who is this	sira niki
whole	samian
whom	sané
whose	gelahné
why	kenapi
why not	kenapi ten
wicked	kejem
wide	linggah
widow	balu
width	lebarné
wife	kurenan
wild	rengas
will	wasiat
will	lakar
willing	ngelah niat
win	menang
wind	angin
window	jendela
windy	bek angin
wine	anggur
winter	musim dingin
wipe	ngelapin
wire	kawat
wisdom	kawicaksanaan
wise	wicaksana
wish	kainginan
wish you all the best	dumogi maan rahayu
witch	dukun
with	sareng
withdraw	nyemak
withdraw	narik
withdrawal	panarikan
within	di dalem
without	sing termasuk
witness	saksi
witty	cerdas
wolf	serigala
woman	nak luh
women	nak luh
won	menang
won't	ten lakar
wonder	metakon-takon
wonderful	melah gati
wood	kayu
wool	kain wol
word	kata
words	kata
work	mekarya
work out	olahraga
working	sedeng megaé
world	jagat
worm	uled
worn	buwuk
worried	masa kuwatir
worry	kuatir
worse	lebih jelé
worship	mamuja
worst	sané paling berek
worth	nilainé
worth it	sepadan
worthy	sané pantes
would	mekikén
wound	berung
Wow	Wah
wrap	mungkus
wrap	bungkusan
wrath	kapedihan
wrist	pergelangan lima
write	nulis
Write here	Tulis deriki
writing	tulisan
written	masurat
wrong	pelih
wrote	nulis
yard	natah
yawn	mewahem
Yeah	Nah
year	warsa
years	warsa
yeast	ragi
yell	nyerit
yellow	kuning
Yes	Nggih
yes baby	nggih cinta
yes dear	nggih sayang
yes honey	nggih sayang
yes my love	nggih sayangku
yes of course	inggih pasti
yesterday	ibi
yet	tondén
yield	ngasilang
yield	nyerah
you	idane
you are	Idané
you are beautiful	idané jegég pesan
you are so beautiful	idané jegég pesan
you are welcome	sami-sami
you can	Idané ngidaang
You know	Uning idané
you too	sami-sami
you're welcome	suksma mawali
young	anom
your	gelah idané
your welcome	mewali
yourself	idané padidi
youth	pemuda
you’re welcome	sami-sami
yummy	jaan
zero	nol
