a	sada
a little	sitik
a lot	melala
a lot of	melala
abandon	la diate
abandon	tertading
abandon	tertadingken
abandoned	la diate
abide	tinggal
ability	beluh
able	beluh
able	banci
about	kerna
above	i datas
abroad	ndauh
abroad	luar negeri
absence	la reh
absent	la hadir
absolutely	ue tuhu kel
absorb	cepcep
absorb	cahcah
abstract	abstrak
absurd	absurd
abundance	erjunjung sampur
abundance	sampur
abundance	simpar
abundant	simpar
abuse	niksa
accent	aksen
accept	alo
accept	aloken
access	sentabi
accident	kecelakan
accommodation	ingan tading
accomplish	dat sa
accomplished	dung
accomplished	dungi
according	adi ia nari
account	profile
account	akun
accuracy	si pasti
accurate	payo
accurate	tengteng
accused	tuduhken
ache	mesui
ache	sui
achieve	seh
achievement	si i capai
acknowledge	Meteh
acknowledge	Eteh
acquaintance	kenalen
acquire	dat sa
acquired	ncikep
acquisition	ipindo
acquisition	i tempatken
across	nyebrang
across	sebrang
act	erkelakuen
action	aksi
active	mejingkat
activities	pedahin
activity	dahi
actor	aktor
actual	situhuna
actual	tuhu
actually	situhuna
acute	akut
adapt	persada
add	I tambah
addicted	kecanduan
addition	tambahen
additional	tambahen
address	alamat
adequate	Biasa
adjacent	bena
adjective	adjektif
adjust	sesuaiken
admire	ngena
admit	siakui
adopt	adopsi
adorable	ulin
adorable	mejile
advance	leben
advanced	canggih
advantage	keuntungen
adventure	petualangen
adverb	kata kerja
advertisement	iklan
advertising	momo
advertising	iklan
advice	saran
advise	mere kata pergegeh
advocate	ngiahken
aesthetic	mejile
affair	lua-lua
affair	erlua-lua
affect	panpan
affection	kekelengen
afford	dat
afford	bias
affordable	terjangko
afraid	mbiar
after	kenca dung
after	enggo
after	menggo
afternoon	Ciger
afternoon	Suwari
afterwards	lepas e
again	lagi
against	alu
against	lawan
age	umur
agency	agensi
agent	agen
aggressive	merawa
agile	bulayat
ago	si enggo lewat
agree	pe
agreement	kata arih
agriculture	agrikultur
ahead	arah lebe
ahead	leben
aid	penampat
aim	tuju
air	udara
airport	bandara
aisle	lorong
alarm	tanda
alcohol	alkohol
alert	metenget
alive	nggeluh
all	kerina
all right	merandal
all right	payo
all the best	kerina si mehuli
allow	pediat
allowed	i pediat
almost	hampir
alone	sisada
along	ras
along	ikut
already	enggo
Alright	erkite-kiteken
also	pe
alternative	Dalan sideban
although	anem
although	anem pe
always	lalap
am	ialah
amazing	jore
amazing	mejuah-juah
ambiguous	ambigu
ambition	kiniteken
ambitious	ercita-cita
amend	pegancih
amend	gancih
amid	i pusung
among	kelang-kelang
among us	i bas kita
amount	beligai
amusing	meriah
an	sada
analysis	analisis
ancestors	si nai-nai
anchor	jangkar
ancient	gel-gel
and	ras
and you	ras kam
angel	malekat
anger	rawa
angle	suki
angry	merawa
animal	durbia
ankle	pergelangan nahe
anniversary	peringaten tahunan
announcement	momo
annoy	teran
annoyed	terganggu
annoying	ngilas ate
annual	tehunen
anonymous	la sieteh
another	si deban
answer	jawaben
anticipate	saro
anticipate	erem
anxiety	aru ate
anxious	aru ate
any	tiap
anymore	nari
anyone	ise saja
anything	kai pe
anyway	erkite-kiteken
anyways	ku pebegi
anyways	cakap-cakap
apart	sirang
apartment	apartemen
apologize	ersentabi
apparent	pengidah
apparently	kepeken
appeal	mejile
appear	reh
appearance	idahna
appearance	teridah bage
appeared	mulbang
appeared	mulgap
appetite	ngidan erpangan
apple	apel
application	aplikasi
apply	siterapken
apply	siperaken
appointment	janji
appreciate	hergai
appreciation	meherga
approach	deher
approach	sideher-deheren
appropriate	pantas
approval	persetujun
approve	isetujui
approved	sada kata
approximately	kira-kira
april	April
arbitrary	arbitrase
architect	arsitek
architecture	arsitektur
archive	arsip
are	ialah
are	adalah
are you	kam kin
are you busy	sibuk kam
are you married	enggo kam erjabu
are you married or single	enggo kam erjabu entah lenga
Are you still there?	je denga kam?
are you there	je kin kam
area	ladang
area	area
argue	rubat
argue	cakapken
argument	argumen
arise	pultak
arise	ndarat
arm	tan
army	anak bala
around	kelelung
arrange	nusun
arrangement	pengaturen
arrival	reh
arrive	seh
arrived	seh
arrogant	medelus
arrogant	delus
arrow	panah
art	seni
article	artikel
artificial	bahanen
artificial	beluh-beluhen
artist	pande
as	bali
as	bagi
as long as	kidekah
as long as	sidekah
as well	bagi
as well as	bali
as well as	tempa
ash	rabu
ash	abu
ashamed	mela
ask	sungkun
asked	sungkun
asleep	tunduh
asleep	metunduh
aspect	arah rupa
aspect	arah segi
Assamese	Assamese
assault	perangi
assembly	seperempat
assertive	assertive
assess	menilai
assessment	ujian
asset	kepunaen
assets	erta
assign	tanda
assignment	tugas
assignment	dahin
assist	nampati
assist	sampat
assistant	penampat
associate	Temanna
associated	berhubungen
association	asosiasi
assume	akap
assumption	akap
assumption	pengagak
at	i
at	bas
at least	egia
ate	Man
athlete	atlet
attach	rikut
attached	enggo ikut ikut
attachment	lampiran
attack	pegas
attempt	anggap
attempt	dahin
attend	reh
attendance	kerehen
attention	peraten
attitude	perukuren
attract	minahi
attraction	jerat
attractive	mejingkat
attractive	mejile
attribute	atribut
audience	penonton
august	agustus
aunt	bibi
aunt	mami
aunty	bibi
authentic	si asli
author	si penulis
authority	si erkuasa
autumn	musin gugur
available	lit
average	penegah-nengah
avoid	elak
avoid	silah
awake	keke
awake	medak
award	penghargaan
aware	eteh
awareness	eleh
away	ndauh
away	lawes
awesome	merandal
awesome	mejile
awful	la mehuli
awful	latlat
awkward	hangke
awkward	mehangke
Aymara	Aymara
baby	bayi
bachelor	sarjana
back	ngulih
back	ulih
background	arah pudi
bad	la uli
bad	a mehuli
bag	tas
bait	pinah
bait	empan
bake	adonan
bakery	roti
baking soda	Soda kue
balance	seimbang
balance	seri
ball	bola
Bambara	Bambara
banana	pisang
band	pita
bang	dor
bank	bank
bar	batang
barely	jarang
bargain	tawar
bark	kulit batang kayu
barley	page
barrier	cikar
barrier	baleng
base	pantil
base	alas
based	alas
basement	basemen
basic	Dasar
basically	dasar
basically	alas
basil	kumangi
bastard	metai
Batak Karo	Batak Karo
batch	bagin
bath	ercebah
bath	ridi
bathroom	Kamar Mandi
battery	baterai
battle	perang
battle	peperangen
bay	teluk
be	jadi
be	turah
be careful	jaga-jaga
beach	pante
beam	kayu balok
beans	bontis
bear	tahan
bear	rem
bear	angkar
beard	janggut
bearing	bantalen
beast	kinirawan
beat	kalah
beautiful	mejile
beauty	mejile rupana
became	erkiteken
because	sebab
because	perban
become	reh na
bed	ingan medem
bedroom	ingan medem
bee	uani
bee	wani
bee	tengguli
beef	daging
been	pernah
beer	bir
before	sope
began	imulai
begin	mulai
beginning	mulai
behalf	guna
behalf	mbelin
behave	perbahanenta
behavior	kelakuen
behaviour	kesemalen
behind	pudi
being	mahkluk
belief	kiniteken
believe	tek
belly	mbeltek
belong	jang na
beloved	kekelengen
below	teroh
below	teruh
belt	ikat pinggang
bench	manca-manca
bend	mbengkokken
beneath	i teruh
benefit	laban
benefits	manpaat
beside	i samping
besides	enca e
best	si bagus na
best of luck	pejoreken
best regards	mejuah-juah
better	madan
between	kelang
beverage	inemen
beyond	arah darat
Bhojpuri	Bhojpuri
bias	La tutus
biased	rembo
bicycle	gareta
bid	penawaren
big	galang
bike	sepeda
bill	bon
bind	tambat
bind	ikut
bind	rakut
bird	perik
birthday	Ulang Tahun
bit	sitik
bite	karat
bitter	pagit
black	biring
black	mbiring
blade	pedang
blame	situduhen
blank	lungun
blanket	selimbut
blanket	caben
blast	beltuk
blast	telkas
bleach	mbentaren
blend	persada
bless	pasu-pasu
blessed	i pasu-pasu
blind	la banci ngidah
blind	buta
bliss	kemeriahen
block	tutup
blood	dareh
bloom	rudang
blow	embus
blue	biru
blue	meratah
blunt	la entajem
board	salang
board	belang
boat	kapal
body	daging
boil	luam
bold	tebal
bond	erteman
bone	tulan
book	buku
boost	juljul
booster	si empacu
boot	cepatu
boots	sulampak
boots	cepatu
border	teneh
bore	leja
bore	ngelngel
bored	leja
boring	leja
boring	ngel-ngel
born	tubuh
borrow	injam
borrow	layap
boss	bos
both	duana
bother	usur
bottle	botol
bottom	siteruh
bought	embah
bought	baba
bounce	mantul
bound	ersda
boundaries	cikar
boundaries	baleng
bow	bungkuk
bow	bongkok
bowl	cayak
bowl	mangkuk
box	tagan
box	kotak
box	ertabung
boy	anak si dilaki
boyfriend	rondong
bracelet	gelang
brain	otak
branch	ranting
brand	merek
brave	pan
breach	nungsang
breach	ngelawesi
bread	roti
break	ngadi
breakfast	sarapen
breast	tenten
breath	kesah
breathe	erkesah
breed	keturunen
breed	jenis
brick	bata
bride	si sereh
bridge	jembaten
brief	Sentisik
bright	terang
brilliant	pentar
bring	baba
bro	senina
broad	mbelang
broadcast	Penyiaran
broke	penggel
broken	ceda
broom	napui
broom	sapu
brother	senina
brother	turang
brother in law	silih
brought	nukur
brought	tukur
brown	coklat
brush	sikat
brush	brus
bucket	buket
buddy	temah meriah
budget	perhitungen
bug	kabang-kabang
build	bangun
building	gedung
built	ibangun
bulk	mbue jumlahna
bulk	melala jumlahna
bull	banteng
bully	iancam
bump	dempar
bump	dumpur
bump	nendeng
bunch	perjergung
bunch	jergung
bundle	paket
burden	beban
buried	urukken
burn	meseng
burst	baltuk
bury	nguruk
bus	motor galang
bus	bis
bush	peren
bush	rambah
business	usaha
bust	emo
busy	picet dahin
but	tapi
butter	mentega
butterfly	kaba-kaba
button	tombol
buy	nukur
buy	tukur
by	ndat
by	ndatken
by the way	e bage kin
bye	mejuah-mejuah
cabbage	kol
cabinet	lemari
cage	kurungen
cage	karang
cake	kue
calf	anak lembu
call	dilo
call me	dilo
called	i dilo
called	i lebuh
calm	malem ukur
calm	tenang
came	enggo reh
campaign	kampanye
can	banci
can	beluh
can	bancing
can't	la banci
Cancel	la surung
cancer	kanker
capable	banci
capable	beluh
capacity	kapasitas
capital	modal
caption	keterangen
capture	ngerigep
capture	nambut
car	motor
career	karir
careful	anjar-anajr
carefully	germet
carefully	mejantang
careless	ungkas
caring	tera
caring	gagang
carpenter	pande kayu
carpet	karpet
carrot	wortel
carrot	artol
carry	mbaba
carry	baba
carry on	taruhken
carry out	baba
case	soal
case	kasus
cash	sen
cast	kalak
castle	astana
casual	Biasa
cat	kucing
catch	tangkap
catch	dat
category	kategori
cattle	lembu
caught	jerngem
cause	alasen
cause	sabap
caution	momo
cautious	jaga-jaga
cave	geriten
cease	nonggok
cease	ceng
ceiling	loteng
celebrate	rayaken
cell	kurungen
center	pusat
center	pusung
center	pusong
century	abad
cereal	sereal
ceremony	kerja
certain	tek
certainly	si tuhu na
certificate	sertifikat
chain	rante
chair	kursi
challenge	tantangen
chance	kesempaten
change	ganti
change	sambar
change	tukar
chaos	keributen
character	karakter
characteristics	karakteristik
charge	galar
charge	galari
charity	amal
charming	mejile rupana
chart	bagan
chase	ngayaki
chat	cakap-cakap
chat	percakapen
cheap	murah
cheat	calus
cheating	tokohi
check	nin
check	nihen
cheek	kurum
cheek	mekurum
cheer	ersurak
cheerful	ceria
cheers	tos
cheese	keju
chemistry	kimia
cherish	meriah
chess	catur
chest	tenten
chew	cengatngat
chew	bulgam
chicken	Manuk
chief	ketua
child	danak
child	si i pupus
childhood	kitik denga
children	kanak-kanak
children	danak-danak
chill	bergeh
chimneys	lubang
chimneys	pinusu
chin	isang
chocolate	merengge
choice	Pilihen
choose	pilih
choose	mindan
chop	ngkeret-keret
chores	dahin i jabu
chubby	mbahut
chubby	tembam
church	Gereja
cinnamon	kayu manis
circle	bulat
circumstances	soal
citizen	jelma
city	kota
claim	siaku-akun
clarify	ngantusi
clarify	nerangken
class	kelas
clay	taneh liat
clean	jelis
clear	terang
clerk	perdahin
clever	beluh
client	klien
cliff	tebing
climate	iklim
climb	nenagkih
climb	nangkih
clingy	tergantung
clock	jam
close	tutup
cloth	uis
clothes	uis
cloud	awan
cloudy	gelap nandangi udan
clown	badut
clue	petunjuk
clumsy	kikuk
cluster	kelompok
coach	pelatih
coal	batu bara
coast	pesisir
coat	jaket
coffee	kopi
cognitive	pikir
coincidence	rembang
coincidence	katikana
cold	bergeh
collapse	Rontas
collapse	Runtuh
collar	kerahung baju
colleague	teman erdahin
colleagues	teman sejawat
collect	ngumpulekn
collection	erta-erta
college	perkuliahen
color	labuh
color	curak
color	rupa
colorless green ideas slept furiously	Adi tenang lampas kita medem
colour	labuh
colour	curak
colour	rupa
column	kolom
comb	suri
combination	persada
combine	andingen
come	reh
come here	ku jenda
come here	ariko
come on	reh
come on	mari
comfort	malem ate
comfort	senang
comfortable	malem
coming	reh
coming soon	minter
coming soon	ngkotepi
command	pedah
command	mente
comment	komentar
commercial	iklan
commission	upah
commit	lakuken
commitment	janji
committed	erkomitmen
commodity	merdem
common	biasa
communicate	peseh
communicate	mereken
communication	Komunikasi
community	teman-teman
community	teman arih
commute	perdalinen
commute	perdalanen
companion	perusahaan
company	teman
compare	i bandingken
comparison	uman
comparison	anding
compassion	keleng ate
compassionate	medes ukur
compassionate	erkeleng ate
compatible	la megombang
compete	ersaing
competent	guru
competition	lomba
competitive	erlumba
complain	komplain
complaint	jungut-jungut
complement	sangkep
complement	ngkuhi
complete	dung
complete	enggo dung
completely	kep
completely	kuh
completely	sangkep
complex	kompleks
compliance	teman
complicated	melala ukur
compliment	la nggalar
comply	patuh
comply	nuhuken
composition	komposisi
compound	mpersadasa
comprehension	andingen
comprehensive	Si erbeluh
compromise	dalan tengah
compulsory	wajib
computer	komputer
concentrate	sari
concept	konsep
concern	aru ate
concerned	morah
concert	konser
conclusion	asil
concrete	semen
condition	keadaan
conditions	keadaan
conduct	atur
conference	konfrensi
confess	pengakun
confidence	la permela
confident	tek
confirm	merawa
conflict	rubati
confused	gelut
confusion	jengang
confusion	laler
confusion	gulut
congrats	mejuah-juah
congratulation	mejuah-juah
congratulations	mejuah-juah
conjunction	konjungsi
connect	sambung
conquer	ginemgem
conquer	nembah
conscious	Sadar
consciousness	kesadaren
consent	simetehen
consequences	akibat
conservation	pengulihi
conservative	konserfatif
consider	ukur-ukuri
considered	si cakapken
consist	risi
consistency	la melukah rubah
consistent	tutus
constant	tetap
constantly	rusur
constantly	tetap
constipation	juram
constipation	jeram
constipation	beheng
construction	sangana mbagun
consume	man
consumption	komsumsi
contact	kontak
contagious	langket
contain	si isina
contains	isin
contemporary	sesuai jamanna
contempt	pengkilang
contempt	penaling
content	inti
content	isi
contest	kontes
context	konteks
continent	banua
continue	Minter
continue	Terus
contract	kontrak
contrast	erlawanen
contribute	si ibere
contribution	sumbangen
control	ngangkar
control	erem
control	antan
controversial	kontroversial
convenience	sikap
convenience	nyaman
convenient	malem ate
convenient	senang
conversation	percakapen
convert	miser
convert	mesalin
convert	ngiserken
convey	i angkut
convince	erbansa nggit
convinced	ngande-ngande
cook	Tasak
cooking	erdakan
cool	mbergeh
cooperation	arih
cope	ngatasisa
copper	tembaga
core	mbagas
corn	jong
corner	suki
correct	benar
correct	la salah
cost	erga
costume	uis
cottage	sapo godang
cotton	kapas
couch	sofa
couch	kursi
cough	mbatuk
could	banci
council	dewan
count	kira
count	kera
counter	ngatasi
counter	ngelawan
country	negara
countryside	kuta
couple	erpasangen
courage	pang
course	dalan
course	erdalanen
court	lapangan
courtesy	kinihamaten
cousin	sembuyak
cover	sampul
cow	kerbo
coward	percikcik
cozy	salang ukur
cozy	sikap
crab	ketam
crack	tubing
crack	celgang
crack	pecah
craft	pande
crap	perbualen
crash	nendeng
craving	pemindon
craving	sura-sura
crawl	nggarang
crazy	adon
create	erban
create	ban
creative	kreatif
credit	kredit
creep	kalak ane
creepy	ngeri kel
crew	anak buah
crime	ihat
crime	jahat
cringe	ciga
crisis	krisis
criteria	kriteria
critical	kritis
criticism	melawen
crop	nastas
crop	ngkeret
crops	suan-suanen
crops	sinuan-sinuanen
cross	salib
crow	gagakl
crowd	kalak enterem
crowded	melala jelma
crown	mahkota
crucial	perlu
crucial	penting
crucial	metaruk
cruel	merambit
cruise	erlayar
crush	hermuk
crush	lengas
cry	Ngandung
cucumber	cimen
cuddle	dakep
culture	Adat
cunning	macik
cup	Calung
cupboard	lemari
curb	singatur
curb	pengatur
cure	si erbanca malem
curfew	jam malam
curiosity	penasaran
curious	sungkun
curious	nungkun
curly	perngut
currency	sen
current	gundari
currently	sangana
curse	numpahi
curtain	gorden
cushion	kalang ulu
custom	si biasa
customer	si nukur
customs	bea cukai
cut	potong
cute	pertawan
cute	man tawan
cycle	siklus
cycling	bersepeda
dad	bapa
daddy	bapa
daily	suwari-wari
dairy	produk susu
dam	belanen
damage	ceda
damn	andikoh
damn	andih
damp	ngisap
dance	landek
danger	mara
danger	ganggang
dangerous	bahaya
dark	gelap
darling	turang
dash	kiam
data	datas
date	pasangan
date	tanggal
daughter	pupus
day	suwari
dead	mate
deadline	seh paksana
deaf	tuli
deal	sue
deal	sada ukur
dear	kekelengen
Dear All	mejuah-juah
Dear Customer	sinihamati kami
Dear Customer	man ban ndu
Dear Customer	si nukur
Dear Parents	mejuah-juah nande ras bapa
Dear Sir	mejuah-juah pak
Dear students	mejuah-juah murid-murid
Dear Team	mejuah-juah tim kerina
death	kematen
debate	debat
debit	debit
debris	puing
debt	rutang
debt	utang
decade	dekade
decay	macik
deceased	pinakit
deceive	tokohi
december	Desember
decent	nggo banci
decide	putusken
decided	putusken
decision	keputusen
deck	ture
decline	tulak
decrease	erkurang
dedicated	Tutus
dedication	kininggeten si pegegeh
deed	akta
deep	mbagas
deer	rusa
default	dagingna
defeat	naluken
defend	gengken
define	i jelasken
definitely	tetap
definition	erti
degree	derajat
delay	lit man timaan
delayed	tunda
delayed	cuncun
delete	hapus
deliberate	sajaken
deliberate	itutus
delicate	lemah
delicious	entabeh
delicious	tabeh
delight	meriah
delight	senang
delighted	meriah ate
deliver	naruhken
delivered	taruhken
delivery	pengirimen
demand	pemindo
demand	pindo
demanding	pindo
democracy	demokrasi
demon	begu
demonstrate	Mbuktiken
denied	tulak
density	pelpel
density	seset
dentist	dokter gigi
deny	I tolak
department	bagin
departure	kebrangkaten
depend	molah-olah
depend	molah-molah
deploy	gawer
deploy	derak
deploy	tabur
deposit	setoran
depressed	jutjut
depressed	meriso
depression	depresi
depth	bagas
describe	penjelasen
description	penjelasen
desert	gurun
deserve	patut
deserve	arus
design	gambar
design	desain
designation	penggelaren
desire	sura-sura
desk	meja
despair	getem pusuh
desperate	Ugapa pe banci
despite	gia
despite	amina gia
dessert	pangan manis
destination	arah
destination	tuju
destiny	Pergeluhna
destroy	ngkernepken
destruction	kernep
destruction	sontar
destruction	lengas
detail	limet
details	detail
detect	tandai
determination	berkat tutus
determine	sitentuken
determined	tutus
devastated	sontar
develop	kimbang
developed	ngkimbangken
development	perdalanen
device	alat
devil	begu
devoted	tetap ukur
devoted	memes
Dhivehi	Dhivehi
diabetes	diabetes
diarrhea	ciret
diary	cataten
diary	suratenken
dictionary	kamus
did	lakoken
die	mate
died	mate
diet	atur per pan
difference	andingen
different	lain
difficult	mesera
dig	tukak
dig	uruk
dignity	martabat
diligent	mejingkat
dinner	man karaben
dip	bagasken
direct	langsung
direction	petunjuk
director	direktur
dirt	erdemak
dirt	melket
dirty	meleket
dirty	liam
disable	morah
disabled	celek
disabled	cengga
disappear	bener
disappointed	tondel ukur
disaster	bencana
discard	ambekken
discharge	mulihi
discharge	pulihi
discipline	sikap ngatur waktu
discount	diskon
discover	meteh
discrimination	diskriminasi
discuss	diskusi
discuss	i diskusiken
discussion	runggu
disease	pinakit
diseases	pinakit
disguise	iubahna dirina bali ras si atena tiruna
disgusting	ciga
dish	pinggan
dish	capah
dishes	pinggan
dismiss	mbubarken
dispatch	merentahken
display	Si i idahken
disposal	menterken
disposal	abekken
dispute	sengketa
dispute	pasal
distance	jarak
distinct	ndauh
distinguish	la si persada
distress	mesera
distribution	i bagiken
district	arah area
disturb	ngganggu
ditch	dalin lau
dive	nelam
dive	erkeneng
diverse	erbage-bage
diversity	ermacam-macam
divide	taka
divide	elaken
divine	lit sifat ketuhanen
divorce	simulihen
divorce	mulih dejang
divorce	sirang
dizzy	pusing
do	ban
do you	kam uga
do you love me	keleng kin atendu aku
doctor	Dokter
document	rakut
document	iket
does	erbuat
doesn't	lenga
dog	biang
Dogri	Dogri
doing	erban
doll	gana-gana
domain	domain
domestic	domestik
dominant	dominan
don't	ula
Don't worry	ula sangsi
donate	cukong
done	dung
done	enggo dung
done	enggo sai
donkey	kalde
dope	mejile
double	ganda
doubt	jelpa
doubt	la tek
dough	singgur
dough	adonan
down	teruh
download	unduh
draft	sele-sele
drag	iseret
drain	kerah
drama	drama
draw	gambar
drawer	ngganaken
drawing	nggambar
dread	kebiaren
dread	biar
dream	nipi
dress	baju terusan
drill	uruk
drink	minem
drink	inemen
drive	Embah motor
drop	ndabuh
dropped	ndabuh
dropped	naktak
drought	kekerahen
drunk	minem
dry	kerah
duck	bebek
dude	dilaki
due	jatuh tempo
due to	i karenaken
dull	dengat
dumb	motu
dump	Buang
dump	Iambekken
duration	durasi
during	sanga
during	sangana
dust	Abu
duty	dahin
dwell	tading
dying	bernungen
each	sekalak-sekalak
each other	ras sideban
eager	morah
eagle	elang
ear	cuping
earlier	ndauh-ndauh wari
early	lampas
earn	sen masuk
ears	cuping
earth	doni
earthquake	linur
ease	i ringanken
easily	sunahsa
easily	sunah
east	timur
easy	labo susah
eat	man
eating	man
economic	ekonomis
economy	ekonomi
edge	duru
edge	ujung
edit	edit
education	edukasi
education	pelajaren
effect	efek
effective	efektif
efficiency	efisiensi
efficient	efisien
effort	kelatihen
egg	naruh
eggplant	terung
ego	ego
eight	waluh
eighteen	sepuluh waluh
eighty	waluh puluh
either	si apai
elaborate	i perjelas
elaborate	i jelasken
elbow	siku-siku
elder	sintua
elderly	situa
elegant	meraja
elegant	meparas
element	unsur
elephant	gajah
eleven	sepuluh sada
eligible	Banci
eliminate	sasapken
else	sideban
embarrassed	mela
embarrassing	pemela-melaken
embrace	uling
embrace	dakep
emerge	tulak
emergency	keadaen darurat
emotional	rukuren
empathy	empati
emphasis	i perjelas
emphasize	ngutamaken
employee	si ngian
employees	kalak si erdahin
employer	tokeh
employment	dahin
empty	lume
empty	kosong
enable	perbeluh
encounter	perjumpaan
encourage	asak
end	keri
endangered	nggertak
endangered	ngendam
endangered	nganjui
endeavor	erbenting kibul
endurance	pegegeng
endure	menderita
enemy	imbang
energy	tenaga
energy	energi
engage	terlibat
engaged	enggo mbaba belo selambar
engagement	Mbaba Melo Selambar
engine	mesin
engineer	insinyur
English	Inggris
enhance	pergalang
enjoy	senang
enormous	galang kel
enough	bias
enough	seh
ensure	pastiken
ensure	erpasti
enter	ku bas
entertainment	hiburen
enthusiasm	senang
enthusiastic	antusias
entire	kerina
entitled	kinituan
entity	persada
entrance	labah
entrepreneur	si puna usaha
envelope	amplop
environment	sekitarna
envy	cian
epic	mehuli
epic	mejile
epidemic	epidemi
epidemic	pinakit si pedas marpar ku jelma sinterem
equal	seri
equipment	peralaten
equity	kewajaren
equivalent	seri
eraser	ngapus
eraser	pemasap
error	rusak
escape	si elok ken
especially	terlebih
essay	tulisen
essence	esensi
essential	perlu
essential	penting
essential	metaruk
establish	erbanca jadi
established	majeken
established	majek
estate	banjaren
estimate	perkiraan
estimated	estimasi
etc	ras sidebanna
eternal	rasa lalap
ethics	aturen
evaluate	evaluasi
evaluation	evaluasi
even	seri
even though	enggo bage pe
evening	karaben
event	kerja
eventually	dung na
ever	pernah
every	tiap-tiap
everybody	kerina
everyone	kerina jelma
everything	kerina
evidence	tanda
evil	jahat
evil	nakal
evolution	evolusi
evolve	erkimbang
Ewe	Ewe
ex	bekas
exact	tengteng
exactly	payo
exactly	tenteng
exam	cubaken
exam	tiliken
examine	mepayo
examine	papayo
example	contoh
exceed	ngelewati
excellent	mantap
excellent	si bagusna
except	sekatan
except	katan
exception	pengecualian
excess	sampuren
excessive	terlung
exchange	ertukar
excited	meriah ukur
excitement	meriah
exciting	senang
exclusive	mehaga
excuse	sentabi
excuse me	sentabi
execute	eksekusi
execution	eksekusi
executive	eksekutif
exercise	latihen
exhaust	latih
exhausted	latih
exhibit	pameran
exhibition	pertunjuken
exhibition	pameran
exist	lit
existence	eksistensi
existing	lit
exit	ndarat
expand	Mpebelang
expect	agak
expected	siarapken
expenses	galaren
expensive	meherga
expensive	merga
experience	pengalaman
experiment	percubaan
expert	pakar
expert	kalak pentar
expired	mali
expired	berngap
explain	jelasken
explanation	pengata
exploit	eksploitasi
explore	I jelajahi
export	ekspor
expose	menampakkan
exposed	la terlindungi
exposed	terbuka
exposure	pedarat
express	i cidah ken
expression	i cidahken
extend	si perpanjang
extended	ngumput
extended	pegedang
extension	kepanjangen
extent	cakupen
external	eksternal
extinct	mungil
extra	ekstra
extract	ekstrak
extraordinary	la teralang
extraordinary	lanai bo teralang
extraordinary	lanai kelanglang
extreme	ekstrim
extremely	seh kel
eye	mata
eyes	Mata
fabric	uis
fabulous	metarok
fabulous	mejile
face	ayo
facilitate	memfasilitasi
facilities	faisilitas
facility	fasilitas
fact	si benar
fact	fakta
factor	faktor
factory	pabrik
facts	si tuhuna
fade	malap
fade	bungkas
fail	ndabuh
fail	ndaboh
failed	peltep
failed	bangkas
failure	sukul
failure	tangke
faint	pingsan
fair	pinter
fair	bujur
fairly	merandal
fairly	payo
fairy	turi-turin
faith	kiniteken
faithful	kiniteken
faithful	tek
fake	bual
fake	la tutus
fall	ndabuh
FALSE	palsu
FALSE	labo tuhu
fame	ergelar
fame	terberita
familiar	bagi tempa penah idah
family	keluarga
famine	melihe
famous	terkenal
famous	jadi
fan	kipas
fancy	rula-ula
fantastic	fantastis
far	ndauh
farewell	perpisahen
farm	juma
farmer	ngemo
fascinating	menarik
fashion	mode
fast	tir
fast	metir
fat	mbur
fat	mbor
fatal	si sontar
fate	engga dalan na
father	bapa
fatigue	latih
fault	kesalahen
favorite	favorit
favour	gejap
favourite	Favoritna
fear	kebiaren
fear	biar
feast	kerja-kerja
feather	buk-buk
feather	mbulu
feature	kelebihen
features	kelebihen
february	Februari
fed up	ngelngel
fed up	soman
fee	bayaren
feed	bere man
feedback	balasen
feel	nanam
feel	gejap
feeling	perasaen
feet	nahe
fell	ndabuh
fellow	teman
fellow	turang senina
felt	rasa
female	diberu
fence	Pagar
fence	Tembok
fertile	gempus
festival	merdang merdem
fetch	datas
fetch	tangkap
fever	demam
few	sitik
fewer	magin
fiance	tunangen
fiction	fiksi
field	lapangen
fierce	garang
fifteen	sepuluh lima
fifty	lima puluh
fight	adu
fighting	rubat
figure	Sibage jelma
figure out	pedatken
file	berkas
fill	isiken
filled	risin
filled	jangkai
filled	rancung
film	film
filthy	melket
finally	enca e maka
finance	finansial
financial	keuangen
find	jumpai
find	ndatken
find out	darami
fine	mehuli
fine	huli
fine	uli
finger	jari
finish	dung
finished	enggo dung
fire	api
firm	menaheng
first	pertama
first	perlebe
first name	nama deban
fish	nurung
fit	sehat
five	lima
fix	i perbaiki
fixed	peken
flag	bandera
flash	pedas
flash	mis
flat	rata
flaw	sinanggel
flawless	sangkep
flawless	pangke
flee	riben
flee	rambo
flesh	gulen
flew	kabang
flex	date
flexible	fleksibel
flight	penerbangan
flip	balik
flip	ciak
flirt	penggoda
flirting	gasgas
float	mengapung
flood	bajir
floor	lante
flour	tepong
flour	tepung
flow	dalan
flow	alur
flower	rudang
flu	flu
fluent	beluh
fluently	beluh
fluffy	samel
fluffy	dayok
fluid	dangir
fly	kabang
focus	fokus
fog	remang
foggy	meremang
foggy	mehino
fold	ngelipat
folks	rayat
folks	kalak sinterem
follow	ngayak
follow up	rikut
following	ayaki
food	pangan
fool	motu
foolish	itokohi
foolish	tebu-tebu
foot	nahe
football	sepakbola
for	man
for	ku
for	lako
For example	usih
for instance	usih
for you	man kam
for you	man bandu
forbidden	la banji
force	dorongen
forecast	ramalan cuaca
forehead	perdempaken
forehead	pemutaren
foreign	la semal
foreign	serap
foreign	gandil
forest	hutan
forever	jumpa bulan ras matawari
forget	lupa
forget	la inget
forgive	ngalemi
forgive	alemi
forgot	lale
forgot	mampet
fork	Garpu
form	tempas
formal	resmi
former	sope lenga si gundari
fortunately	sibegandingen
fortune	nasib
fortune	peruntungan
forty	empat puluh
forty-two	empat puluh dua
forward	ku lebe
foster	iasuh
fought	rubat
found	demu
found	jumpa
foundation	fondasi
four	empat
fourteen	sepuluh empat
fox	rubah
fragile	bahaya
frame	bingkai
framework	arih
fraud	penupi
freak	aneh
free	karkar
free	jayo
free	siang
freedom	kebebasen
freeze	beku
freeze	kumpa
freeze	kenden
frequency	frekuensi
frequent	frekuensi
frequently	sering
frequently	rusur
fresh	segar
fresh	mbaru
friday	Jumat
fridge	lemari es
fridge	kulkas
friend	teman
friendly	mejingkat
friends	Teman
friendship	teman meriah
frightened	mbiar
frightening	mbiar
frightening	kebiaren
frog	katak
frog	padek
from	nari
front	leben
frozen	beku
frozen	kumpa
fruit	buah
frustrated	ceda ate
frustrated	merawa
fuel	minak
fuel	bensin
Fulfulde	Fulfulde
full	pol
full	besur
fun	meriah
function	jabat-jabaten
fundamental	alas
funeral	penguburen
funeral	pemakamen
funny	man tawan
fur	mbulu
furious	murkas
furious	merawa
furious	siber
furniture	furnitur
further	sahun
furthermore	enca dung e
future	wari si pepagi
gain	dat
game	guro-guron
game	rambat
game	erbicik
gap	jarak
garage	garasi
garbage	sampah
garden	peken
garlic	lasuna
gate	Gerbang
gather	kumpulken
gathering	rarasen
gathering	pugun
gathering	pulung
gauge	ukur
gave	mereken
gear	gigi (motor)
gender	kadena
general	Umum
generally	semal
generally	kesemalen
generate	erbahan
generation	generasi
generous	mehuli
genius	beluh
genre	adum
genre	rupa
gentle	lembut
gentle	meteruk rukur
gentle	manjar-anjar
genuine	mehuli
gesture	erlagu
get	dat
get	ndapet
get	dapet
get dressed	ruis
get up	Cinderken
get well soon	lampas madan
getting	ndatken
ghost	begu
ghosting	bene
giant	raksasa
gift	hadiah
gift	kado
ginger	bahing
girl	anak dibedru
girlfriend	rondong
give	bere
give	bereken
give up	menyerah
given	bere
glad	meriah ukur
glance	pengidah
glass	gelas
glasses	kaca
glimpse	mentas
global	global
gloomy	ceda ate
gloves	sarung tangan
glow	terang
glow up	robah kel
glow up	terang
glue	rekat
go	lawes
go	berkat
go ahead	banken
go away	lawesken
go away	ente ko
go to bed	pedemken
goal	tujuen
goals	sura-sura
goat	medil
goat	kambing
god	Dibata
god bless you	dibata si masu-masu
goes	lawes
goes	ente
going	lawes
going to	ku
gold	emas
gone	lawes
gonna	maka
goo	melket
good	merandal
good	mejile
good afternoon	mejuah-juah
good bye	leben kami
good day	wari mehuli
good evening	mejuah-mejuah
good job	mejile kai si dahikenndu
good job	merandal kai si dahikenndu
good looking	merupa
good looking	meparas
good luck	selamat sukses
good morning	mejuah-juah
good morning	mejuah-juah i bas wari si sendah
good morning my love	pagi kekelengen
good night	selamat malam
goodbye	mejuah-juah
goodnight	pedemi
goodnight	tunduhken
goods	alat
Google Translate	google translate
goose	kangsa
gorgeous	uji
gorgeous	mejile
gossip	Cekurak
gossip	Gosip
got	dat
got it	angka
government	pemerintah
grab	rentak
grade	nilai
gradually	manjar-anjar
graduate	lulus
grain	turah
grant	ibereken
granted	ikabulken
granted	ibereken
grapes	anggur
grasp	ncengkeram
grass	rumput
grass	dukut
grateful	syukur
gratitude	syukur
grave	geriten
grave	lubang sidepa
gray	abu-abu
great	melaga
great	mehantu
great	mersik
greed	merangap
greedy	biangsa
green	Meratah
greet	jumpa
greeting	nehkken
greeting	sintabi
greetings	tabik
greetings	sinehken
greetings	kehamaten
grey	abu-abu
grid	kisi
grief	ceda ate
grind	nggiling
grip	gelemen
grocery	keperlun kalak tep-tep wari
groom	penganten si dilaki
gross	ciga
ground	taneh
group	grup
grow	tumbuh
growth	perturah
grumpy	merambit
Guarani	Guarani
guarantee	njamin
guard	sijagaisa
guess	tebak
guest	tami
guidance	jujuren
guidance	gelemen
guide	tuntunen
guilty	akap lepak
guilty	lepak
guy	dilaki
guys	si dilaki
gym	tempa kula
habit	kebiasan
habitat	ingan
had	jang
had	ajang
hail	erlebuh
hair	buk
half	setengah
half	separuh
hall	jambur
hand	tan
handle	tagangen
handsome	gantang
hang	nggantung
hang out	pulung-pulung ras teman meriah
happen	terjadi
happened	terjadi
happiness	megoh
happiness	kesenangen
happy	senang
happy birthday	selamat wari kejadiin
happy birthday	selamat ulagn tahun
happy birthday to you	selamat ulang tahun man bandu
happy new year	selamat tahun baru
hard	piher
hardly	meringis
hardly	piher
hardly	depar
hardly ever	si meserana
harm	bahaya
harmful	bahaya
harmony	harmoni
harsh	jerngas
harvest	merdang
has	madan
has	simada
hate	Segat
have	mada
have	simada
have a good day	mbera-mbera wari enda wari simehuli
have a nice day	mejuah-juah
have breakfast	togeh
have breakfast	man erpagi-pagi
have fun	meriah
have you eaten	enggo panganindu
having	jang
hazard	mara
hazard	ganggang
haze	remang
he	ia
he has	kerajangenna
he has	lit punana
he has	ajangna
he is	ia
head	takal
headache	mesui takal
heal	malem
heal	ermalem na
healing	Mpepalem
health	malem
health	kemaemen
healthy	malem
healthy	sehat
hear	begi
heard	begi
heart	pusuh
heart	ate
heat	las
heaven	sorga
heavy	mberat
hectic	congcing
hectic	picet
height	ganjang
heir	petadingen
heist	pinangko
held	tagang
held	jemak
hell	neraka
Hello	halo
hello dear	halo turang
hello how are you	mejuah-juah uga berita ndu
hello how are you doing	mejuah-juah kai berita
helmet	helm
help	bantu
help	sampat
helpful	penolong
helpful	mejingkat
hence	emaka
her	ia
herd	begi
here	i jenda
heritage	warisen
hesitate	la nggit
Hey	hei
Hi	halo
hi how are you	uga beritandu
Hi there	uga
hidden	buni
hide	cibun
hide	cibuni
hide	buni
hierarchy	hirarki
high	meganjang
highlight	kilas balik
hike	nangkeng
hike	nangkih
hiking	lintas alam
hilarious	man tawan
hill	uruk.
him	ia
hint	petunjuk
hip	Gaul
hips	awak
hire	i pekerjaken
hiring	perdahin
his	jang na
history	Sejarah
history	Riwayat
hit	pek-pek
Hmm	hmm
hobby	hoby
hold	tagang
hold on	timai
hole	lubang
holiday	libur
hollow	lapung
hollow	lume
hollow	lambang
home	jabu
homework	dahanen
honest	mehuli
honestly	situhuna
Honey	tengkuli
honor	mehamat
honor	iergai
hood	tudung
hook	kawil
hop	lompat
hope	arapan
hopefully	erkite-kiteken
hopeless	getem
horizontal	horizontal
horn	klakson
horrible	seh kel ngerina
horror	ngeri
horse	kuda
hospital	rumah sakit
hospitality	perlagu
host	si ngian
hostile	agresif
hot	melas
hot	las
hotel	Hotel
hour	jam
hours	jam
house	jabu
household	jabu
how	uga
how about you	kam uga
how are you	uga berita ndu
how are you doing	uga berita ndu
how are you doing today	uga berita ndu sendah
how are you doing today	uga berita ndu i wari si sendah
how are you today	uga beritandu
how do you do	erkai kam
how is	uga e
how many	piga
how much	sekai
how often	rusur
how often	lalap
how old are you	piga umur ndu
how was your day	uga beritandu sendah
how was your night	uga kabarndu berngi enda
however	tapi
however	kepeken
hub	pusung
hub	pusong
hub	agi
hubby	dilaki
hug	rangkem
hug	dakep
huge	galang
human	jelma
humble	mehuli
humid	bencit
humid	lembap
humidity	bencit
humidity	mberngap
hundred	seratus
hungry	melihe
hunt	buru
hurricane	baliung
hurry	tir
hurry up	pedas
hurry up	metir
hurry up	mis
hurt	sui
husband	perbulangen
hustle	gulamit
hustle	kelih
hut	sapo
hut	sopo
hygiene	jelis
I	aku
I am	aku
I am fine	aku sehat
I am fine	mejuah-juah
I can	aku beluh
I can't	aku la banci
I do	aku pe
I do not know	la ku teh
I do not understand	la ku eteh
I don't	aku lang
I don't know	la ku teh
I don't understand	la ku anka
I don't understand what you mean	la ku eteh kai atendu
I don't understand what you mean	la ku angka kai atendu
I don't understand you	kai nindu
I don’t know	la ku teh
I don’t understand	la ku angka
i guess	ku akap
I had	lit jangku
I had	ajangku
I had	kerajangenku
I have	aku lit
I have been	aku enggo
I hope so	bage pe ku akap
I know	ku teh
I like	aku nggit
I like you	ngena ateku kam
I love	merhat
I love my big brother	keleng ateku kakaku sidilaki sintua
I love my big sister	keleng ateku kakaku sidiberu sintua
I love my father	keleng ateku bapaku
I love my little brother	keleng ateku agingku si dilaki
I love my little sister	keleng ateku agingku si diberu
I love my mother	keleng ateku nandeku
I love my mother	keleng ateku mamakku
I love you	keleng ateku kam
I love you so much	keleng kel ateku kam
I love you too	aku pe ngena ateku kam
I mean	si ku maksud
I miss you	tedeh ateku kam
I miss you so much	tedeh ateku kam
I see	ku idah
I think	kuakap
I understand	ku angka
I want	pet aku
I want	nggit aku
I want to see you	nura-nura jumpa man bandu
I want you	kam ateku ngena
I was	aku
I will	aku me pagi
I will	aku me
I would be	banci aku
I'm	aku
I'm fine	meriah ateku
I'm good	beritaku baik
I'm here	jenda aku
I'm sorry	sentabi
ice	es
ice cream	es krim
idea	saran
ideal	pepayosa
ideal	payo
identical	bali
identical	seri
identify	identitas
identity	identitas
idiot	motu
idle	la erdahin
if	adi
if	adina
ignore	elok
ignore	elok ken
ill	sakit
illegal	ilegal
illness	pinakit
Ilocano	Ilocano
image	gambar
imagine	imajinasi
immediate	pedas
immediately	minter
immediately	mis
immense	si meganjang
impact	lih efek
impatient	la genggeng
implement	i mata i
import	impor
important	perlu
important	penting
impose	paksan
impose	erah
impossible	metahat
impress	megah
impress	agah
impression	diate
impressive	erkesan
improve	pehuli
improve	pekena
improvement	terlaki
in	i bas
in addition	tambahen
In fact	situhuna
in front of	lebe-lebe
in order to	ateku ku
in order to	suraku ku
inappropriate	la tengteng
incentive	insentif
incident	kejadin
include	ras
include	ikut
including	rikut ras
including	rikutken
income	penghasilen
inconvenience	la nyaman
increase	tole
increase	bubuh
increased	erbuena
increased	ertambah
incredible	mehaga
indeed	payo
independent	sisada
independent	mandiri
India	India
indicate	i maksudken
indigenous	situhuna
indigenous	tuhu
individual	sekalak
industry	industri
inevitable	La banci elokken
infant	bayi
infection	lengket
infinity	la teralang
inflammation	rintepen
inflammation	dilam
inflation	inflasi
influence	panpan
inform	momoken
information	berita
information	tenah
ingredients	bahanbahan
inheritance	tading-tadingen
initial	tang tang na
initial	inisial
initiative	inisiatif
injured	terluka
injury	nentap-nentap
injury	suin
innocent	polos
innovation	inovasi
inquiry	Penungkunen
insane	adon
insect	serangga
insecure	permela
insert	ngkahupi
insert	ngancuhi
inside	i bas
insight	pengalamen
insist	tetap ukur
insist	mekeng
insomnia	la banci tunduh
inspiration	buah penggejapen
inspiration	mereken perukuren
inspire	menginspirasi
install	ngatupken
instance	instansi
instant	pedas
instant	lampas
instead	kelih
instead	dalih
instead	alih
instead of	alih-alih
instructions	instruksi
instrument	peralatan
insult	risi
insurance	asuransi
intact	ersada
integrity	si jadina
integrity	malem ukur
intellectual	kebeluhen
intelligence	beluh
intelligent	kecerdasen
intend	maksudna
intended	sengajaken
intense	mberat
intention	tujuen
interact	cakap-cakap
interaction	ngeruntusi
interaction	erkata-kata
interest	morah ate
interested	tertarik
interesting	mejile
interfere	nengka
interfere	nabat
interfere	meguting
intermediate	sedang
intermediate	tengah-tengah
internal	ibas
international	internasional
internship	erdahin
internship	magang
interpret	ngartiken
interpreter	nalinken
interrupt	singgor
interrupt	ningguri
interview	Wawancara
intimate	akrab
into	ku
introduce	kenalken
introduction	si pedatandaken
introvert	sip jelmana
intuition	penggejapen
invalid	bual
invalid	la tuhu
invent	petembe
invent	tempa
inventory	inventaris
invest	investasi
investigate	siksik
invitation	erdilo
invitation	tenah
invite	undang
invoice	invoice
involve	ikut serta
involved	ras
involved	rikut
iron	Besi
is	ialah
is	adalah
island	pulo
isolated	persirang
issue	cakap mambur-mambur
issues	cakap mambur-mambur
it	ena
it is	ia
it was	mbarenda
it was	lebe ndube
it's	e
it's	enda
it's ok	labo dalih
It's okay	labo dalih
item	barang
items	sada
its	ena
I’m	aku
jacket	jaket
jail	kurungen
January	januari
jar	bulungen
jaw	engkap
jealous	cian
jerk	berengsek
jewelry	erta-erta
jewelry	upam
job	dahin
jogging	joging
join	ikut
join	sikut
joint	persada
joke	jagar
journalist	wartawan
journey	perdalinen
journey	perdalanen
joy	meriah ukur
joy	meriah ate
judge	hakim
juice	jus
july	Juli
jump	engkat
jump	enggal
june	Juni
junk	si la terpake
just	kenca
just	ngenca
just do it	cubaken saja
justice	pinter ukur
justice	bujur
justify	petengteng
justify	nuhuken
Kalaallisut	Kalaallisut
keen	ngena
keep	simpan
keep it up	ergiah-giah
kept	nusun
kept	ncibalken
kettle	teko
key	Kunci
kick	tipak
kick	sulpak
kid	riak-riak
kidding	jagar-jagar
kidney	ginjal
kids	anak kitik
kids	danak danak
kill	munuh
kind	mekacar
kind	bacar
kind	mbacar
kinda	atek
kinda	tukas
kinda	idik
kindly	mekacar
kindness	alu mehuli
king	raja
kiss	ema
kiss	icium
kitchen	dapor
kitchen	belakang
kitchen	dapur
kite	layang-layang
kitten	kucing
knee	tihun
knew	pemeteh
knife	sio
knight	bala
know	teh
knowledge	pemeteh
known	sieteh
Konkani	Konkani
Krio	Krio
label	merek
labor	tenaga kerja
labor	si erdahin
labour	kalak upahen
lack	kurang
ladder	tangga
lady	singuda-nguda
laid	tunduhken
lake	danau
lamb	domba
lamb	kambing
lame	la meriah
lamp	tendang
land	taneh
land	juma
landscape	lanskap
language	bahasa
lap	ampu
large	galang
last	terakhir
last	si akhir
last but not least	terakhir, tapi la kalah penting
last name	Gelar Keluargana
late	melawensa
lately	wari si e
lately	genduwari
later	kari
latest	ujung
latest	sidik
latest	sipat
latter	surat
laugh	tawa
laughing	tawa
laughter	metawa
laughter	tawa
launch	berkat
laundry	ncuci
law	aturen
law	hukum
lawn	rumput embal
lawyer	pengacara
lay	cibal
layer	lapis
layout	layout
lazy	kisat
lead	memimpin
leader	pengulu
leader	si biak
leader	penegu-negu
leaf	bulung
leak	pultak
lean	ersandar
leap	lompat
learn	erlajar
learning	erlajar
lease	sewan
least	si akhir
leather	kulit
leave	lawes
leaves	bulung-bulung
led	ipimpin
left	kares
leg	nahe
legacy	warisen
legal	sagal
legal	ukum
legend	lagenda
legit	lako
legit	esah
legit	tuhu
leisure	cirungguk
leisure	medale
lend	injam
length	gedang
less	kurang
lesson	erlajar
lesson	pelajaren
let	pediat
letter	surat
letter	kabar
lettuce	selada
level	tingkatan
leverage	manfaat
liability	baban
library	perpustakaan
lick	dilat
lie	bual
lies	bual
life	kegeluhen
life	geluh
lift	angkat
light	terang
lightning	perkas
like	bage
like	ngena
likely	tah
likely	mawen
likely	ntah
likewise	pe bage
line	batas
line	garis
Lingala	Lingala
link	jaringan
lion	singa
liquid	medak
liquid	lecek
list	daftar
listen	begiken
listening	begi
literally	situhuna
literature	iteratur
litter	liter
little	sitik
live	nggeluh
live	geluh
live	geloh
liver	ulu
lives	tading
living	tading
living room	ture
lizard	beraspati
lizard	kosar
load	si risiken
loaf	roti
loan	pinjamen
local	lokal
location	likaso
location	ingan
lock	kunci
lockdown	isolasi sada daerah
log	cataten
lol	tawa
lonely	sisada
long	ganjang
long	gedang
long time no see	enggo ndekah la jumpa
look	nin
look	nehen
loop	ilingkari
loop	ikelilingi
loose	bene
lord	dibata
lose	talu
loss	bene
lost	kalah
lot	melala
loud	mejek
loud	gejek
lounge	ture
love	keleng
love	ate jadi
love	kekelengen
love you	keleng man bandu
lovely	malem
low	meteruh
low	teruh
lower	ku teruh
lower	teruhken
loyal	setia
loyal	mehuli
loyalty	kesetian
luck	jore
luck	perulihen
lucky	eruntung
lucky	untung
Luganda	Luganda
luggage	ingan uis
luggage	tas
lump	mecepiken
lunch	man ciger
lungs	rak-rak
lungs	erak
luxury	luxury
lying	erbual
machine	mesin
mad	merawa
madam	nande
made	si erban
made	erban
magazine	majalah
magnificent	mulia
magnificent	mehaga
maid	si erdahin
main	si utama
maintain	pertahanken
maintenance	perbaiki
maintenance	ngian
maintenance	gelah uda ceda
Maithili	Maithili
major	galang
majority	mayoritas
make	bahan
make	ban
make up	erbahan
male	dilaki
mall	mall
man	dilaki
manage	beluh erban
management	menejemen
manager	menejer
mandatory	harus
mandatory	la banci lang
manifest	terang
manifest	tangkas
manipulate	mbuali
manner	pengelako
many	melala
many many happy returns of the day	wari enda maba kemalemen ate
march	maret
margin	selisih
market	pajak
marriage	perjabun
married	erjabu
mask	gundala
mass	massa
massive	melala
master	si bos
master	sipuna
match	cocok
mate	Pasangen
material	bahan
math	erkira
math	ngirai
matter	dahin
maturity	enggo ngena
maturity	mbelin
may	banci
maybe	tah
maybe	ntah
me	aku
me too	aku pe
meal	nakan
mean	megasgas
mean	jambak
mean	merisi
meaning	erti
means	Ertina
meant	si imaksudken
meanwhile	sope
measure	ukur
measures	tumbak
measures	sukat-sukat
meat	jukut
meat	daging
medical	tambari
medicine	Obat
meditation	meditasi
medium	sedang
meet	jumpa
meeting	ertemu
Meiteilon	Meiteilon
melt	dane
melt	sese
melt	neren
memories	ingeten
memory	ingeten
mental	mental
mention	i sebut
mentioned	tandai
mentor	pengawas
merchant	merchant
mercy	ngalemi
mercy	alem
merely	lang pe
merry christmas	selamat wari natal
mess	rontang
message	pesan
message	berita
messy	la susun
metal	besi
method	metode
mice	menci
middle	si tengah
midnight	peteng
midnight	rebi-rebi
might	banci
mild	la mberat
milestone	ulih latih
military	militer
milk	susu
million	juta
mind	tangkel
mindset	pola pikir
mine	ajang ku
mine	jang ku
mingle	persada
minor	minor
minute	menit
minutes	menit
miracle	kumalak
miracle	gandil
mirror	cermin
mirror	keca
miscellaneous	erbage
mischievous	gutul
miserable	erceda ate
misery	kiniseran
miss	tedeh
miss you	tedeh ate
missing	bene
mission	misi
mist	remang
mistake	kesalahen
Mizo	Mizo
mobile	handphone
mock	nguru
mock	isakken
model	rupa
moderate	cukup
moderate	sangana
modern	modern
modest	jolos ukur.
modest	doles ukur.
moist	bencit
moist	mberngap
moisture	bencit
moisture	lembab
mold	rekamen
mold	tuang
mole	menci uruk
mom	nande
moment	paksa
moment	sanga
monday	Senin
money	sen
monitor	monitor
monkey	imbo
month	bulan
mood	ukur
mood	ate
moody	kuan-kuanen
moon	mbulan
moon	bulan
moral	moral
more	nambah
more	tole
more	nari
moreover	enca e
morning	pepagi
mortgage	gade
most	si kal
mostly	asapa
mostly	simbuena
mother	nande
motion	uit
motion	giah
motivation	alasen
motivation	dalanna
mountain	deleng
mouse	menci
mouth	Babah
move	kemuit
movement	ole
movement	uit
movement	endek
movie	film
mrs	nande
much	melala jelma
mud	lumpur
mug	gelas
muscle	urat
museum	museum
mushroom	dawan
music	musik
must	la banci lang
mute	kem
mutual	duana
my	kerajangenku
my	jangku
My dear	Si Kukelengi
my friend	temanku
My hovercraft is full of eels	kapalku dem alu cibakut
My hovercraft is full of eels	kapalku dem alu sibakut
my love	kekelengenku
my name is	gelarku si
my pleasure	alu meriah ukur
myself	aku
mysterious	misterius
mystery	misteri
myth	turi-turin
nail	cekili
nail	silu-silu
naive	naif
name	gelar
narrative	naratif
narrow	la mbelang
narrow	sempit
nasty	kotor
nasty	jorok
nasty	mbau
national	nasional
nationality	kebangsan
native	Matah
native	Alami
natural	alami
nature	Alam
nausea	runce
nausea	mbulen
near	ndeher
near	ndiher
nearby	ndeher
nearly	ndeher
neat	sikap
neat	jore
necessary	siperluna
neck	kerahung
necklace	bura-bura
necklace	rante
need	perlu
negative	Negatif
neglect	la iperdiateken
negotiate	runggu
neighbor	sidapuren
neighborhood	Lingkungenta
neither	la kai pe
nephew	bebere
nerd	semal
nerd	gandil
nervous	sebak
nest	asar
nest	dokan
net	bersih
network	jaringen
neutral	netral
never	lenga pernah
never give up	terus lanjutken usahandu
never mind	labo dalih
nevermind	labo dalih
nevertheless	sampang bage
new	mbaru
news	berita
next	Selanjutna
next to	i sebelah
nice	merandal
nice	senembas
nice	jore
nice to meet you	meriah ukur jumpa kam
niece	permen
niece	bebere
night	Berngi
nightmare	nipi si la mehuli
nine	siwah
nineteen	sepuluh siwah
ninety	siwah puluh
No	lang
no problem	labo dalih
no way	si la mungkin terjadi
nobody	la lit
noise	gejek
noisy	gejek
none	la kai pe
noon	ciger
nope	lang
nor	labo pe
normal	normal
north	utara
nose	igong
nose	idung
nostalgic	Nostalgia
not	labo
not	lang
not at all	la kerina
not bad	lumayan
Not now	la gundari
not yet	lenga
note	cataten
noted	cataten
nothing	lume
notice	teh
noticed	pemeteh
noun	kata benda
nouns	kata benda
novel	novel
november	Nopember
now	gundari
nowadays	mbarubaru enda
nuisance	kacam
nuisance	guting
nuisance	dogel
null	nol
numb	dengat
number	nomor
nurse	perawat
nut	baut
nutmeg	pala
nutrition	nutrisi
oath	kune-kune
oath	duhung
obesity	mbur
obey	la i tonggal
obey	tongkah
object	objek
objective	objektif
obligation	kejaiben
obscure	rembo
observation	observasi
observe	nehen
obsessed	pet kel
obsessed	ngena kel
obsession	sura-sura
obsolete	tuk
obsolete	male
obstacle	ambaten
obstacle	sinanggel
obtain	i pertahanken
obtained	datken
obvious	terang
obviously	me enggo teh
occasionally	labo rusur
occupation	erdahin
occupation	dahin
occupied	congcing
occur	lit
occurred	terjadi
occurs	bahanen
ocean	laut
october	Oktober
odd	kalang
odd	sangkalen
odds	ntah pe
of	oleh
of	dat
of course	tentu
off	mate
offensive	sergang
offer	sitawaren
offer	tawar
office	kantor
official	cabal
often	gati
often	megati
Oh	O
oh really	tuhu e
oil	minak
ok	ue
ok dear	ue turang
ok honey	ue turang
ok my love	ue turang
okay	ue
okay baby	uwe kekelengen
okay dear	ue turang
okay honey	ue turang
okay my love	ue turang
old	metua
on	datas
once	sekali
one	sada
one language is never enough	sada cakap la pernah bias
onion	bawang bombai
online	daring
only	kenca
only	ngenca
open	talang
open	buka
operation	operasi
opinion	asar
opportunities	peluang
opportunity	kesempaten
opposite	imbang
opposite	alu
optimistic	optimis
option	ramo
option	legan
option	pilihen
optional	pilihen
or	tah
or	entah
orange	rimo
order	surat
order	lebuh
ordinary	si biasa
organization	Organisasi
orientation	pandangen
orientation	orientasi
origin	kuta kemulihen
original	asli
Oromo	Oromo
orphan	lumang
other	sideban
otherwise	adi lang
ought	simehulina
our	jang ta
our	ajang ta
Our mission: to enable everyone, everywhere to understand the world and express themselves across languages.	Dahin-dahin kami : Gelah kerina perpantas ras melcik erlagu ibas percakapen
Our mission: to organize the world's information and make it universally accessible and useful.	Dahin-dahin kami : jujurken rakuten doni enda ras erbahan mesunah ogei ras mbelin oratna
out	darat
outcome	pekeriken
outfit	uis
outgoing	mbaca
outlet	ingan
outline	garis besar
outside	i darat
outstanding	mehamat
over	selese
over	enggo sai
over there	jenda
over there	jendam
overall	kerina
overcome	silewati
overthinking	melala perukuren
overthinking	melalasa rukur
overwhelmed	lau mbelin
overwhelming	mbue kel
overwhelming	melala kel
owe	Er utang
owl	burung hantu
own	ajangku
owner	si puna
ox	sapi
pace	kecepaten
pack	paket
package	paket
paid	i galari
pain	sui
paint	cet
painting	lukisan
pair	pasangen
pale	mbulan
palm	tapak
pan	pinggan
pandemic	pandemik
panic	panik
pants	seluar
paper	kertas
paradise	surga
parallel	paralel
parcel	luah
pardon	sentabi
parents	orang tua
park	peken
parrot	kiung
parsley	seledri
part	bagin
participate	rikut
particular	khusus
particularly	si erdahin
particularly	si ah
partner	pesangen
party	kerja
pass	lewatken
passage	pasar
passage	dalan
passed	silewat
passion	gajah
passionate	ergiah-giah
passive	sinik
password	kata kunci
past	si enggo lewat
patch	pemubul
patch	ngerangkapi
path	dalan
pathetic	la jore
pathetic	ngenas
patience	sabar
patient	sabar
pattern	suatu
pause	peltep
pause	pegeng
pavement	trotoar
pay	galar
pay	nggalar
payment	galaren
peace	malem ate
peaceful	teneng
peaceful	diam
peach	persik
peak	datas
peak	puncak
pear	pir
peas	kacang
peculiar	gandil
peculiar	mentat
pee	pis
pee	ciah
peel	maki
peel	ngkupas
peel	nguliti
peer	teman
peers	teman meriah
pen	pena
pencil	pinsil
pending	man timaan
people	kalak
pepper	kertas
perceive	ngidah
perceive	ngenen
perception	sipengidahen
perfect	sangkep
perform	pentas
performance	kuda-kuda
performance	pentas
perhaps	mungkin
period	paksa
permanent	lanai banci i ganti
permission	Ijin
permit	diat
permit	njula
permit	terbereken
perseverance	megegeh
persistent	terus erjuang
person	Jelma
person	Kalak
personal	kalak
personality	karakter
personality	kepribadian
perspective	si iddah
perspective	pengidahen
persuade	endik
persuade	ande
pervert	rencam
pervert	mejantur
pervert	lagu lamehuli
pet	binatang peliharaen
phase	fase
phenomenon	fenomena
philosophy	filsafat
phone	telepon
photo	foto
phrase	frasa
physical	ersentuhen
pick	pilih
pick up	angkat
picture	gambar
piece	sadar
pieces	mecepik
pig	uili
pig	babi
pigeon	darapati
pigeon	derapati
pigeon	nderapati
pile	uloken
pillow	Bantal
pilot	pilot
pin	pin
pineapple	nanas
pink	merah Jambu
pit	kelbuk
pit	liang
pit	pinusu
pitch	benterken
pity	mekuah ate
place	ingan
places	ingan
plague	pinakit
plain	mbulan
plain	mbentar
plan	rencana
plane	pesawat terbang
plant	tumbuhen
plants	suan-suanen
plate	piring
platform	platform
play	agat-agat
play	main
playing	erguro-guro
playing	ercah
pleasant	Malem
please	tolong
please	bantu
please	sampat
pleased	senang
pleasure	riah ukur
pleasure	senang
pledge	sumpah
plenty	melala
plot	Tanda
plot	Pertanda
plug	steker
plum	plum
plumber	tukang ledeng
plural	melala
podcast	podcast
poem	andung-andung
poem	bilang-bilang
poetry	andung-andung
poetry	bilang-bilang
point	poin
poison	bisa
police	polisi
policy	kebijaken
polite	jemat
polite	mesekul
pollution	pousi
pond	kolam
pool	kolam
poop	ngenge
poop	kuture
poor	musil
pop	pop
popular	I tandai jelma
population	jumlah kalak
pork	dalu
pork	wili
pork	babi
porridge	dakdak
port	pelabuhen
position	posisi
position	ingan
positive	positif
possess	mpuna
possession	ajang
possessive	cian
possible	banci
post	posting
postpone	i tunda
potato	kentang
potato	gentang
potential	kengasupen
pound	pon
poverty	la bayak
power	Kekuaten
powerful	megegeh kel
practical	praktis
practice	latihen
praise	Puji-pujiin
prank	tebu-tebu
pray	Ertoto
precious	meherga
precise	Tepat
precisely	tengteng
predict	ngeramalken
prefer	pilih
prefer	mindan
preference	preferensi
pregnant	mehuli kulana
pregnant	enggo ngena dagingna
prejudice	erprasangka
premises	ingan
premium	premiun
preparation	ersikap
preparation	pesikap
prepare	persikapen
prepared	sikap
prepared	pesikapken
preposition	kata depan
presence	kehadiren
present	upah
present	luah
present	pemeren
presentation	persentasi
preserve	i lestariken
preserve	i jaga
president	presiden
press	tekan
pressure	tekanen
pretend	erpura-pura
pretty	mehuli
pretty	mejile
prevent	erem
previous	sope
prey	mangsa
price	erga
pride	bangga
pride	morah
priest	pendeta
primary	si utama
prime	sipesada
princess	ndehara
principal	prinsip
prior	sope lenga
priority	si utama
prison	kurungen
privacy	privasi
private	Pribadi
privilege	hak istimewa
prize	luah
probably	mawen
problem	pasal si e
procedure	dalan na
proceed	enggo banci siperdalen
process	proses
produce	erbansa
product	produk
production	produksi
profession	dahanen
professional	profesional
profile	profil
profit	keuntungen
profound	pulning
profound	ndulkih
progress	dalan
project	proyek
prominent	nampang
promise	janji
promote	i promosiken
promotion	promosi
prompt	si ingetken
prone	sukah sontar
pronouns	kata depan
pronunciation	pengataken
proof	bukti
proper	si mehuli
properly	sikap
properties	properti
property	ajang
proposal	proposal
prospect	prospek
prosperity	rejeki
prosperity	kinibayaken
prosperous	tembun
prosperous	mejuah
protect	lindungi
proud	megah
proud	agah
prove	mbuktikan
provide	sikap
provide	lit
provide	kebas
provided	tanda
province	propinsi
provision	persedian
puberty	kembali
public	kalak enterem
pull	rentak
pumpkin	jambe
punctual	nepati
pupil	mata
purchase	tukur
pure	tutus
purple	Terong
purpose	tujuan
purpose	nuju
purse	tas
pursue	ayaki
pursuit	penalemen
pursuit	penundalen
push	isorong
put	cibal
put	tare
qualification	kualifikasi
quality	kualitas
quantity	sekai lala na
quantity	jumlah
quarantine	karantina
quarrel	rubaten
quarter	seperempat
Quechua	Quechua
queen	ratu
queer	kumalak
queer	gandil
query	sungkunen
question	pertanyaen
queue	antri
queue	man timan
quick	cepat
quickly	metir
quiet	sip
quilt	lembut
quilt	cabin
quit	ngadi
quit	ndarat
quite	sitik
quiz	kuning-kuningen
quotation	kutipen
quote	pedah
quotes	kata bujur
rabbit	kelinci
race	balap
rage	rawanen
rain	udan
raise	angkat
raise	engkat
raised	itambahi
raised	ipeganjangi
ran	kiam
random	Labo layas
range	belang na
rapid	lampas
rapidly	pedas
rapidly	mis
rare	jarang
rarely	jarang
rash	dardar
rash	merutu
rat	menci
rate	erga
rather	siteng-tengna
ratio	andingen
rational	rasional
raw	matah
re	lagi
reach	seh
reached	ijangko
reaction	reaksi
read	mbaca
read	baca
reading	ngoge
ready	siap
ready	enggo banci
real	Tuhu
reality	situhuna
realize	sadar
realized	sedar
realized	sadar
really	tuhu
rear	arah pudi
reason	alasen
reasonable	wajar
reasonable	pantas
recall	dilo
receipt	bukti galar
receive	alo
receive	aloken
received	sialoken
received	alo
recent	si mbaru e
recently	la ndekah enda
reception	resepsi
recipe	resep
reckless	mekamis
reckless	mejajar
recognition	pengakun
recognize	tanda
recommend	si enggo pernah i nanami kalak
recommended	rekomendasi
record	rekor
recover	pesuangken
recover	suang
recovery	suang
rectangle	persegi panjang
red	megara
redeem	tukarken
redemption	penebusen
reduce	uraki
redundant	silalap
refer	lebih
reference	referensi
reflect	reflek
reflection	refleksi
refrain	sinik
refrigerator	kulkas
refund	ulihken
refuse	lang nina
refused	kata labo
regard	pasal si e
regarding	pasal si
regardless	Emaka
regards	tertanda
region	area
register	Daftar
regret	erkadiola
regular	biasa
regular	langganen
regularly	kesemalen
reject	la nggit
relate	ikaitken
related	Kade-kade
relationship	hubungen
relative	relative
relatives	mantung-antung
relax	rileks
release	pedarat
released	pulahi
released	ngeldus
relevant	baling
relevant	seri
reliable	banc iandalken
relief	Enggo malem ate
relieve	pengapul
relieve	malem ate
relieve	tambar malem
relieved	malem
relieved	lias ate
religion	Agama
religious	pekiniteken
reluctant	ngonjumken
rely	ersandar
remain	lalap
remaining	si lit denga
remarkable	la teralang
remedy	peken
remedy	erpeken
remedy	pekenken
remember	inget
remind	ingetken
reminder	penginget
remote	i pedalamen
remove	muat
render	endes
rent	erga sewa
repair	permalem
repair	perbaiki
repeat	siulangi
replace	iganti
reply	balasen
report	laporen
represent	si mabaken
reputation	reputasi
request	pemindon
request	pindo
require	si i butuhken
required	perlu
required	sikel
rescue	i selamatken
rescue	i dapeti
research	riset
resemble	bali
resemble	bagi
resentment	sinik
reservation	pesan
reserve	cadangen
reserve	serap
resident	taneh
resign	ngadi-ngadi
resign	elpeltep
resilience	ketangguhen
resilient	balagadingen
resilient	ketadu
resilient	nipe-nipe
resist	tarung
resistance	perlawanen
resolution	resolusi
resolve	dungiken
resolve	pedungi
resort	sopo godang
resources	sumber daya
respect	hergai
respect	ergai
respond	njabapi
response	balasen
responsibility	tanggung jawab
responsible	si ertanggung jawab
rest	ngadi
rest in peace	idilo dibata
restaurant	restoran
restore	pekenken
restrict	mbatasi
result	asil
results	bekas
results	pehala
resume	terus
resume	sahun
retail	erdaya
retain	si man tahanen
retention	ingan nusunsa
retired	pensiun
retreat	gawah-gawah
retrieve	muat
return	ngulih
return	mulih
return	ulih
reveal	reh na
revealed	mulgap
revenge	pembalasen dendam
revenue	Untung
reverse	ibalikken
review	tinaju
revise	mpesikap
revise	mperobahisa
revision	peken
revolution	revolusi
reward	hadiah
rhythm	endek
rib	rangrang
rib	biding
rice	Nakan
rich	bayak
rid	ngkernepken
rid	i agui
ride	nangkih
ridiculous	man tawan
right	kemuhun
right	kemuhen
right now	gundari
rigid	kaku
ring	cincin
rinse	cuci
riot	gujuh
riot	mbeto
rip	mate
rip	idilo Dibata
ripe	tasak
rise	nangkih
risk	resiko
rival	imbang
river	lau
road	pasar
road	dalan
roast	manggang
roast	nutung
robust	gegeh
rock	batu
rod	tungkat
rod	ciken
role	peran
role	bagien
roll	erpunpun
roll	kulkul
roll	erbelit-belit
roof	loteng
roof	genting
roof	atap
room	kamar
root	urat
rope	tali
rotten	macik
rough	merisi
rough	kasar
roughly	merisi
roughly	megesges
round	erlingkar
round	mbulat
route	arah perdalanen
routine	rutin
row	baris
rub	nggusgus
rub	gising
rub	alu
rubber	karet
rubbish	sampah
rude	meregen
rug	ambal
ruin	ceda
rule	ukum
ruler	mistar
rules	ukum
run	kiam
running	giang
running	kiam
running	landih landih
rural	kuta
rush	tir
rush	metir
sack	pelawes
sacred	badia
sacred	melikas
sacrifice	korban
safe	la kebiaren
safe	kukut
safe flight	mbera-mbera selamat penerbanganndu
safety	keamanen
sage	kebijaksanaan
said	nina
sail	erlayar
sailing	erlayar
sake	erkiteken
sake	hari-hari wari dem wari
salary	gaji
sale	erdaya
salmon	salmon
salt	sira
same	seri
Same here	bage pe
sample	sampel
sand	kersik
Sanskrit	Sanskrit
sarcastic	aling
sassy	palangen
sat	sedih
satisfaction	ralah-alah
satisfaction	sipi
satisfied	puas
satisfy	teran
satisfying	malem ate
satisfying	teran
Saturday	Sabtu
sausage	sosis
savage	meliar
save	susun
save	simpan
saw	nen
saw	nehen
saw	idah
say	nina
say	ning
scale	ukuren
scam	ngkicuki
scar	luka
scar	ugahen
scarce	la lit ija pe
scared	mbiar
scared	biar
scarf	selendang
scary	mbiar
scattered	erderak
scattered	serser
scattered	nenaken
scene	pemandangen
scene	mejile man tatapen
scenery	pengidah
scent	merim
schedule	jadwal
school	sekolah
science	ipa
scientist	papayo
scientists	ilmuwan
scientists	kalak pentar
scissors	gunting
scold	rawai
scope	Termasuk
score	skor
scrap	la surung
scrap	la sahun
scratch	carok
scream	suraki
scream	uahken
screen	layar
screw	obeng
script	tulisen
sea	laeit
sea	lawet
seal	pertanda
seal	janji
search	terdaram
search	ndarami
season	musim
seat	kursi
second	si peduaken
secret	bunibuni
secret	rahasia
section	bagin
secure	aman
security	aman
security	keamanen
security	tenang
see	nin
see you	jumpaka kita pagi
see you later	jumpa kita pagi
see you soon	leben kami
see you tomorrow	jumpa kita pagi
seed	singkebuah
seed	buah
seek	nin
seek	idah
seem	Teridah
seems	ku akap
seen	ternen
seize	tangkap
seizure	kejang
seldom	rusur
select	pilihen
self	diri sendiri
self healing	gawah-gawah
selfish	per ate-ate
sell	dayaken
sell	daya
sell	erdaya
send	kirim
send me your picture	bereken aku fotondu
senior	senior
sense	Nanam
sensible	masuk akal
sensitive	sensitif
sent	isuruhna
sent	isuruh
sentence	kalimat
sentences	kalimat
separate	i pisah
Sepedi	Sepedi
september	September
sequence	Urutan
series	seri
serious	serius
serious	la main-main
seriously	alu tutus
serve	sajiken
service	pengelako
session	bagin
set	setel
set up	Sikapken
setting	layas
setting	pekena
settle	erjabu
seven	pitu
seventeen	sepuluh pitu
seventy	pitu puluh
several	melala
severe	mberat
sew	semit
sew	njarumi
sh	sh
shade	cicio
shade	cinenggem
shadow	awih
shake	kucuk
shake	oncak
shall	seharusna
shallow	la mbagas
shame	mela
shape	tempas
share	erpela
share	erbagi
sharp	culiki
sharp	bacer
she	ia
she has	kerajangenna
she has	ajangna
she is	ia
shed	gudang
sheep	domba
sheet	halamen
sheet	kertas
shelf	Rak
shell	buar-buar
shell	kerang
shelter	ingan ngadi
shield	perise
shield	otar-otar
shift	Waktu erdahin
shine	sinar
ship	kapal
shipping	erlayar
shirt	baju
shoes	sulampak
shoot	timbak
shoot	metar
shop	toko
shopping	nukur
shopping	nukuri
shore	tepi lawet
shore	duru lawet
short	gendek
shortage	sikurang
shot	tembaken
should	arus
shoulder	bara
shout	sora megang
show	pentas
show me	cidahken
shower	ridi
shrimp	udang
shrink	susut
shut	sip
shut	sinik
shut up	sip ken
shy	mela
sibling	senina
sibling	turang
siblings	senina
siblings	turang
sick	sakit
sick	bangger
side	arah
sigh	desah
sight	pemandangen
sightseeing	pengidah
sign	tanda tangan
signature	tanda tangan
significant	penting
silence	sib
silence	kem
silence	kesawangen
silent	pelteng
silent	lungun
silent	ngelngel
silk	sotera
silk	sutra
silly	adon
silver	perak
similar	serupa
similar	seri
simp	kalak si motu.
simp	kalak lenge.
simple	la melala macam
simultaneously	ras
simultaneously	sekalian
simultaneously	radu
since	kenahun
since	kinahun
sincere	bujur
sincerely	tuhu-tuhu
sincerely	alu tutus
sing	ngerende
sing	rende
singer	perende
single	sada
sink	ingan cuci
Sir	pa
sister	senina
sister	turang
sister in law	beru
sit	kundul
site	ingan
situation	suiatuasi
six	enam
sixteen	sepuluh enem
sixty	enem puluh
size	ukuren
skill	kebeluhen
skills	kemampuan
skills	kebeluhen
skin	kulit
skinny	kertut
skinny	kertang
skip	lewatken
skirt	rok
sky	langit
slave	juak-juak
sleep	tunduh
sleep	medem
sleeping	medem
sleepy	ngantuk
sleepy	aneng-aneng
sleeve	tan baju
slice	seket
slice	getap
slice	keret
slide	nggeser
slightly	sitik
slim	kitik
slip	jongkang
slope	reben
slope	ande-ande
slot	regat
slot	lupung
slow	lambat
slowly	anjar-anjar
slowly	manjar-anjar
small	kitik
smart	beluh
smart	pintar
smell	mbau
smile	cirem
smoke	pulpul
smoke	cimber
smooth	alus
snack	cimpa
snail	cih
snail	kacunggi
snail	kerang
snake	nipe
snake	upar
snake	uhur-uhur
snap	punggur
snap	penggel
snap	mesepak
snow	Salju
so	adi bage
so cute	imut-imut kel
so far	seh jenda
soak	litap
soak	namuren
soap	sabun
sober	la mabuk
soccer	sepakbola
social	sosial
society	kalak enterem
socks	kaus kaki
soft	melete
soft	lete
software	perangkat lunak
soil	taneh
sold	enggo lako
sold out	keri terdaya
sold out	keri lako
soldier	bala
sole	sada
solid	padat
solution	dalan keluar
solution	solusi
solve	dung i
solve	dung
some	sebagin
somebody	sekalak
somehow	entah uga
someone	si sadah
someone	si ah
something	ena
something	ah
sometimes	sung
song	ende
soon	kari
sophisticated	mehaga
Sorani	Sorani
sore	karaben
sore throat	kalah-kalah mesui
sorrow	kecedan ate
Sorry	ersentabi
sort	gendek
sought	encari
soul	tendi
soulmate	pasangen
sound	suara
soup	sup
sour	acem
sour	macem
source	asal
south	selatan
space	jarak
spam	spam
span	njemak
span	ncikep
Spanish	bahasa Spanyol
spare	si cadangen
speak	ngerana
special	unik
special	spesial
species	jenis
specific	si ah
spectacular	seh kal luar biasana
speech	pidato
speechless	kem
speed	erdeteng
spell	ejaan
spend	tukurken
spent	galaren
spicy	siak
spicy	meser
spike	labang
spin	erputar
spin	pusing
spinach	bayam
spirit	tendi
spirit	kesah si Badia
spit	cidur
splendid	mejile
split	erbagi
spoil	perated-ate
spoiled	ergani-gani
spoiled	gani
spontaneous	spontan
spoon	sendok
spot	igan
spouse	pasangen
spread	derak
spread	tabur
spring	tiap-tiap
square	petak
squeeze	riprip
squeeze	pecek
squeeze	pelut
squid	cumi
squirrel	mencibut
st	santo
st	santa
stab	cucuk
stab	tebak
stable	tetap
stack	uloken
stack	anggunken
staff	anggota
stage	panggung
stage	pentas
stage	panggong
stain	liam
stain	keliamen
stairs	redan
stake	tama
stake	tikam
stalk	rikuten
stall	kurungen
stamp	cap
stand	Cinder
standard	si bisana
star	kumala
star	bintang
start	simulai
start	mulai
started	mulana
starving	melihe
state	bagun
state	kecibalna
statement	kata kalak
statement	ning kalak
station	stasiun
statue	gana-gana
status	status
stay	kem
stay	sinik
stay safe	mehimet
stay safe	metenget
steady	Terus
steady	Tetap
steak	jukut
steal	itangko
steam	Uap
steel	besi
steep	jegir
steep	embang
stem	tangke
step	jingkang
stick	ranting
stiff	lokang
stiff	jegah
still	denga
sting	cit
stingy	degil
stingy	mesiksik
stir	ngiahken
stock	stok
stolen	itangko
stomach	Beltek
stone	batu
stood	cinder
stool	manca-manca
stool	mane-mane
stop	ngadi
storage	ingan nusunsa
store	struk
storm	badai
story	turi-turin
stove	kompor
straight	pinter
straightforward	nebek
straightforward	ngeskes
strain	tekanen
strange	gandil
stranger	kalak asing
strategy	gabe-gabe
strategy	sura-sura
straw	sedotan
strawberry	stroberi
streak	gerus
streak	rapan
stream	tapin
stream	lau
street	dalan
strength	gegrh
strength	megegeh
stress	stres
stretch	ngenat
strict	tegas
strike	i pek pek
string	nali
strip	elak
strive	erjuang
stroke	struk
strong	gegeh
strong	megegeh
struck	iserbu
structure	struktur
struggle	erjuang
struggling	bebe
struggling	rumpil
struggling	ewas-ewas
stubborn	pemersik
stuck	sangket
student	murid
study	erlajar
studying	erlajar
stuff	ting tang
stuff	perkara
stunning	mejie kel
stupid	motu
style	gaya
subject	subjek
submission	endes, endesken
submit	nurut
submit	nembah
substance	bahan
substitute	pengganti
subtle	la nampang
subtle	tempa la idah
succeed	seh sura-sura
success	jadi
success	sukses
successful	sukses
such	bagi
such as	bage pe
suck	hisap
sudden	mis
suddenly	tetiba
suffer	derita
suffering	pegengken
sufficient	enggo bias
sugar	gula
suggest	kataken man ia
suggest	tenahken
suggestion	Saran
suit	baju
suit	jas
suitable	pas
suitable	cocok
suitcase	kotak
sum	beliga
summary	inti cerita
summer	musin las
summit	ancuk
summit	tampe
sun	matawari
sunday	minggu
sunny	ciger
sunset	singgem
sunset	sinalsalna
sunshine	matawari
super	super
superior	ndauh ulin
superior	hebat
supervisor	supervisi
supper	makan malam
supply	stok
support	tempi
support	embah
suppose	seharus na
supposed	iperkiraken
sure	kiniteken
sure	tek
sure	yakin
surface	Si paling darat
surface	Si paling datas
surge	lonjaken
surgery	operasi
surname	beru
surname	merga
surprise	kejuten
surprised	sengget
surrender	erleja-leja
surrender	mpediat
surrender	nerah
surrounding	ngkleweti
surveillance	ngembari
surveillance	pernehen
survey	pertanyaen
survive	ertahen
suspect	iakap
suspended	akap
suspended	kena kal ku pusuh
suspicious	curiga
sustain	tetapken
sustain	sirawaten
sustainability	genggen
sustainable	erkelanjuten
swag	tangkon
swallow	bendut
swap	nukari
swear	ersumpah
sweat	panasen
sweater	baju panas
sweep	turapken
sweep	sapu
sweet	tebu
sweet	entebu
sweet dreams	nipi si mehuli
sweet tooth	nggusi
sweetheart	Kelengi
swell	mbosal
swell	ngguldih
swelling	besar
swim	langi
swim	erlangi
swimming	erlangi
swing	ayunen
switch	ertukar
swollen	burjing
swollen	bosal
swollen	besar
sword	mermo
sword	piso
symbol	tanda
sympathy	simpati
symptoms	gejala
system	sistem
table	meja
tackle	mengawasi
tag	tanda
tail	ikur
tail	ikor
take	buat
take away	baba
take care	anjar-anjar
take care	manjar-anjar
take off	talangi
take off	bukaken
taken	ibuat
talk	ngerana
talkative	mekacar
tall	gedang
tall	meganjang
tap	klik
tape	tape
target	Target
task	dahin i jabu
task	tugas
taste	Nanam
tasty	ntabeh
taught	i ajari
taught	ajaren
tea	Teh
teach	Ajar
teacher	guru
team	Tim
tear	beridak
tears	lau mbelin
tease	nggasgasi
tease	ncubai
technology	teknologi
teeth	Ipenna
tell	kataken
tell	tenahkan
tell me	Kataken man aku
temper	bundut
temper	dayok
temper	kulpik
temperature	temperatur
temple	kuil
temporary	sedang
ten	sepuluh
ten thousand	sepuluh ribu
tenant	newaken
tend	menukah
tendency	tendensi
tender	unung
tender	lete
tense	tebek
tense	keskes
tense	beting
tension	tekanen
tent	tenda
tentative	sementara
term	ketentuen
terms	peraturen
terrible	la mehuli
terrific	la teralang
territory	taneh
territory	jahjahen
test	tes
text	tulisan
than	kasa
than	asa
than	asang
thank	bujur
thank you	bujur
Thank you for your patience while we investigate shipment	bujur i bas kesabaren ndu sangana selidiki kami kerna pengirimen ndu
thank you so much	bujur melala
thank you very much	Bujur melala
thanks	bujur
Thanks for using our app	bujur enggo make aplikasi kami
that	ena
that is	enda
that's good	mehuli
that's good	mejile
the	enda
theft	pinangko
their	jang kalah
them	kalah
theme	tema
themselves	kalak enda
then	kenca
then	enca
theory	teori
there	doh
there	jah
there	jadah
there are	lit
there is	ena
there is	enda lit
therefore	sebab
these	enda
they	kalak ah
they are	kalak enda
thick	bagal
thief	penangko
thigh	paha
thin	menipes
thin	kertang
thing	benda
things	benda
think	bagal
third	peteluken
thirsty	muas
thirteen	sepuluh telu
thirty	telu puluh
this	enda
this is	enda ia
thorough	sinasa
thorough	kibul-kibulen
thoroughly	secara keseluruhan
those	adah
those	ena
though	anem
though	anem pe
thought	tangkel
thought	ukur
thoughtful	rukuren
thoughts	pikir
thousand	seribu
thread	benang
threat	ancamen
threaten	gertak
threaten	ngendam
three	telu
threshold	i ambang
thrilled	meriah ukur
thrive	erkembang tir
throat	kerahung
through	lewat arah si
throughout	seh
throughout	seh asa
throw	benter
thumb	kambal-kambal
thunder	lenggur
Thursday	Kamis
thus	e maka
tick	cingkabek
tide	muncak-muncak
tidy	sikap
tidy	jore
tie	dasi
tiger	biahat
tiger	arimo
tiger	terep-terep
tight	pelcik
Tigrinya	Tigrinya
time	jam
timid	pemela
tiny	kitik
tip	tip
tips	ulih
tire	ban
tired	latih
tissue	tisu
title	judul
to	ku
to be	man
toast	roti panggang
today	wari si sendah
today	sendah
today	wari enda
toddler	danak-danak si kitik
toes	kambal-kambal
together	ras
together	ersada
toilet	kamar mandi
told	kataken
tolerance	toleransi
tolerate	tolerir
tomato	tomat
tomorrow	pagi
tongue	dilah
tongue	ndilah
tonight	berngi e
too	pe
took	buat
tool	alat
tools	alat
tooth	ipen
top	datasen
topic	tema
torn	rigat
torture	peniksaan
torture	sahsah
total	total
touch	jemak
tough	gegeh
tough	megegeh
tour	gawah-gawah
toward	ku arah
towards	ku
towel	andok
towel	anduk
town	kuta
toxic	racun
trace	tapak nahe
track	dalan
trade	ertukar
tradition	adat
traditional	si gel-gel
traditional	si nai-nai
traffic	lalu lintas
trail	bekas
trail	tapak
train	kereta api
training	erlajar
training	latihen
trait	lagu
trait	pelagu
traits	erlagu
traits	pelagu
transfer	Pindah
transition	transisi
translate	terjemahken
transparent	transparan
transport	transport
transportation	transportasi
trap	perangkap
trash	sampah
trauma	trauma
travel	gawah-gawah
tray	ingan
treasure	erta karun
treat	ian
treat	kema
treatment	Pengelakon
tree	batang
tremendous	seh kal galangna
trend	menukah
trial	percubaan
trick	arih
tried	icuba
trigger	Si erbansa
trim	ngkeret
trim	nabahi
trim	nggagahi
trip	perdalanen
trouble	soal
trouble	nanggel
trousers	seluar
truck	truk
TRUE	tuhu
trunk	ingan barang si arah pudi
trust	tek
truth	si tuhu
try	cuba
Tsonga	Tsonga
tube	bulungen
Tuesday	Selasa
tuition	uang sekolah
turkey	turki
turmeric	kuning gersing
turn	giliren
turtle	labi-labi
tutor	cara
twelve	sepuluh dua
twenty	dua puluh
twenty-one	dua puluh sada
Twi	Twi
twice	peduakaliken
twist	mukusur
twist	musing
two	dua
type	tipe
typical	khas
ugly	mejin
ultimate	terakhir
ultimate	pendungi
umbrella	payung
unable	la ngasup
uncle	mama
uncle	bapak uda
uncle	tengah
unconscious	megombang
under	teruh
underneath	berneh
underneath	teruh
underrated	mangkar
underrated	megombang
understand	angka
understood	pemeteh
unfortunately	egia
uniform	seragam
unique	unik
unit	unit
university	universitas
unknown	la sieteh
unless	katan
until	seh
until	seh asa
unusual	a bage biasa
up	nangkih
up to you	atendu
update	berita si mbaru
upgrade	upgrade
upon	suatu wari
upset	burlih-burlih
upset	burlah-burlah
urban	kota
urge	merhat kel
urgent	Penting
us	kita
use	gunaken
use	i gunaken
used	ipake
useful	erguna
useless	lanai reguna
usual	biasana
usually	bagi si gel-gel
usually	biasa
utility	guna
vacation	liburen
vaccination	Vaksin
vaccine	vaksin
vacuum	isap
vague	la jelas
valid	banci
valley	kelbung
valuable	erguna
value	erga
variety	macam
various	erbage
various	bage
vary	erbage-bage
vary	ermacam-macam
vase	vas
vast	luas
vegetable	gulen-gulen
vegetables	langen
vehicle	motor
vendor	vendor
venom	erbisa
venture	anggep-anggepen
venture	kelatihen
venture	pedahin
venue	ingan
verify	mreksa
versatile	serbaguna
version	versi
vertical	vertikal
very	kel
very good	merandal
vessel	kapal
via	arah
vibe	pengidahen
vibes	pengidahen
vicious	ilat
vicious	macik
victim	korban
video	video
view	pemandangen
village	kuta
villain	musu
vinegar	beja
vintage	antik
violence	kekerasen
violent	brutal
viral	viral
virgin	si nguda-ngudasi so keliamen
virtual	Secara online
virtual	Virtual
virtue	si mehuli
vision	pengenehenen
visit	reh ertamu
visual	pengidah
visual	idah
vital	penting
vivid	vivid
vocabulary	kumpulen kata-kata
voice	sora
void	kosing
volume	Jilid
volunteer	tenaga sukarela
vomit	mutah
vulnerable	lemah
wage	upah
wage	gaji
wages	upah tendi
waist	awak
wait	timai
waiter	naruhken
waiting	nimai
wake	medak
wake up	medak
walk	erdalan
walking	erdalan
wall	dingding
wallet	dompet
wander	gawah-gawah
wanna	nggit
wanna	jojoken
wanna	rudu
want	nggit
want	merhat
wanted	idarami
wanted	icari
war	Perang
wardrobe	lemari
warehouse	gudang
warm	angat
warn	momoken
warning	jaga-jaga
warrior	serdadu
warrior	anak bala
was	adalah
wash	burihi
waste	sia-sia
watch	nen
watch	nehen
water	lau
watermelon	semangka
wave	siombak
way	dalan
way	arah
we	kita
we	kami
we are	kami
we can	banci
weak	kote
weak	ngulah
weakness	kiniseran
wealth	Geluh mehaga
wealthy	bayak
wear	pake
wearing	pake
weather	tewen
wedding	kerja-kerja
wedding	kerja
Wednesday	wari Rabu
weed	ganja
week	Minggu
weekend	akhir pekan
weight	mberat
weird	la semal
weird	gandil
welcome	selamat datang
welfare	kemakmuren
Well	malem
well done	Mehuli Kal
went	lawes
were	ialah
west	barat
wet	bencah
whale	paus
what	kai
what about you	uga akap ndu
what about you	kam uga
what are you doing	serkai kam sangana
what are you doing now	erkai kam sendah
what are you doing now	erkai kam sangana gundari
what are you doing right now	erkai kam e
what do you do	erkai kam
what do you do for a living	kai dahinndu
what do you mean	kai maksud ndu
what do you want	kai pemindondu
what happened	kena kai
what is	kai kin
what is this	kai e
what is your job	kai dahinndu
what is your name	ise gelar ndu
what's up	uga berita
what's your name	ise gelarndu
whatever	kai pe
wheat	gandum
wheel	roda
when	katawari
when	ndigan
whenever	katawari pe
where	i ja
where are you	i ja kin kam
where are you from	ja nari kam
where are you now	i ja kam gundari
where do you live	ja kam tading
where is	ija
whereas	i
whether	tewen
which	si
which	sade
which	sidah
while	sedang
whisper	kusip
whistle	peluit
white	mentar
white	mbentar
who	ise
who are you	ise kin kam
who is	ise
who is this	enda ise
whole	kerina
whom	ise
whose	jang ise
whose	ajang ise
why	engkai
why not	uga maka lang
wicked	Jahat
wide	salang
wide	belang
widow	mbalu
widow	mulih-mulih
width	gedang
wife	ndehara
wild	meliar
will	me
willing	nggit
win	menang
wind	angin
window	pintun perik
windy	berangin
wine	anggur
winter	musim bergeh
wipe	sasap
wire	wayar
wisdom	kebeluhen
wise	beluh
wise	pintar
wish	ate
wish you all the best	dibata si masu-masu
witch	guru sibaso
with	alu
withdraw	ngadi
withdraw	ndarat
withdrawal	penariken
within	ibas
without	so
without	la so
witness	saksi
witty	pande
wolf	gurek
wolf	biang kerangen
woman	diberu
women	diberu
won	menang
won't	lang
wonder	jengang
wonderful	mejile
wood	kayu
wool	wol
word	kata benda
words	kata
work	dahin
work out	erdahin
working	erdahin
world	doni
worm	ombal-ombal
worm	cacing
worn	pake
worried	er ukur
worry	aru ate
worse	mumuk
worship	penyembahen
worst	la mehuli
worst	salah
worth	erga
worth	meherga
worth it	payo
worthy	si badia
would	tole
wound	albak
Wow	wah
wrap	Balut
wrap	Tutupi
wrath	rawai
wrath	kerawanen
wrist	tan
write	suratken
Write here	tulisken i jenda
writing	nulis
written	tulis
wrong	lepak
wrote	tulis
yard	kesain rumah
yawn	kehayamen
yawn	kayamen
Yeah	Ue
year	tahun
years	tahun
yeast	leme
yeast	ragi
yell	sergang
yellow	megersing
Yes	ue
yes baby	ue turang
yes dear	Ue sayang
yes honey	ue turang
yes my love	ue turang
yes of course	payo kal
yes of course	ue kin
yesterday	derbih
yesterday	nderbih
yet	lenga
yield	pendapaten
yield	asil
you	kam
you	ndu (kepunyaan)
you are	Kam
you are beautiful	mejile kel kam
you are so beautiful	mejile kel kam
you are welcome	bujur
you can	kam banci
You know	metehndu
you too	Kam pe
you're welcome	bujur melala
young	uda
young	nguda
your	ndu
your welcome	bujur
yourself	kam
youth	anak perana
youth	anak singuda denga
you’re welcome	bujur
yummy	ntabeh
yummy	matin
zero	kosong
