abandoned	fililen
abandon	ka fili
abide	ka bato
ability	se ko
able	se
about	kan
above	sanfɛ
abroad	tunga
absence	dayan
absent	a tɛ yen
absolutely	a bɛ ten
absorb	ka kunu
abstract	ɲɛfɔli kunkurun
absurd	kuntanya
abundance	caman
abundant	caman
abuse	ka tɔɲɔn
accent	fɔcogo
accept	ka sɔn
access	ka se a ma
accident	kasara
accommodation	ladon
accomplished	kɛlen
accomplish	ka lawaleya
according	kɔsɔn
account	jate
accuracy	fáranfasiya
accurate	jɔnjɔn
accused	jalakibaa
ache	dimi
achieve	ka kɛ
achievement	baarakɛlen
acknowledge	ka lakodon
acquaintance	dɔnni
acquired	sɔrɔla
acquire	ka sɔrɔ
acquisition	sɔrɔli
across	cɛ
action	wale
active	walawalalen
activities	baaraw
activity	baara
act	kɛwale
actor	walekɛla
actually	bari
actual	sisan
acute	selekenin
adapt	ka bɛrɛbɛn
addicted	dɔrɔgutala
additional	farankan
addition	kafoli
add	ka fara kan
address	dagayɔrɔ
adequate	bɛrɛbɛnlen
adjacent	kɛrɛ fɛ
adjective	mankutu
adjust	dálakɛnyɛ
admire	ka kɛ a fɛ
admit	ka jɔ a la
adopt	ka yamaruya
adorable	tanulen
advanced	min bɛ ɲɛfɛ
advance	ka taa ɲɛfɛ
advantage	nafa
adventure	taama
adverb	sɛmɛntiyalan
advertisement	gansilisɛbɛn
advertising	gansili
advice	laadilikan
advise	ka laadi
advocate	awoka
aesthetic	ɛsitetiki
affair	kunko
affection	kanu
affect	ka se a ma
affordable	daduman
afford	ka san
afraid	siranya
after	kɔfɛ
afternoon	wula
afterwards	tɛmɛnen kɔ
against	kama
again	tugunni
agency	tɔn
agent	walekɛla
age	si
aggressive	farin
agile	fɛgɛman
ago	a bɛ wagati bɔ
agree	ka bɛn
agreement	bɛnkan
agriculture	sɛnɛ
ahead	ɲɛ fɛ
aid	dɛmɛ
aim	taabolo
air	fiɲɛ
airport	awiyɔnso
aisle	egilisi
a	kelen
alarm	hakiljigifen
alcohol	dɔlɔ
alert	lasɔmini
a little	dɔɔni dɔrɔn
alive	bɛ balo la
all	bɛɛ
allowed	yamaruyalen
allow	ka yamaruya
all right	ɔwɔ
all the best	ne ka duba i ye
almost	sinasina
alone	kelen na
along	a nɔ fɛ
a lot	caman
a lot of	caman
already	kelen
Alright	Awɔ
also	fana
alternative	cogowɛrɛ
although	hali
always	tuma bɛ
amazing	kabakoma
ambiguous	ɲagamilen
ambition	tɔ́gɔɲini
ambitious	ɲɛtaa kanubaga
amend	ka amande
amid	caman cɛ
am	n ye
among	cɛma
among us	an cɛman
amount	da
amusing	ɲɛnajɛlan
analysis	sɛgɛsɛgɛli
ancestors	bɛnbaw
anchor	ka siri
ancient	kɔrɔlen
and	ani
and you	ani e
angel	mɛlɛkɛ
anger	dimi
angle	sleke
angry	dimilen
animal	bagan
an	Kelen
ankle	senkuru
anniversary	sanyɛlɛma
announcement	kunnafoni
annoyed	tɔɔrɔlen
annoying	tɔɔrɔlan
annoy	ka tɔɔrɔ
annual	san ni san
anonymous	dogolen
another	dɔ wɛrɛ
answer	jaabi
anticipate	ka kɔn
anxiety	jɔrɔ
anxious	hamitɔ
any	a mana ke min ye
anymore	tɛ bilen
anyone	mɔgɔ o mɔgɔ
anything	foyi
anyway	a kɛra cogo o cogo
anyways	a kɛra cogo o cogo
apart	a danma
apartment	so
apologize	ka yafa deli
apparent	jɛlen
apparently	a bɛ i na fɔ
appeal	ka weleli kɛ
appearance	yecogo
appeared	kunbɔra
appear	ka yira
appetite	dumuninege
apple	pɔmu
application	waleyali
apply	ka waleya
appointment	ɲɔgɔnkunbɛn
appreciate	tanu
appreciation	latanuli
approach	surunya
appropriate	bɛrɛbɛnnen
approval	yamaruyali
approved	yamaruyalen
approve	ka sɔ̀n
approximately	masurun
april	awirilikalo
arbitrary	binkani
architect	pilan bɔla
architecture	pilan bɔ
archive	ka mara
area	yɔrɔ
are	ye
are you busy	i tɛgɛ degunnen don wa
are you	e ye
are you married	i furulen don wa
are you married or single	i furulen do wa walima i ma furu
Are you still there?	Aw bɛ yan hali bi wa?
are you there	i be yen wa
argue	ka sɔsɔli kɛ
argument	sɔsɔli
arise	ka wili
arm	tɛgɛkala
army	kɛlɛbolo
around	dafɛ
arrange	ka ɲɛnabɔ
arrangement	ɲɛnabɔli
arrival	nali
arrived	se la
arrive	ka se
arrogant	kángɛlɛn
arrow	biɲɛkisɛ
article	sariyasen
artificial	hadamaden ka fɛn dilannen
artist	jadilanna
art	seko
ashamed	maloyalen
ash	bugurinjɛ
as	i n'a fɔ
asked	ɲininkala
ask	ka ɲininka
asleep	ka sunɔgɔ
as long as	kamasɔrɔ
aspect	yɔrɔ
Assamese	Asamwa
assault	binkani
assembly	asanbile
assertive	ka fɔ
assess	ka sɛgɛsɛgɛ
assessment	sɛgɛsɛgɛli
asset	kisɛ
assets	kìsɛ
assign	ka baara di
assignment	baara
assistant	dɛmɛbaa
assist	ka dɛmɛ don
associated	jɛlen
associate	jɛɲɔgɔn
association	tɔn
assume	k'i jɔyɔrɔ fa
assumption	bisigiyali
as well	ani fana
as well as	ani fana
ate	dumunu kɛ
at	fɛ
athlete	bolikɛla
at least	laban na
attached	sirinen
attach	ka siri
attachment	sirili
attack	ka bin
attempt	ka si filɛ
attendance	senjɔli
attend	ka sen don
attention	janto
attitude	kewale
attraction	lasamali
attractive	min bɛ mɔgɔ sama
attract	lasamali
attribute	ka ɲi
audience	lamɛlijama
august	utikalo
aunt	tɛnɛmuso
aunty	tɛnɛmuso
authentic	lakika
authority	fanga
author	wálebaga
autumn	otɔmi
available	bɛ yen
average	hakɛlama
avoid	fɛngɛ
awake	ka wuli
award	kado
aware	hakilimaya
awareness	laadiriyali
away	jàn
awesome	kabakoma
awful	cɛjuguman
awkward	ɲɛ́nango
Aymara	Ayimara
baby	denyɛrɛnin
bachelor	cɛgana
background	hukumu
back	kɔ
bad	jugu
bag	saki
bait	nuku-nuku
bake	ka wusu
bakery	nbuurudilanyɔrɔ
baking soda	kùmunan
balance	ka bɛrɛbɛn
ball	balɔn
Bambara	Bamanankan
banana	namasa
band	bandi
bang	ka gosi
bank	waribon
bar	dɔlɔminyɔrɔ
barely	sisan
bargain	ka tɛrɛmɛ
bark	jirifara
barley	ɔrizi
barrier	bariyɛri
base	bazi
based	ka sinsin
basement	kuluwo
basically	jubajula
basic	kunfɔlɔ
basil	basili
bastard	ɲàmɔgɔden
batch	kulu
bath	ka ko
bathroom	ɲɛgɛn
battery	batiri
battle	kɛlɛ
bay	loriye
beach	jida
beam	ɛrɛyɔn
beans	siyɔ
beard	bonbonsi
bearing	muɲuli
bear	muɲu
beast	bagan
beat	ka bugɔ
beautiful	cɛɲi
beauty	cɛɲɛ
became	kɛla
be careful	i janto
because	barisa
become	kɛ
bed	dalan
bedroom	siso
bee	diden
beef	misisogo
been	a kɛ la
beer	biyɛri
before	fɔlɔ
began	daminɛna
begin	ka daminɛ
beginning	daminɛ
behalf	tɔgɔla
behave	ka i jogo dɔn
behavior	jogo
behaviour	tagabolo
behind	kɔfɛ
being	ni fɛn
belief	danaya
believe	danaya
belly	kɔnɔbara
belong	ta don
beloved	ja nye mɔgɔ
below	jukɔrɔ
belt	sentiri
bench	ban
bend	ka gɔlɔn
beneath	duguma
benefits	nafaw
benefit	tɔnɔ
be	se
beside	kɛrɛ fɛ
besides	o kɔfɛ
best	fisaya
best of luck	ka i gɛrɛsɛgɛ
best regards	i ni ce kɔsɛbɛ
better	fisa
between	cɛ
beverage	minfɛnw
beyond	o sanfɛ
Bhojpuri	Bojpuri
bias	dɛmɛ fan
biased	fan sugandi
bicycle	nɛgɛso
bid	ka pariye
big	belebele
bike	nɛgɛso
bill	sariya bolo
bind	ka siri
bird	kɔ̀nɔ
birthday	wolodon
bite	ka kin
bit	kin
bitter	kuna
black	finman
blade	murukisɛ
blame	ka jalaki
blanket	birifini
blank	lankolon
blast	ka ci
bleach	zawɛli ji
blend	ka ɲagami
bless	duba
blessed	dubalen
blind	fiyentɔ
bliss	daamu
block	kare
blood	joli
bloom	ka filɛri bɔ
blow	ka fiyɛ
blue	bula
blunt	ka dɔgɔya
board	tabulo
boat	bato
body	farikolo
boil	ka wuli
bold	farin
bond	bɔn
bone	kolo
book	gafe
booster	fangadilan
boost	ka fisaya
boot	ka faga ka mɛnɛ
boots	samarabaw
border	dancɛ
bored	girin
bore	forazidingɛ
boring	taabataaba
born	wolo
borrow	ka singa
boss	patɔrɔn
bother	ka tɔɔrɔ
both	u fila bɛ
bottle	buteli
bottom	jukɔrɔla
bought	sani
bounce	ka pan pan
boundaries	danfaraw
bound	ka tugu
bow	kala
bowl	tasa
box	buwati
boy	cɛmani
boyfriend	kamalen
bracelet	bololanɛgɛ
brain	kunsɛmɛ
branch	bolofara
brand	mariki
brave	jalagɛlɛn
breach	ka kari
bread	buuru
breakfast	daraka
break	ka a kari
breast	sin
breathe	ka ninakili
breath	ninakili
breed	ka lamara
brick	biriki
bride	kɔɲɔmuso
bridge	pɔn
brief	surunma
bright	manamanalen
brilliant	kunkɛnɛma
bring	ka a naati
broad	belebeleba
broadcast	ganseli
bro	balimakɛ
broke	kari
broken	karilen
broom	furalan
brother	balimakɛ
brother in law	nimɔgɔkɛ
brought	a y'a nati
brown	bilenman
brush	bɔrɔsi
bucket	palan
buddy	teri
budget	baarakɛnafolo
bug	fɛnɲɛnama
building	so
build	ka jɔ
built	jɔ̀len
bulk	caman
bull	ntura
bully	ka bàgabaga
bump	jùnkun
bunch	caman
bundle	fɔrifɛ
burden	doni
buried	su don
burn	ka jeni
burst	ka ci
bury	ka sutura
bush	kungo
business	ko
bus	kaare
bust	ka halaki
busy	degu
but	nka
butterfly	nfirinfirinin
butter	naare
button	butɔn
buy	ka san
bye	k'an bɛn
by	ni a ye
by the way	o sen fɛ
cabbage	Supompe
cabinet	kabinɛ
cage	ka datugu
cake	gato
calf	misiden
called	min bɛ wele ko
call me	ne wele
call	weleli
calm	mada
came	nana
campaign	kanpaɲi
Cancel	ka dankari
cancer	kansɛri
can	ka se
can't	tɛ se
capable	sékola
capacity	fanga
capital	faaba
caption	minɛni
capture	ka minɛ
career	baara
careful	jàntońyɛ̀rɛla
carefully	nɛmɛnɛmɛ
careless	hamibali
caring	hami
car	mɔbili
carpenter	jiridɛsɛla
carpet	tapi
carrot	karɔti
carry	ka ta
carry on	ka kɛ
carry out	ka kɛ
case	jati
cash	nafolomugu
cast	ka yelen
castle	so belebele
casual	nɔgɔma
catch	k'a minɛ
category	suguya
cat	jakuma
cattle	misiw
caught	minɛli
cause	bila
caution	jantoyɛrɛla
cautious	jasigi
cave	kuluwo
cease	ka dabila
ceiling	pilafɔn
celebrate	ɲɛnajɛ
cell	selili
center	santiri
century	sànkɛmɛ
cereal	suman
ceremony	ɲɛnajɛ
certain	dɔw
certainly	jaati
certificate	dipilomu
chain	jɔlɔkɔ
chair	sɛsi
challenge	gɛlɛya
chance	garisigɛ
change	ka yɛlɛma
chaos	cɛnnin
characteristics	kɛcogow
character	jogo
charge	jalakilen
charity	kànuya
charming	cɛɲi
chart	sɛbɛn
chase	ka gɛn
chat	ka masala
cheap	sɔngɔ duman
cheating	namarali
cheat	ka namara
check	waritasɛbɛn
cheek	dafuruku
cheerful	nísɔnduman
cheer	i ni baara
cheers	tɛkɛrɛfɔw
cheese	foromazi
chemistry	furafeereyɔrɔ
cherish	ka buruɛrɛ
chess	damu
chest	disi
chew	ka ɲimi
chicken	sisɛ
chief	kuntigi
child	denmisɛn
childhood	denmisɛnya
children	denmisɛnw
chill	nɛnɛ
chimneys	sisibɔyɔrɔ
chin	bonbon
chocolate	sokola
choice	ɲɛnata
choose	sugandi
chop	ka ci
chores	sokɔnɔ baaraw
chubby	belebeleba
church	egilisi
cinnamon	kanɛli
circle	koori
circumstances	kɛcogo
citizen	jamanaden
city	duguba
claim	ka laɲini
clarify	ka lajɛya
class	kilasi
clay	bɔgɔ
clean	ka jɔsi
clear	jɛman
clerk	pilantɔn
clever	kegun
client	sannikɛla
cliff	kulu
climate	wagati
climb	ka yɛlɛ
clingy	nɔrɔnan
clock	mɔnturu
close	ka datugu
closet	alimɔri
clothes	fini
cloth	fini
cloud	kabanɔgɔ
cloudy	kabafin
clown	sosi
clue	ekuru
clumsy	ɲɛnabɔbali
cluster	jɛkulu
coach	degelikaramɔgɔ
coal	sarabon
coast	kɔgɔjida
coat	dolokiba
coffee	kafe
cognitive	kunkolola
coincidence	balinan
cold	nɛnɛ
collapse	ka bin
collar	kannakɔnɔ
colleague	baarakɛɲɔgɔn
colleagues	baarakɛɲɔgɔnw
collection	farankan
collect	ka cɛ
college	kolɛzi
colorless green ideas slept furiously	hakilina lajɛbali lakodɔn ka gɛlɛ
color	ɲɛ
colour	ɲɛ
column	kɔlɔni
combination	farankan
combine	ka faraɲɔgɔnkan
comb	pɛɲi
come here	na yan
come	ka na
come on	don
comfortable	lafiyalen
comfort	lafia
coming	nata
coming soon	sɔɔni
command	ka kɔmande
comment	jateminɛ
commercial	jago
commission	ci
commit	ka kalifa
commitment	layidu
committed	cɛsirilen
commodity	dumunifɛn
common	min bɛ deli ka kɛ
communicate	kumaɲɔgɔnya
communication	kunnafonin
community	sigida
commute	ka yɛlɛma
companion	tɔɲɔgɔn
company	cakɛda
compare	ka sanga
comparison	sangali
compassionate	makaritigi
compassion	hinɛ
compatible	min bɛ bɛn ni ɲɔgɔn ye
compete	ka ɲɔgɔndan
competent	fàamuyalen
competition	ɲɔgɔndan
competitive	ɲɔgɔndanli
complain	makasi
complaint	makasi
complement	dafalan
complete	ka dafa
completely	pewu
complex	gɛlɛnman
compliance	ka bɛn a ma
complicated	ɲagamilen
compliment	tanuli
comply	ka bɛn a ma
composition	kɛ fɛnw
compound	dukɛnɛ
comprehension	famuyali
comprehensive	famuyalen
compromise	sèndòn
compulsory	jagoya
computer	ɔridinatɛri
concentrate	cɛsiri
concept	kumasen
concerned	a bɛ a la
concern	hanminanko
concert	kɔnsɛri
conclusion	kuncɛli
concrete	bɛtɔn
condition	cogo
conditions	bɛnkanw
conduct	kɛwale
conference	lajɛba
confess	ka kɔnɔ fɔ
confidence	lanaya
confident	dannayabaa
confirm	sɛmɛntiya
conflict	kɛlɛ
confused	ɲaamilen
confusion	ɲaamili
congrats	i ni ce
congratulation	i ni baara
congratulations	i ni baara
conjunction	síratigɛ
connect	ka kɔnɛkite
conquer	ka minɛni
conscious	hakilima
consciousness	làadirima
consent	bɛnkan
consequences	kɔlɔlɔw
conservation	marali
conservative	maralikɛla
considered	a kɛ i na fɔ
consider	ka jate
consist	bɛna
consistency	fasaya
consistent	fasaman
constant	kumabɛ
constantly	kumabɛ
constipation	kɔnɔja
construction	sojɔ
consume	ka dun
consumption	dunmuli
contact	ka wele
contagious	fiɲɛbana
contain	ka ku
contains	kɔnɔnafɛnw
contemporary	bi ko
contempt	ɲígi
content	kɔnɔnafɛn
contest	ka sɔsɔ
context	hukumu
continent	bangu
continue	ka taa fɛ
contract	bɛnkan
contrast	kɔnɔnafilila
contribute	ka bolomafara di
contribution	bolomafara
control	ka jateminɛ
controversial	lagosilen
convenience	sagoma
convenient	ɲɛnama
conversation	masala
convert	yɛlɛma
convey	ka lase
convinced	lasɔnna
convince	ka lason
cooking	tobili
cook	ka tobili kɛ
cool	suma
cooperation	tɛgɛdiɲɔgɔnma
cope	ka ku
copper	nɛgɛ
core	kìsɛ
corner	seleke
corn	kàba
correct	jaati
cost	sɔngɔ
costume	fini
cottage	so fitini
cotton	kɔɔri
couch	dilan
cough	sɔgɔsɔgɔ
could	a tun bɛ se
council	kɔnseye
counter	kɔntɛri
count	ka jate
country	jamana
countryside	burusi
couple	cɛ ni muso
courage	jagɛlɛya
course	kalan
courtesy	ɲumanya
court	kiritikɛso
cousin	kanimɛ
cover	ka datugu
coward	fukari
cow	misimuso
cozy	lafiyalen
crab	turuto
crack	cida
craft	bololabaara
crap	ko kolon
crash	benni
craving	kɔngɔ
crawl	fofo
crazy	fatɔ
create	ka dilan
creative	kekuman
credit	juru
creep	ka yɛlɛ
creepy	bagabagalifɛn
crew	ekipu
crime	sariyatiɲɛ
cringe	ka sigi
crisis	gɛlɛya
criteria	sariyasenw
critical	kìsɛ
criticism	lagosili
crop	sɛnɛ fɛnw
crops	sɛnɛfɛnw
cross	ka tigɛ
crowded	jama caman
crowd	jama
crow	ka kasi
crown	masafugula
crucial	nafan ka bon
cruel	fariya
cruise	bato
crush	nɔɔni
cry	ka kasi
cucumber	kɔnkɔn
cuddle	mùnumɛnɛ
culture	dɔnko
cunning	kegun
cupboard	alimɔri
cup	bɔli
curb	ka kɛlɛ
cure	ka fura kɛ
curfew	kuwurufe
curiosity	kiriyosite
curious	ko sɛgɛsɛgɛla
curly	dayɛlɛnan
currency	wari
currently	sisan
current	sisan
curse	danga
curtain	irido
cushion	kunkolodalan
customer	sannikɛla
custom	laada
customs	laada
cute	cɛɲi
cut	ka tigɛ
cycle	sikili
cycling	nɛgɛsoboli
daddy	baba
dad	fa
daily	don o don
dairy	nɔnɔmafɛn
damage	ka tiɲɛ
dam	barazi
damn	kɔrɔtɔli
damp	suma
dance	dɔ̀n
danger	farati
dangerous	faratima
dark	dibi
darling	kanu
dash	tiirinin
data	kunnafoniw
date	don
daughter	denmuso
day	don
deadline	dan
dead	su
deaf	tulogeren
deal	ɲɛsin
Dear All	Aw bɛɛ ni ce
Dear Customer	N Balima sannikɛla
dear	n balima
Dear Parents	N bangebaw
Dear Sir	N balima cɛ
Dear students	N balima kalandew
Dear Team	N balima ntolatantɔn maaw
death	saya
debate	sɔsɔli
debit	sarali
debris	ɲaman
debt	juru
decade	san tan
decay	toli
deceased	banbaatɔ
deceive	ka janfa
december	desanburukalo
decent	wasobaliya
decided	latigɛlen
decide	ka latigɛ
decision	latigɛ
deck	pɔn
decline	ka ban
decrease	ka jigin
dedicated	kɛrɛnkɛrɛnlen
dedication	dedikasi
deed	kɛwale
deep	dun
deer	minan
default	fɔlɔ
defeat	ka se sɔrɔ
defend	ka lakana
define	dànsìgi
definitely	tigitigi
definition	yirali
degree	dipilomu
delayed	a mɛna
delay	ka mɛ
delete	ka jɔsi
deliberate	ka lawili a kaman
delicate	ɲɛ́namisɛn
delicious	dumanba
delighted	nisɔndiyalen
delight	ka nisɔndiya
delivered	jiginni
deliver	ka di
delivery	jiginni
demanding	laɲininnen
demand	ka laɲinini
democracy	bɛɛjɛfanga
demon	sitanɛ
demonstrate	ka jira
denied	a bana a ma
density	hakɛ
dentist	ɲinfurakɛla
deny	ka dalacɛ
department	depariteman
departure	tagali
depend	ka bɔ a la
deploy	ka yɛrɛkɛ
deposit	ka bila
depressed	jigitigɛlen
depression	farifaga
depth	dunya
describe	ka lakali
description	cogojirali
desert	cɛncɛnkungo
deserve	ka kan ni ... ye
designation	welecogo
design	desɛn
desire	nege
desk	tabali
despair	jigintanya
desperate	jigitigɛ
despite	hali
dessert	desɛri
destination	taayɔrɔ
destiny	dakan
destroy	ka halaki
destruction	cɛnni
detail	faranfasiyali
details	ɲɛfɔli
detect	ka lásàa
determination	wúlikajɔ
determine	dansigi
determined	jijalen
devastated	nagasila
developed	yiriwalen
develop	ka yiriwa
development	yiriwali
device	minɛn
devil	sitanɛ
devoted	kariyalen
Dhivehi	Dwehi
diabetes	jabɛti
diarrhea	kɔnɔboli
diary	jurunali
dictionary	daɲɛgafe
did	a y'a kɛ
died	sa
die	ka sa
diet	erezimu
difference	danfara
different	wɛrɛ
difficult	gɛlɛnman
dig	ka sen
dignity	danbe
diligent	ka fɛsɛfɛsɛ
dinner	surafana
dip	ka su
direction	kuntilenna
direct	ka ɲɛminɛ
director	kuntigi
dirt	nɔgɔ
dirty	nɔgɔlen
disabled	a jɔ la
disable	ka lajɔ
disappear	ka tunu
disappointed	jigitigɛ
disaster	kojugu
discard	ka fili
discharge	ka jigin
discipline	kolo
discount	dajigi
discover	ka ye
discrimination	ɲɛnawoloma
discussion	jɛkafɔ
discuss	ka jɛkafɔ kɛ
disease	bana
diseases	banaws
disguise	ka yɛrɛ masike
disgusting	ɲígintɔ
dish	daga
dishes	dagaw
dismiss	ka gɛn
dispatch	ka ci
display	ka yira
disposal	ka bɔ i bolo
dispute	dalamankan
distance	janya
distinct	kelen
distinguish	faranfasiya
distress	kàmanagan
distribution	ɲinli
district	sigida
disturb	ka tɔɔrɔ
ditch	fose dingɛ
dive	ka nɔn
diverse	caman
diversity	danfaraw
divide	ka tila
divine	ka sídɔn
divorce	furusa
dizzy	ɲɛnamini
doctor	dɔgɔtɔrɔ
document	sɛbɛn
does	kɛ la
doesn't	ayi
Dogri	Dogri
dog	wulu
doing	kɛli
do	kɛ
doll	dendennin
domain	donko
domestic	sokɔnɔna
dominant	fangatigi
donate	ka saraka bɔ
done	a kɛra
donkey	fali
don't	ka na kɛ
Don't worry	Kana jɔrɛ
dope	dɔrɔgu ta
double	siɲɛfila
doubt	sigasiga
dough	ndoro
down	duguma
download	ka telesarize
do you	e bɛ
do you love me	i bɛ ne fɛ wa
draft	ka labɛn
drag	ka ta ka bila
drain	jiboli
drama	tiyatiri
drawer	tiriwari
drawing	desɛn
draw	ka desɛn
dread	siranya
dream	sugon
dress	fini
drill	ka seni
drink	ka min
drive	ka boli
drop	k'a bila ka bin
dropped	bɔla
drought	ja
drunk	minnen
dry	ka ja
duck	tɔnkɔnɔ
dude	teri
due	sarata
due to	o kɔsɔn
dull	manamantanya
dumb	naloma
dump	dingɛ
duration	don hakɛ
during	senfɛ
dust	buguri
duty	baara
dwell	ka sigi
dying	satɔ
each	bɛɛ kelen kelen
each other	kelen kelen bɛɛ
eager	kɔrɔtɔ
eagle	samatasɛgɛ
ear	kulo
earlier	joona
early	joona
earn	sɔrɔ
ears	tulo
earth	dugukolo
earthquake	dugukoloyɛrɛyɛrɛ
ease	nɔgɔya
easily	nɔgɔnman
east	kɔrɔn
easy	nɔgɔnman
eating	dumuni
eat	ka dun
economic	marali
economy	sɔrɔ
edge	kɛrɛda
edit	ka korize
education	ladamuni
effective	min bɛ baara la
effect	nɔ
efficiency	nɔ kaɲi
efficient	nɔɔ kaɲin
effort	seko
eggplant	obɛrizini
egg	sɛfan
ego	yɛrɛkanu
eighteen	tan ni segin
eight	segin
eighty	bisegin
either	walima
elaborate	ka labɛn
elbow	nɔnkɔnkuru
elder	cɛkɔrɔba
elderly	mɔgɔkɔrɔbaw
elegant	buga
element	fɛn
elephant	sama
eleven	tannikelen
eligible	yamaruyalen
eliminate	ka bɔ
else	dɔ wɛrɛ
embarrassed	dasunsun
embarrassing	maloyako
embrace	ka dasun
emerge	ka poyi
emergency	peresela ko
emotional	nisɔndiya
empathy	hinɛ
emphasis	faranfasiya
emphasize	ka sinsin
employee	baarakɛla
employees	baarakɛdenw
employer	ka ta baara la
employment	baara
empty	lankolon
enable	ka yamaruya
encounter	ka kunbɛ
encourage	ka sinsin
endangered	bɛ faratila
endeavor	cɛsiri
end	laban
endurance	ko kuli fanga
endure	ka ku
enemy	jugu
energy	kisɛya
engaged	maninɛlen
engage	ka ŋaniyata
engagement	angageman
engineer	ɛnzeniyɛri
engine	motɛrɛ
English	Angilɛtɛri
enhance	ka fisaya
enjoy	tonɔmabɔ
enormous	camanba
enough	fisa
ensure	ka i gɛlɛya ka
enter	ka don
entertainment	ɲɛnajɛ
enthusiasm	nisɔndiya
enthusiastic	nísɔnduman
entire	bakuruba
entitled	min tɔgɔ ye
entity	yɔrɔ
entrance	donda
entrepreneur	kɛnyɛrɛye
envelope	anwulopu
environment	sigida
envy	nege
epic	poyi
epidemic	bana
equal	kan
equipment	baarakɛminɛn
equity	kelenya
equivalent	ɲɔ̀gɔn
eraser	jɔsilikɛlan
error	filijuru
escape	ka kila
especially	kɛrɛnkɛrɛnlenyala
essay	sɛbɛn
essence	esansi
essential	fanba
established	gilalen
establish	ka labɛn
estate	so
estimated	jateminɛna
estimate	ka jateminɛ
etc	o ni dɔ wɛrɛw
eternal	banbali
ethics	taabolow
evaluate	ka ewaliye
evaluation	ewaliyasiyɔn
even	hali
evening	su
even though	hali ni
event	lajɛrɛ
eventually	labanna
ever	badaa
every	bɛɛ
everybody	bɛɛ
everyone	bɛɛ
everything	bɛɛ
evidence	seereya
evil	juguya
evolution	ɲɛtaga
evolve	ewoliye
Ewe	Ewe
exactly	jaati
exact	o yɛrɛ
examine	ka sɛgɛsɛgɛ
exam	isamɛn
example	misaliya
exceed	ka tɛmɛ a dan kan
excellent	ɲuman ɲuman
except	fɔ
exception	fɔ
excess	dantɛmɛ
excessive	dantɛmɛ
exchange	ka falen
excited	nisondiyalen
excitement	nisɔndiya
exciting	sugubalan
exclusive	kelen
excuse	hakɛ to
excuse me	hakɛ to
execute	faga
execution	fagali
executive	ɲɛmɔgɔ
exercise	degeli
exhaust	bɔli
exhausted	sɛgɛnlen
exhibition	perezantasiyɔn
exhibit	ka jira
exist	a bɛ yen
existence	ɲɛnamaya
existing	min bɛ yen kɔrɔlen
exit	ka bɔ
ex	kɔrɔlen
expand	ka janya
expected	jìgi dali
expect	makɔnɔ
expenses	musakaw
expensive	gɛlɛn
experience	ko dɔn
experiment	ka kɛ ka lajɛ
expert	dɔnnibaga
expired	dati bana
explain	ka ɲɛfɔ
explanation	ɲɛfɔli
exploit	ka nafa bɔ
explore	ka mafilɛ
export	ka labɔ
exposed	lakanabali
expose	ka jira
exposure	dàntigɛli
expression	kumasen
express	ka kuma
extended	samanen
extend	ka lasama
extension	samali
extent	janya
external	kɔfɛla
extinct	ka faga
extract	ka labɔ
extra	farankan
extraordinary	dákabana
extreme	damatɛmɛ
extremely	kojugu
eye	ɲɛ
eyes	ɲɛw
fabric	finimugu
fabulous	kabakoma
face	ɲɛda
facilitate	nɔgɔya
facilities	baarayɔrɔw
facility	nɔ̀gɔya
factor	fɛn
factory	izini
facts	kow
fact	walen
fade	fɔsɔnfɔsɔn
failed	dɛsɛla
fail	ka dɛsɛ
failure	ka dɛsɛ
faint	ka kirin
fair	fisa
fairly	fisa
fairy	nsiirin
faith	dannaya
faithful	kantigi
fake	lankolon
fall	ka bi
false	nkalon
fame	tɔgɔ
familiar	delina
family	denbaya
famine	kɔ́ngɔba
famous	tɔgɔtigi
fancy	cɛ kaɲi
fan	fifalan
fantastic	ɲɛnamaba
farewell	bilasirali
far	jan
farmer	sɛnɛkɛla
farm	foro
fascinating	dabalibanfɛn
fashion	mɔdɛli
fast	teliman
fatal	juguman
fat	belebeleba
fate	dakan
father	fa
fatigue	sɛgɛn
fault	jalaki
favorite	kɛrɛnkɛrɛnlen
favour	barika
favourite	ninkanta
fear	siranya
feast	duminiba
feather	si
features	suguya
feature	suguya
february	fewuruyekalo
fed up	ka nege bɔ
feedback	kibaru kɔsegi
feed	ka balo
feeling	dùsukunnata
feel	ka sunsun
fee	sɔngɔ
feet	senw
fell	benna
fellow	jɛɲɔgɔn
felt	kásasama
female	muso
fence	sinsan
fertile	yɔrɔduman
festival	gintanba
fetch	ka ɲini
fever	farigan
few	damadɔ
fewer	dama dɔɔnin
fiance	maminɛkɛ
fiction	suya
field	foro
fierce	farin
fifteen	tan ni duuru
fifty	biduuru
fighting	kɛlɛ
fight	ka kɛlɛ kɛ
figure	jateden
figure out	ka jate
file	papiye
filled	falen
fill	ka fa
film	filimu
filthy	nɔgɔlen
finally	a laban
finance	finansi
financial	wariko
find	ka sɔrɔ
find out	ka sɔ̀rɔ
fine	a kan ɲi
finger	bolokɔni
finished	a bana
finish	laban
fire	tasuma
firm	gɛlɛn
first	fɔlɔ
first name	tɔgɔ
fish	jɛgɛ
fit	dakɛɲɛ
five	duuru
fixed	labɛnnen
fix	ka kulon
flag	darapo
flash	yelen
flat	fɛnsɛlen
flawless	ɲumanba
flaw	wo
flee	ka boli
flesh	farisogo
flew	bolila
flexible	labilalen
flex	ka kuru
flight	awiyɔn
flip	kilape
flirting	jalali
flirt	ka jala
float	filotɛri
flood	jiwalankata
floor	dugukolo
flour	mugu
flower	filɛri
flow	sooro
fluent	kɔsɛbɛ
fluently	kɔsɛbɛ
fluffy	makama
fluid	ji
flu	murusɔgɔsɔgɔ
fly	dimɔgɔ
focus	ɲɛsin
fog	bugun
foggy	ɲaamilen
fold	ka kuru
folks	jama
following	ɲɛfɛta
follow	ka tugu
follow up	ka tugu
food	dumuni
foolish	hakilintan
fool	lafili
football	ntolatan
foot	sen
forbidden	kɔlilen
force	ka karaba
forecast	ɲɛbila
forehead	tenda
foreign	dunuan
forest	tu
forever	badaa
For example	I n'a fo
forget	ka ɲina
forgive	ka yafa
forgot	ɲìnɛ
for instance	misali la
fork	furusɛti
for	kosɔn
formal	sariyakɔnɔ
former	kɔrɔlen
form	mɔn
fortunately	ala barika la
fortune	nafolo
forty	binaani
forty-two	binaani ni fila
forward	ɲɛ
for you	i ta
foster	ka yiriwa
fought	kɛlɛ
foundation	jusigilan
found	sɔrɔlen
four	naani
fourteen	tan ni naani
fox	kungowulu
fragile	fɛ́gɛn
frame	lamini
framework	hukumu
fraud	sonyali
freak	siranya
freedom	hɔrɔnya
free	ka kunmabɔ
freeze	ka gilase
frequency	fiɲɛturukala
frequent	kuma caman
frequently	kuma caman
fresh	kɛnɛ
friday	juma
fridge	firigo
friendly	jòlimandi
friendship	teriya
friends	teriw
friend	teri
frightened	jasiralen
frightening	bagabagali
frog	ntori
from	ka bɔ
front	ɲɛfɛla
frozen	galasila
fruit	yiriden
frustrated	lasiranlen
fuel	taji
Fulfulde	Fula
full	faalen
function	baarakunda
fundamental	dugumata
funeral	jɛnɛja
funny	yɛlɛko
fun	yɛlɛko
furious	diminen
furniture	minɛw
fur	si
further	foo yen fɛ
furthermore	tagalen yɛ
future	sini
gain	sɔrɔ
game	tulon
gap	furancɛ
garage	garasi
garbage	ɲaman
garden	nakɔ
garlic	layi
gate	da
gathering	lajɛ̀
gather	lajɛ
gauge	ka ewaliye
gave	a dila
gear	witɛsi dolan
gender	cɛnimusoya
generally	bakurubala
general	zenerali
generate	ka dilan
generation	zenerasiyɔn
generous	ɲumanya
genius	hakiliduman
genre	sifa
gentle	ɲuman
genuine	kegunman
gesture	taamasiyɛn
get dressed	fini donna
get	sɔrɔ
getting	sɔrɔli
get up	ka wili
get well soon	ka kɛnɛya di
ghosting	su wililen
ghost	ja
giant	belebele jamanjan
gift	sama
ginger	ɲamaku
girlfriend	sungurun
girl	npogotigi
give	ka di
given	dilen
give up	ka bila
glad	nisɔndiyalen
glance	ka lajɛ
glasses	nunɛti
glass	wɛɛrɛ
glimpse	ka ɲɛ jɔ a la
global	fanbɛ
gloomy	dibilen
gloves	ganw
glow	jigiya
glow up	ka manamana
glue	kɔli ji
go ahead	taga ɲɛfɛ
goal	ka bi don
goals	kuntilennaw
goat	ba
go away	ta ne ɲɛ
god bless you	Ala ka barika don i la
god	ma
goes	taa
going	ka taa
going to	taalen
go	ka taa
gold	sanu
gone	a taala
gonna	bɛna
good afternoon	i ni wula
good bye	kan bɛ
goodbye	kan bɛn
good day	ka tile hɛrɛ
good	duman
good evening	i ni su
good job	baara ɲuman
good looking	yecogo ɲuman
good luck	kunnaja
good morning	a' ni sɔgɔma
good morning my love	ne jarabi ni sɔgɔma
good night	ka an bo su ra
goodnight	ka su hɛrɛ
goods	feerefɛnw
Google	Gugɔli
Google Translate	Gugɔli ka bayɛlɛmali
goose	kulokulodeni
goo	yeelennen
gorgeous	ɲumanba
gossip	kɔrɔfɔli
got it	a sɔrɔla
go to bed	taga la
got	sɔrɔ
government	gofɛrɛnaman
grab	minɛ
grade	jala
gradually	dɔɔni dɔɔni
graduate	ka dipilomu sɔrɔ
grain	kisɛ
granted	yamaruyalen
grant	ka yamaruya
grapes	rezɛn
grasp	ka minɛ
grass	bin
grateful	waleɲumandɔn
gratitude	waleɲumandɔn
grave	kaburu
gray	bugurinjɛ
great	belebele
greed	natabaya
greedy	nuguma
green	binkɛnɛ
greeting	folikan
greetings	folikanws
greet	ka foli kɛ
grey	bugurinjɛ
grid	nɛgɛjuru
grief	hami
grind	ka si
grip	ka nɔrɔ
grocery	dumunifɛn feereyɔrɔ
groom	furucɛ
gross	belebele
ground	dugukolo
group	jɛkulu
grow	ka falen
growth	jiidiya
grumpy	farifagalen
Guarani	Gwarani
guarantee	gáranti
guard	ka kɔlɔsi
guess	ka jaabi ɲinin
guest	dunan
guidance	bɛrɛbɛrɛli
guide	bereminɛbaa
guilty	hakɛtigi
guy	cɛ
guys	mɔgɔw
gym	zimu
habitat	so
habit	fini
had	a tun b'a fɛ
hail	ka fo
hair	kunsigi
half	tilancɛ
hall	ali
hand	bolo
handle	kala
handsome	cɛɲi
hang	ka dulon
hang out	ka bɔ ɲɔgɔnfɛ
happened	a kɛla
happen	ka kɛ
happiness	nisɔndiya
happy birthday	sanbε sanbε
happy birthday to you	a ni san kura
happy new year	ka san kura hɛrɛ caya
happy	ɲagali
hard	gɛlɛnman
hardly ever	a ka gɛlɛn kuma bɛɛ
hardly	gɛlɛnman
harmful	tɔɔrɔlan
harmony	cogo cɛɲi na
harm	tɔɔrɔ
harsh	gɛlɛma
harvest	tigɛ
has	sɔrɔ
hate	kɔniya
have a good day	ka tile hɛrɛ
have a nice day	ka tile hɛrɛ
have breakfast	ka daraka dun
have fun	ka i ɲɛnajɛ
have	sɔrɔ
have you eaten	i ye dumuni kɛ wa
having	sɔrɔli
hazard	balinan
haze	bugun
he	a
headache	kunkolodimi
head	kunkolo
healing	kɛnɛyali
heal	kɛnɛya
health	kɛnɛya
healthy	kɛnɛman
heard	mɛn na
hear	ka mɛn
heart	ale
heat	funteni
heaven	sankolo
heavy	girin
hectic	sɛgɛn
he has	a….bɛ
height	janya
heir	ciyɛntala
he is	a ye
heist	sonyali
held	minɛlen
hell	jahanama
Hello	aw ni baara
hello dear	i ni ce n balima
hello how are you doing	i ni ce, i ka kɛnɛ wa
hello how are you	i ni ce, i ka kɛnɛ wa
helmet	kasiki
help	dɛmɛ
helpful	dɛmɛni
hence	o kama
her	ale
herd	ka gɛn
here	yan
heritage	ciyɛn
hesitate	ka siga
Hey	Hee
Hi	aw ni baara
hidden	dogolen
hide	ka dogo
hierarchy	ɲɛmɔgɔya
high	jamanjan
highlight	ka faranfasiya
hi how are you	i ni ce, i ka kɛnɛ wa
hike	senataama
hiking	senataama
hilarious	yɛlɛko
hill	kulu
him	a
hint	taamasiyɛn
hips	tɔ̀gɔ
hip	tɔ̀gɔ
hire	ka ta baara la
hiring	tali
his	a
history	tariku
Hi there	ani ce yan
hit	ka bugɔ
Hmm	hum
hobby	dónnatɛmɛ
hold	ka minɛ
hold on	ka jɔ
hole	dingɛ
holiday	kɔnze
hollow	wo
home	so
homework	sokɔnɔbaara
honestly	sɛbɛ-sɛbɛ la
honest	sɛbɛ
Honey	Di
honor	bonya
hood	kapo
hook	nugunugu
hopefully	ni ala sɔn na
hope	jigi
hopeless	jigidan
hop	ka pan pan
horizontal	dalen
horn	biɲɛ
horrible	cojugu
horror	juguman
horse	so
hospital	dɔgɔtɔrɔso
hospitality	jatigiya
hostile	juguya
host	jatigi
hotel	lotɛli
hot	kalanman
hour	lɛrɛ
hours	lɛrɛw
household	somɔgɔw
house	so
how about you	i yɛrɛ dun
how are you doing	i ka kɛnɛ wa
how are you doing today	i ka kɛnɛ bi wa
how are you	i ka kɛnɛ wa
how are you today	i ka kɛnɛ bi wa
how	cogo di
how do you do	i ka kɛnɛ wa
however	nka
how is	a bɛ di
how many	joli
how much	joli
how often	siyɛ joli
how old are you	i ye san joli ye
how was your day	kow bɛ cogo di
how was your night	hɛrɛ sira wa
hubby	cɛ fɔlɔ
hub	sentiri
hug	dasun
huge	belebeleba
human	hadamaden
humble	maajigilen
humidity	sumaya
humid	nɛma
hundred	kɛmɛ
hungry	kɔngɔ
hunt	ka gɛ́n
hurricane	fólônkóto
hurry	teliya
hurry up	teliya
hurt	ka jogin
husband	furucɛ
hustle	mɛ̀sɛkɛmɛsɛkɛ
hut	bon
hygiene	saniya
I am fine	ne ka kɛnɛ
I am	n ye
I can	ne bɛ se
I can't	ne tɛ se
ice cream	kɛrɛmu galase
ice	galasi
idea	hakilina
ideal	ɲɛnaman
identical	kelen ye
identify	ka yira
identity	boyoro
idiot	naloma
idle	salen
I do	ne bɛ
I do not know	ne tɛ a dɔn
I do not understand	ne m'a faamuya
I don't know	ne t'a dɔn
I don’t know	ne tɛ a dɔn
I don't	ne tɛ
I don’t understand	ne m'a faamuya
I don't understand	N m'a faamu
I don't understand what you mean	Ne tɛ i kuman nin faamu
I don't understand you	ne m'a i faamuya
if	ni
ignore	ka na a dɔn
i guess	ne hakilila
I had	Ne tun ye...sɔrɔ
I have been	Ne tun ye
I have	ne bɛ
I hope so	Ne lannin b'a la
I know	n b'a dɔn
I like	ne bɛ a fɛ
I like you	i ko ka di ne ye
ill	bana
illegal	a ma daga
illness	bana
Ilocano	Ilokano
I love my big brother	ne bɛ n kɔrɔkɛ fɛ
I love my big sister	ne bɛ n kɔrɔmuso fɛ
I love my father	ne bɛ n fa fɛ
I love my little brother	ne bɛ n dɔgɔkɛ fɛ
I love my little sister	ne bɛ n dɔgɔmuso fɛ
I love my mother	ne bɛ n ba fɛ
I love	ne bɛ i fɛ
I love you	n b'i fɛ
I love you so much	n b'i fɛ kojugu
I love you too	ne fana bɛ i fɛ
image	ja
imagine	ka miri
I mean	ne ko
I'm fine	n ka kɛnɛ
I'm good	ne ka kɛnɛ
I'm here	Ne bɛ yan
I miss you	i ɲɛnafin bɛ n na
I miss you so much	i ɲɛnafinba de bɛ ne na
immediately	o yɔrɔnin bɛɛ
immediate	sisan sisan
immense	belebeleba
I’m	ne ye
I'm	n ye
impact	barikaya
impatient	basigibali
implement	ka lawaleya
important	nafama
import	ka ladon
impose	ka jagoya
impossible	abada
impression	yecogo
impressive	kabakoma
impress	ka lasonni kɛ
improve	ka fisaya
improvement	fisayali
I'm sorry	i fo
in addition	ani fana
inappropriate	ladamubali
incentive	kɔnɔnasuli
incident	kasara
include	ka fara kan
including	i n'a fɔ
income	sɔrɔ
inconvenience	kɔlɔlɔ
increased	layɛlɛlen
increase	ka caya
incredible	kabako
indeed	Kɔni
independent	yɛrɛmahɔrɔnya
India	Ɛndujamana
indicate	ka jira
indigenous	dugulen
individual	kelenaya
industry	ɛndisiri
I	Ne
inevitable	min tɛ se ka bali
In fact	o la sa
infant	den
infection	banayɛlɛma
infinity	ɛnfiniti
inflammation	jeninin
inflation	funun
influence	kɔnɔnasuruku
information	kunnafoni
inform	ka kunnafoniya
in front of	ɲɛfɛ
ingredients	nafɛnw
inheritance	ciyɛn
initial	daminɛ
initiative	hakilinan
injured	banalen
injury	joginli
in	kɔnɔ
innocent	jalakibali
innovation	inowasiyɔn
in order to	walasa ka
inquiry	ɲininkali
insane	hakilitan
insect	fɛnɲɛnama
insecure	lakanabali
insert	ka don
inside	kɔnɔ
insight	hakilina
insist	sinsin
insomnia	sùnɔgɔbaliya
inspiration	fangadilan
inspire	ka sama
install	ka sigi
instance	sanfɛ
instant	wagati
instead	no na
instead of	sani
instructions	cikanw
instrument	minɛn
insult	neni
insurance	asuransi
intact	a cogola
integrity	tilennenya
intellectual	mɔgɔ kalannen
intelligence	kegunya
intelligent	hakiliduman
intended	dabɔlen
intend	ka ŋaniya
intense	ka bon
intention	ŋaniya
interaction	kùnmafalen
interact	ka dalafalen kɛ
interested	nafaman
interesting	di
interest	nafa
interfere	ka sendon
intermediate	furancɛmɔgɔ
internal	kɔnɔna na
international	diɲɛfanbɛ
internship	baaradegin
interpreter	dalaminɛ
interpret	ka dalaminɛli kɛ
interrupt	ka bali
interview	kúmaɲɔgɔnya
intimate	bùlonkɔnɔsi
into	kɔnɔna
introduce	ka jira
introduction	daminɛ kuma
introvert	kɔnɔnamɔgɔ
intuition	sɔ̀mi
invalid	dagabali
invent	ka dilan
inventory	jatebɔ
investigate	ka fɛsɛfɛsɛ
invest	ka wari bɔ
invitation	weleli
invite	ka wele
invoice	fakitiri
involved	min sen bɛ a la
involve	ka sèndòn
iron	nɛgɛ
I see	ne ye a famu
island	gun
isolated	dogolen
issue	gɛlɛya
issues	gɛlɛyaw
is	ye
it	a
item	minɛn
items	minɛns
I think	ne hakilila
it is	o don
its	a
it's	a ye
it's ok	a ka ɲi
It's okay	a ka ɲi
it was	a tun ye
I understand	n y'a faamu
I want	ne bɛ a fɛ ka
I want to see you	ne b'a fɛ ka i ye
I want you	ne mago bɛ i la
I was	n tun
I will	ne bɛ na...
I would be	Ne tun ka kan ka kɛ
jacket	wɛsiti
jail	kaso
January	zanwuyekalo
jar	jifiɲɛn
jaw	dakala
jealous	kele
jerk	naloma
jewelry	masiri
job	baara
jogging	tagama
join	sɛgɛrɛ
joint	tuguda
joke	tulonkɛkuma
journalist	kunnafonidila
journey	taama
joy	nisɔndiya
judge	kiiritigɛla
juice	zi
july	zuluyekalo
jump	ka pan
june	zuwɛnkalo
junk	nɛgɛkolon
just	a bena
just do it	a kɛ dɔrɔn
justice	tílennenya
justify	ka lájɛya
Kalaallisut	Kalaallisut
keen	dusudiya
keep it up	taga a fɛ
keep	k'a mara
kept	maralen
kettle	tasale
key	kile
kick	ka tan
kid	baden
kidding	tulonkɛkuma
kidney	kɔ́mɔkìli
kids	denmisɛnw
kill	ka faga
kinda	cogodɔ la
kindly	yumanya
kindness	ɲumanya
kind	sugu
king	masakɛ
kiss	ka bizu kɛ
kitchen	kabugu
kite	sɛriwolan
kitten	jakumaden
knee	kunbere
knew	dɔnnen
knife	muru
knight	sobolila
know	ka dɔn
knowledge	dɔnniya
known	lakodonnen
Konkani	Konkani
Krio	Kriyo
label	tàamasiyɛn
labor	baarakɛbolo
labour	baara
lack	dɛsɛ
ladder	yɛlɛnyɛlɛnnan
lady	muso
laid	dalen
lake	dala
lamb	sagasogo
lame	lamu
lamp	lanpan
land	duguma
landscape	dugufɛrɛ
language	kan
lap	ka nɛmu
large	belebeleba
last but not least	sani laban cɛ
last	laban
last name	jamu
late	lɛrɛ kɔfɛ
lately	kɔsala ni na
later	kɔfɛ
latest	laban
latter	laban
laughing	yɛlɛli
laugh	ka yɛlɛ
laughter	yɛlɛkan
launch	daminɛ
laundry	finiko
lawn	gazɔn
law	sariya
lawyer	awoka
layer	lazɛri
lay	ka da
layout	labɛn cogo
lazy	salabaatɔ
leader	ɲɛmɔgɔ
lead	ka ɲɛminɛ
leaf	bulu
leak	cida
lean	ka jɛngɛn
leap	ka pan
learning	kalan
learn	ka kalan
lease	luwanse
least	laban
leather	wòlo
leave	ka taa
leaves	furabuluw
led	ka ɲɛminɛ
left	numan
legacy	tiɲɛ
legal	dagalen
legend	lezandi
legit	dagalen
leg	sen
leisure	ɲɛnajɛ
lend	ka singa
length	janya
less	dcnni
lesson	kalansen
let	ka to
letter	bataki
lettuce	salati
level	hakɛya
leverage	ka labila
liability	bólokanbila
library	gafekalanyɔrɔ
lick	ka nɛmu
lie	nkalon
lies	nkalonw
life	ɲɛnamaya
lift	ka lawili
lightning	yeelenmɛnɛ
light	yeelen
like	i n'a fɔ
likely	i n'a fɔ
likewise	o kelen
line	ci
Lingala	Lingala
link	ka tugu
lion	wara
liquid	jimafɛn
listening	lamɛnni
listen	ka lamɛn
list	lisi
literally	a kɔrɔ yɛrɛ
literature	gafesɛ bɛnnenw ani kumakan maralenw
litter	ɲaman
little	misɛn
live	ka balo
liver	biɲɛ
lives	balow
living	baloli
living room	salɔn
lizard	basa
load	doni
loaf	nbuurukun
loan	juru
local	dugulen
location	sigiyɔrɔ
lockdown	yɛrɛmabɔ
lock	ka sɔgɔ
log	jirikuru
lol	yɛlɛko
lonely	kelenna
long	jan
long time no see	a kɛla fama ye
look	ka filɛ
loop	bukulu
loose	bɔnɛ
lord	matigi
lose	ka tunun
loss	bɔnɛ
lost	tununi
lot	caman
loud	kɔsɛbɛ
lounge	tanuli
love	kanu
lovely	kanuya
love you	ne bɛ i fɛ
lower	ka lajigin
low	fɛ́gɛn
loyal	kantigi
loyalty	hɔ́rɔnya
luck	kunna
lucky	kunnaja
Luganda	Luganda
luggage	minɛn
lump	junkun
lunch	tilelafana
lungs	fogonfogon
luxury	fɛn cɛ ɲumanw
lying	kalontigɛ
machine	mansin
madam	madamu
made	dilan
mad	fatɔ
magazine	gafe
magnificent	cɛɲɛ
maid	baarakɛden
main	kunbaba
maintain	ka laminɛ
maintenance	labɛn
Maithili	Maytili
major	fanba
majority	faanba
make	keli
make up	makiyazi
male	cɛ
mall	kɛsu
manage	mara
management	mara kɛ cogo
manager	marabaga
man	cɛ
mandatory	waajibi
manifest	ka nisɔn jira kɛ
manipulate	ka kulonkɛ
manner	cogo
manual	min bɛ fɛn bolo la
many	caman
many many happy returns of the day	ka tile hɛrɛ caya
march	marisikalo
margin	danfara
market	sugu
marriage	furu
married	furulen
mask	masiki
massive	caman
mass	kulu
master	makɛ
match	takala
material	minɛ
mate	tɔɲɔgɔn
math	matematiki
matter	ko
maturity	baliguya
may	a bɛ se
maybe	a bɛ se ka kɛ
meal	dumuni
meaning	kɔrɔ
mean	kɔrɔ
means	fɛɛrɛw
meant	kɔrɔ ye
meanwhile	san ni
measure	ka suma
measures	fɛɛrɛw
meat	sogo
medical	furakɛli
medicine	fura
meditation	jatiminɛ
medium	hakɛ
meeting	ɲɔgɔnye
meet	ɲɔgɔn dalajɛ
Meiteilon	Meyteylon
melt	ka yeele
memories	hakili
memory	hakili
me	ne
mental	hakili
mentioned	tɔgɔ fɔlen
mention	ka ko fɔ
mentor	degebaga
merchant	feerekɛla
mercy	makari
merely	dama
merry christmas	sambɛ̀ sambɛ̀
message	bataki
mess	ka ɲagami
messy	ɲagamilen
metal	nɛgɛ
method	kɛcogo
me too	ne fana
mice	ɲinɛw
middle	cɛmancɛ
midnight	dugutila
might	a tun bɛ se
mild	bɛnɛ
milestone	fan nafaman
military	sɔrɔdasi
milk	nɔnɔ
million	miliyɔn
mind	olu
mindset	hakilina
mine	ne taa
mingle	ka ni don
minor	dɔgɔmani
minute	miniti
minutes	ɲɔgɔnyesɛbɛn
miracle	kabako
mirror	dugalen
miscellaneous	sugu caman
mischievous	kegunman
miserable	mìsikinɛ
misery	faantanya
missing	tununen
mission	ci
miss	ka jɛ̀
miss you	i ɲɛnafin bɛ ne na
mistake	hàkɛ
mist	bugun
Mizo	Mizo
mobile	telefɔni
mock	ka ɲagaribɔ
model	mɔdɛli
moderate	ka bɛrɛbɛn
modern	kura
modest	mɔgɔsɛbɛ
moist	ɲigin
moisture	bugun
mold	wugu
mole	muli
mom	ba
moment	wagati
monday	tɛnɛ
money	wari
monitor	degebaga
monkey	warabilen
month	kalo
mood	nisɔn
moody	nisɔnduma
moon	kalo
moral	hakili
more	caman
moreover	ani fana
morning	sɔgɔma
mortgage	sow
most	fanba
mostly	siyɛn caman na
mother	bamuso
motion	mosiyɔn
motivation	kun
mountain	kuluba
mouse	ɲinɛ
mouth	da
movement	yɛlɛmayɛlɛma
move	yɛlɛma
movie	filimu
mrs	madamu
much	caman
mud	bɔgɔ
mug	min filen
muscle	bu
museum	mize
mushroom	fiyenan
music	fɔli
must	kan
mute	bobo
mutual	fan fila ko
My dear	ne balima
my friend	ne teri
My hovercraft is full of eels	N ka ayerogilisɛri dugumana faalen bɛ sajɛgɛw la
my love	n jarabi
my	n
my name is	ne tɔgɔ ye
my pleasure	ne de wasala
myself	ne yɛrɛ
mysterious	gundo
mystery	gundo
myth	bisigiyako
nail	pɔnti
naive	duga
name	tɔ̀gɔ
narrative	lankaleli
narrow	dɔgɔman
nasty	juguma
nationality	jàmanadenya
national	jamaden
native	dugulen
natural	yɛrɛyɛrɛ
nature	kɛcogo
nausea	fɔɔnɔnege
nearby	kɛrɛ fɛ
near	kɛrɛ fɛ
nearly	sɔɔni dɔrɔn
neat	sanuyalen
necessary	kan
neck	kan
necklace	kannakɔnɔ
need	mago
negative	juguma
neglect	lèle
negotiate	ka tɛrɛmɛ
neighborhood	sigida
neighbor	sigiɲɔgɔn
neither	o fana tɛ
nephew	bɛnden
nerd	kegun
nervous	dimilen
nest	ɲaa
net	dafalen
network	erezo
neutral	kelenna
never	abada
never give up	ka na ban abada
never mind	kana i janto a la
nevermind	kana i janto nin na
nevertheless	o bɛɛ n'a ta
new	kura
news	kunnafoniw
next	nata
next to	a kɛrɛfɛ
nice	saraman
nice to meet you	i dɔnnin diyaran ye
niece	bɛndenmuso
nightmare	sugo jugu
night	su
nine	kɔnɔntɔn
nineteen	tan ni kɔnɔntɔn
ninety	bikɔnɔntɔn
No	Ayi
nobody	mɔgɔ si
noise	mankan
noisy	mankaman
none	foɲisi
noon	midi
nope	ayi
no problem	basi tɛ
normal	o ka kan
north	saheli
nor	.... wa
nose	nun
nostalgic	ɲɛnafin
not at all	fiyewu
not	ayi
not bad	a kaɲi
noted	a famuna
note	nɔti
nothing	foyi
noticed	kunnafoninen
notice	ka jateminɛ
Not now	Sisan tɛ
not yet	ma se fɔlɔ
nouns	tɔgɔw
noun	tɔgɔ
novel	kura
november	nowanburukalo
nowadays	bidonya
no way	abada
now	sisan
nuisance	tɔɔrɔli
null	fu
number	nimɔrɔ
numb	mùlukubagatɔ
nurse	furakɛla
nut	ekuru
nutmeg	misikadi kolo
nutrition	baloli
oath	kalilikan
obesity	bonyakojugu
obey	ka labato
objective	kuntilenna
object	minɛn
obligation	jagoya
obscure	dibilen
observation	jateminɛt
observe	ka jateminɛ
obsessed	ɲamajɔbaliya
obsession	fa
obsolete	datibanen
obstacle	kunbalan
obtained	sɔrɔla
obtain	ka sɔrɔ
obvious	jɛlen
obviously	tiɲɛ yɛrɛ la
occasionally	kuma ni kuma
occupation	baara
occupied	okipe
occur	ka kɛ
occurred	kɛla
occurs	kɛ
ocean	kɔgɔjiba
october	ɔkutɔburukalo
odd	dakɛnyɛbali
odds	garisigɛ
of course	Kɔsɛbɛ
offensive	bagama
offer	ka ni
office	biro
official	faama
off	k'a bɔ a la
of	ka
often	waati dɔ
Oh	Eeh
oh really	oh sɛbɛ la
oil	tulu
okay baby	ayiwa bb
okay	basi tɛ
okay dear	awɔ
okay honey	awɔ n jarabi
okay my love	Awɔ n jarabi
ok dear	ayiwa ne balima
ok honey	ayiwa ne jarabi
ok my love	awɔ ne jarabi
ok	n sɔnna
old	kɔrɔ
once	siɲɛ kelen
one	kelen
one language is never enough	kan kelen pe dɔrɔn tɛ labɔli kɛ fiyewu
onion	jaba
on	kan
online	bɔlɔlɔ san fɛ
only	dɔrɔn
open	ka dayɛlɛ
operation	opereli
opinion	hakilinan
opportunities	sɔrɔdaw
opportunity	kunnandiya
opposite	dɔwɛrɛ
optimistic	jigima
optional	wajibi tɛ
option	cogo
orange	lenburuba
order	ci
ordinary	gansan
organization	ɲɛnabɔli
orientation	ɲɛyirali
original	yɛrɛyɛrɛ
origin	bɔyɔrɔ
Oromo	Oromo
orphan	falatɔ
or	walima
other	dɔ wɛrɛ
otherwise	n'o tɛ
ought	kan ka
our	an
Our mission: to enable everyone, everywhere to understand the world and express themselves across languages.	An ka baara : ka bɛɛ dɛmɛ fanbɛ walasa bɛɛ ka se ka diɲɛ famuya ani fana bɛɛ ka se ka i hakilina fɔ kanw bɛɛ la.
Our mission: to organize the world's information and make it universally accessible and useful.	An ka baara : ka diɲɛ kunnafoni labɛn ani ka a lasɔrɔli nɔgɔya bɛɛ ma.
outcome	jaabi
outfit	teni
outgoing	bɔ ta
out	kɛnɛma
outlet	bɔda
outline	ka fɛsɛ-fɛsɛ
outside	kɛnɛma
outstanding	kabakoma
oven	pɔli
over	a kan
overall	bakuruba
overcome	ka latɛmɛ
over there	yan
overthinking	miiriya ba
overwhelmed	faalen
overwhelming	ɲagamilen
owe	juru
owl	gingin
own	bɛ ... fɛ
owner	tigi
ox	misi
pace	táamasen
package	pake
pack	ka faraɲɔgɔn kan
paid	sara
pain	dimi
painting	pɛntirili
paint	pɛntiri
pair	fila
pale	jɛ́
palm	tɛgɛ
pandemic	bana
panic	siraɲɛ
pan	pɔli
pants	pantalɔn
paper	papiye
paradise	alijɛnɛ
parallel	kuntilenna kelen
parcel	du tɛrɛn
pardon	yafa
parents	mansaw
park	pariki
parrot	solo
parsley	pɛrisili
part	fan
participate	ka sendon
particular	kɛrɛnkɛrɛnlen
particularly	kɛrɛnkɛrɛnlenyala
partner	jɛɲɔgɔn
party	ɲɛnajɛ
passage	tɛmɛsira
passed	tɛmɛnen
passionate	fɛ
passion	jarabi
passive	tɛmɛta
pass	ka tɛmɛ
password	kɔdi
past	tɛmɛnen
patch	ka bari
pathetic	ɲɛ́manɔgɔ
path	sira
patience	muɲuli
patient	sabalilen
pattern	ɲɔgɔn
pause	ka jɔ
pavement	pawe
payment	sarali
pay	sara
peaceful	hɛrɛ ni baaden
peace	hɛrɛ
peach	mɔnni
peak	kùncɛ
pear	puwari
peas	siyɔ
peculiar	kɛrɛnkɛrɛnlen
peel	fara
pee	powari
peers	tɔɲɔgɔnw
peer	toɲɔgɔn
pencil	kiriyɔn
pending	makɔnɔlila
pen	sɛbɛnnikɛlan
people	jama
pepper	foronto
perceive	ka sɔrɔ
perception	yecogo
perfect	dafalen
performance	se
perform	ka baara
perhaps	lala
period	kuntaala
permanent	kudayi
permission	yamaruya
permit	yamaruya
perseverance	taaɲɛ
persistent	mɛta
personality	hadamadenya
personal	mɔgɔkelenko
person	mɔgɔ
perspective	síratigɛ
persuade	ka lasɔnni kɛ
pervert	fatɔ
pet	sokɔbagan misɛni
phase	kumasen
phenomenon	fɛnw
philosophy	filo
phone	telefɔni
photo	foto
phrase	kumasen
physical	fanga
pick	ka ta
pick up	ka a tɔmɔ
picture	ja
piece	kunkurun
pieces	kunkurunw
pigeon	beretugan
pig	lɛ
pile	sara
pillow	kunkɔrɔdonnan
pilot	pankurunbolila
pin	biɲɛ
pineapple	jàbibi
pink	bilenman
pitch	kɛnɛjɛ
pit	kɔ̀lɔn
pity	hinɛ
place	sigiyɔrɔ
places	sigiyɔrɔw
plague	bana
plain	kɛnɛjɛ
plane	awiyɔn
plan	fɛɛrɛ
plants	yiriw
plant	yiri
plate	asiyɛti
platform	bɔlɔlɔ kan
playing	tulon kɛ
play	tulon kɛ
pleasant	diya
pleased	diya
please	sabari
pleasure	diya
pledge	delili
plenty	caman
plot	bɛnbɛli
plug	kurantayɔrɔ
plumber	pulɔnbiye
plum	mandi
plural	cayalan
podcast	kan talen
poem	poyi
poetry	poyi sɛbɛn
point	bìɲɛ
poison	baga
police	polisi
policy	fɛɛrɛ
polite	ladamunɛn
pollution	cɛnnin
pond	ji dingɛ
pool	pisini
poop	ka bo kɛ
poor	faantan
pop	ka ci
popular	lakodonnen
population	jama
pork	lɛsogo
porridge	mɔni
port	pɔri
position	jɔyɔrɔ
positive	sɔnsira
possess	bɛ ... Bolo
possession	bolofɛn
possessive	tigiyalan
possible	bɛ se ka kɛ
postpone	ka bila kɔfɛ la
post	pɔsiti
potato	kɔmitɛrɛ
potential	ɲɛnama
pound	ka susu
poverty	faantanya
power	fanga
powerful	barikama
practical	nɔ̀gɔman
practice	degeli
praise	batoli
prank	dalabɔli
pray	ka seli
precious	nafama
precise	ka sɛbɛntiya
precisely	kɛrɛnkɛrɛnlenyala
predict	ka sini dɔn
preference	fisaya
prefer	ka fisaya
pregnant	kɔnɔma
prejudice	dankari
premises	yɔrɔw
premium	kalite fɔlɔ
preparation	labɛnli
prepared	labɛnlnen
prepare	ka labɛn
preposition	bilaɲɛ
presence	sen jɔ
presentation	perezantasiyɔn
present	sisan
preserve	ka lasago
president	jamakuntigi
press	ka digi
pressure	gɛrɛntɛ
pretend	ka kɛ i na fɔ
pretty	cɛɲi
prevent	k'a bali
previous	tɛmɛnen
prey	sɔ́nnifɛn
price	sɔngɔ
pride	kuncɛbaya
priest	sarakalasebaga
primary	fɔlɔ
prime	pirimu
princess	masaden
principal	ɲɛmaa
priority	min bɛ kɛ fɔlɔ
prior	sa ni
prison	kaso
privacy	daamu
private	yɛrɛye
privilege	fɔ́lɔyali
prize	donbolo
probably	a bɛ se ka kɛ
problem	kunko
procedure	taabolo
proceed	ka tɛ̀mɛ a fɛ
process	ka tɛmɛ
produce	ka kɛ
production	sɛnɛ
product	ka kɛ
professional	baarakɛla
profession	baara
profile	porofili
profit	tɔnɔ
profound	dunya
progress	ɲɛfɛtaali
project	poroze
prominent	sɛ̀bɛlama
promise	ka lahidu ta
promote	ka layiriwa
promotion	jalayɛlɛ
prompt	balina
prone	dùsuba
pronouns	nɔnabila
pronunciation	fɔcogo
proof	séereya
proper	dafalen
properly	kaɲɛ
properties	bolo fɛnw
property	ta
proposal	poropozisiyɔn
prospect	hakilina
prosperity	ɲɛsuma
prosperous	sabatili
protect	ka lakana
proud	kuncɛbaa
prove	ka kíisa yira
provided	dilen
provide	k'a di
province	marali
provision	dumuni
puberty	denkɔrɔbaya
public	foroba
pull	ka sama
pumpkin	jě
punctual	wagati la
pupil	lakɔliden
purchase	ka san
pure	yɛrɛyɛrɛ
purple	koloji
purpose	kun
purse	bee
pursue	nɔgɛn
pursuit	nɔgɛn
push	ka ɲɔni
put	k'a don
qualification	donko
quality	kalite
quantity	hakɛ
quarantine	ka i madogo ka bɔ mɔgɔw la
quarrel	kɛlɛ
quarter	kin
Quechua	Kecuwa
queen	masamuso
queer	dabaliban
query	ɲininkali
question	ɲininkali
queue	kun
quickly	joona
quick	teliman
quiet	mumalen
quilt	dara
quite	Bɛrɛ t'a jɛ
quit	ka bɔ
quiz	dɔnnin sɛgɛsɛgɛli
quotation	sɔngɔ di
quote	ka sɔngɔ jateminɛ
quotes	sɔngɔn di
rabbit	sonsan
race	siya
rage	wulubana
rain	sanji
raised	lawili
raise	ka kɔrɔta
random	kunfɛ
range	labɛnko ɲuman
ran	ka boli
rapidly	joona-joona
rapid	teliman
rarely	a man ca
rare	manteli ka kɛ
rash	farikolo bana
rate	hakɛ
rather	fisa
ratio	kɛmɛsarada
rational	nafaman
rat	toto
raw	kɛnɛ
reached	a sera
reach	ka sɔrɔ
reaction	reyakisɔn
reading	gafekalan
read	ka kalan
ready	labɛn
reality	kow
realized	kɛlen
realize	ka kɛ
real	lakika
really	lakika
rear	kɔfɛla
reasonable	fisa
reason	kun
recall	ka segin ka wele
receipt	seereya sɛbɛn
received	sɔrɔ la
receive	ka sɔrɔ
recent	kɔsa in na
recently	kɔsa in na
reception	donda
recipe	eresɛti
reckless	ɲɛ́malobali
recognition	boɲamasegin
recognize	k'a lakodɔn
recommended	lakofɔlen
recommend	ka gɛ̀lɛya
record	ka kumakan ta
recover	ka kɛnɛya
recovery	kɛnɛyali
rectangle	selekenaani
red	bilema
redeem	ka kunmabɔ
redemption	sarali
reduce	ka dɔgɔya
redundant	tanikasegin
reference	tàyɔrɔ
refer	ka yira
reflection	hakilijakabɔ
reflect	taasi
refrain	yɛrɛ minɛ
refrigerator	firigo
refund	ka sara
refused	banna
refuse	ka ban
regard	bonya
regarding	ka ɲɛsin
regardless	ka bɔ a la
regards	folikanws
region	màra
register	tɔgɔwelekaye
regret	ka nimisa
regular	kumabɛ
regularly	kuman bɛ
reject	ka fili
re	ko kura
related	ka talikɛ
relate	ka sagan
relationship	jɛɲɔgɔnya
relative	limaanaw
relatives	balimaw
relax	sɛgɛnlafiɲɛbɔ
released	labilalen
release	ka bila
relevant	nafaman
reliable	lanayabaa
relief	dɛmɛ
relieved	kɛnɛya la
relieve	ka labila
religion	diinɛ
religious	diinɛ
reluctant	yíranyirannci
rely	ka jigi da
remaining	tɔ
remain	ka to
remarkable	kɔ̀lɔsilen
remedy	saraka
remember	ka hakilina jigi
reminder	hakilinajiginla
remind	hakili jigin
remote	samanen
remove	ka labɔ
render	ka i yɛrɛ di
rent	luwanse
repair	ka dilan
repeat	seginkan
replace	ka falen
reply	ka a jaabi
report	cisama
represent	ka nɔnabila kɛ
reputation	tɔgɔ
request	delili
required	laɲininnen
require	ka laɲini
rescue	ka dɛmɛ don
research	ɲinili
resemble	ka bɔ ... fɛ
resentment	koniya
reservation	lakofɔli
reserve	ka mara
resident	lasigiden
resign	ka baara bila
resilience	ko ku
resilient	fasaman
resistance	firifirili
resist	ka firifiri
resolution	ŋaniya
resolve	ka ɲɛnabɔ
resort	eresɔri
resources	sɔ̀rɔda
respect	bonya
respond	ka jaabi
response	jaabi
responsibility	bólokanbila
responsible	kuntigi
restaurant	dumunikɛyɔrɔ
rest in peace	ka diina i la
rest	ka lafiɲɛ
restore	ka lasegin
restrict	ka dansiri
result	jaabi
results	jaabiw
resume	ka daminɛ ko kura ye
retail	dɔgɔdɔgɔnifeere
retain	ka majɔ
retention	marali
retired	sɛngɛ lafiɲɛ
retreat	ka senbɔ
retrieve	Sigikamine
return	segin
revealed	jiralen
reveal	ka jira
revenge	ta sara
revenue	sɔrɔ
reverse	ka yɛlɛma
review	ka sɛgɛsɛgɛ
revise	ka sɛgɛsɛgɛ
revision	seginkanni
revolution	erewolisɔn
reward	sara
rhythm	fɔ́lisen
rib	galakakolo
rice	malo
rich	nafolotigi
ride	ka boli
ridiculous	ko lankolon
rid	ka fili
right	jo
right now	sisan
rigid	makama
ring	balolanɛgɛ
rinse	sananko
riot	balawu
ripe	mɔlen
rip	ka fara
rise	ka funun
risk	farati
rival	kɛlɛɲɔgɔn
river	ba
road	sira
roast	worotilen
robust	ka fɔri
rock	farakurun
rod	kala
role	jɔyɔrɔ
roll	ka kolonkolon
roof	bili
room	soden
root	dili
rope	juruden
rotten	tolila
rough	gɛlɛnman
roughly	ɲɔ̀gɔnna
round	kúlukutulen
route	sira
routine	don o don
row	mankan
rubber	manama
rubbish	ɲaman
rub	tereke
rude	malobali
rug	tapi
ruin	jaasi
ruler	tiiricilan
rule	sariya
rules	sariyaw
run	ka boli
running	boli
rural	burusi
rush	ka girin
sack	bɔrɛ
sacred	lasirannen
sacrifice	saraka
safe flight	pan ɲuman
safe	lakanalen
safety	lakana
sage	hakilitigi
said	fɔ
sailing	batoboli
sail	ka kurunboli
sake	kɔsɔn
salary	sara
sale	feere
salmon	somɔn jɛgɛ
salt	kɔgɔ
same	hali
Same here	o kelen do yan
sample	esantiyɔn
sand	cɛncɛn
Sanskrit	Sanskrit
sarcastic	yɛlɛko
sassy	nafantan
satisfaction	wasali
satisfied	wàsabagatɔ
satisfying	wasa
satisfy	wasa
sat	sigilen
Saturday	sibiri
sausage	na
savage	kungofɛn
save	ka mara
saw	a ye
say	ka fɔ
scale	sumanikɛlan
scam	namara
scarce	dɔ́gɔ
scared	lasiran
scarf	dankana
scar	jolifɔn
scary	lasiranfɛn
scattered	serilen
scene	kɛnɛ
scenery	ɲɔ́gɔlɔn
scent	wusulan
schedule	waati
school	kalanso
science	dɔnniya
scientists	dɔnniyabagaw
scientist	siyantifiki
scissors	sizo
scold	ka kɔrɔfɔ
scope	nafa
score	bi
scrap	ɲaman
scratch	ka siyɛn
scream	kulekan
screen	ekaran
screw	wisi
script	sɛbɛnni
sea	kɔgɔji
seal	tuguda
search	ɲini
season	wagati
seat	sigilan
second	filanan
secret	gundo
section	fan
secure	ka lakana
security	lakana
seed	si
see	ka ye
seek	ɲini
seem	i n'a fɔ
seems	i n'a fɔ
seen	a yela
see you	kan bɛn
see you later	kan bɛn kɔfɛ
see you soon	kan bɛn sɔɔni
see you tomorrow	k'an bɛn sini
seize	ka minɛ
seizure	minɛli
seldom	ɲinin ka
select	ka sugandi
self healing	yɛrɛ kɛnɛyali
selfish	ɲɛngo
self	yɛrɛ
sell	ka feere
send	ka ci
send me your picture	i foto ci ne ma
senior	kùntigi
sense	kɔrɔ
sensible	fɛgɛya
sensitive	ɲɛ́namisɛn
sent	a ci la
sentence	kumasen
sentences	kumasenw
separate	ka fara
Sepedi	Sepedi
september	sɛtanburukalo
sequence	dasigi
series	seriw
seriously	sɛbɛla
serious	sɛbɛ
serve	ka sɔn
service	cákɛda
session	sesiyɔn
set	ka kɛ
setting	paramɛtiri
settle	ka sigin
set up	ka bila sen kan
seventeen	tan ni wolonfila
seventy	biwolonfila
seven	wolonfila
several	damadɔ
severe	juguman
sew	ka kala
shade	ka dibi don
shadow	ja
shake	ka yigiyigi
shall	kan
shallow	ka kunu
shame	maloya
shape	ka labɛn
share	niyɔrɔ
sharp	daduman
she	bi
shed	ka bɔn
sheep	saga
sheet	dara
she has	a ye ... sɔrɔ
she is	a ye
shelf	mɛ̀mɛ
shell	ka wɔrɔ
shelter	siyɔrɔ
shield	nɛgɛbɛnnan
shift	ka yɛlɛma
shine	Ka manamana
ship	baton
shipping	cili bato fɛ
shirt	duloki
sh	jɛgɛ
shoes	samaraw
shoot	ka ci
shop	butigi
shopping	sanni
shore	jida
shortage	danya
short	surun
shot	tiri
shoulder	kamakun
should	ka kan
shout	ka kule
shower	ɲɛgɛn
show	k'a jira
show me	a jira ne ma
shrimp	kerevɛti
shrink	ka woyo
shut	ka datugu
shut up	ka i da tugu
shy	malo
sibling	balima
siblings	balimaw
sick	banabagatɔ
side	kɛrɛ
sight	ɲɛ
sightseeing	turizimu
sigh	yeli
signature	bolonɔ
significant	nafama
sign	taamasiyɛn
silence	kumabaliya
silent	dotugu
silk	fuu
silly	naloma
silver	warijɛ
similar	ɲɔgɔn
simple	nɔgɔman
simp	nɔgɔman
simultaneously	ɲɔ̀gɔnfɛ
since	Kabini
sincerely	sɛbɛsɛbɛla
sincere	sɛbɛ
singer	dɔnkilidala
sing	ka dɔnkili da
single	cɛganan
sink	lawabo
Sir	cɛ
sister	balimamuso
sister in law	nimɔgɔmuso
site	yɔrɔ
sit	ka sigi
situation	koɲɛw
sixteen	tan ni wɔɔrɔ
sixty	biwɔɔrɔ
six	wɔɔrɔ
size	kundama
skill	dɔnko
skills	dɔ́nko
skin	golo
skinny	fasalen
skip	ka lasogo
skirt	zipu
sky	sankolo
slave	jɔn
sleeping	sunɔgɔ
sleep	ka sunɔgɔ
sleepy	sunɔgɔ
sleeve	gulokiboloda
slice	ka tigɛ finitifitini
slide	ka cɛɛnɛ
slightly	dɔɔni
slim	misɛn
slip	cɛɛnɛ
slope	jigi-jigi
slot	ka don
slowly	dɔɔnin-dɔɔnin
slow	suma
small	fitinin
smart	kegun
smell	kasa
smile	ka yɛlɛ
smoke	sisi
smooth	nugu
snack	daladumini
snail	kerekete
snake	sa
snap	ka ja ta
snow	nɛzi
soak	ka ɲigin
soap	safunɛ
sober	sulen
soccer	ntolatan
social	sosiyali
society	sosiyete
socks	susɛti
so cute	cɛ ka ɲi ka kojugu
so far	sisan
soft	magan
software	lozisiyɛli
soil	dugukolo
sold	feere la
soldier	sɔrɔdasi
sold out	ka feere
sole	kelen
solid	jalen
solution	fɛɛrɛ
solve	ka ɲɛnabɔ
somebody	mɔgɔ
some	dɔw
somehow	cogodɔ la
someone	mɔgɔ
something	fɛn dɔ
sometimes	tuma dɔ
song	dɔnkili
so	o de kama
soon	sɔɔni
sophisticated	ɲɛnabɔlen
Sorani	Sorani
sore	joli
sore throat	kan dimi
sorrow	ɲɛnasisi
Sorry	Hakɛto
sort	ka woloma
sought	laɲinilen
soulmate	taamaɲɔgɔn
soul	ni
sound	kanɲɛ
soup	naji
source	bununda
sour	kumu
south	worodugu
space	yɔ́rɔ
spam	bataki siganaman
Spanish	Ɛsipaɲɔli
span	janya
spare	ka mara
speak	ka kuma
special	kɛrɛnkɛrɛnlen
species	násuguyaw
specific	kɛrɛnkɛrɛnlen
spectacular	ílɛlifɛn
speech	kumakan
speechless	bobo
speed	teliya
spell	kilisi
spend	ka wari bɔ
spent	kɛla
spicy	farin
spike	bìɲɛ
spinach	pinari
spin	ka munu
spirit	ni
spit	ka tu
splendid	a kaɲi kojugu
split	ka cɛci
spoiled	cɛnnen
spoil	tiɲɛ
spontaneous	sisan
spoon	kuyɛri
spot	sigiyɔrɔ
spouse	furumuso
spread	ka jɛnsɛn
spring	k'a ta marisikalo la ka taa bila mɛkalo
square	kɛrɛnaani
squeeze	ka madigi
squid	kalamu
squirrel	nkɛlen
stab	ka muru curu
stable	basigilen
stack	faraɲɔgɔnkan
staff	baarakɛlaw
stage	dakun
stain	nɔ
stairs	yɛlɛnyɛlɛnnan
stake	bɔlɔ
stalk	kala
stall	ka kale
stamp	tɛnburu
standard	sariya
stand	ka jɔ
star	dolo
started	daminɛna
start	ka daminɛ
starving	kɔngɔ
state	faso
statement	dantigɛli
station	sitasiyɔn
statue	jirimɔgɔnin
status	sigisariyaw
stay	ka to
stay safe	ka i lakana
steady	basigilen
steak	sogo
steal	ka sonya
steam	sisi
steel	nɛgɛ
steep	teliman
stem	kala
step	etapu
stick	bere
stiff	fɛgɛma
still	hali bi
sting	ka kin
stingy	tɛgɛmagɛlɛ
stir	ka lamaga
stock	ka mara
stolen	sonyalen
stomach	kɔnɔbara
stone	gabakurun
stood	jɔ̀len
stool	kurun
stop	ka dabila
storage	marayɔrɔ
store	butigi
storm	funufunu
story	tariki
stove	furuno
straightforward	tilennen
straight	tilennen
strain	gungurun
strange	dunan
stranger	dunan
strategy	fɛɛrɛ
strawberry	firɛzi
straw	karata
streak	seri
stream	kɔ
street	bɔlɔn
strength	barika
stress	hamina
stretch	ka sama
strict	kilennen
strike	báarabila
string	gaari
strip	ka wɔrɔ
strive	ka sabati
stroke	kuru bɔ
strong	fɔrɔlen
struck	gosilen
structure	kɛcogo
struggle	kɛlɛ
struggling	kɛlɛ
stubborn	tulomagɛlɛn
stuck	nɔrɔlen
student	kalanden
studying	kalan
study	kalan
stuff	fɛn
stunning	dabaliban
stupid	naloma
st	waliju
style	mɔdɛli
subject	walekɛlan
submission	majigi
submit	ka kolo
substance	kɔnɔnafɛn
substitute	ka falen
subtle	ko lankolon
succeed	sabati
successful	sanga sɔrɔ
success	sanga
such as	i n'a fɔ
such	ni
suck	ka min
sudden	ka bali
suddenly	yɔrɔni kelen
suffering	dimi
suffer	ka tɔɔrɔ
sufficient	ɲɛnama
sugar	sukaro
suggest	hakilina yira
suggestion	poropozisiyɔn
suitable	min bɛ bɛn
suitcase	walisi
suit	ka minɛ
sum	hakɛ
summary	farankan
summer	k'a ta zuwɛnkalo ka taa sɛtanburukalo la
summit	kuncɛ
sunday	kari
sunny	tilebilen
sunset	tilebin
sunshine	tileɲɛ
sun	tile
super	a kaɲi
superior	a sanfɛ
supervisor	ɲɛmɔgɔ
supper	ka dumini kɛ
supply	ka di a ma
support	sɛmɛjiri
supposed	i n'a fɔ
suppose	ka bisigi
sure	jaati
surface	kɛnɛ
surge	ka yɛlɛ
surgery	operelikɛyɔrɔ
surname	jamu
surprise	bala
surprised	balinan
surrender	yɛrɛdi
surrounding	lamini
surveillance	lakɔlɔsi
survey	ɲininili
survive	ka balo
suspect	siganamɔgɔ
suspended	kɔnlen
suspicious	siganama
sustainability	mɛli
sustainable	mɛta
sustain	ka mɛn
swag	kado
swallow	ka kunu
swap	ka falen
swear	ka kalen
sweater	jugujugu
sweat	wɔsi
sweep	ka fura
sweet	bɔnbɔn
sweet dreams	sugo ɲumanw
sweetheart	dusukunni
sweet tooth	myɛ̀tɔya
swelling	funuli
swell	ka funun
swimming	nɔnni
swim	nɔn
swing	búmusò
switch	ka mɛnɛ
swollen	kununen
sword	npan
symbol	sɛnboli
sympathy	mɔgɔya
symptoms	bana taamasiyɛnw
system	sisitɛmu
table	tabali
tackle	ka ɲɛnabɔ
tag	ka nɔrɔ
tail	kukala
take away	a ta ka boyi
take care	i janto i yɛrɛ la
take	ka ta
taken	a talen
take off	ka bɔ
talkative	kumakɛlaba
talk	ka kuma
tall	jamajan
tape	worobinɛ
tap	worobinɛ
target	kun
task	baara
taste	ka nɛnɛ
tasty	timi
taught	kalan
teacher	karamɔgɔ
teach	ka kalan
team	ekipu
tear	ɲɛji
tears	ɲɛji
tease	ka dálabɔ
tea	te
technology	tɛkinolozi
teeth	ɲinw
tell	ka lakali
tell me	a fɔ ne ye
temperature	goniyahakɛ
temper	dimi
temple	Alabatosoba
temporary	waatininko
tenant	luwanse
tendency	cogo
tender	timi
tend	ka sama
tense	waati
tension	tansiyɔn
ten	tan
tentative	ka eseye
tent	finiso
ten thousand	ba tan
term	dan
terms	bɛnkanw
terrible	jugu
terrific	sariyanfɛn
territory	jamana
test	kɔrɔbɔli
text	masalabolo
thank	i ni ce
thanks	barika
Thanks for using our app	Aw ni ce aw ye taalikɛ ni anw ka aplikasɔn nin ye
thank you	a' ni cɛ
Thank you for your patience while we investigate shipment	i ni ce i ka makɔnɔli la, an bɛ ka sama ci
thank you so much	i ni ce kɔsɛbɛ
thank you very much	i ni ce kɔsɛbɛ
than	ni...
that is	nin don
that	o
that's good	o ka ɲi
the	e
theft	sonyali
their	u
theme	dakun
themselves	u yɛrɛ
them	u
then	o de kosɔn
theory	kɛ cogo
there are	bɛ ye
therefore	ola
there is	a bɛ yen
there	yen
these	ninnu
they are	u ye
they	olu
thick	fasaman
thief	nson
thigh	woro
thin	fasa
thing	fɛn
things	fɛnw
think	ka miiri
third	sabanan
thirsty	minɔgɔ
thirteen	tan ni saba
thirty	minnɔgɔ
this is	nin ye
this	nin
thorough	fɛsɛfɛsɛ
thoroughly	kɔsɛbɛ
those	minnu
though	nka
thoughtful	miiriya
thought	miiriya
thoughts	miirili
thousand	ba kelen
thread	gaari
threaten	ka lasiran
threat	lasiranli
three	saba
threshold	dantigɛ
thrilled	lasiralen
thrive	ka sabati
throat	gɔnɔ
through	fɛ
throughout	cɛ
throw	ka fili
thumb	bolokɔni kunba
thunder	sanpɛrɛnkan
Thursday	alamisa
thus	o de kosɔn
tick	ka yigi-yigi
tide	jikuru
tidy	ladonen
tie	ka siri
tiger	wara
tight	ncɔyin
Tigrinya	Tigrinya
time	waati
timid	maloya
tiny	dɔgɔmani
tip	laadilikan
tips	laadilikanw
tired	sɛgɛnnen
tire	sɛgɛn
tissue	fìnimugu
title	titiri
toast	ka tɔsi kɛ
to be	ka kɛ
today	bi
toddler	bilakoroniw
toes	senkɔni
to	fɛ
together	ɲɔgɔn fɛ
toilet	ɲɛgɛn
told	fɔla
tolerance	yafa
tolerate	ka yafa
tomato	tamati
tomorrow	sini
tongue	nɛ
tonight	su ni na
too	fana
took	a y'a ta
tool	minɛn
tools	minɛnw
tooth	ɲin
topic	dakun
top	san fɛ
torn	tunɔminen
torture	ka tɔɔrɔ
total	kasabi
touch	ka maga
tough	gɛlɛ
tour	turi
towards	kasin
toward	ye
towel	jɔsilan
town	duguba
toxic	baga
trace	ka nɔ bɔ
track	nɔ
trade	feere
traditional	laadalako
tradition	laada
traffic	sirikilasiyɔn
trail	kiri
training	degeli
train	tɛrɛn
traits	taamasiyɛn
trait	taamasiyɛn
transfer	ka ci
transition	furancɛfanga
translate	ka bayɛlɛma
transparent	jɛlen
transportation	táransipɔrɔ
transport	pase
trap	foolo
trash	ɲaman
trauma	jawili
travel	ka taama
tray	tiriwari
treasure	nafolo
treat	ka furakɛ
treatment	furakɛli
tree	yiri
tremendous	dákabana
trend	taabolo
trial	kiri
trick	ka lafili
tried	sɛgɛnlen
trigger	ka ci
trim	ka gana
trip	ka talon
trouble	kɔnɔnafilila
trousers	pantalɔn
truck	kamiyɔn
true	sɛbɛ
trunk	kɛsu
trust	dannaya
truth	tìɲɛ
try	ka kɔrɔbɔ
Tsonga	Tsonga
tube	tiyo
Tuesday	tarata
tuition	ladonli
turkey	kulokulo
turmeric	káliyakuru
turn	ka yɛlɛma
turtle	koorokaara
tutor	ladonbaga
twelve	tannifila
twenty	mugan
twenty-one	mugan ni kelen
twice	siɲɛ fila
twist	ka tunɔmi
Twi	Tuwi
two	fila
type	ka sɛbɛen masin na
typical	gansan
ugly	cɛjugu
ultimate	kɔ́dan
umbrella	sanjibɛnnan
unable	se tan
uncle	bɛnkɛ
unconscious	míiribali
under	jukɔrɔ
underneath	jukɔrɔ
underrated	sɔngojugu
understand	ka famuya
understood	famuyala
unfortunately	kunagoya
uniform	teni
unique	kelenpe
unit	inite
university	kalansoba
unknown	lakodonbali
unless	fɔ
until	fɔ
unusual	kɛrɛnkɛrɛnlen
update	ka lakuraya
upgrade	ka fisaya
upon	tigitigiya
up	sanfɛ
upset	diminen
up to you	n'i ko cogo min
urban	duguba
urge	ka laɲini
urgent	makogɛlen
us	an
used	kɔrɔlen
useful	nàfaman
use	k'a nafa bɔ a la
useless	kolon
usual	kɔrɔlen
usually	ka caaya
utility	nafa
vacation	kɔnze
vaccination	boloci
vaccine	fura
vacuum	lankolon
vague	kɔnɔdun
valid	a kaɲin
valley	kùlufurancɛ
valuable	nafaman
value	nafama
variety	suguya
various	wɛrɛ
vary	ka yɛlɛ ka jigi
vase	tinto
vast	ka bon
vegetable	nafɛn kɛnɛ
vegetables	yiridenw
vehicle	bolimafɛn
vendor	feerekɛla
venom	baga
venture	ka taga awantiri la
venue	yɔrɔ
verify	sɛgɛsɛgɛ
versatile	nafacaman
version	wɛrisiyɔn
vertical	jɔ̀len
very good	a kaɲi kɔsɛbɛ
very	kɔsɛbɛ
vessel	bato
via	fɛ
vibe	kunpan
vibes	yigiyigi
vicious	juguya
victim	kàsaaratɔ
video	wideyo
view	yeli
village	dugu
villain	cɛjugu
vinegar	winɛgiri
vintage	kɛnɛ
violence	tɔɲɔnli
violent	nijugu
viral	diɲɛ lamini
virgin	npogotigi
virtual	bɔlɔlɔ kan
virtue	kalite
vision	jiralifɛn
visit	ka taa bɔ
visual	ye ko
vital	ɲɛnama
vivid	yelenman
vocabulary	wokabilɛri
voice	kan
void	lankolon
volume	mankan
volunteer	wɔlɔntɛri
vomit	ka fɔnɔ
vulnerable	barikatan
wage	sara
wages	sara
waist	cɛkisɛ
waiter	ɲinikɛla
waiting	makɔnɔli
wait	ka kɔnɔ
wake	ka wuli
wake up	ka kunun
walking	tagama
walk	ka taama
wallet	bee
wall	kogo
wander	yaalayaala
wanna	bɛna
want	bɛ ... fɛ
wanted	laɲinilen
wardrobe	alimɔri
warehouse	màgasan
war	kɛlɛ
warm	wɔlɔkɔ
warning	lasɔmi
warn	ka lasɔmi
warrior	kɛlɛkɛcɛfarin
wash	ka ko
waste	ka tiɲɛ
was	tun
watch	mɔnturu
water	ji
watermelon	nsɛrɛ
wave	jikuru
way	cogo
weak	fɛgɛnman
weakness	fɛgɛnya
wealth	nafolo
wealthy	nafolotigiya
we	ani
we are	anw ye
wearing	donfini
wear	ka don
weather	waati
we can	an bɛ se
wedding	furusiri
Wednesday	araba
weed	bin
week	dɔgɔkun
weekend	dɔgɔkunlaban
weight	girinya
weird	balinanko
welcome	i danse
welfare	kɛnɛya
well done	a ɲɛna
Well	Kɔsɛbɛ
went	taara
were	a tun be
west	tilebin
wet	ɲigin
whale	balɛni
what about you	i yɛrɛ dun
what are you doing	i be ka mun kɛ
what are you doing now	i be ka mun kɛ sisan
what are you doing right now	i bɛ ka mun de kɛ sisan sisan
what do you do	e bɛ mun baara kɛ
what do you do for a living	e bɛ baara jumɛ de kɛ
what do you mean	i b'a fɛ ka mun de fɔ
what do you want	e bɛ mun fɛ
whatever	fɛn o fɛn
what happened	mun kɛra
what is	mun do
what is this	nin ye mun ye
what is your job	i bɛ mun baara kɛ
what is your name	i tɔgɔ ye di
what	mun
what's up	mun bɛ ye
what's your name	i tɔgɔ bɛ di
wheat	alikama
wheel	sen
whenever	kuma o kuma
when	waati
where are you from	i be bɔ dugu jumen na
where are you	i bɛ min
where are you now	i bɛ min sisan
whereas	ka sɔrɔ
where do you live	e sigi bɛ min
where is	a bɛ min
where	min
whether	ni
which	jumɛn
while	ka .... to....
whisper	ŋùnuŋunu
whistle	filenin
white	jɛman
who are you	e ye jɔn ye
who is	jɔn ye
who is this	nin ye jɔn ye
who	jon
whole	mumɛ
whom	min
whose	jɔn ta
why	munna
why not	munna ayi
wicked	mɔgɔjugu
wide	wagalen
widow	muso-cɛ-salen
width	jayan
wife	furumuso
wild	kungo
willing	sagoya
will	se
wind	fiɲɛ
window	finɛtiri
windy	fiɲɛma
wine	diwɛn
win	ka sɔ̀rɔ
winter	samiya
wipe	ka jɔsi
wire	filijuru
wisdom	hakilitigiya
wise	halilitigi
wish	sago
wish you all the best	ne ka duba i ye
witch	subaga
with	ani
withdrawal	labɔli
withdraw	bɔsili
within	cɛma
without	-bali
witness	seere
witty	hakilinako
wolf	lugaru
woman	muso
women	muso
wonderful	dusumgali
wonder	k'i yɛrɛ ɲininka
won	sɔrɔla
won't	tɛna
wood	yiri
wool	sagasi
word	daɲɛ
words	kumadenw
work	baara
working	baara
work out	ka labɛn
world	duniya
worm	ntumu
worn	ka kànkarimadá
worried	jɔrɔlen
worry	kɔnɔnafilila
worse	juguman
worship	batoli
worst	kolon
worth it	a bɛ a kun bɔ
worth	nafa
worthy	nafaman
would	bɛ
wound	joli
Wow	oow
wrap	ka meleke
wrath	dimi
wrist	bololanɛgɛ
Write here	a sɛbɛ yan
write	ka sɛbɛn
writing	sɛbɛnni
written	sɛbɛnnen
wrong	hakɛ
wrote	sɛbɛnna
yard	dukɛnɛ
yawn	haalo
Yeah	Awɔ
year	san
years	sanw
yeast	fununnan
yell	ka pɛrɛn
yellow	nɛrɛmuguman
Yes	Awɔ
yes baby	ɔwɔ bb
yes dear	ɔwɔ balima
yes honey	Awɔ n jarabi
yes my love	Awɔ n jarabi
yes of course	ɔwɔ kɛ
yesterday	kunu
yet	fɔlɔ
yield	nafa sɔrɔli
you are beautiful	i cɛ ka ɲi
you are	e ye
you are so beautiful	i cɛ ka ɲi
you are welcome	i ni ce
you can	i bɛ se
you	i
You know	i bɛ a dɔn
young	kamalen
your	aw ta
you’re welcome	i dancɛ
you're welcome	i ni ce
yourself	i yɛrɛ
your welcome	i ka bisimilayi
youth	denmisɛnya
you too	e fana
yummy	timiman
zero	fu
