abandoned	छोड़ल
abandon	छोड़ दिहल
abide	पालन कईल
ability	जोग्यता
able	काबिल
about	बारे में
above	ऊपरे
abroad	बिलाईत
absence	गैरमौजूदगी
absent	अनुपस्थित
absolutely	बिल्कुल
absorb	सोख लिहल
abstract	सारांश
absurd	बेमतलब
abundance	ढेर सारा
abundant	खूब सारा
abuse	गरियावल
accent	लहजा
accept	मान लीं
access	पहुँचल
accident	दुरघटना
accommodation	घर
accomplished	पूरा भईल
accomplish	पूरा करऽ
according	अनुसार
account	खाता
accuracy	शुद्धता
accurate	सटीक
accused	दोषी
ache	र्दद
achievement	उपलबधि
achieve	हासिल करीं
acknowledge	स्वीकार कईल
acquaintance	जान-पहचान
acquired	अर्जित
acquire	कमाईल
acquisition	अधिग्रहण
across	आरपार
action	कार्रवाई
active	सक्रिय
activities	गतिविधि
activity	गतिविधि
actor	अभिनेता
actually	असल में
actual	वास्तविक
act	कारज
acute	नुकीला
adapt	अनुकूल बनावल
addicted	लती
additional	अतिरिक्त
addition	जोड़
address	पता
add	जोड़ल
adequate	पर्याप्त
adjacent	बगल के
adjective	विशेषण
adjust	ठीक से राखल
admire	बड़ाई कयिल
admit	मान लिहल
adopt	अपनावल
adorable	देखे लायक
advanced	उन्नत
advance	आगे बढ़ल
advantage	लाभ
adventure	साहसिक काम
adverb	क्रिया विशेषण
advertisement	विग्यापन
advertising	विज्ञापन
advice	सलाह
advise	सलाह
advocate	वकील
aesthetic	सुरुचिपूर्ण
affair	मामला
affection	नेह
affect	प्रभाव डालल
affordable	किफायती
afford	बेंवत
afraid	डर
afternoon	दुपहरिया बाद
afterwards	बाद में
after	बाद में
against	के खिलाफ
again	फेरु
agency	एजेंसी
agent	एजेंट
age	उमिर
aggressive	आक्रामक
agile	चुस्त
ago	पहिले
agreement	समझौता
agree	मानल
agriculture	खेती
ahead	आगे
aid	सहायता
aim	निशाना
airport	हवाई अड्डा
air	हवा
aisle	गलियारा
alarm	अलार्म
alcohol	शराब
alert	चेतावनी
a little	तनी-मनी
alive	जिंदा
allowed	अनुमत
allow	आग्या दिहीं
all right	ठीक बा
all the best	सुभकामना
all	कुल्हि
almost	लगभग
alone	अकेले
along	के साथे
a lot of	ढेर सारा
a lot	ढेर सारा
already	पहिले से
Alright	ठीक बा
also	भी
alternative	वैकल्पिक
although	हालांकि
always	हर दम
amazing	शानदार
ambiguous	अस्पष्ट
ambition	महत्वाकांक्षा
ambitious	महत्वाकांक्षी
amend	संशोधन
amid	के दौरान
among us	हमनी के बीच
among	के बीच में
amount	राशि
amusing	मनोरंजक
analysis	विश्लेषण
ancestors	पितर
anchor	लंगर
ancient	पुरान
and you	अउरी रउवा
and	औरी
angel	देवदूत
anger	खीस
angle	कोण
angry	खीसियाइल
animal	मवेसी
ankle	टखना
anniversary	सालगिरह
announcement	मुनादी
annoyed	नाराज
annoying	उबियाह
annoy	परेसान कईल
annual	सालाना
anonymous	अनाम
another	दोसर
answer	जबाब
anticipate	पूर्वानुमान लगावल
anxiety	चिंता
anxious	चिंतित
anymore	एकरा बाद
anyone	केहू भी
anything	कवनो चीज
anyways	वईसे भी
anyway	कवनो तरी
any	कवनो
an	एगो
apartment	अपार्टमेंट
apart	दूरी पर
apologize	माफी मांगल
apparently	जाहिर तौर पर
apparent	स्प्ष्ट
appeal	गोहार
appearance	भेख
appeared	दिखाई दिहल
appear	हाजिर
appetite	भूख
apple	सेब
application	दरखास
apply	लागू करीं
appointment	नियुक्ति
appreciate	तारीफ
appreciation	सराहना
approach	पहुॅंंच
appropriate	ठीक
approval	मंजूरी
approved	मंजूर
approve	मंजूर करऽ
approximately	लगभग
april	अप्रिल
arbitrary	मनमाना
architecture	स्थापत्यकला
architect	वास्तुकार
archive	संग्रह
area	इलाका
are you busy	का तू व्यस्त बाड़ऽ
are you married or single	तहार बियाह भ गईल बा कि अभी नईखे भईल
are you married	का राउर बियाह हो गयिल बा
Are you still there?	का तू अभियो ओहिजा बाड़ऽ
are you there	का ओहिजा तू बाड़ऽ
are you	तू हऊअऽ
argue	बतरस
argument	बहस
arise	जागल
army	सेना
arm	बांहि
around	चारों ओर
arrangement	बेवस्था
arrange	सामान के ठीक ढंग से राखल
arrival	आगमन
arrived	पहुँच गईले
arrive	चहुँपल
arrogant	अक्खड़
arrow	तीर
article	लेख
artificial	बनावटी
artist	कलाकार
art	कला
ashamed	शम्रिंदा
ash	राख
asked	पूछनीं
ask	पूछल
asleep	सुतल
as long as	जब ले
aspect	पहलू
Assamese	असमिया
assault	मारपीट
assembly	सभा
assertive	निश्चयात्मक
assessment	आँकल
assess	आकलन
assets	जायदाद
asset	संपत्ति
assignment	दिहल गयिल कवनो काम
assign	सौंपी
assistant	सहायक
assist	हाथ बँटावल
associated	संबद्ध
associate	सहजोगी
association	संगत
assume	मान लीं
assumption	मानल बात
as well as	के संगे-संगे
as well	जईसन भी
as	जईसन
ate	खईनीं
athlete	एथलीट
at least	कम से कम
attached	जुड़ल
attachment	अनुलग्रंक
attach	संलग्न करीं
attack	हमला
attempt	कोशिश
attendance	हाजिरी
attend	शामिल होखीं
attention	धेयान
attitude	तरीका
attraction	आकर्षण
attractive	मन मोह लेबे वाला
attract	आकर्षित कईल
attribute	गुण
at	पर
audience	देखनिहार
august	अगस्त
aunty	चाची
aunt	काकी
authentic	प्रामानिक
authority	अधिकार
author	लेखक
autumn	पतझड़
available	उपलब्ध
average	ठीक-ठाक
avoid	टालल
awake	जाग जा
award	पुरस्कार
awareness	जागरुकता
aware	जानकारी
away	ओहटा
awesome	खूब बढ़िया
awful	भद्दा
awkward	अजीब
Aymara	आइमारा
a	एगो
baby	बचवा
bachelor	जैकर अबलै बियाह नईखै भईल
background	पृष्ठभूमि
back	पीछे
bad	खराब
bag	थइला
bait	प्रलोभन
bakery	बेकरी
bake	सेंकल
baking soda	खाए वाला सोडा
balance	संतुलन
ball	गैंदा
Bambara	बंबारा
banana	केला
band	बैंड
bang	धमाका
bank	बैंक
barely	खाली
bargain	मोलभाव
bark	भौंकल
barley	जौ
barrier	रोड़ा
bar	सरिया
based	आधारित
basement	तहखाना
base	आधार
basically	मूल रूप से
basic	बुनियादी
basil	तुलसी
bastard	हरामी
batch	जत्था
bathroom	नहानघर
bath	नहाईल
battery	बैटरी
battle	लड़ाई
bay	खाड़ी
beach	समुंंदर के किनारा
beam	किरन
beans	फली
beard	दाढ़ी
bearing	सहन कईल
bear	भालू
beast	जानवर
beat	मारल
beautiful	सुंदर
beauty	सुंदरता
became	भईल
be careful	सम्हल जा
because	काहें कि
become	होखल
bedroom	सुते वाला कमरा
bed	बिछवना
beef	गाय के मांस
been	हईं
beer	बियर
bee	मधुमक्खी
before	पहिले
began	शरू-भईल
beginning	शुरुआत
begin	चालू कयिल
behalf	के ओर से
behave	अच्छा बर्ताव कईल
behavior	बेवहार
behaviour	बेवहार
behind	पीछे
being	होखल
belief	आस्था
believe	बिस्वास
belly	पेट
belong	होखल
beloved	बेहद प्यारा
below	निच्चे
belt	कमरबंद
bench	बेंच
bend	झुक जाइल
beneath	नीचे
benefits	लाभ
benefit	फायदा
besides	के अलावा
beside	लगे
best of luck	सुभकामना
best regards	आदर के संगे
best	सबसे नीमन
better	बढ़िया
between	बीच में
beverage	पिये वाला सामान
beyond	पार
be	होवे
Bhojpuri	भोजपुरी
biased	पक्षपाती
bias	पक्षपात
bicycle	साइकिल
bid	बोली
big	बड़हन
bike	बाइक
bill	बिल
bind	जिल्द
bird	चिरई
birthday	जनमदिन
bite	कौर
bitter	तीत
bit	कौर
black	करिया
blade	ब्लेड
blame	अछरंग
blanket	कंबल
blank	खाली
blast	विस्फोट
bleach	ब्लीच
blend	मिलावल
blessed	भाग्यवान
bless	आशीष दिहल
blind	आन्हर
bliss	परमानंद
block	खंड
blood	खून
bloom	फलल-फूलल
blow	फूँकल
blue	बूलू
blunt	कुंद
board	बोड
boat	नाव
body	देह
boil	उबाल
bold	हिम्मती
bond	मेलभाव
bone	हड्डी
book	किताब
booster	बूस्टर
boost	बढ़ावा
boots	बूट
boot	जूता
border	सरहद
bored	उबियाइल
bore	सुराख
boring	ऊबन
born	जनम
borrow	उधार मांगल
boss	मालिक
bother	झंझट
both	दूनो
bottle	बोतल
bottom	पेनी
bought	कीनायिल
bounce	उछाल
boundaries	सरहद
bound	विवश
bowl	कचोरी
bow	धनुही
box	बक्सा
boyfriend	प्रेमी
boy	लईका
bracelet	कंगन
brain	दिमाग
branch	साखा
brand	ब्रांड
brave	हिम्मती
breach	उल्लंघन
bread	रोटी
breakfast	नास्ता
break	तोड़ल
breast	छाती
breathe	सांस लिहल
breath	सांस
breed	नसल
brick	ईंट
bride	दुलहिन
bridge	पुल
brief	छोटहन
bright	चटक
brilliant	बहुत खूब
bring	लियाव
broadcast	प्रसारण
broad	चौड़ा भाग
broken	टूटल
broke	टूट गईल
broom	झाड़ू
brother in law	साला
brother	भाई
brought	ले आवल गयिल
brown	भूअर
bro	भाई
brush	कूंची
bucket	बालटी
buddy	संगी-साथी
budget	आमदनी आ खरचा के हिसाब
bug	कीड़ा
building	इमारत
build	निर्माण
built	बनावल गईल
bulk	थोक
bully	धमकावल
bull	सांढ
bump	टक्कर
bunch	गुच्छा
bundle	बेडल
burden	बोझा
buried	दफनावल
burn	जलन
burst	चटख
bury	गाड़ल
bush	झाड़ी
business	कारोबार
bust	तूर दिहल
busy	व्यस्त
bus	बस
butterfly	तितली
butter	माखन
button	बटन
but	लेकिन
buy	किनायिल
bye	बाए
by the way	ओइसे
by	द्वारा
cabbage	गोभी
cabinet	मंत्रिमंडल
cage	पिंजरा
cake	केक
calf	बछड़ा
called	बोलावल गयिल
call me	हमके कॉल करी
call	पुकारल
calm	शांत
came	अईनी हं
campaign	अभियान
Cancel	मना कइ दीं
cancer	कैंसर
can't	नईखी सकत
can	सकिले
capable	काबिल
capacity	क्षमता
capital	पूंजी
caption	शीर्षक
capture	कब्जा
career	करियर
carefully	सावधानी से
careful	सावधान
careless	लापरवाह
caring	देखभाल
carpenter	बढ़ई
carpet	गलीचा
carrot	गाजर
carry on	जारी रखऽ
carry out	अंजाम दिहल
carry	ढोअल
car	कार
case	केस
cash	रोकड़ा
castle	किला
cast	फेंकल
casual	अनौपचारिक
catch	धरीं
category	श्रेणी
cattle	मवेशी
cat	बिलार
caught	पकड़ायिल
cause	कारन
caution	सावधानी
cautious	सर्तक
cave	गुफा
cease	बंद कईल
ceiling	छत
celebrate	जश्न मनावल
cell	कक्ष
center	केंद्र
century	सदी
cereal	अनाज
ceremony	समारोह
certainly	निश्चित रूप से
certain	कुछु
certificate	प्रमाण-पत्र
chain	जंजीर
chair	कुर्सी
challenge	ललकारल
chance	मौका
change	बदलल
chaos	अव्यवस्था
characteristics	विशैषता
character	चरित्तर
charge	चार्ज
charity	दान-पुन्न
charming	आर्कषक
chart	चार्ट
chase	पीछा कईल
chat	बातचित
cheap	सस्ता
cheating	धोखाधड़ी
cheat	धोखाा
check	जाँच
cheek	गाल
cheerful	हंसमुख
cheers	जयकारा
cheer	जयकारा
cheese	पनीर
chemistry	रसायन
cherish	दुलार कईल
chess	शतरंज
chest	सीना
chew	चबाईल
chicken	चूजा
chief	मुख्य
childhood	बचपन
children	बुतरू
child	बच्चा
chill	ठिठुरन
chimneys	चिमनी
chin	ठोड़ी
chocolate	चॉकलेट
choice	पसंद
choose	चुनीं
chop	टुकड़ा-टुकड़ा कईल
chores	ऊबाऊ काम
chubby	गुलफुला
church	गिरजाघर
cinnamon	दालचीनी
circle	वृत्त
circumstances	परिस्थिति
citizen	नागरिक
city	शहर
claim	माॅंंग
clarify	सफाई दिहल
class	कक्षा
clay	चिकना मिट्टी
clean	साफ
clear	साफ
clerk	लिपिक
clever	चँल्हाक
client	ग्राहक
cliff	खड़ा चट्टान
climate	आबोहवा
climb	चढ़ाई
clingy	चिपचिपा
clock	घड़ी
closet	कोठरी
close	बंद करीं
clothes	कपड़ा
cloth	कपड़ा
cloudy	बदरियाईल
cloud	बादल
clown	जोकर
clue	संकेत
clumsy	फूहड़
cluster	झुरमुट
coach	कोच
coal	कोयला
coast	किनारा
coat	कोट
coffee	कॉफी
cognitive	संज्ञानात्मक
coincidence	संजोग
cold	ठंढा
collapse	ढहल
collar	गिरेबान
colleagues	संगे काम करे वाला लोग
colleague	संगे काम करे वाला
collection	संग्रह
collect	इकट्ठा करऽ
college	कालेज
colorless green ideas slept furiously	बेरंग हरियर विचार गुस्सा होका सुत गईल
color	रंग
colour	रंग
column	खंभा
combination	संयोजन
combine	जोड़ल
comb	कंघी
come here	एहिजा आवऽ
come on	अरे आवऽ
come	आईं
comfortable	आरामदेह
comfort	आराम
coming soon	जल्दी आ रहल बा
coming	आवतानी
command	आदेश
comment	टिप्पणी
commercial	व्यावसायिक
commission	आयोग
commitment	वादा
committed	समर्पित
commit	बंध गईल
commodity	माल
common	साधारण
communicate	बातचीत कईल
communication	संचार
community	बेरादरी
commute	पहिनल
companion	संगी-साथी
company	कंपनी
compare	तुलना
comparison	तुलना
compassionate	दयालु
compassion	दया
compatible	अनुकूल
competent	सक्षम
compete	मुकाबला कईल
competition	होड़
competitive	प्रतिस्पर्धात्मक
complaint	सिकायत
complain	सिकायत
complement	पुराव
completely	पूरा तरह से
complete	पूरा करीं
complex	जटिल
compliance	बात मानल
complicated	जटिल
compliment	प्रशंसा
comply	पालन करीं
composition	संरचना
compound	हाता
comprehension	समझ-बूझ
comprehensive	व्यापक
compromise	समझौता करऽ
compulsory	अनिवार्य
computer	कंपूटर
concentrate	ध्यान कैंद्रित कईल
concept	संकल्पना
concerned	परवाह
concern	चिंता
concert	कंसर्ट
conclusion	अंतिम बात
concrete	ठोस
conditions	हालात
condition	हालत
conduct	चाल चलन
conference	सम्मेलन
confess	स्वीकार कईल
confidence	बिस्वास
confident	बिस्वास
confirm	पक्का कयिल
conflict	टकराव
confused	अउँजियाइल
confusion	उलझन
congrats	बधाई
congratulations	बधाई
congratulation	बधाई
conjunction	संयोजन
connect	जुड़ीं
conquer	जीत हासिल कईल
consciousness	चेतना
conscious	सचेत
consent	सहमत
consequences	नतीजा
conservation	संरक्षण
conservative	रुढ़िवादी
considered	बिचार कयिल गयिल
consider	मथल
consistency	संगतता
consistent	एक जईसन
consist	बनावट
constantly	लगातार
constant	स्थिर
constipation	कब्ज
construction	निर्माण
consume	खपत कईल
consumption	खपत
contact	संपर्क
contagious	छुतहा
contains	सामिल बा
contain	सामिल कईल
contemporary	समकालीन
contempt	निंदा
content	सामग्री
contest	प्रतियोगिता
context	प्रसंग
continent	महाद्वीप
continue	चालू रखीं
contract	ठेका
contrast	फरक देखावल
contribute	जोगदान कयिल
contribution	योगदान
control	नियंत्रण
controversial	विवादास्पद
convenience	सुविधा
convenient	सुबिधाजनक
conversation	बतकही
convert	रूप बदल
convey	सूचित कईल
convinced	कायल
convince	राजी कईल
cooking	खाना बनावल
cook	खाना बनावल
cool	ठंढा
cooperation	सहयोग
cope	सामना कईल
copper	तांबा
core	मरम
corner	कोना
corn	मकई
correct	सही
costume	पोशाक
cost	दाम
cottage	झोंपड़ी
cotton	रूई
couch	सोफा
cough	खांसी
could	सकिले
council	परिषद
counter	काउंटर
countryside	गवंई इलाका
country	देश
count	गिनती
couple	जोड़ा
courage	हिम्मत
course	कोर्स
courtesy	सौजन्य
court	अदालत
cousin	चचेरा
cover	ढँकल
coward	डरपोक
cow	गाय
cozy	आरामदायक
crab	केकड़ा
crack	दरार
craft	कारीगरी
crap	बकवास
crash	दुर्घटना
craving	चाह
crawl	धीरे धीरे चलल
crazy	सनकी
create	बनावल
creative	रचनात्मक
credit	करज
creepy	रेंगे वाला
creep	रेंगना
crew	चालक दल
crime	अपराध
cringe	घिघियाइल
crisis	संकट
criteria	मानदंड
critical	समालोचनात्मक
criticism	आलोचना
crops	फसल
crop	फसल
cross	पार कईल
crowded	भीड़भाड़ वाला
crowd	भीड़
crown	मुकुट
crow	कऊआ
crucial	बहुते जरूरी
cruel	निरदयी
cruise	क्रूज
crush	मसलल
cry	रोआई
cucumber	खीरा
cuddle	छाती से लगावल
culture	चलन
cunning	धूर्त
cupboard	अलमारी
cup	कप
curb	नियंत्रण
cure	रोगमुक्ति
curfew	कर्फ्यू
curiosity	कुछ जाने के इच्छा
curious	उत्सुक
curly	घुंघराला
currency	मुद्रा
currently	अभी
current	अबही
curse	सराप
curtain	परदा
cushion	तकीया
customer	गहकी
customs	सीमाशुल्क
custom	रिवाज
cute	सुंदर
cut	काट दियाइल
cycle	साइकिल
cycling	साइकिल चलावल
daddy	बाबूजी
dad	बाबूजी
daily	रोज
dairy	डेयरी
damage	नुकसान
damn	सराप
damp	नम
dam	बांध
dance	नाच
dangerous	खतरनाक
danger	खतरा
dark	अन्हरिया
darling	जानू
dash	पानी का छींटा
data	आंकड़ा
date	तारीख
daughter	बेटी
day	दिन
deadline	समय-सीमा
dead	मरल
deaf	बहिर
deal	सौदा
Dear All	सब केहू
Dear Customer	प्रिय गाहक
Dear Parents	प्रिय अभिभावक
Dear Sir	प्रिय महोदय
Dear students	प्रिय छात्र
Dear Team	प्रिय टीम
dear	प्रिय
death	मऊगत
debate	बहस
debit	नामे
debris	मलबा
debt	कर्ज
decade	दशक
decay	सड़न
deceased	मृतक
deceive	धोखा दिहल
december	दिसम्बर
decent	सुघर
decided	निहचित
decide	फैसला कईल
decision	फैसला
deck	डेक
decline	मना क दिहल
decrease	घटाईं
dedicated	समर्पित
dedication	समर्पण
deed	बैनामा
deep	गहिर
deer	हरिन
default	बाकी
defeat	हराईं
defend	रक्षा कईल
define	परिभाषित करीं
definitely	बिल्कुल
definition	परिभाषा
degree	डिग्री
delayed	देर से
delay	देरी
delete	हटाईं
deliberate	सोच-विचार के कईल
delicate	नाजुक
delicious	स्वादिस्ट
delighted	प्रसन्न
delight	खुसी
delivered	पहुंची देहनी
delivery	बच्चा दिहल
deliver	सौंपल
demanding	जादा काम चाहल
demand	मांग
democracy	लोकतंत्र
demonstrate	कुछ देखावल
demon	रोक्षस
denied	मना कईल
density	घनत्व
dentist	दांत के डॉक्टर
deny	मना
department	विभाग
departure	रवाना भईल
depend	आश्रित
deploy	तौनाती
deposit	जमा
depressed	अवसादग्रस्त
depression	अवसाद
depth	गहराई
describe	वर्णन कयिल
description	बिबरन
desert	रेगिस्तान
deserve	लायक
designation	पदनाम
design	डिजाइन
desire	मनकामना
desk	मेज
despair	निराशा
desperate	खिसियाह
despite	एकरा बावजूद
dessert	खाना के अंत में परोसल जाए वाला मिठाई
destination	ठिकाना
destiny	भाग्य
destroy	नष्ट कईल
destruction	विनाश
details	विवरण
detail	ब्योरेवार
detect	पता लगावल
determination	पक्का निश्चय
determined	मन पक्का क लिहल
determine	तय करीं
devastated	तहस-नहस
developed	विकसित
development	बिकास
develop	बिकास
device	जंतर
devil	शैतान
devoted	समर्पित
Dhivehi	दिवेही
diabetes	मधूमेह
diarrhea	दस्त
diary	डायरी
dictionary	शब्दकोश
did	कयिल गयिल
died	मर गईले
diet	आहार
die	मरल
difference	अंतर
different	अलग
difficult	अलटाह
dignity	इज्जत
dig	खोदल
diligent	मेहनती
dinner	रात के खाना
dip	गोता
direction	दिशा
director	निर्देशक
direct	सीधा
dirty	गंदा
dirt	गंदगी
disabled	विकलांग
disable	विकलांग
disappear	गायब
disappointed	उदासल
disaster	विपत्ति
discard	रद्द कईल
discharge	स्राव
discipline	अनुशासन
discount	छुट
discover	खोज निकालल
discrimination	भेदभाव
discussion	विचार-विमर्श
discuss	बतियावल
diseases	रोग
disease	बेमारी
disguise	स्वांग
disgusting	घिनौना
dishes	बरतन
dish	बरतन
dismiss	खारिज
dispatch	रवानगी
display	देखावऽ
disposal	निपटान
dispute	विवाद
distance	दूरी
distinct	अलग
distinguish	फरक देखावल
distress	संकट
distribution	वितरण
district	जिला
disturb	परेशान
ditch	खाई
diverse	विविध
diversity	विविधता
dive	डुबकी
divide	बाँटल
divine	दिव्य
divorce	तलाक
dizzy	सिर घुमल
doctor	डाक्टर
document	दस्तावेज
doesn't	नईखे
does	काम कयिल
Dogri	डोगरी
dog	कुकुर
doing	काम
doll	गुड़िया
domain	डोमेन
domestic	घरेलू
dominant	प्रमुख
donate	दान कईल
done	हो गईल
donkey	गदहा
Don't worry	चिंता मत कर‍ऽ
don't	मत करऽ
dope	नशीला दवा
double	दुगुना
doubt	शक
dough	लोई
download	डाउनलोड करीं
down	नीचे
do you love me	का तू हमसे प्यार करेलू
do you	का रऊआ
do	करीं
draft	मसउदा
drag	खींचल
drain	नाली
drama	नाटक
drawer	दराज
drawing	चित्रकारी
draw	खींचीं
dread	खौफ
dream	सपना
dress	पहिनावा
drill	कवायद
drink	पियल
drive	गाड़ी चलावऽ
dropped	गिरल
drop	गिरल
drought	सूखा
drunk	नशा में
dry	सूखल
duck	बत्तख
dude	छोकड़ा
due to	एकरा चलते
due	बकाया
dull	सुस्ताह
dumb	गूंग
dump	घूरा
duration	अवधी
during	ओही समय
dust	धूल
duty	डिउटी
dwell	बसल
dying	मौत
each other	एक दूसरा से
each	एकएक गो
eager	उत्सुक
eagle	बाज
earlier	पहिले
early	सेकराहे
earn	कमाइल
ears	कान
earthquake	भूकंप
earth	धरती
ear	कान
ease	आराम
easily	आसानी से
east	पूरब
easy	आसान
eating	खाईल
eat	खाईं
economic	किफायती
economy	अर्थबेवस्था
edge	कोर
edit	संपादन कईल
education	पढ़ाई
effective	असरदार
effect	प्रभाव
efficiency	क्षमता
efficient	माहिर
effort	कोशिश
eggplant	बैंगन
egg	अंडा
ego	अहंकार
eighteen	अठारह
eighty	अस्सी
eight	आठ
either	कऊनो
elaborate	विस्तार से कहऽ
elbow	कोहनी
elderly	बुजुर्ग
elder	बड़
elegant	सुरूचिपुर्ण
element	तत्त्व
elephant	हाथी
eleven	एगारह
eligible	योग्य
eliminate	हटावल
else	नाहीं त
embarrassed	लाज लागल
embarrassing	संकोची
embrace	गले मिलल
emergency	आपातकाल
emerge	उभरल
emotional	भावुक
empathy	समानुभूति
emphasis	जोर डालल
emphasize	जोर डालऽ
employees	कर्मचारी
employee	करमचारी
employer	नियोक्ता
employment	रोजगार
empty	खाली
enable	सक्षम करीं
encounter	मुठभेड़
encourage	हिम्मत दिहल
endangered	लुप्तप्राय
endeavor	परयास
endurance	धीरज
endure	टिके रहल
end	समाप्त करीं
enemy	दुश्मन
energy	ऊर्जा
engaged	बाझल
engagement	जुड़ाव
engage	काम पर लगावल
engineer	इंजीनियर
engine	इंजिन
English	अंगरेजी
enhance	बढ़ावल
enjoy	मजा
enormous	बिसाल
enough	बहुते
ensure	पक्का कयिल
entertainment	मनोरंजन
enter	घुसऽ
enthusiasm	उत्साह
enthusiastic	उत्साही
entire	सगरे
entitled	हकदार
entity	संस्था
entrance	प्रवेश
entrepreneur	उद्यमी
envelope	लिफाफा
environment	वातावरण
envy	तोहके ईयाद करीले
epic	महाकाव्य
epidemic	महामारी
equal	बराबर
equipment	औजार
equity	हिस्सेदारी
equivalent	समकक्ष
eraser	मेटावे वाला
error	त्रुटि
escape	साफ बचि के निकल गयिल
especially	खासकर
essay	निबंध
essence	सार
essential	जरूरी
established	स्थापित
establish	स्थापित करीं
estate	जायदाद
estimated	अनुमानित
estimate	आकलन
etc	आदि-आदि
eternal	अविनाशी
ethics	आचार-विचार
evaluate	मूल्याकंन
evaluation	मूल्यांकन
evening	सांझि
even though	भले ही
eventually	अंत में
event	कार्यक्रम
even	तब्बो
everybody	हर केहू
everyone	सभ कोई
everything	हर चीजु
every	हरेक
ever	हमेशा
evidence	सबूत
evil	बुराई
evolution	क्रमिक विकास
evolve	विकसित कईल
Ewe	एवै
exactly	एकदम
exact	सटीक
examine	परीछा
example	उदाहरण
exam	परीच्छा
exceed	पार क गईल
excellent	बहुत नीमन
exception	अपवाद
except	के छोड़ि के
excessive	काफी जादा
excess	अधिक
exchange	लेनदेन
excited	जोश में
excitement	उत्साह
exciting	रोमांचक
exclusive	एकमात्र
excuse me	माफ करेबि
excuse	क्षमा
execute	निष्पादित करीं
execution	अमल
executive	कार्यकारी
exercise	वर्जिश
exhausted	थाकल
exhaust	निकास
exhibition	प्रदर्शनी
exhibit	प्रदर्शनी
existence	अस्तित्व
existing	मौजूदा
exist	जिन्दा
exit	निकास
expand	बढ़ावऽ
expected	अपेक्षित
expect	अनुमान
expenses	खरचा
expensive	महँग
experience	अनुभव
experiment	प्रयोग
expert	विशेषज्ञ
expired	समय-सीमा खतम बा
explain	बिस्तार से बतावल
explanation	व्याख्या
exploit	शोषण
explore	पता लगाव
export	निर्यात
exposed	उजागर
expose	उजागार कईल
exposure	खुलासा
expression	अभिव्यक्ति
express	आपन बात राखल
extended	बढ़ावल
extend	बढ़ावल
extension	बढ़ावल
extent	हद
external	बाहरी
extinct	दुर्लभ
extract	निचोड़
extraordinary	असाधारण
extra	अतिरिक्त
extremely	अत्यंत
extreme	चरम
ex	भूतपूर्व
eyes	आंख
eye	आँख
fabric	कपड़ा
fabulous	सानदार
face	चेहरा
facilitate	सहज बनावल
facilities	सुविधा
facility	सुविधा
factory	कारखाना
factor	कारक
facts	तथ्य
fact	तथ्य
fade	मुरझाईल
failed	असफल
failure	असफल
fail	फेल
faint	मूर्छा
fairly	पर्याप्त
fairy	अप्सरा
fair	सुंदर
faithful	वफादार
faith	भरोसा
fake	नकली
fall	गिरल
false	गलत
fame	प्रसिध्दि
familiar	परिचित
family	परिवार
famine	अकाल
famous	नामी
fancy	फैंसी
fantastic	सानदार
fan	पंखा
farewell	बिदाई
farmer	किसान
farm	खेत
far	ओहटा
fascinating	जियरा के लुभावे वाला
fashion	फैशन
fast	तेज
fatal	घातक
fate	तकदीर
father	बाप
fatigue	थकाहट
fat	मोट
fault	दोष
favorite	मनजोग
favourite	पसंदीदा
favour	एहसान
fear	भय
feast	दावत
feather	पंख
features	विशेषता
feature	चेहरा-मोहरा
february	फरवरी
fed up	थकल
feedback	प्रतिक्रिया
feed	खाना खियावल
feeling	अनुभव
feel	महसूस करीं
feet	गोड़
fee	शुल्क
fellow	संगी-साथी
fell	गिर गईल
felt	महसूस भईल
female	मेहरारू
fence	बाड़
fertile	उपजाऊ
festival	परब-त्यौहार
fetch	निकालल
fever	जर बोखार
fewer	कम
few	तनी
fiance	मंगेतर
fiction	काल्पनिक कहानी
field	खेत
fierce	आग-बबूला
fifteen	पंदरह
fifty	पचास
fighting	मार-पिटाई
fight	मारामारी
figure out	हिसाब लगावल
figure	डौल
file	फाइल
filled	भरल
fill	भरल
film	फिलिम
filthy	गंदा
finally	अंत में
finance	आमदनी
financial	माली
find out	पता लगाईं
find	पावल
fine	नीक
finger	अंगुरी
finished	खतम करीं
finish	खतम करीं
fire	आगि
firm	कंपनी
first name	पहिला नांव
first	पहिला
fish	मछरी
fit	फिट
five	पाँच
fixed	तय
fix	ठीक करऽ
flag	झंडा
flash	चौंध
flat	चापुट
flawless	दोषरहित
flaw	खोट
flee	फरार भईल
flesh	गूदा
flew	उड़ गईल
flexible	लचीला
flex	मोड़ल
flight	उड़ान
flip	पलटी
flirting	छेड़खानी
flirt	इशकबाजी
float	डोंगा
flood	बाढ़ि
floor	फर्श
flour	आटा
flower	फूल
flow	बहाव
fluently	बेधड़क
fluent	बेधड़क बोले वाला
fluffy	भुलक्कड़
fluid	तरल
flu	बुखार
fly	उड़ल
focus	ध्यान
foggy	धुंधला
fog	कोहरा
fold	तह कईल
folks	ईयार
following	चेला
follow up	जाँच कईल
follow	पीछे पीछे चलल
food	खाना
foolish	मूरख
fool	मूरख
football	फुटबॉल
foot	गोड़
forbidden	निषिद्ध
force	बल
forecast	पूर्वानुमान
forehead	माथा
foreign	बिलायती
forest	जंगल
forever	हरमेशा खातिर
For example	उदाहरण खातिर
forget	भुलल
forgive	माफ कईल
forgot	भूला गईले
for instance	मिसाल के तौर पर
fork	कांटा
formal	औपचारिक
former	जवन पहिले हो चुकल बा
form	फारम
fortunately	भाग्यवश
fortune	भाग्य
forty-two	बयालीस
forty	चालीस
forward	आगे
for you	तहरा खातिर
for	खातिर
foster	पालन-पोषण कईल
fought	लड़ले
foundation	नींव
found	मिल गयिल
fourteen	चौदह
four	चार
fox	लोमड़ी
fragile	नाजुक
framework	ढांचा
frame	ढांचा
fraud	धोखा
freak	सनकी
freedom	आजादी
freeze	फ्रीज
free	बेपइसा के
frequency	आवृत्ति
frequently	अकसर
frequent	बार-बार
fresh	ताजा
friday	शुक
fridge	जम गईल
friendly	मित्रवत
friendship	ईयारी
friends	ईयार
friend	संघतिया
frightened	डरल
frightening	डरावना
frog	मेढक
from	से
front	सामने
frozen	जमल
fruit	फल
frustrated	हताश
fuel	ईंधन
Fulfulde	फुलफुल्दे
full	भरल
function	परोजन
fundamental	मौलिक
funeral	अंतिम संस्कार
funny	मजगर
fun	मस्ती
furious	आगबबूला
furniture	काठ के बनल सामान
furthermore	अऊरो
further	एकर अलावा
fur	छाल
future	भविष्य
gain	फायदा
game	खेल
gap	अंतर
garage	गैराज
garbage	कचरा
garden	बगईचा
garlic	लहसुन
gate	दरवाजा
gathering	जलसा
gather	इकट्ठा भईल
gauge	नाप
gave	दैहनीं
gear	गियर
gender	लिंग
generally	आम तौर पर
general	साधारन
generate	उपजावल
generation	पीढ़ी
generous	दिलदार
genius	प्रतिभावन
genre	शैली
gentle	सज्जन
genuine	असली
gesture	हाव-भाव
get dressed	तईयार हो जा
getting	पावल
get up	उठ जा
get well soon	जल्दी निरोग होईं
get	प्राप्त
ghosting	छलावा
ghost	भूत
giant	बहुते बड़हन
gift	भेंट
ginger	अदरक
girlfriend	प्रेमिका
girl	लइकी
given	दिहल गईल
give up	छोड़ दिहल
give	दिहीं
glad	खुश
glance	झलक
glasses	चश्मा
glass	कांच
glimpse	झलक
global	वैश्विक
gloomy	उदास
gloves	दस्ताना
glow up	चमकल
glow	चमक
glue	गोंद
go ahead	आगे बढ़ऽ
goals	लक्ष्य
goal	मकसद
goat	बकरी
go away	भाग जा
god bless you	भगवान रऊर भला करस
god	भगवान
goes	जात बा
going to	जा रहल बानीं
going	जा रहल बा
gold	सोना
gone	गईले
gonna	जा रहल बानीं
good afternoon	शुभ दूपहरिया
good bye	अलविदा
goodbye	अलविदा
good day	दिन सुभ हो
good evening	शुभ संध्या
good job	बहुत बढ़िया
good looking	सुनर
good luck	मंगल होखे
good morning my love	हमरा जान के सुप्रभात
good morning	शुभ प्रभात
goodnight	शुभ रात
good night	शुभ रात्री
goods	सामान
good	नीमन
Google Translate	गूगल अनुवाद
Google	गूगल
goose	बत्तख
goo	कवनो चिपचिपा पदार्थ
gorgeous	खूबसूरत
gossip	गपशप
got it	समझ गईनीं
go to bed	सुते जा
got	मिलल
government	सरकार
go	जाईं
grab	झपटल
grade	कक्षा
gradually	धीरै-धीरै
graduate	स्नातक
grain	अनाज
granted	दिहल गईल
grant	माली मद्द
grapes	अंगूर
grasp	पकड़ल
grass	घास
grateful	आभारी
gratitude	कृतज्ञता
grave	समाधि
gray	धूसर
great	बढियाॅंं
greedy	लालची
greed	लालच
green	हरियर
greetings	अभिवादन
greeting	अभिवादन
greet	अभिवादन कईल
grey	धूसर
grid	ग्रिड
grief	शोक
grind	पीस
grip	पकड़
grocery	किराना
groom	दूलहा
gross	सकल
ground	ज़मीन
group	समूह
growth	विकास
grow	बढ़ल
grumpy	क्रोधी
Guarani	गुआरानी
guarantee	गारंटी
guard	रक्षक
guess	पहिचानीं
guest	मेहमान
guidance	दिशानिर्देश
guide	मार्गदर्शन
guilty	दोषी
guys	लोग
guy	लोग
gym	जिम
habitat	ठौर-ठिकाना
habit	आदत
had	के पास रहल
hail	ओसा
hair	बार
half	आधा
hall	सभामंडप
handle	हेंडिल
handsome	सुघर
hand	हाथ
hang out	अड्डा
hang	टंगाई
happened	भईल
happen	भईल
happiness	खुसी
happy birthday to you	जनमदिन मंगलमय हो
happy birthday	जन्म दिन के शुभ कामना
happy new year	नया साल के सुभकामना
happy	खुश
hardly ever	सायदे कबो
hardly	मुसकिल से
hard	कड़ा
harmful	हानिकारक
harmony	सद्भाव
harm	नुकसान
harsh	कठोर
harvest	कटाई
has	के पास
hate	घिन
have a good day	राऊर दिन शुभ रहे
have a nice day	तहार दिन बढ़िया रहे
have breakfast	कलेवा क लऽ
have fun	मजा करऽ
have you eaten	का तू खा लेले बाड़ऽ
have	पास
having	लगे रहल
hazard	जोखिनम
haze	धूंध
headache	कपार दरद
head	कपार
healing	इलाज
healthy	भला चंगा
health	स्वास्थ
heal	घाव ठीक भईल
heard	सुनाइल
heart	दिल
hear	सुनल
heat	गरम
heaven	स्वर्ग
heavy	भारी
hectic	व्यस्तता से भरल
he has	ओकरा लगे
height	ऊँचाई
heir	वारिस
heist	सेंधमारी
he is	ऊ हऊअन
held	पकड़ल
hello dear	ए सुन ना डियर
hello how are you doing	काहो का चलता
hello how are you	राम राम, कईसन बाड़ऽ
Hello	प्रणाम
hell	नरक
helmet	हेलमेट
helpful	मददगार
help	मदद
hence	एह से
herd	झुंड
here	इहाॅंं
heritage	विरासत
her	ऊनकर
hesitate	झिझक
Hey	अरे
he	ऊ
hidden	छिपल
hide	लुकाइल
hierarchy	पदक्रम
highlight	मुख्य आकर्षण
high	ऊँच
hi how are you	काहो कईसन बाट
hike	बढ़ोतरी
hiking	ढेर दूर ले पैदल सफर
hilarious	आनंददायक
hill	टीला
him	उनके
hint	इशारा
hips	कूल्हा
hip	कूल्हा
hire	किराया प दिहल
hiring	भर्ती
history	इतिहास
his	उनकर
Hi there	राम-राम
hit	पीटल
Hi	एहो
Hmm	हम्म
hobby	शौक
hold on	रूकऽ
hold	पकड़
hole	छैद
holiday	छुट्टी के दिन
hollow	खोखला
homework	गृहकार्य
home	घर
honestly	ईमानदारी से
honest	ईमानदार
Honey	मध
honor	सम्मान
hood	ओढ़नी
hook	हुक
hopefully	उम्मीद बा
hopeless	नाउम्मीद
hope	उम्मेद
hop	छलांग
horizontal	क्षैतिज
horn	सींग
horrible	डरावना
horror	डर
horse	घोड़ा
hospitality	सत्कार
hospital	अस्पताल
hostile	विरोधी
host	जजमान
hotel	होटल
hot	गरम
hours	घंटा
hour	घंटा
household	गिरस्ती
house	घर
how about you	रऊआ कईसन बानी
how are you doing today	आज का चलता
how are you doing	का चलता
how are you today	का हाल बा आज
how are you	का हाल बा
how do you do	रऊआ कईसन बानीं
however	हालांकि
how is	कईसन बा
how many	केतना
how much	कतना
how often	केतना बार
how old are you	रऊवाॅंं क साल क बानी
how was your day	तहार दिन कईसन बीतल
how was your night	तहार रात कईसन बीतल
how	कईसे
hubby	पति
hub	हब
huge	बड़
hug	सीना से लगावल
human	इंसान
humble	रहनदार
humidity	नमी
humid	नम
hundred	सौ
hungry	भूखा
hunt	शिकार
hurricane	तूफान
hurry up	जल्दी करऽ
hurry	जलदी करऽ
hurt	घाव लागल
husband	खसम
hustle	धक्का दिहल
hut	कुटिया
hygiene	स्वच्छता
I am fine	हम ठीक बानी
I am	हम हईं
I can't	हम नईखी सकत
I can	हम कर सकेनीं
ice cream	आइसक्रीम
ice	बरफ
ideal	आर्दश
idea	विचार
identical	समान
identify	पहचान
identity	पहिचान
idiot	बेवकूफ
idle	आलसी
I do not know	हम नईखी जानत
I do not understand	हम नईखी समझत
I don't know	हम ना जनेलीं
I don’t know	हमरा नईखे पता
I don't understand what you mean	हम ना समझनीं कि तू का कहल चाहतारऽ
I don't understand you	हम तोहके ना समझनी
I don't understand	हमके समझ में नईखे आवत
I don’t understand	हम ना समझनी
I don't	हम ना
I do	हम करेनी
if	अगर
ignore	देखि के अनदेखा कयिल
i guess	हमरा लागत बा
I had	हम कईनीं
I have been	हम कईले बानी
I have	हमरा लगे बा
I hope so	हमरा आसा बा
I know	हम जानत बाटी
I like you	हम तोहरा के पसंद करीले
I like	हमरा पसंद बा
illegal	अवैध
illness	बेमारी
ill	बेमार
Ilocano	इलोकानो
I love my big brother	हम आपना बड़का भाई के प्यार करिले
I love my big sister	हम आपना बड़की बहिन के प्यार करिले
I love my father	हम आपना बाबूजी के प्यार करिले
I love my little brother	हम आपना छोटका भाई के प्यार करिले
I love my little sister	हम आपना छोटकी बहिन के प्यार करिले
I love my mother	हम आपना मई के प्यार करिले
I love you so much	हम तहरा से बहुते परेम करेनीं
I love you too	हमहूं तोहसे प्यार करीले
I love you	हम तोहसे प्यार करेलीं
I love	हम प्यार करिले
image	छवि
imagine	कल्पना करीं
I mean	हमार मतलब बा
I'm fine	हम बढ़िया बानीं
I'm good	हम अच्छा बानी
I'm here	हम एहिजा बानीं
I miss you so much	हम तोहके बड़ा ईयाद करिले
I miss you	तहार इयाद आवत बा
immediately	तुरंत
immediate	तुरंत
immense	बहुते अधिक
impact	असर
impatient	बेताब
implement	अमल में लियावल
important	महत्वपूर्ण
import	आयात
impose	थोपल
impossible	असंभव
impression	प्रभाव
impressive	परभावशाली
impress	ठप्पा
improvement	सुधार
improve	सुधार
I'm sorry	हमरा के माफ करीं
I'm	हम हईं
I’m	हम हईं
in addition	एकरा अलावा
inappropriate	अनुचित
incentive	प्रोत्साहन
incident	घटना
include	सामिल कईल
including	समेत
income	कमाई
inconvenience	असुविधा
increased	बढ़ल
increase	बढ़ल
incredible	अजगुत
indeed	सच्चो
independent	आजाद
India	भारत
indicate	इंगित कईल
indigenous	मूल निवासी
individual	बेकती
industry	उद्योग
inevitable	जवन टालल ना जा सके
In fact	दरअसल
infant	शिशु
infection	संक्रमण
infinity	अनंत
inflammation	सूजन
inflation	मुद्रास्फीति
influence	चलती
information	खबर
inform	सूचित करीं
in front of	एकरा सामने
ingredients	सामग्री
inheritance	विरासत
initial	शुरुआती
initiative	पहल
injured	चोटग्रस्त
injury	चोट
innocent	शरीफ
innovation	नया खोज
in order to	ताकि
inquiry	जांच
insane	पगलेट
insect	कीड़ा-मकोड़ा
insecure	असुरक्षित
insert	डालीं
inside	भीतर
insight	अंतर्दृष्टि
insist	जोर दिहल
insomnia	नींद ना आवल
inspiration	प्रैरणा
inspire	प्रेरित कईल
install	स्थापित करऽ
instance	उदाहरण
instant	तुरंत
instead of	एकरा बजाय
instead	बदला में
instructions	निर्देश
instrument	औजार
insult	अपमान
insurance	बीमा
intact	बरकरार
integrity	सच्चाई
intellectual	बुद्धिजीवी
intelligence	अकलमंदी
intelligent	होशियार
intended	इच्छित
intend	इरादा
intense	तीव्र
intention	इरादा
interaction	परस्पर क्रिया
interact	मेलजोल कईल
interested	दिलचस्पी
interesting	मजदार
interest	सूद
interfere	बीच में पड़ल
intermediate	मध्यवर्ती
internal	भीतरी
international	अंतरराष्ट्रीय
internship	इंटर्नशिप
interpreter	दुभाषिया
interpret	व्याख्या कईल
interrupt	रुकावट डालल
interview	साक्षात्कार
intimate	इत्तिला कईल
into	में
introduce	परिचय
introduction	परिचय
introvert	अंतर्मुखी
intuition	सहज ज्ञान
invalid	अमान्य
inventory	सूची
invent	ईजाद कईल
investigate	छीन-बीन कईल
invest	निवेश करीं
invitation	नेवता
invite	नेवता पठाईं
invoice	चालान
involved	शामिल
involve	सामिल
in	में
iron	लोहा
I see	हम देखतानी
island	द्वीप
isolated	पृथक
issues	समस्या
issue	मुद्दा
items	वस्तू
item	सामान
I think	हम सोचतानी
it is	ई ह
It's okay	ई ठीक बा
it's ok	ठीक बा
its	इसका
it's	ई हऽ
it was	ई रहे
it	इ
I understand	हम समझत बानीं
I want to see you	हम तोहसे मिलल चाहतानी
I want you	हम तोहके चाहनीं
I want	हम चाहतानी
I was	हम रहनीं
I will	हम करेबि
I would be	हमार होई
jacket	जैकट
jail	जेल
January	जनवरी
jar	जार
jaw	जबड़ा
jealous	डाही
jerk	झटका
jewelry	गहना
job	नौकरी
jogging	धीरै-धीरे चलल
joint	जोड़
join	ज्वाइन
joke	मजाक
journalist	पत्रकार
journey	सफर
joy	हर्ष
judge	लाट साहेब
juice	रस
july	जुलाई
jump	कूदल-फांदल
june	जून
junk	कचरा
just do it	बस करि दऽ
justice	न्याय
justify	सही साबित कईल
just	अबहीं
Kalaallisut	कलाल्लिसुत
keen	तेज
keep it up	एके जारी रखऽ
keep	रख्खल
kept	रखल बा
kettle	केतली
key	चाभी
kick	लात मारल
kidding	मजाक
kidney	गुरदा
kids	बच्चा
kid	बच्चा
kill	हत्या
kinda	तरह के
kindly	कृपया
kindness	दयालुता
kind	दयालू
king	राजा
kiss	चुम्मा
kitchen	रसोईघर
kite	पतंग
kitten	बिल्ली का बच्चा
knee	घुटना
knew	जानत रहनीं
knife	छुरी
knight	शूरवीर
knowledge	ग्यान
known	ज्ञात
know	जानल
Konkani	कोंकणी
Krio	क्रियो
label	लेबल
labor	मजदूर
labour	मजदूर
lack	कमी
ladder	साढ़ी
lady	महिला
laid	लेटावल
lake	झील
lamb	मेमना
lame	लूला
lamp	दिया
landscape	परिदृश्य
land	जमीन
language	भाखा
lap	भाग
large	बड़हन
last but not least	अंतिम लेकिन कम महत्वपूर्ण नईखे
last name	अंतिम नाम
last	अंतिम
lately	हाल ही में
later	बाद में
latest	सबसे हाल के
late	देरी
latter	बाद वाला
laughing	हंसल
laughter	हँसी
laugh	हँसल
launch	शुरुआत
laundry	धोबीघाट
lawn	मैदान
lawyer	बकील
law	कानून
layer	परत
layout	खाका
lay	नकशा
lazy	असकतियाह
leader	नेता
lead	आगे होखल
leaf	पतई
leak	रिसाव
lean	दुबला
leap	उछाल
learning	ज्ञानार्जन
learn	सीखल
lease	पट्टा
least	कम से कम
leather	चमड़ा
leaves	छुट्टी
leave	छुट्टी
led	राह देखवले
left	छोड़ देलन
legacy	विरासत
legal	कानूनी
legend	दंतकथा
legit	वैध
leg	पांव
leisure	फुरसत
lend	कर्जा दिहल
length	लंबाई
lesson	सबक
less	कम
letter	चिट्ठी पतरी
lettuce	सलाद
let	होखे दीं
level	स्तर
leverage	फायदा उठाईं
liability	देनदारी
library	पुस्तकालय
lick	घूंसा
lies	लेटल
lie	झूठ
life	जिनगी
lift	उठावल
lightning	बिजली
light	उजियार
likely	संभावित
likewise	वईसे ही
like	पसन
line	रेखा
Lingala	लिंगाला
link	संपर्क
lion	शेर
liquid	तरल
listening	सुनल
listen	सुनीं
list	सूची
literally	पूरा तरह से
literature	साहित्य
litter	कूड़ा
little	छोट
liver	कलेजा
lives	रहेला
live	जियल
living room	बईठका
living	रहन-सहन
lizard	छिपकली
load	भार
loaf	पावरोटी
loan	उधार
local	स्थानीय
location	अस्थान
lockdown	तालाबंदी
lock	ताला
log	लट्ठा
lol	ठहाकेदार हँसी
lonely	अकेला
long time no see	बहुत समय से नईखऽ मिलल
long	लाम
look	देखीं
loop	कुंडली
loose	ढीला
lord	भगवान
lose	हेराइल
loss	नुकसान
lost	भूला गयिल
lot	बहुते
loud	जोर से
lounge	लाउंज
lovely	प्यारा
love you	तोहके प्यार करिले
love	प्यार
lower	निचला
low	कम
loyalty	निष्ठा
loyal	बफादार
lucky	भाग्यशाली
luck	भाग्य
Luganda	लुगांडा
luggage	सामान
lump	गांठ
lunch	दुपहरिया के खाना
lungs	फेफड़ा
luxury	विलासिता
lying	झूठ बोलल
machine	मशीन
madam	महोदया
made	बनल
mad	पगलेट
magazine	पत्रिका
magnificent	सानदार
maid	नौकरानी
maintain	बनवले राखल
maintenance	रखरखाव
main	मेन
Maithili	मैथिली
majority	बहुमत
major	बड़हन
make up	शृंगार
make	बनावल
male	मरद
mall	मॉल
management	प्रबंधन
manager	प्रबंधक
manage	बंदोबस्त कईल
mandatory	बहुत जरूरी
manifest	घोषना कईल
manipulate	हेरफेर कईल
manner	तौर-तरीका
manual	हाथ से कईल
many many happy returns of the day	ई दिन बार-बार आवो
many	ढेर
man	आदमी
march	मार्च
margin	हाशिया
market	मंडी
marriage	बियाह
married	बियाहल
mask	मुखौटा
massive	काफी विशाल
mass	समूह
master	माहटर साहेब
match	मैच
material	सामान
mate	दोस्त
math	गणित
matter	मामला
maturity	परिपक्वता
maybe	हो सकेला
may	हो सकेला
meal	खाना
meaning	मतलब
means	माने
meant	मतलब
meanwhile	ए बीच
mean	माने
measures	उपाय
measure	नापल
meat	मांस
medical	चिकित्सा
medicine	दवाई
meditation	समाधि
medium	माध्यम
meeting	बईठक
meet	मिलल
Meiteilon	मैतैलोन
melt	पिघलाव
memories	ईयाद
memory	ईयाद
mental	मानसिक
mentioned	उल्लिखित
mention	जिकिर
mentor	सलाहकार
merchant	सौदागर
mercy	दया
merely	महज
merry christmas	क्रिसमस के बधाई
message	सनेस
messy	गंदा
mess	झमेला
metal	धातु
method	विधि
me too	हमहूॅंं
me	हम
mice	चूहा
middle	मध्य
midnight	आधी रात
might	हो सकेला
mild	हलुक
milestone	मील के पथर
military	सेना
milk	दूध
million	दस लाख
mindset	मानसिकता
mind	मगज
mine	हमार
mingle	आपस में मिलल
minor	नाबालिग
minutes	मिनट
minute	मिनट
miracle	चमत्कार
mirror	आइना
miscellaneous	विविध
mischievous	शरारती
miserable	घिनौना
misery	दुरगति
missing	लापता
mission	ध्येय
miss you	तोहकै ईयाद करीलै
miss	कुमारी
mistake	गलती
mist	कोहरा
Mizo	मिज़ो
mobile	मोबाइल
mock	दिखावटी
model	नमूना
moderate	उदार
modern	आधुनिक
modest	आडंबरहीन
moisture	नमी
moist	नम
mold	ढालल
mole	छछूंदर
moment	पल
mom	माई
monday	सोमार
money	रुपिया
monitor	निगरानी कईल
monkey	बानर
month	महीना
moody	तुनकमिजाज
mood	मन
moon	चाँद
moral	नैतिक
moreover	एकरा अलावे
more	अधिका
morning	भोर
mortgage	रैहन
mostly	ज्यादातर
most	अधिका
mother	माई
motion	गति
motivation	प्रैरणा
mountain	पहाड़
mouse	मूस
mouth	मुँह
movement	हरकत
move	चलल
movie	मूवी
mrs	सिरीमती
much	ढेर
mud	पांक
mug	लोटा
muscle	मांसपेशी
museum	संग्रहालय
mushroom	कुकुरमुत्ता
music	संगीत
must	जरूर
mute	गूंगा
mutual	आपसी
My dear	हमार जानेमन
my friend	हमार ईयार
My hovercraft is full of eels	हमार होवरक्राफ्ट ईल से भरल बा
my love	हमार मोहब्बत
my name is	हमार नांव हऽ
my pleasure	हमार सौभाग्य
myself	हम खुद
mysterious	रहस्यमय
mystery	रहस्य
myth	मिथक
my	हमार
nail	नाखून
naive	अनाड़ी
name	नांव
narrative	कहानी
narrow	पातर
nasty	बेहाया
nationality	राष्ट्रीयता
national	राष्ट्रीय
native	पैदाइशी
natural	स्वाभाविक
nature	चाल चलन
nausea	उबकाई
nearby	नियरा
nearly	लगभग
near	भीरी
neat	साफ सुथरा
necessary	जरूरी
necklace	हार
neck	गरदन
need	जरूरत
negative	नकारात्मक
neglect	उपेक्षा कईल
negotiate	मोल-भाव कईल
neighborhood	अड़ोस-पड़ोस
neighbor	पड़ोसी
neither	ना ई ना ऊ
nephew	भतीजा
nerd	पढ़ाकू
nervous	अउंजाइल
nest	घोंसला
network	नेटवर्क
net	जाल
neutral	बेपरवाह
never give up	कबो हार मत मानऽ
never mind	कवनो बात ना
nevermind	कवनो बात ना
nevertheless	तब्बो
never	कब्बो ना
news	खबर
new	नया
next to	एकरा आगे
next	अगिला
nice to meet you	रऊवाॅंं से मिलके अच्छा लागल ह
nice	सुंदर
niece	भतीजी
nightmare	खराब सपना
night	रात
nineteen	उनईस
ninety	नब्बे
nine	नौ
nobody	केहू ना
noise	शोरगुल
noisy	शोर
none	कवनो ना
noon	दुपहरिया
nope	ना
no problem	कवनो बात ना
normal	सामान्य
north	उत्तर
nor	आउर ना
nose	नाक
nostalgic	ईयाद में आतुर
not at all	बिलकुल ना
not bad	बुरा नईखे
noted	मशहूर
note	धेयान दीं
nothing	कुछु ना
noticed	ध्यान दिहल गईल
notice	सूचना
Not now	अबहिं ना
not yet	अभी तक ना
not	नाहीं
nouns	संज्ञा
noun	संज्ञा
novel	उपन्यास
november	नवंबर
nowadays	आजुकाल्हि
no way	बिलकुल ना
now	अबहिं
No	ना
nuisance	उपद्रव
null	कुछ ना
number	संख्या
numb	सुन्न पड़ गईल
nurse	नर्स
nutmeg	जायफल
nutrition	पोषण
nut	सनकी
oath	कसम
obesity	मोटापा
obey	कहना मानल
objective	उद्देश्य
object	वस्तु
obligation	बाध्यता
obscure	अस्पष्ट
observation	अवलोकन
observe	गौर से देखल
obsessed	भूत ध लिहल
obsession	जुनून
obsolete	अप्रचलित
obstacle	रूकावट
obtained	प्राप्त
obtain	पावल
obviously	सफ्फा-सफ्फा
obvious	स्पष्ट
occasionally	कबो-काल्ह
occupation	कार-बार
occupied	कब्जा कईल
occurred	भईल
occurs	होत बा
occur	होखल
ocean	सागर
october	अक्टूबर
odds	अंतर
odd	बिचित्र
of course	जरूरे
offensive	अप्रिय
offer	ऑफर
office	कार्यालय
official	अधिकारी
off	बंद
often	कई बारी
of	का
oh really	का सचहूं
Oh	ओह
oil	तेल
okay baby	ठीक बा जान
okay dear	ठीक बा, जान
okay honey	ठीक बा, जानेमन
okay my love	ठीक बा, जानम
okay	ठीक बा
ok dear	ठिक बा जानेमन
ok honey	ठीक बा जानेमन
ok my love	ठीक बा हमार जान
ok	ठीक बा
old	बूढ़
once	एक बार
one language is never enough	एगो भाखा कबो पर्याप्त ना होला
one	एगो
onion	पियाज
online	ऑनलाइन
only	खाली
on	ऊपरे
open	खुला
operation	संचालन
opinion	राय
opportunities	अवसर
opportunity	मौका
opposite	उल्टा
optimistic	आशावादी
optional	ऐच्छिक
option	विकल्प
orange	संतरा
order	आदेश
ordinary	सधारन
organization	संगठन
orientation	अभिविन्यास
original	असली
origin	मूल
Oromo	ओरोमो
orphan	अनाथ
or	अऊर
otherwise	ना त
other	दोसर
ought	कुछुओ
Our mission: to enable everyone, everywhere to understand the world and express themselves across languages.	हमनी के ध्येय: हर केहू के, हर दुनिया के समझे में अऊरी विभिन्न भाखा-बोली में खुद के अभिव्यक्त करे में समर्थ।
Our mission: to organize the world's information and make it universally accessible and useful.	हमनी के ध्येय: दुनिया के जानकारी के इकट्ठा कईल अऊरी एके सबे केहू खातिर सुलभ आ उपयोगी बनावल।
our	हमन क
outcome	परिणाम
outfit	पोशाक
outgoing	जाए वाला
outlet	दुकान
outline	रूपरेखा
outside	बहरी
outstanding	बाकी
out	बहरी
oven	भट्ठी
overall	कुल मिला के
overcome	काबू पावल
over there	उहवां
overthinking	जादा सोचल
overwhelmed	भाव में बहि गयिल
overwhelming	ज़बरदस्त
over	ऊपर
owe	कर्जदार होखल
owl	उल्लू
owner	मालिक
own	आपन
ox	बैल
pace	चाल
package	पैकेज
pack	पैक
paid	भुगतान भईल
painting	चित्र
paint	पेंट
pain	दरद
pair	जोड़ा
pale	फीका
palm	हथेली
pandemic	महमारी
panic	घबराहट
pants	पैंट
pan	कड़ाही
paper	कागज
paradise	स्वर्ग
parallel	समानांतर
parcel	पारसल
pardon	माफ करीं
parents	माई-बाप
park	पार्क
parrot	सुग्गा
parsley	अजवायन
participate	हिस्सा लिहल
particularly	खास तौर पर
particular	खास
partner	संगी
party	दल
part	अंश
passage	मार्ग
passed	बीत गईल
passionate	जोशीला
passion	सनक
passive	निष्क्रिय
password	पासवर्ड
pass	पास
past	अतीत
patch	चेपी
pathetic	दयनीय
path	राह
patience	धीर
patient	मरीज
pattern	परकार
pause	ठहराव
pavement	फुटपाथ
payment	भुगतान
pay	भुगतान
peaceful	शान्तिपूर्ण
peace	शांति
peach	आड़ू
peak	चोटी
pear	नाशपाती
peas	छेमी
peculiar	विशेष
peel	छाल
peers	संगी-साथी
peer	समकक्ष मनई
pee	पेशाब
pencil	पेंसिल
pending	फँसल
pen	कलम
people	लोग
pepper	काली मिर्च
perceive	महसूस कईल
perception	सोचावट
perfect	एकदम ठीकठाक
performance	प्रदर्शन
perform	तमाशा कईल
perhaps	शायद
period	अवधि
permanent	स्थायी
permission	अनुमति
permit	परमिट
perseverance	जिद
persistent	लगातार
personality	व्यक्तित्व
personal	व्यक्तिगत
person	आदमी
perspective	नजरिया
persuade	फुसुलावल
pervert	गुमराह मनई
pet	पालतू जानवर
phase	अवस्था
phenomenon	घटना
philosophy	दरसन
phone	फोन
photo	तस्वीर
phrase	मुहावरा
physical	भौतिक
pick up	उठावल
pick	चुनाई
picture	तसवीर
pieces	टुकड़ा
piece	टुकड़ा
pigeon	कबूतर
pig	सूअर
pile	ढेर
pillow	तकिया
pilot	पायलट
pineapple	अनानास
pink	गुलाबी
pin	पिन
pitch	अलकतरा
pity	मन पसीजल
pit	गड़हा
places	जगह
place	जगह
plague	प्लेग
plain	सादा
plane	हवाई जहाज़
plants	पौधा
plant	पवधा
plan	योजना
plate	थरिया
platform	मंच
playing	खेलल
play	खेला
pleasant	सुखद
pleased	प्रसन्न
please	कृप्या
pleasure	मजा
pledge	प्रतिज्ञा
plenty	भरपूर
plot	प्लाट
plug	प्लग
plumber	नलसाज
plum	बेर
plural	बहुचन
podcast	पॉडकास्ट
poem	कविता
poetry	कविता
point	बिंदु
poison	जहर
police	पुलिस
policy	नीति
polite	सरीफ
pollution	प्रदूसन
pond	तालाब
pool	कुंड
poop	गौली चलने के आवाज
poor	गरीब
popular	लोकप्रिय
population	आबादी
pop	पॉप
pork	सुअर के मांस
porridge	लपसी
port	बंदरगाह
position	दरजा
positive	आशावादी
possession	कबजा
possessive	केहू पर हक जताए वाला
possess	काबू कईल
possible	संभव
postpone	आगे पर टाल दिहल
post	डाक
potato	आलू
potential	संभावित
pound	बाड़ा
poverty	गरीबी
powerful	शक्तिशाली
power	जोर
practical	व्यावहारिक
practice	अभ्यास
praise	प्रशंसा
prank	शरारत
pray	प्रार्थना
precious	कीमती
precisely	ठीक-ठीक
precise	सटीक
predict	भविष्यवाणी कईल
preference	तरजीह
prefer	पसंद
pregnant	गभर्वती
prejudice	पूर्वाग्रह
premises	परिसर
premium	प्रीमियम
preparation	तईयारी
prepared	तईयार
prepare	तइयारी कयिल
preposition	पूर्वसर्ग
presence	उपस्थिति
presentation	प्रस्तुति
present	वर्तमान
preserve	सहेजी
president	राष्ट्रपति
pressure	दबाव
press	इस्तरी
pretend	बहाना बनावल
pretty	सुंदर
prevent	मना कयिल
previous	पिछिला
prey	शिकार कईल
price	दाम
pride	गुमान
priest	पुजारी
primary	प्राथमिक
prime	प्रधान
princess	राजकुमारी
principal	प्रधानाध्यापक
priority	परधानता
prior	पहिले
prison	जेल
privacy	गोपनीयता
private	प्राइवेट
privilege	विशेषाधिकार
prize	इनाम
probably	हो सके
problem	परेशानी
procedure	तरीका
proceed	आगे बढ़ऽ
process	प्रक्रिया
produce	उपज
production	उत्पादन
product	उत्पाद
professional	पेशेवर
profession	पेशा
profile	प्रोफाइल
profit	फायदा
profound	खोह
progress	आगे बढ़ल
project	परियोजना
prominent	महत्वपूर्ण
promise	वादा
promote	बढ़ावा दिहल
promotion	तरक्की
prompt	तत्पर
prone	औंधा
pronouns	सर्वनाम
pronunciation	उच्चारण
proof	सबूत
properly	अच्छा तरह से
properties	गुण
property	धन-दउलत
proper	ठीक
proposal	प्रस्ताव
prospect	संभावना
prosperity	संपन्नता
prosperous	समृद्ध
protect	बचावल
proud	गुमान
prove	साबित करऽ
provided	दिहल गईल
provide	देईं
province	प्रान्त
provision	प्रावधान
puberty	तरुनाई
public	जनता
pull	खींचल
pumpkin	कोंहड़ा
punctual	समय के पाबंद
pupil	छात्र
purchase	कीनल
pure	पवित्र
purple	बैंगनी
purpose	माने
purse	बटुआ
pursue	लागल रहल
pursuit	पीछा
push	धक्का
put	राखि दिहीं
qualification	योग्यता
quality	गुण
quantity	मात्रा
quarantine	कोरंटाइन
quarrel	झगड़ा
quarter	तिमाही
Quechua	केचुवा
queen	रानी
queer	विचित्र
query	पूछताछ
question	सवाल
queue	कतार
quickly	झट से
quick	झट से
quiet	शांत
quilt	तोशक
quite	बिल्कुल
quit	छोड़ीं
quiz	प्रश्नोत्तरी
quotation	हवाला
quotes	उध्दरण
quote	मोल लगावल
rabbit	खरगोश
race	दौड़
rage	उत्पाद
rain	बरखा
raised	उभरल
raise	पालल-पोसल
random	सतमेरवनी
range	रेंज
ran	धवले
rapidly	तेजी से
rapid	तेज
rarely	शायदे कब्बो
rare	दुलम
rash	चकत्ता
rate	भाव
rather	बल्कि
rational	तर्कसंगत
ratio	अनुपात
rat	मूस
raw	काँच
reached	पहुँच गईंनीं
reach	पहुँच
reaction	प्रतिक्रिया
reading	पढ़ल रहल बानी
ready	तइयार
read	पढ़ल
reality	असलियत
realized	एहसास भईल
realize	अहसास
really	सच्चो
real	वास्तविक
rear	पिछला
reasonable	यथोचित
reason	कारन
recall	ईयाद
receipt	रसीद
received	मिलल
receive	पायीं
recently	हाले में
recent	हाल के
reception	अगवानी
recipe	नुसखा
reckless	लापरवाह
recognition	मान्यता
recognize	चिन्हीं
recommended	अनुशंसित
recommend	सिफारिश कईल
record	दर्ज करीं
recovery	वसूली
recover	वसूल कईल
rectangle	आयत
redeem	धन दैकै छुड़ावल
redemption	करजा से मुक्ति
reduce	घटायीं
redundant	फालतू
red	लाल
reference	सिफारिश
refer	हवाला दिहल
reflection	प्रतिबिंब
reflect	प्रतिबिंबित भईल
refrain	बचल
refrigerator	फ्रिज
refund	धन-वापसी
refused	मना का दिहल
refuse	मना क दिहल
regarding	से जुड़ल
regardless	निफिकिर
regards	सादर
regard	लिहाज
region	इलाका
register	पंजी
regret	माफी
regularly	नियमत तैर पर
regular	नियमित
reject	नामंजूर कईल
related	जुड़ल
relate	संबंधित
relationship	रिस्ता
relatives	रिश्तेदार
relative	नातेदार
relax	आराम
released	रिहा
release	जारी कयिल
relevant	काम लायक
reliable	भरोसे लायक
relief	राहत
relieved	कार्यमुक्त
relieve	राहत मिलल
religion	धरम
religious	धार्मिक
reluctant	अनिच्छुक
rely	भरोसा कईल
remaining	बचल-खुचल
remain	लाश
remarkable	धेयान देबे योग्य
remedy	उपाय
remember	इयाद कयिल
reminder	रिमांइडर
remind	ईयाद दिलाईं
remote	दूर में स्थित
remove	निकालल
render	प्रस्तुत
rent	किराया
repair	मरम्मत
repeat	दुहरावऽ
replace	बदलीं
reply	जबाब
report	रपट
represent	प्रतिनिधित्व कईल
reputation	प्रतिष्ठा
request	निहोरा
required	जरूरी
require	जरुरत
rescue	बचाव
research	शोध
resemble	समान भईल
resentment	नाराजगी
reservation	आरक्षण
reserve	आारक्षित
resident	निवासी
resign	इस्तीफा दिहल
resilience	लचीलापन
resilient	लचीला
resistance	प्रतिरोध
resist	विरोध
resolution	समाधान
resolve	हल कईल
resort	सैरगाह
resources	संसाधन
respect	आदर
respond	जवाब दऽ
response	जबाब
responsibility	जिम्मेदारी
responsible	जिमेदार
restaurant	रेस्तरां
rest in peace	आत्मा के सदगति मिले
restore	बहाल कईल
restrict	रोकल
rest	आराम
results	परिणाम
result	नतीजा
resume	रिज्युम
retail	खुदरा
retain	बनवले राखीं
retention	रोक कै राखल
retired	सेवानिवृत्त
retreat	वापसी
retrieve	संबंधित
return	लउटल
revealed	परगट भईल
reveal	खुलासा
revenge	बदला
revenue	राजस्व
reverse	उलटाव
review	समीक्षा
revise	दोहराईं
revision	संशोधन
revolution	किरांति
reward	इनाम
re	दुबारा
rhythm	ताल
rib	पसली
rice	चाऊर
rich	धनी
ride	सवारी
ridiculous	बेहूदा
rid	छुटकारा दियावल
right now	अभिये
right	ठीक
rigid	सख्त
ring	अंगूठी
rinse	कुल्ला करऽ
riot	दंगा
ripe	परिपक्क
rip	फाड़ल
rise	उगल
risk	जोखिम
rival	प्रतिद्वंद्वी
river	नदी
road	सड़क
roast	भुनल
robust	मजबूत
rock	चट्टान
rod	छड़ी
role	भूमिका
roll	लपेटल
roof	छत
room	कमरा
root	जड़
rope	रसरी
rotten	सड़ल-गलल
roughly	सांढ
rough	खुरदुराह
round	गोल
route	रास्ता
routine	दिनचर्या
row	लाइन
rubber	रबर
rubbish	बकवास
rub	रगड़
rude	अकड़ू
rug	गलीचा
ruin	बरबाद
ruler	अपवाद
rules	नियम
rule	नियम
running	धावल
run	दउरीं
rural	गंवई
rush	भीड़भाड़
sack	थैला
sacred	पवित्र
sacrifice	त्याग
safe flight	सुरक्षित उड़ान
safety	सुरक्षा
safe	सुरक्षित
sage	साधू
said	कहलन
sailing	नोकायन
sail	समुद्री यात्रा
sake	खातिर
salary	वेतन
sale	बिक्री
salmon	सामन मछरी
salt	निमक
Same here	हमरे इहे कहनाम बा
same	ओइसने
sample	नमूना
sand	बालू
Sanskrit	संस्कृत
sarcastic	व्यंग्यपूर्ण
sassy	दबंग
satisfaction	संतुष्टि
satisfied	संतुष्ट
satisfying	संतोषजनक
satisfy	संतुष्ट भईल
Saturday	सनिचर
sat	सनिचर
sausage	सॉस
savage	बनेचर
save	बचावल
saw	लउकल
say	कहीं
scale	पैमाना
scam	धोखा
scarce	अपर्याप्त
scared	डेराइल
scarf	दुपट्टा
scary	डरावना
scar	चोट के निसान
scattered	छितराईल
scenery	नजारा
scene	द्रशय
scent	खुशब
schedule	सूची
school	स्कूल
science	बिग्यान
scientists	वैज्ञानिक
scientist	वैज्ञानिक
scissors	कईंची
scold	डांटल-फटकारल
scope	दायरा
score	स्कोर
scrap	रद्दी माल
scratch	खरोंच
scream	चीख
screen	स्क्रीन
screw	पेंच
script	लिपि
seal	मोहर
search	तलाशी
season	मौसम
seat	बईठे के जगह
sea	समुन्दर
second	दूसरा
secret	गुप्त
section	धारा
secure	सुरक्षित
security	सुरक्षा
seed	बीज
seek	माँगल
seems	बुझात बा
seem	जान पड़ल
seen	दैखनीं हं
see you later	बाद में फेर मुलाकात होई
see you soon	जल्दि फेर मुलाकात होई
see you tomorrow	काल्हि मिलल जाई
see you	फेर मिलेब
see	देखीं
seize	जब्त कईल
seizure	कब्जा
seldom	कब्बो कब्बो
select	चुनीं
self healing	खुद से उपचार
selfish	स्वार्थी
self	खुद
sell	बेचल
send me your picture	हमके आपन तसवीर भेजऽ
send	भेजीं
senior	वरिष्ठ
sense	होस
sensible	समझदार
sensitive	संवेदनशील
sentences	वाक्य
sentence	वाक्य
sent	भैजल गईल
separate	अलहदा
Sepedi	सेपेडी
september	सितंबर
sequence	अनुक्रम
series	श्रृंखला
seriously	गंभीरतापूर्वक
serious	गम्भीर
serve	चाकरी कईल
service	नौकरी
session	सत्र
setting	स्थापना
settle	बस जाईल
set up	सेटअप
set	सेट
seventeen	सतरह
seventy	सत्तर
seven	सात
several	कई गो
severe	गम्हीर
sew	टांकल
shade	छेंह
shadow	परछाई
shake	हिलल-डुलल
shallow	ओछा
shall	करिहें
shame	लाज
shape	अकार
share	बाँटीं
sharp	नुकीला
shed	छप्पर
sheep	भेड़
sheet	चादर
she has	ओकरा लगे
she is	ऊ हियऽ
shelf	ताखा
shell	सीप
shelter	सहारा
she	ऊ
shield	शील्ड
shift	बदलल
shine	चमक
shipping	शिपिंग
ship	जहाज
shirt	कमीज
shoes	जूते
shoot	गोली मारल
shopping	खरीदारी
shop	दुकान
shore	सागर के किनारा
shortage	कमी
short	नाटुर
shot	गोला
shoulder	कंधा
should	चाहीं
shout	शोर मचावल
shower	बौछार
show me	हमके देखावऽ
show	देखायीं
shrimp	झींगा
shrink	सिकुड़ल
shut up	चुप रहऽ
shut	बंद
shy	लजकोकड़
siblings	भाई बहिनी
sibling	एक पेट के जामल
sick	बेमार
side	भाग
sightseeing	दर्शनीय स्थल पर घूमल-फिरल
sight	जगहा
sigh	विलाप
signature	हस्ताक्षर
significant	बहुते महत्व वाला
sign	चिन्ह
silence	चुप्पी
silent	खामोश
silk	रेशम
silly	बउराह
silver	चांदी
similar	एके निहन
simple	साधारन
simp	भोला-भाला
simultaneously	संगे-संगे
sincerely	भवदिय
sincere	ईमानदार
since	तब से
singer	गायक
single	अकेला
sing	गावऽ
sink	डूबल
Sir	हुजूर
sister in law	साली
sister	बहिन
site	साईट
situation	हालत
sit	बईठऽ
sixteen	सोलह
sixty	साठ
six	छह
size	आकार
skills	कौशल
skill	कौशल
skinny	दुबला-पतला
skin	चमड़ी
skip	छोड़ दऽ
skirt	लहंगा
sky	आकास
slave	गुलाम
sleeping	सूतल बा
sleepy	निद्राल
sleep	सुतल
sleeve	आस्तिन
slice	टुकड़ा
slide	फिसल-पट्टी
slightly	तनी-मनी
slim	पातर
slip	पर्ची
slope	ढाल
slot	खांचा
slowly	धीरे-धीरे
slow	धीमा
small	छोट
smart	बनल ठनल
smell	गंध
smile	हँसी
smoke	धुआं
smooth	चिकन
snack	नाशता
snail	घोंघा
snake	साँप
snap	फोटो
snow	बरफ
soak	भिगोईं
soap	साबुन
sober	संयमी
soccer	फुटबाॅल
social	सामाजिक
society	समाज
socks	मोजा
so cute	बहुते नीक
so far	अब ले
software	सॉफ्टवेयर
soft	मोलायम
soil	मिट्टी
soldier	फौजी
sold out	बेचा गईल
sold	बिका गईल
sole	एकमात्र
solid	ठोस
solution	हल
solve	समाधान
somebody	केहू
somehow	केहू ना केहू तरह
someone	केहू
something	कवनो चीजु
sometimes	कब्बो कब्बो
some	कुछु
song	गीत
soon	हाली
sophisticated	परिष्कृत
Sorani	सोरानी
sore throat	गला में खराश
sore	घाव
sorrow	गम
Sorry	माँफ करीं
sort	क्रम में सजावल
sought	तलाशल गईल
soulmate	हमसफर
soul	आत्मा
sound	आवाज
soup	सूप
source	स्रोत
sour	खटाह
south	दक्खिन
so	एही से
space	जगह
spam	स्पैम
Spanish	स्पेनिश
span	अवधि
spare	फालतू
speak	बोलऽ
special	खास
species	प्रजाति
specific	बिशेस
spectacular	सानदार
speechless	अवाक
speech	बोलल
speed	चाल
spell	बोली
spend	खर्चा
spent	खरच कईले
spicy	मसालेदार
spike	खूंटा
spinach	पालकी के साग
spin	घुमावऽ
spirit	आत्मा
spit	थूकल
splendid	सानदार
split	तूरल
spoiled	बिगाड़ल
spoil	खराब कईल
spontaneous	सहज
spoon	चम्मच
spot	दाग
spouse	मरद-मेहरारू
spread	छितरायिल
spring	स्प्रिंग
square	चौकोर
squeeze	निचोड़ल
squid	ब्यंग
squirrel	गिलहरी
stable	स्थिर
stab	छरा भोंकल
stack	ढेर
staff	करमचारी
stage	मंच
stain	दाग
stairs	जीना
stake	दांव लगावल
stalk	रौबदार चाल
stall	दुकान
stamp	मोहर
standard	मानक
stand	ठाड़ रहऽ
started	सुरू हो गईल
start	चालू कयिल
starving	निराहार
star	तारा
statement	कहनाम
state	राज
station	स्टेशन
statue	मूर्ति
status	ओहदा
stay safe	सुरक्षित रहीं
stay	ठहरीं
steady	स्थिर
steak	मांस के टुकड़ा
steal	चुरावल
steam	भाप
steel	इस्पात
steep	खड़ा ढाल
stem	तना
step	कदम
stick	छड़ी
stiff	कठोर
still	फिर भी
stingy	कंजूस
sting	डंक
stir	हलचल
stock	भंडार
stolen	चोरी हो गईल
stomach	लाद
stone	पत्थर
stood	खड़ा भईल
stool	मचिया
stop	रूकीं
storage	भंडारण
store	दुकान
storm	तूफान
story	कहानी
stove	अंगीठी
straightforward	सीधा सादा
straight	सोझे
strain	खिंचाव
stranger	अजनबी
strange	अटपटाह
strategy	रणनीति
strawberry	स्ट्रॉबेरी
straw	भूसा
streak	लकीर
stream	बहल
street	गली
strength	जोर
stress	तनाव
stretch	फैलाव
strict	सख्त
strike	हड़ताल
string	डोरी
strip	पट्टी
strive	कोशिश कईल
stroke	झटका
strong	मजबूत
struck	टक्कर लागल
structure	ढांचा
struggle	संघर्ष
struggling	लड़ाई-झगड़ा
stubborn	ढीठ
stuck	अँटकल
student	छात्र
studying	पढ़ रहल बा
study	पढ़ाई-लिखाई
stuff	सामान
stunning	मन मोह लेबे वाला
stupid	मूरख
style	अंदाज
subject	बिषय
submission	जमा कईल
submit	जमा करीं
substance	पदार्थ
substitute	विकल्प
subtle	सूक्ष्म
succeed	कामयाब भईल
successful	सफल
success	सफलता
such as	जईसे कि
such	अइसन
suck	चूसल
suddenly	अचके
sudden	अचानक
suffering	दुख
suffer	कष्ट भोगल
sufficient	अनघा
sugar	चीनी
suggestion	सुझाव
suggest	सलाह
suitable	सही
suitcase	सूटकेस
suit	सूट
summary	सारांश
summer	गरमी
summit	शिखर
sum	जोड़
sunday	इतवार
sunny	धूपदार
sunset	सुर्यास्त
sunshine	सूरज कै रोशनी
sun	सूरज
superior	बेहतर
supervisor	सुपरवाईजर
super	बेहतरीन
supper	रात के भोजन
supply	सप्लाई
support	समर्थन
supposed	मान लिहल गईल
suppose	मान लीं
sure	पक्का
surface	सतह
surgery	सर्जरी
surge	हिलोर
surname	कुलनाम
surprised	चकित
surprise	अचरज
surrender	घुटना टैकल
surrounding	आस-पास
surveillance	निगरानी कईल
survey	सर्वे
survive	जियल
suspect	संदैहास्पद
suspended	मुअत्तल
suspicious	संदेह से भरल
sustainability	टिकाऊपन
sustainable	टिकाऊ
sustain	बनाए रखल
swag	पोटली
swallow	निगलल
swap	अदला-बदला
swear	कसम खाईल
sweater	सुईटर
sweat	पसीना
sweep	झाड़ू बुहारन
sweet dreams	रात बढ़िया बीतो
sweetheart	जानेमन
sweet tooth	मिठाई का चस्का
sweet	मीठ
swelling	सूजन
swell	फुलाव
swimming	तईरल
swim	तैराकी
swing	झूला
switch	स्विच
swollen	फूलल
sword	तलवार
symbol	प्रतीक
sympathy	सहानुभूति
symptoms	लक्षण
system	प्रणाली
table	टेबुल
tackle	निपटल
tag	घुंडी
tail	पोंछ
take away	ले जा
take care	ध्यान राखीं
taken	लिहल गईल
take off	उड़ान भरल
take	लेना
talkative	बातूनी
talk	बतियाईं
tall	लाम
tape	फीता
tap	नल
target	लक्ष्य
task	काम
taste	स्वाद
tasty	स्वादिष्ट
taught	सीखावल
teacher	गुरूजी
teach	सिखावल
team	टीम
tears	लोर
tear	आँसू
tease	शरारत
tea	चाय
technology	तकनीक
teeth	दांत
tell me	हमरा के बताईं
tell	कहीं
temperature	तापमान
temper	झुंझलाहट
temple	मंदिर
temporary	अस्थाई
tenant	किरायेदार
tendency	प्रवृत्ति
tender	टेंडर
tend	झुकल
tense	बेचैन
tension	तनाव
tentative	संभावित
ten thousand	दस हजार
tent	तंबू
ten	दस
terms	शर्त
term	मियाद
terrible	डरावन
terrific	भयानक
territory	क्षेत्र
test	परीक्षा
text	पाठ
Thanks for using our app	हमनी के ऐप इस्तेमाल करे खातिर धन्यवाद
thanks	धन्यवाद
Thank you for your patience while we investigate shipment	शिपमेंट जाॅंंच करे के समय रऊवाॅंं के सब्र करे के खातिर धन्यवाद
thank you so much	रउवा के बहुत बहुत धन्यवाद
thank you very much	राऊर खूब-खूब धन्यवाद
thank you	धन्यबाद
thank	धन्यवाद
than	के तुलना में
that is	यानी
that's good	ई अच्छा बा
that	ऊ
theft	चोरी भईल
their	उनकर
theme	विषय
themselves	ऊ लोग खुद
them	उहनी लोग
then	तब
theory	सिद्धांत
there are	उहवां
therefore	एही खातिर
there is	उहवां बा
there	ऊहाॅंं
these	ई
they are	ऊ लोग ह
they	ऊ
thick	मोट
thief	चोर
thigh	जांघ
things	सामान
thing	चीज
think	सोचीं
thin	पातर
third	तीसरा
thirsty	प्यासा
thirteen	तेरह
thirty	तीस
this is	ई ह
this	ई
thoroughly	विस्तार से
thorough	सुरू से अंत ले
those	उहनी लोग
thoughtful	सावधान
thoughts	विचार
thought	सोच
though	मगर
thousand	हजार
thread	धागा
threaten	धमकावल
threat	धमकी
three	तीन
threshold	दहलीज
thrilled	रोमांचित
thrive	उन्नति कईल
throat	गला
throughout	शुरू से अंत तक
through	जरिये
throw	फेंकीं
thumb	अंगूठा
thunder	गड़गड़ाहट
Thursday	बियफे
thus	एह तरी
tick	कुटकी
tide	ज्वार-भाटा
tidy	रूमाल
tie	कंठलँगोट
tiger	बाघ
tight	सकेत
Tigrinya	तिग्रिन्या
time	समय
timid	डरपोक
tiny	छोटहन
tips	सलाहर
tip	नोक
tired	थाकल
tire	टायर
tissue	ऊतक
title	हक
toast	टोस्ट
to be	होए वाला
today	आजु
toddler	बच्चा
toes	पांव के उंगली
together	साथे-साथे
toilet	पाखाना
told	कहनीं
tolerance	सहनशीलता
tolerate	बरदाश्त कईल
tomato	टमाटर
tomorrow	काल्हु
tongue	जीभ
tonight	आज के रात
took	ले लिहल
tools	उपकरण
tool	साधन
tooth	दांत
too	भी
topic	विषय
top	ऊपर
torn	फाटल
torture	यातना दिहल
total	कुल
touch	छूअऽ
tough	कड़ेर
tour	यात्रा
towards	के ओर
toward	का ओर
towel	तौलिया
town	शहर
toxic	बिसैला
to	खातिर
trace	निशान
track	डड़ार
trade	व्यापार
traditional	परंपरागत
tradition	परंपरा
traffic	यातायात
trail	रास्ता
training	प्रशिक्षण
train	रेल
traits	लक्षण
trait	विशेषता
transfer	स्थानांतरण
transition	अवस्थांतर
translate	अनुवाद
transparent	पारदर्शी
transportation	परिवहन
transport	परिवहन
trap	जाल
trash	कचरा
trauma	सदमा
travel	जतरा
tray	तश्तरी
treasure	खजाना
treatment	इलाज
treat	इलाज
tree	पेड़
tremendous	अद्भुत
trend	रूझान
trial	अजमावल
trick	चालाकी
tried	कोशिश भईल
trigger	ट्रिगर
trim	कांट-छांट कईल
trip	सैर
trouble	दिक्कत
trousers	पतलून
truck	ट्रक
true	सच
trunk	पेटी
trust	भरोसा
truth	सच्चाई
try	कोशिश करीं
Tsonga	त्सोंगा
tube	ट्यूब
Tuesday	मंगर
tuition	ट्यूशन
turkey	तुर्की
turmeric	हरदी
turn	पलट
turtle	कछुआ
tutor	अध्यापक
twelve	बारह
twenty-one	एकईस
twenty	बीस
twice	दु बेर
twist	मोड़
Twi	ट्वी
two	दु
type	किसिम
typical	ठेठ
ugly	बदरूप
ultimate	सर्वश्रेष्ठ
umbrella	छतरी
unable	असमर्थ
uncle	काका
unconscious	बेहोश
underneath	नीचे
underrated	कम आंकल
understand	बुझायिल
understood	समझ गईनीं
under	नीचे
unfortunately	दुर्भाग से
uniform	वर्दी
unique	खास
unit	इकाई
university	विश्वविद्यालय
unknown	अनजान
unless	जब ले ना
until	तबले
unusual	असामान्य
update	अपडेट
upgrade	तरक्की
upon	ऊपर
upset	परैसान
up to you	रऊआ प निरभर करत बा
up	ऊपर
urban	शहरी
urgent	तत्काल
urge	विनती
used	इस्तेमाल भईल
useful	उपयोगी
useless	निकम्मा
use	उपयोग
usually	हमेशा जईसन
usual	सामान्य
us	हमनीं के
utility	उपयोगिता
vacation	छुट्टी
vaccination	टीकाकरन
vaccine	टीका
vacuum	खालीपन
vague	डावांडोल
valid	वैध
valley	घाटी
valuable	कीमती
value	कीमत
variety	किसिम
various	कई गो
vary	अंतर भईल
vase	फूलदान
vast	व्यापक
vegetables	तरकारी
vegetable	तरकारी
vehicle	सवारी
vendor	बेचे वाला
venom	जहर
venture	उद्यम
venue	स्थल
verify	सत्यापित करीं
versatile	बहुमुखी
version	संस्करण
vertical	खड़ा
very good	बहुत बढ़िया
very	बहुते
vessel	पतीला
via	जरिए
vibes	सनसनी
vibe	महौल
vicious	बुरा
victim	पीड़ित
video	वीडियो
view	नजारा
village	गांव
villain	खलनायक
vinegar	सिरका
vintage	काफी पुरान गाड़ी
violence	हिंसा
violent	हिंसक
viral	वायरल
virgin	कुआंर
virtual	भर्चुअल
virtue	नैतिक गुन
vision	नजर
visit	मुलाकात
visual	दृश्य
vital	अहम
vivid	जीवंत
vocabulary	शब्दावली
voice	आवाज
void	सून्य
volume	मात्रा
volunteer	स्वंयसेवक
vomit	उलटी कईल
vulnerable	छुईमुई
wages	तनखाह
wage	वेतन
waist	कमर
waiter	वेटर
waiting	इंतजार करतानी
wait	रूक
wake up	उठऽ
wake	जाग जा
walking	घूमल
walk	टहलल
wallet	बटुआ
wall	भीत
wander	टहलल
wanna	चाहतानी
wanted	चाहत रहनी
want	चाही
wardrobe	अलमारी
warehouse	गोदाम
warm	गरम
warning	चेतावनी
warn	चेतावनी दिहल
warrior	योद्धा
war	लड़ाई
wash	धुलाई
waste	कूड़ा
watch	घड़ी
watermelon	तरबूजा
water	पानी
wave	लहर
way	राहि
weakness	कमजोरी
weak	कमजोर
wealthy	पईसा वाला मनई
wealth	मालदार
we are	हमनी का हईं जा
wearing	पहिनल
wear	पहिनल
weather	मौसम
we can	हमनि का कर सकिले जा
wedding	बियाह
Wednesday	बुध
weed	मोथल
weekend	सप्ताहांत
week	हप्ता
weight	वजन
weird	अजबे
welcome	स्वागत
welfare	कल्याण
well done	बहुत बढ़िया
Well	ठीक
went	गयिलन
west	पछिम
wet	गील
we	हम
whale	व्हैल
what about you	आपन सुनाईं
what are you doing now	रऊवाॅंं अबहीं का करत बानीं
what are you doing right now	अबहीं तू का कर रहल बाड़ऽ
what are you doing	का होता
what do you do for a living	रऊआ का काम करिलै
what do you do	रऊआ का करिले
what do you mean	राउर का मतलब बा
what do you want	तू का चाहत बाड़ऽ
whatever	जवन भी
what happened	का भयिल
what is this	ई का हऽ
what is your job	रऊआ का काम करिले
what is your name	राउर नाम का ह
what is	का ह
what's up	का हो रहल बा
what's your name	तहार नांव का हऽ
what	का
wheat	गेहूँ
wheel	चक्का
whenever	जब कबो
when	कब
where are you from	तू कहाॅं से बाट
where are you now	रऊआ अभी कहाँ बानीं
where are you	तू कहाॅंं बाट
whereas	जबकि
where do you live	रऊआ कहां रहिले
where is	कहां बा
where	कहाॅंं
whether	कौनो
which	कऊन
while	जब
whisper	फुसफुसाईल
whistle	सीटी
white	ऊजर
who are you	राउर परिचय
who is this	ई के हऽ
who is	के हऽ
whole	पूरा
whom	केकरा के
whose	केकर
who	कऊन
why not	काहे ना
why	काहें
wicked	उत्पाती
wide	चाकर
widow	मुसमात
width	चौड़ाई
wife	लुगाई
wild	जंगली
willing	चाहल
window	खिड़की
windy	तूफानी
wind	हवा
wine	शराब
winter	जाड़ा
win	जीत
wipe	पोंछल
wire	तार
wisdom	अकिल
wise	बुद्धिगर
wish you all the best	रऊआ के ढेर सारा सुभकामना
wish	चाह
witch	डाईन
withdrawal	निकासी
withdraw	निकालल
within	के भीतर
without	बिना
with	साथे
witness	गवाह
witty	विनोदपूर्ण
wolf	भेड़िया
woman	जनाना
women	जनाना
wonderful	गज्जब
wonder	गज्जब
won't	ना होई
won	जीत गईनीं
wood	लकड़ी
wool	ऊन
words	शब्द
word	शब्द
working	कामकाजी
work out	कसरत
work	काम
world	दुनिया
worm	कीड़ा
worn	पहिनल
worried	चिंतित
worry	चिंता
worse	बहुते खराब
worship	पूजा
worst	सबसे खराब
worth it	मूल्यवान
worthy	योग्य
worth	लायक
would	चाहिले
wound	घाव
Wow	बहुत अच्छा
wrap	लपेटाई
wrath	गुस्सा
wrist	कलाई
Write here	एहिजा लिख
write	लिखीं
writing	लिखल
written	लिखित
wrong	गलत
wrote	लिखनीं
yard	बाड़ा
yawn	जम्हाई
Yeah	हॅंं
years	साल
year	बरिस
yeast	खमीर
yellow	पियर
yell	चिल्लाईल
yes baby	हं जान
yes dear	हं जानेमन
yes honey	हँ ए जान
yes my love	हँ, हमार जान
yes of course	हं बिलकुल
yesterday	काल्हु (बीतल)
Yes	हॅंं
yet	अबही तक
yield	फायदा
you are beautiful	तू सुनर बाड़ू
you are so beautiful	तू बड़ा सुनर बाड़ू
you are welcome	राउर स्वागत बा
you are	तू हऊअ
you can	रउवा ले हो जाई
You know	रऊआ जानतानी
young	जवान
you're welcome	राऊर सोआगत बा
you’re welcome	राऊर सोआगत बा
yourself	रऊआ खुद
your welcome	राऊर सोआगत बा
your	तोहार
youth	जवान
you too	तूहूं
you	रऊवाॅं
yummy	स्वादिष्ट
zero	शून्य
