a	a
a little	Drus
a lot	aṭas
a lot of	aṭṭas n
abandon	as-yeǧǧ
abandoned	yettwaǧǧan
abide	Aqader
ability	tizmar
able	yezmer
about	azal n
above	nnig
abroad	deg tmurt n berra
absence	Agdal
absent	iɣab
absolutely	s tidet
absorb	Ytessu
abstract	tasleḍt
absurd	azulal
abundance	lɛewla
abundant	yesɛan aṭas
abuse	aẓekkeṛ
abuse	ẓekker
accent	weɣdebbu
accept	yeqbel
access	akeccum
access	akcem
accident	laksida
accommodation	asmeckiked
accomplish	afen
accomplished	Ykemmel
according	Ɣef leḥsab
account	amiḍan
accuracy	iṣeḥḥa
accurate	d tin n tidet
accused	Yetthem
ache	yeqreḥ
ache	leqriḥ
achieve	ad yaweḍ
achievement	Yuweḍ s iswi
acknowledge	Yesteɛṛef
acquaintance	tamusni
acquire	ad d-tawiḍ
acquired	yeṭṭfen
acquisition	Ajnaw
across	deg tama
act	asagber
action	axeddim
active	yezwer
activities	Leqdicat
activity	leqdic
actor	asegbar
actual	Tura
actually	s tidet
acute	Anamsad
adapt	d-temyezg
add	rrnu
addicted	Yemlek-ik
addition	asnerni
additional	yerna
address	azen
adequate	yessefken
adjacent	tajaṛet
adjective	Arbib
adjust	Iqeɛɛed
admire	Tḥemmel
admit	qbel
adopt	yettwasmemmi
adorable	yessewhamen
advance	azwer
advance	zwir
advanced	tizwirt
advantage	tagnit
adventure	asurif
adverb	amernu
advertisement	adellel
advertising	adellel
advice	anṣaḥ
advise	Yenṣeḥ
advocate	amsedday
aesthetic	icbeḥ
affair	temsalt
affect	sikec
affection	tayri
afford	as-yefk
affordable	yesɛan azal
afraid	yugad
after	deffir
afternoon	tameddit
afterwards	sakkin
again	ɛawed
against	mgal
age	leɛmer
agency	tasemsert
agent	ameggi
aggressive	yesseḍ
agile	Icrir
ago	zik
agree	qbel
agreement	amtawa
agriculture	Taffelaḥet
ahead	sdat
aid	ɛiwen
aim	iswi
air	aḍu
airport	anafag
aisle	abrid
alarm	Asakay
alcohol	ssker
alert	nebbeh
alive	yedder
all	akk
all right	Ulac aɣilif
all the best	ayen yelhan akk
allow	ǧǧet
allowed	yettunefk
almost	qrib
alone	awḥid
along	s ttul
already	yakan
Alright	bxir
also	ula d
alternative	afran
although	ɣas akken
always	dima
am	nekk
amazing	yessewhamen
ambiguous	timsullest
ambition	tilisa
ambitious	yesεan asirem
amend	beddel
amid	Gar
among	gar
among us	gar-anaɣ
amount	azal
amusing	yesdehha
an	d
analysis	asekkuḍ
ancestors	imawlan
anchor	Agelzim
ancient	aqdim
and	akk-d
and you	I kecc
angel	lmelk
anger	urfan
angle	Tiɣmert
angry	ifeqeɛ
animal	iɣersiwen
ankle	taweṭzit
anniversary	amuli
announcement	Aberriḥ
annoy	naqem
annoyed	yettqelliq
annoying	yetǧini
annual	Yal aseggas
anonymous	Udrigen
another	wayeḍ
answer	tiririt
answer	Err
anticipate	heggi iman-ik
anxiety	leɣṣeb
anxious	yettḥebbiṛ
any	kra yellan
anymore	nnig waya
anyone	kra n yiwen
anything	ula yiwen
anyway	Akken yebɣu yili
anyways	aken yebɣu yili
apart	Menɣir
apartment	Axxam
apologize	ssuref fell-as
apparent	azedi
apparently	iban-d
appeal	asuter
appear	ad d-iban
appearance	udem
appeared	yetban
appetite	tilisa
apple	tteffaḥ
application	aseqdec
apply	aseqdec
appointment	asebded
appreciate	ḥemmel
appreciation	ackar
approach	iqerreb
approach	lqrib
appropriate	igwulmen
approval	Yeqbel
approve	yeqbel
approved	iwufeq
approximately	azal n
april	Yebrir
arbitrary	Ddreε
architect	Amasdag
architecture	Tasegda
archive	amyag
are	llan
are you	d kečč
are you busy	Tceɣleḍ
are you married	tezweǧeḍ ?
are you married or single	Tzewǧeḍ neɣ ur tzewǧeḍ ara?
Are you still there?	mazal-ik din?
are you there	Tellaḍ din?
area	tamnaḍt
argue	Ttnaɣeɣ s wawal
argument	ajadel
arise	Nulfu
arm	selaḥ
army	Tazemmalet
around	zzin - d
arrange	iṣeggem
arrangement	assemsawi
arrival	Aggad
arrive	aweḍ
arrived	yewweḍ-d
arrogant	zuxx
arrow	tneccabt
art	taẓuri
article	amagrad
artificial	asnulfu
artist	anaẓur
as	am
as long as	anect
as well	ula d
as well as	am akken
ash	aɣed
ashamed	yettsetḥi
ask	steqsi
asked	Yseqsa
asleep	tnafa
aspect	tamuɣli
Assamese	Asams
assault	yemmeɣ
assembly	agraw
assertive	Sentem
assess	ad d-tḥesseḍ
assessment	aseɣti
asset	Ameskar
assets	cci
assign	efk
assignment	asebter
assist	Allel
assistant	amalal
associate	ameddakel
associated	imeddukal
association	tiddukla
assume	ad as-tiniḍ
assumption	asali
at	deg
at least	meqqar
ate	yečča
athlete	anaddal
attach	Yeqqen
attached	yettwaṭṭfen
attachment	Asbad
attack	Aẓdam
attempt	yeεreḍ
attempt	taεreḍt
attend	ad d-yawi
attendance	Tilin
attention	afad
attitude	addud
attract	d-jebdeɣ lwelha
attraction	yetɛeǧǧben
attractive	yessewhamen
attribute	Ayla
audience	agdud
august	ɣuct
aunt	ɛemmi
aunty	xali
authentic	d tin n tidet
author	amaru
authority	adabu
autumn	lexrif
available	illa
average	amḍan
avoid	xḍu
awake	yuki
award	arraz
aware	yesnen
awareness	tamusni
away	yebɛed
awesome	yelha
awful	d ayen n diri
awkward	Ur yesɛi lmeɛna
Aymara	Aymara
baby	agrud
bachelor	ambur
back	ɣer deffir
background	Tazrawt
bad	yir
bag	asga
bait	tceṛkeţ
bake	Yesseway
bakery	taḥanut
baking soda	soda n lɣella
balance	semnekni
balance	amennekna
ball	takurt
Bambara	Bambara
banana	tabanant
band	tarabbut
bang	azlam
bank	Lbanka
bar	lbaṛ
barely	ɣas kan
bargain	amennuɣ
bark	Yesseglef
barley	taẓegwa
barrier	Zzerb
base	ireṣṣan
based	ters
basement	aderbuz
basic	agejdan
basically	Deg llsas
basil	leḥbeq
bastard	Aɛeṭṭay
batch	taffa
bath	abduz
bathroom	elhmam
battery	iẓra
battle	Amennuɣ
bay	tamda-nni.
be	ili
be careful	s ttawil
beach	lebḥar
beam	aberg
beans	tadlaxt
bear	Ursu
bear	yebib
beard	tamart
bearing	Asebdad
beast	aɣersiw
beat	awwet
beat	acala
beautiful	icbeḥ
beauty	cbaḥa
became	yuɣal
because	axaṭar
become	yuɣal
bed	usu
bedroom	taxxamt n yiḍes
bee	Tizizwit
beef	aksum
been	yella
beer	tabyirt
before	uqbel
began	yebda
begin	yebda
beginning	tazwara
behalf	S yisem
behave	Seggem
behavior	tikli
behaviour	tikli
behind	deffir
being	d win yellan
belief	Ayen yettamen
believe	amneɣ
belly	Aεebbuḍ
belong	d ayla
beloved	ɛziz
below	ddaw
belt	tabagust
bench	Aɣalad
bend	ikennu
beneath	ddaw
benefit	abaɣur
benefit	rez
benefits	yesfayden
beside	ɣer tama
besides	ar tama
best	ayen yelhan
best of luck	afud igerzzen
best regards	azul aḥmayan
better	axir
between	gar-asen
beverage	tissit
beyond	deffir
Bhojpuri	Bhojburi
bias	neḥwaz
biased	Yezga
bicycle	asnasɣal
bid	Ssarameɣ
big	ameqqran
bike	Tasnasɣalt
bill	tafatuṛt
bind	Tuqna
bird	Afrux
birthday	amuli
bit	cwiṭ
bite	kerrec
bite	akerric
bitter	Rẓag
black	aberkan
blade	Tazzit
blame	aεezzer
blame	εezzer
blank	d ilem
blanket	amcum
blast	Ifelɛes
bleach	Asemlal
blend	Xleḍ
bless	ibarek
blessed	yettwaberken
blind	d aderɣal
bliss	Tumert
block	yergel
blood	idammen
bloom	yeǧǧuǧeg
blow	suf
blue	azegzaw
blunt	Sseḥfa
board	tafelwit
boat	taflukt
body	tafekka
boil	Sserkem
bold	idammen
bond	akmas
bone	iɣes
book	snegmed
book	adlis
boost	antag
boost	njeε
booster	amsedday
boot	asenduq n tkeṛṛust.
boots	ibuzgen
border	tilisa
bore	abruj
bored	yeɛyat
boring	yessexlaε
born	ilul
borrow	ad t-reḍḍleṭ
boss	amεellem
both	isin
bother	yecɣeb
bottle	tqerɛunt
bottom	daw
bought	yuɣ
bounce	Neggez
bound	yeqqnen
boundaries	Aymir
bow	tanzed
bowl	aqessul
box	Asenduq
boy	aqcic
boyfriend	amdakel
bracelet	Tamesyast
brain	allaɣ
branch	ufurk
brand	azemz
brave	yesɛan tabɣest
breach	Taruzi
bread	aɣrum
break	taruzi
break	yerrez
breakfast	imekli n tṣebḥit.
breast	tedmart
breath	tneffes
breathe	ad tneffsed
breed	igellu
brick	Lajjur
bride	tislit
bridge	Tileggit
brief	ssewzel
bright	yeṣfa
brilliant	yessewhamen
bring	awi-d
bro	A gma
broad	hraw
broadcast	Brudkast
broke	Yerrez
broken	yerẓen
broom	tamedwazt
brother	gma
brother in law	mmi-is n uḍeggal
brought	awid
brown	aqehwi.
brush	Tmecceḍ
bucket	Abelyun
buddy	ameddakel
budget	ameṣruf
bug	abeɛɛuc
build	Lebni
building	asebnu
built	Ybennu
bulk	amur ameqqran
bull	azger
bully	aḥeqqar
bump	afelliq
bunch	Kra
bundle	tazdemt
burden	taεkemt
burden	εebbi
buried	yettwamḍel
burn	tmes
burst	amgerrad
bury	Yemḍel
bus	asakac
bush	igissi n taɣat
business	axeddim
bust	amgerrad
busy	yeɛmer
but	maca
butter	udi.
butterfly	aferṭeṭṭu
button	Taqeffalt
buy	ad d-taɣeḍ
by	sɣur
by the way	aḥeqa
bye	ar timlilit
cabbage	akrembiḍ.
cabinet	Ajmir
cage	Tagerbit
cake	lgaṭu
calf	tafunast
call	tiɣri
call me	Siwel-iyi-d
called	yessawel
calm	yerked
came	Yusa-d
campaign	tawayt
can	tizmar
can	yezmer
can't	ur zmireɣ ara
Cancel	yekkes
cancer	akensir
capable	yesεan tallalt
capacity	tazmert
capital	tamanɣt
caption	azwel
capture	Ḍḍfeɣ-d
car	takeṛṛust
career	axeddim
careful	ḥader
carefully	s leḥder
careless	Yestehza
caring	aseḥbiber
carpenter	amisɣar
carpet	taṛakna
carrot	Zrudiya
carry	tudema
carry on	Kemmel
carry out	Uqqem
case	tamsalt
cash	Ixelleṣ s idrimen
cast	ţţegger
castle	teɣremt
casual	s tagnit
cat	amcic
catch	ṭṭef
category	taggayin
cattle	lmal
caught	yettwaṭṭfen
cause	sebba
cause	yeɣra
caution	ḥadret
cautious	Yetḥadar
cave	tenɣert
cease	teḥbes
ceiling	afella
celebrate	asfugel
cell	Taxibat
center	talemmast
century	lqern
cereal	yimendi
ceremony	tafugla
certain	iban
certainly	s tidet
certificate	aselkin n tgezzayt
chain	tiselselt
chair	akersi
challenge	ḥazem
challenge	acqirrew
chance	asirem
change	abeddel
chaos	amennuɣ
character	azamul
characteristics	ismal
charge	agga
charity	taẓallit
charming	yessewhamen
chart	Ameskan
chase	tebɛen
chat	yetqeṣṣir
cheap	ɣlay
cheat	yettkellix
cheating	yettkellix
check	asefqed
check	sefqed
cheek	laḥnak
cheer	ssebɣes
cheerful	yesferḥen
cheers	ssebɣas
cheese	ayet
chemistry	takrura
cherish	ɛziz
chess	icahen
chest	aglim
chew	Tufẓa
chicken	ayaziḍ
chief	d aneḥkam
child	agrud
childhood	temẓi
children	arrac
chill	semmeḍ
chill	asemmiḍ
chimneys	isekkilen
chin	tamart
chocolate	ccikula
choice	lxetyar
choose	xtir
chop	Gzem
chores	leqdic n wexxam
chubby	acaṛan
church	teklizt
cinnamon	Lqerfa
circle	tawinest
circumstances	tegnit
citizen	Aɣerman
city	tamdint
claim	tuttra
clarify	yessefhem
class	tneɣrit
clay	yideqqi.
clean	zeddigen
clear	yesfeḍ
clear	zedig
clerk	anawur
clever	ameḥruc
client	yemsaɣen-nneɣ
cliff	Acṛuf
climate	Anezwi
climb	afud
clingy	Amaltaɣ
clock	amasrag
close	ɣleq
closet	texzant
cloth	Acettiḍ
clothes	iceṭṭiḍen
cloud	isighina
cloudy	d asigna
clown	Aferkus
clue	takti
clumsy	yetqelleq
cluster	tagrumma
coach	asleɣmay
coach	sluɣmu
coal	ireg
coast	rrif n yilel
coat	akebbuḍ
coffee	lqahwa
cognitive	Awessun
coincidence	D zzheṛ kan
cold	ssemeṭ
collapse	iɣelli
collar	iri
colleague	ameddakel
colleagues	imdukal
collect	ad d-tekkes
collection	telkensit
college	tasdawit
color	Ini
colorless green ideas slept furiously	tiktiwin tizegzawin ur nesεi tiɣmi ṭṭsen s wurrif
colour	ini
column	Ajgu
comb	timceḍt
combination	Asafar
combine	asdukkel
come	arwaḥ
come here	aya-d ɣer d-a
come on	amazrar
comfort	Ari
comfortable	yesɛa lehna
coming	Yettaweḍ-d
coming soon	Qṛib ad d-yaweḍ
command	Iḍebbir
comment	yiwenniten
commercial	ttjaṛa
commission	aseɣlef
commit	Egg
commitment	iseḍsay aṭas
committed	yeṭṭef
commodity	Alzazen
common	amaynut
communicate	asmmeslay
communication	tasmilt
community	tasdukla
commute	abrid
companion	Ameddakel
company	taggayt
compare	semsawi
comparison	quren
compassion	leḥnana
compassionate	arufi
compatible	yemṣada
compete	Yettekkay
competent	Yeẓweṛ
competition	Amsazwar
competitive	teɣdirawt
complain	d-yettcetkin
complaint	accetki
complement	ţamɛiwent
complement	ɛiwen
complete	akmmel
completely	akkit
complex	Asemlal
compliance	iga
complicated	Yewɛeṛ
compliment	tajmilt
comply	Rewes
composition	Tira
compound	ameskan
comprehension	Tigzi
comprehensive	amatu
compromise	surdu
compromise	issurduyen
compulsory	tamelzumt
computer	aselkim
concentrate	ţṛekzeḍ
concept	takti
concern	yuggad
concern	ugur
concerned	yettwaḥsab
concert	abaraz
conclusion	Taggara
concrete	ssiman
concrete	akmam
condition	ccerḍ
conditions	tiweltin
conduct	tanehrawet
conference	Asarag
confess	Yestaɛṛef
confidence	laman
confident	yettkel
confirm	sseknemt
conflict	amennuɣ
confused	yexlef
confusion	arway
congrats	Ayyuz
congratulation	Mebruk
congratulations	ayyuz
conjunction	taseftit
connect	Qqen
conquer	Amez
conscious	yesɛan tamusni
consciousness	tamusni
consent	yeqbel
consent	amsefham
consequences	tinalkamin
conservation	aḥraz
conservative	Amagaz
consider	meggez
considered	Iɣil
consist	llan deg-s
consistency	imwalam
consistent	llan
constant	amedya
constantly	dima
constipation	Tuqeft
construction	lebni
consume	Suder
consumption	Asseqdec
contact	nermes
contact	anermis
contagious	ineṭṭeḍ
contain	yesεan
contains	yesεa
contemporary	amaynut
contempt	aḥqar
content	agemmay
contest	Amsizwer
context	usatal
continent	Amenẓaw
continue	kemmlet
contract	sedres
contract	agatu
contrast	agdel
contrast	segdel
contribute	yettekka
contribution	yettekka
control	tḥekm
controversial	Amhawer
convenience	amtawa
convenient	yessefken
conversation	ameslay
convert	abeddel
convert	ybeddel
convey	Ţţawin
convince	Yesseqneɛ
convinced	Yesseqneɛ
cook	niwel
cook	nwal
cooking	nwal
cool	yelha aṭas
cool	semmeḍ
cooperation	Amedhel
cope	neɣleb
copper	Neḥas
core	Ul
corn	akbal
corner	teɣmert
correct	d ayen yelhan
cost	suma
costume	ayrid
cottage	Axxam
cotton	Tabduɣt
couch	akanapi
cough	Tusut
could	yezmer
council	Aseqqamu
count	leḥsab.
counter	tamasragt
country	tamurt
countryside	tamurt
couple	sin
courage	tabɣest
course	asurif
court	tanzarfit
courtesy	leḥdaqa
cousin	miss n ɛemmi
cover	taduli
cow	tafunast
coward	yttagad
cozy	yesεan lehna
crab	ḥenneqric
crack	Yeṭṭerḍeq
craft	Tindi
crap	Iẓẓan
crash	asehwu
crash	yeɣli
craving	Yetcihwa
crawl	yettmurud
crazy	Selbeɣ
create	asnulfu
creative	ameslal
credit	aṛḍal
creep	ufuḥan
creepy	yefjeε
crew	Imaslaḍen
crime	imenɣi
cringe	skerwec
cringe	yeskrwic
crisis	Tazɣent
criteria	timsal
critical	yekkat deg
criticism	anqad
crop	Lɣella
crops	lɣella
cross	mideg
cross	amidag
crow	Agaref
crowd	lɣaci
crowded	yeččur
crown	aqacuc
crucial	yesεan azal ameqqran
cruel	leqseḥ
cruise	aḥewwes
crush	yefcel
crush	εfes
cry	yettru
cucumber	axyar
cuddle	asiger iɣallen
culture	tadelsa
cunning	tiḥrci
cup	taqbuct
cupboard	asalu
curb	Tarkent
cure	asafar
cure	yejji
curfew	asmi ara d-yeffeɣ lḥal
curiosity	Lekluf
curious	d ameslay
curly	ikeṛṭuṭef
currency	tadrimt
current	assaɣ
currently	deg tallit
curse	yenɛel
curtain	asaber
cushion	tsumta
custom	asmel
customer	amsaɣ
customs	Amsaɣ
cut	igezzem
cut	agezzum
cute	d ayen icebḥen
cycle	asnasɣal
cycling	Anehaṛ n usnasɣal
dad	baba
daddy	baba
daily	yal ass
dairy	ayefki
dam	Aggug
damage	yetwaɣ
damage	atwaɣ
damn	Ay aɛeffan
damp	Bzeg
dance	ccḍeḥ
danger	amihi
dangerous	yuεer
dark	aberkan
darling	ay aḥbib
dash	azzel
data	Isefka
date	azmez
date	ttiεad
daughter	yelli-s
day	ass
dead	yemmut
deadline	Amenḍar
deaf	aɛeẓẓug
deal	alhu
deal	lqdic
dear	ay aḥbib
Dear All	Ay atmaten ɛzizen
Dear Customer	amseqdac aḥbib
Dear Parents	ay imawlan aεzizen
Dear Sir	i mass
Dear students	i yinelmaden
Dear Team	i terbaεt
death	lmut
debate	Askasi
debit	azenzi
debris	Iceqfan
debt	ḍḍlaba
decade	Aseggas
decay	yeţdumu
deceased	Yemmut
deceive	iɣuṛṛ
december	dujember
decent	yeḥdeq
decide	ad d-tefriḍ
decided	neɛzem
decision	rray
deck	tiqenṭert
decline	nnger
decrease	semẓi
dedicated	yettunefken
dedication	Abuddu n teṛwiḥt
deed	Agi
deep	lqayen
deer	taferka
default	amkan ur nettwassen
defeat	aneɣluy
defeat	sefsu
defend	aḥuddu
define	sebeyen
definitely	s tidet
definition	tabadut
degree	Agerdas
delay	leɛḍil
delay	wexxren
delayed	Iɛeḍḍel
delete	ssukkes
deliberate	S tmeɛmada
delicate	Imikri
delicious	benin
delight	Azwet
delighted	S tumert
deliver	isellek
delivered	Yezuzer
delivery	asefk
demand	asuter
demand	ysuter
demanding	asuter
democracy	tugdut
demon	irin
demonstrate	sseknen
denied	Yugi
density	Tuzeret
dentist	amejjay n tuɣmas
deny	ad tnekreḍ
department	aseqqamu
departure	ṛṛwaḥ
depend	yeqqen
deploy	Fser
deposit	asersay
deposit	sers
depressed	yeffeɣ-it leɛqel
depression	sneɣnayen
depth	Talqayt
describe	aglam
description	aglam
desert	tanezruft
deserve	yuklal
design	nherwel
designation	Asras
desire	yessaram
desire	lebɣi
desk	Tanarit
despair	Tulza
desperate	tuyes
despite	ɣas akken
dessert	taseggrit.
destination	amḍiq anda teddut
destiny	lmektub
destroy	yessenger
destruction	nnger
detail	ttefṣil
details	ttfaṣil
detect	yetfiq
determination	aɛewwel
determine	afen
determined	yettwasnen
devastated	yetwaɣ
develop	asnulfu
developed	yesnefli
development	asnerni
device	allal
devil	Ciṭan
devoted	Zeggu
Dhivehi	Divehi
diabetes	aṭṭan n sskeṛ
diarrhea	Tuzzel tɛebbuḍt
diary	aɣmis
dictionary	amawal
did	yexdem
die	yemut
died	Yemmut
diet	rrijim
difference	Amgared
different	imxalaf
difficult	yuɛer
dig	ad d-tekkes
dignity	lḥerma
diligent	Ameḥruc
dinner	imensi
dip	tubbɣa
direct	srid
direction	direction
director	Anemhal
dirt	ammus
dirty	yexnuness
disable	aɛiban
disabled	aɛiban
disappear	yeffeɣ
disappointed	yexṣem
disaster	d axeṣṣaṛ
discard	aḍegger
discharge	ssuffɣen
discipline	ţṛebga
discount	Yeneqqes
discover	Yufa
discrimination	afraz
discuss	mmeslay
discussion	Ameslay
disease	aṭṭan
diseases	aṭṭanen
disguise	yelsa-d amzun
disgusting	amcum
dish	aḍebsi
dishes	iqbac
dismiss	ggumma
dispatch	asufeg
display	askan
disposal	Aheggi
dispute	amennuɣ
distance	mebɛid
distinct	amgarad
distinguish	amgired
distress	Cedda
distribution	afraq
district	taɣiwant
disturb	Yettcewill
ditch	targa
dive	Neggez
diverse	yal ṣṣenf.
diversity	amgarad
divide	bḍu
divine	n Ṛebbi
divorce	berru
divorce	yebra
dizzy	yemlilli
do	xdem
do you	neɣ ala
do you love me	tḥemmeld-iyi?
doctor	ṭṭbib
document	taftart
does	yes-s
doesn't	ur d-yettili ara
dog	aydi
Dogri	Dugri
doing	yexdem
doll	tapupilt
domain	agmuḍ
domestic	n wexxam
dominant	Teḥkem
don't	Ur tt-ttarra ara
Don't worry	Ur ttqelliq ara
donate	aṣeddeq
done	ifukk
donkey	aɣyul
dope	Zeṭla
double	uslig
double	aslag
doubt	ycuk
doubt	ccek
dough	Arekti
down	ɣer lqaɛa
download	Ssigez
draft	asenfar
draft	aru
drag	zzuɣureɣ
drain	asuf
drama	tamuggit
draw	arrsam
drawer	leqjer
drawing	Ssuneɣ
dread	Afjaε
dream	argu
dream	targit
dress	taqendurt
drill	taseflut
drink	tissit
drink	sew
drive	yenheṛ
drop	yeɣli
drop	timeqqit
dropped	Yhewwed-d
drought	taɣart
drunk	Yeswa
dry	yekkaw
duck	abṛik
dude	ay ameddakel
due	lḥeq
due to	imi
dull	d amcum
dumb	ungif
dump	Akamyun
duration	tallit
during	deg
dust	aɣebbar
duty	lwajeb
dwell	yezdeɣ
dying	Yettmettat
each	yal yiwen
each other	wa ɣer wayeḍ
eager	yesɛan lebɣi
eagle	Igider
ear	Amẓẓuɣ
earlier	zik-nni
early	zik
earn	rebḥ
ears	Imeẓẓuɣen
earth	akal
earthquake	tzenzelt
ease	tasusmi
easily	s tefses
east	asammar
easy	ishel
eat	ačč
eating	tuččit
economic	Admis
economy	tadamsa
edge	rrif
edit	ẓreg
education	aselmed
effect	asemdu
effective	yesɛan azal
efficiency	afud
efficient	yesɛan azal
effort	afud
egg	tamellalt
eggplant	batenjal
ego	iman-iw
eight	tmanya
eighteen	mraw d ṭam
eighty	ṭam n tmerwin
either	neɣ
elaborate	asnulfu
elbow	teɣmert
elder	amɣar
elderly	Amɣar
elegant	yelha
element	Aftus
elephant	ilu
eleven	Mraw d yiwen
eligible	yesεan azref
eliminate	yekkes
else	ayen nniḍen
embarrassed	ḥeccmeɣ.
embarrassing	leḥṛis
embrace	qbel
emerge	Sifrir
emergency	yeεǧel
emotional	Yetḥulfu
empathy	lɣiḍ
emphasis	tilawt
emphasize	yettḥettit
employee	axeddam
employees	ixeddamen
employer	anemhal
employment	axeddim
empty	ilem
enable	yezmer lḥal
encounter	Yemlal
encourage	sselhu
end	taggara
endangered	deg umihi
endeavor	Ifadden
endurance	Tazidirt
endure	yesɛan ṣṣbeṛ
enemy	aεdaw
energy	tazmert
engage	Yexḍeb
engaged	Yexḍeb
engagement	lexḍubeyya
engine	amutur
engineer	ajenyur.
English	Taglizit
enhance	yesnerni
enjoy	ɛǧeb-as
enormous	ameqqran
enough	icaṭ
ensure	ad d-yefk
enter	kecmet
entertainment	zzhu
enthusiasm	azɣal
enthusiastic	yetḥmes
entire	akk
entitled	azref
entity	Amsari
entrance	unekcum
entrepreneur	imεellm
envelope	tabrat
environment	tiwennaḍin
envy	tismin
epic	timelḥemt
epidemic	tasakrart
equal	amzun
equipment	allal
equity	amur n tnefsit
equivalent	kifkif
eraser	Sefeḍ
error	tuccḍa
escape	Tarwla
especially	ladɣa
essay	tṣeddart
essence	Tumast
essential	yessefk
establish	asebded
established	yettwasbedd
estate	uɣeggad
estimate	asugen
estimated	azal n
etc	atg
eternal	amud
ethics	taɣema
evaluate	asmuqqel
evaluation	aseɣti
even	ula d
even though	ɣas akken
evening	tameddi
event	tedyant
eventually	taggara
ever	yal ass
every	yal
everybody	medden akk
everyone	akk
everything	kra yelan
evidence	issekniyen
evil	yir
evolution	Timerni
evolve	yenrna
Ewe	Ew
ex	ameddakel n zik
exact	Swaswa
exactly	swaswa
exam	Akayad
examine	ttmuqul
example	Amedya
exceed	yugar
excellent	yelha
except	siwa
exception	ala
excess	asṭuqqut
excessive	sṭuqqut
exchange	abeddel
excited	Seqlileḥ
excitement	Anbac
exciting	yessewham
exclusive	amagaz
excuse	ssuref-iyi
excuse me	Ssuref-iyi
execute	Uqqem
execution	Taselkemt
executive	amḍebber
exercise	Lɣem
exercise	alaɣmu
exhaust	Ffaggweɣ
exhausted	yeɛya
exhibit	Timzikent
exhibition	Timzikent
exist	yella
existence	Tilawt
existing	i yellan
exit	tuffɣa
expand	semɣur
expect	rjju
expected	yettunefk
expenses	aserref
expensive	ɣlay
experience	tirmit
experience	armi
experiment	Tarmit
expert	amussnaw
expired	yemmut
explain	efhem
explanation	asegzi
exploit	Tanfust
explore	ad d-nadi
export	assifiḍen
expose	Fser
exposed	Iban-d
exposure	asfel
express	nlemmed
expression	ad d-tessenfaliḍ
extend	kemil alma
extended	Amraḥ
extension	Tasgiwit
extent	Asket
external	Amniri
extinct	yenger
extra	ugar
extract	Yekkes
extraordinary	ifazen
extreme	Imixfiw
extremely	s waṭas
eye	Tiṭ
eyes	allen
fabric	Aceṭṭiḍ
fabulous	yessewhamen
face	sedmer
face	udem
facilitate	ashelli
facilities	arfiq
facility	ltesala
fact	tidett
factor	amezzarew
factory	Taneɣraft
facts	tidett
fade	tettṛuḥu
fail	yexṣer
fail	lexṣara
failed	yexṣer
failure	lexṣara
faint	yexlef
fair	uɣdim
fair	aḥeqqi
fairly	Daqs
fairy	senɣed
faith	Liman
faithful	anṣiḥ
fake	Mačči d win n tidet
fall	yeɣli
fall	lexrif
false	Ur iṢṢehara
fame	yetwassen
familiar	yettwasnen
family	Tawacult
famine	laẓ
famous	yettwassnen
fan	tesbuḥrut
fancy	ɣlay
fantastic	yelha
far	ibɛed
farewell	Ar Timlilit
farm	tabḥirt
farmer	afellaḥ
fascinating	yessewhamen
fashion	telkimt
fast	taɣawla
fat	yesseḥa
fatal	messus
fate	lmektub
father	baba
fatigue	ɛeggu
fault	leɛyub
favorite	ay yettwaḥemmlen
favour	Derbez
favourite	iḥemmel
fear	lxuf
fear	yuggad
feast	Tameɣra
feather	ifer
feature	limaṛa
feature	amyez
features	ṣifath
february	furar
fed up	Daqs
fee	asekkil
feed	aɣrum
feedback	iwenniṭen
feel	ḥulfa
feeling	iḥulfan
feet	iḍaṛṛen
fell	yeɣli
fellow	amdakel
felt	yettwaḥulfu
female	tamettant
fence	assefreg
fertile	d tiferka
festival	tafaska
fetch	awed
fever	tawla
few	kra
fewer	drus
fiance	ameddakel
fiction	ussugen
field	amkan
fierce	d amcum
fifteen	mraw d semmus
fifty	semmus n tmerwin
fight	ammectcew
fight	nnaɣ
fighting	Ammectcaw
figure	udem
figure	yefhem
figure out	Yefhem
file	Sentu
fill	Teccuṛ
filled	yeččur
film	asaru
filthy	Yerka
finally	taggara
finance	taẓraf
financial	idrimen
find	afed
find out	af-d
fine	tafgurt
fine	yelha
finger	aḍad
finish	ikfa
finished	Yefuk
fire	Times
firm	ilumm
firm	ajmir
first	amezwaru
first name	Isem amezwaru
fish	iselman
fit	yessfken
five	semmus
fix	ad iyi-tṣeggmed
fixed	Ṣeggem
flag	Senjaq
flash	lebreq
flat	yeẓẓel
flat	isbeṭ
flaw	lexṣaṣ
flawless	Aneblal
flee	Yerwel
flesh	aksum
flew	yufeg
flex	ileɣwanen
flexible	talwayant
flight	waffug
flip	Bren
flirt	yetthukku
flirting	ad as-yessekles
float	yettifliw
flood	aḥemmal
floor	lqaɛa
flour	Agil
flow	Yettazzal
flow	sriddimen
flower	tazeǧǧigt
flu	abeḥri.
fluent	Iserreḥ
fluently	s talwit
fluffy	allagaɣ
fluid	Amengi
fly	afud
focus	lhu-d
focus	ddehn
fog	asigna
foggy	agu
fold	ad ṭebqeɣ
folks	Imdanen
follow	ḍfer
follow up	ḍfer
following	seld
food	učči
fool	abehlul
fool	kellex
foolish	amhaw
foot	aḍar
football	Ddabex udar
for	a xatar
For example	Amedya
for instance	amedya
for you	i kečč
forbidden	yettwagdel
force	lǧehd
forecast	asugen
forehead	Ayendur
foreign	agelzim
forest	tiẓgi
forever	i lebda
forget	ttuɣ
forgive	suref
forgot	Yettu
fork	taferciḍt
form	Get-d
form	ṣṣenf
formal	tunṣib
former	anemhal
fortunately	Asragen
fortune	lxir
forty	ukkuẓ n tmerwin
forty-two	ukkuẓ n tmerwin d sin
forward	ɣer zdat
foster	snernan
fought	Yennuɣ
found	ufan
foundation	llsas.
four	ṛebɛa
fourteen	mraw d ukkuz
fox	abaṛeɣ
fragile	yexsen
frame	tazelɣa
framework	aɣawas
fraud	aderraḥ
freak	afɣul
free	ilelli
freedom	tilelli
freeze	tigersin
frequency	Asnagar
frequent	isnagaran
frequently	s waṭas
fresh	ajdid
friday	Ljemɛa
fridge	afrigu
friend	ameddakel
friendly	d imeddukal
friends	imdukal
friendship	tadukli
frightened	yugad
frightening	yessexlaεen
frog	Agru
from	si
front	zdat
frozen	yefri
fruit	lfakya
frustrated	Teččeḥ
fuel	aserɣu.
Fulfulde	Fulfud
full	yeččur
fun	amnecreḥ
function	axeddim
fundamental	yesɛan azal d ameqran
funeral	lǧanaza
funny	yesetay
fur	taduṭ
furious	yerfa
furniture	lqecc
further	ugar
furthermore	Ula d
future	imal
gain	afud
gain	yerbeḥ
game	Turaret
gap	Icellix
garage	agaraj
garbage	zebbal
garden	lejnan
garlic	tiskart
gate	tawwurt
gather	dduklet
gathering	Temallelen
gauge	lekkiil
gave	yefka
gear	aselkim
gender	anaw
general	umata
generally	S umata
generate	tasutayt
generation	Isarawwen
generous	afeḥcuc
genius	uḥric
genre	Ṣṣenf
gentle	yeḥdeq
genuine	tidett
gesture	aḥabac
get	awi
get dressed	els
get up	Kker-d
get well soon	qrib ad yejjey
getting	yettwaṭṭaf
ghost	azɣuɣ
ghosting	asfel
giant	Agehguh
gift	asefk
ginger	seknejbir
girl	taqcict
girlfriend	tamdakelt
give	fket
give up	ad sellmeɣ
given	imudden
glad	ferḥeɣ
glance	Yemmuqqel
glass	zejaj
glasses	Nwader
glimpse	Tamuɣli
global	amata
gloomy	Amsulles
gloves	lligat
glow	tafrara
glow	yefrari
glow up	ad d-yezzin
glue	seneṭḍ
go	ṛuḥ
go ahead	Aha
go away	ruḥet
go to bed	ruḥ ad teṭseḍ
goal	iswi
goals	iswiyen
goat	taɣatt
god	Rebbi
god bless you	ad k-ibarek rebbi
goes	iteddu
going	yettruḥu
going to	ad nruḥ
gold	ureɣ
gone	iruḥ
gonna	ad
goo	Ggu
good	awqam
good	yewqem
good afternoon	Azul
good bye	Di laman
good day	ass ameggaz
good evening	tameddit yelhan
good job	cɣel igerzen
good looking	yelha
good luck	Afud igerrzen
good morning	tifawin
good morning my love	Azekka igerrzen a tayri-w
good night	iḍ igerrzen
goodbye	Ar azul
goodnight	iḍ ameggaz
goods	alzazen
Google	Google
Google Translate	Asegzi n Google
goose	uwezziw
gorgeous	yessewhamen
gossip	assiwel ɣef medden
got	yewweḍ
got it	Ẓriɣ-t
government	lḥukuma
grab	ṭṭfen
grade	tizmilin
gradually	s ttawil
graduate	agerdas
grain	imendiyen
grant	efk
granted	yettunefk
grapes	aḍil
grasp	yeḍḍef
grass	aẓekkun
grateful	ncekkeṛ aṭas
gratitude	tanemmirt
grave	aẓekka
gray	Aciban
great	yelha mliḥ
greed	Aqjmar
greedy	ṭṭmeɛ
green	azegzaw
greet	Yelha
greeting	Azul
greetings	Azul
grey	ttcabeɣ
grid	Sefreg
grief	leḥzen
grind	ddez
grip	Altaɣ
grocery	taḥanut
groom	isli
gross	imeqranen
ground	akal
group	Agraw
grow	semɣur
growth	timɣur
grumpy	yerfa
Guarani	Gurani
guarantee	Neḍmen-it
guard	taɛessast
guess	ad d-tiniḍ
guest	inebgi
guidance	asɣal
guide	ladlil
guide	nher
guilty	d amednub
guy	argaz
guys	ay arrac
gym	addal
habit	tanumi
habitat	amḍiq
had	yella
hail	webruri
hair	acebbub
half	azgen
hall	Tazeɣɣa
hand	Afus
handle	aselkim
handsome	yerbeḥ
hang	fessr
hang out	ad nezzi
happen	yeḍra
happened	Tedra
happiness	sseɛd- nsen
happy	yefreḥ
happy birthday	amulli ameggaz
happy birthday to you	amuli-k d ameggaz
happy new year	aseggas ameggaz
hard	igder
hardly	siɣil
hardly ever	D awezɣi
harm	dir
harm	swiɣ
harmful	yesḍurru
harmony	Amtawa
harsh	d aẓidan
harvest	temger
has	yesɛa
hate	yekṛeh
have	yesɛa
have a good day	sεut ass yelhan
have a nice day	Sεeddi ass ameggaz
have breakfast	ččet imekli
have fun	Anecraḥ
have you eaten	teččiḍ ?
having	seεεu
hazard	Amihi
haze	Aggu
he	netta
he has	yesεa
he is	D netta
head	aqerru
headache	aqraḥ n yiɣef
heal	asseḥlu
healing	aseḥlu
health	tazmert
healthy	ilha i tezmert
hear	yeslad
heard	yesla
heart	qeriḥ
heat	lḥamu
heat	seḥmu
heaven	igenni
heavy	ẓẓayen
hectic	amzun
height	laɛli
heir	mekkus
heist	Tirzi
held	yeṭṭfen
hell	times
Hello	azul
hello dear	Azul ay aḥbib
hello how are you	Azul, amek i telliḍ?
hello how are you doing	Azul amek tettilid?
helmet	amsegdal
help	ɛiwen
helpful	iεawnen
hence	ihi
her	agla-s
herd	tqeḍεit
here	dagi
heritage	Lweṛt
hesitate	yekukra
Hey	iy
Hi	azul
hi how are you	azul amek tettilid
Hi there	Azul dina
hidden	yeffer
hide	ad yeffer
hierarchy	igḍam
high	ɛelay
highlight	Derrer
hike	Imzwura
hiking	amerreḥ
hilarious	yesseḍsay
hill	tiɣilt
him	netta
hint	awehhi
hip	ammas taγma
hips	Taɣma
hire	kru
hiring	Lekra
his	ayla-s
history	Amezruy
hit	yekkat
Hmm	Yah
hobby	Aramsu
hold	ṭṭfet
hold on	Ṭṭef
hole	tasraft
holiday	imuras
hollow	d tilemt
home	axam
homework	aɣanen
honest	afeḥli
honestly	Tidet kan
Honey	ay amelḥan
honor	Ɛuzz
hood	arazal
hook	ɛellq
hop	ineggez
hope	sirem
hope	asirem
hopefully	Nessaram
hopeless	ulac asirem
horizontal	igli
horn	Iciw
horrible	Ssexlaɛ
horror	tugdi
horse	ayis
hospital	sbiṭar
hospitality	Tasnubegt
host	isnubga
host	inebggi
hostile	yuɛer
hot	yeḥman
hotel	Asensu
hour	ssaεa
hours	tisaɛtin
house	axxam
household	Tawacult
how	amek
how about you	I kemm?
how are you	amek tettiliḍ
how are you doing	amek i tettiliḍ
how are you doing today	amek i telliḍ ass-a
how are you today	amek tettiliḍ assa
how do you do	amek i tettilid
how is	Amek akka
how many	acḥal
how much	acḥal
how often	acḥal n tikkal
how old are you	acḥal tesɛiḍ n yiseggasen
how was your day	Amek id iɛedda wass-ik?
how was your night	Amek yella yiḍ-im?
however	maca
hub	talemast
hubby	ay argaz
hug	sudan
hug	arebbeε
huge	ameqqran
human	amdan
humble	yesṭufan
humid	Yebzeg
humidity	Asebzeg
hundred	Tawinas
hungry	laẓ
hunt	ṣṣyada
hurricane	Tabuciḍant
hurry	Ɣiwlet
hurry up	aεjel
hurt	yejreḥ
husband	argaz
hustle	derreḥ
hustle	axelwaḍ
hut	Agurbi
hygiene	iffisen
I	i
I am	d nekk
I am fine	Ur iyi-yuɣ wara
I can	Zemreɣ
I can't	Ur zmireɣ ara
I do	Xedmeɣ
I do not know	ur εlimaɣ ara
I do not understand	ur fehimaɣ ara
I don't	Ur tt-ssineɣ ara
I don't know	Ur ẓriɣ ara
I don't understand	ufehhmeɣ ara
I don't understand what you mean	ur fehimaɣ ara d-acu tebɣiḍ ad tiniḍ
I don't understand you	Ur k-fhimeɣ ara
I don’t know	ur εlimeɣ ara
I don’t understand	Ur fhimeɣ ara
i guess	cukkeɣ
I had	Lliɣ
I have	Sεiɣ
I have been	lliɣ
I hope so	Aka i sarmeɣ ula d nekk
I know	ɛalmeɣ
I like	ḥemlleɣ
I like you	ḥemleɣ-k
I love	Ḥemmleɣ
I love my big brother	ḥemleɣ gma ameqran
I love my big sister	ḥemleɣ uletma tameqrant
I love my father	ḥemleɣ baba
I love my little brother	ḥemleɣ gma amecṭuḥ
I love my little sister	ḥemleɣ uletma tamecṭuḥet
I love my mother	ḥemleɣ yemma
I love you	ḥemleɣ-k
I love you so much	Ḥemmleɣ-kem aṭas
I love you too	Ḥemmleɣ-kem ula d nekk
I mean	Bɣiɣ ad d-iniɣ
I miss you	xaqeɣ fell-am
I miss you so much	Cceɣ fell-am aṭas.
I see	Ẓriɣ
I think	Cukkeɣ
I understand	Fehmeɣ.
I want	Bɣiɣ
I want to see you	Bɣiɣ ad kem-ẓreɣ
I want you	Bɣiɣ-k
I was	Lliɣ
I will	ad
I would be	ad illiɣ
I'm	nekkini
I'm fine	Ur iyi-yuɣ wara
I'm good	Aql-i akken ilaq
I'm here	aqli d-a
I'm sorry	Ssuref-iyi
ice	adfel
ice cream	tamagrist
idea	tikti
ideal	igerrzen
identical	yetmcuba
identify	issin
identity	laṣel
idiot	amenzug
idle	tiffenyent
if	ma yella
ignore	ur tt-neḥsib
ill	yuḍen
illegal	Yettwagdel
illness	aṭṭan
Ilocano	Ilucanu
image	Tawlfat
imagine	ad txayleḍ
immediate	imiren kan
immediately	imiren kan
immense	imiren
impact	sikec
impact	asemdu
impatient	ur iṣebbeṛ ara
implement	aseqdec
import	amaktar
import	kter
important	yesɛan azal
impose	smaṭa
impossible	d awezɣi
impress	yessewhem
impression	Asiggez
impressive	tessewhem
improve	selhu
improvement	Aselhu
in	deg
in addition	Nnig
In fact	g tidet
in front of	Zdat
in order to	I wakken ad
inappropriate	ur nlaq ara
incentive	asnerni
incident	tadyant
include	gar-asen
including	gar-asen
income	lemdxul
inconvenience	cebbel
increase	timerniwt
increase	rnu
increased	yetnerni
incredible	d ayen ur nettamnen
indeed	s tidet
independent	tilelli
India	lhend
indicate	ssinim
indigenous	Ayla n tmuret
individual	waḥdes
industry	Tamguri
inevitable	Terra tmara
infant	Llufan
infection	aɣetel
infinity	ifaḍ
inflammation	Taḥawcart
inflation	Iwerzan
influence	asmili
influence	wekki
inform	sseεlem
information	isallen
ingredients	leḥwal
inheritance	yekkus
initial	tazwara
initiative	Tasntayt
injured	yettwajerḥen
injury	Lǧerḥ
innocent	ur yesɛi ddnub
innovation	Amesnulfu
inquiry	aseqsi
insane	amehbul
insect	abεuc
insecure	ur yettwaḥrez
insert	ger
inside	deg daxel
insight	Tikta
insist	ywekked
insomnia	leɛziṛ
inspiration	Taswedt
inspire	iţţuweḥḥa
install	Assersi
instance	amedya
instant	taswiεt
instead	deg umkan
instead of	Deg webdil
instructions	lewṣayat
instrument	wallal n uẓawan
insult	rregmat
insurance	asegzawal
intact	tummiḍt
integrity	taḥeqqit
intellectual	Aggag
intelligence	aggagen
intelligent	Yeḥṛec
intend	ad t-id-yefk
intended	Yetwqsed
intense	yesεan tazzla
intention	lebɣi
interact	Myermed
interaction	yetfael
interest	amur
interested	iletha
interesting	yhum
interfere	Ankeccam
intermediate	talemmast
internal	Ar daxxel
international	agraɣlan
internship	aswir
interpret	yessefhem
interpreter	ameslay
interrupt	igezzem
interview	tadiwennit
intimate	tdukli
into	deg
introduce	issekcem
introduction	tezzwert
introvert	ur isεi ara ywiet tamslayet
intuition	anazzay
invalid	ur yesɛi ara azal
invent	asnulfu
inventory	tasḍunt
invest	Asefti
investigate	Alewwaṭ
invitation	tinubga
invite	Σreḍ
invoice	ceyeε tafatuṛt
invoice	tafatuṛt
involve	d-yettawin
involved	Yettekka
iron	εeddi
iron	uzzal
is	d
island	tigzirt
isolated	Yexla
issue	acebbul
issue	aɣbel
issues	timsal
it	yes-s
it is	d ayen
it was	yella
it's	d
it's ok	ulac aɣbel
It's okay	Dayen
item	tawuri
items	tiɣawsiwin
its	d
I’m	Nekk
jacket	takebbuḍt
jail	takurmut
January	Yennayer
jar	tbuqalt
jaw	Aɣesmaṛ
jealous	yetasem
jerk	senhez
jewelry	isɣunen
job	axeddim
jogging	tazzla
join	rnu ɣer
joint	Usɣin
joke	tiqqesert
journalist	aneɣmas
journey	aditkel
joy	lferḥ
judge	yeḥkem
judge	lḥakem
juice	iẓem-a
july	Yulyu
jump	neggez
june	yunyu
junk	zbel
just	swaswa
just	kan
just do it	xedmit kan
justice	taɣdemt
justify	isfukulen
Kalaallisut	Kalalisut
keen	tɛesqeḍ
keep	ṭṭen
keep it up	kemmlet aken
kept	Yejja
kettle	taserkamet
key	tasarut
kick	Wwet
kid	aqcic
kidding	Aqesser
kidney	Tigezzelt
kids	arrac
kill	yenɣa
kind	d tin n lεali
kind	ṣṣenf
kinda	Cwiya
kindly	Txxil-k
kindness	leḥdaqa
king	Agellid
kiss	Ssuden
kitchen	tacuct
kite	Tanafagt
kitten	akkatus
knee	tigecrirt
knew	Yeẓra
knife	lmus
knight	Amnay
know	ẓriɣ
knowledge	tamusni
known	yettwassen
Konkani	Kunkani
Krio	Kryu
label	tibzimin
label	cṛed
labor	axeddim
labour	Axeddim
lack	derus
ladder	asellum
lady	Tameṭṭut
laid	teẓẓel
lake	agelmim
lamb	izimer
lame	aquḍar
lamp	taftilt
land	tamurt
land	Yahwa
landscape	Tarakalt
language	tutlayt
lap	irebbi
large	wesiɛ
last	aneggaru
last but not least	taggara maca mači d tin meqqren
last name	isem n twacult
late	iɛeṭṭel
lately	tagara
later	ticki
latest	Ungal
latter	Anegaru
laugh	taḍsa
laughing	tettaḍsa
laughter	taḍsa
launch	asnulfu
laundry	assired
law	asaḍuf
lawn	tazzla
lawyer	abugaṭu
lay	Ssers
layer	Tissi
layout	asnazel
lazy	afenyan
lead	asfel
leader	Aqerru
leaf	tafriwt
leak	tneggi
lean	ttsennideɣ
leap	neggez
learn	yelmed
learning	Almad
lease	Yekra
least	madrus
leather	aglim
leave	yejja
leave	tujjit
leaves	izerfan
led	yessawḍen
left	azelmaḍ
leg	aḍar
legacy	amur
legal	lqanun
legend	tmucuha
legit	Tasaduft
leisure	listaɛ
lend	reḍleɣ
length	teɣzi
less	daw
lesson	Tamsirt
let	as-d-yeǧǧ
letter	tabṛat
lettuce	taḥlawatt
level	Aswir
leverage	anammud
liability	aselkem
library	taserkant
lick	mceḥ
lie	tikerkas
lie	skerkes
lies	Tiskerkas
life	tudert
lift	yerfed.
lift	ddem
light	yedwa
light	tafat
lightning	Lbreq
like	am
likely	ahat
likewise	akken daɣen
line	azirig
Lingala	Lingala
link	Yeqqen
lion	Izem
liquid	imengi
list	umuɣ
listen	ssefled
listening	asmeḥses
literally	s wawal
literature	tasekla
litter	Ur ttḍeggir tursaḍ
little	cwiṭ
live	edder
live	amudir
liver	Tasa
lives	Tudert
living	tudert
living room	tmesrit
lizard	aḥelbubu
load	tteɛbeyya
loaf	Aɣrum
loan	Areḍḍal
local	n tmurt
location	amkan
lock	tsekkaṛt
lockdown	asebded
log	izquren
lol	iseḍsay aṭas
lonely	iman-is
long	ɣezzifen
long time no see	acḥal aya ur k-nezri
look	muqqel
look	tamuɣli
loop	akerus
loose	Ɣezzif
loose	seεreq
lord	sidi
lose	yesruḥ
loss	lexṣara
lost	iḍaɛ
lot	aṭas
loud	lɛellay
lounge	tamesrit
love	tayri
love	yeḥmel
love you	Ḥemmleɣ-kem
lovely	Iḥemmlen
low	derus
lower	rxisit
loyal	yeṣfan
loyalty	unṣiḥ
luck	zzheṛ
lucky	ẓẓher
Luganda	Luganda
luggage	ifecka
lump	Taḥjurt
lunch	imekli
lungs	Turin
luxury	Alameɣ
lying	lekdeb
machine	tamacint
mad	yemxel
madam	massa
made	yettwaxedmen
magazine	taḥanut
magnificent	yessewhamen
maid	taqeddact
main	netta id d seḥ
maintain	aḥader
maintenance	aseḥbiber
Maithili	Matili
major	meqqer
major	amenzad
majority	tuget
make	agg
make up	yettezriri
male	argaz
mall	amsenzi
man	amdan
manage	assemhel
management	aseɣti
manager	unemhal
mandatory	awalen
manifest	senked
manipulate	Nawel
manner	tikli
manual	s ufus
many	aṭas
many many happy returns of the day	aṭas n wussan n lferḥ
march	Maɣres
margin	Rrif
market	Alzuz
marriage	zzwaǧ
married	yezweǧ
mask	tagelmust
mass	taẓayt
massive	ameqqran
master	Aselmad
match	tuqna
match	yeqqen
mate	ameddakel
material	allal
math	tusnakt
matter	taluft
matter	aḥseb
maturity	aneẓaẓ
may	tikwal
may	yzmer
maybe	ahat
me	neki
me too	ula d nekk
meal	Tiremt
mean	snamek
mean	anamek
meaning	anamek
means	d tallelt
meant	yeqsed
meanwhile	Syin
measure	qiss
measures	aḥezzeb
meat	aksum
medical	Tesnajya
medicine	ddwa
meditation	aḥebber
medium	aegen
meet	mlal
meeting	timlilit
Meiteilon	Mitelun
melt	ifessi
memories	cfawat
memory	takatut
mental	Anellay
mention	Yebder
mentioned	Yebder-d
mentor	aselmad
merchant	Amzenzi
mercy	ṛṛeḥma
merely	kan
merry christmas	Aseggas ameggaz
mess	axrab
message	awal
messy	yetccwil
metal	Amɣuz
method	tikli
mice	iɣerdayen
middle	Alemmas
midnight	nsaf yiḍ
might	ahat
mild	alessas
milestone	taɣsert
military	aserdasi
milk	ayefki
million	amelyun
mind	allaɣ
mind	xemmem
mindset	Tanelayt
mine	ayla-w
mine	amɣiz
mingle	Rwi
minor	amecṭuḥ
minute	dqiqa
minutes	Dqayeq
miracle	lbeṛhan
mirror	lemri
miscellaneous	amgarad
mischievous	amencuf
miserable	aqlalqal
misery	lḥif
miss	ttu
miss you	Cedhaɣ-kem
missing	ixuṣṣ
mission	tuɣdaḍt
mist	agu
mistake	tuccḍa
Mizo	Mizu
mobile	asawal
mock	aqejjem
model	Amudem
moderate	slukkez
moderate	amnazal
modern	amaynut
modest	imsetḥi
moist	amcum
moisture	Asebzeg
mold	Yejjunjeṛ
mold	azenjer
mole	Tafuyt
mom	yemma
moment	taswiεt
monday	ass n letnayen
money	idrimen
monitor	asmel
monkey	ibki
month	aggur
mood	ṭebiɛa
moody	Amencuf
moon	Agur
moral	Taɣara
more	ugar
moreover	yerna
morning	Taṣebḥit
mortgage	Ṛehn
most	ugar
mostly	S umata
mother	Tayemat
motion	Ahuzzu
motivation	lḥir
mountain	adrar
mouse	aɣerday
mouth	Imi
move	Ddu
movement	Amussu
movie	Asaru
mrs	Massa
much	aṭas
mud	aluḍ
mug	Tiski
muscle	aẓekka
museum	asalay
mushroom	agersal
music	aẓawan
must	atfar
must	ylaq ad
mute	d asusman
mutual	amgarad
my	-iw
My dear	Ay aḥbib-iw
my friend	amdakel-iw
My hovercraft is full of eels	aḍu-inu yeccur d izerfan
my love	tayri-w
my name is	isem-iw
my pleasure	D lferḥ-iw
myself	Iman-iw
mysterious	Adrug
mystery	timeshselt
myth	tamacahut
nail	accaren
naive	abuhal
name	isem
narrative	Aḥkay
narrow	deyiq
nasty	amcum
national	aɣelnaw
nationality	tagduda
native	aneṣli
natural	n umata
nature	agama
nausea	Yettemɛujjut
near	qrib
nearby	deg tama
nearly	Qrib
neat	zedig
necessary	yessefk
neck	amgerḍ
necklace	tezrart
need	siser
need	aser
negative	n diri
neglect	stehzi
negotiate	amcawaṛ
neighbor	Anarag
neighborhood	agmam
neither	ula d yiwen
nephew	mis n gema
nerd	Lweswas
nervous	yefqeɛ
nest	Agnin
net	internet
network	isireg asekdan
neutral	arawsan
never	urjin
never give up	Werǧin ad tayseḍ
never mind	Ur tt-tewqiε ara
nevermind	Ur tt-tewqiε ara
nevertheless	ɣas akken
new	amaynut
news	imaynuten
next	Win i d-iteddun
next to	tama n
nice	yelha
nice to meet you	ferḥeɣ imi d nemlal
niece	llis n gma
night	iḍ
nightmare	yir targit
nine	tẓat
nineteen	mraw d tẓa
ninety	tẓa n tmerwin
No	ala
no problem	ulac ugur
no way	Ulac wamek
nobody	Ula yiwen
noise	lḥess
noisy	yesɣurru
none	ulac
noon	tameddit
nope	ala
nor	Ula
normal	d ayen ilhan
north	agafa
nose	Inzer
nostalgic	tamdanit
not	khati
not at all	Xaṭi.
not bad	ur diri-t ara
Not now	maci tura
not yet	Mazal
note	tinqiḍin
noted	Yura
nothing	ulac
notice	asebter
noticed	Iger tamawt
noun	isem
nouns	nekwat
novel	Ungal
november	wamber
now	tura
nowadays	ass-a
nuisance	ccmata
null	Ulac
numb	Yeddubbez
number	uṭṭun
nurse	tafremlit
nut	Taquqet
nutmeg	tameskuyt
nutrition	Učči
oath	taggalit
obesity	Abenter
obey	Ad yaɣ awal
object	taɣawsa
objective	iswi
obligation	Ttwaḥettem
obscure	isulles
observation	ansfqed
observe	yettwali
obsessed	yeṭṭef-itt
obsession	yesleb
obsolete	yeqdim
obstacle	Ugur
obtain	yewwi
obtained	yewwi-d
obvious	iban
obviously	iban
occasionally	tikwal
occupation	alethi
occupied	yeṭṭef
occur	d-yeḍran
occurred	yeḍran
occurs	yeḍra
ocean	Ugaraw
october	tuber
odd	amur
odds	Imellilen
of	n
of course	iban
off	yeffeɣ
offensive	ijerreḥ
offer	efk
offer	tufkin
office	tesreqqest
official	tunṣibt
often	s waṭas
Oh	ah
oh really	yah d tiddet
oil	Zzit
ok	yerbaḥ
ok dear	yerbaḥ a taεzizt
ok honey	Yerbḥ a yaḥbib
ok my love	Ih a tayri-w
okay	anεam
okay baby	yerbaḥ a laεzizer
okay dear	Ihi ay aḥbib
okay honey	yerbeḥ ay aḥbib
okay my love	ih a tayri-w
old	aqdim
on	ɣef
once	yiwen
one	yiwen
one language is never enough	yiwet n tutlayet utekfi ara
onion	aẓalim
online	onlayn
only	siwa
open	yeldi
operation	tamhelt
opinion	tamuɣli
opportunities	tignatin
opportunity	tagnit
opposite	mgal
optimistic	d win yesɛan asirem
option	afran
optional	umaḍgir
or	neɣ
orange	acini
orange	tccina
order	lwṣaya
order	suter
ordinary	amagnu
organization	Tuddsa
orientation	askan
origin	aneṣli
original	taneṣlit
Oromo	Urmu
orphan	agujil
other	wiyaḍ
otherwise	ma ulach
ought	yessefk
our	ayla-nneɣ
Our mission: to enable everyone, everywhere to understand the world and express themselves across languages.	Taswiεt-nneɣ: ad d-nerr akk medden, di yal amkan ad fehmen amaḍal u ad d-sbeggnen iman-nsen deg tutlayin.
Our mission: to organize the world's information and make it universally accessible and useful.	Taswiεt-nneɣ: ad nheggi isallen n umaḍal u ad ten-nerr d wid yettwafen akk deg umaḍal.
out	bera
outcome	Agemmuḍ
outfit	uselsu
outgoing	ay d-yeffɣen
outlet	tamezt
outline	tuzzeya
outside	beṛṛa
outstanding	Igerrez
oven	ufarnu.
over	af-it
over there	Dinna
overall	s umata
overcome	yeɣleb
overthinking	yetxemmim aṭas
overwhelmed	yeččuṛ
overwhelming	nɣed
owe	Ttalaseɣ
owl	Bururu
own	iman-is
own	sεu
owner	bab-is
ox	azger
pace	tikli
pack	apaki
package	ukerrud
paid	yettwaxellṣen
pain	leqriḥ
paint	yesbeɣ
painting	tsebɣeḍ
pair	tayuga
pale	iceḥeb
palm	Teẓẓa
pan	taḥbult
pandemic	aṭṭan
panic	Lxuf
pants	aserwal
paper	lkaɣeḍ
paradise	Lǧennet
parallel	Tamnawayt
parcel	akaraf
pardon	suref
parents	imawlan
park	wefrag
parrot	Babaɣayu
parsley	lmeɛdnus
part	amur
participate	ttekki
particular	s umata
particularly	ladɣa
partner	ameddakel
party	tameɣra
pass	ad d-yeffeɣ
passage	Aɛeddi
passed	Yekka
passion	leḥna
passionate	terḥa
passive	atwaɣ
password	awal n uffir
past	ayen iɛeddan
patch	acerrig
path	abrid
pathetic	d ayen iqeṛḥen
patience	ṣṣber
patient	sber
patient	asebbar
pattern	amussu
pause	aḥbas
pavement	taneddut
pay	xellṣ
payment	Axelles
peace	talwit
peaceful	talwit
peach	taxuxet
peak	tasemhuyt
pear	ifires
peas	Tajilbanet
peculiar	amaynut
pee	izan
pee	yexṛa
peel	Sseqcer
peer	yerfiqen
peers	imdukkal
pen	asebter
pencil	imru
pending	ar mara
people	imdanen
pepper	ifelfel
perceive	yettwali
perception	Tamuɣli
perfect	aneblal
perform	yexdem
performance	axeddim
perhaps	ahat
period	tallit
permanent	dima
permission	ttesriḥ.
permit	Ad yeǧǧ
perseverance	Ṣṣber
persistent	Aselway
person	amdan
personal	ayla-s
personality	tugna
perspective	tamuɣli
persuade	qenneε
pervert	Amazuf
pet	iɣersiwen n wexxam
phase	Aswir
phenomenon	tanamunt
philosophy	Yafelesuft
phone	tilifu
photo	Tawlaft
phrase	tafyirt
physical	n tfekka
pick	afen
pick up	ddem
picture	tugna
piece	amur
pieces	Tizeqwin
pig	aḥelluf
pigeon	atbir
pile	aεmur
pillow	tasumta
pilot	amsafeg
pin	umesmir
pineapple	Ananas
pink	aweṛdi
pit	Tamdunt
pitch	ttegec
pity	Sḥissifeɣ
place	sseg
place	adeg
places	Timnaḍin
plague	bucḥiṭ
plain	ifrar
plan	aɣawas
plane	Asafag
plant	imɣan.
plants	imɣan
plate	aḍebsi
platform	agnenna
play	turaret
play	urar
playing	Turaret
pleasant	yesεa lεali
please	texxil-ik
please	gerrez
pleased	necreḥ
pleasure	iferḥ
pledge	tagallit
plenty	aṭas
plot	amḍiq
plug	Tergel
plum	taberquqt
plumber	Amaldam
plural	asget
podcast	Apudkast
poem	asefru
poetry	Tamedyazt
point	Ṛṛay
poison	ssem
police	tamsulta
policy	tasertit
polite	yemɛen
pollution	asegzi
pond	temda
pool	amdun
poop	Iẓẓan
poor	agellil
pop	pop
popular	yettwassnen
population	agdud
pork	aksum n yilfan
porridge	taẓayt
port	asagen
position	amkan
positive	d ayen yelhan
possess	tesɛiḍ
possession	yemlek
possessive	yesɛan
possible	yezmer
post	tinawet
post	sissen
postpone	Awexxer
potato	lbaṭaṭa
potential	yezzmer
pound	arḍel
poverty	timuɣben
power	Tazmert
powerful	tazmert
practical	d ayen iṣeḥḥan
practice	xdem
practice	tamusni
praise	iḥmed
prank	Tiqecmeɛt
pray	taẓallit
precious	yesɛan azal
precise	waswa
precisely	swaswa
predict	ad d-tban
prefer	yesmenyif
preference	Acucem
pregnant	S tadist
prejudice	taneḥyaft
premises	Idiganen
premium	Tabkart
preparation	Aheggi
prepare	heggit
prepared	yetheggi
preposition	tanzeɣt
presence	tisin
present	amiran
present	tilawt
present	aqeddem
presentation	asegzi
preserve	ad ḥerzen
president	aselway
press	tazmeket
press	ẓem
pressure	atekki s lǧehd
pretend	Yerra iman-nnes am
pretty	Tecbeḥ
pretty	twennaε
prevent	ur t-tettaǧǧa ara
previous	win yezrin
prey	tawaqqast.
price	ssuma
pride	zzux
priest	Aqessis
primary	amenz
prime	Agejdan
princess	tgeldunt
principal	anemhal
prior	uqbel
priority	tazwart
prison	lḥebs
privacy	Tabadnit
private	sser
privilege	lemzeyya
prize	Arraz
probably	ahat
problem	ugur
procedure	tikli
proceed	kemmlet
process	xdem
process	akala
produce	asnulfu
product	asegmi
production	Afares
profession	Ixeddim
professional	amsadur.
profile	alegdis
profit	rrbeḥ
profound	Lqay
progress	Asnerni
progress	nerni
project	Asenfaṛ
prominent	yettbanen
promise	seɣ
promise	taɣest
promote	asnerni
promotion	asmal
prompt	tuɛjilt
prone	Asentel
pronouns	ismawen
pronunciation	Asusru
proof	anza
proper	yessefken
properly	akken ilaq
properties	Ayla
property	ayla
proposal	asumer
prospect	iẓṛi
prosperity	liser
prosperous	inkelwi
protect	d-yeḥrez
proud	yesɛa zzux
prove	ţţbut
provide	ad d-dfken
provided	yettunefk
province	Tawilayt
provision	Abecci
puberty	taggaḍt
public	agdud
pull	jebdeɣ
pumpkin	taxayst
punctual	deg lawan
pupil	Anelmad
purchase	taɣawsa
pure	zeddigen
purple	azegzaw
purpose	iswi
purse	taska
pursue	yeḍfer
pursuit	amseḍfar
push	Demmer
put	ssers
qualification	Asmerked
quality	anaw
quantity	aṭas n
quarantine	aseḥbes deg uxam
quarrel	amennuɣ
quarrel	yetnaɣ
quarter	kuẓet
Quechua	Kucwa
queen	tagellidt
queer	Cad
query	aseqsi
question	Asteqsi
queue	izireg
queue	isstef
quick	s tɣawla
quickly	s tɣawla
quiet	tasusmi
quilt	abtlaw
quit	serseɣ
quite	aṭas
quite	berka
quiz	Iseqsiyen
quotation	yetwaksed
quote	bder
quote	tanfalit
quotes	tinebdurin
rabbit	Aktul
race	temsizzlin
rage	wurrif
rain	agffur
raise	tukra
raise	ekker
raised	iḍehred
ran	Yuzzel
random	s zzheṛ
range	iseḍsay aṭas
rapid	Yεjel
rapidly	s lεejlan
rare	ur d-yettili ara
rarely	Dru
rash	Ttufeɣa
rat	iɣerdayen
rate	amqim
rather	axir
ratio	assaɣ
rational	ameɣẓan
raw	azegzaw
re	aɛawed
reach	aweḍ
reached	yewweḍ
reaction	Tasedmirt
read	ɣer
reading	taɣuri
ready	Ihegga
real	tidett
reality	Tilawt
realize	ifaq
realized	Yega
really	s tidet
rear	deffir
reason	ssebba
reasonable	itemtawan
recall	Mmekti
receipt	tafaturt
receive	awent
received	yettwaṭṭfen
recent	ussan-a ineggura
recently	saken kan
reception	Tarmest
recipe	Taftart
reckless	ur nḥader
recognition	asmussen
recognize	yeẓra
recommend	ckerr
recommended	Smagel
record	asekles
record	sekles
recover	yejjey
recovery	ittejjey
rectangle	Asrem
red	Azggaɣ
redeem	ad t-id-sellken
redemption	asfel
reduce	senqess
redundant	Asleg
refer	awehi
reference	amnir
reflect	yessendad
reflection	Asended
refrain	Sunef
refrigerator	afrigu
refund	ad k-id-ɣeṛmen
refuse	ur tt-neqbil
refused	yugi
regard	amedya
regarding	ɣef wayen yerzan
regardless	ɣas akken
regards	Ruh di talwit
region	tamnaḍt
register	azmam
regret	sḥassfeɣ
regular	n tidet
regularly	taẓallit
reject	ur tt-yeqbil ara
relate	d-yettmeslayen
related	assaɣ
relationship	Tadukli
relative	amaraw
relative	ammasaɣ
relatives	imawlan
relax	serreḥ
release	tilelli
release	slelli
released	yettwaserreḥ
relevant	yesɛan azal
reliable	yesεan laman
relief	asertiḥ
relieve	ssexsi
relieved	yesteɛfa
religion	ddin
religious	ddin
reluctant	ur yeqbil ara
rely	ttkel
remain	qqimen
remaining	ay d-yeqqimen
remarkable	ixulef
remedy	asafar
remember	Cfu ɣef
remind	asmekti
reminder	smekti
remote	asfel
remove	kkes
render	Itccur
rent	Iṛḍel
repair	asebded
repeat	ɛawd
replace	ybedde
reply	tuɣalit
reply	yerra
report	aru
report	aṛabul
represent	d amedya
reputation	Tisellet
request	asteqsi
request	seqsi
require	yessefk
required	yessefk
rescue	asellek
research	unadi
resemble	amzun
resentment	amennuɣ
reservation	iḥeṛṛ
reserve	ḥerreɣ
resident	imezdaɣen
resign	yeffeɣ seg lxedma
resilience	taẓayt
resilient	angeẓwer
resist	qabl
resistance	resistance
resolution	Awenneɛ aṭas.
resolve	Fru
resort	yeqdec
resources	tigmawiyin
respect	leqder
respect	yteqadar
respond	rret-d
response	tiririt
responsibility	ssebba
responsible	win yesɛan azal
rest	asgunfu
rest in peace	sgunfu deg talwit
restaurant	Taneccit
restore	Selhu
restrict	Kref
result	agmuḍ
results	igmaḍ
resume	aseɣti
retail	asmel
retain	ad yeqqim
retention	aseḥbiber
retired	yetaxeṛ
retreat	wexxer
retrieve	ad d-tekkes
return	uɣal
reveal	ad d-sbeggen
revealed	Yeban-d
revenge	ttaṛ
revenue	rrebeḥ
reverse	Iqleb
review	sentqed
review	akayad
revise	tceggeṛ
revision	Allas
revolution	Tagrawla
reward	tarrazet
rhythm	Acala
rib	taɣect
rice	rruẓ
rich	d imerkantiyen
rid	asfel
ride	tuzzya
ride	yerkeb
ridiculous	d ayen ur nesεi azal
right	d tidett
right	ayfus
right now	Tura
rigid	yeqquren
ring	txatemt
rinse	Slaleɣ
riot	aɣelwaɣ
rip	tiɣersi
rip	seɣres
ripe	aneẓiẓ
rise	ali
rise	asbedded
risk	qemmer
risk	mihi
rival	amenzaɣ
river	asif
road	Abrid
roast	yeẓɣan
robust	Ajiwar
rock	aẓru
rod	aɛekkaz
role	axeddim
roll	Amteltel
roof	ssqef
room	taxxamt
root	Aẓaṛ
rope	tamrart
rotten	irka
rough	qessiḥ
roughly	azal
round	amgerrad
route	abrid
routine	ţannumi
row	wa deffir n wa
rub	ḥuk
rubber	lberru
rubbish	injan
rude	ur nemɛin
rug	amqelleq
ruin	swiɣ
rule	Alugan
ruler	alugan
rules	Ilugan
run	tuzla
running	tarwela
rural	taɣiwant
rush	ixef
rush	seεjel
sack	Tacacit
sacred	Aɣuddid
sacrifice	asfel
safe	laman
safe flight	iffig n laman
safety	laman
sage	Amasnag
said	yenna-d
sail	uɣerrabu
sailing	tanawt
sake	Ɣef ljal
salary	tacehṛit
sale	azenzay
salmon	aslem
salt	lmelḥ
same	am
Same here	ula d dayi
sample	tukkist
sand	ṛṛmel
Sanskrit	Sanskrit
sarcastic	akellix
sassy	Qjer
sat	yeqqim
satisfaction	lfeṛḥ
satisfied	Feṛḥen
satisfy	yessefqed
satisfying	yessefqed
Saturday	sad
sausage	takurdast
savage	amcum
save	Sellket
saw	iwala
say	ini
scale	ssers ɣef umizan-a
scam	amcum
scar	Ccama
scarce	Imidrus
scared	yugad
scarf	akerzi
scary	yessexlaεen
scattered	yezzuzer
scene	Imeẓri
scenery	Imeẓri n temdint
scent	tafenda
schedule	ahil
schedule	yetwahegga
school	aɣerbaz
science	tussna
scientist	Amusnaw
scientists	immusnawen
scissors	timedyaẓ
scold	yennuɣ
scope	Aḥric
score	ugmuḍ
scrap	Aqaḍ
scratch	ixebcen
scream	isuɣ
screen	Agdil
screw	tefsiḍ
script	sinaṛyu
sea	ilel
seal	tafuyt
search	anadi
season	tsemhuyt
seat	amka
second	wis sin
secret	sser
section	Aɣella
secure	yumen
security	laman
see	ẓer
see you	Ar timlilit
see you later	Ar ticki
see you soon	Ar ticki
see you tomorrow	ad nemlil azeka
seed	Zreɛ
seek	nadi
seem	amzun
seems	Am akken
seen	iwala
seize	icelqef
seizure	Tumza
seldom	Drus
select	Yextar
self	iman-ik
self healing	tujya iman-is
selfish	d imenzayen
sell	zzenzeɣ
send	ceggeɛ
send me your picture	Ceyyeε-iyi-d tawlafet-ik
senior	amɣar
sense	anamek
sensible	yesɛan azal
sensitive	Yettḥulfu
sent	ceggeε
sentence	tafyirt
sentences	tifyarin
separate	msebḍa
Sepedi	Sbedi
september	ctember
sequence	Amnakel
series	amazrar
serious	s tidet
seriously	s tidet
serve	Qdem
service	aseqdec
session	timlilit
set	εel
set	aεeddul
set up	Tuddsa
setting	Aɣwar
settle	aseggem
seven	ṣa
seventeen	mraw d ṣṣa
seventy	ṣṣa n tmerwin
several	aṭas
severe	ẓẓayen
sew	aselkim
sh	Cc
shade	tili
shadow	Tili
shake	xemmseɣ
shall	ad
shallow	ur d-yezzi
shame	anẓul
shape	talɣa
share	amur
sharp	yeqqur
she	nettat
she has	tesεa
she is	d tidet
shed	Lmeqsud
sheep	izimer
sheet	Tiferyin
shelf	tṛeffit
shell	Takkunt
shelter	taseddarit.
shield	asegdel
shift	ibeddel
shine	afeǧǧeǧ
ship	lbabuṛ
shipping	aseref
shirt	ttriku
shoes	isebbaḍen
shoot	qerres
shop	taḥanut
shopping	Ad yeqḍu
shore	tefsirt
short	wezzilen
shortage	lexṣaṣ
shot	qerrseḍ s ubeckiḍ
should	yessefk
shoulder	Tuyat
shout	leɛyaḍ
show	Yemla-iyi-d
show	assumer
show me	sken-iyi-d
shower	assu
shrimp	lqemṛun
shrink	asuddes
shut	Mdel
shut up	Ssusem
shy	ysetḥa
sibling	atmaten
siblings	atmaten
sick	yuḍen
side	udem
sigh	nnehta
sight	tmuɣli.
sightseeing	Asakac
sign	azmul
signature	azmal
significant	yettban
silence	tasusemi
silent	Tasusmi
silk	aḥrir
silly	d amehbul
silver	Aẓref
similar	am wa
simp	afraray
simple	isehlen
simultaneously	S tudkli
since	seg wasmi
sincere	s wul yeṣfan
sincerely	s wul yeṣfan
sing	cnu
singer	Acenay
single	yiwen
sink	izedder
sink	asugu
Sir	mass
sister	uletma
sister in law	yellis udeggal
sit	qqim
site	amkan
situation	talɣa
six	sḍis
sixteen	mraw d sḍis
sixty	sḍis n tmerwin
size	Acḥal ay tettlusuḍ
skill	Aẓwar
skills	tizemrin
skin	aglim
skinny	yeḍɛef
skip	asget
skirt	tacuct
sky	igenni
slave	aqeddac
sleep	igen
sleeping	Iḍes
sleepy	yesganay
sleeve	ifassen
slice	aḥerrif
slice	gzem
slide	uccuḍ
slightly	cwiṭ
slim	teḍɛef
slip	ccḍeɣ
slope	tasawent
slot	Abruj
slow	s ttawil
slowly	s ttawil
small	mečtuḥ
smart	uḥric
smell	Sraḥeɣ
smile	azmumeg
smile	zmummeg
smoke	awwu
smooth	yefsus
snack	tanalt
snail	ajeɣlal
snake	Azrem
snap	sṭerḍqeɣ
snow	adfel
so	ihi
so cute	D ayen icebḥen
so far	ar tura
soak	selxes
soap	Ṣṣabun
sober	tesεa tazmert
soccer	takurt n uḍar
social	tmetti
society	tmetti
socks	Iqaciren
soft	aleqqaq
software	aseɣẓan
soil	akal
sold	yezzenz
sold out	yenza
soldier	Aserdas
sole	iman
solid	anazbay
solution	tifrat
solve	fru
some	kra
somebody	ḥed
somehow	S kra n tarrayt
someone	yiwen
something	kra
sometimes	tiswiɛin
song	Tizlit
soon	qrib
sophisticated	yesεan tizemmar
Sorani	Surani
sore	dir
sore	qerriḥ
sore throat	yuḍen taɣect-nnes
sorrow	leḥzen
Sorry	suref-iyi
sort	ṣṣenf
sought	yettnadin
soul	taṛwiḥt
soulmate	tameddurt n teṛwiḥ
sound	taɣect
soup	aseqqi
sour	tesmem
source	aɣbalu
south	anẓul
space	littseɛ
spam	aselkim
span	Aggay
Spanish	lispan
spare	uffer
spare	zyada
speak	mmeslay
special	amaynut
species	senf
specific	d tin n
spectacular	yessewhamen
speech	awal
speechless	yegugem
speed	Lemɣawla
spell	ameslay
spend	yessexdamen
spent	Yserref
spicy	aqerḥan
spike	Tasbult
spin	ttellmeɣ
spinach	tibidest
spirit	taṛwiḥt
spit	Susef
splendid	Yeswehamen
split	Msebḍan
split	beḍu
spoil	ixeṣṣer
spoiled	ixeṣṣer
spontaneous	d tin ur nettwaḥwaǧ
spoon	Taɣenjayt
spot	amkan
spouse	argaz
spread	amyag
spring	tafsut
square	amkuẓ
squeeze	ad ẓẓmeɣ
squid	aqerniḍ
squirrel	anẓid
st	lwali
stab	sentu
stable	imnekayen
stack	Agudi
staff	Tarbaεt
stage	asurif
stain	Acamiḍ
stairs	isunan
stake	tgejdit
stalk	Ageṭṭum
stall	Asenser
stamp	aɣḍem
stand	ateg
stand	ad d-teqqim
standard	Amslugan
star	Itri
start	bdu
started	Yebda
starving	laẓ
state	awanek
state	sken
statement	agenna
station	teɣsert
statue	Asebdad
status	talɣa
stay	qqim
stay	Iɣimi
stay safe	ḥader iman-ik
steady	terkid
steak	biftak
steal	tuker
steam	ddexxan
steel	Dkir
steep	Ygan
stem	lejdra
step	asurif
stick	ɛelleq
stiff	yeqqur
still	mazal
still	animir
sting	Tuqsa
stingy	amecḥaḥ
stir	senhez
stock	lɛewla
stolen	Yetwaker-d
stomach	aɛebbuḍ
stone	Ablaṭ
stood	ibedd
stool	taberduεt
stop	ḥebset
storage	asexzen
store	taḥanut
storm	aḍu
story	tamεayet
stove	lkanun.
straight	srid
straightforward	srid
strain	S yiɣil
strange	abeṛṛani
stranger	Abeṛṛani
strategy	Tasudest
straw	Alim
strawberry	Timerziwt
streak	Aferrug
stream	afeggḍ
street	abrid
strength	leggder
stress	yetqelleq.
stretch	seɣzef
strict	tesseḥṛas
strike	amennuɣ
string	amrar
strip	Akerzi
strive	tetteg
stroke	tezɣint
strong	yeǧhed
struck	Twet-itt
structure	lebnyan
struggle	yennuɣ
struggle	amennuɣ
struggling	Yetnaɣ
stubborn	yetɛanad
stuck	yelseq
student	Anelmad
study	azraw
study	sbrurez
studying	Leqraya
stuff	leḥaǧa
stunning	yessewhamen
stupid	aɛeggun
style	Aɣanib
subject	amyag
submission	asekcem
submit	asebter
substance	asget
substitute	asbdel
subtle	d tiferkiwin
succeed	yerbeḥ
success	rrbeḥ
successful	rbeḥ
such	am
such as	am
suck	ṭṭed
sudden	imiren
suddenly	deg yiwet n teswiɛt
suffer	ttḥuzan
suffering	Yenɛettab
sufficient	ddeqs
sugar	sskeṛ
suggest	ssumer
suggestion	takti
suit	Aselsu
suit	yels
suitable	yessefken
suitcase	tbalizt
sum	Timerni
summary	agzul
summer	anebdu
summit	Taqerruyet
sun	Iṭig
sunday	Acer
sunny	itij
sunset	afud n yiṭij
sunshine	tafukt
super	Yelha
superior	ameqqran
supervisor	amεellem
supper	Ygerrez
supply	lemaɛta
supply	yettak
support	amatag
support	alel
suppose	ad d-nini
supposed	ilaq ad yili
sure	iban
surface	tahri
surge	Aglay
surgery	tamzelt
surname	isem n twacult
surprise	ɣef lɣeflan
surprised	Yewhem
surrender	sellem
surrounding	tuzya
surveillance	Asefqed
survey	aseɣti
survey	ad skeydeɣ
survive	ad yidir
suspect	yecuk
suspect	ameckuk
suspended	yettwaḥbes
suspicious	yettcikki
sustain	sehbiber
sustainability	asuddem
sustainable	d ayen yettwaḥerzen
swag	Aglaf
swallow	issebleɛ
swap	beddal
swear	yeggul
sweat	tidi
sweater	atriku
sweep	ferrḍeɣ
sweet	ẓiḍ
sweet dreams	tirga lεali
sweet tooth	taẓidant
sweetheart	Ay aḥbib
swell	asefti
swelling	Timerniwt
swim	Succef
swimming	Yetɛumu
swing	blelli
swing	asuddes
switch	beddel
switch	amsenfal
swollen	Ssuf
sword	ajenwi
symbol	azamul
sympathy	lɣiḍ
symptoms	asken
system	anagraw
table	tdabut
tackle	Amu
tag	Tibzimin
tail	taseḍḍa
take	awi
take away	aţṭef abrid
take care	ḥader iman-ik
take off	kkes
taken	yettwakkes
talk	sawel
talk	awal
talkative	amsuget
tall	kemmil
Tamazight	Tamaziɣt
tap	abezzim
tap	ddes
tape	akalas
target	ḥekker
target	iswi
task	axeddim
taste	εber
taste	taεbrit
tasty	Bnin
taught	yesselmad
tea	latay
teach	aselmed
teacher	aselmad
team	tarbaɛt
tear	agezam
tears	imeṭṭawen
tease	ad t-tceɣleḍ
technology	teknussna
teeth	tuɣmas
tell	ini-d
tell me	ini-d
temper	ţbiεa
temperature	Taẓɣelt
temple	lemqam
temporary	ametti
ten	mraw
ten thousand	mraw n igiman
tenant	Akeray
tend	yesɛan
tendency	Tiɣumdin
tender	leḥnana
tense	yetqelleq
tension	lḥir
tent	Aqiḍun
tentative	tawsest
term	Awal
terms	imeslayen
terrible	yessewhamen
terrific	Acekkit
territory	tamnaḍt
test	akayad
test	yeεred
text	aḍris
than	tanya
thank	tanemmirt
thank you	tanemmirt
Thank you for your patience while we investigate shipment	Tanemmirt ɣef ṣṣbeṛ-nwen skud nesteqsay ɣef tulust-nni.
thank you so much	tanmirt-ik aṭas
thank you very much	Tanemmirt aṭas
thanks	tanemmirt
Thanks for using our app	tanemmirt imi seqdacet aslaɣ-nneɣ
that	wihin
that is	D wa i d
that's good	D ayen yelhan
the	t
theft	Tikurḍa
their	n-sen
them	asen
theme	Asentel
themselves	iman-nsen
then	ihi
theory	Asekkuḍ
there	dinna
there are	Ellan
there is	yella
therefore	ihi
these	wigi
they	nutni
they are	atnan
thick	zhur
thief	amakar
thigh	tamessaḍt
thin	taẓayt
thing	taɣawsa
things	tɣawsiwin
think	xemmem
third	Wis kraḍ
thirsty	fad.
thirteen	mraw d kṛaḍ
thirty	Krad n tmerwin
this	ayagi
this is	d ayagi
thorough	Silqi
thoroughly	akken ilaq
those	wid
though	ɣas akken
thought	yeɣil
thought	axemmem
thoughtful	yeɣil
thoughts	Yetxemmim
thousand	agim
thread	amrar
threat	asigwad
threaten	yeggez
three	kraḍ
threshold	tazwara
thrilled	sseɛd
thrive	ad tgerrez
throat	ugerjum.
through	srid
throughout	deg yal
throw	ategecc
thumb	adebuz
thunder	rrεeḍ
Thursday	Lexmis
thus	akka
tick	tasellufet
tide	Angi
tidy	ssemsaway
tie	yeqqen
tie	tafikult
tiger	aksil
tight	ḍeyiq
Tigrinya	Tigrinya
time	akud
timid	Taksilt
tiny	amecṭuḥ
tip	tenṣiḥin
tips	iɣef
tire	Tinges
tired	ɛeyyu
tissue	tamecwart
title	azwel
to	i
to be	Ad yili
toast	Aɣrum
today	assa
toddler	Aqruj
toes	tifednin
together	lwaḥi
toilet	abduz
told	yenna-yas
tolerance	Asuref
tolerate	agellez
tomato	tumaṭic
tomorrow	azekka
tongue	Iles
tonight	iḍ-a
too	ula d
took	yewwi
tool	dduzan
tools	dduzan
tooth	tuɣmest
top	afella
topic	Asentel
torn	Yesɣers
torture	Ifker
total	iɣyeɣen
touch	anali
tough	yeqquren
tour	Taberninet
toward	ɣer
towards	ɣer
towel	tasfeḍt
town	tamdint
toxic	texneq
trace	yeḍfer
track	abrid
trade	tanezzuyt
trade	steg
tradition	ansay
traditional	lɛaddat
traffic	Tamsuɣelt
trail	abrid
train	tamacint
training	aselmed
trait	Tikliwin
traits	timsal
transfer	ceggeɛ
transition	Asegbat
translate	trejmat
transparent	Tafrawant
transport	Tidist
transportation	Asiweḍ
trap	tifxet
trash	amur
trauma	ideddisen
travel	adirah
tray	Asesmal
treasure	agerruj
treat	afud
treatment	yettdawi
tree	Ttejṛa
tremendous	ameqqran
trend	aɛaned
trial	ccṛeɛ
trick	ikellex
tried	yeεreḍ
trigger	anekar
trigger	nker
trim	Tcar
trip	tikli
trouble	ugur
trousers	isebbaḍen
truck	akamyun
true	d tidet
trunk	agemmay
trust	Fles
trust	taflest
truth	tidet
try	ɛreḍ
Tsonga	Tsugna
tube	Ajeεbub
Tuesday	Ass n tlata
tuition	tiɣri
turkey	Turk
turmeric	zεefran
turn	dewer
turtle	Amhettak
tutor	asegdel
twelve	Mraw d ssin
twenty	Snat tmerwin
twenty-one	snat n tmerwin d yiwen
Twi	Twi
twice	snat n tikwal
twist	Bbernenni
two	sin
type	aru
typical	amaynut
ugly	ilic
ultimate	aneggaru
umbrella	tasiwant
unable	ur yezmir ara
uncle	xali
unconscious	yendewwax
under	ddaw
underneath	ddaw
underrated	Afham
understand	fehmeɣ
understood	yegza
unfortunately	d asḥissef
uniform	Tayiwnit
unique	ussaf
unit	Abuyan
university	Tasedawit
unknown	ur itwassen ara
unless	ala ma yella
until	alamma
unusual	ur d-yezga ara
up	dasawen
up to you	ɣur-k
update	stemriɣ
update	amucced
upgrade	asileɣ
upgrade	sileɣ
upon	ɣef
upset	ambiwel
urban	aɣerman
urge	aksaf
urge	ccihwa
urgent	d ayen iεeǧlen
us	nekni
use	aseqdec
use	seqdec
used	yetwasexdam
useful	itewasexdam
useless	ur nesɛi azal
usual	am tannumi
usually	s umata
utility	ilaq
vacation	imuras
vaccination	acraḍ
vaccine	creḍ
vacuum	Sizdeg
vague	ur d-yefhim
valid	yesɛan azal
valley	Iɣzer
valuable	yesεan azal
value	sazel
value	azal
variety	agmuḍ
various	imgaraden
vary	mgarad
vase	taqbuct
vast	ameqran
vegetable	imɣan
vegetables	tidal
vehicle	takeṛṛust
vendor	Imzenzi
venom	ssem
venture	Tirmisin
venue	amḍiq
verify	ad d-teẓreḍ
versatile	Taseɣnawt
version	tasenfelt
vertical	Abedday
very	xilla
very good	Yelha mliḥ
vessel	taḍebsit
via	Seg
vibe	iswaɣ
vibes	tiɣriwin
vicious	Amcum
victim	taɣtest
video	Tavidyut
view	tamuɣli
village	Taddart
villain	Amcum
vinegar	Amaɣus
vintage	d aqdim
violence	Takriḍt
violent	aqehhar.
viral	Anfafad asenselkim
virgin	tilemẓit
virtual	d tin n tidet
virtue	tazelma
vision	tamuɣli
visit	arzaf
visit	rzef
visual	Amwalan
vital	yesɛa azal
vivid	ydder
vocabulary	tamawalt
voice	Taɣect
void	ur yesɛi azal
volume	imesli
volunteer	ţekki
vomit	yerra
vomit	iriran
vulnerable	yettwaḥerzen
wage	Lexlaṣ
wages	Lexlaṣ
waist	amḍar
wait	arǧu
waiter	axeddam ittsarban
waiting	yettraju
wake	Aki
wake up	kker
walk	tiddit
walk	ddu
walking	Tiddit
wall	lḥiḍ
wallet	tezḍam
wander	amenṭar
wanna	bɣiɣ
want	yebɣa
wanted	bɣan
war	Lgirra
wardrobe	taxzant
warehouse	amkan
warm	yeḥma
warm	seḥmu
warn	Ɛeyyen
warning	Aɛeyyen
warrior	ammenuɣ
was	yella
wash	ssired
waste	aḍeyyeɛ
waste	iḍeyyeɛ
watch	saɛa
water	aman
watermelon	alegguẓ
wave	lmuja
way	abrid
we	nekni
we are	aqlaɣ
we can	nezmer
weak	iḍɛef
weakness	ḍḍeɛfan
wealth	ssεaya
wealthy	d imerkantiyen
wear	lles
wearing	Lebsa
weather	Tallit
wedding	tameɣra
Wednesday	Lḥedd
weed	azaglu
week	ddurt
weekend	taggara n ssmana
weight	taẓayt
weight	ttuzureɣ
weird	d ayen yessewhamen
welcome	ansuf yis-wen
welfare	nḥareb ɣef
Well	dɣa
well done	Yelha lḥal
went	irruḥ
were	llan
west	agmuḍ
wet	yebzeg
whale	iselman
what	d-acu
what about you	Amek i telliḍ?
what are you doing	d-acu i txedmeḍ
what are you doing now	d acu i txeddmeḍ tura
what are you doing right now	D-acu txedmed tura
what do you do	D acu txeddmeḍ?
what do you do for a living	d acu i txeddmeḍ i tudert-ik?
what do you mean	D acu i tebɣiḍ ad tiniḍ
what do you want	d-acu tebɣiḍ
what happened	acu yeḍran
what is	d acu
what is this	D-acu-t wa
what is your job	D-acu-t uxeddim-ik
what is your name	isem-ik
what's up	D-acu yellan
what's your name	isem-ik
whatever	ayen yellan
wheat	Irden
wheel	iberrnen
when	melmi
whenever	yal tikkelt
where	anda
where are you	anda telliḍ
where are you from	ansa-k
where are you now	Anda-k tura?
where do you live	Anda i tzedɣeḍ?
where is	Anda-t
whereas	Imi
whether	ma yella
which	wi
while	skud
whisper	astewtew
whistle	ṣeffer
white	amellal
who	anwa
who are you	Anwa-k
who is	anwa i yellan
who is this	anwa-t wagi
whole	akk
whom	anwa
whose	wid
why	i wacu
why not	ayɣer ala
wicked	amcum
wide	wessiɛ
widow	taǧǧalt
width	assumer
wife	tameṭṭut
wild	fahmeɣ
will	aɣazal
will	ad
willing	d wid yebɣan
win	afran
wind	aḍu
window	ṭṭaq
windy	d aḍu
wine	ccrab
winter	tagrest
wipe	Sfeḍ
wire	Inziz
wisdom	tamusni
wise	aḥdad n wawal
wish	sirem
wish	asirem
wish you all the best	saramaɣ-ak akk ayen yelhan
witch	win
with	AK
withdraw	kkes-d
withdrawal	jebed
within	deg
without	bela
witness	Inigi
witness	wanes
witty	Amegzu
wolf	aɣsi
woman	tameṭṭut
women	tilawin
won	Terbeḥ
won't	Ur yebɣi ara
wonder	yewhem
wonderful	yelha
wood	asɣar
wool	taduṭ
word	awal
words	Awalen
work	ixeddim
work	axdem
work out	Yexeddem
working	Ixeddim
world	Amaḍal
worm	tawekka
worn	Yeḥfa
worried	Tecɣeb
worry	yetqelleq
worse	yir
worship	ɛebd
worst	ayen n diri
worth	azal
worth it	yuklal-it
worthy	yuklal
would	AD
wound	lǧerḥ
Wow	yelha
wrap	ssemttuttel
wrath	Agernin
wrist	amrar
write	aru
Write here	aru d-a
writing	Tira
written	imyura
wrong	yeɣleḍ
wrote	Yura
yard	afrag
yawn	afayi
yawn	yetfayi
Yeah	ih
year	Aseggas
years	iseggasen
yeast	iɣes
yell	ysuɣ
yellow	awraɣ
Yes	ih
yes baby	ih a taεzizt
yes dear	ih ay amdakul
yes honey	ih a tayri
yes my love	ih a tayri-w
yes of course	Ih, d ayen ibanen
yesterday	iḍelli
yet	mazal
yield	asuf
you	kečč
you are	kečč
you are beautiful	Tcebḥeḍ
you are so beautiful	Tecbḥed aṭas
you are welcome	bla lemzeya
you can	tzemreḍ
You know	Tezrid
you too	Ula d kemm
you're welcome	Ulac aɣilif
young	amecṭuḥ
your	agla-k
your welcome	Ansuf yis-m
yourself	iman-im
youth	temẓi
you’re welcome	Ansuf yess-k
yummy	Aleqqaɣ
zero	ilem
