a little	panono
a lot	ifingi
a lot of	ifingi ifya
abandon	ukusha
abandoned	umulekelesha
abide	ukwikala
ability	kwishiba
ability	maka
able	kuti
about	pali
above	pamulu
abroad	ku calo cimbi
absence	ukubulilwa
absent	ukukanabapo
absolutely	cine cine
absorb	kwingisha
abstract	kwelenganya
absurd	ukusenda
abundance	ubwingi
abundant	ifingi
abuse	umucushisha
accent	imilandile
accept	ukusuminisha
access	ukusanga
access	ukuwata
accident	ubusanso
accommodation	ukwikala
accomplish	ukukwanisha
accomplished	ukukwanisha
according	ukulingana
account	akaunti
accuracy	filya fine
accuracy	ukutontapo
accurate	ukulungika
accused	ukubepeaha
accused	ukepulesha imilandu
ache	ukukalipwa
achieve	ukufikilisha
achievement	ukukwanisha
acknowledge	ukusumina
acquaintance	ukwishibana
acquire	ukukwata
acquired	ukukwata
acquisition	ukukwata
acquisition	ukwambako
across	ukupita
act	ukubomba
action	ukubomba
active	icilebombeka
activities	ifyakucita
activity	umulimo
actor	kapanga
actual	cilyacine
actually	na kuba
actually	cine cine
acute	sana
adapt	ubwana
add	ukulundapo
addicted	ukubelesha
addition	ukulundapo
additional	ukulundako
address	aderesi
adequate	ukukumanina
adjacent	ukupalamina
adjective	ukulondolola
adjust	ukuwamya
admire	ukukumbwa
admit	ukusumina
adopt	ubwana
adopt	ukusunga
adorable	icitemwiko
adorable	ukuwama
advance	ukulunduluka
advance	ukutwala pantanshi
advanced	pantanshi
advantage	ubusuma
adventure	cangalo
advertisement	ukusabankanya
advertising	ukwishibisha
advertising	ukutungilila
advice	ukupanda amano
advise	ukupanda amano
advocate	uwakulandilako
aesthetic	ukumoneka bwino
aesthetic	ukuyemba
affair	icito yenu
affair	mulandu
affect	ukukuma
affection	imyumfwile
afford	ukukwanisha
affordable	ukukwanisha
afraid	ukutina
after	panuma
afternoon	icungulo
afterwards	panuma
again	nakabili
against	ukwalukila
against	ukukaana
age	umwaka
age	inkulo
agency	uwakutuma
agent	uwakutuma ukubomba
aggressive	ubunaushi
agile	ukucincila
ago	akale
agree	ukusuminisha
agreement	ukusuminisha
agriculture	ifyabulimi
ahead	pantanshi
aid	ubwafwilisho
aim	ukutonta
air	umwela
airport	icibansa ca ndeke
aisle	kupita
alarm	ukusoka
alarm	ukwishibisha
alcohol	ubwalwa
alert	ishibisha
alive	uwamweo
all	fyonse
all	conse
all right	cilifye bwino
all the best	ifisuma fyonse
allow	ukusuminisha
allowed	ukusuminisha
almost	mupepi
almost	panonofye
alone	weka
alone	beka
alone	neka
along	pamo
already	kale
Alright	Cilifye bwino
also	nakabili
alternative	ifya kubomfya fimbi
although	nangula
always	lyonse
am	ine
amazing	icipesha amano
amazing	cawama
ambiguous	ifishalondoloka
ambition	ukufwaisha
ambitious	ukufwaisha
amend	ukubombelapo
amid	pa kati
among	pamo
among us	pakati kesu
amount	impendwa
amusing	icisuma
an	ne
analysis	ukupitulukamo
ancestors	ifikolwe
anchor	ukwikatilila
ancient	ifyakale
and	ne
and	kabili
and you	nga iwe
angel	malaika
angel	umungeli
anger	ukufulwa
angle	imbali
angry	ukukalipa
angry	ukufulwa
animal	inama
ankle	akatende
anniversary	ubushiku bwa pa caka
announcement	ukwishibisha
annoy	ukukalifya
annoyed	ukuufulwa
annoying	ukukalifya
annual	cila mwaka
anonymous	uushaishibikwa
another	cimbi
answer	ubwasuko
anticipate	ukwenekela
anxiety	ukusakamikwa
anxious	ukusakamikwa
any	icili conse
anymore	nakalya
anyone	uuli onse
anything	ifili fyonse
anyway	na kuba
anyways	nakuba
apart	ukupaatukana
apartment	ing'anda
apologize	ukulonmba ubwelelo
apparent	cimoneka
apparently	mu kumonekesha
appeal	ukwipukisha
appear	ukumonekela
appearance	imimonekele
appeared	ukumonekela
appetite	ukufwaya ifyakulya
apple	apulo
application	ukubomfya
apply	ukubomfya
appointment	ukusontwa
appreciate	ukutotela
appreciation	ukutotela
approach	ukupalama
appropriate	icalinga
approval	ukusuminisha
approve	suminisha
approved	ukusuminishiwa
approximately	mupepi
approximately	nalimo
april	shinde
arbitrary	mulinganya
architect	uwa makuule
architecture	uwamakule
archive	umakusungila
are	bali
are you	iwe niwe
are you busy	bushe uli ne milimo
are you married	bushe walyupwa
are you married or single	walyupwa atemwa waba weka
Are you still there?	Mucili epomuli?
are you there	epo uli
area	incende
argue	ukukansana
argument	ukunkansana
arise	ukwima
arm	ukuboko
army	umushilika
around	ukushinguluka
arrange	tantika
arrangement	ubutantiko
arrival	ukufika
arrive	ukufika
arrived	fikile
arrogant	ukuituntumba
arrogant	icilumba
arrogant	ukuitumika
arrow	akakusontelako
art	ukulenga
article	inkalata
artificial	icakupanga
artist	kemba
as	nga
as	kwati
as	nge
as long as	kanofye
as well	nacena
as well as	ukubikamofye
ash	ulukungu
ashamed	insoni
ask	ukwipusha
asked	aipusha
asleep	ukulala
aspect	iciputulwa
aspect	ulubali
Assamese	Assamese
assault	ukucena
assembly	ukukolongana
assertive	ukusuminisha
assess	ukupima
assessment	ukucenchenta
asset	icipe
assets	ifipe
assign	ukupela
assignment	umulimo
assignment	icakucita
assist	afwa
assistant	kafwa
associate	ampana
associated	capamo
association	ukulanshanya
assume	ukutontonkanya
assumption	ukwelenganya
at	pa
at least	efilyako
ate	lya
athlete	kangala wa mangalo
attach	ukukakatika
attached	kakatikwa
attachment	icakakatikwako
attack	ukucena
attempt	esha
attend	ukusangwa
attendance	ukusangwa
attention	ukubikako amano
attention	ukuposako amano
attitude	imibele
attract	ukongola
attraction	icakutungilila
attractive	ukuyemba
attribute	imibele
audience	ibumba
august	kutumpu
aunt	mayo senge
aunty	nasenge
authentic	cine cine
author	kalemba
authority	insambu
autumn	mibundo
available	icilipo
available	epocili
average	avareji
average	cipimo
avoid	ukusengauka
avoid	taluka
awake	ukubuuka
award	icilambu
aware	ukwishiba
awareness	ukwishiba
away	ukutali
awesome	cisuma sana
awful	icabipa
awful	icakutinya
awkward	ukubifya
Aymara	Aymara
baby	akanya
baby	umwana
bachelor	nkungulume
back	ukubwelela
back	kunuma
background	apakwambila
bad	icibi
bag	icola
bait	lyambi
bake	ukwipika
bakery	umwakupangila
baking soda	ukupanga soda
balance	ukuba pakati
ball	umupila
Bambara	Bambara
banana	inkonde
band	bakalisha
bank	kwishilya
bar	mupindo
bar	icikulwa cabwalwa
barely	panono
barely	kwempe
bargain	ukumfwana
bark	ukubosa
barley	limo limo
barrier	umwakupelela
base	icapanshi
based	pamulandu
basement	umuputule wapanshi
basic	kwambilapo
basically	na kuba
basil	bondwe
bastard	umwana wa muchani
batch	katundu
bath	samba
bathroom	umwakusambila
battery	ibatili
battle	ubulwi
bay	icishi
be	ba
be careful	cenjela
be careful	isunge bwino
beach	ululamba
beam	ukubengeshima
beans	cilemba
bear	ukubelelela uluse
beard	umwemfu
bearing	icisendo
beast	iciswango
beat	ukulisha
beat	ukuma
beautiful	ica emba
beauty	busuma
became	ukuba
because	pantu
become	ukuba
bed	ubusanshi
bedroom	umuputule wa kusendamako
bee	ulushimu
beef	inama
been	ukuba
beer	ubwalwa
before	pa ntashi
before	ilyo
began	ambile
begin	amba
beginning	intendekelo
behalf	ukwimininako
behave	icindike
behavior	imibele
behaviour	imibele
behind	kunuma
being	ukuba
belief	ukucetekela
believe	cetekela
belly	ulufumo
belong	ukuba
beloved	wemutemwikwa
below	pesamba
belt	umushipi
Bemba	Ichibemba
bench	icipuna
bend	ongamya
beneath	pesamba
benefit	amapaalo
benefits	ifyakunonkelamo
beside	pambali
beside	nalimo
besides	pa mbali ya
best	icisuma
best of luck	ukacite bwino
best regards	ukuposha kusuma
better	mibele isuma
better	cawamapo
better	bwino
between	pakati
beverage	ubwalwa
beyond	ukucila
Bhojpuri	Bhojpuri
bias	akapaatulula
biased	kupatulwa
bicycle	incinga
bid	ukutambika
big	icikulu
big	ubukulu
bike	inchinga
bill	amalipilo
bind	ukukaka
bird	akoni
birthday	ubushiku bwakufyalwa
bit	panono
bite	ukusuma
bitter	ubukali
black	icafita
black	imfifi
blade	icakucekelako
blade	ulupanga
blame	ukupeela umulandu
blank	tapali
blanket	icakufimbana
blast	ukopoleka
bleach	ukonaula
bleach	ukupatulanya
blend	ukuba
bless	pala
blessed	uwapalwa
blind	impofu
bliss	ukusansamuka
block	ukulesha
blood	umulopa
bloom	icipyango
blow	ukupuupa
blow	ukuputa
blue	bluu
blue	kafiifi
blunt	icamba
blunt	ukupeepa
blunt	fwaka
board	bumba
boat	ubwato
body	umubili
boil	ukwipika
bold	ukupama
bond	suntinkanya
bone	ifupa
book	icitabo
boost	ukusunkilisha
booster	ukucincisha
boot	insapato
boots	insapato
border	umushilwa
bore	afyele
bored	ukutendwa
boring	ukutendusha
born	ukufyalwa
borrow	ukwashima
borrow	ukukongola
boss	abakalamba bancito
both	fyonse fibili
bother	ukucusha
bottle	ibotolo
bottom	pesamba
bought	ukushitwa
bounce	ukutanuka
bound	ukukakwa
boundaries	umwakupelela
bow	ukukontama
bowl	inweno
box	bokoshi
boy	umulumendo
boyfriend	umwaume umunandi
bracelet	amolu yacela
brain	ububongo
branch	umusambo
brand	umusango
brave	ukushipa
breach	ukonaula
breach	ukupatulanya
bread	umukate
break	ukutusha
break	ukutoba
breakfast	icakulya cakacelo
breast	ibele
breath	ukupema
breathe	ukupema
breed	ukusanda
brick	ulunjelwa
bride	nabwinga
bridge	ubulalo
brief	panono
bright	ulubuto
brilliant	ukucelebuka
bring	leta
bro	munyina
broad	cinkumbawile
broadcast	ukusabankanya
broke	toba
broke	ukukana kwata
broken	ukutobeka
broom	icipyango
brother	munyinane
brother in law	mulamu umwaume
brought	ukuletwa
brown	fitulukila
brush	kusha
bucket	imbeketi
buddy	we cibusa
budget	bajeti
bug	icishishi
build	ukukula
building	ukukula
built	ukukula
bulk	ifingi
bull	ing'ombe
bully	kacusha
bully	icipondo
bump	ukukumana
bunch	ibumba
bundle	bando
burden	icisendo
buried	ukushika
burn	ukoca
burst	ukupoleka
bury	ukushika
bus	basi
bush	impanga
business	amakwebo
bust	ukupoleka
busy	milimo
busy	ukupamfiwa
but	nomba
but	lelo
butter	umukaka watikama
butterfly	icipelebesha
button	ibatai
buy	ukushita
by	na
by the way	elyo kabili
by the way	na kuba
bye	naya
cabbage	kabeji
cabbage	kabiki
cabinet	cabineti
cage	kasalanga
cake	keke
calf	umwana wang'ombe
call	tuma
call me	njita
called	ukwitwa
calm	ukutekanya
came	ishile
campaign	kampeni
can	kuti
can't	tekuti
Cancel	Ukuleesha
cancer	impwalonda
capable	ukukwanisha
capacity	amaka
capital	umusumba ukalamba
capital	indalama
caption	umutwe
capture	ukwikata
car	motoka
career	incito
careful	cenjela
carefully	ukutekanya
careless	umulekelesha
caring	ukusakamana
carpenter	kapala wambawo
carpet	kapeti
carrot	kalota
carry	ukusenda
carry	ukwimya
carry on	konkanyapo
carry out	ukubomba
case	umulandu
cash	indalama
cast	ukuposelwa
castle	ing'anda yamfumu
casual	buyefya buyefya
cat	pushi
catch	ukwikata
category	ifiputulwa
cattle	ing'ombe
caught	ukwikata
caught	ukwikatwa
cause	kulenga
caution	ukusoka
cautious	ubusoke
cave	lupako
cease	ukupwisha
ceiling	umutenge
celebrate	ukusefya
cell	akabulungwa
cell	ibaba
center	pakati
century	imyaka umwanda umo
cereal	fya ngano
ceremony	ukusefya
certain	shininkisha
certainly	cine cine
certificate	ipepala
chain	munyololo
chair	umupando
challenge	ubwafya
chance	ishuko
change	ukuchinja
change	ukwalula
chaos	icimfulunganya
character	imibele
characteristics	imibele
charge	ukupeela
charge	ukulipila
charity	ukutemwa
charming	ukuyemba
chart	icikopo
chase	ukukonka
chase	ukutamfya
chat	ukulanshanya
cheap	icishakwata mutengo
cheat	bepa
cheating	ukubeepa
check	ceceta
cheek	itobo
cheek	isaya
cheer	ukusansamuka
cheerful	ukusansamuka
cheers	eya mukwai
cheese	shiisi
chemistry	kemestri
cherish	ukutemwa
cherish	tangisha
chess	ukutamfya
chest	icifuba
chew	sheta
chicken	inkoko
chief	imfumu
child	umwana
childhood	ku bwaice
children	abana
chill	tekanya
chimneys	chimuni
chin	icilefulefu
chocolate	chokoleti
choice	ukusala
choose	sala
chop	ukuputula
chores	imilimo ya pa ng'anda
chubby	uwaina
church	ulukuta
cinnamon	cinamoni
circle	bulungana
circle	shunguluka
circumstances	ifingalengesha
citizen	umwikashi
city	umusumba
claim	ukupoka
claim	ukulipilwa
clarify	londolola
class	kalashi
clay	iloba
clean	ubusaka
clear	ukubuuta
clerk	uulemba
clever	ukusalapuka
clever	ukucenjela
client	uubomba
cliff	ulupili
climate	imiceela yalukaaluka
climb	ukukwela
clingy	lunkonena
clock	inkoloko
close	ukwisala
closet	umuputule
cloth	icakufwala
clothes	ifyakufwala
cloud	ikumbi
cloudy	ikumbi
clown	icinyau
clue	icishibilo
clumsy	umulekelesha
cluster	icisansangu
coach	kasambilisha
coal	amalasha
coast	amasamba
coat	ilaya
coffee	kofi
cognitive	amano
coincidence	amankumanya
cold	ukutalala
collapse	ukupona
collar	inteneshi
colleague	cibusa
colleagues	ifibusa
collect	senda
collection	ukulungamika
college	isukulu lya masambililo yakalamba
color	langi
colorless green ideas slept furiously	amano aya shakwata ilangi ayakatapa katapa yalipitile mubukali
colour	ilangi
column	iciputulwa
comb	icisakulo
combination	suntinkana
combine	kumbikanya
come	isa
come here	isa kuno
come on	iseni
comfort	talalika
comfortable	ukwikushiwa
coming	ukwisa
coming soon	ukwisa bwangu
command	ifipope
comment	ukulandapo
commercial	amakwebo
commission	umulimo
commit	bika
commit	tula
commitment	ukuipeela
committed	ukuipelesha
commodity	icakubomfya
common	icaishibikwa
common	icaseeka
communicate	ukulanshanya
communication	ukulanshanya
community	ubwikashi
commute	ukwenda
companion	umutemwikwa
company	kampani
compare	palanya
comparison	ukupalanya
compassion	uluse
compassion	icikuku
compassionate	uluse
compatible	icalingana
compete	ukucimfyanya
competent	ukwishibisha
competition	ukucimfyana
competitive	ukucilikana
complain	ukuilishana
complaint	ukuilishanya
complement	ukutasha
complete	ukupwisha
completely	ukupwilikosha
complex	icapikana
compliance	ukucita ifilekabilwa
complicated	icakosa
compliment	ukutasha
comply	ukumfwila
comply	ukunakila
composition	mipangilwe
compound	ulubansa
comprehension	kukutuluka
comprehensive	icakukutuluka
compromise	ukuususukako
compulsory	ukupatikisha
computer	compyuta
concentrate	bikako amano
concept	itontonkanyo
concept	ilyano
concern	ukusakamikwa
concerned	ukusakamana
concert	ukulongana
conclusion	ukusondolwela
concrete	icaikata
concrete	icauma
condition	umusango
condition	umubele
conditions	imibele
conduct	ifunde
conference	ukulongana
confess	ukutumbula
confidence	ukucetekela
confident	ukucetekela
confirm	ukushininkisha
conflict	inkondo
conflict	ubulwi
conflict	ukupusana
confused	ukulubana
confusion	icimfulunganya
congrats	ukutasha
congratulation	ukutashiwa
congratulations	ukutasha
connect	ukusuntikanya
conquer	ukucimfya
conscious	kampingu
consciousness	kampingu
consent	ukusuminisha
consequences	ifingafumamo
conservation	ukulanshanya
conservative	ifyakubomfya
consider	tontonkanya
consider	languluka
considered	lcalangulukwa
consist	ukukwata
consistency	libili libili
consistent	umupampamina
constant	ukutwalila
constantly	ukutwalilila
constipation	ukufimbilwa
construction	ubukule
consume	ukulya
consume	ukunwa
consumption	ukunwa
contact	ukukumana
contagious	icalwala
contagious	icikwete ubulwele
contain	ukukwata
contains	ukukwata
contemporary	inshita imo ine
contempt	umulandu
content	ifyebo
content	ifilimo
content	ukuteka mutima
contest	ubulwi
context	imibele
context	icishungulwike
continent	icalo
continue	konkanyapo
contract	incito
contrast	ukupusanya
contribute	ukubikapo
contribution	ukusangula
control	ukutungulula
controversial	icakusobanya
convenience	ukuyafwilisha
convenient	ukuwamina
conversation	ukulanshanya
convert	ukupilibulwa
convey	ukupitila
convince	ukushinina
convinced	uwashininwa
cook	ukwipika
cooking	ukwipika
cool	talala
cool	bwino
cooperation	ukwikatana
cope	ukukwanisha
copper	mukuba
core	cifulo ca pa kati icibilima
corn	itaba
corner	icifutu
correct	ukulungika
cost	umutengo
costume	icakufwala
cottage	ing'anda
cotton	ubutonge
couch	umupando
cough	ukukosomola
cough	ukukola
could	kuti
council	icilye
count	ukupenda
counter	kaunta
country	icalo
countryside	kumbali yacalo
couple	abaupana
courage	ukushipa
course	inshila
court	icilye
courtesy	cacitwaa na
cousin	umufyala
cover	ukufimba
cow	ing'ombe
coward	camwenso
cozy	kushisha
crab	ing'anse
crack	umulale
craft	ukupanga
crap	amafi
crash	ukutobeka
craving	insala ya
crawl	ukwamfula
crazy	ukupena
crazy	ukufulungana
create	ukulenga
create	ukupanga
creative	ukusalapuka
credit	inkongole
creep	ukusokama
creepy	ukutiinya
crew	ibumba
crime	umulandu
cringe	umwenso
cringe	ukusebana
crisis	ubusanso
criteria	ifipimo
critical	icakosa
criticism	ukutalikishanya
crop	ukuputula
crops	amataba
cross	ulupanda
crow	ukwamfula
crowd	ibumba
crowded	abantu abengi
crowded	ibumba ilikalamba
crown	icilongwe
crucial	ukukakala
cruel	ukucusha
cruel	ukubipa
cruise	ukubutuka
crush	fwanta
crush	onaula
cry	lila
cucumber	icibimbi
cuddle	ukwikatana
culture	intambi
cunning	ukucenjelesha
cup	kapu
cup	inkomaki
cupboard	kabati
curb	ukupwisha
cure	ukuundapa
curfew	inshita ya kubwelela ku ng'anda
curiosity	icimpwena
curious	ukufwaisha ukushiba
curly	ukupombana
curly	ukunyongana
currency	indalama
current	pali nomba
currently	nomba line
curse	tipa
curtain	iketani
cushion	ukupwisha
custom	intambi
customer	kasitoma
customer	kashita
customs	intambi
cut	ukuputula
cute	icisuma
cycle	bulungana
cycle	shunguluka
cycling	ukucofa injinga
dad	tata
daddy	tata
daily	cilabushiku
dairy	cilabushiku
dam	umumana
damage	ukonaulwa
damn	yangu
damp	ukuposa
dance	shana
danger	ubusanso
dangerous	ubusanso
dark	icafita
dark	imfifi
darling	umutemwikwa
dash	ukubutuka
date	ubushiku
daughter	umwana umwanakashi
day	ubushiku
dead	ukufwa
deadline	impela
deaf	nkomamatwi
deal	ukupangana
dear	wemutemwikwa
Dear All	mwebatemwikwa bonse
Dear Customer	Mune Kastoma
Dear Parents	Mwebatemwikwa Bafyashi
Dear Sir	Mwebatemwikwa Mukwai
Dear students	Mwebatemwikwa abasambi
Dear Team	Mwebatemwikwa Ibumba
death	imfwa
debate	ukutalikana
debit	inkongole
debris	ifisoso
debt	inkongole
decade	imyaka ikumi
decay	ukubola
deceased	uwafwa
deceive	ukubepwa
december	umupundu milimo
decent	uwa mucinshi
decent	busaka
decide	usala
decided	salile
decision	ukusala
deck	bwato
decline	kana
decrease	ukuceepa
dedicated	ukuipeela
dedication	ukuitula
deed	imilimo
deep	icashika
deer	insebula
default	ukubwesha
defeat	cimfya
defend	ukupokolola
define	londolola
definitely	cine cine
definition	ukulondolola
degree	cipimo cimo
degree	digiri
delay	ukucelwa
delayed	ukukokosha
delete	ukufuta
delete	ukufumyapo
deliberate	umufulo
delicate	ukucenchenta
delicious	icisuma
delicious	icawama
delight	ukusekelela
delighted	insasa
deliver	ukutuma
delivered	ukutwala
delivered	ukufisha
delivery	ukuleeta
delivery	ukupeela
delivery	ukutwala
demand	ukufwaikwa
demand	ukufwaya
demanding	ukufwailisha
democracy	demokrasi
demon	iciwa
demonstrate	langilila
denied	ukukana
density	ukwanguka
dentist	dokota wameno
deny	ukukana
department	iciputulwa
departure	ukufuma
departure	ukuya
depend	cilifye
deploy	tuma
deposit	ukubika
depressed	ukusakamikwa
depression	amasakamika
depth	mukati
describe	londolola
description	ubulondoloshi
desert	iciswebebe
deserve	ukuyana
deserve	ukulinga
design	ukupanga
designation	ishina
desire	ukukabila
desk	itebulo
despair	ukufupulwa
desperate	ukupelelwa
despite	te mulandu
despite	ca kutila
dessert	mu matololo
destination	uko aleya
destination	icifulo
destiny	impela
destroy	onaula
destruction	ukonaula
detail	ifyebo
details	ifyebo
detect	ukusanga
determination	ukupampamina
determine	umupampamina
determine	ukufwaisha
determined	ukupampamina
determined	uwabikako amano
determined	ukufwaisha
devastated	ukutinya
develop	ukulunduluka
develop	ukupanga
develop	ukukula
developed	ukupangwa
developed	ukubako
development	ubuyantanshi
device	icintu
devil	satana
devoted	ukuipela
Dhivehi	Dhivehi
diabetes	ubulwele bwa sugar
diarrhea	ukupolomya
diary	icitabo cakulembamo
dictionary	dikitionary
did	citile
die	ukufwa
died	fwile
diet	imilile
difference	ukupusanya
different	ucapusana
difficult	ukukosa
dig	imba
dignity	ubucindami
diligent	ukufwaya
dinner	icakulya cabushiku
dip	ukwingisha
direct	ukusontelela
direction	ukutungulula
direction	inshila
director	umukalamba
dirt	icisoso
dirty	ifiko
dirty	ubusali
dirty	ukulamba
disable	ukulesha
disabled	ukulesha
disappear	ukuluba
disappointed	ukulengwa insoni
disaster	icinkunka
discard	ukufumya
discharge	ukufumya
discipline	ukufunda
discipline	ukusalapula
discount	ukubweshako
discover	ukusanga
discrimination	ukupatulula
discrimination	akapatulula
discuss	ukulanshanya
discussion	ukulanshanya
disease	ubulwele
diseases	amalwele
disguise	ukufisama
disgusting	umuselu
dish	ica kulya
dishes	ifipe
dismiss	ukufumyapo
dispatch	twala
display	ukulangilila
display	ukulangisha
disposal	ukufumyapo
disposal	ukuposa
dispute	ukuumana
distance	intanfu
distinct	pusanya
distinguish	ukulekanya
distress	ubulanda
distribution	ukusabankanya
district	umusumba
disturb	ukufulunganya
ditch	icilindi
dive	ukutolokela mumenshi
diverse	pusanapusana
diverse	lekanalekana
diversity	pusanapusana
divide	ukwakanya
divine	mushilo
divorce	ukulekana
dizzy	ulunsingwa
do	cita
do you	ule
do you love me	walintemwa
doctor	shing'anga
doctor	dokotala
document	icipepala
does	ukucita
doesn't	teshibe
dog	imbwa
Dogri	Dogri
doing	ukucita
doll	icilubi
domain	ubufumu
domestic	icitekwa
domestic	ica pang'nda
dominant	ukucimfya
don't	leka
Don't worry	wisakamana
donate	ukusonka
done	cacitwa
donkey	kabalwe
dope	ukukolwa
double	fibili
doubt	ukutwishika
dough	ifibulungwa fya mufuba
down	panshi
down	pesamba
download	ukusenda
draft	ukulemba
drag	ukusesha
drain	ukufumya
drama	ubwangalo
draw	ukushila
draw	ukulenga
drawer	drowa
drawing	ukulenga
dread	ukufwa
dream	iciloto
dress	icakufwala
drill	ukwimba
drink	ukunwa
drive	ukwensha
drop	ukuponya
dropped	ukuponya
drought	icilala
drunk	ukukolwa
dry	ukuma
duck	imbata
dude	cilumendo
due	pa mulandu
due	inshita
due to	pamulandu na
dull	ukushishita
dumb	uwabula amano
dumb	imbulwa mano
dump	posa
duration	inshita
during	ilyo
dust	ulukungu
duty	umulimo
dwell	ukwikala
dying	ukufwa
each	cila umo umo
each other	umo nomubiye
eager	ukubikako amano
eager	ukufwaisha
eagle	kapumpe
ear	ukutwi
earlier	mukubangilila
early	bwangu
earn	ukukwata
ears	amatwi
earth	isonde
earthquake	icinkuunka
ease	ica anguka
easily	mukwanguka
east	akabanga
easy	ukwanguka
eat	ukulya
eating	ukulya
economic	ifyabunonshi
economy	ubunonshi
edge	mpela
edit	ukuwamya
education	amasambililo
effect	kufumamo
effective	ukufumamo
efficiency	ukubomba bwino
efficient	ukubomba bwino
effort	amaka
effort	ukubombesha
egg	ilini
eggplant	impwa
ego	ukuyumfwa
eight	cinekonsekonse
eighteen	ikumi limo nacine konse konse
eighty	amakumi cine konse konse
either	atemwa
elaborate	ukulondolola
elbow	imboyo
elder	umukalamba
elderly	abacikulile
elderly	abacikalamba
elegant	ica emba
element	cimo
elephant	insofu
eleven	ikumi limo na imo
eligible	ukulinga
eliminate	fumyapo
else	cimbi
embarrassed	ukumfwa insoni
embarrassing	insoni
embrace	ukukumbatila
embrace	ukufukatila
emerge	ukufuma
emergency	kampampa
emotional	luse luse
empathy	ukulangulukilako
emphasis	ukukonkomesha
emphasize	ukukonkomesha
employee	umubomfi
employees	ababomfi
employer	uupela inchito
employment	incito
empty	icabulwamo
enable	kusuminisha
encounter	ukukumana
encourage	ukukoselesha
end	mpela
endangered	ukupwa kwa buulkali
endeavor	ukupitamo
endurance	ukushipikisha
endure	ukushipikisha
enemy	umulwani
energy	amaka
engage	ukukobekela
engaged	ukukobekelwa
engaged	uwalimbwa
engagement	ukuibimba
engine	injini
engineer	injinia
English	IciNgeleshi
English	Icisungu
enhance	ukubuutisha
enjoy	ukuipakisha
enormous	icikalamba
enough	capwa
enough	cakumanina
ensure	mona ukutila
enter	ingila
entertainment	amangalo
enthusiasm	kucincimuka
enthusiastic	uwacincila
entire	yonse
entitled	uwalinga
entity	ukwingisha
entrance	apakwingilila
entrepreneur	shimakwebo
envelope	enifulupu
environment	imikalile
environment	icifulo
environment	ifyatushinguluka
envy	umufimbila
epic	icikalamba
epidemic	ubulwele
equal	umulinganya
equipment	icipe
equity	umulinganya
equivalent	ukulingana
eraser	fuuta
error	icilubo
escape	ukubutuka
escape	ukufyuka
especially	sana sana
especially	maka maka
essay	ukulemba
essence	icena cisuma
essential	ichilefwika
establish	imika
established	kwimikwa
estate	ing'anda
estimate	ukutunganishiwa
estimated	ukutunga
estimated	ukuteyanya
eternal	mukati
ethics	intambi
evaluate	cencenta
evaluation	ukucencenta
even	nangu fye
even	nelyo fye
even though	nangula
evening	icungulo
event	ukucitika
eventually	mu kuipata kwa nshita
ever	lyonse
every	conse
everybody	bonse
everyone	bonse
everything	fyonse
everything	conse
evidence	icishininkisho
evil	ububifi
evolution	ukushunguluka
evolve	ukushunguluka
Ewe	Ewe
exact	filyafine
exactly	ifyo fine fye
exactly	na kuba
exam	exam
examine	ukucencenta
example	icilangililo
exceed	ukucila
excellent	bwino saana
except	kano fye
exception	ukufumyako
excess	ubwingi
excessive	ubwingi
exchange	ukukabushanya
excited	insansa
excited	ukutemwa
excitement	insasa
exciting	ukucincimusha
exclusive	ukufumyapo
excuse	njelelako
excuse me	njeleleniko
execute	ukucita
execution	ukubomba
execution	ukwipaya
executive	umukalamba
exercise	ukucita
exhaust	ukunaka
exhausted	ukunaka
exhibit	ukulangisha
exhibition	ukulangisha
exist	ukubako
existence	ukubapo
existing	ifilipo
exit	ukufuma
expand	kusha
expect	ukulolela
expected	ukwenekela
expenses	ifyakushita
expensive	ica mutengo
experience	ukukumana
experience	ukwishiba icintu
experiment	ukwesha
expert	uwaishibisha
expired	ukupwa
explain	londolola
explanation	ubulondoloshi
exploit	ifikalamba
explore	ukufwailisha
export	ukufumya
export	ukutuma
expose	ukuletwa bambilibili
exposed	ukuleta pambilibili
exposure	ukuletwa pa mbilibili
express	ukulanga
expression	ukulangisha
extend	ukukusha
extended	ukukusha
extension	ukukusha
extent	apakufika
external	kunse
extinct	ukufumyapo
extra	ifisheleko
extract	ukufumya
extraordinary	icapulishamo
extraordinary	icikalamba
extreme	ukucilamo
extremely	ukucilamo
eye	ilinso
eyes	amenso
fabric	insalu
fabulous	icawama
face	icinso
facilitate	ukwafwilisha
facilities	ifikuulwa
facility	icikuulwa
fact	icishinka
factor	icilenga
factory	umwakupangila
facts	ifyacine
fade	ukupwa
fail	ukufilwa
failed	ukufilwa
failure	ukufilwa
faint	icitu
fair	mulinganya
fairly	ubusuma
fairy	utushimi
faith	icicetekelo
faithful	ukuba uwacishinka
fake	icabufi
fake	ukubepa
fall	ukupona
FALSE	icabufi
fame	ukwishibikwa
familiar	shibikwa
family	ulupwa
famine	icipowe
famine	insala
famous	ukulumbukwa
famous	ukwishibikwa
fan	ukuputilisha
fancy	icalulumbi
fantastic	cisuma sana
far	ukutali
far	apatali
farewell	ukushalikapo
farm	ibala
farmer	umulimi
fascinating	icakupapusha
fashion	fashionI
fast	bwangu
fat	ukwina
fatal	icakosa
fate	kulingila libela
father	tata
fatigue	ukunaka
fault	icilubo
favorite	icatemwikwa
favour	ububile
favourite	icatemwikwa
fear	umwenso
fear	ukutina
feast	umutebeto
feather	isako
feature	icishibilo
features	ifishibilo
february	abengele kakalamba
fed up	uku naka
fee	umutengo
feed	ukuliisha
feedback	umubwekesha
feel	ukumfwa
feeling	ukumfwa
feet	inkasa
fell	ponene
fellow	umunandi
felt	ukuumfwa
female	umwanakashi
fence	fensi
fertile	umufundo
festival	ukusefya
fetch	ukufwaya
fetch	ukutapa
fever	ubulwele bwa mpepo
few	ukucepa
few	utunono
fewer	ufinono
fiance	nkobekelwa
fiction	ifyakupanga
field	mwibala
fierce	ukutinya
fifteen	ikumi limo na fisano
fifty	amakumi yasano
fight	ukulwa
fighting	ukulwa
figure	nambala
figure	icipendo
figure out	ukwesha ukufwailisha
file	faelo
fill	ukwisusha
filled	ukwisula
film	filimu
filthy	ifiko
finally	pampela
finance	indalama
financial	indalama
find	fwaya
find out	ukusanga
fine	cisuma
finger	umunwe
finish	ukupwisha
finished	nacipwa
fire	umulilo
firm	ukushangila
first	intanshi
first name	ishina lykwambilapo
fish	isabi
fit	ukulinga
five	fisano
fix	lungisha
fixed	icalungishiwa
flag	inembele
flash	ukubyasha
flat	papatala
flat	icalambalala
flaw	icilubo
flawless	uwabula ubulema
flee	ukubutuka
flesh	umunofu
flew	ukupupuka
flex	ukwanguka
flexible	kondenkana
flight	indeke
flip	ukukupukula
flirt	ukusengasenga
flirting	ukusengasenga
flirting	ukupanapana
float	eelela
flood	lyeshi
floor	panshi
flour	ubuunga
flow	ukukonkoloka
flower	iluba
flu	icifine
fluent	uwaishiba
fluently	ukulanda bwino
fluffy	amasako
fluid	ifyamenshi
fly	ukupupuka
focus	ukutonta
fog	fubefube
foggy	fubefube
fold	icinka
folks	bacibusa
follow	ukukonka
follow up	ukukonka
following	ukukonka
food	icakulya
fool	icipumbu
foolish	ukutumpa
foolish	ubupumpu
foot	ulukasa
football	umupila
for	kuli
for	pa
For example	icakumwenako
for instance	icapala
for you	fyobe
forbidden	icabindwa
force	ukupatikisha
forecast	imicele
forehead	impumi
foreign	abeni
foreign	iceni
forest	impanga
forever	umuyaya
forget	labako
forgive	ukwelela
forgot	ukulaba
fork	cibusa
form	ukufuma
formal	icamucinshi
former	icakale
fortunately	icabulanda
fortune	icuma
forty	amakumi yane
forty-two	amakmi yane na fibili
forward	pantanshi
forward	ku ntanshi
foster	ukusunga
fought	lwile
found	ukusanga
foundation	imufula
four	ciine
fourteen	ikumi na cine
fox	mumbwe
fragile	ukukalipwa
frame	fremu
framework	imipangilwe
fraud	ubucenjenshi
freak	cipena
free	buntungwa
freedom	ubutungwa
freeze	ukutalala
frequency	ukwikata
frequent	lyonse lyonse
frequently	lyonse lyonse
fresh	icipya
fresh	timbwa
friday	pali cisano
fridge	friji
friend	cibusa
friendly	uwa cikuuku
friends	ifibusa
friendship	buci busa
frightened	umwenso
frightening	ukutinya
frog	cuula
from	ukufuma
front	intanshi
frozen	ukukosa
fruit	icisabo
frustrated	icifukushi
frustrated	ukufulwa
fuel	amafuuta
Fulfulde	Fulfulde
full	ukwisula
fun	ukwangala
function	imibombele
fundamental	icifwaikwa
funeral	icililo
funny	ukuseka
fur	amasako
furious	ukufulwa
furniture	ifipuna
furniture	mbao
further	pantanshi
furthermore	ukuyapantanshi
future	ku ntashi
gain	ukunonka
game	ubwangalo
gap	umupaka
garage	icikulwa ca myotoka
garbage	ifisoso
garbage	ifiko
garden	ibala
garlic	garliki
gate	imponolo
gather	ukulonganika
gathering	ukulongana
gauge	ukupima
gave	pele
gear	icakufwala
gender	ifya banakashi ne fya baume
general	cinkumbawile
generally	icinkumbawila
generate	ukupanga
generation	inkulo
generous	kapekape
genius	uwamano
genre	umutundu
gentle	tekamutima
genuine	ica cine cine
gesture	ukulangisha
get	senda
get dressed	fwala
get up	ima
get well soon	upole bwangu
getting	ukusenda
ghost	iciwa
ghosting	iciwa
giant	ipaka
giant	icikulu
gift	icabupe
ginger	jinja
girl	umwanakashi
girlfriend	umwanakashi umonobe
give	pela
give up	ukuleka
given	ukupelwa
glad	insansa
glance	ukulengela
glass	igalashi
glasses	amakalashi
glimpse	ukumona
global	icalo conse
gloomy	ukubeeka
gloves	amagulovu
glow	ukwaka
glow up	moneka bwino
glue	icakulambatikila
go	kabiye
go ahead	cicite
go ahead	kabiye
go away	kabiye uko
go to bed	kabiye usendame
goal	buyo
goal	wele
goals	ifyakucita
goat	imbushi
god	lesa
god bless you	lesa akupale
goes	ukuya
going	ukuya
going to	ukuya ku
gold	golide
gone	icapita
gonna	nde
goo	kabiye
good	bwino
good	cisuma
good afternoon	cungulopo mukwai
good bye	shalapo
good day	umutende
good evening	cungulopo mukwai
good job	umulimo uusuma
good looking	ulemoneka bwino
good luck	ishuko
good morning	mwashibukeni
good morning my love	mwashibukeni we mutemwikwa
good night	musendame bwino
goodbye	shalapo
goodnight	ubushiku ubusuma
goods	ifipe
Google	Google
Google Translate	Ukwilula kwa Google
goose	imbwa
gorgeous	icisuma
gossip	umulomo
got	ukukwata
got it	naumfwa
government	ubuteko
grab	ukwikata
grade	giledi
gradually	panono panono
graduate	uwasambilila
grain	itaba
grant	pela
granted	ukupeelwa
grapes	imyangashi
grasp	ukwikata
grasp	ukwiluka
grasp	ukwishiba
grass	icani
grateful	ukutotela
gratitude	ukutasha
grave	inshinshi
gray	kashika
great	icikalamba
greed	ukubipa umutima
greedy	ubuukali
green	katapa katapa
greet	umutende
greet	posha
greeting	ukuposha
greetings	ukuposha
grey	iyafitulukila
grid	imishilwa
grief	ukulila
grind	ukupela
grip	ukwikata
grocery	ifikabilwa
groom	shibwinga
gross	cabipa
ground	panshi
ground	umushili
group	ibumba
grow	ukukula
growth	ukukula
grumpy	ubulanda
Guarani	Guarani
guarantee	ukusuminisha
guard	ukusunga
guard	ukucingilila
guess	ukutunganya
guest	umweni
guidance	ukutungulula
guide	ukutungulwila
guilty	uwa mulandu
guy	cilumendo
guy	umulumendo
guy	umwaume
guys	ifibusa
habit	cibelesho
habitat	abekala
had	kwete
hail	mfula
hair	umushishi
half	citika
half	pakati
hall	icikuulwa
hand	ukuboko
handle	ukubomfya
handsome	umusuma
hang	kulika
hang out	ukwangala
happen	ifyacitike
happened	icacitike
happiness	insansa
happy	insansa
happy	ukusangalala
happy	ukutemwa
happy birthday	ubushiku bwa kufyakwa ubusuma
happy birthday to you	ubushu bwa nsansa ubwakufyalwa kobe
happy new year	umwaka upya uwansansa
hard	ukukosa
hard	icakosa
hard	ukosa
hardly	nangu panono
hardly ever	ukwabule nangu cimo
harm	ukucena
harmful	bipila
harmony	umutende
harmony	icumfwano
harsh	ukukalipa
harvest	ukusombola
has	ali
hate	ulupato
have	ukukwata
have a good day	kwata ubushiku ubusuma
have a nice day	kwate ubushiku ubusuma
have breakfast	kwata icakulya ca lucelo
have fun	kwata inshita iisuma
have you eaten	bushe naulya
having	ukukwata
hazard	ubusanso
haze	fube fube
he	ali
he	ena
he has	ena nakwata
he is	ena ali
head	umutwe
headache	ukukalipwa kwamutwe
heal	ukuundapa
healing	ukuposha
healing	ukundapa
health	ubumi
healthy	ubutuntulu
healthy	ubumi
hear	ukumfwa
heard	ukumfwa
heart	umutima
heat	ukukaba
heaven	kumulu
heavy	icafina
hectic	kalifya
height	ubutali
heir	impyani
heist	ukwiba
held	ukubela
held	ukucitwa
hell	kumbo
Hello	Muli shani
Hello	Halo
hello dear	mulishani mukwai
hello how are you	muli shani
hello how are you doing	wabomba shani
helmet	icimpompo
help	ukwafwilisha
help	ukwafwa
helpful	ubwafwilisho
hence	nalimo
her	ena
herd	ifitekwa
here	pano
here	kuno
here	apa
heritage	icuma
hesitate	ukutwishika
Hey	Iwe
Hi	Muli shani
hi how are you	iwe uli shani
Hi there	Muli shani imwe
hidden	ukufisa
hide	ukufisama
hide	ukubelama
hierarchy	ubutantiko
high	pamulu
highlight	ukushila
hike	ukukwela
hiking	ukunina
hilarious	icakusekesha
hill	ulupili
him	ena
hint	ishibisha
hip	lutungu
hips	imisana
hire	ukwingisha
hiring	ukwingisha ababomfi
his	cakwe
history	ilyashi lyakale
hit	ukupuma
hobby	ifyowatemwa
hold	ikatilila
hold on	ikatisha
hole	icilindi
holiday	cuti
hollow	icipunda
home	ing'anda
homework	umulimo waku ng'anda
honest	bucishinka
honest	uwa cishinka
honestly	umufuma cumi
Honey	Ubuchi
honor	cindika
hood	ilaya likwete icisote cakufimbana kumutwe
hook	icakukobeka
hop	ukutoloka
hope	isubilo
hopefully	ngacaciwama
hopeless	ukwabule subilo
horizontal	iciputulwa
horn	insengo
horrible	icabipa
horror	ukutinya
horse	ipunda
hospital	icipatala
hospitality	ukusengela
host	shibweni
hostile	ifilwani
hot	ukukaba
hotel	hoteli
hour	insa
hour	ora
hours	amaora
house	ing'anda
household	abang'anda
how	bushe
how	shani
how about you	ngaiwe
how are you	muli shani
how are you doing	Muli shani
how are you doing	bushe mulifye bwino
how are you doing today	mulishani ubushiku bwalelo
how are you today	mulishani ilelo
how do you do	wabomba shani
how is	ali
how many	bali banga
how much	shiinga
how often	miku inga
how old are you	ukwete imyaka inga
how was your day	bwaciba shani ubushiku bobe
how was your night	bushe bwaciba shani ubushiku bobe
however	lelo
hub	icinsa
hubby	umutemwikwa
hug	ukukumbata
huge	icikulu
huge	icikalamba
human	umuntu
humble	ukuicefya
humid	umutonshi
humidity	umutonshi
hundred	umwanda umo
hungry	insala
hunt	ukulunga
hurricane	icikuuku
hurry	angufyanya
hurry up	endeaha
hurt	ukukalipwa
husband	umulume
hustle	ukulwisha
hut	akayanda
hygiene	ubusaka
I	ine
I am	Ninebo
I am fine	Indifye bwino
I can	kuti na
I can't	ine tekuti
I do	Nasumina
I do not know	Ine nshishibe
I do not understand	nshumfwikishe
I don't	Nshi
I don't know	nshishibe
I don't know	katwishi
I don't understand	nshumfwile
I don't understand what you mean	nshumfwikishe ulepilibula nshi
I don't understand you	nshumfwikishe
I don’t know	nshinshibe
I don’t understand	nshumfwikishe
i guess	ndemona
I had	nalikwete
I have	ninkwata
I have been	Naliba
I hope so	limbi
I know	ninjishiba
I like	nalitemwa
I like you	nalikutemwa
I love	Nalitemwa
I love my big brother	Nalitemwa ndume yandi umukulu
I love my big sister	Nalitemwa nkashi yandi umukulu
I love my father	Nalitemwa tata wandi
I love my little brother	Nalitemwa ndume yandi
I love my little sister	Nalitemwa nkashi yandi
I love my mother	Nalitemwa mayo wandi
I love you	Nalikutemwa
I love you so much	Nalimitemwa saanafye mayo
I love you too	Nalikutemwa naine wine
I mean	ndepilibula
I miss you	nakufuluka
I miss you so much	nakufuluka sanafye
I see	Na mona
I think	ndetontonkanya
I understand	Naumfwa
I want	nde fwaya
I want to see you	Ndefwaya ukukumona
I want you	ndekufwaya iwe
I was	Nali
I will	Nala
I would be	Kuti naba
I'm	Nine
I'm fine	ndifye bwino
I'm good	ndifye bwino
I'm here	Ndipano
I'm sorry	njelelako
ice	amenshi ayakosa
idea	mfundo
ideal	icalinga
identical	ukumoneka cimo cine
identify	ukwishibikwa
identity	kwishibikilako
idiot	iciwelewele
idle	ukwikalafye
if	nga
ignore	ukuusula
ill	ukulwala
illegal	tacili mwifunde
illness	ubulwele
Ilocano	Ilocano
image	icikope
imagine	tontonkanyapo
immediate	nombaline
immediately	ili line
immediately	nomba line
immense	fuma
impact	ukufishiwapo
impact	ukwambukila
impatient	ukukanalolela
implement	ukubomfya
import	ukuletamo
important	ukucindama
impose	ukubika
impossible	icishingacitwa
impress	ukutemune
impression	ukutemuna
impression	ukutemwa
impressive	kutemuna
improve	ukucilapo
improve	ukuwamya
improvement	ubuyantanshi
in	mu
in addition	uku lundapofye
In fact	nakuba
in front of	kuntanshi yakwa
in order to	mucifulo
inappropriate	ifishalinga
incentive	nkosho
incident	icacitike
include	ukubikapofye
including	ukubikapo
income	indalama
inconvenience	ukufulunganishiwa
increase	ukufusha
increase	ukubikako
increase	ukukula
increased	ukufushiwa
incredible	icipapusho
incredible	icisungusho
indeed	cine cine
independent	ukuibela
independent	ukuiteka
indicate	langisha
indigenous	abekala mushi
individual	cila umo
industry	indastri
inevitable	icingacitika
infant	akanya
infection	ubulwele
infinity	umuyaya
inflammation	ubucingo bwa mubili
inflation	ukupya
influence	ukongola
inform	ukwishibisha
information	ifyebo
ingredients	ifikabilwa
inheritance	ukupyana
initial	intanshi
initiative	amano
injured	ukucenwa
injury	ukuncenwa
injury	ukuicena
innocent	uwakayele
innovation	ubukuule
inquiry	ukufwailisha
insane	ukufulungana
insect	akashishi
insecure	ukukana cingililwa
insert	ukwingisha
inside	mukati
insight	ukumona patali patali
insist	ukupatikisha
insomnia	ukukana kwata utulo
inspiration	ukuuputwamo
inspire	ukuuputwa
install	ingisha
instance	icilangililo
instant	palyapene
instead	mucifulo ca
instead of	mucifulo
instructions	ifilangililo
instrument	icakulisha
insult	insele
insurance	inshuwalanshi
intact	icaikatana
integrity	amano
intellectual	amano
intelligence	amano
intelligent	ukukwata amano
intend	ukufwaya ukucita
intended	cacilinga
intense	ukushika
intention	impange
interact	ukulanshanya
interaction	ukulanshanya
interest	buseko
interested	ukufwaya
interesting	ca kupapusha
interfere	ukupumfyanya
intermediate	nomba line
internal	mukati
international	international
interpret	ilula
interpreter	kelula
interrupt	ukupumfyanya
interview	ukulanshanya
interview	amepusho
intimate	ukwishibana
into	mukati
into	muli
introduce	utendeka
introduction	intanshi
introvert	uwaitemwa
intuition	kampingu
invalid	tacilembomba
invent	ukupanga
inventory	ifipe ifilipo
invest	ukubikamo
investigate	fwailikisha
invitation	ukusengela
invite	ukwita
invoice	ipepala lya kushitilapo
involve	ukuibimbamo
involved	ukusangwa
iron	icela
is	ali
island	icishi
isolated	ukuipatula
issue	umulandu
issue	ubwafya
issues	amafya
it	ni
it	uku
it	ici
it is	ni
it was	cali
it's	ni
it's ok	cilifye bwino
It's okay	cilifye bwino
item	icipe
item	icintu
items	ifipe
its	ni
I’m	Nine
jacket	ijaketi
jail	icifungo
January	akabengele kanono
jar	ulukombo
jaw	icipanga
jealous	ubufuba
jealous	akalumwa
jerk	jeke
jewelry	ifyabeka
job	inchito
jogging	ukubutuka
join	ukwikatana
joint	ukukumbinkana
joke	ukusekesha
journalist	kasabankanya we lyashi
journey	ubulendo
joy	insansa
judge	kapingula
juice	dirinki
july	akapepo kakalamba
jump	toloka
june	akapepeo kakalamba
junk	ciwelewele
just	fye
just do it	cicifye
justice	umulinganya
justify	lungamika
Kalaallisut	Kalaallisut
keen	fwaisha
keep	suunga
keep it up	twalilileni ukuya pantanshi
kept	ukusunga
kettle	iketulo
key	ulufungulo
kick	panta
kid	umwaice
kidding	ndesekesha
kidney	imfyo
kids	abana
kill	ipaya
kind	umusango
kinda	icapalako
kindly	luse luse
kindness	uluse
king	imfumu
kiss	tomona
kitchen	umwakwipikila
kite	kaiti
kitten	pushi
knee	ikufi
knew	ishibe
knife	umwele
knight	mushilika
know	ishiba
knowledge	amano
knowledge	ukwishiba
known	ukwishibikwa
Konkani	Konkani
Krio	Krio
label	icilembo
labor	ukubomba
labour	ukubomba
lack	ukubulisha
ladder	umutanto
lady	mwanakashi
laid	ukulambalika
lake	umumana
lamb	impanga
lame	ubulema
lamp	inyali
land	incende
land	impanga
landscape	palubansa
language	ululimi
lap	ukuulu
large	icikulu
large	icikalmba
last	cakulekelesha
last but not least	mukulekelesha
last name	ishina lya kulekelesha
late	ukucelwa
lately	mulibwangu
later	limbi
latest	icipya
latter	ukulekelesha
laugh	ukuseka
laughing	ukuseka
laughter	inseko
launch	ukutendeka
laundry	ukucapa
law	ifunde
lawn	ulunkoto
lawyer	bacilolo
lay	ukulambalala
layer	umutika
layout	imimonekele
lazy	ubunang'ani
lead	tungulula
leader	intungulushi
leaf	ibula
leak	ukutulika
lean	shintilisha
leap	ukusombola
learn	ukusambilila
learning	ukusambilila
lease	imapnga
least	ubunono
leather	impapa
leave	sha
leave	kabiye
leave	leka
leaves	amabula
led	ukutungulula
left	ku kuso
left	fuma
leg	ukulu
legacy	icikolwe
legal	icasuminishiwa
legend	icikolwe
legit	icacishonka
leisure	inshita ukutuusha
lend	ukwashimisha
length	ukulepa
length	ubutali
less	ukucepa
less	utunono
lesson	isambililo
let	leka
letter	inkalata
lettuce	umusalu
level	iciputulwa
leverage	ukubomfya
leverage	ukututila
liability	itutumuko
library	librare
lick	ukumyanga
lie	ubufi
lies	amabufi
life	ubumi
lift	ukwimya
light	ulubuuto
lightning	utulumba
like	pamo
like	nalimo
likely	nalimo
likewise	nalimo
line	mutande
Lingala	Lingala
link	ukusuntikanya
lion	inkalamo
liquid	icasongoloka
list	ubutantiko
listen	ukumfwa
listening	ukumfwa
literally	icine cine
literature	ukubelenga
litter	icisoso
litter	ifiko
little	utunono
little	ukucepa
live	ukwikala
liver	libu
lives	imweo
living	ukwikala
living room	icipinda cakwikalamo
lizard	malinso
load	ukubika
loaf	iciputulwa
loan	loni
local	mulya mwine
location	icifulo
lock	isala
lockdown	ukucingililwa
lockdown	ukwisalilwa
log	umulando
lonely	weka
lonely	neka
long	ukuleepa
long time no see	pakokola ukwabula ukumoneka
look	mona
loop	intambo
loose	bucilende
lord	shifwe
lose	ukufilwa
loss	ubuluse
lost	ukuluba
lot	iingi
loud	icongo
loud	ukulila
loud	ukupunda
lounge	lounge
love	ukutemwa
love you	nanlikutemwa
lovely	icisuma
low	ukucepa
lower	ukucefyako
loyal	bucishinka
loyalty	ukuba ne cishinka
luck	ukubulisha
lucky	ishuko
Luganda	Luganda
luggage	icipe
lump	umupusa
lunch	icakulya cakasuba
lungs	bapwapwa
luxury	ubucindami
lying	ukubepa
machine	macini
mad	ubushilu
mad	ukupena
mad	ukufulwa
madam	mayo
made	ukupangwa
magazine	magazini
magnificent	ubusuma
maid	umubomfi
main	icikulu
main	icikalamba
maintain	ukusungilila
maintenance	ukuwamya
Maithili	Maithili
major	icikulu
majority	cinabwingi
make	ukupanga
make up	ifyakupanga
male	umwaume
mall	icikulwa
man	umuntu
man	umwaume
manage	ukubomba
manage	ukukwanisha
management	ukwangalila
manager	umukalamba
mandatory	cipope
manifest	ukumonekela
manipulate	ukubeleleka
manner	umubele
manual	ifyakubomfya
many	abengi
many	ifingi
many	ishingi
many many happy returns of the day	ifintu ifingi ifisuma fibwelele kuli iwe mubushiku
march	kutumpu
margin	umushilwa
market	pamaliketi
marriage	icupo
married	ukupwa
mask	icakufisa pamenso
mass	icinabwingi
massive	icikulu
master	kafundisha
match	ukulingana
match	ukupalana
mate	umunandi
material	ifya kubomfya
math	insamushi
matter	umulandu
maturity	ubukalamba
may	kuti
maybe	limbi
maybe	nalimo
maybe	atemwa
me	ine
me too	naine wine
meal	icakulya
mean	ukulola
mean	ukupilibula
meaning	ubupilibulo
means	cilepilibula
meant	pilibula
meanwhile	nomba
measure	ukupima
measures	icipimo
meat	inama
medical	icipatala
medicine	umuti
meditation	ukushetulula
medium	ishila
meet	kumanya
meet	ukukumanisha
meeting	ukulongana
meeting	ukukumana
Meiteilon	Meiteilon
melt	ukusungulula
memories	ifyakwibukisha
memory	ukwibukisha
mental	amano
mention	lumbula
mentioned	lumbwile
mentor	kafundisha
merchant	abakushita
mercy	uluse
merely	limo limo
merry christmas	iciminshiminshi cisuma
mess	ubusali
mess	ukubifya
message	imbila
messy	ifiko
metal	inshimbi
metal	icela
method	umusango
mice	koswe
middle	pakati
midnight	pakati kabushiku
might	kuti
mild	ukufuuka
milestone	ukuya apatali
military	ubushilika
milk	umukaka
million	ikanalimo
mind	amano
mind	ukutontonkanya
mindset	bongo bongo
mine	wandi
mine	candi
mingle	ukwangala
minor	akanono
minor	akacepesha
minute	mineti
minutes	ba mineti
miracle	icipapwa
mirror	icilola
miscellaneous	icikumbawila
mischievous	ukukana uumfwa
miserable	uwa bulanda
misery	ukucula
miss	ukupusa
miss	ukufuluka
miss	umukashana
miss you	nakufuluka
missing	ukuluba
mission	ifyakucita
mist	fubefube
mistake	icilubo
Mizo	Mizo
mobile	lamya
mock	ukucusha
model	umusango
moderate	ukucepa
modern	buyantanshi
modest	ukuiceefya
modest	ukulinga
modest	mucinshi
moist	fube fube
moisture	umutonshi
mold	ukupanga
mole	ciputa
mom	mayo
moment	panshita
monday	pali cimo
money	indalama
monitor	ukulonda
monitor	ukubikako amano
monkey	kolwe
month	umwenshi
mood	imibele
moody	umusango
moon	umwenshi
moral	intambi
more	na fimbi
moreover	mukulundapo
moreover	na kabili
morning	ulucelo
mortgage	icipe
most	cinabwingi
mostly	ilingiline
mother	mayo
motion	ukusela
motivation	ukukoselesha
mountain	ulupili
mouse	kwindi
mouse	koswe
mouth	akanwa
move	sela
movement	imyendele
movie	filimu
mrs	bana
much	sana
mud	amatipa
mug	kapu
muscle	ulupaka
museum	umwakusugila ifyakale
mushroom	ubowa
music	inyimbo
must	ufwile
mute	cibulu
mutual	ukupalana
my	candi
My dear	cibusa wandi
my friend	cibusa wandi
My hovercraft is full of eels	Hovercraft yandi naisula na ee
my love	mutemwkwa wandi
my name is	ishina lyandi nine
my pleasure	natemwa
myself	nemwine
mysterious	ifyankama
mystery	inkama
myth	ifyabufi
nail	umusomali
nail	ulwala
naive	ciwelewele
name	ishina
narrative	ubulondoloshi
narrow	kamfyemfye
nasty	icabipa
national	icaalo
nationality	mucalo cobe
native	umwikala mushi
natural	icifyalilwa
nature	umusango
nausea	umuselu
near	mupepi
nearby	mupepi na
nearly	mupepifye
neat	ubusaka
necessary	icilefwaika
neck	umukoshi
necklace	umunyololo wa mumukoshi
need	ukukabila
negative	ukufumyako
neglect	lekelesha
negotiate	ukumfwana
neighbor	umwina mapalamano
neighborhood	abena mupalamano
neither	nangu
nephew	umwipwa
nerd	ubuwelewele
nervous	umwenso
nervous	insandesande
nest	icinsa
net	isumbu
network	netiweki
neutral	pakati
never	nakalya
never	takwakatale
never	tekuti
never give up	wikatala leka
never mind	te mulandu
nevermind	temulandu
nevertheless	lelo
new	icipya
news	ilyashi
next	konkelepo
next to	mupepi na
nice	icisuma
nice	fisuma
nice	lisuma
nice to meet you	cisuma twamonana
niece	umwipwa umwanakashi
night	ubushiku
nightmare	iciloto cakutinya
nine	pabula
nineteen	ikumi limo napabula
ninety	amakumi pabula
No	Awe
No	Nakana
no problem	takuli bwafya
no way	nakalwa
no way	te kuti
nobody	nangu umo
noise	icongo
noisy	icacongo
none	takuli
noon	icungulo
nope	awe
nor	atemwa
normal	cacifyalilwa
north	ku kapinda ka ku kuso
nose	umona
nostalgic	ukukopwa icikope
not	takwaba
not at all	nakalya
not bad	cilifye bwino
Not now	Nomba awe
not yet	tacila
note	mona
noted	caishibikwa
nothing	tapali
notice	icishibisho
noticed	nacishibikwa
noun	ishina
nouns	amashina
novel	akatabo kelyashi
november	cinshi kubili
now	nomba
nowadays	inshita shino
nuisance	ukupena
null	takwaba
numb	ukuloba
number	impendwa
nurse	ba sitsta
nurse	ba nasi
nut	inati
nutrition	ififwaikwa
oath	umulapo
obesity	ukwinisha
obey	ukumfwila
object	icintu
objective	ipange
obligation	ukupatikishiwa
obscure	ukuloba
observation	ukumona
observe	ukumona
obsessed	ukutemwisha
obsession	ukukumbwa
obsolete	icapwililika
obstacle	ifyakucingilila
obtain	ukusenda
obtained	ukusenda
obvious	ca cine
obviously	ukwabula ukutwishika
occasionally	limo limo
occupation	inchito
occupied	umulimo
occupied	ukwikala
occur	ukucitika
occurred	icacitike
occurs	ifyacitike
ocean	bemba
october	ulusuba lukalamba
odd	amafya
odds	amafya
of	ya
of	wa
of course	emukwai
of course	kwena
off	shimya
off	ukuleka
offensive	icakukalifya
offer	ukupeela
office	ofesi
official	umulashi
often	ilingi line
Oh	Owe
oh really	ifyo finefye
oil	amafuta
ok	ee
ok	cawama
ok dear	ee wemutemwikwa
ok honey	cisuma mutemwikwa
ok my love	ee wemutemwikwa wandi
okay	ee
okay baby	ee wemutemwikwa
okay dear	ee wemutemwika
okay honey	cisuma wemutemwikwa
okay my love	emukwai wemutemwikwa wandi
old	kale
old	umukote
on	pa
once	umuku umo
one	umo
one	cimo
one language is never enough	icitundu cimo tacaba icakwanina
onion	kanyense
online	pamwela
only	fye
open	isula
operation	ukubomba
operation	ukulepula
opinion	imimwene
opportunities	amashuko
opportunity	ishuko
opposite	ukupusana
optimistic	ukwenekela icisuma
option	ukusala
optional	kusalapo
or	nangula
orange	icungwa
order	ubutantiko
ordinary	umutuutu
ordinary	icafye
ordinary	yaweyawe
organization	akabungwe
orientation	ukufunda
orientation	ukupishamo
orientation	ukusambilisha
origin	intendekelo
original	kubalilapo
original	icandendekelo
Oromo	Oromo
orphan	uushakwata abafyashi
other	cimbi
otherwise	nga te ifyo
ought	ufwilefye
our	cesu
Our mission: to enable everyone, everywhere to understand the world and express themselves across languages.	Umulimo wesu: kulenga cila umo, ukuli konse ukwishiba isonde kabili no kuilondolola  abene  mufitundu.
Our mission: to organize the world's information and make it universally accessible and useful.	Umulimo wesu: kulonganya ilyashi lye sonde no kulenga libe ilingasangwa isonde lyonsw no kubomfiwa.
out	ukufuma
out	fuma
outcome	ukufumamo
outfit	ifya kufwal
outgoing	ukuya
outlet	ukwakufimina
outline	ubutantiko
outside	panse
outstanding	icapulamo
oven	umwakocela
over	ukupwa
over	ukucila
over there	kuno
overall	pali fyonse
overcome	ukucimfya
overthinking	ukutontonkanishisha
overwhelmed	cipesha amano
overwhelming	icikalamba
owe	yangu
owl	icipululu
own	umwine
own	obe
owner	umwine
ox	ing'ombe
pace	musenselo
pack	ukubika
package	ifyalongwa
package	imilongele
paid	lipilwa
pain	ukukalipwa
paint	ukupenta
painting	ukupenta
pair	fibili fibili
pale	buuta
palm	icisansa
pan	pani
pandemic	icikuko
pandemic	ubulwele
panic	ukutulumushiwa
pants	ifyakufwala
paper	ipapela
paradise	paradaise
parallel	ukupalana
parcel	katundu
pardon	ukwelela
parents	abafyashi
park	icibansa
parrot	mucence
part	iciputulwa
participate	ukuibimbamo
particular	maka maka
particularly	sana sana
partner	uubomba nankwe
party	ukusefya
pass	ukupita
passage	umwakupita
passed	ukupita
passion	ukufwaisha
passionate	uwacincila
passive	ukupita
past	akale
patch	icikamba
path	inshila
pathetic	icabipa
patience	ukutekanya
patient	umulwele
patient	ukulolela
pattern	umusango
pause	iminika
pavement	pavement
pay	lipila
payment	amalipilo
peace	umutende
peaceful	umutende
peach	shimikila
peak	ukucila
pear	piya
peas	intonga
peculiar	ukuibela
pee	ukusunda
peel	ukupala
peer	cibusa
peer	umubiyo
peers	abanobe
pen	icilembelo
pencil	icilembelo
pending	ukulolela
people	abantu
pepper	impilipili
perceive	ukwishiba
perceive	ukwiluka
perception	ukukutuluka
perfect	ukupwililika
perform	ukucita
performance	ukubomba
performance	imibombele
perhaps	limbi
perhaps	nalimo
period	inshita
permanent	ukubelelela
permission	insambu
permit	ukusuminisha
perseverance	umukosha
persistent	ukushipikisha
person	umuntu
personal	umuntu umwine
personality	ubuntu
perspective	tontonkanyapo
persuade	ukunashanasha
pervert	ukupondamika
pet	icitekwa
phase	iciputulwa
phenomenon	icakupapusha
philosophy	filosofi
phone	lamya
photo	icikope
phrase	amashiwi
physical	ifya mubili
pick	senda
pick	bulapo
pick up	ukusenda
picture	icikope
piece	iciputulwa
piece	indalama
pieces	utupimfya
pig	inkumba
pig	kapoli
pigeon	inkunda
pile	umwina
pillow	umusao
pilot	kensha
pin	pini
pineapple	cinanazi
pink	kashikila
pink	pinki
pit	ubulanda
pitch	iciunda
pity	uluse
place	incende
places	incende
plague	icinkunka
plain	icimfulumfulu
plan	ipange
plane	indeke
plant	ukubyalika
plants	ifimuti
plate	imbale
platform	platform
play	ukuteya
play	ubwangalo
play	ukwangala
playing	ukwangangala
pleasant	ukutemunwa
please	napapata
please	mukwai
pleased	sansamuka
pleasure	ukusekelela
pledge	ukulaya
plenty	ifingi
plot	ipange
plug	ukusomeka
plum	ukusolomoka
plumber	kabika wa mipaipi
plural	ubwingi
podcast	ukusabankanya
poem	mushikakulo
poetry	imishikakulo
point	icishinka
poison	ubwanga
police	bakapokola
policy	ulupapulo
polite	ukuba ne cikuuku
pollution	ukukowesha
pond	icishiba
pool	icishiba
poop	amafi
poor	umupiina
pop	ukutuluka
popular	ukwishibikwa
population	impendwa
population	ubwingi bwacintu
pork	umunani wakumba
porridge	poleji
port	apakwingisha
position	icifulo
positive	ukushininkishiwa
possess	ukukwata
possession	icikwatwa
possessive	ukuteka
possible	ukucitwa
post	tuma
postpone	ukusesha
potato	amapotato
potential	kwenekela
pound	ukufina
poverty	icipowe
power	amaka
powerful	camaka
practical	ukusambilila
practice	ukusambilila
praise	ukushinshimuna
prank	ukubepa
pray	peepa
precious	mutengo
precious	wamisha
precise	nalimo
precisely	filyafine
predict	sobela
prefer	ukusalapo
prefer	kuti natemwa
preference	ukusala
pregnant	imita
prejudice	ukupatanya
prejudice	impatila
premises	amayanda
premium	icikuulu
preparation	ukupekanya
prepare	ukupekanya
prepared	ukupekanishiwa
preposition	ishiwi lyakukumbinkanya
presence	ukubapo
present	icilipo
presentation	ukulangisha
preserve	ukusunga
president	kateeka
press	tinka
pressure	ukutitikisha
pretend	ukufipanga
pretty	ica emba
prevent	ukutaluka
prevent	ukulesha
prevent	ukucingilila
previous	kunuma
prey	kabupalu
price	umutengo
pride	icilumba
priest	shimapepo
primary	ifyakubalilapo
prime	ukufwaisha
princess	namfumu
principal	icishinte
prior	ilyo
prior	intanshi
priority	ukubikisha amano
prison	icifungo
privacy	mubumfinsolo
private	kumbali
private	ubumfisolo
privilege	ishuko
prize	icilambu
probably	limbi
probably	nalimo
problem	ubwafya
procedure	ubutantiko
procedure	icakukonka
proceed	ukuyapantanshi
process	inshila
produce	ukufumya
produce	ukupanga
product	icipe
production	ukupanga
profession	incito
professional	uwaishibisha
profile	profaelo
profit	profiti
profound	ifyashika
progress	ukulunduluka
project	icakubomba
project	umulimo
project	icakucita
prominent	icikankala
promise	ukulaya
promote	ukutungilila
promotion	ukutungilila
prompt	ukwipusha
prone	ukulambalala
pronouns	pronouni
pronunciation	imitile yamashiwi
proof	icishininkisho
proper	bwino bwino
properly	bwino bwino
properties	ifipe
property	icipe
property	icikwatwa
proposal	ukutubulwilwa
prospect	subilo
prosperity	ukunonka
prosperous	ukulunduluka
protect	ukucingilila
proud	icilumba
prove	shinikisha
provide	ukupeela
provided	icapelwa
province	incende
provision	pakupeelela
provision	pakucitila cimo
puberty	ukukula
public	icinabwing
pull	ukutinta
pumpkin	icipushi
punctual	ukubangilila
pupil	umwana wesukulu
purchase	ukushita
pure	ukusangulula
purple	cakashika
purpose	ipange
purpose	bufwayo
purse	icikwama
pursue	ukukonkela
pursuit	umupampamina
push	ukusunka
put	bika
qualification	ifilelefwaikwa
quality	imibele
quantity	ubwingi
quarantine	ukusungwa
quarantine	ukucingililwa
quarrel	ukumana
quarter	umwenshi
quarter	iciputulwa
Quechua	Quechua
queen	namfumu
queer	uwacilamo
query	ilipusho
question	ilipusho
queue	mulongo
quick	bwangu
quickly	bwangu
quiet	tondolo
quilt	ubusanshi
quit	ukuusha
quit	ukuleka
quite	tondolo
quiz	amapusho
quotation	ukwambula ifileshitwa
quote	ukwambula
quotes	ifyakwambula
rabbit	kalulu
race	umutundu
rage	icifukushi
rain	imfula
raise	ukwimya
raise	ukukula
raised	imishe
ran	butuka
random	ukupumikisha
range	ukufika
range	ukushinta
rapid	mukampampa
rapidly	bwangu bwangu
rare	icaibela
rarely	te liingi
rarely	limo limo
rash	butuuka
rat	kwindi
rat	koswe
rate	pima
rather	atemwa
rather	mu cifulo
ratio	icipimo
rational	umuli amano
raw	icibishi
re	uku
reach	ukufika
reached	naifika
reaction	imicitile
read	beleenga
reading	ukubelenga
ready	ukuiteyanya
ready	ukuipekanya
real	icacine
reality	icishinka
reality	icituntulu
realize	ukwiluka
realized	ukwiluka
really	cine cine
rear	kunuma
reason	umulandu
reasonable	icilimo amano
recall	ibukisha
receipt	lisiti
receipt	akapepala mwashitilepo
receive	ukupokelela
received	ukupokelela
recent	mulibwangu
recently	nomba line
reception	ukupokelela
recipe	ifyakukonka
recipe	ifyakubomfya
reckless	umulekelesha
recognition	ukwishibikwa
recognition	ukulumbuka
recognize	ukwishiba
recommend	ukukoselesha
recommended	icatungililwa
record	lemba
recover	ukupola
recovery	ukubwekeshiwapo
red	icakashika
redeem	ukulubula
redemption	ukulubulwa
reduce	cefya
redundant	ukucila
refer	ukulangilila
reference	kuloshako
reflect	ukupitulukamo
reflection	ukumonekela
refrain	ukutaluka
refrigerator	umwakutalalikila
refund	ukubwesha amalipilo
refuse	kana
refused	ukukanwa
regard	ukubikako amano
regarding	pa mulandu
regardless	nangula cingaba
regards	ukuposha
region	incende
register	ukulembesha
register	umwakulembesha
regret	ilangulushi
regret	ukulangulushiwa
regular	lyonse
regularly	lingiline
reject	ukukana
relate	palana
related	ukwampana
relationship	kwampana
relationship	icumfwano
relationship	bucibusa
relative	uwalupwa
relatives	ulupwa
relax	tusha
release	ukuleka
released	ukulekwamo
relevant	icikumine
reliable	subilo
reliable	cashintililwapo
reliable	ukubapo
relief	ubwafwilisho
relieve	ukutusha
relieve	ukupemwina
relieved	ukukombosha
religion	bukapepa
religious	bukapepa
reluctant	ukushimunuka
rely	ukushintilisha
remain	ukushala
remaining	ifisheleko
remarkable	icawamisha
remarkable	icakupapusha
remedy	umuti
remember	ukwibukisha
remind	ukwibukisha
reminder	icibukisho
remote	ukutali
remove	fumya
render	ukufumya
rent	ukusonkela
rent	ukulomba
rent	ukulipila
repair	ukuwamya
repeat	ukubwekeshapo
replace	ukubwekeshapo
reply	ubwasuko
reply	umubwekesha
report	nsebo
represent	ukwimininako
reputation	ishina lisuma
request	ukulomba
require	ukufwaya
required	icilefwaika
rescue	ukupususha
research	ukufwalisha
resemble	ifyapalana
resentment	ukukanya
reservation	ukusunga
reserve	suunga
resident	abang'anda
resign	ukuleka
resilience	ukushipikisha
resilient	ukushipikisha
resist	kana
resistance	ukukanaya
resolution	ukusuminishanya
resolve	ukuwamya
resort	icifulo
resources	ifintu fingabomfya
respect	umuchinshi
respond	ankula
response	ubwankulo
responsibility	umulimo
responsible	ukubikako amano
rest	ukutusha
rest in peace	tusha mumutende
restaurant	icikuulwa bashitisha ifyakulya
restore	ukubwekeshepo
restrict	ukulesha
result	icifuminemo
results	ififuminemo
resume	ukutendeka
resume	ukupituluka
retail	ukushitisha
retain	bwesha
retention	ukwibukisha
retired	ukuleka
retreat	ukuleka
retrieve	bweshapo
return	ukubwelela
reveal	ukusokolola
revealed	ukusokololwa
revenge	ukulandula
revenue	indalama
reverse	ukubwelela inuma
review	ukupitulukamo
revise	ukupituluka
revision	ukupitulukamo
revolution	ukwaluka
reward	icilambu
rhythm	imimbile
rib	ulubafu
rice	umupunga
rich	ukunonka
rid	fumyapo
ride	ukwendela
ride	ncinga
ridiculous	ukuseka
right	cine
right	kukulyo
right now	nomba line
rigid	icakosa
ring	inindaminwe
rinse	ukusukulula
riot	icimfulunganya
rip	lepula
ripe	icapya
rise	ukwima
rise	ukukula
rise	ima
risk	ubusanso
rival	ukupuputulwa
river	umumana
road	umusebo
roast	ukoca
robust	ukukosa
rock	ilibwe
rod	inkonto
role	umulimo
roll	ukukunkuluka
roof	umutege
room	iciputulwa
room	umuputule
root	umushila
rope	intambo
rotten	icabola
rough	bubi bubi
rough	bukali
roughly	bubi bubi
roughly	namaka
round	ukushinguluka
route	inshila
routine	fimofine
row	umutande
rub	ukushinga
rubber	icakufutilako
rubbish	ubusali
rubbish	ifiko
rude	uwabula uluse
rug	icisamu
ruin	ukonaula
rule	ifunde
ruler	intungulushi
rules	ifipope
rules	amafunde
run	ukubutuka
running	ukubutuka
rural	kumushi
rush	butukila
sack	isaka
sacred	icamushilo
sacrifice	ilambo
sacrifice	ukuitula
sacrifice	ukuipelesha
safe	ukucingililwa
safe flight	wende bwino mundeke
safety	ubucingo
sage	uwamano
said	atile
sail	ukwenda
sailing	ukoba
sake	mulandu
salary	amalipilo
sale	shitisha
salt	umucele
same	cimo cine
Same here	cimo cine pano
sample	icakulangilila
sand	umucanga
Sanskrit	Sanskrit
sarcastic	bukali bukali
sassy	uwasalangana
sat	aikele
satisfaction	ukwikushiwa
satisfied	ukwikushiwa
satisfy	ukwikusha
satisfying	icakwikusha
Saturday	Pa Cibelushi
sausage	sosenji
savage	umutuutu
savage	icipondo
savage	uwabipa
save	ukusunga
saw	mwene
say	ukulanda
scale	icakupiminako
scam	icabufi
scar	icibala
scarce	tafimoneka
scared	umwenso
scared	ukutina
scarf	insalu yamumukoshi
scary	ukutinya
scattered	ukusalangana
scene	ukumonekela
scenery	ukumonekela
scent	icanunka
schedule	ubutantiko
school	isukulu
science	sayansi
scientist	sayantist
scientists	bakasambilila bafya science
scissors	sisasi
scold	ukukalipila
scope	umulimo
score	ukwingisha
scrap	icapwa
scratch	ukukwesa
scream	ukupunda
screen	icilola
screw	nati
script	ilembo
sea	bemba
seal	ukukakatika
search	fwaya fwaya
season	inshita
seat	apakwikala
second	icacibili
secret	inkama
section	iciputulwa
secure	ukucingililwa
security	ubucingo
see	ukumona
see you	twamonana
see you later	twalamonana
see you soon	tukamonana
see you tomorrow	tukamonana mailo
seed	ibuto
seek	ukufwaya
seem	ukumoneka
seems	cilemoneka
seen	ukumonwa
seize	pwisha
seizure	cipumputu
seldom	te lingi
seldom	limo limo
select	sala
self	wemwine
self healing	ukundapwa kwa we mwine
selfish	ukuitemwa
selfish	bukaitemwe
sell	shitisha
send	tuma
send me your picture	ntuminako ifikope fyobe
senior	umukalamba
sense	ilyano
sensible	icamano
sensitive	ukuumfwa
sent	tuma
sentence	umusela
sentences	imisela
separate	ukupatula
Sepedi	Sepedi
september	akasuba kanono
sequence	ubutantiko
series	konkana
serious	ukubikako amano
serious	ukuposako amano
seriously	nganshi
serve	ukubombela
serve	ukupepa
service	ukubomba
session	inshita
set	ukubika
set up	panga
setting	ukubika
settle	ukwikala
seven	cine lubali
seventeen	ikumi limo na fibil
seventy	amakumi cinelubali
several	ifingi
severe	ukubipisha
sew	ukubila
shade	icintelelwe
shadow	icinshingwa
shake	ukusunkanya
shall	kuti
shallow	ukutalama
shame	insoni
shape	umusango
share	ukwakanya
sharp	icatwa
she	ali
she has	wene alikwata
she is	wene ali
shed	ukusuma umulopa
sheep	impanga
sheet	ipepala
shelf	shelufu
shell	cipanga
shell	icipapa
shelter	umwa kwikala
shield	icishango
shift	ukukuka
shine	beka
ship	ubwato
shipping	ukutuma pabwato
shirt	ilaya
shoes	insapato
shoot	ukubwekeshapo
shop	ituka
shop	ishitolo
shopping	ukushita
shore	kwishilya
short	ukucepa
short	ubwipi
shortage	ukubulisha
shot	ukupika
should	bushe
should	afwile
shoulder	icipeya
shout	punda
show	ukulanga
show me	ndangisha
shower	ukusamba
shrimp	ing'anse
shrink	cefya
shrink	fina
shut	isala
shut up	talala
shy	insoni
sibling	munyinane
siblings	bamunyinane
sick	ukulwala
side	pambali
sigh	ukupemashika
sight	ukumona
sightseeing	ukutandala
sign	icishibilo
signature	ukusaina
significant	ukucindama
significant	icikankala
silence	tondolo
silent	tondolo
silk	silika
silk	insalu ishabeka
silly	fya buwelewele
silver	siluva
similar	ukupalana
simple	ukwanguka
simultaneously	libili libili
since	ukufuma
sincere	bufuma cumi
sincerely	mucishinka
sincerely	necishinka
sing	imba
singer	kemba
single	umushimbe
single	uwabula ukuupwa
single	cimo
sink	ukwibila
Sir	Mukwai
sister	nkashi
sister in law	mulamu umwanakashi
sit	ikala
site	icifulo
situation	umusango
situation	umubele
six	mutanda
sixteen	ikumi limona mutanda
sixty	amakumi mutanda
size	icalinga
skill	kulamuka
skills	ukulamuka
skin	inkanda
skinny	umubili
skip	ukutolokela
skip	ukuciliila
skirt	siketi
sky	mulwelele
sky	mumulu
slave	umusha
sleep	ukusendama
sleep	ukulaala
sleeping	ukulala
sleepy	utulo
sleeve	ilaya
slice	ukuputula
slide	telelesha
slide	sesha
slightly	panono
slim	onda
slip	ukutelela
slope	umunyololo
slot	icipunda
slow	panono
slowly	panono
small	utunono
small	nono
smart	ubusaka
smell	ukununka
smile	ukumwentula
smoke	icushi
smooth	ukutelela
snack	ifyakulya
snail	inkola
snake	insoka
snap	icikope
snow	amenshi makasa
so	eico
so cute	icawama
so far	pantansi
soak	ukubomba
soap	isopo
sober	kololoka
soccer	umupila
social	ukwisha
society	ubwikashi
socks	insokoshi
soft	icanaka
soil	umushili
soil	iloba
sold	cashitishiwa
sold out	ukushitisha nakupwa
soldier	umushilika
sole	nyantilo
solid	icakosa
solution	ubwafwilisho
solve	ukupwisha
some	fimo
somebody	umuntu umo
somehow	limo
someone	umo
something	icintu cimo
sometimes	inshita shimo
song	inyimbo
soon	nomba line
sophisticated	icalubana
Sorani	Sorani
sore	icilonda
sore throat	ifilonda pa mukoshi
sorrow	ubulanda
Sorry	Ubulanda
Sorry	Njelelako
Sorry	Ububi
sort	sala
sought	ukusala
soul	umweo
soulmate	umutemwikwa wapamutima
sound	iciunda
soup	supu
soup	umuto
sour	ukukantuka
source	intulo
south	akapinda ka kukulyo
space	umupaka
spam	sipamu
span	intamfu
Spanish	IciSpanishi
spare	ukutengela
speak	landa
speak	ukulanda
special	ukucindama
special	ukuibela
species	imisango yanama
specific	ukulungatika
spectacular	icawamisha
speech	ifyebo
speech	imilandile
speechless	ukwabule fyebo
speed	ukubutuka
spell	ukusoma amashiwi
spend	ukubomfya
spent	ukushitila
spicy	ifyanunkila
spike	ukuma
spin	ukushungulusha
spinach	spinaci
spirit	umupashi
spit	fwisa
splendid	ubusuma
split	akanya
spoil	ifyatapwa
spoiled	ukonaula
spontaneous	icipya
spoon	supuni
spot	apo pene
spot	palya pene
spouse	umwina mwenu
spread	ukusabankanya
spring	shinde
square	sikweya
squeeze	ukutitikisha
squirrel	akapale
st	washila
stab	ukuchoma
stable	itanga lya ng'ombe
stable	shikatala
stack	ukwikatwa
staff	ababomfi
stage	inshita
stain	ifiko
stairs	amatabo
stake	umutengo
stalk	umupeti
stall	ituuka
stamp	ukudinda
stamp	ukustampa
stand	ukwiminina
standard	icilangililo
standard	ifunde
star	ulutanda
start	ukwamba
started	caambile
starving	insala
state	imibele
statement	amashiwi
station	siteshoni
statue	icibumbo
statue	icakubumbo
status	imibele
stay	ukwikala
stay safe	ikala bwino
stay safe	ikala uwacingililwa
steady	ukuiteyanya
steak	umunofu
steal	ukwiba
steam	umwela wamenshi yakaba
steel	iceela
steep	ukushuluka
stem	icimuti
stem	umusambo
stem	citimba timba
step	intampulo
stick	icimuti
stiff	icakosa
still	lucili
still	nalyo line
still	bacili
sting	ukusuma
stingy	akaso
stir	kumba
stock	ifipe
stolen	icaibwa
stomach	mumala
stone	ilibwe
stood	ukwiminina
stool	akapuna
stop	ukuleka
storage	umwakusungila
store	ukulonganika
store	ukusunga
store	ituuka
storm	icikuuku
storm	cibulukutu
story	ilyashi
stove	shitofu
straight	ukulungantana
straight	ukulungama
straight	ukololoka
straightforward	icololokwe
strain	ukufunshika
strange	icaibela
stranger	umweni
strategy	imbombele
straw	icani
strawberry	amatunda
streak	kankala
stream	umumana
street	umusebo
strength	amaka
stress	ubulangulushi
stress	ukusamikwa
stretch	ukololoka
strict	icakosa
strike	ukusansa
string	intambo
strip	fula
strive	ukwesha
strive	ukushipikwa
stroke	ulupuma
strong	amaka
strong	ukukosa
struck	ukuma
structure	icikuulwa
struggle	ukulwisha
struggle	ubwafya
struggle	ukushomboka
struggling	ukucucutika
struggling	ukulwishanya
stubborn	bumankonso
stubborn	ukutalama
stuck	ukukakatila
student	umusambi
study	ukusambilila
study	ukusoma
studying	ukucimfyanya
stuff	ifintu
stunning	ukuwama
stupid	ukutumpa
style	umusango
subject	umutwe
submission	ukuipela
submit	ukutuma
substance	icintu
substitute	icakupyanika
subtle	ukucenjela
succeed	ukulunduluka
succeed	ukukwanisha
success	ukutunguluka
successful	mukutunguluka
such	pamo
such	musango yo
such as	ifyapa
suck	ukonka
sudden	mukupumikisha
suddenly	mukupuminkisha
suffer	ukucula
suffering	ukucula
sufficient	ukulinga
sugar	shuga
suggest	ukutubulula
suggestion	ukutubulula
suit	suti
suitable	ukulinga
suitcase	icola
sum	impendwa
summary	ukusupawila
summer	mulusuba
summit	ukukumana kwa kulanshanya
sun	akasuba
sunday	pamulungu
sunny	ulusuba
sunset	akasuba ukuwa
sunshine	ukubalika kwa kasuba
super	icacindama
superior	umukalamba
supervisor	kalolekesha
supper	icawamisha
supply	ukupeela
support	ukutungilila
suppose	nalimo
supposed	nalimo
sure	cine cine
surface	mushili
surface	palwelele
surge	itenga
surgery	ukulepula
surname	ishina
surprise	ukupapa
surprised	ukupapa
surrender	ukuitula
surrounding	ulubansa
surveillance	ukubikako amano
survey	ukufwailikisha
survive	ukupusuka
suspect	tunganishiwa
suspended	ukuleshiwa
suspicious	ukutunganya
sustain	ukusunga
sustainability	ukukwanisha ukusunga
sustainable	icatungililwa
swag	ifyakufwala
swallow	mina
swap	ukucinja
swear	lapa
sweat	ukupiba
sweater	icawamisha
sweep	ukupyanga
sweet	ukuwama
sweet	ukulowa
sweet dreams	ifiloto fisuma
sweet tooth	ukutemwa ifyalowa
sweetheart	umutemwikwa
swell	ukufimba
swelling	ukufimba
swim	ukusamba
swimming	ukowa
swing	akampelwa
switch	ukwalula
swollen	ukufimba
sword	ulupanga
symbol	ifilangililo
sympathy	uluse
symptoms	ifyakwishibilako
system	imibombele
table	itebulo
tackle	bombelapo
tag	ukulemba
tail	umucila
take	senda
take away	funyapo
take away	fumyapo
take care	ukusakamana
take care	ukuisunga
take off	ambapo
taken	ukusendwa
talk	ukulanda
talkative	ukulandikisha
tall	umutali
tap	ukubombafyako
tap	ukusendako
tap	umupompi
tape	tepu
target	ukupimwa
target	ukusanswa
task	umulimo
taste	ukusonda
tasty	ukusonda
taught	ukusambilisha
tea	tii
teach	ukufunda
teacher	kasambilisha
teacher	kafundisha
team	ibumba
tear	ukupwa
tears	ifilamba
tease	ukupumya
technology	technology
teeth	ameeno
tell	ukweba
tell me	njeba
temper	icifukushi
temperature	imibele ya miceele
temple	itempele
temporary	panshita inono
ten	ikumi
ten thousand	amakana ikumi
tenant	ulesonkela
tend	umusango
tendency	ukukongama
tender	icikuuku
tense	imilandile
tension	ukukangana
tent	itenti
tentative	ukufwaya
term	ishiwi
terms	ifipope
terms	ifyakukonka
terrible	icabipa
terrific	icisuma
territory	incende
test	ukwesha
text	ilembo
than	ukucila
thank	totela
thank you	Natotela
Thank you for your patience while we investigate shipment	Twatotela pakulolela kwenu ilyo tucili tulelolekesha pafyo mubikile mubwato
thank you so much	natotela saana
thank you very much	natotela saana
thanks	natotela
Thanks for using our app	twatotela pakubomfya iyi app yesu
that	uwa
that	ica
that	ukuti
that is	nalimo ni
that's good	cilya cisuma
the	ba
theft	ukwiba
their	cabo
them	bena
theme	umutwe
themselves	abenebeka
then	lilya
then	cilya
theory	ifyalembwa
there	kulya
there	uko
there	apo
there are	baba aba
there is	kuli ici
therefore	elyo nomba
these	ifi
they	bene
they are	bena bali
thick	ukutikama
thief	kabolala
thief	umupupu
thigh	itanta
thin	ukucepa
thin	ukonda
thing	icintu
things	ifintu
think	ukutontonkanya
third	fitatu
thirsty	icilaka
thirteen	ikumi limo na fitatu
thirty	amakumi yatatu
this	ici
this is	ici ni
thorough	kushimikiaha
thoroughly	bwino bwino
those	balya
though	nangula
thought	ukutontonkanya
thought	itontonkanyo
thoughtful	ukutontonkanishishako
thoughts	amatontonkanyo
thousand	ikana limo
thread	ubushishi
thread	insalu
threat	icintiinya
threaten	ukutinya
three	itatu
threshold	apakupelela
thrilled	ukusansamuka
thrive	ukutemwisha
throat	pa mukoshi
through	ukupitila
throughout	ukupulinkana
throw	ukuposa
thumb	icikomdo
thunder	icibulukuto
Thursday	Pali Cisano
thus	efyo
tick	chonga
tide	ubusaka
tidy	ubusaka
tie	ukukaka
tiger	imbwili
tight	ukwikatisha
Tigrinya	Tigrinya
time	inshita
timid	ukutina
tiny	akanono
tiny	ukucepa
tip	icakwafwa
tips	ifishibisho
tire	uku naka
tired	ukunaka
tissue	icakukumwinako
tissue	icakupipilako
tissue	tishu
title	umutwe
to	mpaka
to	ku
to be	ukuba
toast	ukuposha
today	ilelo
toddler	akanya
toes	utukondo
together	capamo
toilet	icimbusu
told	ukweba
tolerance	ukusuminisha
tolerate	ukusuminisha
tomorrow	ubushiku bukonkelepo
tomorrow	mailo
tongue	ululimi
tonight	lelo ubushiku
too	ine wine
took	sendele
tool	icibombelo
tools	ifyakubomfya
tooth	ilino
top	pamulu
topic	ilyashi
topic	isambilisho
torn	ukulepula
torture	ukukanda
total	ukusanshya fyonse pamo
touch	ukwikata
tough	ukushipa
tough	icakosa
tough	uwa maka
tour	enda
toward	ukutonta
towards	ukulosha
towel	insalu
town	umusumba
toxic	sumu
toxic	icikola
trace	fwaya
track	inshila
trade	amakwebo
tradition	intambi
traditional	intambi
traffic	bamotoka
trail	inshila
train	ukusambilisha
train	ishitima
training	ukusambilisha
trait	umusango
traits	imisango
transfer	ukusesha
transfer	ukutwala
transition	ukupilibuka
translate	ilula
transparent	palwelele
transport	imyendele
transportation	imyendele
trap	iciteyo
trash	ifiko
trauma	ubusanso
travel	ukwenda
travel	bulendo
tray	treyi
treasure	icuma
treat	ukusunga
treatment	ukundapa
tree	icimuti
tremendous	icapulishamo
trend	citika
trial	cilye
trick	ubucenjeshi
tried	ukwesha
trigger	ukusolomoka
trim	ukucefya
trip	ubulendo
trouble	ubwafya
trousers	itoloshi
truck	icimbayambaya
TRUE	icine
TRUE	cine
TRUE	icishinka
trunk	icishiki
trust	ukucetekela
truth	icishinka
try	ukwesha
Tsonga	Tsonga
tube	umupaipa
Tuesday	Pali Cibili
tuition	amasambilio
turkey	inkoko ikalamba
turmeric	tumeriki
turn	pilbuka
turtle	fulwe
tutor	kafundisha
twelve	ikumi nafibili
twenty	amakumi yabili
twenty-one	amakumi yabili na imo
Twi	Twi
twice	imiku ibili
twist	ukucinja
two	fibili
type	umusango
typical	ukwimininako
ugly	icabipa
ultimate	capulishamo
umbrella	umwamfuli
unable	ukukanakwanisha
uncle	yama
unconscious	ukufenta
under	pesamba
underneath	pesamba
underrated	ukusulwa
understand	ukumfwikisha
understand	ukwishiba
understood	fyaumfwika
unfortunately	ku ca bulanda
uniform	icakufwala capalana
unique	icaibela
unique	icishimoneka moneka
unit	iciputulwa
university	isukulu
unknown	ukukanaishibikwa
unless	kanofye
until	mpaka
unusual	ukuibela
up	pamulu
up to you	cili kuli iwe
update	ukuwamya
upgrade	wamya
upon	ilyo
upon	pa
upset	ukufulwa
urban	itauni
urge	ukukonkomesha
urgent	nomba line
us	ifwe
use	ukubomfya
used	bomfeshiwe
useful	icingabomba
useless	icishakwata ichito
usual	icaseka
usually	ilingi line
utility	akampani
vacation	ukutusha
vacation	cuti
vaccination	umuti
vaccine	umuti
vague	ukwelenganya
vague	ukumoneka panono
valid	umulandu
valley	umupokapoka
valuable	mutengo
value	icamutengo
variety	misango yalekana lekana
various	ifyalekanalekana
vary	pusanapusana
vase	ibotolo
vast	elyo
vegetable	umusalu
vegetables	imisalu
vehicle	motoka
vehicle	ichimbayambaya
vendor	uulebomba umulimo
venom	ubusungu
venture	ubukwebo
venue	icifulo
verify	ukupalanya
verify	ukumona nakabili
versatile	ukukwanisha ukwenda konse konse
version	umusango
vertical	ukubatama
very	sana
very good	cawama
vessel	icipe
via	ukupitila
vibe	ukumfwa bwino
vibes	ukulila
vibes	imyumfwile
vicious	ukukalipa
victim	kabupalu
video	vidio
view	ukumona
village	umushi
villain	icipondo
vinegar	ifyakantuka
vintage	icabutulukila
violence	uluukakala
violence	ubunkalwe
violent	ubunkalwe
viral	ukumbuka
virgin	nacisungu
virtual	icilemoneka
virtue	amaka
virtue	ubulumba
vision	icimonwa
visit	ukutandala
visual	ukumona
vital	icacindama
vivid	icishilemonekesha
vocabulary	amashiwi
voice	ishiwi
void	nangu cimo
volume	iciunda
volunteer	uwakwafwilisha
vomit	ukuluka
vulnerable	ukukana kwata
wage	amalipilo
wages	amalipilo
waist	umusana
wait	lolela
waiter	umubomfi
waiting	ukulolela
wake	buka
wake up	shibuka
walk	ukwenda
walking	ukwenda
wall	icibumba
wallet	icikwama
wander	ukusabanta
wanna	fwaya
want	ukufwaya
wanted	ukufwaikwa
war	ubulwi
wardrobe	umwakubika ifyakufwala
warehouse	ing'anda ya kusungilamo
warm	icikabilila
warm	cifulefule
warn	ukusoka
warning	ukusoka
warrior	umushilika
was	cali
was	yali
wash	suuka
wash	samfwa
wash	wamya
waste	ubusali
waste	onaika
watch	tamba
water	amenshi
watermelon	icitangamenshi
wave	ibimbi
way	inshila
we	ifwe
we are	ifwe tuli
we can	kuti twacita
weak	ubunake
weakness	ubunake
wealth	ubunonshi
wealthy	ubunonshi
wear	ukufwala
wearing	ukufwala
weather	imiceele
wedding	ubwinga
Wednesday	Pali Citatu
weed	ifisoso
weed	icamba
week	umulungu
weekend	ubushiku bwa pa mulungu
weight	ukufina
weird	icipapwa
welcome	ukusengela
welfare	ubusuma bwa
Well	Bwino
well done	mwacita bwino
went	kuya
were	bali
were	ali
west	kumasamba
wet	ukubomba
wet	ukubomfya
whale	icisabi
what	ninshi
what	cinshi
what about you	ngaiwe
what are you doing	finshi mulecita
what are you doing now	ninshi ulecita pali nomba
what are you doing right now	finshi ifyo ulecita
what do you do	mwabombeni
what do you do for a living	finshi efyo cita mubwikashi
what do you mean	wapilibula cinshi
what do you want	ninshi ulefwaya
what happened	ninshi yacitike
what is	cinshi ca
what is this	ni cinshi ci
what is your job	nincito nshi ubomba
what is your name	ni wani ishina lyobe
what's up	bwafya nshi
what's your name	ishina lyobe niwe ani
whatever	icili conse fye
wheat	ingano
wheel	iwilo
wheel	itaila
when	lisa
whenever	ilililyonse
where	kwisa
where are you	ulikwisa
where are you from	ni kwi wafuma
where are you now	uluikwisa pali nomba
where do you live	wikala kwisa
where is	nikwisa
whereas	apo
whether	nangula
which	cisa
while	ilyo
whisper	totosha
whistle	umunsoli
white	ukubuuta
who	nani
who	wisa
who are you	ulikwisa
who is	ninani
who is this	nani uyu
whole	conse
whom	nani
whose	uwo
why	mulandu nshi
why not	cinshi cingalesha
wicked	umubifi
wide	ubukulu
widow	mukamfwila
width	ubukulu
wife	umukashi
wild	mpanga
wild	iciswango
will	bushe
willing	ukufwaya
win	ukucimfya
wind	umwela
window	iwindo
windy	umwela
wine	umwangashi
winter	inshila ya mpepo
wipe	ukufumyapo
wire	lusale
wisdom	amano
wise	amano
wish	ukufwaya
wish you all the best	ndemutotela
witch	indoshi
with	na
withdraw	ukuleka
withdraw	ukufumya
withdrawal	ukuleka
withdrawal	ukufumya
within	mukati
without	ukwabula
witness	kamboni
witness	inte
witty	uwacenjela
wolf	umumbulu
woman	umwanakashi
women	abanakashi
won	ukucimfya
won't	takuli
wonder	ukusunguka
wonderful	icisuma
wood	icimuti
wool	masako
word	ishiwi
words	amashiwi
work	ukubomba
work	umulimo
work out	ukubomba
working	ukubomba
world	icalo
worm	akashishi
worn	ukupwa
worried	ukusamana
worry	ukusakamana
worse	icabipa
worship	ukupepa
worst	icabipa
worth	icalinga
worth	ukucindama
worth	ukulinga
worth it	icalinga
worthy	icalinga
would	kuti
wound	icilonda
wound	ukuicena
Wow	Yangu
wrap	fimba
wrath	ubukali
wrist	pakuboko
write	leemba
Write here	lemba apa
writing	ukulemba
written	icalembwa
wrong	ukulubana
wrong	icalubana
wrong	ukubifya
wrote	ukulemba
yard	ulubansa
yard	incende
yawn	ukwaula
Yeah	Emukwai
year	umwaka
years	imyaka
yeast	intutumushi
yell	ukupunda
yellow	mutuntula
Yes	Ee
yes baby	ee wemutemwikwa
yes dear	ee wemutemwikwa
yes honey	ee wemutemwikwa
yes my love	ee wemutemwikwa wandi
yes of course	ee nifyo fine
yesterday	ubushiku bwafuminepo
yesterday	mailo
yet	lelo
yet	nalyo line
yield	ukutwala
you	iwe
you are	iwe uli
you are beautiful	ulimusuma
you are so beautiful	uli musuma sana
you are welcome	mwaiseni mukwai
you can	kuti wa
You know	Nawishiba
you too	naiwe wine
you're welcome	mwaiseni
young	umwaice
your	obe
your welcome	mwapokelelwa
yourself	wemwine
youth	umusepela
you’re welcome	uli uwasengelwa
yummy	ica kulya cisuma
zero	tapali
