a	e
a little	kakye
a lot	munonga
a lot of	bingi
abandon	kureka
abandoned	kureka
abide	okwikiriza
ability	okubasya
able	kubasa
about	ahari
above	ahaiguru
abroad	aheruyihanga
absence	ekitariho
absent	okubura ahantu
absolutely	amazima
absorb	okunywa
abstract	kukingiriza
absurd	ekyobusaasi
abundance	obwingyi
abundant	obwingi
abuse	kujuma
accent	engamba yorurimi
accept	kwikiriza
access	kuhikaho
accident	butando
accommodation	oburaro
accomplish	kumara
accomplished	ekihwaire
according	kurugirira
account	kubara
accuracy	kupimagye
accurate	kuhikirira
accused	okuvunanwa
ache	obusaasi
achieve	kuboneka
achievement	kuhangura
acknowledge	ndamanya
acquaintance	kuba na
acquire	kutunga
acquired	kikatungwa
acquisition	kutunga
across	kushara
act	kwimukiramu
action	ekikorwa
active	kuba orakora
activities	emirimo
activity	omurimo
actor	omuzaani
actual	kyenyini
actually	nikwekiri
acute	ekya juba
adapt	okumanyiira
add	okwongyera
addicted	otwiirwe omutima
addition	okwongyera
additional	okwongyerera
address	andagiriro
adequate	kiramara
adjacent	ekya aharubaju
adjective	kushoborora
adjust	kworobyamu
admire	kwetenga
admit	kwikiriza
adopt	okureberera otari munya buzaare
adorable	ekirakundwa munonga
advance	bukyarikare
advanced	omutindo
advantage	kyansi
adventure	kurambura
adverb	enshoborora kikorwa
advertisement	kuranga
advertising	okuranga
advice	ekihaburo
advise	obuyambi
advocate	okuhagira
aesthetic	kuba na
affair	ebya rukundo
affect	kuretera
affection	rukundo
afford	kubasa
affordable	ekirabasika
afraid	kutina
after	handihakye
afternoon	kyamushana
afterwards	bwanyima
again	ogundi
against	ahari
age	emiaka
agency	ekitongole
agent	omutumwa
aggressive	obukambwe
agile	ekiratambura juba
ago	kare
agree	ikiriza
agreement	endagano
agriculture	eby obuhingi
ahead	omumeisho
aid	obuyambi
aim	gyenderera
air	omyoya
airport	ekishayi ky'endegye
aisle	ekizinga
alarm	akade
alcohol	amarwa
alert	okurabura
alive	kubaho
all	byona
all right	kitereire
all the best	ebirungi
allow	kwikiriza
allowed	kwikiriza
almost	nkekyo
alone	wenka
along	aharubaju
already	kumara
Alright	Mazima
also	na
alternative	ningashi
although	nobukirabe
always	burijo
am	nyowe
amazing	kyanshemeza
ambiguous	ekiramanyiisa bingi
ambition	ekigyendererwa
ambitious	kwenda munonga
amend	okuhinduraho
amid	rwagati
among	omuri
among us	amureitwe
amount	obwingi
amusing	ekirashemeza
an	e
analysis	kwetegyereza
ancestors	ba tatenkuru
anchor	okukwatisa
ancient	amashemererwa
and	na
and you	kandi iwe
angel	maraika
anger	ekiniga
angle	ango
angry	ekiniga
animal	ekikooko
ankle	akagombamburi
anniversary	omwaka
announcement	ekirango
annoy	okunyizya
annoyed	okunyiiga
annoying	kuteganisa
annual	omwaka
anonymous	otagambirwe amaziina ge
another	ondijo
answer	angarukamu
anticipate	okuteekateeka
anxiety	amashemererwa
anxious	kushemererwa
any	ekyorabone
anymore	ogundi
anyone	buryomwe
anything	burikimwe
anyway	tashonga
anyways	kyona eki kiri
apart	oihireho
apartment	ekizimbe
apologize	kushaba okusasirwa
apparent	ekirarebeka
apparently	bwajuba
appeal	kujuriza
appear	kubaho
appearance	enshushana
appeared	akarebeka
appeared	kikarebaka
appetite	okwenda
apple	apo
application	okushaba
apply	shaba
appointment	kukuha omurimo
appreciate	okusima
appreciation	okusiima
approach	omuringo
appropriate	kyenyine
approval	okuhamya
approve	okuhamya
approved	ekihamiibwe
approximately	kyenyine
april	okwezi kwa kana
arbitrary	ekitereezo
architect	omwombeki
architecture	enyombeka
archive	kuhangura
are	hati
are you	ori
are you busy	oine eki ori kukora
are you married	oshweirwe
are you married or single	oshweirwe oba okyariwenka
Are you still there?	Okyaari hanu?
are you there	oriyo
area	emyanya
argue	kuhakanisana
argument	kugambaho
arise	okwimuka
arise	imuka
arm	omukono
army	amahe
around	hanu
arrange	kutereza
arrangement	okutebekanisa
arrival	okuhika
arrive	okuhika
arrived	kuhikaho
arrogant	kugambira ebyo
arrow	obutta
art	ebya ebishushani
article	akacweka
artificial	ekikozirwe omuntu
artist	omweshongozi
as	nka
as long as	kasita
as well	nakyo
as well as	nakyo
ash	kashenda
ashamed	okushwara
ask	buuza
ask	okubuuza
asked	kikabuzibwa
asleep	abyaami
aspect	ekyokukora
Assamese	Assamese
assault	okutwara kubi
assembly	orukunganya
assertive	oragamba aine obumanzi
assess	kugyeza
assessment	ekigyezo
asset	ekyobugaiga
assets	ebintu
assign	okuha omurimo
assignment	ekyokukora
assist	okuyamba
assistant	omuhwezi
associate	kukwatanitsya
associated	kukwatanisa
association	ekigombe
assume	yeshwaniriza
assumption	ekyokweshushaniriza
at	ahari
at least	hakiri
ate	akarya
athlete	omwiruki
attach	okukwatisyaho
attached	kikwitseho
attachment	okukwatanisa
attack	okurumba
attempt	kugyeza
attend	kubayo
attendance	okubaho
attention	okufaho
attitude	entekateka
attract	okukurura
attraction	okukurura
attractive	kusikiriza
attribute	okweterera
audience	abampurikize
august	okwezi kwa munaana
aunt	shwenkazi
aunty	nyokwento
aunty	shwenkazi
authentic	ekihikire
author	omuhandiki
authority	obushoborozi
autumn	omwitumba
available	kubaho
average	ahagati
avoid	yerinde
awake	orareeba
award	ekihembo
aware	kumanya
awareness	kwetebekanisa
away	hare
awesome	kwetegyereza
awful	kirashwakubi
awkward	kutinisa
Aymara	Aymara
baby	omwana
bachelor	diguri
back	enyima
background	omumwanya
bad	kibi
bag	enshahu
bait	ebykurya bya ekyenyanja
bake	okubumba
bakery	bekeeri
baking soda	ekitumbisa
balance	enshagye
ball	omupiira
Bambara	Bambara
banana	ebitokye
band	banda
bang	hoonda
bang	okuhoond
bank	eibikiro byesente
bar	ebaara
barely	hakye
bargain	kuramuza
bark	okumoka
barley	bare
barrier	ekiratamba eikono
base	omusingyi
based	kirugiriire
basement	entangiro
basic	ebikwato
basically	ekikuru
basil	omubazi gwebishaka
bastard	ekinyandaro
batch	ekirundo
bath	okwozya
bathroom	ekinabiro
battery	eryanda
battle	orutaro
bay	ekyasha kyeitaka
be	kuba
be careful	gyira obwegyendesereza
beach	akayanja kokwibiriramu
beam	ekyererezi
beans	ebihimba
bear	kigumire
beard	ebireju
bearing	okuzaara
beast	ekintu
beat	teera
beautiful	okubonera
beauty	oburungi
became	kikaba
because	ahabwokuba
become	kuba na namazima
bed	ekitanda
bedroom	ekishengye
bee	enjokyi
beef	enyama yente
been	abaire
beer	amarwa
before	ahanyimaho
began	kikatandikwa
begin	kutandika
beginning	okutandika
behalf	omumwanya
behave	kutwaza
behavior	emicwe
behaviour	emichwe
behind	enyima
being	okuba
belief	okwikiriza
believe	kwikiriza
belly	eibondo
belong	ekya
beloved	omukundwa
below	ahansi
belt	orukoba
bench	efoomu
bend	okugondeka
beneath	ahansi
benefit	amagoba
benefits	ebyarugamu ebirungi
beside	aharubaju
besides	ohabyekyo
best	kirungi
best of luck	omugisha omurungi
best regards	okwakura okurungi
better	kirungi
between	ahagati
beverage	ekyokunywa
beyond	kyarenga
Bhojpuri	Bhojpuri
bias	kubanganisa
biased	okubanganisa
bicycle	egaari
bid	okushaba kutunga omugisha
big	ekihango
bike	egaari
bill	esente zokushashura
bind	okukwatanisa
bird	enyonyi
birthday	amazarwa
bit	kace
bite	kuruma
bitter	kusharira
black	ekiriiragura
blade	ekisyo
blame	kucwera omushango
blank	ahariho busha
blanket	burangiti
blast	okuturisya
bleach	okuhindura erangi
blend	okujwanzya
bless	okuha omujisha
blessed	kuhebwa omugisha
blind	empumi
bliss	amashemererwa
block	eitafari
blood	eshagama
bloom	ekikondoozo
blow	kuhuha
blue	bururu
blunt	ekikazire
board	orubaho
boat	obwato
body	omubiri
boil	okuteeka
bold	kuba na namazima
bond	kunywanisa
bone	eigufa
book	ekitabo
boost	kuha amaani
booster	kongyera
boot	enkaito
boot	butisi
boots	butisi
border	esharo
bore	okurima
bored	kubura ekyokushemeza
boring	tikiraha omuhimbo
born	kuzarwa
borrow	kuteiza
boss	omukama
both	byona
bother	kufayo
bottle	ecupa
bottom	entango
bought	kugura
bounce	okutaruuka
bound	ensharo
boundaries	ensharo
bow	okwinama
bowl	ebahuro
box	ebokisi
boy	omwojo
boyfriend	munywani ari omwoojo
bracelet	enkwanzi
brain	obwonko
branch	eitaji
brand	okuramba
brave	emanzi
breach	okwihamu erangi
bread	omugati
break	akuruhukwa
breakfast	kyanstya
breast	amabere
breath	kwotsya
breathe	kwistya
breed	kujwa
brick	eitafaari
bride	enjugano
bridge	orutindo
brief	omugufu
bright	owobwengye
brilliant	owamagyezi
bring	reta
bro	munywani
broad	ekishanjukire
broadcast	okuhereza amakuru
broke	kikaatwa
broke	akaata
broken	kuhendeka
broom	ekikondoozo
brother	murumuna
brother in law	muramu
brought	kureta
brown	kwera
brush	okukuuba
bucket	ebaketi
buddy	munywani
budget	embarira
bug	akakoko
build	kwombeka
building	kombeka
built	ekyombekirwe
bulk	obwingyi
bull	enumi
bully	okubonabonesa
bump	okutomera
bunch	ekirundo
bundle	omuba
burden	omusharaba
buried	akaziikwa
burn	kotsya
burst	kubaruka
bury	okuziika
bus	basi
bush	ekishaka
business	okushubura
bust	kushatuka
busy	kubura obwire
but	nkonka
butter	amajuta ngente
butterfly	ekihuguhugu
button	eipesha
buy	kugura
by	na
by the way	yego
bye	kare
cabbage	kabegyi
cabinet	kabineti
cage	akaju
cake	omugati
calf	omutavu
call	kweta
call me	nterera esimu
called	kwetwa
calm	mpora mpora
came	akaija
campaign	okuronda akaruru
can	orabasa
can't	tikikaaba
Cancel	okushazamu
cancer	kansa
capable	kubasa
capacity	kubasa
capital	orurembo
caption	okukwata
capture	okukwata
car	emotoka
career	okuhabura
careful	kwegyendesereza
carefully	nobwegyendesereza
careless	otarafayo
caring	okufayo
carpenter	omubeizi
carpet	kapeti
carrot	karoti
carry	yegura
carry on	okubaasa
carry out	okukora
case	omushango
cash	esente eziriho
cast	kuzana
castle	ebyokuzanisa
casual	kyaburijo
cat	kapa
catch	okukwata
category	ekichweeka
cattle	ente
caught	kutwatwa
cause	kuretera
caution	okurabura
cautious	okwegyendesereza
cave	omwina
cease	ekirareeta
ceiling	kuchingaho
celebrate	kujaguza
cell	akatafaari komubiri
center	rwagati
century	ekyaasha
cereal	embibo
ceremony	omukoro
certain	kache
certainly	namunonga
certificate	ekihandiiko
chain	orujegyere
chair	entebe
challenge	ekyobuzibu
chance	omugisha
change	kuhindura
chaos	okutabura
character	entwaza
characteristics	obumanyiso
charge	kucwhera
charity	embabazi
charming	okutwara obwonko
chart	chaati
chase	kubinga
chat	okuganiira
cheap	kuguragye
cheat	okwiiba
cheating	okwiiba
check	kucebera
cheek	eitama
cheer	okuhagira
cheerful	kushemererwa
cheers	kujaguza
cheese	amajuta
chemistry	ebya emibazi
cherish	okukunda munonga
chess	kyeesi
chest	ekifuba
chew	okufutana
chicken	enkonko
chief	oukama
child	omwana
childhood	obwana
children	abaana
chill	kuhumuraho
chimneys	endesezo
chin	akareju
chocolate	kyokoreti
choice	kutorana
choose	kutorana
chop	okutema
chores	akarimo
chubby	omuhango
church	eiramizo
cinnamon	omudarasini
circle	enziga
circumstances	embera
citizen	omuturagye
city	orurembo
claim	okukyetamu ekyawe
clarify	shoboorora
class	ekibina
clay	eibumba
clean	obuyonjo
clear	nikwe
clerk	omutegyeki wa omuruka
clever	owamagyezi
client	kasitoma
cliff	orukiri
climate	embera
climb	kutemba
clingy	ekirakwata
clock	eshaaha
close	haihi
closet	ahokubiika
cloth	ekijwaaro
clothes	ebijwaro
cloud	ekichu
cloudy	oruho
clown	omushema
clue	okwibizaho
clumsy	kubura embaabazi
cluster	ekirundo
coach	omutendeki
coal	koolu
coast	omwaro
coat	ekoti
coffee	omwani
cognitive	ekya obwonko
coincidence	okutomerana kwebirabaho
cold	kirafuka
collapse	kugwa
collar	ekitogyi
colleague	mutahi wangye
colleagues	omunywani
collect	kuronda
collection	orukunganyo
college	eitendekyero
color	erangi
colorless green ideas slept furiously	ekitaine erangi kinyantsi
colour	erangi
column	orunyiriri
comb	okushokoza
combination	okukwatanisa
combine	okukwataniisa
come	ija
come here	ija hanu
come on	rugaho
comfort	okugira obusingye
comfortable	kuhumura gye
coming	okwiija
coming soon	ekirikwija juba
command	okuragiira
comment	okuha entekateeka
commercial	omushuburo
commission	omushoro
commit	kwehayo
commitment	okwehayo
committed	kwehayo
commodity	ekyamaguzi
common	burijo
communicate	okugamba
communication	kugamba
community	omwanya
commute	okushashura
companion	omuyambi
company	kubanabandi
compare	kuringanisa
comparison	okugyeragyeranisa
compassion	rukundo
compassionate	omutima gwokuyamba
compatible	ebirakwatagana
compete	okuhakahakana
competent	oine ekiretagwa
competition	empaka
competitive	okuhakahakana
complain	kwetombwita
complaint	kwetombwaita
complement	okuha amani
complete	okuhendera
complete	hendera
completely	bwoona
complex	kuguma
compliance	kuhikiriza
complicated	kuguma
compliment	ebiragyenda hamwe
comply	okuhikyiriza
composition	ebikozire
compound	embuga
comprehension	okukyeenga
comprehensive	ekiramara
compromise	kugyenda nakyo
compulsory	eiteka kukora
computer	karimagyezi
concentrate	okuta amani
concept	eishomo
concern	nikikuru
concerned	kinkwiseho
concert	emworeko
conclusion	empendera
concrete	enkogoto
condition	embera
conditions	embeera
conduct	kukurira
conference	oruterane
confess	okwatura
confidence	kuhama
confident	kuhama
confirm	kuhamya
conflict	entaro
confused	obutasharamu
confusion	okubuzabuzibwa
congrats	kurika
congratulation	kurika
congratulations	webare
conjunction	omukukwatanisa
connect	okukwatanisa
conquer	okuhamba
conscious	kufayo
consciousness	obutebekana bwomutwe
consent	okwikirizana
consequences	ebirarugamu
conservation	okurunda
conservative	oteenda kuhinduka
consider	nakyo nikikuru
considered	kitwigwe
consist	kyiine
consistency	obutahinduka
consistent	kutahinduka
constant	nikwekitwire
constantly	ekiragumuzamu
constipation	empata
construction	kwombeka
consume	okukozesa
consumption	kukozesa
contact	kuronda
contagious	ekiraturira
contain	kugumira
contains	kiine
contemporary	ekyomurembe
contempt	okugaywa
content	amakuru
contest	empaka
context	omukishwani
continent	ekiziinga
continue	kugumizamu
contract	omurimo omukire kakye
contrast	kuhakanisa
contribute	omuganda
contribution	ekyokugaitaho
control	okutegyeka
controversial	ekitarakyengikwa
convenience	ekitarateganisa
convenient	obwire obushemeire
conversation	enganira
convert	okuhindura
convey	kurabyaho
convince	kubihabiha
convinced	okwikiriza
cook	kuteka
cooking	kuteka
cool	obuteka
cooperation	enkwatanisa
cope	okumanyira
copper	kopa
core	ekyahagati
corn	ekichhori
corner	eshonda
correct	kihikire
cost	ebeyi
costume	ebijwaro by okuzaniramu
cottage	enju
cotton	pamba
couch	ekitanda
cough	enkorora
could	kirabasa
council	eishengyero
count	kubara
counter	ekirabara
country	eishaza
countryside	ekichweeka kyeihanga
couple	abakundine
courage	kuha amani
course	poroguramu
court	koti
courtesy	kihagiibwe
cousin	munyanyanzi  wa shwento
cover	fundikira
cow	ente
coward	ekinyabwooba
cozy	ekyeihoreere
crab	ekitangura
crack	okwata
craft	ebyemikono
crap	ekishema
crash	okuhonda
craving	okwetenga
crawl	okwajura
crazy	kirashetsya
create	kuhangaho
creative	kuhangahangaho
credit	kukoragye
creep	okukuruza
creepy	ekiraranda
crew	mukuru wabakozi
crime	omushango
cringe	obutiini
crisis	obwire bweibura
criteria	ebirakuratiritirwa
critical	embera imbi
criticism	okuhakanisa
crop	ekihingwa
crops	ebihingwa
cross	kucwekanisa
crow	ekikoona
crowd	kwijurirana
crowded	kwijurirana
crown	ekijwaro kya ahamutwe gwomugabe
crucial	kikuru
cruel	amazima
cruise	okutamburira ahabwaato
crush	obutikirizana
cry	kurira
cucumber	kyukamba
cuddle	kutambuza
culture	obyobuhangwa
cunning	ekiine amagyezi
cup	ekikopo
cupboard	ekabada
curb	okutambira
cure	kutambura
curfew	omukingo
curiosity	okwenda kumanya
curious	kwenda kumanya
curly	ekihinyirwe
currency	esente
current	bwahati
currently	obwahati
curse	omukyeeno
curtain	kateni
cushion	akashego
custom	eyomuntu omwe
customer	omuhagizi
customs	emigyenzo
cut	kutema
cute	abaneire
cycle	omwehinduro
cycling	okuvuga
dad	taata
daddy	taata
daily	burijo
dairy	amate
dam	ekidiba
damage	kushishikara
damn	kwenda kubi
damp	okunaga
dance	okuzina
danger	akabi
dangerous	ekyakabi
dark	omwirima
darling	omukundwa
dash	omusitaari
data	data
date	ebiro
daughter	omuhara
day	ekiro
dead	ekifire
deadline	obwire obu otaine kurengaho
deaf	ekiteta
deal	purani
dear	okundwa
Dear All	mwena
Dear Customer	Omuhagizi Omukundwa
Dear Parents	Abazeire abakundwa
Dear Sir	Sebo omukundwa
Dear students	Abeegyi abakundwa
Dear Team	Ebekigombe abakundwa
death	rufu
debate	ekihajaano
debit	eibanja
debris	ebisingo
debt	eibanja
decade	emyaka ikumi
decay	okujunda
deceased	omufu
deceive	okubeiha
december	okwezi kwa ikumi neibiri
decent	kujwaragye
decide	kusharamu
decided	kusharamu
decision	ensharamu
deck	deeki
decline	kugwa
decrease	kucendeza
dedicated	kuhayo
dedication	okuhayo ahari
deed	ebikorwa
deep	haringwa
deer	akakoko
default	obuzibu
defeat	okusingurwa
defend	okurwanirira
define	kushobrora
definitely	kweri
definition	kushoborora
degree	diguri
delay	kucerererwa
delayed	ekikyerereziibwe
delete	okusangura
deliberate	ekigyenderirwe
delicate	ekiratika
delicious	kunura
delight	amashemererwa
delighted	kushemererwa
deliver	okuhayo
delivered	okuhisya obutumwa
delivery	kuhitsya
demand	kwenda
demanding	okushaba
democracy	demokorasiya
demon	omuzimu
demonstrate	shoborara
denied	okwimwa
density	oburemeezi
dentist	omushaho wa amaino
deny	kwehakana
department	ekichweeka
departure	kusimbura
depend	okurugyirira
deploy	kutamu
deposit	kushashuraho
depressed	okuteganisibwa omumutwe
depression	kutabagye
depth	oburaingwa
describe	kushoborara
description	enshoborora
desert	okoma
deserve	ahashemerire
design	kutereza
designation	okutebekanisa
desire	okwetenga
desk	entebe
despair	okwehwa amatsiko
desperate	kuwa amatsiko
despite	nobworabe
dessert	okoma
destination	empendera
destiny	ahamuheru
destroy	okushisha
destruction	okushiisha
detail	obwijwiire
details	obwijwiire
detect	okumanya
determination	ekigyendererwa
determine	kusharamu
determined	ofiireyo
devastated	okuteganisibwa
develop	kutunguka
developed	ekikurakureine
development	entunguka
device	ekyoma
devil	sitaani
devoted	oyeheireyo
Dhivehi	Dhivehi
diabetes	oburweire bwa shukari
diarrhea	ekirukano
diary	ebihandiiko by burizooba
dictionary	kavunuuzi
did	kika
die	okufa
died	akafa
diet	ebyokurya
difference	enyahukana
different	tikirashwana
difficult	kigumire
dig	okuhinga
dignity	ekitinisa
diligent	okureeba hare
dinner	kyamwabazyo
dip	okwibika
direct	kugyera kimwe
direction	orubaju gwokutoramu
director	omutegyeki
dirt	oburofa
dirty	ekigubire
disable	okuzibira
disabled	ekimuga
disappear	kuburaho
disappointed	kuwa amaani
disaster	ekigwererezi
discard	yesaasire
discard	okwesaasira
discharge	okusibuura
discipline	emicwe
discount	omuhendo ogusigaireho
discover	kujumbura
discrimination	okwahura
discuss	kuganira
discussion	ekiganiiro
disease	endwara
diseases	endware
disguise	okwebeiha
disgusting	kutama
dish	ediishi
dishes	amadiishi
dismiss	okusetura
dispatch	okusetura
dispatch	okusindika
display	kworeka
disposal	okunaga
dispute	obutikirizana
distance	akanya
distinct	ekyomutano
distinguish	kutanitsya
distress	okuteganisibwa
distribution	kugaba
district	disiturikiti
disturb	kutabura
ditch	ekiina
dive	guruka
diverse	ekyiine bingi
diversity	amatane
divide	okugabanisa
divine	ekya ruhanga
divorce	okushenya eka
dizzy	kutagira amaani
do	kora
do you	ori
do you love me	orankunda
doctor	omushaho
document	ekihandiiko
does	kirakora
doesn't	tikikaba
dog	embwa
Dogri	Dogri
doing	kukora
doll	ekidori
domain	ekishaka kyomuntu
domestic	ebyomuka
dominant	ekikuru
don't	otakikora
Don't worry	otafayo
donate	okugabira
done	kyakorwa
donkey	endogoya
dope	ekirungi
double	okubazamu kabiri
doubt	kubanganisa
dough	ekyokubumbamu
down	ahansi
download	okuhanura kuruga ahamutimbaganano
draft	kugyeza
drag	okukurura
drain	kwoma
drama	katemba
draw	kutera
drawer	akashandukye
drawing	okuteera ekishushani
dread	ebitutu byeishokye
dream	ekiroto
dress	ekiteteyi
drill	okurima
drink	kunywa
drive	kuvuga
drop	eitondo
dropped	ekinagirwe
drought	ekyanda
drunk	osinzire
dry	kwoma
duck	embata
dude	omusigazi
due	ahabwokuba
due to	aha bw'
dull	taine magezi
dumb	ekiteta
dump	kunaga
duration	obwire
during	omubwire
dust	omucucu
duty	omurimo
dwell	okutuura
dying	okufa
each	buryomwe
each other	buryomwe
eager	okwenda
eagle	omukya
ear	okutu
earlier	enyimaho
early	kuchera
earn	kutunga
ears	amatu
earth	ensi
earthquake	omusisa
ease	kurobya
easily	nobwangu
east	bukika
easy	ekyanguhi
eat	eirya
eating	okurya
economic	ekikwatagiine nesente
economy	eby'entasya
edge	eshonda
edit	okuboneza ekihandiiko
education	obwegyese
effect	okurugiramu
effective	kukorwa
efficiency	okugira okubasa
efficient	kiramara
effort	amaana
egg	eihuri
eggplant	entoonga
ego	okweyendeza
eight	munaana
eighteen	ikumi namunaana
eighty	kinaana
either	oba
elaborate	shoborora
elbow	enkokora
elder	omukuru
elderly	omugurusi
elderly	omukaikuru
elegant	oine ekiteero kirungi
element	ekichweka
elephant	enjojo
eleven	ikumi nemwe
eligible	oshemerire
eliminate	okwihamu
else	ekindi
embarrassed	kutegwa enkuba
embarrassing	ekyokushwazana
embrace	kugumizamu
emerge	okureetwa
emergency	ekyahonaho
emotional	ekibeerabeera
empathy	embabazi
emphasis	kukihamya
emphasize	okuta esira
employee	omukozi
employees	abakozi
employer	omukama
employment	omurimo
empty	busha
enable	okwikiriza
encounter	kubugana
encourage	muhe amani
end	muheru
endangered	ekiri omukabi
endeavor	ijuka
endurance	okugumisiriza
endure	okugumisiriza
enemy	emwangi
energy	amani
engage	kubamu
engaged	kubamu
engagement	kuba omukintu
engine	ingini
engineer	owebyemikono
English	orujungu
enhance	omutindo
enjoy	shemererwa
enormous	kihango munonga
enough	kiramara
ensure	orebeke
enter	okutaha omukintu
entertainment	kushemeza
enthusiasm	kushemererwa
enthusiastic	amashemererwa
entire	boona
entitled	kishemereirwe
entity	ekintu
entrance	ahokutahiramu
entrepreneur	omushubuzi
envelope	ebahasa
environment	omwanya
envy	kwetenga
epic	ekyamani
epidemic	endwara erajanjara kuhika hare
equal	kwingana
equipment	ekikwato
equity	oburinganiza
equivalent	ekiringana
eraser	akasanguzo
error	enshobi
escape	kutoroka
especially	namunomuno
essay	ekihandiko
essence	omugasho
essential	nikikuru
establish	kuhangaho
established	kutaho
estate	amaju
estimate	kutebereza
estimated	ekirateberezibwa
etc	nebindi
eternal	ekitarihwaho
ethics	emichwe
evaluate	okushwijuma
evaluation	okushwijuma
even	nkekyo
even though	nobukirabe
evening	omwabazyo
event	ekikorwa
eventually	ahamuheru
ever	burijo
every	buri
everybody	buri omwe
everyone	buryomwe
everything	burikimwe
evidence	obuhame
evil	ekibi
evolution	okuruga omukintu
evolve	okureeta
Ewe	Ewe
ex	owabeireho
exact	kyenyini
exactly	kyenyine
exam	ekigyezo
examine	okushwijuma
example	ekyokureberaho
exceed	okurenzya
excellent	kyabonera munonga
except	kureka
exception	okwihaho
excess	ekingi munonga
excessive	ekiingi munonga
exchange	kuhanitsya
excited	okushemererwa namani
excitement	okushenmererwa
exciting	kushemeza
exclusive	ekihiremu
excuse	okusasira
excuse me	nsasira
execute	okukora omurimo
execute	okwita
execution	okukora omurimo
execution	okwiita
executive	akakiko
exercise	omurimo
exhaust	ekizoozi
exhausted	okuwamu
exhibit	okworeka
exhibition	omworeko
exist	okushohora
existence	okubaho
existing	ekiriho
exit	okuruga
expand	kushanjura
expect	ndamanya
expected	nkaakitekaateka
expenses	enshohoza
expensive	kusera
experience	obikugu
experiment	ekisipirimenti
expert	omukugu
expired	kifire
explain	kushoborora
explanation	okushoborora
exploit	okikozesa
explore	kumanya
export	ekushohoza kuruga omwihanga
expose	ekworeka
exposed	okumanywa
exposure	kuweza
express	kugyenderaho
expression	kwegambaho
extend	kongyeraho
extended	ekyongeirweyo
extension	kwongerayo
extent	kwinganaki
external	ekyaheeru
extinct	ekyarugireho
extra	ekyeyogyeireho
extract	omubisi
extraordinary	ekitari kya buriijo
extreme	ekirengeine
extremely	ekirungi
eye	eriisho
eyes	amaisho
fabric	ekijwaro
fabulous	kushemererwa
face	obuso
facilitate	okuhereza obuhwezi
facilities	ebyombeko
facility	ekyombeko
fact	ekyamazima
factor	ekiraretera
factory	fakitore
facts	amazima
fade	okuhwamu esha
fail	kuremwa
failed	akaremwa
failed	kikaremwa
failure	kuremwa
faint	kurwa ahansi
fair	hakiri
fairly	hakiri
fairy	hakiri
faith	okwikiriza
faithful	okuba omwesigwa
fake	ekitahikire
fall	okurwa
FALSE	ekishuba
fame	okumanywa
familiar	kmanyira
family	eka
famine	enjara
famous	kumanywa
fan	kushemererwa
fancy	kirungi
fantastic	ekirungi munonga
far	hare
farewell	embaga yokusibura
farm	eihingiro
farm	eirisizo
farmer	omuhiingyi
fascinating	kwita
fashion	enkora
fast	juba
fat	muhango
fatal	ekiraita
fate	obuzibu
father	taata
fatigue	ekiniga
fault	obuzibu
favorite	ekiboneire
favour	okugombeza
favourite	ekiboneire
fear	kutina
feast	okurya
feather	eiyoya
feature	obumanyiso
features	obumanyiso
february	okwezi kwa kabiri
fed up	okutamwa
fee	esente zokushashura
feed	kurisa
feedback	ekyarugamu
feel	hurira
feeling	kuhurira
feet	ebigyere
fell	ekitashaya
fellow	mutaahi
felt	kuhurira
female	omukazi
fence	orugo
fertile	ahareera
festival	omukoeo
fetch	kutaha
fever	omushaijo
few	kache
fewer	ebikye
fiance	omugore
fiction	ebyebishuba
field	ahamurimo
fierce	obwoba
fifteen	ikumi neitano
fifty	makuma ataano
fight	kurwana
fighting	okurwana
figure	enamba
figure out	okumanya
file	fayiro
fill	kwijuza
filled	kyeijwiire
film	akatambi
filthy	ekigubire
finally	ahamuheru
finance	ebya entasya
financial	ebyesente
find	shanga
find out	okuronda
fine	kyabora
finger	orukumu
finish	kumara
finished	kikahwa
fire	omuriro
firm	kuhamya
first	obwira
first name	eizina byokubanza
fish	ekyenyanja
fit	kihikire
five	itaano
fix	kutamu
fixed	ekikwatsire ahakindi
flag	ebendera
flash	ekyererezi
flat	akaterero
flaw	ekizibu omumaisho
flawless	ohikire
flee	okutoroka
flesh	omubiri
flew	kikaguruka
flex	okuhinduka
flexible	ekirabasa kuhinduka
flight	oruguruka
flip	okuhindura
flirt	okuzanisa
flirting	okwezesa
float	okutungama
flood	omwijuro
floor	ahansi
flour	ensano
flow	kutamburagye
flower	ekimuri
flu	senyiga
fluent	okugamba kurungi orurimi
fluently	okugamba orurimi kurungi
fluffy	owebinyampo
fluid	ekya amaizi
fly	esnshwehera
focus	kureba
fog	ekiho
foggy	oruho
fold	okukuba
folks	abaturagye
follow	kukurata
follow up	okukuratirira
following	kukurata
food	ebyokurwa
fool	omushema
foolish	obushema
foot	ekijere
football	omupiira gwebigyere
for	ekya
For example	ekyokureberaho
for instance	ekyokureberaho
for you	ahabwawe
forbidden	ekibi
force	kugyema
forecast	kutebereza
forehead	obusyo
forehead	enkoombe
foreign	amahanga
forest	eihamba
forever	obutwire
forget	kwebwa
forgive	okusasira
forgot	ekyebirwe
fork	ehuma
form	ekibina
formal	ekya kare
former	obire ariho
fortunately	ekyomugisha
fortune	omugisha
forty	makumi ana
forty-two	ana neibiri
forward	omumaisho
foster	okubeera omuzaire otari munyabuzaare
fought	akarwana
found	kushangwa
foundation	omusiingi
four	ina
fourteen	ikumi neina
fox	muha
fragile	furajahiro
frame	omuriro
framework	efureemu
fraud	kuhutaza
freak	ekirema
free	kweshariramu
freedom	obusingye
freeze	okuhinduka orubaare
frequency	obwingyi
frequent	ekiragumizamu
frequently	butemereza
fresh	omubiri
friday	orwakatano
fridge	ekyokufukiza
friend	munywana
friendly	kunywana
friends	abanyamukago
friendship	obunywaani
frightened	kutambura nenyonyi
frightening	ekiratiinisa
frog	ekikyere
from	kuruga
front	omumaisho
frozen	ekikwatsirwe orubaare
fruit	ekijuma
frustrated	kutabagye
fuel	amajuta
Fulfulde	Fulfulde
full	kwijura
fun	okushemererwa
function	omukoro
fundamental	ekikuru munonga
funeral	orufu
funny	kuhemura
fur	hare
furious	okukora namani
furniture	ebibijaire
further	kongeraho
furthermore	kwongyeraho
future	omumaisho
gain	ogundi
game	omuzaano
gap	omwanya
garage	garagi
garbage	kasasiro
garden	omusiri
garlic	katunguru chumu
gate	ogwigi
gather	kurundana
gathering	okukunganya
gauge	okubaramu
gave	kikahebwa
gear	giya
gender	muntu ki
general	boona
generally	omuribyona
generate	okureeta
generation	omurembe
generous	embabazi
genius	omugezi
genre	omuzani
gentle	oyetweire
genuine	ekyamazima
gesture	akamnyiso ka ahamubiri
get	kwata
get dressed	jwaara
get up	eimuka
get well soon	okukyira juba kurungi
getting	okutunga
ghost	omuzimu
ghosting	okubuzyaho
giant	ekihango munonga
gift	ekirabo
ginger	etangahuzi
girl	omwishiki
girlfriend	omunywaani ari omwishiki
give	bahe
give up	kurekura
given	ekihairwe
glad	kushemererwa
glance	okureebaho kakye
glass	ekirahuri
glasses	ebirahuri
glimpse	akakwibizaho
global	eky'ensi yoona
gloomy	omugore
gloves	girravu
glow	okwangashana
glow	okwaaka
glow up	okwangashana
glue	gama
go	gyenda
go ahead	gumizamu
go away	gyenda kuri
go to bed	za omukitanda
goal	gora
goals	ebigyendererwa
goat	embuzi
god	sitani
god bless you	Ruhanga akuhe omugisha
goes	aragyenda
going	kugyenda
going to	okuza
gold	ezaabu
gone	yagyenda
gonna	ndaza
goo	oine rukundo
good	kiboneire
good afternoon	wasibagye
good bye	kare
good day	eizoba rirungi
good evening	omwazo murungi
good job	omurimo murungi
good looking	ekirareebeka gye
good luck	kakwendeze omugisha
good morning	orire ota
good morning my love	oriire ota rukundo yangye
good night	oraregye
goodbye	kaare
goodnight	ekiro kirungi
goods	ebintu
Google	Google
Google Translate	okuvunuura kwa Google
goose	guuzi
gorgeous	oburungi
gossip	orugambo
got	kutunga
got it	nakitunga
government	gavumenti
grab	kuhangura
grade	guredi
gradually	mpora mpora
graduate	okujwara
grain	enjuma
grant	okuha
granted	kyakuheebwa
grapes	emizabibu
grasp	okukwata
grass	ebinyasi
grateful	munonga
gratitude	ekihika
grave	ekituuro
gray	erangi ya kashenda
great	nekyamani
greed	omururu
greedy	omururu
green	kinyasi
greet	okwakura
greeting	endamustyo
greetings	okwakura
grey	ekya kala ya kashenda
grid	omusitaari
grief	obusasi
grind	okusya
grip	okukwatisa amaani
grocery	ebijuma nemboga
groom	omugore
gross	entasya
ground	ahansi
group	ekigombe
grow	kukura
growth	okukura
grumpy	otarahaaga
Guarani	Guarani
guarantee	kigombwa
guard	omurinzi
guess	tebereza
guest	omugyenyi mukuru
guidance	endagiriro
guide	kuhabura
guilty	oine omushango
guy	omunaha
guys	abajo
gym	ahokwombekera omubiri
habit	omuze
habitat	obutuuro
had	akaba
hail	okuruga
hair	eishokye
half	ekicweka
hall	omwanya gokuteraniramu
hand	omukono
handle	kukwata
handsome	okubonera
hang	kuhanika
hang out	okutamburamu
happen	okubaho
happened	kikabaho
happiness	okushemererwa
happy	okushemererwa
happy birthday	kurika amazarwa
happy birthday to you	amazaaribwa amarungi
happy new year	kurika omwaka
hard	kigumire
hardly	kigumire
hardly ever	tikikabagaho
harm	kuhutaza
harmful	ekyakabi
harmony	omubusingye
harsh	kuguma
harvest	okusharura
has	yaba
hate	kwanga
have	ba
have a good day	gyira eizooba rirungi
have a nice day	eizoba rirungi
have breakfast	rya kyansya
have fun	okushemererwa
have you eaten	wariire
having	okugira
hazard	ekyakabi ahamagara
haze	orwiziizi
he	omushaija
he has	aine
he is	no mushaija
head	omutwe
headache	omutwe
heal	kukira
healing	kukira
health	amagara
healthy	ebyamagara
hear	kuhurira
heard	kuhurira
heart	omutima
heat	obutagasi
heaven	eiguru
heavy	kuremera
hectic	ekirahenda
height	oburingwa
heir	omusika
heist	obushuma
held	kujira
hell	omumuriro
Hello	Haro
hello dear	haro omukundwa
hello how are you	haro oragambaki
hello how are you doing	haro, oragambaki
helmet	elemeti
help	yamba
helpful	kirayamba
hence	nahabwekyo
her	ekyomukazi
herd	eisyo ry amatungo
here	hanu
heritage	kusikira
hesitate	kweyangisa
Hey	halo
Hi	haro
hi how are you	agandi ori ota
Hi there	ori ota okwe
hidden	ekisherekirwe
hide	okushereka
hierarchy	amatembezo gobukuru
high	ahaiguru
highlight	ebya amani omubingi
hike	okuteemba akakiro
hiking	kugwa omukintu
hilarious	akamanyiso
hill	akashozi
him	ogwe
hint	kukwataho
hip	ekitumo
hips	amanyanya
hire	kupangosa
hiring	okutiiza
his	ekyo mushaija
history	ebyafayo
hit	kutera
Hmm	haa
hobby	ekyorakunda kukora
hold	kwataririmu
hold on	rindaho
hole	ekiina
holiday	ekihumuro
hollow	ekiine omwina
home	omuka
homework	omurimo gwomuka
honest	owamazima
honestly	mazima
Honey	obwoki
honor	ekitinisa
hood	enkofiira
hook	ehuuku
hop	okuguruka
hope	ndesiga
hopefully	namatsiko
hopeless	oteine matsiko
horizontal	ekikikami
horn	eihembe
horrible	ekiratiinisa
horror	ekiratinisa
horse	endogoya
hospital	eirwariro
hospitality	obufura
host	kutayayisa
hostile	omubi
hot	kirotsya
hotel	omwanya gwokuriiramu
hour	eshaaha
hours	eshaaha
house	enju
household	ekyomunju
how	bata
how about you	kandishi iwe
how are you	oragambaki
how are you doing	eragyenda eta eyokwe
how are you doing today	wasiba ota eirizoba
how are you today	ori ota erizooba
how do you do	ori ota
how is	kiri kita
how many	bingahi
how much	obwingi buta
how often	buri ryaari
how old are you	oine emiaka engahi
how was your day	eizoba byaba rita
how was your night	oriire ota
however	nambwenu
hub	oburugo
hubby	omukundwa
hug	kubumbatira
huge	kihango
human	omuntu
humble	owemicwe
humid	ekibiho
humidity	ekibeiho
hundred	igana
hungry	enjara
hunt	okuhiiga
hurricane	omuyaga
hurry	kwanguha
hurry up	rahuka
hurt	kiranyiza
husband	omwami
hustle	kukora na amaani
hut	ekitiindi
hygiene	obuyonjo
I	Nyowe
I am	nyowe
I am fine	ndi kurungi
I can	ndabasa
I can't	tinkabasa
I do	nda
I do not know	tindamanya
I do not understand	tinakyeenga
I don't	tinda
I don't know	tindamanya
I don't understand	Tinakyenga
I don't understand what you mean	tindakyenga eki wamanyisa
I don't understand you	tindakukyenga
I don’t know	tindamanya
I don’t understand	ndakyeenga
i guess	ndateekateeka
I had	nkaba nyine
I have	nyine
I have been	Mbeire ndi
I hope so	nyine amatsiko ngu nikwe
I know	ndakimanya
I like	ndakunda
I like you	ndakikunda
I love	ndakunda
I love my big brother	Ndakunda kirumuna kyangye
I love my big sister	Ndakunda kinyanyazi
I love my father	Ndakunda  taata
I love my little brother	Ndakunda murumuna wangye
I love my little sister	Ndakunda kanyanyazi
I love my mother	Ndakunda mama
I love you	Ndakukunda
I love you so much	ndakukunda munonga
I love you too	ndakukunda
I mean	ndamanyisa
I miss you	oramburaho
I miss you so much	nkusisiire munonga
I see	ndareba
I think	ndagira
I understand	nacenga
I want	ndenda
I want to see you	ndeenda kukureeba
I want you	ndakweenda
I was	nkaba
I will	ninza
I would be	Nkabeir
I'm	nyowe
I'm fine	ndigye
I'm good	ndigye
I'm here	ndi hanuya
I'm sorry	nsasira
ice	orubaare
ice cream	ayisi kurimu
idea	ekiteekateeko
ideal	ekyaburiijo
identical	amashwane
identify	kumanya
identity	okumanya
idiot	sitani
idle	oteine ki ari kukora
if	kirabasa
ignore	okureka
ill	obusasi
illegal	ekitarikirizibwa
illness	oburwaire
Ilocano	IIocano
image	ekishushani
imagine	haza nkekyo
immediate	ahonaho
immediately	ahonaho
immense	ekihango
impact	kuretera
impatient	okutagira kugumisiriza
implement	kongyesereza
import	okutasyamu
important	nikikuru
impose	okworeka amani
impossible	ekitarabasika
impress	okushemeza
impression	okusiiga ekishushani
impressive	kusikiriza
improve	kuhinduraho
improvement	okwongyeramu
in	omunda
in addition	okwongyeraho
In fact	ekyamazima
in front of	omumeisho ga
in order to	okwenda
inappropriate	ekitaretagwa
incentive	ebiratebwamu
incident	ekirabaho
include	tamu
including	okutwariramu
income	entasya
inconvenience	okuteganisa
increase	okonjeza
increased	ekyeyongyeire
incredible	ekyomutano
indeed	kweri
independent	kwetegyeka
India	Buhindi
indicate	koreka
indigenous	ekya hanu
individual	burimuntu
industry	eikorero
inevitable	niteka kubaho
infant	omwana
infection	ekirwaire
infinity	kuhika ahamuheru
inflammation	ekizimba
inflation	okuhaga
influence	kureterera ekintu
inform	okumanyisa
information	amakuru
ingredients	ebirungo
inheritance	obusika
initial	obumanyiso
initiative	obujunanizibwa
injured	okuhutara
injury	obuhuta
innocent	amazima
innovation	okujumbura
inquiry	okubuza
insane	obugwiraro
insect	entondo
insecure	kubua obwerinzi
insert	okutasyamu
inside	omunda
insight	kumanya
insist	okuremeraho
insomnia	okutabuka omutwe
inspiration	okutamau amani
inspire	okutamu omuhimbo
install	okubyara
instance	ekyokureberaho
instant	ekyahonaho
instead	ningashi
instead of	omumwanya gwa
instructions	ebiragyenderwaho
instrument	ekikwato
insult	okujuma
insurance	inshuwarensi
intact	ekikwateine
integrity	ekitinisa
intellectual	ekyamagyezi
intelligence	amagyezi
intelligent	obwengye
intend	okwenda
intended	ekigyendereire
intense	kuba na
intention	ekigyendererwa
interact	okuhinganisa ebiteisyo
interaction	okugamba hamwe
interest	okwetenga
interested	kwenda
interesting	kirashemeza
interfere	okutamba eikono
intermediate	ekya rwagati
internal	eky omunda
international	eky ensi yoona
internship	okwegyera ahandijo muntu
interpret	okuteganiisa
interpreter	omuvunuuzi
interrupt	okuteganisa
interview	kugyezesebwa
intimate	ekiri heihi
into	omuri
introduce	kwegambaho
introduction	kwanjura
introvert	okutejumbira
intuition	obwonko
invalid	ekitaine makuru
invent	okujumbura
inventory	okujumbura
invest	okutamu
investigate	okuchondooza
invitation	okwetwa
invite	kurarika
invoice	obutumwa
involve	kwenjumbira
involved	kubamu
iron	amabati
is	hati
island	ekizinga
isolated	okwahurwa
issue	enshonga
issues	enshonga
it	ki
it is	eki ni
it was	kikaba kiri
it's	kiri
it's ok	tikiine nshonga
It's okay	kiri gye
item	ekintu
items	ebintu by amaguzi
its	kiri
I’m	ndi
jacket	egyaketi
jail	ekihome
jail	okuta omukihome
January	okwezi kwokubanza
jar	ejaaga
jaw	enjino
jealous	eitima
jerk	omushema
jewelry	ebyokwehundisa
job	omurimo
jogging	okwiruka
join	kwegeita
joint	ekya hamwe
joke	omuzanazano
journalist	omunyamakuru
journey	orugyendo
joy	amashemerwa
judge	kusharamu
juice	omubisi
july	okwezi kwa mushanju
jump	guruka
jump	okuguruka
june	okwezi kwa mukaaga
junk	ebisingo
just	kare
just do it	kikore kusha
justice	oburainganiza
justify	okushoborora
Kalaallisut	Kalaallisut
keen	kuzora amaisho
keep	kuma
keep it up	gumiza aho
kept	kirabiikwa
kept	kikabiikwa
kettle	ebinika
key	ekishumuruzo
kick	okuteera
kid	omwana
kidding	okuzaana
kidney	ensigo
kids	abaana
Kiga	Kiga
kill	okwita
kind	omuringo
kinda	omuringo gwa
kindly	nakushaba
kindness	okufayo
king	omukama
kiss	okunyweggyera
kitchen	ekiyungwe
kite	omukya
kitten	akana ka kapa
knee	okuju
knew	kikamanya
knife	omusyo
knight	omuhereza
know	ndamanya
knowledge	obwengye
known	okumanywa
Konkani	Konkani
Krio	Krio
label	akamanyiso
labor	obukozi
labour	obukozi
lack	okubura
ladder	amadara
lady	omukazi
laid	kikabyarwa
lake	enyanja
lamb	ekyana kye ntama
lame	ekimuga
lamp	etaara
land	eitaka
landscape	akaterero
language	orurimi
lap	ebibero
large	kihango
last	ahamuheru
last but not least	akyahamuheru
last name	eizina byamuheru
late	kucerererwa
lately	obuhweire
later	handihakye
latest	ekishembireyo
latter	ekyashembayo
laugh	sheka
laugh	okusheka
laughing	okusheka
laughter	esheko
launch	kwikiriza kutandika
laundry	ebya okwozya ebijwaro
law	ekiragiro
lawn	omwenda
lawyer	omuramuzi
lay	kurambira
layer	akashushu
layout	ekishwani
lazy	obworo
lead	kwebembera
leader	omwebembezi
leaf	eibabi
leak	okujwa
lean	kwegamira
leap	okukguruka
learn	kushoma
learning	okweega
lease	okukunganya
least	akace
leather	oruhu
leave	akahumuro
leaves	amababi
led	kwebembera
left	kurugamu
leg	okuguru
legacy	ekijutsyo
legal	ekyebiragiro
legend	abakuru
legit	ekirungi munonga
leisure	kuhumuraho
lend	kuteiza
length	oburingwa
less	kache
lesson	eishomo
let	reka
letter	abaruha
lettuce	ebimere
level	eidara
leverage	omugisha
liability	ekyobugaiga
library	eiterekyero byebitabo
lick	okurigatsya
lie	okubiha
lies	ebishuba
life	amagara
lift	kiriza
light	ekyererezi
lightning	omurabyo
like	nka
likely	kirabasika
likewise	naniwe
line	omusitaari
Lingala	Lingala
link	orutindo
lion	ekicuncu
liquid	ekya amaizi
list	orukarara
listen	hurikiza
listening	okuhurikiriza
literally	okushoma
literature	obuhandikye
litter	okunaganaga
little	kace
live	kutura
liver	ekitigu
lives	amagara
living	okutuura
living room	ahamuryango
lizard	omusilibanyi
load	okupakira
loaf	ekibumbirwe
loan	kweguza
local	byaburijo
location	omwanya
lock	enkufuru
lockdown	omukyingo
log	empimbi
lol	kusheka munonga
lonely	kubawenka
long	ekireingwa
long time no see	timperuka kukureeba
look	reeba
loop	enyindo
loose	kuferwa
lord	omukama
lose	kuferwa
loss	okufeerwa
lost	kubura ekyokusharamu
lot	byingi
loud	munonga
lounge	omwanya gwokuriramu
love	rukundo
love you	ndakukunda
lovely	kukundwa
low	kace
lower	okukyendeeza
loyal	kuhurira
loyalty	amazima
luck	omugisha
lucky	omugisha
Luganda	Luganda
luggage	omugugu
lump	omweremwa
lunch	kyamushana
lungs	ebihaha
luxury	ebyokwesehmeza
lying	okubeiha
machine	ekyoma
mad	ebyondo
madam	nyabo
made	kukora
magazine	magaziini
magnificent	ekirungi munonga
maid	omukozi omuka
main	ekikuru
maintain	gumizamu
maintenance	okureeberera
Maithili	Maithili
major	kikuru
majority	abeingi
make	kora
make up	eby okwekoraho
male	omushaija
mall	ahokugura ebintu
man	omushaija
manage	kubasa
management	akiiko
manager	kubasa
mandatory	eitekwa
manifest	okworeka
manipulate	okuhindura
manner	emicwe
manual	ekirakozesibwa omuntu
many	bingi
many many happy returns of the day	ebirungi byeizooba bingi
march	okwakashatu
margin	omusitaari
market	akatare
marriage	obushweere
married	kushwera
mask	akakokoro
mass	ekitambo kya misa
massive	ekyingyi
master	omushomesa
match	kuringaniza
mate	mutahi wawe
material	ekikozeso
math	okubara
matter	enshonga
maturity	obukuru
may	ninga
maybe	kirabasika
me	nyowe
me too	nananye
meal	ebykubya
mean	kiramanyisa
meaning	kiramanyisa
means	kumanyisa
meant	kimanyisibwe
meanwhile	tukyari hanu
measure	okupima
measures	epipimo
meat	enyama
medical	ebya amgara
medicine	omubazi
meditation	okuteekateeka
medium	ekya rwagati
meet	bugana
meeting	orukiko
Meiteilon	Meiteilon
melt	okunyeenya
memories	ebijusyo
memory	okwijuka
mental	eky omutwe
mention	kuhayo
mentioned	ekyagambwa
mentor	omuhabuzi
merchant	omushubuzi
mercy	embabazi
merely	kusha
merry christmas	nohiri enungi
mess	kushubwa
message	amakuru
messy	kuguba
metal	ekyooma
method	omuringo
mice	embeba
middle	ahagati
midnight	eitumbi
might	kirabasa
mild	batsyobatsyo
milestone	eibare
military	ekyamahe
milk	amate
million	akakade
mind	entekateka
mindset	entekateeka
mine	ekyangye
mingle	okugoya
minor	tikyamani
minute	edakiika
minutes	edakiika
miracle	ekyokutangaaza
mirror	endebegwamu
miscellaneous	ezarengamu
mischievous	ekitarasiimwa
miserable	obusasi
misery	enaku
miss	kubura
miss you	kuburwa
missing	okubura
mission	ekigyendererwa
mist	ekiho
mistake	enshobe
Mizo	Mizo
mobile	ekirahindura omwanya juba
mock	okushinyokera
model	ekyokureberaho
moderate	ekya rwagati
modern	ekyomurembe
modest	oyetweire
moist	ekijubire
moisture	omutondo
mold	oruhumbu
mole	efukuzi
mom	mama
moment	obwire
monday	orwokubanza
money	esente
monitor	okushura
monkey	enkyeende
month	omwezi
mood	embera
moody	orahinduriza juba
moon	okwezi
moral	emichwe
more	okwongyera
moreover	nekindi
morning	orire ota
mortgage	omusingo
most	namunonga
mostly	kukira munonga
mother	mama
motion	ekiganiiro
motivation	omuhimbo
mountain	omushozi
mouse	embeba
mouth	omunwa
move	kutambura
movement	okutambura
movie	akatambi
mrs	omukyara
much	kingi
mud	ebyondo
mug	ekikopo
muscle	enyama
museum	ekijukizo
mushroom	ekituzi
music	ebyeshongoro
must	eiteka
mute	okuhunmisa
mutual	kukwatana
my	owangye
My dear	munywani wangye
my friend	munywani wangye
My hovercraft is full of eels	Amato gangye gaijwire enjoka
my love	rukundo yangye
my name is	eizina ryangye
my pleasure	niinye nakira
myself	nyowe
mysterious	ekitarakyengyikwa
mystery	ekitarakyengikwa
myth	ekitaramanywa
nail	omusimaari
naive	oteine ki aramanya
name	eizina
narrative	okutebya
narrow	ekifunzire
nasty	kirasheshemura
national	ekyeihanga
nationality	oweihanga
native	omutuze
natural	ekyobuhangwa
nature	embeera
nausea	esheshemi
near	haihi
nearby	ekya heihi
nearly	haihi
neat	obuyonjo
necessary	kikuru
neck	ebitsya
necklace	nikilace
need	kwenda
negative	kibi
neglect	okureka
negotiate	okuramuza
neighbor	omutaahi
neighborhood	muriranwa
neither	ningashi
nephew	owashwenkazi
nerd	omugezi ahunami
nervous	obutini
nest	ekyashuri
net	akatimba
network	neeti waaka
neutral	oteine rubaju
never	tikikabagaho
never give up	otarihwayo
never mind	otafayo
nevermind	otafayo
nevertheless	tikace munonga
new	ekitsya
news	amakuru
next	ondijo
next to	ekikurateire
nice	kyabonera munonga
nice to meet you	nashemererwa kukurebaho
niece	muhara wangye
night	omukiro
nightmare	ekirooto kiratinisa
nine	mwenda
nineteen	ikumi na mwenda
ninety	kyenda
No	Tikirabasika
no problem	tihariho kizibu
no way	tihariho muringo
nobody	tihariho noomwe
noise	orwari
noisy	orwari
none	tikirimu
noon	shaaha mukaaga
nope	ingaha
nor	nainga
normal	ekya buriijo
north	amashuma
nose	enyindo
nostalgic	okwenda ebyarabireho
not	hapana
not at all	ngaaha
not bad	tikiri kibi
Not now	hatari hati
not yet	tikikabaire
note	ekihandiiko
noted	kyakwatwa
nothing	tikiriho
notice	ekihandiko
noticed	kikamanywa
noun	eizina byekintu
nouns	eizina
novel	ekyakabi
november	okwezi kwa ikumi nakumwe
now	hati
nowadays	ebiro ebi
nuisance	otaine mugasho
null	ekitariho
numb	kutina
number	enyuguta
nurse	omushaho
nut	omusimaari
nutmeg	okushaza omumupiira
nutrition	ebya enrya
oath	ekiragano
obesity	obugomokye
obey	kwikiriza
object	ekintu
objective	ebigyenderwaho
obligation	omurimo
obscure	ekisherekirwe
observation	okureeba
observe	kureba
obsessed	kuharara
obsession	okukunda munonga
obsolete	kyonka
obstacle	ekiratamba ikono
obtain	kuba
obtained	okatunga
obtained	kikatungwa
obvious	namazima
obviously	namazima
occasionally	mukoro
occupation	omurimo
occupied	okukwatwa
occur	okubaho
occurred	kikabaho
occurs	kirabaho
ocean	enyanja empango
october	okwezi kwikumi
odd	ekihera
odds	ebihera
of	kya
of course	nikwokwe
off	kuhumura
offensive	ekirareetera omushango
offer	omugisha
office	ofisi
official	omukuru
often	burijo
Oh	Nikwe
oh really	eeh, namazima
oil	amajuta
ok	kare
ok dear	kare omukundwa
ok honey	kare omukundwa
ok my love	kare mukundwa wangye
okay	kare
okay baby	ego omwereere
okay dear	kare mukundwa
okay honey	webare omukundwa
okay my love	webare mukundwa wangye
old	kukura
on	aha
once	omurundi gumwe
one	omwe
one language is never enough	orurimi rumwe tiruramara
onion	obutunguru
online	ekya ahamutimbagano
only	kusha
open	kugambiriraho
operation	enkora
opinion	ekiteiso
opportunities	emigisha
opportunity	omugisha
opposite	einyima
optimistic	kutekateka kirungi
option	ekyokutooranamu
optional	tikya boona
or	ningashi
orange	omuyembe
order	engyenderwaho
ordinary	ekyaburijo
organization	ekigombe
orientation	okushomesa
origin	oburugo
original	ekyokubanza
Oromo	Oromo
orphan	efuuzi
other	ekindi
otherwise	ningashi
ought	ndihamu
our	nekyeitu
Our mission: to enable everyone, everywhere to understand the world and express themselves across languages.	Ekigyendererwa kyeitu: okubasisa buri omwe, ahantu hoona kwetegyereza ensi nokweshobororaho omundimi zoona
Our mission: to organize the world's information and make it universally accessible and useful.	Ekigyendererwa kyeitu: okutebekanisa obutumwa bwensi yoona kubukora obwomugasho kandi oburahikwaho buri omwe
out	aheru
outcome	ekirarugamu
outfit	ekijwaro
outgoing	ori kurugamu
outlet	ahokushohorera
outline	hereza
outside	aheru
outstanding	omutindo
oven	ekarayi
over	aha
over there	hariya
overall	omuribyona
overcome	kuhangura
overthinking	okuteekateka munonga
overwhelmed	kyandenga
overwhelming	kyarengana
owe	kubanja
owl	ekihunyira
own	ekyawe
owner	mukama wakyo
ox	endaaho
pace	sipidi
pack	okupakira
package	ekitebekanisiibwe
paid	kushashura
pain	obusasi
paint	kusiga
painting	okusiiga erangi
pair	ebibiri
pale	kweramutare
palm	ekiganja
pan	akabanda
pandemic	ebigwererezi
panic	okutiina
pants	panti
paper	orupapura
paradise	eiguru
parallel	tibikabugana
parcel	ebahasa
pardon	okusaasira
parents	omuzaire
park	okwemereza
parrot	kasuku
parsley	pasili
part	ekichweka
participate	kwejumbira
particular	kimwe
particularly	namunonga
partner	omukundwa
party	embaga yokusibura
pass	rabaho
passage	omuhanda
passed	akaraba
passed	akahika
passion	rukundo
passionate	okugirira rukundo
passive	burabaho
password	ekufuru
past	ekyawire
patch	ekibara
path	omuhanda
pathetic	kutabagye
patience	kugumisiriza
patient	omugwaire
pattern	mutahiwangye
pause	yemereza
pavement	aharubaju rwenkuuto
pay	kushashura
payment	okushasura
peace	obusingye
peaceful	ekiine eihoreere
peach	okwikirizana
peak	akatwetwe
pear	mugyezi
peas	obushaza
peculiar	ekitari kya buriijo
pee	okusheesah
peel	okuhaata
peer	omunywani
peers	abanywani
pen	akacumu
pencil	ekaramu
pending	tikikabire
people	abantu
pepper	eshenda
perceive	okukuratira
perception	entekateka
perfect	kuhikirira
perform	kukora
performance	kukora
perhaps	nikwe kiri
period	akaire
permanent	obutweire
permission	orutsya
permit	okuha orusya
perseverance	okuremeraho
persistent	ekiragumaho
person	omuntu
personal	ekyomuntu
personality	obuntu
perspective	entekateka
persuade	kubihabiha
pervert	okushereka omubigambo
pet	omunyamukago
phase	omurundi
phenomenon	embeera
philosophy	ebya amagyezi nokuteekateeka
phone	esimu
photo	ekishushani
phrase	ekigambo
physical	kweberaho
pick	kwihaho
pick up	eiyaho
picture	ekishwana
piece	akantu
pieces	ebichweka
pig	empunu
pigeon	pijiyoni
pile	ekirundo
pile	runda
pillow	akashego
pilot	omuvugi wendegye
pin	akachumisi
pineapple	enanansi
pink	pinki
pit	ekiina
pitch	ekishayi
pity	ekyobusasi
place	omwanya
places	emyanya
plague	oburwaire
plain	erangi omwe
plan	entekateka
plane	akaterero
plant	ekimera
plants	ebimera
plate	esowani
platform	akatuuti
play	okuzana
playing	okuzaana
pleasant	kushemeza
please	mushawe
pleased	kushemeza
pleasure	ekihika
pledge	okuhiga
plenty	byingi
plot	ekibanja
plug	puraaga
plum	ekiretengwa
plumber	owebya amaizi
plural	obwingi
podcast	ekiganiiro ahari karimagyezi
poem	ebigambo
poetry	okuhandiika
point	enshonga
poison	obutwa
police	poliisi
policy	eiteka
polite	emicwe
pollution	kushisha ebyobuhangwa
pond	ekidiba
pool	puru
poop	amazi
poor	obworo
pop	okuturika
popular	kumanywa
population	orubaro
pork	enyama yempunu
porridge	obushera
port	omwaro
position	omwanya
positive	tekatekagye
possess	okugira
possession	kubanakyo
possessive	ekyoine
possible	kirabasika
post	kutaho
postpone	kwongyerayo
potato	ekitakuri
potato	ekiriibwa
potential	amani
pound	esente za buraaya
poverty	obworo
power	amani
powerful	ekyamani
practical	ekikozirwe emikono
practice	kugyezaho burijo
praise	kushaba
prank	outego mubi
pray	okushaba
precious	embabazi
precise	omubugufu
precisely	omubwangu
predict	okutebereza
prefer	kukira
preference	okukira ekindi
pregnant	oine enda
prejudice	kwegamira
premises	amaka
premium	ekirungi
preparation	okutebekanisa
prepare	kutereza
prepared	okwetebekanisa
preposition	okutebekanisa
presence	kuba oriho
present	okubaho
presentation	kuhayo
preserve	kukuma
president	omwebembezi weihanga
press	okunyiga
pressure	ekyoya
pretend	kweshwaniriza
pretty	kubonera
prevent	kwerinda
previous	bwajuba
prey	enyama
price	ebeyi
pride	omwepaanko
priest	omuburizi
primary	omusingye
prime	ekyamani munonga
princess	muhara womugabe
principal	kutahinduka
prior	ahanyimaho
priority	kikuru
prison	ekihome
privacy	ekyomuntu buntu
privacy	ekyokwehereera
private	omukihama
privilege	omugisha
prize	ekihembo
probably	ahagati
problem	ekizibu
procedure	kuratira
proceed	gumizamu
process	omuringo
produce	kushohoza
product	ekirarugamu
production	okukora
profession	omurimo
professional	obukugu
profile	ebirakwataho
profit	amagoba
profound	bwoona
progress	obusingunzi
project	purokekiti
prominent	kumanywa
promise	kuraganisa
promote	kutembesa
promotion	okukuza
prompt	kureterera
prone	ekiri omukabi ko
pronouns	ekihaniso kyeizina
pronunciation	okugamba ebigambo
proof	amazima
proper	obuteka
properly	kurungi
properties	obumanyiiso
property	ekyobugaiga
proposal	ekitenso
prospect	ekiratekatekwaho
prosperity	okugaigara
prosperous	ekyobugaiga
protect	kukuma
proud	kwesima
prove	kuhamya
provide	kuha
provided	kikahebwa
province	ekichweka
provision	okuhereza
puberty	omushogoyo
public	kyabona
pull	kukurura
pumpkin	amoozi
punctual	ahashaaha
pupil	omwegi
purchase	kugura
pure	kyenyine
purple	papo
purpose	omugasho
purse	omugasho
pursue	kukuratirira
pursuit	okukuratirira
push	kusindika
put	tamu
qualification	ebiretagwa
quality	omutindo
quantity	obwingi
quarantine	kuzibira
quarrel	okuyomba
quarter	kimwe kya kana
Quechua	Quechua
queen	omugabekazi
queer	ekiratinisa
query	ekibuuzo
question	ekibuzo
queue	akanyiriri
quick	juba
quickly	jubajuba
quiet	hunama
quilt	ekizingo
quit	okuhwaho
quite	kuhunama
quiz	ekigyezo
quotation	okukozesa ebigambo byondijo
quote	okugambwa
quotes	ebigambo by ondijo muntu
rabbit	akame
race	empaka
rage	obwingi
rain	enjura
raise	imusa
raised	ekyayimuksibwe
ran	okwiruka
random	boona
range	ahagati
rapid	ekirabaho juba
rapidly	jubajuba
rare	kiboneka omwe
rarely	tikirakira
rash	orughere
rat	kapa
rate	omuhendo
rather	ningashi
ratio	orugyeragyeraniso
rational	orabasa kuteekateeka
raw	obuto
re	okugarukamu
reach	kuhuika
reached	akahika
reaction	okuha entekateeka
read	shoma
reading	okushoma
ready	kwetereza
real	nikyo
reality	amazima
realize	kwetegyereza
realized	ekimanyirwe
really	namazima
rear	kyenyine
reason	enshonga
reasonable	ekyiine omuramwa
recall	okwijuka
receipt	akokushashuriraho
receive	kwakira
received	kwakira
recent	bwajuba
recently	bwajuba
reception	okwakiira
recipe	kugarukamu
reckless	obutafayo
recognition	okumanya
recognize	okwetegyereza
recommend	kumuhagira
recommended	ekyiragirirwe
record	ebihandiko
recover	okukyira
recovery	okukira
rectangle	ebokisi
red	kutukura
redeem	okujuna
redemption	okujuna
reduce	cendeza
redundant	oteine hi akwasiize
refer	ekyokureberaho
reference	ekyokureberaho
reflect	okworeka
reflection	ekishushani
refrain	okukwata ahari
refrigerator	efuriigi
refund	kugaruzaho
refuse	kwanga
refused	okanga
regard	kuramutsya
regarding	endamutsyo
regardless	oyihireho
regards	endamustyo
region	ekyanga
register	kwehandikisya
regret	okwefuza
regular	burijo
regularly	buriijo
reject	okwanga
relate	okushwanisa
related	kushwana
relationship	obuzare
relative	omunyabuzare
relatives	abanyabuzaare
relax	humura
release	kurekura
released	ekirekwirwe
relevant	ekiine akakwaate
reliable	okwesigwa
relief	obuyambi
relieve	okuruhuukwa
relieved	okuruhukwa
religion	edini
religious	eky ediini
reluctant	kutafayo
rely	kwesiga
remain	sigara
remaining	ekisigaire
remarkable	ekyamani
remedy	omubazi
remember	kwijuka
remind	kwijutsya
reminder	ekijusyo
remote	rimoti
remove	kwihaho
render	okuhereza
rent	kupangisa
repair	kukanika
repeat	kugarukamu
replace	kuza omumwanya gwa
reply	kugarukamu
report	kushoborara ekyabaho
represent	kujwekyera
reputation	ekitinisa
request	okushaba
require	ekiretenga
required	kiretagisa
rescue	kuyamba
research	kuchondoza
resemble	birashwana
resentment	okumarwa
reservation	okurekyereza
reserve	okubiika
resident	omuturagye
resign	okuhumura
resilience	okuremeraho
resilient	oragumisiriza embeera
resist	okuteikiriza
resistance	okwanga kutegyekwa
resolution	ensharamu
resolve	okusharamu
resort	okusharaho
resources	ebintu byokukozesa
respect	ekitinisa
respond	okugarukamu
response	engarukamu
responsibility	kikukwiseho
responsible	oshemerire
rest	kuhumuraho
rest in peace	humura omubusingye
restaurant	hoteri
restore	okugarura busya
restrict	okuzibira
result	kurugamu
results	ebyarugamu
resume	garukamu
retail	akaduka
retain	kugumana
retention	okugumya
retired	owahumwiire
retreat	okugaruka
retrieve	okucungura
return	kuhinduka
reveal	kwatura
revealed	ekyorkirwe
revenge	okuhoora enzigu
revenue	esente zokushashura
reverse	okugarura busya
review	kugarukamu
revise	okweyijusya
revision	okweyijusya
revolution	okuhinduka
reward	ekirabo
rhythm	rizimu
rib	orubaju
rice	omuceri
rich	kugaigara
rid	kikavugwa
ride	vuga
ridiculous	kwatagura
right	kihikire
right now	hatiiya
rigid	ekigumire
ring	empeta
rinse	kuboneza eishokye
riot	orutaro
rip	okusharuura
ripe	ekihaire
rise	kwimuka
risk	obuzibu
rival	omwangyi
river	omugyera
road	enkuto
roast	okukaranga
roast	okwotsya
robust	ekyamani
rock	orukiri
rod	ekikondo
role	obujunanizibwa
roll	okuzinga
roof	kushakara
room	ekishengye
root	omuzi
rope	omuguha
rotten	ekijunzire
rough	kushamba
roughly	nagyeranisa
round	omurundi
route	omuhanda
routine	ekya buriijo
row	akanyiriri
rub	sangura
rubber	akasanguzo
rubbish	ebisingo
rude	kuguma
rug	ekisimuzo
ruin	kunyiga
rule	ekiragiro
ruler	rura
rules	ebiragiro
run	okwiruka
running	okwiruka
rural	ekyaro
rush	yiruka
sack	okubinga
sacred	ekiratiinwa
sacrifice	kwehayo
safe	origye
safe flight	oguruke kuringi
safety	obusingye
sage	omugezi
said	kugamba
sail	okuvuga ahamaizi
sailing	okuvuga ahamaizi
sake	ahabwa
salary	omushara
sale	kuguza
salmon	ekyenyanja
salt	omwonyo
same	kirashwana
Same here	nahanu nikwe
sample	sampo
sand	omushenyi
Sanskrit	Sanskrit
sarcastic	oburyarya
sassy	oine omutima
sat	akasitama
satisfaction	okumarwa
satisfied	kuhaga
satisfy	okuhaazya
satisfying	ekirahazya
Saturday	orwamukaga
sausage	sosegi
savage	ebekibira
save	kubika
saw	kareba
say	gamba
scale	kubara
scam	omwata
scar	enkojo
scarce	ekirabura
scared	okutiina
scarf	sikaafu
scary	kutinisiriza
scattered	ebitataine
scene	omwanya
scenery	omwanya
scent	akahooho
schedule	poroguramu
school	eishomero
science	obyobuhangwa
scientist	omwinika nkondo
scientist	omusayansa
scientists	abeinika nkondo
scissors	makansi
scold	okukabukira
scope	kumarayo
score	okuteeba
scrap	ekikuzire
scratch	kuhara
scream	okuteera orwaari
screen	ekyoreki
screw	okunyiiza
script	ekyahandikirwe
sea	enyanja
seal	kukoma
search	kuronda
season	obwire
seat	ekitebe
second	ekyakabiri
secret	ekihama
section	ekichweka
secure	okubiika
security	ebyokwerinda
see	reba
see you	nitureebana
see you later	tureebane bwanyima
see you soon	tureebane juba
see you tomorrow	turebane nyenchakare
seed	embibo
seek	kuronda
seem	kirashwa
seems	kirarebeka
seen	kirebirwe
seize	okukwata
seizure	okukwatwa akazengyerera
seldom	tikirakira
select	toorana
select	okutoorana
self	ekyawe nkomuntu
self healing	okwekiza
selfish	kweyendeza
sell	kuguza
send	okwohereza
send me your picture	nsindikira ekishushani kyaawe
senior	omukuru
sense	ekyamakuru
sensible	ekiine amakuru
sensitive	kwecengyera
sent	kwohereza
sentence	ebigambo
sentences	sentensi
separate	kutanisa
Sepedi	Sepedi
september	okwezi kwa mwenda
sequence	kutereza
series	seri
serious	okufayo
seriously	kimanyisibwe
serve	kuhereza
service	obuhereza
session	omushomo
set	group ya babiri
set up	kutandika
setting	enkorwa
settle	kutura
seven	mushanju
seventeen	ikumi namushanju
seventy	nshanju
several	byingi
severe	kingi
sew	okubaziira
sh	sha
shade	ekichuuchu
shadow	ekichuuchu
shake	okujunguza
shall	taraza
shallow	obugufu
shame	ekirashwazana
shape	enkorwa
share	bagana
sharp	kuchaza
she	omukazi
she has	aine
she is	nomukazi
shed	ekibunda
sheep	entama
sheet	kibi
shelf	amadara omukabada
shell	ekikogosyo
shelter	enju
shield	engabo
shift	kuhindura omwanya
shine	okwaaka
ship	kutasyamu
shipping	okutambuza ahamaizi
shirt	esati
shoes	engaito
shoot	okuteeba
shop	eduuka
shopping	okugura ebintu
shore	ahamwaro
short	mugufu
shortage	okutagyira bingi
shot	okuteera eisasi
should	kishemerire
shoulder	amabega
shout	okuyomba
show	kwereka
show me	nyoreka
shower	ekinabiro
shrimp	otaine mugasho
shrink	okukyendera
shut	okukiinga
shut up	kuhunamisa
shy	okuswara
sibling	barumuna
siblings	abijukuru
sick	omugwaire
side	aharubaju
sigh	okwitsya
sight	okureba
sightseeing	okureeba
sign	akamanyiiso
signature	omukono
significant	kikuru
silence	okuhunama
silent	okuhunama
silk	siruki
silly	busha
silver	ezaabu
similar	kushwana
simp	ekyanguhi
simple	kyanguhi
simultaneously	bwingi gumwe
since	kwiha
sincere	amazima
sincerely	mazima
sing	okweshongora
singer	omweshongozi
single	omuhuru
sink	haringwa
Sir	sebo
sister	munyanyazi
sister in law	muramukazi
sit	kusitama
site	omwanya
situation	embeera
six	mukaaga
sixteen	ikumi namukaaga
sixty	nkaaga
size	obuhango
skill	obukugu
skills	obukugu
skin	omubiri
skinny	okoohire
skip	kuguruka
skirt	sikati
sky	ahaiguru
slave	omuhuuku
sleep	okubyaama
sleeping	okubyaama
sleepy	okugira oturo
sleeve	emikono yebijwaro
slice	akashate
slide	kushuma
slightly	kakye munonga
slim	okohire
slip	okuterera
slope	akashuumo
slot	omwanya
slow	mpora
slowly	mpora
small	kace
smart	obuyonjo
smell	ekinuko
smile	kushekaho
smoke	omwiika
smooth	kuterera
snack	obwokurya bwanguhi
snail	ekinyangongoori
snake	enjoka
snap	ekishwani
snow	orubare
so	mbwenu
so cute	oboneire munonga
so far	hati
soak	okutumbika
soap	esabuuni
sober	okugyira omutwe gutebekeine
soccer	omupiira
social	ekya abantu
society	ekyanga
socks	sokisi
soft	kworoba
software	ekyomu karimagyezi
soil	eitaka
sold	kuguzwa
sold out	okuguza
soldier	omuserukare
sole	nyamunegyere
solid	amaizi
solution	ensharamu
solve	kumaraho
some	nka
somebody	omuntu
somehow	hakiri
someone	omuntuwena
something	ekintu
sometimes	obwire obwingi
song	ekyeshongoro
soon	juba
sophisticated	kurwa kihumura
Sorani	Sorani
sore	kunyiza
sore throat	omumiro oguzimbire
sorrow	obusaasi
Sorry	Nashobya
sort	kutebenkanisa
sought	kutekateka
soul	omutima
soulmate	omwikiriza mugyenzi wawe
sound	eiraka
soup	supu
sour	omubiri
source	oburugo
south	omumashuma
space	omwanya
spam	obunyari
span	okuhinduka
Spanish	Orusipana
Spanish	Omusipana
spare	bunoha
speak	kugamba
special	ekyomutano
species	embibo
specific	kyenyine
spectacular	ekirungi munonga
speech	okugamba
speechless	okubura ebigambo
speed	juba juba
spell	kugamba enyuguta
spend	kushohoza
spent	okukozesa esente
spicy	ekirimu ebirungo
spike	eihwa
spin	kutebya
spinach	sipinakyi
spirit	omutima
spit	okuchwera
splendid	ekitinisa
split	kushatura
spoil	kushisha
spoiled	ekisisikaire
spontaneous	ekyeretsire
spoon	ekigyiiko
spot	ahaba ekintu
spouse	omukundwa
spread	kujajanza
spring	omudimo
square	kwingana eshonda
squeeze	okunyiga
squid	engara
squirrel	katwara mafuuni
st	sha
stab	okuchumita
stable	ekitarahinduka
stack	ekirundo
stack	runda
staff	omukozi mutahiwawe
stage	itembero
stain	okugubisya
stairs	obutembezo
stake	enkiingi
stake	ekyasibwaho omukuteeza ampaka
stalk	engiingo
stall	omudaara
stamp	okuribata
stand	kwemerera
standard	ekihikire
star	enyonyoozi
start	tandika
started	kikatandika
started	kyatandika
starving	okwitwa enjara
state	embera yekintu
statement	ekigambo
station	omwanya
statue	ekibumbe
status	okoyemerire
stay	kutura
stay safe	guma nobusingye
steady	burindara
steak	okuteeka
steal	okwiba
steam	ekyoya
steel	ekyooma
steep	ekitembire munonga
stem	engyiingo
step	eidara
stick	omunyafu
stiff	ekigumire
still	nahati
sting	oruviiri
stingy	otaraha ebyeye
stir	okuvuruga
stock	kubika
stolen	ekibibwe
stomach	enda
stone	eibare
stood	akeemerera
stool	ekitebe
stop	yemerera
storage	eibikiro
store	ekitara
storm	ekingonzi
story	ekiganiiro
stove	esigiri
straight	mpaka
straightforward	otarashereka
strain	obusasi
strange	ekitari kya buriijo
stranger	omuhinguzi
strategy	ekitairweho kwana ebijuma
straw	akashekye
strawberry	enkyereere
streak	ekiragumizamu
stream	ekibina
street	enkuto omururembo
strength	amani
stress	obutabagye
stretch	okuregura
strict	kuba ahashonga
strike	kwesharinga
string	kurega
strip	omunyarara
strive	okutoba
stroke	ninga shi
strong	amaani
struck	okuterwa
structure	ekyombeko
struggle	kugwana
struggling	okukazana
stubborn	kumanyisa
stuck	kubura ekyokusharamu
student	omwegi
study	shoma
studying	okweega
stuff	ebintu
stunning	kirashamaza
stupid	omushema
style	enkorwa yekintu
subject	eishomo
submission	okuhayo
submit	yohereza
substance	ekirungo
substitute	okuhinganisa
subtle	kuzibira
succeed	okusikira
success	busingunzi
successful	obuhanguzi
such	nka
such as	nka
suck	okunyunya
sudden	ahonaho
suddenly	ahanaho
suffer	kushasha
suffering	okubonabona
sufficient	kiramara
sugar	sukari
suggest	kuteisa
suggestion	ekirohozo
suit	ekoti
suitable	kishemeire
suitcase	ekikapa
sum	okugeita
summary	omubugufu
summer	ekyanda
summit	orukiiko
sun	okwezi
sunday	ahasande
sunny	omushana
sunset	ekirengabazaana
sunshine	omushana
super	ekirungi
superior	omukuru
supervisor	omuyreberezi
supper	kyakiro
supply	omuhereza
support	kuhagira
suppose	yeshwanirize
supposed	kiine kuba
sure	amazima
surface	ahaiguru
surge	kwimutsya
surgery	okushemeza
surname	eizina ryekika
surprise	ekyokutangaza
surprised	okutangaara
surrender	okuhayo
surrounding	ebitwetoroire
surveillance	okukyaaka
survey	cebera
survive	okukira
suspect	okutekatekaho
suspended	okubinga
suspicious	kwecengyera
sustain	okugumya
sustainability	okwebeisyaho
sustainable	kuturanwa
swag	swaga
swallow	kumira
swap	okuhinduriza
swear	okurahira
sweat	etuutu
sweater	eshweeta
sweep	okukondoora
sweet	kunura
sweet dreams	ebirooto birungi
sweet tooth	eriino rinuzire
sweetheart	omukundwa
swell	okuzimba
swelling	ekizimba
swim	okwooga
swimming	okwooga
swing	kwibira
switch	eipesha
swollen	ekizimbire
sword	rurara
symbol	akamanyiiso
sympathy	embabazi
symptoms	obumanyiiso
system	enkora
table	emeza
tackle	okukwata ahari
tag	akapande
tail	omukira
take	twara
take away	twara
take care	kureberera
take off	kusimbura
taken	kikatwarwa
talk	gamba
talkative	oragamba bingi
tall	muringwa
tap	kukwataho
tape	akatambi
target	kuteba
task	omurimo
taste	kucebera
tasty	ekinuzire
taught	kikashomesibwa
tea	amajani
teach	kushomesa
teacher	omushomesa
team	ekikosi
tear	kuchwa
tears	emiziga
tease	okuteganisa
technology	karimagyezi
teeth	amaino
tell	gambira
tell me	ngambira
temper	ekiniga
temperature	obutagasi
temple	ahokushabira
temporary	ekyahonaho
ten	ikumi
ten thousand	omutwaro
tenant	omupangisa
tend	kwenda
tendency	okwenda
tender	kupatana
tense	ekikwatsire
tension	akajagararo
tent	tenti
tentative	ekiriho hati
term	encuro
terms	ebigambo
terrible	ekibi munonga
terrific	ekibi munonga
territory	enhsahro
test	kugyeza
text	ekihandiiko
than	kukira
thank	webare
thank you	wakora
Thank you for your patience while we investigate shipment	Webare kugumisiriza bwanyima turachondoza ebyemishuburu
thank you so much	webare munonga
thank you very much	webare munonga
thanks	webare
Thanks for using our app	Webare kukozesa apu yeitu
that	kiri
that is	nikyo
that's good	ekyo nikirungi
the	e
theft	obushuma
their	ekyabo
them	bari
theme	omuramwa
themselves	bo nkabo
then	waheza
theory	ekirikirizibwa
there	hari
there are	hariyo
there is	hariho na
therefore	nabwekyo
these	ebi
they	bari
they are	bari
thick	kace
thief	omushuma
thigh	ekibero
thin	kakye
thing	ekintu
things	ebintu
think	kutekateka
third	ekya kashatu
thirsty	eiriho
thirteen	ikumi neishatu
thirty	makuma ashatu
this	eki
this is	eki ni
thorough	kuraba
thoroughly	kurungi munonga
those	abo
though	nobworabe
thought	ekitekateko
thoughtful	obutekateekyi
thoughts	ebiteekateeko
thousand	rukumi
thread	akagoye
threat	kutinisa
threaten	okutinisa
three	eishatu
threshold	entandikiro
thrilled	okushemererwa
thrive	kukuragye
throat	omumiro
through	omuri
throughout	hona
throw	okurekyera
thumb	ahakyaara kisheija
thunder	enkuba
Thursday	orwakana
thus	nikyo
tick	kyebera
tick	akakyebezo
tide	ekingoonzi
tidy	kutebekana
tie	kukoma
tiger	emondo
tight	ekikwatsire
Tigrinya	Tigrinya
time	obwire
timid	otareyesiga
tiny	kace
tip	obuhabuzi
tips	obukoryo
tire	okuruha
tired	kuruha
tissue	ekibabi
title	eizina
to	ahari
to be	okuba
toast	okunywamu
today	eirizoba
toddler	omwereere
toes	ebyaara
together	twena
toilet	kamina
told	kikagambwa
tolerance	okugumisiriza
tolerate	okugumisiriza
tomato	enyanya
tomorrow	nyentsyankare
tongue	orurimi
tonight	ekiro ekyi
too	kiri
took	kutwara
tool	ekikwato
tools	ebikwato
tooth	eriino
top	ahaiguru
topic	omuramwa
torn	kikachwebwa
torture	okuturugunya
total	omugaite
touch	kukwata
tough	kigumire
tour	orurambura
toward	ahari
towards	haihi
towel	etahuro
town	orurembo
toxic	ekiine obutwa
trace	okubona
track	akyeshongoro
trade	orushuburo
tradition	omugyenzo
traditional	ebyobuhangwa
traffic	ebyiruka
trail	okukuratira
train	kushongora
training	kutendeka
trait	omuchwe
traits	emichwe
transfer	kuhindura
transition	okuhinduka
translate	okuvunuura
transparent	ekirarebererwamu
transport	entambura
transportation	okushembusya
trap	omutego
trash	oburofa
trauma	ekikangabwa
travel	kutambura
tray	etureeyi
treasure	kukiha ekitinisa
treat	okutambira
treatment	obujanjabi
tree	omuti
tremendous	ekyamani
trend	empinduka
trial	kugyezaho
trick	omutego
tried	kugyezaho
trigger	kuhaga
trim	okushara
trip	kutayaya
trouble	obuzibu
trousers	empare
truck	ekimotoka
TRUE	amazima
trunk	empimbi
trust	kwesiga
truth	amazima
try	gyezaho
Tsonga	Tsonga
tube	tyubu
Tuesday	orwakabiri
tuition	fiizi
turkey	senkoko
turmeric	tamariki
turn	kuhinduka
turtle	akanyankogote
tutor	omushomesa
twelve	ikumi neibiri
twenty	makumi abiri
twenty-one	abiri nemwe
Twi	Twi
twice	kabiri
twist	okuhinyoora
two	ibiri
type	omuringo
typical	kyenyini
ugly	mubi
ultimate	ekyahamuheru
umbrella	manvuuri
unable	tikikabaasa
unable	tarabaasa
uncle	shwento
unconscious	omutwe gutatebekeine
under	ahansi
underneath	ahansi ya
underrated	otiine ekitiniisa eki ashemereire
understand	kucenga
understood	kyakyengikwa
unfortunately	ekyomugisha mubi
uniform	yunifoomu
unique	kireshwa
unit	akabundi
university	itendekyero rya ahaiguru
unknown	ekitaramanywa
unless	shana
until	kuhistya
unusual	tikyaburijo
up	ahaiguru
up to you	ahariiwe
update	bustya
upgrade	okwongyera omutindo
upon	kiri ahariwe
upset	okunyiga
urban	orurembo
urge	kuteisa
urgent	kwentengwa
us	itwe
use	kwejunisa
used	kukozesebwa
useful	ekyomugasho
useless	ekitaine mugasho
usual	ekya buriijo
usually	nkaburijo
utility	ekyomugasho
vacation	ekihumuro
vaccination	okugyemesa
vaccine	omubazi
vacuum	omwanya
vague	tikishoborokire
valid	kukora
valley	oruhanga
valuable	ekyomuhendo
value	ekyobuguzi
variety	byingi
various	byingi
vary	okuhinduka
vase	ekyokutamu ebimuri
vast	kihango
vegetable	emboga
vegetables	emboga
vehicle	ekiruka
vendor	omushubuzi wa ahamuhanda
venom	obushegu
venture	okubanda
venue	omwanya
verify	okuhamya
versatile	ekirahinduka
version	omuringo
vertical	ekyemereire
very	munonga
very good	kyabonera munonga
vessel	omuhanda
via	kuraba
vibe	kukyamura
vibes	muraro
vicious	omuze mubi
victim	ohikirweho
video	akatambi
view	kureba
village	ekyaro
villain	omushema
vinegar	amarwa
vintage	omusiri gwemizabibu
violence	oruyombo
violent	ekirayomba
viral	ekijanjaire
virgin	oshugaine
virtual	tikyamazima
virtue	ahabwa
vision	okuhweza
visit	kutayaya
visual	ekirareebwa
vital	kikuru
vivid	ekirakyengikwa
vocabulary	ebigambo
voice	eiraka
void	kureka
volume	kongyeza
volunteer	okwehayo kuyamba
vomit	okutanaka
vulnerable	okurwara
wage	omushara
wages	emishaara
waist	omunyugunyu
wait	rindamu
waiter	omuhereza
waiting	okurinda
wake	okwimuka
wake up	imuka
walk	tambura
walking	okutambura
wall	ekisika
wallet	ekashaho kesente
wander	okuzereera
wanna	ndenda
want	nenda
wanted	nandenda
war	orutaro
wardrobe	akeshengye ke emyenda
warehouse	esitooha
warm	ekirostya
warn	okurabura
warning	okurabura
warrior	omurwani
was	akaba
wash	okwozya
waste	kushisha
watch	eshaha
water	amaizi
watermelon	wotameroni
wave	kuhubiraho
way	omuringo
we	itwe
we are	turi
we can	turabaasa
weak	kubura amani
weakness	amani makye
wealth	obugaiga
wealthy	obugaiga
wear	kujwara
wearing	okujwara
weather	kujerenisa
wedding	okubgara
Wednesday	orwakashatu
weed	omwata
week	esande
weekend	wikendi
weight	kuremera
weird	kyantinisa
welcome	kurikayo
welfare	ebya okubaho
Well	kurungi
well done	wakora gye
went	kugyenda
were	bakaba
west	burengyebwaizoba
wet	kufuka
whale	ekyenyanja
what	ngu ekiki
what about you	kandi eki
what are you doing	orikukoraki
what are you doing now	orikukoraki eshaha egi
what are you doing right now	ori kukorakyi hati
what do you do	orakoraki
what do you do for a living	orakoraki kubaho
what do you mean	oramanyisa ki
what do you want	orendaki
what happened	hakabahoki
what is	nkiki ekyo
what is this	eki nenki
what is your job	omurimo gwaawe niguha
what is your name	eizina ryawe ni riha
what's up	hariho ki
what's your name	eizina ryawe ori oha
whatever	ekirabe
wheat	engano
wheel	omupiira
when	ryari
whenever	buri kaire
where	nkahi
where are you	orinkahi
where are you from	oraruga nkahi
where are you now	orinkahi
where do you live	oratura nkahi
where is	kiri nkahe
whereas	nobukirabe
whether	embera yeizoba
which	kihiha
while	oragyezaho nekindi
whisper	okuhwehura
whistle	okucuuriza
white	mutare
who	oha
who are you	oryoha
who is	nooha
who is this	ogu nooha
whole	kyona
whom	oha
whose	ekyoha
why	aha bwaki
why not	ahabwenki ngaaha
wicked	obwamaraya
wide	kihango
widow	efaakazi
width	oburingwa
wife	omukazi
wild	enyamaishwa
will	tu
willing	kwekundira
win	kuhangura
wind	omuyaga
window	edirisa
windy	omuyaga
wine	amarwa
winter	omunjura
wipe	okuragazya
wire	waya
wisdom	obwengye
wise	amagezi
wish	kwendeza
wish you all the best	ndakwendeza ebirungyi
witch	omurogi
with	nana
withdraw	kurekura
withdrawal	okwihayo
within	omumwanya omwe
without	hatariho
witness	karebi
witty	omugezi
wolf	omushega
woman	omukazi
women	omukazi
won	kikasingugwa
won't	tikireije
wonder	tangaza
wonderful	ekirungi munonga
wood	orubaho
wool	wuru
word	ekigambo
words	ebigambo
work	kora
work out	okukora
working	okukora
world	ekigambo
worm	akakooko
worn	ekirajwarwa
worried	kutina
worry	okutina
worse	kubi
worship	okuramya
worst	ekibi munonga
worth	kwingana
worth it	ekishemereire
worthy	ekishemereire
would	nandenda
wound	ekironda
Wow	kyabagye
wrap	kushweka
wrath	ekiniga
wrist	ahagati ya magufa
write	handika
Write here	Handiika hanu
writing	okuhandiiki
written	ekihandikirwe
wrong	kigwiire
wrote	akahandiika
yard	yaadi
yawn	okweyayamura
Yeah	Ego
year	omwaka
years	emyaaka
yeast	ekitumbisa
yell	okukankama
yellow	kyenju
Yes	Yego
yes baby	ego omwereere
yes dear	ego omukundwa
yes honey	ego omukundwa
yes my love	ego nkunzi yangye
yes of course	ego nikwe
yesterday	nyomwebazo
yet	juba
yield	kusharura
you	iwe
you are	ori
you are beautiful	oboneire
you are so beautiful	oranyirira
you are welcome	kurikayo
you can	orabasa
You know	oramanya
you too	naniwe
you're welcome	nakwakira
young	muto
your	nekyawe
your welcome	twakushemererwa
yourself	iwe
youth	omunyeeto
you’re welcome	twakwakiira
yummy	ekinuzire
zero	busha
