a	kele
a little	dɔɔni dɔrɔn
a lot	caman
a lot of	caaman
abandon	toyi
abandon	bila
abandoned	bilara
abandoned	kunbilara
abide	ka bato
ability	sekoya
able	be se
about	kan
above	a bɛɛ kan
abroad	jamana wɛrɛ
absence	dayan
absent	a tɛ yen
absolutely	jaati
absolutely	faasi
absorb	ka kunu
abstract	hakililafɛn
absurd	kuntanya
abundance	caman
abundant	tabarikala
abuse	nɛnɛ
accent	fɔcogo
accept	sɔn
access	be sɔrɔ
accident	sirakankasara
accommodation	jabagala
accommodation	siyɔrɔ
accomplish	dafa
accomplished	kɛlen
according	ka kɛɲa ni . ye
according	ɲumana
account	jati
accuracy	faranfasiya
accurate	lakika
accused	jalakibaa
ache	farifaga
achieve	dafa
achievement	ɲasɔrɔli
acknowledge	lɔnniya
acquaintance	lɔnmɔgɔ
acquire	bi . bolo
acquired	sɔrɔla
acquisition	tali
across	banabiri
act	wale
act	kɛwale
action	koo
action	kɛwale
active	kisɛman
activities	baaraw
activity	kèta
actor	walekɛla
actual	sisan
actually	tiɲɛ na
acute	selekenin
adapt	ka bɛrɛbɛn
add	fara
addicted	dɔrɔgutala
addition	kafoli
additional	farankan
address	kuma
address	ladɛrɛsi
adequate	lɛgɛsɛ
adequate	leru
adjacent	kɛrɛ fɛ
adjective	mankutu
adjust	dakɛɲɛ
admire	tigɛrɛ fɔ
admit	sɔn
adopt	ka yamararuya
adorable	cegu
advance	avansi
advanced	min bɛ ɲɛ fɛ
advantage	nafa
adventure	tunga
adventure	taama
adverb	sɛmɛntiyalan
advertisement	gansilisɛbɛ
advertising	gansili
advertising	jɛsɛnli
advice	ladili
advice	kumagwɛlɛya
advise	ka laadi
advocate	awoka
aesthetic	dako
affair	kunko
affect	yɛlɛ
affection	kanu
afford	se
affordable	daduman
afraid	tɔlɛ
afraid	sran
after	kɔfɛ
afternoon	wula
afterwards	tɛmɛnen ko
again	tuguni
again	tugu
against	kunna
against	kanma
age	si
age	sii
agency	baarabolo
agent	walekɛla
aggressive	kologwɛlɛn
agile	fɛgɛman
ago	a bɛ wagati bɔ
agree	kanbɛn
agreement	bɛnkan
agriculture	sɛnɛ
ahead	ɲafɛla
aid	dɛmɛ
aim	dasigi
air	fɔɲɔ
air	fiɲɛ
airport	awiyɔnso
aisle	egilisi
alarm	hakilijigifɛn
alcohol	alikɔli
alcohol	dɔlɔ
alcohol	dɔrɔ
alert	lasɔmini
alive	nima
alive	ninama
all	bɛɛ
all right	ayiwa
all the best	Ala ka duba i ye
allow	dabɔ
allowed	dagalen
almost	ɲini
almost	ka ban
alone	kelen
along	lɔfɛ
already	kelen
already	ka ban
already	fɔlɔ
Alright	Ayiwa
also	fana
also	do
alternative	bɔda wɛrɛ
alternative	fɛɛrɛ wɛrɛ
although	hali ni
always	tuma bɛɛ
always	waati bɛɛ
always	tuma o tuma
am	n bi
am	nne be
amazing	kabakoman
ambiguous	ɲagamilen
ambition	tɔgɔɲini
ambitious	kankɔrɔbɔ tigi
amend	ka amande
amid	caman cɛ
among	cɛmancɛ
among us	an cɛmancɛ
amount	daman
amusing	ɲɛnajɛlan
an	dö
analysis	sɛgɛsɛgɛli
ancestors	bɛmaw
anchor	ka siri
ancient	kɔrɔ
and	ni
and	ani
and	wa
and you	ele don
angel	mɛlɛkɛ
anger	dimi
angle	skele
angry	dimi
animal	bigan
ankle	senkuru
anniversary	sankunbɛn
anniversary	lonkunbɛn
announcement	kunnafoli
announcement	kunnafoni
annoy	ka tɔɔrɔ
annoyed	tɔɔrɔlen
annoying	ɲanafin
annual	san o san fɛn
anonymous	dogolen
another	wɛrɛ
answer	jaabili
anticipate	ka kɔn
anxiety	gamanagwan
anxious	kɔnɔgwan
any	papaga
anymore	tɛ bilen
anyone	mɔgɔo mɔgɔ
anything	fɛn o fɛn
anything	fɛn bɛɛ
anyway	tiogo tiogo
anyways	tiogo tiogo
apart	a danma
apartment	bon
apartment	so
apologize	sabari
apparent	jɛlen
apparently	min be bɔ ɲɔgɔn ma
appeal	saramaya
appear	kunbɔ
appear	falen
appearance	yecogo
appearance	ɲanaye
appeared	kunbɔra
appetite	dumuninige
apple	pɔmu
application	waleyali
application	siratagama
apply	nɔrɔ
appointment	kunbɛn yɔrɔ
appreciate	mandiya
appreciation	latanuli
approach	yeeli
appropriate	tilennin
appropriate	tas
appropriate	leru
approval	yamaruyali
approve	ka sɔn
approved	yamaruyalen
approximately	i n'a fɔ
april	avirilikalo
arbitrary	binkani
architect	pilan bɔla
architecture	pilan bɔ
archive	sɛbɛmarayɔrɔ
are	be
are	bi
are you	i ye
are you busy	i tɛgɛ degunnen don wa
are you married	i furunin lo
are you married or single	i furunin lo wa walima i ma furu ban
Are you still there?	I be yan hali bi wa?
are you there	i be yen
area	mara
argue	dalaminɛ
argument	dantigɛli
arise	ka wili
arm	kɛlɛkɛlan
arm	bolokala
army	sɔrɔdasiya
army	jamana ka kɛlɛkɛdenkulu
around	dafɛ
arrange	labɛn
arrange	dilan
arrange	babaara
arrangement	ɲɛnabɔli
arrival	nali
arrive	se
arrived	sera
arrogant	siritigɛnin
arrow	biɲɛkisɛ
art	seko
article	kumabolo
article	tɔgɔdɛmɛnan
article	minɛn
artificial	fɛn dilannen
artist	jadilanna
as	i ko
as	i n'a fɔ
as	komi
as long as	janko
as well	ani fana
as well as	ani fana
ash	buguri
ashamed	maloyalen
ask	ɲininga
asked	ɲininkala
asleep	ka sunɔgɔ
aspect	sawura
Assamese	Asamikan
assault	binkani
assembly	asambile
assertive	ka fɔ
assess	sɛgɛsɛgɛ
assessment	sɛgɛsɛgɛli
asset	sekoya
assets	kisɛ
assign	ka baara di
assignment	sekoyira
assist	ka dɛmɛ don
assistant	dɛmɛbaa
associate	baarakɛɲɔgɔn
associated	korira ne ɲɔgɔn ye
association	jɛnkulu
assume	bisigi
assumption	bisigiyali
at	na
at	fɛ
at	la
at least	fɔ
ate	tun ye dumuni kɛ
athlete	bolikɛla
attach	ka siri
attached	sirila
attachment	sirili
attack	ben
attack	ɲafɛla
attempt	tago
attempt	sifilɛ
attempt	kɔrɔbɔ
attend	talikɛ
attend	tali kɛ
attendance	senjɔli
attention	kɔlɔsili
attitude	jogo
attitude	kɛwali
attract	lasamali
attraction	weeleli
attractive	saramaya
attribute	ka ɲi
audience	kititigɛ
august	utikalo
aunt	baa
aunty	baa
authentic	tigitigi
authentic	halala
author	sɛbɛnikɛla
author	tigi
authority	ɲamɔgɔya
autumn	foonɛnɛmakɔnɔ
available	be sɔrɔ
available	be yen
available	fɛrɛ
average	cɛmancɛ
average	cɛ
avoid	kɛɲɛ
awake	ka wuli
award	kado
aware	b'a dɔn
awareness	hakililakunu
away	yɔrɔjan
awesome	kabako
awful	cɛjugu
awkward	ɲanango
awkward	tigɛlango
Aymara	Ayimarakan
baby	denbilennin
baby	denɲɛnin
baby	kɔraden
bachelor	cɛgana
back	kɔfɛ
background	lahalaya
background	sababu
bad	jugu
bag	palan
bag	sakɔsi
bag	bɔrɔ
bait	nuku nuku
bake	ka wusu
bakery	burudilanyɔrɔ
baking soda	bikarbonaadi
balance	falen
ball	balɔn
Bambara	Bambarakan
banana	barada
banana	namasa
band	bandi
bang	tan
bank	waribon
bar	dɔrɔminyɔrɔ
barely	gwansan
barely	nɔgɔman
bargain	tɛrɛmɛ
bark	jirifara
barley	ɔrji
barrier	bariyɛri
base	bazi
based	ka sinsin
basement	djukoro yoro
basic	baju
basically	jubajula
basil	basili
bastard	ɲamɔgɔden
batch	kulu
bath	ka ko
bathroom	jikoyɛrɛ
battery	tabara
battery	batiri
battle	kɛlɛ
bay	loriye
be	be
be	bi
be careful	i janto
beach	kɔgɔjida
beam	ɛryɛɔn
beans	siyɔ
bear	ususi
bear	kurutigɛ
beard	bonbosi
bearing	bi sɔminɛna
beast	bɛgɛn
beat	gusi
beautiful	cɛɲi
beautiful	ɲɛna
beautiful	ɲi
beauty	cɛɲɛ
became	kɛla
because	barisa
because	bari
because	sabu la
become	kè aye
bed	dalan
bed	li
bedroom	siso
bee	liden
beef	misi sogo
been	tun ye
beer	biyɛri
before	fɔlɔ fɔlɔ
began	daminɛna
begin	daminɛ
beginning	daminɛ
behalf	tɔgɔla
behave	ka i jogo dɔn
behavior	jogo
behaviour	jogo
behind	kɔfɛ
being	nimafɛn
belief	danaya
believe	limaniya
belly	kɔnɔbara
belong	kɛ a dɔ ye
beloved	ja nye mɔgɔ
below	duguman
belt	sentiri
bench	ban
bend	ka gɔlɔn
beneath	jukɔrɔ
beneath	jukɔrɔla
benefit	nafa
benefit	kuntɔnɔ
benefits	nafaw
beside	gɛrɛfɛ
besides	kɛrɛfɛ
besides	dafɛ
best	fisaman
best of luck	i ni kunnadiya
best regards	n b'i fora kosɔbɛ
better	fisama
better	fisa
between	cɛmancɛ
between	cɛ
beverage	minfɛnw
beyond	ka tɛmɛ
Bhojpuri	Bozpurikan
bias	gasilako b'a ra
biased	min be ni gasilako ye
bicycle	nɛgɛso
bid	ka pariye
big	belebeleba
big	ba
bike	nɛgɛso
bill	fakitiri
bill	warifuru
bind	siri
bird	kɔnɔni
bird	kɔnɔn
birthday	sanyɛlɛmasel
bit	faan
bit	kungurun
bite	cin
bitter	nunaman
black	finman
black	fin
blade	muruda
blame	jalaki
blank	lankolon
blanket	birifani
blanket	birinkan
blast	ka foronto
bleach	zawɛli ji
blend	ka ɲagamin
bless	duba
blessed	barikaman
blind	fiyentɔ
bliss	daamu
block	latɔn
block	kare
block	tɔn
blood	joli
bloom	ka filriɛri bɔ
blow	fiyɛ
blow	kunɲa
blue	bulaman
blunt	fariman
blunt	fari
board	pano
board	dubalenba
boat	kurun
boat	jikankurun
body	farigolo
boil	ka bara bara
boil	ka wuli
bold	fari
bond	ka siri
bond	ka tugu
bone	kolo
book	livuru
book	gafe
boost	ka fara a kan
booster	ɲafɛtaga tigi
boot	ka faga ka mɛnɛ
boots	sanbarakanjan
boots	donitalan
border	dansɛ
bore	forazidingɛ
bored	ɲanafin
boring	ɲanafin
born	bangera
borrow	juru ta
boss	patɔrɔn
boss	baaratigi
both	o fila bɛɛ
bother	tɔɔrɔ
bottle	buteli
bottom	duguma ta
bought	sannan
bounce	ka pan pan
bound	sirila
bound	sirila ni ɲɔgɔn
boundaries	danfaraw
bow	wugu
bow	kala
bowl	bɔli
box	buwati
boy	dencɛ
boyfriend	tericɛ
bracelet	bololanɛgɛ
brain	kunsɛmɛ
brain	kunkolondɛgɛn
branch	bolofara
branch	yiribolo
brand	mariki
brave	jabɔbali
brave	farati
breach	ka kari
bread	buru
break	pɛrɛn
break	kari
break	tigɛ
breakfast	daraka
breast	siin
breath	dakasa
breath	fiɲɛ
breathe	ninakili
breed	mara
brick	tufa
bride	kɔɲɔmuso
bridge	pɔɔn
bridge	babili
brief	surun
bright	pelepele
bright	wɛlɛwɛlɛ
brilliant	briyan
brilliant	ka ɲɛ
bring	lana
bring	na ni.ye
bro	balimakɛ
broad	siyaman
broadcast	ganseli
broadcast	jɛsɛnli
broke	kari
broken	karila
broom	furalan
brother	faden
brother	woloɲɔgɔn
brother	balimancɛ
brother in law	burancɛ
brought	nana ni . ye
brown	bilen
brush	kunko
bucket	palan
buddy	jɛɲɔgɔn
buddy	go
budget	baarakɛnafolo
bug	dagabali
bug	dabi
build	lɔ
building	soba
built	jɔlen
bulk	a bèè ladjèle
bull	ntura
bully	jatigɛwalekɛla
bump	junkun
bunch	caman
bundle	fɔrifɛ
burden	kunnadoni
buried	su don
burn	tada
burn	jeni
burn	mana
burst	poyi
bury	ka sutura
bus	kaare
bush	kungo
business	sannifeere
business	mako
business	jagobaara
bust	suun
busy	magwan
but	nga
but	jaa
butter	naare
butterfly	nfirinfirinin
button	butɔn
buy	san
by	ma
by	fɛ
by the way	o tuma na
bye	k'an bɛn
cabbage	supompe
cabinet	kabine
cage	ka datugu
cake	gato
calf	misiden
call	weele
call me	ne wele
called	tun weelela
calm	dusufaga
came	tun nana
campaign	kanpaɲi
can	be se
can	bi se
can't	ti se
can't	te se
Cancel	weleku
cancer	kansɛri
capable	sebaga
capable	bi se
capacity	see
capital	faaba
capital	jamana faaba
capital	baarakɛnafolo
caption	minɛni
capture	ka minɛ
car	vatiri
career	baara
careful	bololandi
careful	janto
carefully	nɛmɛnɛmɛ
careless	hamibali
caring	hami
carpenter	jiridɛsɛ
carpet	tapi
carrot	karɔti
carry	ta
carry on	ka kɛ
carry out	ka kɛ
case	ko
cash	nafolomugu
cast	seri
castle	so belebele
casual	misɛnin
cat	jakuma
catch	mina
category	suguya
cattle	misiw
cattle	bɛgɛn
caught	minɛna
cause	dalilu
cause	bila
caution	jantoyɛrɛla
cautious	jasigi
cave	kuluwo
cease	ka dabila
ceiling	plafɔn
celebrate	ɲɛnɛgɛ
cell	selili
center	santiri
century	sankɛmɛ
cereal	suman
ceremony	ɲɛnajɛ
certain	dɔ
certainly	hatɛ
certificate	dipilomu
chain	jɔlɔkɔ
chair	sigilan
chair	sɛsi
challenge	kankɔrɔbɔ
chance	latigɛ
chance	kuntere
change	bayɛlɛma
change	yɛlɛma
change	falen
chaos	fisafasa
character	sɛbɛden
character	jogo
character	kokɛla
characteristics	kɛcogow
charge	nɔɔ minɛ
charge	sendonni
charge	jalaki
charity	sarakafɛn
charming	cɛɲi
chart	sɛbɛn
chase	gwɛn
chat	ka masala
cheap	diman
cheat	ka namara
cheating	namarali
check	sɛgɛsɛgɛ
check	sɛki
cheek	dafuruku
cheer	i ni baara
cheerful	nisɔndiya
cheers	gintan
cheers	ɲagali
cheese	foromazi
chemistry	furafeereyɔrɔ
cherish	ka buruɛrɛ
chess	damu
chest	disi
chew	ɲimi
chicken	sisɛ
chief	dugutigi
chief	kuntigi
child	denmisɛn
childhood	denmisɛnya
children	demisɛnw
chill	tɔn
chill	kɛnɛman
chill	suman
chimneys	sisibɔyɔrɔ
chin	dakun
chocolate	sokola
choice	sugandili
choose	sugandi
chop	ka ci
chores	diyagoyabaaraw
chubby	dafrouba
church	alabatoso
church	eglisi
cinnamon	kanɛli
circle	koori
circle	kooricinan
circle	sɛrɛkili
circumstances	lahalaya
circumstances	sababuw
citizen	jamanaden
citizen	fasoden
city	duguba
claim	ɲininga
clarify	fɔ ka yira
class	kalanbonw
clay	bɔgɔ
clean	pelepele
clean	saani
clear	pelepele
clerk	pilantɔn
clever	cegu
client	sannikɛla
cliff	kulu
climate	nɛɛmayafɛnw
climb	yɛlɛ
clingy	nɔrɔnan
clock	mɔnturu
close	a tugu
closet	alimɔri
cloth	fini
clothes	faninw
clothes	fininw
cloud	kabanɔgɔ
cloudy	kabafin
clown	naloma
clown	sosi
clue	ekuru
clumsy	ɲanango
clumsy	tigɛlango
cluster	jɛkulu
coach	degelikaramɔgɔ
coal	sarabon
coast	kɔgɔjida
coat	kasa
coffee	kafe
cognitive	kunkolola
coincidence	balinan
cold	nɛnɛ
cold	sumanin
cold	mura
collapse	ben
collar	kannankɔnɔ
colleague	baaraɲɔgɔn
colleagues	baarakɛɲɔgɔn
collect	dalajɛn
collect	cɛ
collection	farankan
college	kalansoba
color	ɲɛ
colorless green ideas slept furiously	miriya fiiman kölön'tan tun be ka sinögö fanga la
colour	kulɛri
colour	ɲɛ
column	kɔnɔni
comb	pɛɲi
combination	farali ɲɔgɔn kan
combine	ka faraɲɔgɔnkan
come	n'nali
come here	na yan
come on	surunya
come on	don
comfort	lafia
comfort	dususalo
comfortable	fɛrɛ
coming	nata
coming soon	sɔɔni
command	ka kɔmande
comment	ka kuma fɔ
commercial	jagofɛn
commission	ci
commit	layiru ta
commit	sarati
commitment	maminɛli
committed	layidu tara
committed	kalifara
commodity	jagofɛn
common	foroba
communicate	kumaɲɔgɔnya
communication	kunnafolidibaara
communication	kunnafonijɛnsɛ
communication	kumaɲɔgɔnya
community	jamakulu
commute	ka yɛlɛma
companion	taamaɲɔgɔn
company	bila sira
company	sosiyete
compare	suma
compare	sanga
comparison	sangali
compassion	hinɛ
compassionate	hinɛbagatɔ
compatible	min bɛ bɛn ni ɲɔgɔn ye
compete	ka ɲɔgɔndan
competent	faamuyanin
competition	ɲɔgɔndan
competitive	ɲɔgɔndanli
complain	makasi
complaint	makasi
complement	dafalan
complete	dafanin
completely	pewu
complex	kolokari
compliance	kunbɛn
complicated	gwɛlɛya
compliment	tando
comply	ka bɛn a ma
composition	kɛ fɛnw
compound	dukɛnɛ
comprehension	famuyali
comprehensive	faamuyali
compromise	ladon
compulsory	diyagoya
computer	ɔridinatɛri
concentrate	cɛsiri
concept	sen
concern	bɔ
concern	boli
concerned	sogolala
concert	kɔnsɛri
conclusion	kuma laban
concrete	betɔn
concrete	koo yɛrɛyɛrɛ
condition	waribiyako
condition	cogo
conditions	bɛnkanw
conduct	ɲaminɛ
conduct	labolisira
conduct	cogo
conference	lajɛba
confess	ka kɔnɔ fɔ
confidence	gundo
confident	lannatigiya
confirm	lasinsin
conflict	kɛlɛ
confused	maloya
confusion	ɲaamili
congrats	i ni kunnadiya
congratulation	foli bɛ kɛ
congratulations	i ni kunnadiya
congratulations	tando
conjunction	siratigɛ
connect	ka kɔnɛkite
conquer	ka minɛni
conscious	kununa
consciousness	laadirima
consent	jɛn
consent	mina
consequences	kɔlɔlɔw
conservation	marali
conservative	maralikɛla
consider	bonya
considered	bonyanan
consist	bɛ na
consistency	fasaya
consistent	dafalen
constant	basiginin
constantly	kumabɛ
constipation	kɔnɔja
construction	jɔli
consume	ka dun
consumption	dumuni kɛ cogo
contact	kɔntakti
contagious	fiɲɛbana
contain	ku
contains	ku
contemporary	bi ko
contempt	ɲigi
content	ɲagali
content	kɔnɔnata
content	hakɛ
contest	ka sɔsɔ
context	hukumu
continent	bangu
continue	taga ɲanfɛ
contract	sarati
contract	saratisɛbɛ
contrast	cɛlatigɛ
contribute	tali kɛ
contribution	bolomara
control	ka jatemɛ
controversial	lagosilen
convenience	sagoma
convenient	kè
conversation	baaro
convert	yɛlɛma
convey	yira
convince	lasɔn
convinced	gwɛya
cook	tobi
cook	tobiri kɛ
cooking	bi tobiri kɛra
cool	suma
cool	lasuma
cooperation	ɲɔgɔndɛmɛ
cooperation	tigɛdiɲɔgɔnma
cope	ka ku
copper	nɛgɛ
core	dusu
corn	kaba
corner	seleke
correct	jaati
cost	musakada
cost	sɔngɔ
costume	dreke
cottage	so fitini
cotton	kɔɔri
couch	tilebin fɛ
couch	dilan
cough	sɔgɔsɔgɔ
could	tun be se
council	ɲɔgɔnye
council	ladilikɛla kɛkulu
count	jati
counter	kɔntɛri
country	jamana
countryside	kongon
countryside	burusi
couple	filanin
courage	dusukun
courage	cɛya
course	kalan
court	surun
courtesy	ɲumanya
cousin	kanimɛ
cover	datugu
cover	datugunan
cow	misi
cow	misimuso
coward	fakari
cozy	lafiyalen
crab	turuto
crack	cida
craft	bololabaara
crap	ko kolon
crash	benni
craving	kɔngɔ
crawl	fofo
crazy	kunkolotɔ
create	dan
creative	fɛn kuraw lɔnbaga
credit	juru
creep	ka yɛlɛ
creepy	bagabalifɛn
crew	baaramɔgɔ jɛkulu
crime	sariyatiɲɛ
cringe	grikokele
crisis	gɛlɛya
criteria	sariyasenw
critical	wɛlɛman
criticism	lagosili
crop	sɛnɛ fɛnw
crops	bɔnsɔnw
cross	gwengeyiri
cross	kalanso
crow	ka kasi
crowd	ɲugu
crowd	jama
crowded	ɲugu fanin
crown	masafugula
crucial	kunbaba
crucial	kunba
cruel	kojugu
cruise	bato
crush	fokadigi
crush	bu
crush	nɔɔni
cry	kule
cucumber	kɔnkɔn
cuddle	saalo
culture	lɔnko
culture	seko ani lɔnko
cunning	kegun
cup	tasa
cupboard	aramɔri
cupboard	minanbilaminan
curb	ka kɛlɛ
cure	kɛnɛya
cure	lasiri
curfew	kuwurufe
curiosity	kiriyosite
curious	kosɛgɛsɛgɛla
curly	dayɛlɛnan
currency	wari
current	bi tile
current	woyo
currently	sisanwagati
curse	danga
curtain	irido
cushion	kunkolodalan
custom	landa
custom	sintin
customer	sannikɛla
customs	laada
cut	tigɛ
cut	lɛn
cute	dusumandi
cycle	sikili
cycling	nigɛsoboli
dad	facɛ
daddy	baba
daily	loon o loon
dairy	nɔnɔmafɛn
dam	barasi
damage	gasilako
damn	haramuya
damn	danga
damp	suma
dance	don
danger	farati
dangerous	jugu
dangerous	faratiman
dark	dibi
darling	diyanyebaga
dash	tiirinin
data	kibaruyaw
date	tile
date	waati
daughter	denmuso
day	tile
day	lon
dead	suu
deadline	dan
deaf	tulogweren
deal	mako
dear	balima
Dear All	N Balimaw
Dear Customer	N balima sannikɛla
Dear Parents	N bangebaw
Dear Sir	N balima cɛ
Dear students	N balima kalandebaw
Dear Team	N balima jɛkulu mɔgɔ
death	saya
death	suu
debate	sɔsɔli
debit	sarali
debris	ɲaman
debt	juru
decade	san tan
decay	toli
deceased	banbaatɔ
deceive	ka janfa
december	sesanburukalo
decent	wageyanin
decide	latigɛ
decided	tun latigɛra
decision	latigɛli
deck	pɔn
decline	ban
decrease	dɔgɔya
dedicated	jansara
dedication	dedikasi
deed	kɛwale
deep	dunman
deer	kolonin
default	fili
defeat	ka dɛsɛ
defend	ka lakana
define	ɲafɔ
definitely	walayi
definition	sifɔli
degree	dakun
degree	degere
delay	yakaro
delay	mɛ
delayed	a mɛna
delete	ka jɔsi
deliberate	ka lawili a kaman
delicate	fiɲɛ
delicate	ɲanamisɛn
delicious	danwu
delight	ka nisɔndiya
delighted	diyara
deliver	ka di
delivered	jiginnin
delivery	jigili
delivery	bɔli
demand	deli
demanding	tilenninya
democracy	jamajɛnfanga
democracy	demokarasi
demon	jina
demon	bilisi
demonstrate	yira
denied	a bana a ma
density	hakɛ
dentist	ɲinfurakɛla
deny	sɔsɔli kɛ
department	depariteman
departure	tagama
depend	kabɔ a la
deploy	ka yɛrɛ kɛ
deposit	tɔnɔmala
depressed	jigitigɛlɛn
depression	kunnabana
depth	dunya
describe	fɔ ka yira
describe	cogofɔ
description	cogofɔli
desert	cɛncɛnkongo
deserve	ka kan ka
design	dan
designation	welecogo
desire	kanuya
desire	nege
desk	biro
despair	jigintanya
desperate	jigitanya
despite	hali ni
dessert	dumuni kɔfɛ dumunimisɛn
destination	tagayɔrɔ
destiny	dakan
destroy	ka halaki
destruction	cɛnni
detail	kibaruya misɛn
detail	jago misɛn
details	faranfasiyaliw
detect	ka lasaa
determination	katiya
determine	pereperelatigɛ
determined	can
devastated	halakira
develop	lawɛrɛ
develop	yiriwa
developed	yiriwalen
development	yiriwali
device	baarakɛbolifɛn
device	baarakɛfɛn
devil	sitanɛ
devoted	kariyalen
Dhivehi	Divehikan
diabetes	sukarobana
diarrhea	kɔnɔboli
diary	jurunali
dictionary	daɲɛgafe
did	tun kɛra
die	sa
died	salɔ
diet	erezimu
difference	danfara
different	man kan
different	ti kelen ye
difficult	ka jugu
difficult	ka gwɛlɛ
dig	seen
dig	soni
dignity	hɔɔrɔnya
diligent	ka fɛsɛfɛsɛ
dinner	sifana
dip	ka su
direct	ka ɲɛminɛ
direction	kuntilenna
director	kuntigi
dirt	nɔgɔ
dirty	manɔgɔ
dirty	nɔgɔnin
disable	ka lajɔ
disabled	se tan
disappear	tunu
disappointed	jigitigɛbagatɔ
disaster	balawu
discard	ka fili
discharge	ka jigin
discipline	kolo
discipline	tileninya
discount	dajigi
discover	kɔrɔlɔn
discover	bɔ fɛnkura kan
discrimination	ɲɛnawoloma
discuss	baaro
discuss	kumaɲɔgɔnya
discussion	jɛkafɔ
disease	bana
diseases	banaw
diseases	jangara
disguise	ka yɛrɛ masike
disgusting	saratan
dish	daga
dish	asiɛti
dishes	tasaw
dishes	dagaw
dismiss	ka gɛn
dispatch	ka ci
display	yirali
display	yira
disposal	ka bɔ i bolo
dispute	funufunu
distance	janya
distinct	faranfasiya
distinguish	faranfasiya
distress	kamanagan
distribution	tilanni
distribution	didili
district	arɔndiseman
disturb	kunnasiri
ditch	fose dingɛ
dive	ka nɔn
diverse	sugu tchaman
diversity	sugu caaman
divide	ka tila
divine	ka sidɔn
divorce	furusa
dizzy	ɲanamini
dizzy	tiiri
do	kɛ
do	wale
do	latigɛ
do you	i bi
do you love me	i bi ne fɛ wa
doctor	dɔgɔtɔrɔ
document	sɛbɛn
does	be.kɛra
doesn't	ayi
dog	wulu
Dogri	Dogrikan
doing	kɛlra
doing	kɛla
doll	pupe
domain	donko
domestic	sokɔnɔ.+noun
dominant	fangatigi
don't	ka na kɛ
Don't worry	Kana hami
donate	ni
donate	di
done	kɛra
done	tlara
donkey	sofali
dope	dɔrɔgu ta
double	siɲɛfila
doubt	sigasiga
dough	ndoro
down	duguma
download	ka telesarize
draft	sɛbɛ
drag	ka ta ka bila
drain	sasa
drain	jii labɔ
drama	tiyatiri
draw	filaninben tiiri
draw	ci
drawer	tiriwali
drawing	desɛn
dread	siranya
dream	siko
dream	sugo
dress	fɛɛrɛbɔ
dress	dreke
drill	ka seni
drink	min
drink	minnifɛn
drive	boli
drop	toni
drop	ben
dropped	bilara
dropped	tora
drought	jaa
drunk	minnen
dry	jalan
dry	ja
duck	tɔnkɔnɔ
dude	cɛden
due	joru
due to	kama
dull	ɲanafin
dumb	ja
dump	nɔgɔyɔrɔ
duration	don hakɛ
during	kɔnɔna
dust	gwangwan
dust	buguri
duty	diyagoya
dwell	ka sigi
dying	satɔ
Dyula	Julakan
each	kelen kelen
each other	kelen kelen bɛɛ
eager	nata
eagle	sigɛn
eagle	samatasɛgɛ
ear	tulo
earlier	joona
early	joona
earn	tɔnɔ
ears	tulow
earth	dugukolo
earth	dugumakolo
earthquake	dugukoloyɛrɛyɛrɛ
ease	nɔgɔya
easily	nɔgɔman na
east	kɔrɔn
easy	nɔgɔ
easy	nɔgɔman
eat	dumuni kɛ
eating	dumuni
economic	sɔrɔsira
economy	sɔrɔ
edge	dakun
edge	da
edge	dawolo
edit	ka korize
education	ladamuni
education	kalan
effect	nɔɔ
effective	di
effective	duman
efficiency	nɔ kaɲi
efficient	di
efficient	duman
effort	dɛmɛdɛmɛ
effort	seko
egg	fan
eggplant	obɛrizini
ego	yɛrɛkanu
eight	segin
eighteen	tan ni seegi
eighty	biseegi
either	walima
elaborate	dansigi
elbow	nɔnkɔnkuru
elder	kɔrɔcɛ
elder	kɔrɔmuso
elderly	mɔgɔkɔrɔbaw
elegant	buga
element	fɛn
elephant	sama
eleven	tannikelen
eligible	mɔgɔ min o be se k'a wote
eliminate	ka bɔ
else	tugu
embarrassed	maloyara
embarrassing	maloyako
embrace	mɔmɔ
emerge	ka poyi
emerge	ka yira
emergency	kɔrɔtɔ
emotional	nisɔdiya
empathy	hinɛ
emphasis	magwan
emphasize	ka sinsin
employee	baaraden
employees	baarakɛdenw
employer	patɔrɔn
employment	baara
empty	lakolon
enable	min bi se
encounter	kunbɛn
encourage	koɲumanlɔn
encourage	lafarinya
encourage	sinsin
end	a bana
endangered	bɛ faratila
endeavor	cɛsiri
endurance	ko kuli fanga
endure	ka ku
enemy	jugu
energy	kisɛya
engage	maminɛ
engaged	maminɛ
engagement	maminɛli
engine	motɛri
engine	motɛrɛ
engineer	ladilanbaga
English	angilɛkan
enhance	fara a kan
enjoy	ɲanagwɛ
enormous	belebeleba
enough	wasa
enough	fɛrɛ
ensure	fariya
enter	don
entertainment	ɲɛnɛgɛ
enthusiasm	timinandiya
enthusiasm	diyadon
enthusiastic	jarabi
entire	bakuruma
entire	bɛɛ
entitled	min tɔgɔ ye
entity	yɔrɔ
entrance	donda
entrepreneur	sɔrɔbatigi
entrepreneur	jagokɛlaba
envelope	anwulopu
environment	sigiyɔrɔ n'a lamini
envy	nege
epic	poyi
epidemic	bama
equal	bi bɛn
equipment	minanw
equity	kelenya
equivalent	ɲɔgɔn
eraser	jɔsilikɛlan
error	fili
error	foti
escape	tila
escape	talitali
especially	jango
essay	sɛbɛn
essence	esansi
essential	kunbaba
essential	kunba
establish	lalɔ
established	julɔnnna
estate	so
estimate	fɛɛnw sɔngɔ jatiminasɛbɛ
estimate	jatiminɛ
estimate	kiimɛ
estimated	jateminɛna
etc	o ni dɔ wɛrɛnw
eternal	banbali
ethics	jogodon
ethics	ladili
evaluate	ka ewakiye
evaluation	ewaliyasiyɔn
even	hali
even	hali ni
even though	hali ni
evening	wulafɛ
event	koba
eventually	a laban na
ever	habada
every	kelen kelen
everybody	bɛɛ
everyone	mɔgɔ o mɔgɔ
everyone	bɛɛ
everything	fɛn bɛɛ
evidence	seere
evil	jugu
evolution	ɲɛtaga
evolve	ewoliye
Ewe	Ewekan
ex	kɔrɔlen
exact	o yɛrɛ
exactly	jaati
exactly	cɔ
exactly	leru
exam	isamɛn
examine	ka sɛgɛsɛgɛ
example	misaliya la
exceed	ka tɛmɛ a dan kan
excellent	fisaman
except	ka kan ka
except	kɔnɔ
exception	fɔ
excess	dantɛmɛ
excessive	dantɛmɛ
exchange	kunfalen
exchange	dakun
excited	min bi yen
excited	.lɔgɔ b'a ra
excitement	nisɔndiya
exciting	min bi yen
exclusive	kelen
excuse	hakɛ to
excuse me	hakɛto
execute	faga
execution	fagali
executive	sariyabolibolo
exercise	ɲanagwɛ kɛ
exercise	degeli
exhaust	bɔli
exhausted	sigɛn
exhibit	ka jira
exhibition	yirɛyira
exist	be yen
existence	ɲɛnamaya
existing	min bɛyen kɔrɔlen
exit	ka bɔ
expand	bonya
expect	ka kan ka
expect	kɔnɔ
expected	tun ka ka kan ka
expenses	musakaw
expensive	ka jugu
expensive	ka gwɛlɛ
experience	kɛkafilɛ
experiment	ka kɛ ka lajɛ
expert	dɔnnibaga
expired	dati bana
explain	fɔ ka yira
explain	lafaamuya
explanation	ɲɛfɔli
exploit	ka nafa bɔ
explore	yɔrɔɲini
explore	yɔrɔkurasɛgɛsɛgɛ
export	ka la bɔ
expose	ka jira
exposed	lakanabali
exposure	yirali
express	teliman
express	yira
expression	fɔcogo
extend	lawɛrɛ
extended	samanen
extension	mɔnɔbɔ
extent	ka lasama
external	kɔfɛla
extinct	ka faga
extra	farankan
extract	ka labɔ
extraordinary	dakabana
extreme	damatɛmɛ
extremely	bɛrɛbɛrɛ
eye	ɲaden
eyes	ɲadenw
fabric	finimugu
fabulous	kabakoman
face	ɲan
facilitate	nɔgɔya
facilities	baaraminanw
facility	nɔgɔya
fact	yɔrɔ
fact	nɔɔ
factor	fɛn
factory	izini
facts	yɔrɔw
facts	nɔɔw
fade	fɔsɔnfɔsɔn
fail	bali
failed	dɛsɛla
failure	ɲɛbaliya
faint	kirin
fair	fisa
fairly	fisa
fairy	nsiirin
faith	lannaya
faithful	kantigi
fake	nanbara fɛn
fall	ben
false	DAGWƐLƐYA
fame	tɔgɔ
familiar	min bɛ deli ka kɛ
family	gwaso
family	lu
family	denbaya
famine	kɔngɔba
famous	tɔgɔma
fan	fifa
fan	fiɲɛdilan
fancy	lɔgɔ
fantastic	ɲɛnamaba
far	ka jan
farewell	k'án bɛn
farm	foro
farmer	sɛnɛkɛla
fascinating	min dabaliban
fashion	mɔdɛli
fast	teliman
fat	tɔlɔ
fatal	juguman
fate	dankan
father	facɛ
fatigue	sigɛn
fault	fili
favorite	mandi
favour	barika
favourite	kɛrɛnkɛrɛnlen
fear	jawuli
fear	siranya
fear	siran
feast	fɛti
feast	dumuniba
feather	si
feature	tagamasiɲɛ
features	tagamasiɲɛw
february	feviriyekalo
fed up	fununa
fee	juru
fee	sɔngɔ
fee	wari
feed	dumu
feedback	lakali
feel	mɛn
feeling	nikanko
feeling	kɔnɔnako
feeling	farimasicɛ
feet	seenw
fell	bennan
fellow	jɛɲɔgɔn
felt	tun ye.mɛn
female	musoman
fence	laminikogo
fence	kogo
fertile	yɔrɔdiman
festival	gintanba
fetch	ka ɲini
fever	farigwan
few	dɔgɔ
fewer	dama bɔɔni
fiance	maminɛcɛ
fiction	suya
field	foro
fierce	fari
fifteen	tan ni duuru
fifty	biduuru
fight	kɛlɛ
fighting	kɛlɛ
figure	dama
figure	jatiden
figure out	ka jate
file	papiye
fill	fa
filled	falen
film	filimu
film	sinema
filthy	nɔgɔlen
finally	fin laban
finance	finansi
finance	wari
financial	wariko
find	sɔrɔ
find	masɔrɔ
find	lasɔrɔ
find out	ka sɔrɔ
fine	marahaba
finger	bolokunnaden
finger	boloden
finish	ban
finished	a bana
fire	tasuman
firm	wɛlɛ
first	fɔlɔ
first name	tɔgɔ
fish	jɛgɛ
fit	labɛn ka kɛɲɛ
five	duuru
fix	dilan
fixed	labɛnnen
flag	darapo
flash	yelen
flat	falafala
flat	panpara
flaw	fili
flawless	filibaliya
flee	boli
flesh	farisogo
flesh	bu
flesh	bugu
flew	bolila
flex	ka kuru
flexible	labilalen
flight	awiyɔn
flip	kilape
flirt	ka jala
flirting	kanuya
float	filotɛri
flood	sanjiba
floor	sangaso
flour	mugu
flow	poyi
flow	sɛɛnɛ
flower	filɛru
flu	muranisɔgɔsɔgɔ
fluent	kɔsɛbɛ
fluently	filibaliya la
fluffy	makana
fluid	ji
fly	limɔgɔ
fly	pan
focus	ɲasin
fog	bugun
foggy	bugun lon
foggy	bugun yɔrɔ
fold	ka kuru
folks	sintinw
folks	landaw
follow	tugu
follow up	fɛsɛfɛsɛ
following	nata
food	dumuni
fool	fatɔ
fool	bagan
foolish	hakilintan
foot	seen
football	ntolotan
for	ma
for	ta
For example	misaliya la
for instance	misali la
for you	i ta lo
forbidden	tana
forbidden	tanamako
force	fanga
forecast	fɔkabila
forehead	tenda
foreign	wɛrɛ
foreign	dinan
forest	batu
forest	tufin
forest	tuba
forever	abada
forget	ɲina
forgive	ka yafa
forgot	ɲinɛ
fork	furusɛti
form	cogoya
form	jogo
formal	sariyakɔnɔ
former	kɔrɔman
former	kɔrɔ
fortunately	ala barika la
fortune	nafolo
forty	binaani
forty-two	binaani ni fila
forward	ɲafɛ
forward	ɲafɛla
foster	ka jiriwa
fought	kɛlɛ
found	lasɔrɔla
foundation	jusigilan
foundation	judon
four	naani
fourteen	tan ni naani
fox	kungowulu
fragile	fiɲɛman
frame	lamini
framework	hukumu
fraud	nanbara
freak	saratan
free	hɔɔrɔn
freedom	hɔrɔnyali
freeze	galase
freeze	suma
frequency	fiɲɛturukala
frequent	ca
frequent	caaman
frequently	sɔn
fresh	kɛnɛ
friday	juma
fridge	refrijeratɛɛri
friend	teri
friendly	nɔgɔman
friends	teriw
friendship	teriya
frightened	siranin
frightening	bagabagali
frog	ntori
from	k'a ta
from	ma
front	ɲaa
frozen	fɔminin
fruit	yiriden
frustrated	jigitigɛbagatɔ
fuel	taji
fuel	manafɛn
Fulfulde	Fulakan
full	fanin
fun	tulon
function	ciya
fundamental	dugumata
funeral	sanga
funny	laugh making
fur	farijolo
furious	diminen
furniture	sokɔminanw
further	ɲɛfɛ
furthermore	ka fara o kan
furthermore	katuguni
future	sini
future	wagati nata
gain	sɔrɔ
gain	kuntɔnɔ
game	tulon
gap	furancɛ
garage	garasi
garbage	nɔgɔninya
garden	nakɔ
garlic	layi
gate	dapɔti
gate	da
gate	daba
gather	ɲɔgɔn kunbɛn
gathering	lajɛ
gauge	ka ewaliye
gave	a dila
gear	vitɛsi dolan
gender	cɛ walima muso
general	zenerali
generally	bakurubala
generate	kɛ
generation	zenerasiyɔn
generous	bololandi
genius	hakiliduman
genre	sifa
gentle	ɲuman
genuine	yɛrɛ yɛrɛ
genuine	lakiika
gesture	taamasiyɛn
get	sɔrɔ
get	latigɛ
get	lasɔrɔ
get dressed	fanin don
get up	wili
get well soon	ka kɛnɛya di
getting	sɔrɔli
ghost	ja
ghosting	sigifɛn
giant	diamdian
gift	nilifɛn
ginger	ɲamaku
girl	sunguru
girlfriend	sunguru
girlfriend	go
give	di
give up	bila
given	dilen
glad	nisɔndiya
glance	ka lajɛ
glass	vɛrɛ
glass	vitiri
glasses	nunɛti
glimpse	ka ɲɛ jɔ a la
global	fanbɛ
gloomy	dibilen
gloves	ganw
glow	jigiya
glow up	kɛnɛbɔ
glow up	yeelenyeelen
glue	kɔnli ji
go	tagama
go	taga
go	wa
go ahead	taga ɲɛfɛ
go away	wa
go to bed	ta la
goal	kuntilennan
goals	kuntilennan
goat	baa
god	ala
god bless you	Ala ka duba i ye
goes	taa
going	be tagara
going to	tara .
gold	sanu
gone	baana
gone	tara
gonna	bɛna
goo	yeelennen
good	duman
good	ɲuman
good	diman
good afternoon	i ni tile
good bye	kan bɛ
good day	ka tile hɛrɛ
good evening	i ni wula
good job	baara ɲuman lo
good looking	cɛɲi lo
good luck	garisigɛdiman
good morning	á ni sɔgɔma
good morning	i ni sɔgɔma
good morning	aw ni sɔgɔma
good morning my love	ne jarabi ni sɔgɔma
good night	ka su hɛrɛ
goodbye	k'an bɛn
goodnight	ka an bo su ra
goods	jagofɛnw
Google	gugɔli
Google Translate	Google Bayɛlɛmali
goose	kulokulodeni
gorgeous	cɛɲi
gossip	kɔrɔfɔli
got	sɔrɔla
got it	a sɔrɔla
government	guvɛrɛnɛma
grab	minɛn
grade	dakun
grade	garadi
gradually	dɔɔni dɔɔni
graduate	ka dipilomu sɔrɔ
grain	kisɛ
grant	ka yamaruya
granted	yamaruyalen
grapes	rezɛn
grasp	ka minɛ
grass	bin
grateful	ɲumanlɔnba
gratitude	waleɲumanlɔn
grave	kaburu
gray	bugurinjɛ
great	ba
greed	natabaya
greedy	nuguman
green	namugulama
greet	ka foli kɛ
greeting	foli
greetings	folikanw
grey	bugurinjɛ
grid	nɛgɛjuru
grief	dusukasi
grind	wulusi
grind	sin
grind	bunte
grip	ka nɔrɔ
grocery	dumunifɛn feereyɔrɔ
groom	furucɛ
gross	kurukara
ground	dugukolo
group	jɛkulu
grow	ci
grow	bonya
growth	jiidiya
grumpy	farifagalen
Guarani	Gwaranikan
guarantee	garanti
guard	ka kɔlɔsi
guess	silɔn
guest	lonan
guest	dinan
guidance	bɛrɛbɛrɛli
guide	ɲabila
guilty	hakɛtigi
guy	cɛ
guys	cɛdenw
gym	zimu
habit	deliko
habit	landa
habitat	so
had	tun sɔrɔla
hail	weele
hair	kunsi
half	tilan
half	tilancɛ
hall	kɔridala
hall	ali
hand	bolo
hand	tigɛ
handle	minayɔrɔ
handle	mɔmɔ
handsome	cɛɲi
handsome	sarama
handsome	ɲi
hang	ka dulon
hang out	ka bɔ ɲɔgɔfɛ
happen	ka kɛ
happened	a kɛla
happiness	daamu
happy	nisɔndiya
happy	nɛɛma
happy birthday	i ni sanyɛlɛma
happy birthday to you	I ni sanyɛlɛmaseli
happy new year	sanbɛ sanbɛ
hard	ka gwɛlɛ
hardly	gɛlɛnman
hardly ever	ma se ban
harm	furufara
harm	dimi
harmful	tɔɔrɔlan
harmony	cogo cɛɲi na
harsh	fari
harvest	sɛnɛfɛn
has	sɔrɔ
hate	mangoya
have	sɔrɔ
have	bi.fɛ
have	bi bolo
have a good day	ka tile hɛrɛ
have a nice day	ka tile hɛrɛ
have breakfast	na daraka dun
have fun	ka i ɲɛnajɛ
have you eaten	i ye dumuni kɛ wa
having	sɔrɔla
hazard	balinan
haze	bugun
he	a
he has	a ye.sɔrɔ
he is	a ye
head	kungolo
head	kun
headache	kundimi
heal	kɛnɛya
healing	kɛnɛyasɔrɔ
health	kɛnɛmanya
healthy	kɛnɛ
healthy	saniman
hear	mɛ n
heard	lamɛnnan
heart	dusu
heat	funteni
heat	tila
heat	gwaniya
heaven	sankolo la
heavy	girin
hectic	sɛgɛn
height	kundama
heir	ciɲɛtala
heir	a
heist	sonyali
held	dagara
held	dagala
hell	jahanama
hell	alatasuma
Hello	I ni tile
Hello	I ni wɔla
Hello	I ni sɔgɔma
hello dear	i ni sɔgɔma n teri
hello dear	i ni tile n teri
hello dear	i ni wula n teri
hello how are you	i ni sɔgɔma hɛɛrɛ sira wa
hello how are you	i ni tile hɛɛrɛ tile na
hello how are you	i ni wula hɛɛrɛ tile na
hello how are you doing	i bɛ di
helmet	nigɛfugulan
helmet	kasiki
help	dɛmɛ
helpful	duman
hence	fɔlɔ
hence	bɛɛ
her	ale
her	le
herd	ka gɛ
here	yan
heritage	cɛɛn
hesitate	siga
Hey	I ni tile
Hey	I ni wɔla
Hey	I ni sɔgɔma
Hi	I ni tile
Hi	I ni wɔla
Hi	I ni sɔgɔma
hi how are you	i ni tila i ka kɛnɛ wa
hi how are you	i ni wula i ka kɛnɛ wa
hi how are you	i ni sɔgɔma i ka kɛnɛ wa
Hi there	ani ca yan
hidden	dogolen
hide	sutura
hide	dogo
hierarchy	ɲɛmɔgɔya
high	janmanjan
high	gongolima
high	san
highlight	ka faranfasiya
hike	senataama
hiking	senataama
hilarious	tlonkɛla
hill	kulu
him	a ma
hint	taamasiyɛn
hip	nɔgɔyɔrɔ
hips	tɔgɔ
hire	maminɛ
hiring	tali
his	a
history	tariku
hit	gusi
Hmm	hum
hobby	donnatɛmɛ
hold	minɛ
hold	daga
hold on	ka jɔ
hole	dingɛ
holiday	seliba
hollow	wo
home	so
homework	sokɔnɔbaara
honest	kɔnɔgwɛ
honestly	sɛbɛ sɛbɛla
Honey	Li
honor	bonya
hood	kapo
hook	nugunuu
hop	ka pan pan
hope	jigiya
hope	jigi
hope	jigida
hopefully	ni ala sɔn na
hopeless	jigintanya
horizontal	dalen
horn	biɲɛ
horrible	cojugu
horror	cɛjugu
horse	so
hospital	dɔgɔtɔrɔso
hospitality	jatigiya
hospitality	jabagaya
host	jabaga
host	ja
host	jatigi
hostile	juguya
hot	gwannin
hot	funteniman
hot	bagibagi
hotel	lotɛli
hotel	dunanjigiyɔrɔ
hotel	dunanjigiso
hour	lɛri
hours	lɛri
house	lu
house	bon
household	somɔgɔw
how	cogoya juman
how	cogo di
how	cogo juman
how about you	i yɛrɛ dun
how are you	Hɛɛrɛ tilenan
how are you	hɛɛrɛ sira wa
how are you doing	i ka kɛnɛ wa
how are you doing	hɛrɛ be wa
how are you doing today	I be di bi?
how are you doing today	I fari be di bi?
how are you today	i ka kɛnɛ bi wa
how are you today	i fari be di bi
how do you do	i ka kɛnɛ wa
how is	a bɛ di
how many	joli
how much	joli
how often	ɲaa joli
how old are you	i be ni saan joli
how old are you	i sii ye saan joli
how was your day	i tile tun be di
how was your night	hɛrɛ sira wa
however	nga
however	jaa
however	o bɛɛ n’a taa
hub	sentiri
hubby	furucɛ
hug	kɔnkɔli
huge	belebeleba
huge	yabi
human	hadamaden
humble	lamaloya
humble	yɛrɛmajiginin
humid	ɲigira
humidity	majigilenya
hundred	kɛmɛ
hungry	kɔngɔ
hunt	ka gɛ
hurricane	fɔɲɔba
hurry	teliya
hurry up	teliya
hurt	digi
hurt	dimi
husband	furucɛ
husband	cɛɛ
hustle	teliman
hut	bon
hut	bugubon
hygiene	saniya
I	Nne
I	N
I am	Nne ye
I am	N ye
I am fine	n ka kɛnɛ
I can	N bi se
I can't	Nne ti se
I can't	N ti se
I do	ne bɛ
I do not know	Nne m'a lɔn
I do not understand	ne m'a faamuya
I don't	ne tɛ
I don't know	N t'a lɔn
I don't understand	Nne ti faamuyan
I don't understand	N t'a faamuna
I don't understand what you mean	Ne t'i fɛn min i b'a fɔra nin faamu
I don't understand you	ne m'a famu
I don’t know	N t'a lɔn
I don’t understand	n m'a faamu
i guess	ne b'a silɔn
I had	Nne tun ye .sɔrɔla
I have	Nne ye.sɔrɔ
I have been	Ne tun kɛra
I hope so	N lannin b'a la
I know	Nne b'a lɔn
I like	N bi.fɛ
I like you	N b'i hanu
I love	ne bɛ i fɛ
I love my big brother	N bi n ka kɔrɔkɛ fɛ
I love my big sister	N bi n ka kɔrɔmuso fɛ
I love my father	N bi n ka facɛ fɛ
I love my little brother	N bi n ka dɔgɔcɛ fɛ
I love my little sister	N bi n ka dɔgɔmuso fɛ
I love my mother	N n ka bamuso fɛ
I love you	N b'i fɛ
I love you	Nne b'i fɛ
I love you	i ko ka di n ye
I love you so much	I ko ka di n ye kosɔbɛ
I love you so much	N b'i fɛ kosɔbɛ
I love you too	N b'i fɛ
I mean	Ne koo
I miss you	I lɔgɔ be n na
I miss you so much	i ɲɛnafinba de bɛ ne na
I see	N b'a ye
I think	ka miri
I understand	N b'a faamu
I want	N bi.fɛ
I want to see you	ne b'a fɛ ka i ye
I want you	ne magon bɛ i ra
I was	N tun ye
I will	N bena
I would be	Ne tun b'a fɛ ka kɛ
I'm	N ye
I'm fine	N ka kɛnɛ
I'm good	N ka kɛnɛ
I'm here	Nne be ɲan
I'm here	N bi ɲan
I'm sorry	i yafa n ma
I'm sorry	safurulayi
ice	galasi
ice cream	kɛrɛmi galase
idea	hakilina
ideal	ɲɛnaman
identical	kelen ye
identify	ɲanɔto
identity	boyoro
idiot	lagalagatɔ
idiot	kunntan
idle	salen
if	ni
ignore	ye k'a to yen
ignore	tigɛnsɔnya
ill	man kɛnɛ
illegal	a ma daga
illness	bana
Ilocano	Lokanikan
image	ja
imagine	bisigi
immediate	sisan sisan
immediately	o yɔrɔnin bɛɛ ra
immediately	ikɔrɔ
immediately	sisan bɛɛ
immense	belebeleba
impact	sira don mɔgɔ kɔrɔ
impatient	basigibali
implement	laboli
import	ka ladon
important	nafama
important	kunba
important	masa
impose	ka jogoya
impossible	abada
impress	ka lasonni kɛ
impression	yecogo
impressive	min be mɔgɔ jawuli
improve	yiriwa
improvement	fisayali
in	kɔnɔ
in	la
in addition	ani fana
In fact	o la sa
in front of	ɲɛfɛ
in order to	walasa ka
inappropriate	ladamubali
incentive	kɔnɔnasuli
incident	kasara
include	fara kan
including	i n'a fɔ
income	sɔrɔ
inconvenience	kϽlϽlϽ
increase	caya
increase	boɲɛ
increase	dɔfarakan
increased	farara
incredible	kabakoman
indeed	laban
indeed	a laban
independent	dafanin
India	Ɛndi
indicate	yira
indigenous	dugulen
individual	yɛrɛkunlabilali
industry	lizini
inevitable	min te se ka kɛɲɛ
infant	denɲɛnin
infection	banayɛlɛma
infinity	ɛnfiniti
inflammation	jeninin
inflation	funun
influence	sira don mɔgɔ kɔrɔ
inform	ka kunnafoniya
information	kunnafoli
ingredients	nafɛnw
inheritance	cɛɛn
inheritance	niyɔrɔ
initial	daminɛ
initiative	sababu
injured	joginli
injury	joli
innocent	jurumutan
innocent	jalakibali
innovation	inowasiyon
inquiry	ɲininkali
inquiry	sɛgɛsɛgɛli
insane	fatɔ
insect	fɛnɲɛnama
insecure	tangabaliya
insert	ka don
inside	kɔnɔ
insight	yeeli
insist	ka laɲini
insomnia	sunɔgɔbaliya
inspiration	fangadilan
inspire	ka sama
install	sigi
instance	misaliya
instant	wagati
instead	yanni
instead	nɔ na
instead	sanni
instead of	sani
instead of	nɔ na
instructions	cikanw
instrument	minɛn
insult	neni
insurance	jagwɛlɛya
insurance	asiransi
intact	a cogola
integrity	hɔɔrɔnya
intellectual	mɔgɔ kalannen
intelligence	hakilidja
intelligent	cegu
intend	ka ɲaniya
intended	dabɔlen
intense	gwan
intention	sago
interact	ka dalafalen kɛ
interaction	kunmafalen
interest	nafa
interest	mako
interested	b'a fɛ
interesting	nafama
interfere	ka sendon
intermediate	furancɛmɔgɔ
internal	kɔnɔna na
international	diɲɛfanbɛ
internship	baaradegin
interpret	ka dalaminɛli kɛ
interpreter	kanbayɛlɛmabaga
interrupt	ka bali
interview	koɲɛɲinibaro
interview	kunnafoniɲiniba
intimate	bulonkɔnɔsi
into	kɔnɔ
introduce	yira
introduce	don
introduction	daminɛ
introvert	mɔgɔ min be to a kelen lon bɛɛ
intuition	sɔmin
invalid	dagabali
invent	dan
inventory	jatebɔ
invest	don
investigate	ka segɛsɛgɛ
invitation	weleni
invite	weele
invite	wele
invoice	fakitiri
involve	ka.fara.
involved	timi
iron	nɛgɛ
is	be
is	bi
island	gun
isolated	mabɔra
issue	gwɛlɛya
issue	kunko
issue	baasi
issues	baasi
issues	kunko
it	a
it is	a ye
it was	a tun ye
it's	o don
it's ok	a kanyin
It's okay	a ka ɲi
item	minɛn
items	minɛn
its	a ka
I’m	n ye
jacket	wɛsiti
jail	kasobon
jail	kaso
January	zanwueyekalo
jar	jifiɲɛn
jaw	dakala
jealous	keleyabagatɔ
jerk	naloma
jewelry	masiri
job	baara
jogging	tagama
join	faraɲɔgɔn ma
joint	tuguda
joke	tulonkɛkuma
journalist	kibaruyadibaga
journey	siratagama
joy	ɲagali
joy	nisɔndiya
joy	diya
judge	kitikɛla
juice	zi
july	zuluyekalo
jump	ka pan
june	zuwɛnkalo
junk	nɛgɛkolon
just	lɛgɛsɛ
just	leru
just do it	a kɛ dorɔn
justice	tilennenya
justify	kun fɔ
Kalaallisut	Kalaallisutikan
keen	jilaja
keep	kɛrɛnkɛrɛn
keep	mara
keep	lasago
keep it up	taga a fɛ
kept	lasagola
kettle	selidaga
kettle	tasale
key	kile
key	lakile
kick	ka tan
kid	den
kid	baden
kidding	tulonkɛkuma
kidney	kɔmɔkili
kids	denmisɛnw
kill	faga
kind	suguya
kind	cogoya
kind	ɲuman
kinda	cogodɔ la
kindly	sabari
kindly	haketo ka.
kindness	ɲumanya
king	masakɛ
kiss	ka bizu kɛ
kitchen	gwaso
kitchen	gwabugu
kite	sɛriwolan
kitten	jakumaden
knee	kunbiri
knew	dɔnnen
knife	muru
knight	sobolila
know	lɔn
knowledge	lɔnniya
known	lakodonnen
Konkani	Konkanikan
Krio	Kriyokan
label	tɔgɔla
label	tɔgɔ
labor	baara
labour	baara
lack	dɛsɛ
ladder	yɛlɛyɛlɛnan
lady	muso
laid	dalen
lake	salan
lamb	sagadennin
lame	segelen
lamp	lanpan
land	jigi
land	dugu
landscape	dugufɛrɛ
language	kan
lap	ka nɛmu
large	belebeleba
large	ba
last	laban
last but not least	laban nga kɔfɛ ɛ
last name	jamun
late	janfa
lately	kɔsala ni na
later	o kɔfɛ
latest	laban
latter	laban
laugh	yɛlɛ
laughing	yɛlɛli
laughter	yɛlɛko
laughter	yɛlɛ
launch	finiko
laundry	finiko
law	sariya
lawn	gazɔn
lawyer	avoka
lay	bla duguma
layer	lazɛri
layout	labɛn cogo
lazy	dɛsɛbagatɔ
lead	ɲaminan
lead	ɲɛminɛ
leader	ɲɛmɔgɔ
leaf	flaburu
leak	cida
lean	sɛmɛ
lean	jɛngɛ
leap	ka pan
learn	dege
learn	kalan
learning	kalan
lease	luwanse
least	min ma se a ɲɔgɔnw
leather	wolo
leather	golo
leave	tagama
leave	taga
leaves	flaburuw
led	ka ɲɛminɛ
left	tara
left	numanfɛla
leg	seen
legacy	ciɲɛ
legal	dagalen
legend	sanga
legend	dawula
legit	dagalen
leisure	farifooni
leisure	lafiya
lend	juru don
length	janya
less	dɔgɔya
lesson	kalansen
let	bila
letter	lɛtɛrɛ
lettuce	salati
level	hakɛya
leverage	daga
leverage	dɛrɛ
liability	bolokanbila
library	bibiliyotɛki
library	gafekalanyɔrɔ
lick	ka nɛmu
lie	galon
lies	nkalonw
life	diɲɛlatigɛ
lift	dakɔrɔrta
light	yeelen
light	fɛgɛman
light	falafala
lightning	yeeienmɛnɛ
like	i ko
like	bi . fɛ
like	i n'a fɔ
likely	i n'a fɔ
likely	komi
likewise	i n'a fɔ
likewise	komi
line	ci
Lingala	Lingalakan
link	ka tugu
lion	jara
liquid	jimafɛn
list	lisi
listen	lamɛn
listening	ka lamɛnni
literally	kuma la
literature	sɛbɛbɔli
litter	ɲaman
little	fitinin
live	balo
liver	biɲɛ
lives	sɛbɛ
lives	liwuru
living	baloli
living room	salɔ
lizard	basa
load	doni
loaf	buuru
loan	juruta
loan	jurudon
local	dugulen
location	luwanse
lock	ka sɔgɔ
lockdown	yɛrɛmabɔ
log	jirikuru
lol	daba yɛlɛkan
lonely	kelenpe
long	jamanjan
long time no see	ne mɛnnan ka i ye
look	ye
look	filɛ
loop	bukulu
loose	ɲamatunu
loose	yoloyolo
loose	sa
lord	matigi
lose	bɔnɛ
lose	tunu
loss	bɔnɛ
lost	tununa
lot	kenè
loud	daba
lounge	tanuli
love	jarabi
love	kanuya
love	kanu
love you	b'i fɛ
lovely	dusumandi
low	kadɔgɔ
lower	ka lajigin
loyal	kunkelen
loyalty	hɔrɔnya
luck	kunna
lucky	kunnadiya
Luganda	Lugandakan
luggage	minanw
lump	bagakuru
lunch	tilela
lungs	fogonfogon
luxury	fɛnw cɛ ɲumanw
lying	galon tigɛ
machine	mansin
mad	fatɔ
madam	madamu
made	min kɛra
magazine	gafe
magnificent	cɛɲɛn
maid	denni
main	kunma
maintain	ladamu
maintenance	ladon
Maithili	Maithilikan
major	kunma
majority	faanba
make	kɛ
make up	makiyali
male	cɛɛ
male	cɛman
mall	kɛsu
man	cɛ
man	cɛman
manage	dɛmɛdɛmɛ
manage	mara
manage	lasago
management	kuntigiya
manager	kunnasigibaga
mandatory	diyagoyanin
manifest	i nisɔn jira kɛ
manipulate	ka kulonkɛ
manner	cogoya
manual	min bɛ fɛn bolo la
many	caman
many many happy returns of the day	ala ka nafa caaman caaman d'i ma bi
march	marisikalo
margin	danfara
market	lɔgɔ
market	sugu
marriage	furu
married	furula
mask	masiki
mass	jamaculu
mass	jama
massive	bélé béléba
master	matigi
master	kunkolo
match	alimɛti
mate	tɔɲɔgɔn
material	minan
math	matematiki
math	jatikalan
matter	baasi
matter	kunko
matter	ko
maturity	baliguya
may	be se ka
may	bi se ka
maybe	adɔrɔ
maybe	nasɔrɔ
me	nne
me	n
me too	nne fana
meal	dumuni
mean	ceguman
mean	kɔnɔnajugu
mean	juguman
meaning	kɔrɔ
means	kɔrɔ
meant	kɔrɔye
meanwhile	yanni o tuma cɛ
measure	jati
measure	hakɛsuma
measures	sariyaw
measures	dama
measures	bɛrɛ
meat	sogo
medical	dɔgɔtɔrɔya
medicine	fura
meditation	kɔnɔnamiiri
medium	hakɛ
meet	lajɛba
meet	bɛn
meet	kunbɛn
meeting	ɲɔgɔnye
Meiteilon	Meiteilonkan
melt	ka yeele
memories	hakili
memory	hakili
mental	miriya
mention	kofɔ
mentioned	tɔgɔ fɔlen
mentor	degebaga
merchant	feerekɛla
mercy	makari
merely	gansan la
merry christmas	sambɛ sambɛ
mess	baga
mess	fisafasa
message	ci
messy	fisafasaman
metal	nɛgɛ
method	minɛbolo
method	fɛɛrɛ
method	cogo
mice	ɲinɛnw
middle	kuncɛmana
middle	camancɛ
middle	tilancɛ
midnight	dugutilan
might	faamaya
might	setigiya
mild	suman
milestone	dakun nafama
milestone	dakun sɛbɛ
military	sɔrɔdasi
milk	nɔnɔ
million	miliyɔn
mind	hakili
mindset	hakilina
mine	nne ta
mingle	ka ni don
minor	damanseenna
minute	miniti
minutes	minitiw
miracle	kabako
mirror	dubale
miscellaneous	sugu caman
mischievous	kegunman
miserable	faantan
misery	faabtanya
miss	bila
miss	tanya
miss	jɛn
miss you	i lɔgɔ be n na
missing	tununen
mission	ci
mist	bugun
mistake	fili
Mizo	Mizokan
mobile	telefɔni
mock	mayɛlɛ
mock	jagabɔ
model	mɔdɛli
moderate	ka bɛrɛbɛn
modern	kura
modest	maagililen
moist	ɲigi
moist	jiman
moisture	bugun
mold	wugu
mole	muli
mom	bamuso
moment	wagati
monday	tɛnɛ
money	wari
monitor	degebaga
monkey	sola
month	kalo
mood	nisɔn
mood	dusuman
moody	nisɔnduma
moon	kalu
moral	hakili
more	ka tɛmɛ
more	ka bon
moreover	fara
morning	sɔgɔmada
morning	sɔgɔma
mortgage	ipotɛki
most	nijuru
mostly	siyɛn caman na
mother	bamuso
motion	mosiyɔn
motivation	kun
mountain	kurun
mouse	ɲina
mouth	da
move	magamaga
move	yɛlɛma
movement	yɛlɛmayɛlɛma
movie	filimu
mrs	madamu
much	caaman
mud	bɔgɔ
mug	min filen
muscle	buu
museum	mize
mushroom	fiyenan
music	fɔli
must	ka kan ka
mute	bobo
mutual	ɲɔgɔn
my	nne
my	n
My dear	N jarabi
my friend	N teri
My hovercraft is full of eels	Nne ka ayeroglisɛɛri fara ni sajigwɛ ye
my love	n jarabi
my name is	n tɔgɔ ye
my pleasure	n ka diya
myself	ne yɛrɛ
mysterious	gundo
mystery	gundo
myth	bisigiyako
nail	pɔnti
naive	duga
name	tɔgɔ
narrative	lankaleli
narrow	dɔgɔya
narrow	dɔgɔ
nasty	cɛjugu
national	jamaden
nationality	jamanadenya
native	duguden
native	jamanaden
natural	yɛrɛyɛrɛ
nature	latanganin
nausea	fɔɔnɔnege
near	gɛrɛfɛ
nearby	kɛrɛ fɛ
nearly	sɔɔni dɔrɔn
neat	pelepele
necessary	mi kakan
neck	kan
necklace	kannankɔnɔ
need	bi.fɛ
negative	bansira
negative	sɔsɔlisira
neglect	a ma jate
negotiate	ka tɛrɛmɛ
neighbor	sigiɲɔgnwɔ
neighborhood	sigiya
neighborhood	sigijɔngɔnya
neither	foyi
nephew	lamɔden
nerd	kegun
nervous	basigibali
nest	ɲaa
net	dafalen
network	erezo
neutral	kelenna
never	pɛtu
never	abadan
never give up	ka na ban abada
never mind	ka na jɔrɔ abada
nevermind	kana hami
nevertheless	nga
new	kura
news	kibaruyaw
next	nata
next to	a kɛrɛfɛ
nice	cɛɲi
nice	ɲɛna
nice	ɲi
nice to meet you	n dusu ka di ka i kunbɛn
niece	lamɔden
night	suu
nightmare	sugojugu
nine	kɔnɔntɔn
nineteen	tan ni kɔnɔntɔn
ninety	bikɔnɔntɔn
No	Ayi
No	un un
No	ɔn ɔn
no problem	baasi t'a ra
no problem	tɔɔrɔ t'u ra
no way	abada
nobody	mɔgɔsi
noise	mankan
noisy	mankan kɛlɛ
none	si
none	foyi si
none	mɔgɔ si
noon	midi
nope	ayi
nor	wa
normal	a ka kan
north	worodugu
nose	nuun
nostalgic	ɲanafinya
nostalgic	ɲɛnafinya
not	te
not	ti
not at all	fiyewu
not bad	a juguyalen tɛ
Not now	Sisan tɛ
not yet	ban fɔlɔ
note	nɔti
noted	a famuna
nothing	foyi
nothing	fosi
nothing	papaga
notice	kɔrɔsili kɛ
notice	kunnafoni
noticed	kɔrɔsili kɛra
noticed	yera
noun	tɔgɔ
nouns	tɔgɔw
novel	kura
november	novanburukalo
now	sisan
nowadays	bidonya
nuisance	tɔɔrɔli
null	fu
numb	deessè
number	hakɛya
number	jatiden
nurse	dɔgɔtɔrɔ
nut	ekuru
nutmeg	muskaad yiriden
nutrition	baloli
oath	kalilikan
obesity	bonyakojugu
obey	kolo
object	ban
object	minɛn
objective	dilankun
obligation	diyagoya
obscure	finman
observation	jateminɛ
observe	kɔrɔsi
obsessed	tɔɔrɔnin
obsession	fa
obsolete	datibanen
obstacle	kunbalan
obtain	latigɛ
obtain	lasɔrɔ
obtained	sɔrɔla
obvious	welekubali
obviously	welekubali
occasionally	wagati dɔ
occupation	ciya
occupation	mako
occupation	baara
occupied	okipe
occur	kɛli
occurred	kɛra
occurs	ka kɛ
ocean	kɔgɔjiba
october	ɔtɔburukalo
odd	kunntan
odds	garisigɛ
of	ta
of	ka
of course	koyi
off	te yen
offensive	bagama
offer	di
office	biro
office	cikɛda baarada
official	faama
often	waati caman
often	sɔn
Oh	.yo
Oh	Waayi
Oh	Wala
oh really	tiɲɛ lo
oil	tulu
ok	n'sona
ok dear	ayiwa ne balima
ok honey	ayiwa ne jarabi
ok my love	ayiwa n jarabi
okay	ayiwa
okay baby	ayiwa n jarabi
okay dear	ayiwa n teri
okay honey	baasi t'a la n jarabi
okay my love	ayiwa n jarabi
old	kɔrɔman
on	kan
on	sanfɛ
on	kun
once	ni
once	siɲɛ kelen
one	kelen
one language is never enough	kan kelen dorɔn ti dafa
onion	jaba
online	bɔlɔlɔ san fɛ
only	dorɔn
open	yɛlɛ
operation	baarakɛcogo
operation	opereli
opinion	miiriya
opportunities	kunnadiya
opportunity	seen
opportunity	siratigɛ
opportunity	bolominɛyɔrɔ
opposite	kɔɔ donni
optimistic	jgima
option	cogo
optional	wajibi tɛ
or	wala
or	walima
orange	woranjima
orange	lemburuba
order	yamaruyali
order	latigɛ
order	diyagoyasira
ordinary	gwansan
organization	jɛkulu
orientation	ɲɛyirali
origin	bɔyɔrɔ
original	yɛrɛyɛrɛ
Oromo	Oromokan
orphan	falatɔ
other	wɛrɛ
otherwise	n'o tɛ
ought	kan ka
our	an
our	anw
Our mission: to enable everyone, everywhere to understand the world and express themselves across languages.	an ka baara walasa yɔrɔ bɛɛ ka se ka diɲɛ famuya ani k'u hakilina fɔ kan bɛɛɔɔ, an ka baara walasa yɔrɔ bɛɛ ka se ka diɲɛ famuya ani k'u hakilina fɔ kan bɛɛɔɔ
Our mission: to organize the world's information and make it universally accessible and useful.	an ka baara ye ka diɲɛkunnafoniw labɛ ani k'u kɛ fɛn min bɛ, ani k'u kɛ fɛn min bɛ se ka sɔrɔani nafa srɔ, ani k'u kɛ fɛn min bɛ se ka sɔrɔani nafa srɔ
out	kɛnɛma
outcome	jaabi
outfit	teni
outgoing	bɔ ta
outlet	bɔda
outline	ka fɛsɛ fɛsɛ
outside	kɛnɛma
outstanding	min ɲɔgɔn te yen
oven	pɔli
over	baanna
over there	yen
over there	yenfɛ
overall	bɛɛ
overcome	dumu
overthinking	miiri ka tɛmɛ
overwhelmed	walannin
overwhelming	sungandili
owe	kèta
owl	gingin
own	bi.bolo
own	yɛrɛ
owner	tigi
ox	misi
pace	cɛlatigɛ
pace	tagamasen
pack	ka faraɲɔgɔn kan
package	pake
paid	sarala
pain	dimi
paint	pɛntiri don
paint	pɛntiri
painting	pɛntirili
pair	fila
pale	nyalaguè
palm	tɛgɛ
pan	kasɔrɔli
pandemic	mumumunu bana
panic	siraɲɛ
pants	pantalɔn
paper	sɛbɛn
paradise	alijɛnɛ
parallel	kuntilenna kelen
parcel	du tɛrɛn
pardon	yafa
parents	bangeba
park	pariki
parrot	solo
parsley	pɛrisili
part	fan
participate	taalikɛ
particular	kɛrɛnkɛrɛnnin
particularly	jango
partner	jɛɲɔgɔn
party	fɛti
party	ɲɛnɛgɛ
pass	sabati
pass	tɛmɛ
passage	tɛmɛsira
passed	tɛmɛnen
passion	kanuya
passionate	fɛ
passive	tɛmɛta
password	kɔdi
past	ka kɔrɔ
patch	ka bari
path	sira
pathetic	hinɛtɔ
patience	sabali
patience	dusufaga
patient	farigwantɔ
patient	sabali mɔgɔ
pattern	ɲɔgɔnna
pattern	sugu
pause	ka jɔ
pavement	pawe
pay	san
payment	sarali
peace	hɛɛrɛ
peaceful	hɛrɛ ni baaden
peach	mɔnni
peak	kuncɛmana
peak	dakun
peak	biɲɛ
pear	puwari
peas	siyɔ
peculiar	kɛrɛnkɛrɛnlen
pee	suunadji
peel	fara
peer	toɲɔgɔn
peers	tɔɲɔgɔnw
pen	biki
pencil	kiriyon
pending	min ma kɛ
people	mɔgɔ
people	jama
pepper	foronto
perceive	ka sɔrɔ
perception	sɔminiminan
perfect	cege
perfect	dafanin
perform	kɛ
performance	seloya
performance	se
perhaps	adɔrɔ
perhaps	nasɔrɔ
period	tuma
period	waati
permanent	banbali
permission	yamaruyasɛbɛ
permit	yamaruya
perseverance	taaɲɛ
persistent	mɛta
person	mɔgɔ
personal	mɔgɔkelenko
personality	hadamadenya
perspective	poroze
persuade	lasɔn
pervert	fatɔ
pervert	tiyɛnni
pet	sokɔnɔbigan
phase	kumasen
phenomenon	fɛnw
philosophy	filo
phone	telefɔni
photo	foto
phrase	kumasen
physical	farigolo
pick	tigɛ
pick	soli
pick up	ta
picture	jaa
piece	faranfaran
pieces	kunkurunw
pig	lɛ
pigeon	jɛnɛtugan
pile	sara
pillow	kunkɔrɔdonnan
pillow	kunblana
pilot	pankurunbolila
pin	biɲɛ
pineapple	jabibi
pineapple	anana
pink	bilenman
pit	kɔlɔn
pitch	karafu
pity	hinan
pity	makaritɔya
place	yɔrɔ
places	yɔrɔw
places	lɔyɔrɔw
plague	banaburuku
plague	banajɛnsɛ
plain	gwansan
plan	fɛɛrɛ
plan	bolola
plane	awiyɔn
plant	nɛɛmafɛn
plant	falenfɛn
plant	turu
plants	falenfɛnw
plate	tasa
platform	bɔlɔlɔ kan
play	tlon k
playing	tulob kɛ
pleasant	diya
pleasant	duman
please	i ye sabari
please	i hakɛ to
pleased	kunadiyara
pleasure	nege
pledge	delili
plenty	caaman
plot	yɔrɔ
plug	kurantayɔrɔ
plum	mandi
plumber	pulɔnbiye
plural	cayalan
podcast	kan talen
poem	poyi
poetry	poyi baara
point	tomi
point	da
poison	baga
police	polisi
policy	fɛɛrɛ
polite	ladamunin
pollution	lamininɔgɔ
pond	ji dingɛ
pool	bunbayɔrɔ
pool	dalan
poop	ka bo kɛ
poor	fantan
pop	sarama
popular	jama bɛɛ mɔgɔ
population	jama
pork	lɛsogo
porridge	baga
port	pɔri
position	dakun
position	lɔyɔrɔ
positive	sɔnsira
possess	bɛ bolo
possession	tigiya
possessive	tigiyalan
possible	min bi se
post	bɔlɔ
post	lase
postpone	yakaro
postpone	weleku
potato	kɔmitɛrɛ
potential	sekoya
pound	bugɔbugɔ
pound	bunte
poverty	lakolonya
power	see
powerful	barikama
practical	nɔgɔman
practice	minɛbolo
practice	waleya
praise	bato
prank	dalabɔli
pray	deli
pray	seli
precious	taare
precise	ka sɛbɛntiya
precisely	kɛrɛnkɛrɛnlenyala
predict	ka sni dɔn
prefer	fisaya
preference	fisaya
pregnant	kɔnɔma
prejudice	gasilako
premises	yɔrɔw
premium	kalite fɔlɔ
preparation	labɛnli
prepare	tobi
prepare	babaara
prepared	tobinin
preposition	bilaɲɛ
presence	ɲana
presence	ɲɛ na
present	bii
present	mɔɔ
present	yira
presentation	dantigɛkan
preserve	kana
preserve	latanga
president	jamanatuntigi
press	ka digi
pressure	daga
pretend	nɔminɛ
pretty	janjigi
prevent	bali
previous	fɔlɔ fɔlɔɔ
prey	sɔnnifɛn
price	sɔngɔ
pride	disibaya
pride	kuncɛbaya
priest	sarakalasebaga
primary	baju
prime	pirimu
princess	masaden
principal	kunbaba
prior	kabini
priority	diyanyeta
priority	kɔnkatɛmɛjo min bi tɔɔw ɲɛ
prison	kaso
privacy	daamu
private	dumuduguma
privilege	nafa
prize	kunnawolojala
probably	adɔrɔ
probably	nasɔrɔ
problem	gwɛlɛya
procedure	kititigɛsira
procedure	cogo
proceed	ka taa ma
process	cogo
produce	sɔrɔ
produce	bɔ
product	dilanlifɛn
production	sɛnɛ
profession	baaradegin
professional	baarakalan
profile	porofili
profit	nafa
profound	dunya
progress	yiriwali
project	poroze
prominent	tɔgɔma
prominent	ba
promise	layidu
promise	karifa
promote	yiriwa
promotion	jalayɛlɛ
prompt	waaju
prompt	tigɛlanteli
prone	dusuba
pronouns	nɔnabilaw
pronunciation	fɔcogo
proof	kokɔrɔbɔ
proper	yɛrɛ
properly	saniya
properties	bolo fɛnw
property	marafɛn
property	tigiya
proposal	ɲanala
prospect	hakilina
prosperity	ɲɛsuma
prosperous	sabatili
protect	latanga
protect	kisi
proud	falimɔgɔ
prove	ka kiisa yira
provide	balo
provided	dilen
province	marali
provision	dumunifɛn
puberty	cɛmisɛnya
puberty	sunguruya
public	foroba
pull	saman
pumpkin	jɛ
punctual	wagati
pupil	lakɔliden
purchase	san
pure	gwɛ
pure	saniman
purpose	dilankun
purpose	bilakun
purse	pɔrɔtɔmani
purse	warimisɛnbilanan
pursue	tagama
pursue	magwɛn
pursuit	nɔgɛn
push	ɲɔnti
push	digi
put	don
qualification	tɔgɔmadon
qualification	mankutuli
quality	sɔn
quantity	dama
quarantine	latɔn yɔrɔ
quarrel	kɛlɛ
quarter	kin
Quechua	Kuechuakan
queen	masamuso
queer	kɛrɛnkɛrɛnneya la
query	ɲininkali
question	ɲininga
question	ɲiningali
queue	safa
quick	joona
quickly	joona
quiet	suu
quilt	dara
quilt	birifani
quit	toyi
quit	bila
quite	fin
quiz	degeli
quotation	sɔngɔ di
quote	kofɔta
quotes	sɔngɔn di
rabbit	sonsan
race	siya
rage	wurubana
rain	sanji ben
rain	sanji
rain	sangi
raise	layɛlɛ
raised	lawili
ran	ka boli
random	kuntere
range	sugu wɛrɛw
rapid	telima
rapidly	joona
rare	go
rarely	dɔgɔ
rash	farikolo bana
rat	toto
rate	sɔngɔ
rather	ka kon a nyè
ratio	kɛmɛsarada
rational	nafama
raw	kɛnɛ
re	tuguni
re	tugu
reach	arrive
reach	se
reached	a sera
reaction	reyakisɔn
read	kalan
reading	gafekalan
ready	fɛrɛ
real	tiɲɛ
reality	kow
realize	lɔnya
realized	faamuyara
really	jaati
really	ti ti ti
really	kɔni
rear	kɔfɛla
rear	kɔɔ
reason	dakun
reasonable	fisa
recall	ka segin ka wele
receipt	resi
receive	minɛ
receive	mina
received	sɔrɔra
recent	kurakura
recently	kɔsa nin na
reception	donda
recipe	fana
reckless	miiribali
recognition	boɲamasegin
recognize	lakolɔn
recognize	lɔn
recommend	koo fɔ
recommend	kumagwɛlɛya
recommended	koo fɔra
record	cisama
record	kofɔsɛbɛ
recover	ka kɛnɛya
recovery	kɛnɛyali
rectangle	tangili
rectangle	selekenaani
red	wulen
redeem	kisi
redemption	sarali
reduce	dɔ bɔ
redundant	tanikasegin
refer	ka . ci.fɛ
reference	tamachien
reflect	taasi
reflection	hakilijagabɔ
reflection	jatiminɛ
reflection	miriya
refrain	yɛrɛ minɛ
refrigerator	firigo
refund	sara
refund	warikɔsegi
refuse	jɛn
refuse	ban
refused	banna
regard	gasi
regarding	gasi
regardless	bonyabaliya
regards	gasiw
region	mara
register	sɛbɛn
regret	nimisa
regular	basiginin
regularly	tuman bɛ
reject	ka fili
relate	lakali
related	min be bɔ ɲɔgɔnw ma
relationship	cɛ
relative	somɔgɔ
relative	baliman
relatives	balimaw
relax	labila
relax	afoni
release	bɔli
release	bila
released	labilalen
relevant	bè a ma
reliable	hɔɔrɔn
reliable	ka kan ka
relief	dɛmɛɲini
relief	dugukolo labɛnsigicogo
relieve	sigikamine
relieved	lafiya sɔrɔla
religion	dinan
religious	diinɛ
reluctant	a be kɛɲɛ
rely	la
remain	to
remaining	tɔ
remarkable	kɔsɔsilen
remedy	saraka
remember	hakiliya
remind	hakili jigin
reminder	hakilinajiginla
remote	yɔrɔjan
remove	labɔ
remove	bɔ
render	ka i yɛrɛ di
rent	sosara
rent	sofuru
rent	luwanse
repair	dilan
repeat	segi a kan
repeat	segi
replace	kɔfalen
replace	kunmafalen
reply	jaabili
report	kumatasɛbɛ
report	cikɔsegisɛbɛ
report	kofɔ
represent	bisigiya
reputation	danbe
reputation	mankutu
reputation	dawula
request	dali
require	ka kan ni
required	komi o ka kan
rescue	lahinɛ
rescue	bolominɛyɔrɔ
research	ɲinini
resemble	fɛ
resemble	ka bɔ
resentment	kɔnɔnakuru
resentment	dimi
resentment	mɔnɛ
reservation	lakofɔli
reserve	ka mara
resident	lasigiden
resign	ka baara bila
resilience	ko ku
resilient	fasaman
resist	ka firifiri
resistance	firifirili
resolution	ŋaniya
resolve	ka ɲɛnabɔ
resort	eresɔri
resources	nafolomafɛnw
respect	bato
respect	bonya
respond	jaabi
response	jaabili
responsibility	ɲɛmɔgɔya
responsible	ɲanabɔbaga
rest	lafiɲɛ
rest	lafiya
rest in peace	ala ka dinan i la
restaurant	dumunifeereyɔrɔ
restore	ka lasegin
restrict	ka dansiri
result	jaabi
results	jaabiw
resume	segi k'a kɛ
retail	jagomafila
retain	tɔn
retention	marali
retired	sɛngɛ lafiɲɛ
retreat	rɛtrɛt
retrieve	sigikamine
return	segi
reveal	yira
revealed	jiralen
revenge	ta sara
revenue	nafolo
reverse	ka yɛlɛma
review	sɛgɛsɛgɛli
revise	ka sɛgɛsɛgɛ
revision	seginkanni
revolution	erewolisɔn
reward	kunnawolojala
reward	baraji
rhythm	fɔlisen
rib	galakakolo
rib	galaka
rice	kinin
rich	nafolotigi
rid	ka fili
ride	boli
ridiculous	latulon
right	kini
right	bɛnnin lo
right	ten lo
right now	sisan
rigid	makama
ring	tugutugunin
ring	kasi
rinse	susa
rinse	sanango
riot	balawu
rip	ka fara
ripe	mɔlen
rise	sannayɛlɛn
risk	farati
rival	sinacɛ
rival	sina
river	ba
road	sira
roast	worotilen
robust	ka fɔri
rock	farakurun
rod	kalamanin
role	lɔda
roll	ka kolonkolon
roof	sanbo
room	soden
root	lili
rope	juruden
rotten	torila
rough	ŋɛɲɛ
roughly	ɲɔgɔnna
round	kulukutu
round	mulunkutu
route	sira
routine	don o don
row	sira
row	aranze
rub	jɔɔsi
rub	digi
rub	goro
rubber	gɔmu
rubbish	ɲaman
rude	malobali
rug	ŋɛɲɛ
ruin	halaki
ruin	bɔnɛ
rule	sariya
ruler	tiiricilan
rules	sariyaw
run	boli
run	bori
running	boli
rural	dafɛdugu
rush	teliya
rush	teliman
sack	saki
sack	bɔrɔ
sacred	lasirannen
sacrifice	jibɔn
sacrifice	saraka
safe	wulibal
safe flight	wulibali pankurunnatagama
safety	lakana
sage	hakilitigi
said	kumanan
said	fɔra
sail	ka kurunboli
sailing	batoboli
sake	kɔsɔn
salary	sara
sale	sannin
salmon	tèbèn
salt	kɔgɔ
same	bɔɲɔgɔman
Same here	o kelen do yan
sample	esantiyɔn
sand	cɛncɛn
Sanskrit	Sanskritikan
sarcastic	jagaci
sassy	nafantan
sat	sigilen
satisfaction	wasali
satisfied	kɛlɛkɛlɛ
satisfied	dafanin
satisfied	fanin
satisfy	wasa
satisfying	nafama
Saturday	Sibirilon
sausage	sogo mugu
savage	waraya
save	kisi
saw	tun .ye
say	fɔ
scale	wɔrɔ
scale	fara
scam	yuruya
scar	jolifɔ
scarce	dɔgɔ
scared	tɔlɛ
scared	siranan
scarf	dankana
scary	min be jabɔra
scattered	serilen
scene	kɛnɛ
scenery	ɲɔgɔlɔn
scent	wusulan
schedule	programu
school	kalanso
science	lɔnniya
scientist	siyantifiki
scientists	dɔnnibagaw
scissors	sizo
scold	sɔngɔ
scope	nafa
score	bi
scrap	ɲaman
scratch	baasi
scream	kulekan
screen	ekaran
screw	wisi
script	sɛbɛnni
sea	kɔgɔji
seal	sirinan
search	ɲini
search	woloma
season	wagati
seat	sigilan
second	filanan
second	segɔndi
secret	gundo
section	fan
secure	ka lakana
security	lakana
see	ye
see	filɛ
see you	kan bɛn
see you later	kan bɛ kɔfɛ
see you soon	kan bɛ sɔɔni
see you tomorrow	k'an bɛn
see you tomorrow	an be sini
seed	si
seek	ɲini
seek	tugu
seem	a sugu
seems	i n'a fɔ
seen	a yela
seize	ka minɛ
seizure	minɛli
seldom	lawoloma
select	ka sugandi
self	yɛrɛ
self healing	yɛrɛ furakɛli
selfish	ɲakuna
sell	feere
send	ci
send me your picture	i foto ci ne ma
senior	kuntigi
sense	ja
sense	kala
sensible	fɛgɛya
sensitive	makaritɔ
sent	a ci la
sentence	kumasen
sentence	ɲegili
sentences	kumasenw
separate	danfara
separate	fara
Sepedi	Sepedikan
september	sɛtanburukalo
sequence	dasigi
series	seriw
serious	sɛbɛ
serious	dun
seriously	sɛbɛla
serve	nafa
serve	dumuni
service	mako
session	sesiyɔn
set	lonsigi
set up	kɛ
setting	paramɛtiri
settle	latigɛ
settle	ɲaɲini
seven	wolonfila
seventeen	bisegi
seventy	biwolonfila
several	dama dɔ
several	caaman
severe	fariman
severe	dun
sew	sɛnɛ kɛla
sh	suu
shade	ka dibi don
shadow	ja
shake	ka yigiyigi
shall	bena
shallow	min ti dunman
shame	maloya
shape	cogoya
share	tilan
share	niyɔrɔ
sharp	di
sharp	leru
she	a
she has	a bi
she is	a ye
shed	gwaa
sheep	sagasi
sheep	saga
sheet	dara
sheet	sɛbɛn
shell	fara
shell	ka wɔrɔ
shelter	gwaa
shelter	togon
shelter	dogotu
shield	nɛgɛbɛnnan
shift	yɛlɛma
shine	ka manamana
ship	kurunba
shipping	cili bato fɔ
shirt	semisi
shirt	dereke
shoes	samaraw
shoes	suliye
shoot	k'a tan
shop	bitiki
shopping	sanni
shore	jida
short	surun
shortage	danya
shot	tiri
should	ka kan ka
shoulder	fɛfɛ
shoulder	gaman
shout	ka kule
show	ɲɛfɔ
show	yira
show	ɲanagwɛ
show me	a yira ne ma
shower	koyɔrɔ
shrimp	kerevɛti
shrink	ka wolo
shut	ka datugu
shut up	makun
shut up	da ge
shy	maloya
sibling	baliman
siblings	denw
sick	farigwanto
sick	man kɛnɛ
sick	banabagatɔ
side	faan
side	galaka
side	tɔgɔ
sigh	taamasiyɛn
sight	yeeli
sightseeing	turizimu
sign	tagamasiɲɛ
sign	tigɛnɔbila
signature	tigɛnɔbila
signature	bolonɔ
significant	bolokɔfɛfɛn
silence	kumabaliya
silent	datugu
silk	fuu
silly	naloman
silver	warijɛ
similar	ɲɔgɔnna
simp	sɔgɔman
simple	nɔgɔman
simultaneously	wagati kelen
since	fo
sincere	sɛbɛ
sincerely	sɛbɛsɛbɛla
sing	dɔnkilila
singer	dɔnkililala
single	gwanan
sink	ben
Sir	Balimancɛ
Sir	Cɛmɔgɔ
sister	badenman
sister in law	buramuso
sit	sigi
site	yɔrɔ
situation	ko
six	wɔɔrɔ
sixteen	tan ni wɔɔrɔ
sixty	biwɔɔrɔ
size	kundama
skill	lɔnniya
skills	lɔntaw
skin	golo
skinny	fasalen
skip	toyi
skip	bila
skirt	ɔrɔbu
sky	sankolo
slave	jɔn
sleep	sinɔgɔ
sleeping	sunɔgɔ
sleepy	sinɔgɔ b'a ra
sleeve	gulokiboloda
slice	ka tigɛ fitini fitini
slide	ka tɛnrɛn tɛnrɛn
slightly	falafala
slim	misɛn
slip	cɛɛnɛ
slope	jigi jigi
slot	ka don
slow	sumaman
slowly	dɔɔnin dɔɔnin
small	fitinin
smart	politiki
smell	kasa
smile	yɛlɛ
smoke	sisi
smooth	manugu
smooth	munaki
snack	daladumini
snail	kerekete
snake	saa
snap	ka ja ta
snow	nɛzi
so	o le kosɔn
so	o le kanma
so	o tuma
so cute	cɛ ka ɲi ka ɲakojugu
so far	hali bi
soak	ka ɲigin
soap	safunɛ
sober	sulen
soccer	ntolotan
social	sosiyali
society	baarabolo
society	sosiyete
socks	susɛti
soft	magaman
software	lozisiyɛli
soil	dugumakolo
sold	feerela
sold out	feerela
soldier	sɔrɔdasi
soldier	fama
sole	kelen
solid	jalen
solution	bɔda
solve	ɲanabɔ
some	dɔ
somebody	mɔgɔ
somebody	mɔgɔ dɔ
somehow	cogo walima suguya wɛrɛ
someone	mɔgɔ dɔ
something	fɛn dɔ
sometimes	waati waati
song	dɔnkili
soon	dɔɔnin
sophisticated	sɔrɔbatigi
Sorani	Soranikan
sore	joli
sore throat	kan dimi
sorrow	ɲɛnasisi
Sorry	Safurulayi
Sorry	Hakɛ to
Sorry	I sabari
sort	suguya
sort	sugandi
sought	ɲinina
soul	nii
soulmate	diyanyebaga
sound	kanɲɛ
sound	mankan
soup	naji
sour	kuma
source	bununda
source	fɔlɔyɔrɔ
south	baɲafan
south	worodugu
space	kɛnɛ
spam	jankarabu ci
span	janya
Spanish	Esipaɲɔnli
spare	kisi
speak	kumasɛn
speak	fɔ
special	kɛrɛnkɛrɛn
species	fɛn suguyaw
specific	kɛrɛnkɛrɛn
spectacular	ilɛlifɛnw
speech	wajuli
speech	dantigɛkan
speechless	bobo
speed	teliya
spell	siginindenfɔ
spell	dabali
spell	mɔgɔbolo
spend	wari bɔ
spent	kɛla
spicy	farin
spike	biɲɛ
spin	tago
spin	munu
spin	bisi
spinach	pinari
spirit	nii
spit	tu
splendid	cɛɲi
split	tilanan
spoil	tiɲɛ
spoiled	tiɲɛ
spontaneous	sisan
spoon	kuyɛri
spot	yɔrɔ
spot	ɲanɔto
spot	kurunin
spouse	furuɲɔgɔn cɛman
spouse	furuɲɔgɔn musoman
spread	duruntu
spread	fara
spring	kɔrɔtanan
spring	bunun
spring	soni
square	kaare
squeeze	ka madigi
squid	djidiara
squirrel	nkɛlen
stab	turu
stable	basigilen
stack	faraɲɔgɔnkan
staff	baarabolo mɔgɔw
stage	dakun
stage	tagamasira
stain	nɔ
stairs	yɛlɛnan
stairs	yɛlɛnyɛlɛnna
stake	bɔlɔ
stalk	kala
stall	ka kale
stamp	tɛnburu
stand	lɔ
standard	dansiginin
star	lolo
start	daminɛ
started	daminɛna
starving	kɔngɔ
state	jamana
statement	fɔta
statement	kuma
station	sitasiyɔn
statue	jirimɔgɔnin
status	dakun
stay	to
stay safe	ɲuman sigi
steady	basigilen
steak	sogo
steal	sonya
steam	cici
steam	sisi
steel	nɛgɛ
steep	teliman
stem	kala
step	etapu
stick	bere
stick	nɔrɔnɔrɔ
stiff	fɛgɛma
still	fɔlɔ
sting	cinda
stingy	tɛgɛmagɛlɛ
stir	ka lamaga
stock	bilankɔrɔ
stock	bilanin
stolen	sonyalen
stomach	kɔnɔ
stone	gabakurun
stone	bɛrɛ
stood	jɔlen
stool	kurun
stool	wagalen
stop	lalɔ
storage	marayɔrɔ
store	bila
store	bitiki
store	bilanin
storm	funufunu
story	ziri
story	tariki
stove	furuno
straight	tilennin
straight	kɔnɔnagwɛ
straight	kunkelen
straightforward	para tilennin
strain	yirikurun
strange	kunntan
stranger	dunan
strategy	fɛɛrɛ
straw	karata
strawberry	firɛzi
streak	serilen
stream	kɔɔ
stream	ba
street	siraba
strength	fanga
strength	se
stress	magwan
stretch	ka sama
strict	fari
strike	baarabila
strike	gusi
string	juru
string	juruden
strip	ka wɔrɔ
strive	ka sabati
stroke	surun
stroke	tiiri
strong	barikaman
struck	gosilen
structure	baaradabolo
struggle	kɛlɛ
struggle	ɲakɔrɔse
struggling	kɛlɛ
stubborn	mɔgɔjugu
stuck	balan
student	kalanden
student	kalandenba
study	sɛgɛsɛgɛli
study	kalan
studying	kalan
stuff	sɔgu
stuff	sɔsɔ
stunning	dabaliban
stupid	naloman
style	mɔdɛli
subject	lahalaya
subject	kɔnɔnako
subject	kalanta
submission	dɔgɔmaya
submit	kolo
substance	kɔnɔnafɛn
substitute	ka falen
subtle	ceguman
succeed	sabati
success	kunawolo
successful	dondala
such	ɲɔgɔn
such as	i n'a fɔ
suck	mugan
sudden	ka bali
suddenly	pɔkɛ
suffer	tɔrɔ
suffering	dimi
sufficient	ɲanaman
sufficient	dafanin
sugar	sukaro
suggest	sula
suggestion	ladili
suit	ɲafa
suit	kunminɛ
suitable	bèle a ma
suitcase	walisi
sum	hakɛ
summary	bakurubafɔ
summary	fɔkasurunya
summer	telema
summit	kuncɛ
sun	tile
sunday	dimansilon
sunny	tilebin
sunset	tilebin
sunshine	tileɲɛ
super	a kaɲi
superior	a sanfɛ
supervisor	ɲɛmɔgɔ
supper	ka dumini kɛ
supply	bɔ
supply	bɔli
support	dɛmɛli
support	dɛmɛ
suppose	bisigi
supposed	i n'a fɔ
sure	lɛgɛsɛ
sure	wulibali
surface	kɔkanna
surge	ka yɛlɛ
surgery	operelikɛyɔrɔ
surname	jamu
surprise	bali
surprise	barinnako
surprise	balinanko
surprised	balinan
surrender	yɛrɛdi
surrounding	fanfɛla
surveillance	lakɔlɔsi
survey	sɛgɛsɛgɛli
survive	balo
suspect	siganamɔgɔ
suspended	a jɔlendo
suspicious	sigamɔgɔ
sustain	ka mɛn
sustainability	min bi mɛn
sustainable	min be mɛn
swag	kado
swallow	kunu
swap	ka falen
swear	ka kalen
sweat	wɔsi
sweater	jugujugu
sweep	ka fura
sweet	aluwa
sweet dreams	siko nɔgɔman
sweet tooth	ɲiin ɲuman
sweetheart	dusu
swell	funu
swelling	funu bɛ kɛ
swim	nage
swimming	naze
swing	bumuso
swing	felefala
switch	yɛlɛma
swollen	kununen
sword	npan
symbol	sɛnboli
sympathy	mɔgɔya
symptoms	bana taamasiyɛnw
system	sisitɛmu
table	tabaki
tackle	ka ɲɛnabɔ
tag	ka nɔrɔ
tail	kukala
tail	ku
take	minɛ
take	ta
take	mina
take away	ta ka boyi
take care	mara
take off	bɔsi
take off	fosi
take off	pan
taken	a talen
talk	kuma
talkative	kumakɛlaba
tall	janmajan
tap	orobinɛ
tap	gosigosi
tape	worobinɛ
target	dilankun
target	dasigi
task	baarakèta
taste	nɛmu
tasty	timi
taught	kalanan
tea	tee
tea	dute
teach	kalan
teacher	mɛtɛrɛ
teacher	karamɔgɔ
team	jɛnkulu
tear	ɲɛji
tears	ɲɛji
tease	ka dalabo
technology	tɛkinolozi
teeth	ɲiinw
tell	fɔ
tell	kuma
tell me	a fɔ ne ye
temper	nunsɔ
temper	dusuman
temperature	gwanniyahakɛ
temple	alabatosoba
temporary	donkatɛmɛ
ten	tan
ten thousand	waga mugan
tenant	luwanse
tend	ka sama
tendency	cogo
tender	maga
tense	waati
tension	tansiyon
tent	finiso
tentative	ka eseye
term	kumasɛn
term	laban
terms	bɛnkanw
terrible	kabakoman
terrific	sariyanfɛn
territory	jamana
territory	mara
test	kɛkafilɛ
test	kɔrɔbɔ
text	masalabolo
than	katɛmɛ
thank	i ni ce
thank you	Barika
thank you	i ni ce
thank you	Abarika
Thank you for your patience while we investigate shipment	I ni ce i ka muɲuli kama an bena sɛgɛsɛgɛli kɛ ka filɛ i ci minaw be yɔrɔ min
thank you so much	i ni ce kosɔbɛ
thank you very much	i ni ce kosɔbɛ
thanks	abarika
thanks	barika
thanks	a ni ce
Thanks for using our app	I ni ce i ye baara cɛ ni an ka aplikasiyɔn kama
that	nin
that	o
that	ko
that is	nin don
that's good	a kaɲi
theft	sonya
their	u
them	u
theme	dakun
themselves	u yɛrɛ
themselves	o yɛrɛ dama
then	kɔfɛ
then	o kɔfɛ
theory	kɛ cogo
there	yen
there	yenfɛ
there are	bɛ ye
there is	be yen
therefore	o de kosɔn
these	nunu
these	ninnu
they	u
they	o
they are	u ye
thick	bon bon
thief	nson
thigh	woro
thin	misɛnman
thin	fasa
thing	fɛn
things	fɛnw
think	miiri
third	sabanan
thirsty	jiminnɔgɔ .na
thirteen	tan ni saba
thirty	minnɔgɔ
this	nin
this is	nin ye
thorough	fɛsɛfɛsɛ
thoroughly	kɔsɛbɛ
those	minnu
though	jaa
though	dun
thought	miiriya
thought	kɔnɔnako
thought	miiri
thoughtful	miriya
thoughts	miriya
thousand	wa kelen
thread	gaari
thread	kalan
threat	bagabaga
threaten	baabaali
threaten	papa
three	saba
threshold	dakun
thrilled	lasiralen
thrive	ɲasuma
thrive	yiriwa
throat	kan konola
through	ka tèmè a fè
throughout	banabiri
throw	fili
thumb	bolokɔni kunba
thunder	sanpɛrɛnkan
Thursday	alamisa
Thursday	alamusa
thus	o kaman
tick	ka yigi yigi
tide	kɔgɔjitagama
tidy	sani
tidy	saani
tie	siri
tiger	waranikala
tight	ŋaɲi
Tigrinya	Tigrinyakan
time	siɲɛ
time	jamana
time	wagati
timid	maloya
tiny	fitinin
tip	dakun
tip	juu
tips	laadilikan
tire	mɔbilisen
tire	manan
tired	sɛgɛra
tissue	finimugu
title	tɔgɔ
to	ra
to	la
to be	ka kɛ
toast	ka tɔsi kɛ
today	bi
toddler	bilaroroniw
toes	senkumaden
together	ɲɔgɔn
toilet	ɲɛgɛn
told	fɔla
tolerance	yafa
tolerate	ka yafa
tomato	tomati
tomorrow	sini
tongue	nɛɛn
tonight	su ni na
too	fana
took	minana
tool	minɛn
tools	minɛnw
tooth	ɲin
top	sanfɛ
topic	kunko
torn	tunɔminen
torture	ka tɔɔrɔ
total	kasabi
touch	tu
touch	maga
tough	fasa
tour	turi
toward	kasin
towards	fɛ
towel	jɔsilan
town	duguba
toxic	sɔfɛ
toxic	baga
trace	ka nɔ bɔ
track	nɔ
track	tɛmɛyɔrɔ
trade	jago
trade	jagobaara
trade	julaya
tradition	kɔrɔmanko
tradition	landa
traditional	landa
traffic	sira
traffic	sirikilasiyɔ
trail	kiri
train	kolo
train	bolodon
train	tɛrɛn
training	baaradegeli
training	degeli
trait	taamasiyɛn
traits	taamasiyɛn
transfer	k'a  tchi  a ma
transition	furancɛfanga
translate	ka bayɛlɛma
transparent	jɛlen
transport	doni
transportation	taransipɔrɔ
trap	foolo
trash	ɲamaɲama
trash	nɔgɔ
trauma	jawili
travel	dugutaga
travel	tagama
tray	tiriwari
treasure	nafolo
treat	furakɛ
treatment	furakɛli
tree	yiri
tremendous	dakabana
trend	taabolo
trial	kititigɛ
trick	ka lafili
tried	kititigɛla
tried	kɛkafilɛra
tried	kɔrɔbɔla
trigger	daɲini
trigger	kankɔrɔbɔ
trigger	marfaviridaki
trim	ka gana
trip	talon
trip	dugutaga
trouble	gwɛlɛya
trousers	kulusi
trousers	pantalɔn
truck	kamiyɔn
true	HALALA
true	SƐBƐ
true	LAKIKA
trunk	suun
trunk	cɛmabacɛ
trust	limaniya
truth	tiɲɛ
try	banba
Tsonga	Songokan
tube	tiyo
Tuesday	Tarata
tuition	ladonli
turkey	kulokulo
turmeric	kirkuma
turn	kuruda
turn	faran
turtle	koorokaara
tutor	ladonbaga
twelve	tan ni fila
twenty	mugan
twenty-one	mugan ni kelen
Twi	Ashantikan
twice	siɲɛ fila
twist	ka tunɔmi
two	fila
type	sugu
typical	gansan
ugly	cɛjugu
ultimate	kɔdan
umbrella	sanjibɛnnan
unable	se tan
uncle	belencɛ
unconscious	miribali
under	duguma
underneath	jukɔrɔ
underrated	sɔngojugu
understand	faamu
understood	famuyala
unfortunately	n'ga malatikè
uniform	teni
unique	ɲɔgɔntɛ
unique	kelenpe
unit	inite
university	kalansoba
unknown	lakodonbali
unless	fɔ
until	fo
unusual	min te loon o loon koe ye
up	sanfɛ
up to you	a bagara i ma
update	lakuraya
update	kuraya
upgrade	ka fisaya
upon	kè min kèra
upset	funu
upset	furuku
urban	duguba
urge	teli
urgent	teli
us	an
us	annu
us	anwu
use	kɛ
use	ɲɛci
used	kolon
useful	nafama
useless	kolon
usual	kɔrɔlen
usually	tuma wo tuma
utility	nafa
vacation	kɔnze
vaccination	boloci
vaccine	boloci
vacuum	lankolon
vague	kuma min ti pelepele
valid	jaati
valley	kulufurance
valuable	dondala
valuable	taare
value	daman
variety	sugu
various	sugu wɛrɛw
vary	ka yɛlɛ ka jigi
vase	tinto
vast	kabon
vegetable	nanfɛnkɛnɛ
vegetables	nafɛn kɛnɛ
vehicle	mɔbili
vendor	feerekɛla
venom	baga
venture	ka taga taama la
venue	nani
verify	sɛgɛsɛgɛ
versatile	nafacaman
version	wɛrisiyɔn
vertical	jɔlen
very	yɛrɛ
very good	ka ɲi kosɔbɛ
vessel	bato
via	fɛ
vibe	mamagali
vibes	ɲagali
vicious	diyatɔ
victim	kasaaratɔ
video	wideyo
view	hakilila
village	dugu
villain	cɛjugu
vinegar	winɛgiri
vintage	kɛnɛ
violence	tɔɲɔnli
violent	nijugu
viral	diɲɛ lamini
virgin	npogotigi
virtual	Ɛntɛrinɛti kɔnɔ kow
virtue	kalite
vision	jiralifɛn
visit	lajɛ
visit	na
visual	ye ko
vital	niin
vivid	yelenman
vocabulary	kumadengafe
vocabulary	kumaden kalan
voice	kumakan
void	kolon
void	lakolon
volume	makan
volunteer	wɔlɔntɛri
vomit	kun fɔ
vulnerable	faantan
wage	sara
wages	sara
waist	cɛ
wait	i lɔ
waiter	baarakɛden
waiting	makɔnɔli
wake	ka wuli
wake up	kunu
walk	tama
walk	tagama
walking	tagama
wall	kogo
wallet	pɔrɔtɔmani
wander	yaalayaala
wanna	bɛna
want	fɛ
wanted	tun bi . fɛ
wanted	tun kanuna
war	kɛlɛ
wardrobe	faninbilayɔrɔ
wardrobe	taafebilayɔrɔ
warehouse	magasan
warm	funteni
warm	funtenima
warm	bagibagi
warn	wɔlɔkɔ
warning	lasɔmi
warrior	kɛlɛkɛla
was	tun be
was	tun bi
wash	ka ko
waste	tiɲɛ
waste	ɲaman
watch	filɛ
water	jii
watermelon	nsɛrɛ
watermelon	melon
wave	jikuru
way	sira
we	anwu
we	annu
we	an
we are	an ye
we are	anwu ye
we can	an bi se
we can	an be se
weak	faantan
weakness	fɛgɛnya
wealth	nafolo
wealthy	nafolotigiya
wear	don
wearing	donfini
weather	nɛɛmayafɛnw cogo
wedding	furusiri
wedding	musofuru
Wednesday	arabalon
weed	bin
week	lɔgɔkun
weekend	lɔgɔkun laban
weekend	wikɛni
weight	guliya
weird	kunntan
welcome	i dansɛ
welcome	i ni tagama
welcome	bisimila
welfare	kɛnɛya
Well	A nyèna
well done	baara ɲuman lo
went	tara
went	tagara
were	tun be
were	tun bi
west	tileben
wet	ɲigira
whale	balɛni
what	mun
what about you	ele don
what are you doing	i bi mun lo kɛra
what are you doing	i bi mun kɛ
what are you doing	i bi mun baara kɛra
what are you doing now	i bi mun lo kɛra sisan
what are you doing now	i bi mun kɛra sisan
what are you doing right now	i be mun don kɛ sisan sisan
what do you do	i bi mun baara kɛɛra
what do you do for a living	e bɛ baara jumɛ de kɛ
what do you mean	i ye min fɔ kɔrɔ ko di
what do you want	i be mun lo fɛ
what happened	mun lo kɛra
what is	mun ye
what is	mun lo ye
what is this	nin ye mun ye
what is your job	i bɛ mun baara kɛ
what is your name	i i tɔgɔ ko di
what is your name	i tɔgɔ be di
what's up	mun bɛ ye
what's your name	i tɔgɔ be di
whatever	o
wheat	alikama
wheel	sen
when	yɔrɔ min
when	minkɛ
when	tuman min
whenever	wati wati
where	min
where	yɔrɔ juman
where are you	i be min
where are you from	i bɔra min
where are you from	i be bɔra min
where are you now	i be min sisan
where do you live	i sigilen be min
where do you live	i sigilen be yɔrɔ juman
where is	a bɛ min
whereas	kamasɔrɔ
whereas	kasɔrɔ
whether	yala ni
which	juman
which	jumɛn
while	kamasɔrɔ
while	kasɔrɔ
while	ka.to
whisper	ɲunuɲunu
whistle	filenin
white	gwɛman
who	jɔɔn
who are you	i ye jon ye
who is	jɔn ye
who is this	jon lo
whole	mumɛ
whole	kunturu
whom	minw
whom	min
whose	jon ta
why	mun kosɔn
why	mun na
why	mun y'a to
why not	munna ayi
wicked	jugu
wide	fɛrɛ
widow	muso cɛ salen
width	lɔsurun
width	panpara
wife	muso
wild	kongo kɔnɔ fɛn
will	bina
will	sagoya
will	bena
willing	diyanyetɔ
win	sɔrɔ
win	tɔnɔ
wind	fɔɲɔ
window	finɛtiri
windy	fiyɛma
wine	diwɛn
winter	foonɛnɛ
wipe	ka jɔsi
wire	filijuru
wisdom	hakilimaya
wisdom	hakilitigiya
wise	hakilima
wise	hakilitigi
wish	ŋaniya
wish	sago
wish you all the best	ne ka duba i ye
witch	subaga
with	ni
with	ani
withdraw	bɔsi
withdrawal	labɔli
within	kɔnɔ
within	cɛman
without	ni . tɛ
witness	seereya
witty	hakilinako
wolf	lugaru
woman	muso
women	musow
won	sɔrɔla
won't	tɛna
wonder	yɛrɛ ɲininga
wonder	kabako
wonderful	kabakoman
wood	batu
wood	lɔgɔjalan
wool	sagasi
word	kumasɛn
words	kumadenw
work	baarakɛtaw
work	ciya
work	baara
work out	ka labɛn
working	be kèkan
world	duniɲa
worm	ntumu
worn	ka kankarimada
worried	ɲimiɲama
worry	jɔrɔ
worry	haminanko
worry	hami
worse	kajugu ka tɛmɛ
worship	bato
worst	lajuguya
worth	hɔɔrɔn
worth	ka kan ka
worth it	a bɛ a kun bɔ
worthy	nafaman
would	tun
wound	nigɛda
wound	joli
wound	joginda
Wow	ankasa
wrap	ka meleke
wrath	dimi
wrist	bolokan
write	sɛbɛn
Write here	Sɛbɛ yan
writing	sɛbɛnni
written	sɛbɛnnin
wrong	gasi
wrote	sɛbɛnna
yard	lukɛnɛ
yawn	haalo
Yeah	Awɔ
Yeah	Unhun
Yeah	Ɔnhɔn
year	san
years	saanw
yeast	fununnan
yell	kule
yellow	nɛrɛmuguman
Yes	Awɔ
Yes	unhun
Yes	Ɔnhɔn
yes baby	hɔnhɔn bebe
yes dear	hɔhɔn balima
yes honey	awɔ n jarabi
yes my love	awɔ n jarabi
yes of course	hɔnhɔn kɛ
yesterday	kunu
yet	nga
yet	fɔlɔ
yield	sɔrɔhakɛ
you	i
you	Aw
you	Á
you are	i ye
you are beautiful	i ye sarama ye
you are beautiful	i kɛ ka ɲi
you are so beautiful	i cɛ ka ɲi
you are welcome	bisimila
you are welcome	i dansɛ
you can	i be se
You know	i bɛ a dɔn
you too	i fana
you're welcome	i dansɛ
young	misɛnman
young	cinin
your	i
your	ile
your welcome	i dansɛ
yourself	i yɛrɛ
youth	denmisɛnya
you’re welcome	i dansɛ
yummy	timiman
zero	fu
