abandoned	तज्जे दा
abandoned	त्यागे दा
abandon	तज्जे दा
abide	पालन करना
ability	थबीक
ability	समर्था
able	काबल
able	जोग्य
about	तकरीबन
above	उप्पर
abroad	बदेस
absence	गैर-हाजरी
absent	गैर-हाजर
absolutely	बिलकुल
absorb	सोखना
abstract	अमूर्त
absurd	बेतुका
abundance	भरमार
abundant	सुद्धा
abuse	गाली
accent	लैह्‌जा
accept	मंजूर करो
access	पुज्ज
access	पौंहच
accident	हादसा
accommodation	रिहाश
accomplished	चज्जल
accomplished	जनकार
accomplish	पूरा करना
according	अनुसार
account	खाता
accuracy	शुद्धता
accurate	पक्का
accused	मुजरम
ache	दर्द
ache	पीड़
achievement	प्राप्ती
achievement	सिद्धि
achieve	हासल
acknowledge	कबूल करना
acknowledge	रसीद देना
acquaintance	जान-पंछान
acquired	हासल कीते दा
acquire	हासल करना
acquisition	प्राप्ती
across	आर-पार
action	अमल
action	हरकत
active	सरगर्म
activities	गतिविधियां
activities	सरगर्मियां
activity	सरगर्मी
actor	अदाकार
actually	असल च
actual	असल
act	ऐक्ट
act	कम्म
acute	तेज
acute	त्रिक्खा
adapt	अपनाना
addicted	ब्यसनी
additional	बाद्धू
addition	जोड़
address	पता
add	जोड़ करना
adequate	पूरा
adequate	सुद्धा
adjacent	सटोेए दा
adjective	विशेशन
adjust	तालमेल बठाहना
admire	तरीफ करना
admit	दाखल करना
adopt	अपनाना
adorable	प्यारा
advanced	उन्नत
advance	पेशगी
advantage	फायदा
advantage	लाह्
adventure	हिम्मती कम्म
adverb	क्रिया विशेशण
advertisement	इश्तेहार
advertising	मश्हूरी करना
advice	सलाह्
advise	सलाह्
advocate	बकील
aesthetic	शलैपे आहला
affair	मामला
affair	रिश्ता
affection	चाह्‌
affection	चाह्‌त
affect	मतासर करना
affordable	सस्ती
afford	खर्च करना
afraid	डरे दा
afternoon	दपैहर
afterwards	फिरी
afterwards	मगरा
after	बाद च
against	खलाफ
again	परतियै
agency	अजैंसी
agent	अजैंट
age	उमर
age	बरेस
aggressive	उग्गर
agile	फरतीला
agile	शताबा
ago	पैहलें
agreement	करार
agree	रजामंद
agree	सैहमत
agriculture	राही-बाही
ahead	अग्गें
aid	मदाद
aim	मकसद
airport	एयरपोर्ट
airport	ब्हाई-अड्डा
air	ब्हा
aisle	गलियारा
aisle	रस्ता
alarm	अलार्म
alcohol	शराब
alert	चकन्ना
alert	चुस्त
a little	बिंद सारा
alive	जींदा
allowed	मंजूर करना
allow	करन देओ
all right	ठीक ऐ
all the best	शुभकामनां
all	सब्भै
almost	लगभग
alone	इक्कला
along	इक्कला
along	नबेकला
a lot of	ढेर सारा
a lot	ढेर सारा
already	अग्गें
Alright	सब ठीक ऐ
also	बी
alternative	एवजी
alternative	विकल्पी
although	भाएं
always	म्हेशां
amazing	अजब
ambiguous	संदिग्ध
ambition	तमन्ना
ambition	हिरस
ambitious	लालसी
amend	तरमीम करना
amid	दरम्यान
amid	बछकार
among us	साढ़े च
among	दरम्यान
amount	पैहा
amusing	दिलचस्प
am	दपैहर पैहलें
analysis	विश्लेश्न
ancestors	पुरखे
anchor	लंगर
ancient	प्राचीन
and you	ते तुस
and	ते
angel	परी
anger	गुस्सा
anger	रोह्
angle	कोण
angry	गुस्सा
animal	जनौर
animal	डंगर
ankle	गिट्टा
anniversary	सालगिरह्
announcement	ऐलान
announcement	घोशना
annoyed	नराज
annoyed	मुटसुर
annoying	तकलीफ देय
annoy	सताना
annual	सलाना
anonymous	गुमनाम
another	दुआ
answer	परता
anticipate	मेद करना
anxiety	घबराट
anxious	काहला
anymore	हून
anyone	कोई बी
anything	किश बी
anyways	उं'आं बी
anyway	कोई गल्ल नेईं
any	कोई बी
an	इक
apartment	अपार्टमेंट
apart	बक्ख-बाह्‌रा
apologize	माफ करना
apparently	जाह्‌रा-बाह्‌रा
apparent	जाह्‌र
apparent	परतीत
apparent	साफ
appeal	अपील
appearance	चेहरा-मोहरा
appearance	नुहार
appeared	लब्भै करदा
appear	पेश होना
appetite	त्रिशना
apple	स्येऊ
application	दरखास्त
apply	लागू करो
appointment	मुलाकात
appreciate	सराहना
appreciation	दाद
appreciation	शाबाशी
approach	नजरिया
appropriate	मनासब
approval	मंजूरी
approved	मंजूरशुदा
approve	मंजूर करना
approximately	अंदाजन
april	अप्रैल
arbitrary	मनमर्जी दा
architecture	शिल्पकार
architect	शिल्पकार
archive	पुरालेख
area	इलाका
area	खेत्तर
are you busy	क्या तुस मसरूफ ओ
are you married or single	क्या तुस कुआरे जां ब्होए दे ओ
are you married	तुस ब्होए दे ओ
Are you still there?	तुस अजें बी उत्थें ओ?
are you there	तुस उत्थें ओ
are you	क्या तुस
are	न
argue	बैहस
argument	बैहस
arise	उग्गना
army	फौज
army	सेना
arm	बांह्
around	आलै-दुआलै
arrangement	प्रबंध
arrangement	सरिस्ता
arrange	बंदोबस्त करना
arrival	पुज्जना
arrived	पुज्जी गेआ
arrive	औना
arrive	पुज्जना
arrogant	बद-दमाग
arrow	तीर
article	लेख
artificial	नकली
artist	कलाकार
art	कला
ashamed	झित्था
ashamed	शरमिंदा
ash	सुआह्
asked	पुच्छेआ
ask	आक्खो
ask	पुच्छो
asleep	नींदरै च
as long as	जदूं तगर
aspect	पक्ख
Assamese	असमिया
assault	हमला
assembly	असैंबली
assembly	सभा
assertive	इकरारी
assessment	परख
assess	आंंकना
assets	जैदाद
asset	जैदाद
asset	संपत्ति
assignment	सपुर्द कम्म
assign	सपुर्द करना
assistant	मदादी
assistant	सहायक
assist	मदाद करना
associated	बा-बस्ता
associate	संगी
associate	साथी
association	संघ
association	साथ
assume	मन्नना
assumption	फर्ज़
as well as	कन्नै गै
as well	बी
as	जियां
ate	खाद्धा
athlete	एथलीट
at least	घट्ट-थमां-घट्ट
attached	नत्थी
attachment	अटैचमेंट
attachment	बंधन
attach	नत्थी करना
attack	हमला
attempt	जतन
attendance	हाजरी
attend	शामल होवो
attention	ध्यान
attitude	रुझान
attitude	रौं
attraction	कशश
attraction	खचाऽ
attraction	खिच्च
attractive	रौंसला
attractive	सलोना
attractive	सलोबना
attract	मोहत होना
attribute	गुण
attribute	बशेशता
at	पर
audience	श्रोता
august	अगस्त
aunty	चाची
aunt	चाची
aunt	मामी
authentic	स्हेई
authority	अथार्टी
author	लेखक
autumn	पत्तर-झाड़
available	दस्तयाब
average	दरम्याना
avoid	परहेज
awake	बेदार
award	ईनाम
awareness	जागरती
aware	जानकार
away	छिंडै
away	दूर
awesome	अनोखा
awful	घोर
awkward	बे-ढंगा
Aymara	आइमारा
a	इक
baby	ञ्याणा
bachelor	कुआरा
background	पछौकड़
back	पिच्छै
bad	बुरा
bad	भैड़ा
bag	झोला
bag	थैल्ला
bait	चारा
bakery	बेकरी
bake	सेंकना
baking soda	बेकिंग सोडा
balance	बकाया
balance	संतुलन
ball	खिन्नू
ball	गेद
ball	बाल
Bambara	बंबारा
banana	केला
band	गरोह्‌
band	जत्था
band	बैंड
bang	घम्म
bang	ठल्ल
bang	ठाह्‌
bank	बैंक
barely	बड़ा घट्ट
barely	मसां-मसां
bargain	सौदा
bark	सिक्कड़
barley	जौ
barrier	रकाबट
barrier	रकौट
bar	रोक
based	अधारत
basement	तैह्‌खाना
base	अधार
base	कमीना
base	बुनियाद
basically	बुनियादी तौर पर
basic	बुनियादी
basil	तुलसी
bastard	र्‌हामी
batch	बैच
bathroom	गुसलखाना
bathroom	बाथरूम
bath	न्हौना
battery	बैटरी
battle	जंग
battle	जुद्ध
bay	खाड़ी
beach	समुंदरी कनारा
beam	शतीर
beans	भौंठे
beard	दाढ़ी
bearing	सैहन करना
bear	रिच्छ
beast	डंगर
beast	दरिंदा
beat	रहाना
beautiful	रूपवान
beauty	शलैपा
became	बनी गेआ
be careful	खबरदार होना
because	की जे
become	होई जाना
bedroom	अरांमगाह्‌
bed	बिस्तर
beef	गौमांस
been	गेआ
beer	बीयर
bee	मधुमक्खी
before	पैहलें
began	शुरू करना
beginning	शुरुआत
begin	शुरू
behalf	दी तरफा
behave	ब्यहार करना
behavior	ब्यहार
behaviour	ब्यहार
behind	पिच्छें
being	होआ करदा
belief	आस्था
belief	इमान
belief	जकीन
believe	मन्नो
belly	ढिड्ड
belong	सरबंधत होना
beloved	दिलबर
beloved	प्रेमका
beloved	मशूका
below	हेठ
belt	बेल्ट
bench	अदालत
bench	बेंच
bend	झुकना
beneath	थल्लै
benefits	फायदे
benefits	लाह्
benefit	लाह्
besides	अलावा
beside	छुट्ट
beside	बिजन
best of luck	शुभकामनां
best regards	सादर
best	तैंत
best	बधिया
better	बधिया
between	बिच्च
beverage	सोडा
beyond	पिच्छें
be	होना
Bhojpuri	भोजपुरी
biased	तरफदार
biased	पक्खपाती
bias	तरफदारी
bicycle	सैकल
bid	बोली
big	बड्डा
bike	बाइक
bill	बिल
bind	बन्नना
bird	पक्खरू
birthday	साल-गिरह
bite	टक्क मारना
bitter	कौड़ा
bit	टुकड़ा
black	काला
blade	पच्छना
blade	ब्लेड
blame	तोहमत
blanket	कंबल
blank	कोरा
blast	धमाका
bleach	रंग-काट
blend	मलावट
blend	रला
blessed	धन्न
bless	शीरवाद देना
blind	अन्ना
bliss	नंद
block	खंड
block	ब्लाक
blood	खून
blood	लहू
bloom	बूर
blow	धमाका
blue	नीला
blunt	खुंढा
board	परिशद
board	बोर्ड
boat	किश्ती
body	जिसम
body	शरीर
boil	दाना
boil	फोड़ा
bold	न-झक्क
bond	रिश्ता
bone	हड्डी
book	कताब
booster	बूस्टर
boost	बढ़ावा देना
boots	बूट
boot	जूत
boot	बूट
border	कंढा
border	सरहद्‌द
border	सीमा
border	हद्‌द
bored	उबाऊ
bore	छेक
bore	बेध
bore	सराख
boring	उबाऊ
born	जम्मे दा
borrow	दुहार
boss	सरदार
boss	साहब
bother	भ्रा
both	दोए
bottle	बोतल
bottom	तला
bought	खरीदो
bounce	टपाकी
boundaries	हद्दां
bound	बज्झे दा
bowl	कौली
bow	धनख
box	डब्बा
box	संदूक
boyfriend	आशक
boyfriend	प्रेमी
boy	जागत
bracelet	कंगन
brain	दमाग
branch	ब्रांच
branch	शाखा
brand	ब्रांड
brave	ब्हादर
breach	छेका
breach	तरेड़
bread	ब्रैड
breakfast	न्हारी
break	बकफा
break	बसूनी
breast	स्तन
breathe	साह् लैना
breath	दम
breath	साह्
breed	नसल
brick	इट्ट
bride	लाड़ी
bridge	पुल
brief	मुखसर
bright	चमकीला
brilliant	बुधवान
bring	आहनो
broadcast	प्रसारन
broad	चैड़ा
broken	भज्जे दा
broke	त्रुट्टना
broom	झाड़ू
brother in law	साला
brother	भ्रा
brought	खरीदो
brown	भूरा
bro	भ्रा
brush	बुरश
bucket	बालटी
buddy	दोस्त
budget	बजट
bug	बग
building	बिल्डिंग
build	बनाना
built	बनाया
bulk	डील-डौल
bully	लुंड
bully	सीन्नाजोर
bull	दांद
bull	बलद
bump	रोड़
bump	हचकोला
bunch	गुच्छा
bunch	घुंगा
bundle	गंढ
bundle	पंड
bundle	बंडल
burden	भार
buried	दफन
burn	छाल्ला
burst	फोड़ना
bury	दब्बना
bush	ज्हूड़ी
bush	झाड़ी
business	बपार
bust	छाती
busy	मसरूफ
bus	बस्स
butterfly	तितली
butter	मक्खन
button	बटन
button	सुच्च
but	पर
buy	खरीदो
bye	अलविदा
by the way	उं'आं
by	राहें
cabbage	बंदगोभी
cabinet	कैबिनट
cage	पिंजरा
cake	केक
calf	कट्टा
calf	बच्छा
called	सद्देआ
call me	मिगी काल करो
call me	मिगी सद्दो
call	काल
call	सद्दो
calm	दा'वा
came	आया
campaign	म्हीम
Cancel	मुल्तवी
Cancel	रद्द
cancer	कैंसर
can't	नेईॆ करी सकदा
can	सकना
capable	समर्थ
capacity	थबीक
capacity	समर्था
capital	राजधानी
caption	कप्तान
capture	कब्जा करना
capture	फड़ना
career	पेशा
carefully	ध्यान कन्नै
careful	खबरदार
careless	लापरवाह्
caring	ममतालू
carpenter	तरखान
carpet	दरी
carrot	गाजर
carry on	लग्गे रवो
carry out	अंजाम देना
carry	लेई जाओ
car	कार
case	मसला
case	मामला
cash	नकद
castle	किला
castle	मैह्‌ल
cast	ढालना
casual	बे-ध्यान
catch	पकड़ो
category	वर्ण
category	श्रेणी
cattle	डंगर
cat	बिल्ली
caught	पकड़ो
cause	कारण
caution	चौकसी
cautious	खबरदार
cautious	चौकस
cave	गुफा
cease	बंद करना
ceiling	छत्त
celebrate	समारोह् मनाना
cell	कोठरी
cell	सेल
center	केंदर
center	बश्कार
center	सेंटर
century	शतक
cereal	गल्ला
ceremony	समारोह्
certainly	जकीनी
certain	जकीनी
certificate	सार्टिफिकेट
chain	कड़ी
chain	चेन
chain	लड़ी
chair	कुर्सी
challenge	चनौती
chance	मौका
change	बदलो
chaos	अफरा-तफरी
characteristics	खासियतां
character	चाल-चलन
charge	अलजाम
charge	औहदा-सम्हालना
charge	चार्ज
charity	दान
charming	चमकीला
charming	लिशकना
chart	नक्शा
chase	पिच्छा करना
chat	गल्ल-बात
chat	चैट
cheap	सस्ता
cheating	धोखा देना
cheat	धोखा देना
check	चेक
check	परखो
cheek	खाख
cheerful	जिंदादिल
cheers	तालियां
cheer	दाद
cheese	पनीर
chemistry	कैमीस्ट्रि
chemistry	रसैन
cherish	दुलारना
chess	शतरंज
chest	छाती
chew	गुआली करना
chew	चब्बना
chicken	कुक्कड़ू
chief	मकद्‌दम
chief	मुक्ख
chief	मुखिया
childhood	बचपन
children	ञ्याणें
child	बच्चा
chill	सर्द
chimneys	चिमनी
chin	ठुड्डी
chocolate	चाकलेट
choice	पसंद
choose	चुनो
chop	छांङना
chores	उबाऊ कम्म
chubby	गुग्गलू-मुग्गलू
church	चर्च
cinnamon	दालचीनी
circle	घेरा
circumstances	हालात
citizen	नागरक
citizen	शैह्‌री
city	शैहर
claim	दा'वा
clarify	सफाई देना
class	जमात
class	वर्ग
clay	मिट्टी
clean	साफ
clear	साफ
clerk	क्लर्क
clever	चलाक
client	गाहक
cliff	अंडी
cliff	पड़बी
cliff	पड़ी
cliff	फाट
climate	मौसम
climb	चढ़ना
clingy	लेसदार
clock	घड़ी
closet	नेड़मां
close	बंद
clothes	कपड़े
cloth	कपड़ा
cloth	टल्ला
cloudy	बदलोखा
cloud	बद्दल
clown	जोकर
clue	सराग
clue	सूह्
clumsy	नचज्जा
cluster	घुंगा
coach	कोच
coal	कोला
coast	कनारा
coat	कोट
coffee	काफी
cognitive	संज्ञानात्मक
coincidence	इत्तफाक
cold	ठंडा
cold	सर्द
collapse	डिग्गना
collar	पट्टा
colleagues	सैहकर्मी
colleague	सैहकर्मी
collection	संग्रैह्
collect	किट्ठा करना
college	कालेज
colorless green ideas slept furiously	colorless green ideas slept furiously
color	रंग
colour	रंग
column	थ'म्म
combination	मेल
combine	संयुक्त
comb	कंघा
come here	इत्थें आओ
come on	गल्ल मन्नो
come	आओ
comfortable	अरामदायक
comfort	अराम
coming soon	तौले आवै करदा
coming	औना
command	कमांड
command	हुकम
comment	टिप्पनी
comment	तबसरा
commercial	तजारती
commission	आढ़त
commission	दलाली
commitment	कौल
commitment	जबान
committed	पबंद
commit	पाबंद रौहना
commodity	पदार्थ
commodity	बस्त
common	सांझा
communicate	संचार करना
communication	संचार
community	समुदाय
commute	पाना
commute	लाना
companion	संगी
company	कंपनी
company	साथ
compare	मकाबला करना
comparison	मकाबला
compassionate	किरपालू
compassionate	क्यासी
compassion	जनून
compatible	मेलमां
compatible	संगत
competent	अख्तेयारी
compete	मकाबला करना
competition	मकाबला
competitive	मकाबले आहला
complaint	शकैत
complain	शकैत
complement	पूरक
completely	पूरी चाल्ली
complete	पूरा
complex	मुश्कल
compliance	पालमां
complicated	औक्खा
compliment	शरधांजली
comply	पालन करना
composition	बनावट
compound	हाता
comprehension	समझ
comprehensive	व्यापक
compromise	सुलह-सफाई
compulsory	जरूरी
compulsory	लाजमीं
computer	कंप्यूटर
concentrate	ध्यान देना
concept	धारना
concerned	फिकरमंद
concern	चैंता
concert	कंसर्ट
conclusion	निश्कर्श
concrete	पक्का
concrete	मजबूत
conditions	हालात
condition	हालात
conduct	चाल-चलन
conduct	सलूक
conference	इजलास
confess	इकबाल करना
confidence	जकीन
confidence	भरोसा
confident	बिश्वास पात्तर
confirm	तसदीक
conflict	झगड़ा
confused	परेशान
confusion	झमेला
confusion	धांदल
congrats	बधाई
congratulations	मबारक
congratulation	मबारक
conjunction	संगम
conjunction	संयोजन
connect	जोड़ना
conquer	जित्त
consciousness	सुध-बुध
consciousness	सुर्त
consciousness	होश
conscious	सचेत
consent	रजामंदी
consent	सैहमती
consequences	नतीजे
conservation	सांभ-सम्हाल
conservative	रूढ़िवादी
considered	मन्नेआ
consider	बचारना
consistency	नरंतरता
consistent	सिलसिलेवार
consist	बनावट
constantly	लगातार
constant	नरंतर
constipation	कब्ज
construction	नरमान
consume	खपत करना
consumption	खपत
contact	राबता
contagious	छूहती
contains	शामल
contain	शामल
contemporary	समकाली
contempt	नरादर
content	समग्गरी
contest	मकाबला
context	संदर्भ
continent	महाद्वीप
continue	जारी रक्खना
contract	करार
contract	ठेका
contrast	उलटा
contribute	जोगदान
contribution	जोगदान
control	काबू
controversial	झमेलेदार
convenience	स्हूलत
convenient	सौक्खा
conversation	गल्ल-बात
convert	बदलना
convey	सनेहा देना
convinced	संतुश्ट
convince	संतुश्ट करना
cooking	रुट्टी बनाना
cook	रसोइया
cook	लांगरी
cool	ठंडा
cool	बधिया
cooperation	सैहयोग
cope	सामना करना
copper	त्रामा
core	मुक्ख
corner	कोना
corner	नुक्कर
corn	चंडी
correct	स्हेई
costume	लाब्बा
cost	कीमत
cost	मुल्ल
cottage	कुल्ली
cotton	कपाह्
couch	सोफा
cough	खंग
could	सकदा
council	कौंसल
council	परिशद
counter	जवाबी
countryside	ग्राईं अलाके
country	देश
country	मुल्क
count	गिनना
couple	जोड़ा
courage	दलेरी
courage	हिम्मत
course	कोर्स
courtesy	खलूस
courtesy	नम्मरता
court	अदालत
court	कोर्ट
cousin	परतेर
cover	कवर
cover	जिल्द
coward	डरपोक
cow	गौ
cozy	अरामदेह्
crab	सरकाह्‌ड़
crack	दरेड़
craft	दस्तकारी
crap	बकोआस
crash	टक्कर
craving	चा
craving	चाह्‌त
craving	तमन्ना
crawl	रेंगना
crazy	खबती
crazy	जनूनी
create	बनाना
creative	तमीरी
credit	दुहार
creepy	मुश्कल
creep	मुश्कल
creep	रेगना
crew	चालक दल
crime	जुर्म
cringe	जी-हजूरी
crisis	संकट
criteria	पैमाना
critical	संगीन
criticism	अलोचना
crops	फसलां
crop	फसल
cross	पार करना
crowded	भोड़-भरोचा
crowd	भीड़
crown	ताज
crow	कां
crucial	म्हत्तवपूर्ण
cruel	जालम
cruise	क्रूज
crush	चूर-चूर करना
cry	रौना
cucumber	खीरा
cuddle	बिलङनी
culture	संस्कृति
cunning	चलाक
cunning	चालबाज
cunning	छातर
cupboard	लमारी
cup	कप
curb	रोक लाना
cure	ठीक करना
curfew	कर्फ्यू
curiosity	खतोला
curiosity	खरतोला
curious	उत्सुक
curly	घुंघराले
currency	करैंसी
currency	मुद्रा
currently	मजूदा
current	मजूदा
curse	बद-दुआ
curse	शराप
curtain	पड़दा
cushion	गद्दी
customer	गाह्क
customs	रवाज
custom	रवाज
cute	प्यारा
cut	चीर
cut	टक्क
cycle	सैकल
cycling	सैकल चलाना
daddy	पिता
daddy	प्यौ
daddy	बापू
dad	प्यौ
dad	बापू
daily	रोजना
dairy	डेरी
damage	खराब
damn	लानत
damp	जाबा
damp	सलाबी
dam	डैम
dam	ब'न्न
dance	डांस
dance	नाच
dangerous	खतरनाक
danger	खतरा
dark	न्हेरा
darling	प्यारा
darling	लाडला
dash	झपटा
dash	थपेड़
data	डेटा
data	समग्गरी
date	तरीक
daughter	धी
day	दिन
day	ध्याड़ा
deadline	समें-सीमा
dead	मरे दा
deaf	बोला
deal	सौदा
Dear All	प्यारे साथियो
Dear Customer	प्यारे गाह्क
Dear Parents	प्यारे माता-पिता
Dear Sir	श्रीमान
Dear students	प्यारे विद्यार्थियो
Dear Team	प्यारी टीम
dear	जिगरी
dear	लाडला
death	मौत
debate	बैहस
debit	दुहार
debris	मलबा
debt	कर्ज
debt	दुहार
decade	द्हाका
decay	त्रक्क
decay	त्रक्कड़
deceased	सुरग-बासी
deceive	धोखा देना
december	दिसंबर
decent	शायस्ता
decided	तैऽ
decide	तै करना
decision	फैसला
deck	ज्हाजै दी छत्त
decline	पतन
decrease	घटना
dedicated	समर्पत
dedication	अर्पण
dedication	त्याग
dedication	निश्टा
deed	करनी
deed	कारनामा
deep	डूंहगा
deer	हिरन
default	डिफाल्ट
defeat	हार
defend	हिफाजत करना
define	परिभाशा देओ
definitely	जरूर
definitely	पक्क
definition	परिभाशा
degree	डिग्री
delayed	चिरें
delay	चिर
delete	म्हेसना
deliberate	जानी-बुज्झियै करना
delicate	कुंगला
delicate	नरम
delicious	सुआदला
delighted	खुश
delight	खुशी
delight	मौज
delivered	सपुर्द कीता गेआ
delivery	सपुर्दगी
deliver	सपुर्द
demanding	मंग च होना
demand	मंग
democracy	जम्हूरीयत
democracy	लोक-राज
demonstrate	जलूस कड्ढना
demon	दैंत
demon	प्रेत
demon	बलाऽ
denied	इंकार कीता
density	गाढ़ापन
dentist	दंदे आहला डाक्टर
deny	मनाही
department	मैहकमां
departure	रवानगी
depend	मन्हस्सर
deploy	तैनाती
deposit	जमा
depressed	दलगीर
depression	दुआसी
depression	मलाल
depth	गैहराई
describe	वर्णन करना
description	ब्यौरा
desert	रेगस्तान
desert	रेगिस्तान
deserve	चाहना
designation	औहदा
design	डजैन
desire	अकांख्या
desk	डेस्क
despair	ओ हो
desperate	नराश
despite	बाबजूद
dessert	मठेआई
destination	मंजल
destiny	तकदीर
destiny	नसीब
destroy	तबाह् करना
destruction	तबाही
details	तफसील
detail	तफसील
detect	पता लाना
determination	इरादा
determination	संकल्प
determined	नरधारत
determine	मिथना
devastated	तैह्‌स-नैह्‌स
devastated	बरबाद
developed	तरक्कीयाफ्ता
development	तरक्की
development	बकास
develop	पैदा करना
device	डिवाइस
devil	शतान
devoted	श्रद्धालू
Dhivehi	दिवेही
diabetes	शूगर दी बमारी
diarrhea	दस्त
diary	रोजनामचा
dictionary	डिक्शनरी
did	कीता
died	मरी गेआ
diet	खराक
die	मरना
difference	फर्क
different	बक्खरा
difficult	औक्खा
dignity	मरजादा
dig	हुज्ज
diligent	मैह्‌नती
dinner	रातीं दी रुट्टी
dip	गोता
dip	गोत्ता
dip	टोह्‌बा
dip	डुबकी
direction	दिशा
director	डायरेक्टर
direct	प्रतक्ख
direct	सिद्धा
dirty	गंदा
dirt	गलाजत
dirt	मिट्‌टी
disabled	नकारा
disable	नकारा
disappear	गायब होना
disappointed	नराश
disaster	कैहर
discard	रद्द
discharge	छुट्टी
discharge	रिहाई
discipline	शास्तर
discount	छुट्ट
discount	डिस्कांउट
discover	खोज करना
discrimination	फर्कोफर्की
discussion	चर्चा
discuss	चर्चा करना
diseases	बमारी
disease	बमारी
disguise	सुआंग
disgusting	गंदा
disgusting	घनौना
dishes	पकवान
dishes	प्लेटां
dish	डिश
dish	प्लेट
dismiss	रद्द
dispatch	रवानगी
display	डिस्पले
disposal	नबेड़ा
dispute	झगड़ा
dispute	फसाद
distance	छिंडा
distance	बक्फा
distinct	टकोहदा
distinct	नमायां
distinguish	पंछानना
distinguish	फर्क करना
distress	अपगत
distress	आफत
distress	मसीबत
distribution	बंड
district	जि'ला
disturb	खलल पाना
ditch	खाई
diverse	भांत सभांता
diversity	बन्न-सबन्नता
dive	गोत्ता
dive	चलोभी
divide	बंड
divine	इलाही
divine	ईश्वरी
divorce	तलाक
dizzy	चक्कर
doctor	डाक्टर
document	दस्तावेज
doesn't	नेईं ऐ
does	करदा ऐ
Dogri	डोगरी
dog	कुत्ता
doing	करना
doll	गुड्डी
domain	बादशाही
domain	हद्द
domestic	घरेलू
dominant	हावी
donate	दान देना
done	होई गेआ
donkey	गधा
Don't worry	फिक्र नेईं करो
don't	नेईं
dope	सूध
dope	सैह्‌ल-सूतर
double	दुगना
doubt	शक्क
dough	पीठा
download	डाउनलोड
down	ख'ल्ल
do you love me	क्या तूं मिगी प्यार करनां
do you	क्या तुस
do	करो
draft	मसौदा
drag	खिच्चना
drain	बैह्‌ल
drama	ड्रामा
drawer	दराज
drawer	रखना
drawing	चित्तर
draw	खिच्चो
dread	कौफ
dread	खौफ
dread	दैह्‌शत
dread	हौल
dream	सुखना
dress	पैहनावा
drill	बरमा
drill	भ्यास
drink	पीना
drink	शराब
drive	ड्राइव
dropped	डिग्गेआ
drop	बूंद
drought	सोका
drunk	शराबी
dry	सुक्का
duck	बतख
dude	दोस्त
due to	इस करियै
due	देने जोग
dull	नकम्मा
dumb	ज'ल्ला
dump	ढेर
dump	दत्थर
duration	म्याद
during	दरम्यान
dust	खुक्खल
dust	गर्द
duty	ड्यूटी
dwell	बस्सना
dying	मरै करदा
each other	इक दुए
each	हर
eager	उत्सुक
eagle	इल्ल
earlier	पैहलें
early	सबेला
earn	कमाना
ears	कन्न
earthquake	भचाल
earth	धरत
ear	कन्न
ease	सैहलें
easily	सैह्‌लें
east	पूरब
easy	असान
easy	सखल्ला
eating	खाना
eat	खाओ
economic	आर्थक
economic	माली
economy	अर्थबवस्था
edge	कंढा
edge	कनारा
edge	सिरा
edit	तरमीम करना
education	तलीम
education	शिक्षा
effective	असरदार
effect	असर
efficiency	म्हारत
efficient	चतर
effort	जतन
eggplant	काबली-भट्टा
egg	अंडा
ego	हंकार
eighteen	ठारां
eighty	अस्सी
eight	अट्ठ
either	जां
elaborate	तफसील करना
elbow	आरक
elderly	बजुर्ग
elder	बड्डा
elegant	शानदार
element	तत्व
elephant	हाथी
eleven	ञारां
eligible	काबिल
eligible	जोग्य
eliminate	खतम करना
else	होर
embarrassed	शर्मिंदा
embarrassing	झित्था पौना
embrace	कलावा
embrace	झप्फी
emergency	अमरजैंसी
emerge	उब्भरना
emotional	जजबाती
empathy	हमदर्दी
emphasis	जोर
emphasize	जोर देना
employees	मलाजम
employee	नौकर
employer	नियोक्ता
employment	रुजगार
empty	खा'ल्ली
enable	समर्थ
encounter	टाकरा
encourage	दलासा
encourage	हौसला
endangered	खतरे च
endeavor	उट-नट
endeavor	उट्ट-निट्ट
endurance	दम
endurance	धरेठ
endure	भोगना
end	अंजाम
end	अंत
enemy	दुश्मन
energy	ऊर्जा
engaged	मशगूल
engagement	सगाई
engage	मसरूफ
engineer	इंजीनियर
engine	इंजन
English	अंगरेजी
enhance	बधाना
enjoy	नंद
enjoy	मजा
enormous	बराट-रूप
enough	खासा
enough	बत्हेरा
ensure	जकीनी करना
entertainment	मनोरंजन
enter	दाखल होना
enthusiasm	जोश
enthusiastic	जोशीला
entire	पूरा
entitled	हक्कदार
entity	कंपनी
entity	सत्ता
entrance	दाखला
entrance	दुआठन
entrepreneur	उद्यमी
envelope	लफाफा
environment	चपासम
environment	म्हौल
envy	ईरखा
envy	जलन
epic	महाकाव्य
epidemic	महामारी
equal	बरोबर
equipment	उपकरण
equipment	साजो-समान
equity	इक्विटी
equivalent	बरोबर
eraser	रबड़
error	गलती
error	त्रुटि
escape	बचना
especially	खास करियै
essay	मजमून
essay	लेख
essence	तत्त
essence	सार
essential	जरूरी
established	स्थापत
establish	स्थापत करना
estate	संपत्ति
estimated	अंदाजन
estimate	अंदाजा लाना
etc	बगैरा
eternal	सनातनी
ethics	धरम
ethics	नीति
evaluate	मूल्यांकन करना
evaluation	मूल्यांकन
evening	तरकालां
even though	बेशक्क गै
eventually	आखरकार
event	घटना
event	समारोह्
even	तगर
even	धोड़ी
even	सामां
everybody	हर कोई
everyone	सब्भै
everyone	हर कोई
everything	सब किश
every	हर
ever	कदें
evidence	सबूत
evil	शतान
evolution	विकास
evolve	विकसत करना
Ewe	एवै
exactly	बिलकुल स्हेई
exact	ऐन
exact	ठीक
exact	पूरा
examine	परखना
example	मसाल
exam	मतेहान
exceed	बधना
excellent	आ'ल्ला
excellent	सुआया
exception	अपवाद
except	छुट्ट
except	बगैरा
excessive	अति
excessive	बत्हेरा
excessive	बे-हद्‌द
excess	ज्यादती
exchange	बदलना
excited	जोश च
excitement	जोश
exciting	मजेदार
exclusive	खलोरोआं
excuse me	मिगी माफ करेओ
excuse	माफ करेओ
execute	तमील करना
execute	फांसी देना
execution	तमील
executive	कारजकारी
exercise	कसरत
exercise	भ्यास
exhausted	हुट्टे दा
exhaust	नकास
exhibition	नमैश
exhibit	दस्सना
existence	बजूद
existing	मजूदा
exist	नकास
exit	बाहर
expand	बस्तार करना
expected	लोड़चदा
expect	मेद करना
expenses	खर्चे
expensive	मैंहगा
experience	तजरबा
experiment	तजरबा
expert	माहिर
expired	समाप्त
explain	व्याख्या करना
explanation	बजाह्‌त
explanation	ब्याख्या
exploit	शोशन करना
explore	छान-बीन करना
export	बरामद करना
exposed	फाश
exposed	बे-पड़द
expose	फाश करना
exposure	दखावा
exposure	प्रदर्शन
expression	तरजमानी
expression	मल्हार
express	तेज
extended	बधामां
extend	बधाना
extension	बस्तार
extent	थाह्
extent	हद्द
external	बाहरी
extinct	लोप
extract	नचोड़
extract	रस
extraordinary	गैर-ममूली
extra	बाद्धू
extremely	जनूनी
extreme	बे-ब्हा
ex	पराना
eyes	अक्खां
eye	अक्ख
fabric	कपड़ा
fabric	बजाजी
fabulous	शानदार
face	चेहरा
facilitate	असान बनाना
facilities	स्हूलतां
facility	स्हूलत
factory	कारखाना
factory	फैक्टरी
factor	कारक
facts	तत्थ
fact	तत्थ
fade	मुरझाना
failed	नकाम
failure	नकामी
fail	नकाम
faint	गश
fairly	काफी
fairy	परी
fair	गोरा
fair	सुथरा
faithful	वफादार
faith	ईमान
faith	तबार
fake	नकली
fall	डिग्गना
false	गलत
fame	मश्हूरी
familiar	पंछानू
family	परिवार
famine	काल
famine	कैह्‌त
famous	मश्हूर
fancy	कल्पना
fancy	पसंद
fancy	फैंसी
fantastic	शानदार
fan	पक्खा
farewell	विदाई
farmer	करसान
farm	खेतर
far	दूर
fascinating	मोहत
fashion	फैशन
fast	तेज
fatal	मारू
fate	किसमत
father	प्यौ
father	बापू
fatigue	थकान
fatigue	हुट्टन
fat	मुट्टा
fault	गलती
favorite	पसंदीदा
favourite	पसंदीदा
favour	किरपा
favour	देया
favour	नवाजश
fear	डर
feast	जलसा
feast	जशन
feather	फंघ
features	खासियतां
feature	खासियत
feature	स्हूलत
february	फरवरी
fed up	अवाजार
feedback	फीडबैक
feed	खलाओ
feeling	मसूस करना
feel	मसूस करो
feet	पैर
fee	फीस
fellow	साथी
fell	डिग्गना
felt	मसूस
female	जनाना
female	जनानी
fence	तार
fertile	हैला
festival	त्यहार
festival	परब
fetch	कड्ढना
fever	बखार
fewer	घट्ट
few	किश
fiance	मंगेतर
fiction	कथा साहित्य
field	खेत्तर
fierce	घमासान
fifteen	पंदरां
fifty	पंजाह्‌
fighting	लड़ना
fight	लड़ाई
figure out	पता लाना
figure	आकृति
figure	मूरत
file	फाइल
file	मिसल
filled	दाखल
fill	भरना
film	फिल्म
filthy	गंदा
finally	आखरकार
finance	पैहा
finance	वित्त
financial	आर्थक
financial	माली
find out	पता लाना
find	तुप्पो
fine	जरमान्ना
fine	ठीक
finger	उंगली
finished	खतम
finished	मकम्मल
finish	पूरा करना
fire	अग्ग
firm	मजबूत
first name	पैहला नां
first	पैहला
fish	मच्छी
fit	फिट
fit	स्हेई
five	पंज
fixed	कैम
fixed	नरधारत
fix	स्हेई करना
flag	झंडा
flash	झमकारा
flash	झमाका
flash	झलक
flat	सामां
flawless	नरदोस
flawless	बे-दाग
flaw	खामी
flaw	नुक्स
flee	नस्सना
flesh	गेश्त
flew	डुआरी भरना
flexible	लचोला
flex	झकाना
flex	मोड़ना
flight	उड़ान
flight	डुआरी
flip	झटका देना
flip	टक्कर मारना
flirting	छेड़खानी करना
flirt	इश्कबाजी करना
flirt	ठरक भोरना
float	तरना
flood	हाड़
floor	फर्श
flour	आटा
flower	फुल्ल
flow	तंदीड़ी
flow	प्रवाह्
fluently	धड़ल्ले कन्नै
fluently	बिना रोक-टोक
fluent	तुरतुरा
fluffy	फलामा
fluid	तरल
flu	जकाम
flu	फ्लू
fly	उड्डना
focus	ध्यान देना
foggy	धुंदला
foggy	मन्हैरमां
fog	धुंद
fold	तैह्
folks	मित्तरो
following	दित्ता गेआ
follow up	जांच करना
follow	पालन करना
food	रुट्टी
foolish	झल्ला
foolish	डैंज्जा
fool	जड़
fool	मरखड़
football	फुटबाल
foot	पैर
forbidden	हराम
force	जोर
force	ताकत
forecast	पेशनगोई
forehead	मत्था
foreign	बदेसी
forest	जंगल
forest	जाड़
forever	उक्का
forever	म्हेशां
For example	मसाल दे तौर पर
forget	भुल्लना
forgive	माफ करना
forgot	भुल्लना
for instance	मासल लेई
fork	कांटा
formal	रसमी
former	साबका
form	अर्जी
form	दरखास्त
form	फार्म
fortunately	खुशकिसमती कन्नै
fortune	किसमत
forty-two	बताली
forty	चाली
forward	अग्गें
for you	तुंदे लेई
for	लेई
foster	पोशक
fought	लड़ेआ
foundation	बुनियाद
found	लब्भेआ
fourteen	चौदां
four	चार
fox	लूंबड़
fragile	नाजक
framework	ढांचा
framework	रूपरेखा
frame	खांचा
fraud	धोखा
freak	सनकी
freedom	अजादी
freedom	खु'ल्ल
freeze	जम्मी जाना
free	अजाद
free	खु'ल्ला
frequency	बारंबरता
frequently	अक्सर
frequent	अक्सर
fresh	ताजा
friday	शुक्रवार
fridge	फ्रिज
friendly	दोस्ताना
friendship	दोस्ती
friends	दोस्त
friends	मित्तर
friend	दोस्त
friend	मित्तर
frightened	डरे दा
frightening	डरौना
frog	डिड्डू
from	थमां
from	शा
front	अगला
frozen	जम्मे दा
fruit	फरूट
fruit	फल
frustrated	बे-मेद
fuel	कोला
fuel	तेल
fuel	लक्कड़ी
Fulfulde	फुलफुल्दे
full	पूरा
function	फंक्शन
function	समारोह
fundamental	बुनियादी
funeral	दाह्‌-संस्कार
funny	मजेदार
fun	मजा
furious	तैशी
furniture	फर्नीचर
furthermore	होर बी
further	होर
fur	फर
fur	बुर
future	भविक्ख
gain	फायदा
gain	लाह्
game	खेढ
gap	छिंडा
garage	गेराज
garbage	कचरा
garden	बगीचा
garlic	थोम
gate	गेट
gate	दरवाजा
gathering	किट्ठ
gather	किट्ठे होना
gauge	जाली
gave	दित्ता
gear	गियर
gender	लिंग
generally	आमतौर पर
general	आम
general	जनरल
generate	पैदा करना
generation	पीढ़ी
generous	दानी
generous	फराखदिल
genius	हुश्यार
genre	विधा
gentle	भलामानस
genuine	असली
gesture	शारा
get dressed	पाना
get dressed	लाना
getting	थ्होआ करदा
get up	उट्ठो
get well soon	तौैले ठीक होई जाहगेओ
get	आहनो
ghosting	भूत-प्रेती
ghost	भूत
giant	देऽ
giant	दैंत
gift	तोहफा
ginger	अदरक
girlfriend	गर्लफ्रेंड
girl	कुड़ी
given	दित्ते दा
give up	छोड़ना
give	देओ
glad	खुश
glance	झमाका
glance	झांक
glasses	शीशे
glass	शीशा
glimpse	छ्हाका
glimpse	झमकारा
glimpse	झमाका
global	आलमी
gloomy	दुआस
gloomy	निम्मो-झान
gloves	दस्ताने
glow up	चमको
glow	नखार
glue	सरेश
go ahead	अग्गें बधो
goals	मंजल
goals	लक्ष्य
goal	गोल
goal	मंजल
goat	बक्करी
go away	उठी जाओ
go away	नस्सी जाओ
god bless you	ईश्वर तुंदा भला करै
god	ईश्वर
goes	जंदा ऐ
going to	जा करनां
going	जाना
gold	सुन्ना
gone	गेआ
gonna	होने आहला
good afternoon	शुभ दपैहर
good bye	अलविदा
goodbye	अलविदा
good day	दिन चंगा होए
good evening	शुभ सं'ञ
good job	बड़ा शैल
good looking	रूपवान
good looking	शैल
good luck	कामयाबी
good morning my love	शुभ सबेर मेरी जान
good morning	शुभ सवेर
good night	शुभ रात्रि
goodnight	शुभ रात्रि
goods	समान
good	चंगा
good	शैल
Google	Google
Google Translate	Google Translate
goose	बतख
goo	चिपचिपा घिनौना पदार्थ
gorgeous	खूबसूरत
gorgeous	शानदार
gossip	गप्प
got it	समझी गेआ
go to bed	सौन जाओ
got	हासल होआ
government	सरकार
go	जाओ
grab	पकड़ना
grade	ग्रेड
grade	स्तर
gradually	बल्लें-बल्लें
graduate	ग्रैजुएट
grain	दाना
grain	नाज
granted	मंजूरशुदा
grant	ग्रांट
grapes	ङूंर
grasp	काबू
grasp	चुंगल
grasp	छुहाऽ
grass	घा
grateful	शुक्रगुजार
gratitude	शुकर
grave	कबर
gray	ग्रे
gray	धुंधला
great	बधिया
great	महान
greedy	लालची
greed	लालच
green	सैल्ला
green	हरा
greetings	दुआ-सलाम
greetings	बंदगी
greeting	शुभकामना
greet	दुआ-सलाम करना
grey	भुसला
grey	सलेटी
grid	ग्रिड
grief	मातम
grind	घोटना
grip	पकड़
grocery	करेआना
groom	चरबेदार
gross	कुल
ground	मदान
group	ग्रुप
group	जत्था
group	जुट्ट
group	जुंडली
growth	बाद्धा
grow	बधना
grumpy	सड़ू
Guarani	गुआरानी
guarantee	गरैंटी
guard	पैहरेदार
guess	अंदाजा
guest	मेहमान
guidance	रैहबरी
guide	गाइड
guilty	गलती
guys	दोस्त
guy	दोस्त
gym	कसरतखाना
gym	जिम
habitat	नवास
habit	आदत
had	हा
hail	ऐह्‌न
hair	बाल
half	अद्धा
hall	हाल
handle	हत्था
handle	हैंडल
handsome	बांकड़ा
handsome	रूपवान
hand	हत्थ
hang out	लटकाना
hang	टंगना
happened	घटत
happen	होना
happiness	खुशी
happy birthday to you	तुसेंगी साल-गिरह् दियां मबारकां
happy birthday	सालगिरह् मबारक
happy new year	नमें ब'रे दी मबारक
happy	खुश
hardly ever	शायद गै कदें
hardly	मसां-मसां
hard	सख्त
harmful	खतरनाक
harmony	थबाक
harmony	मेल-जोल
harm	नकसान पजाना
harsh	सख्त
harvest	पैदावार
has	ऐ
hate	नफरत
have a good day	तुंदा दिन शुभ होए
have a nice day	थुआढ़ा दिन शुभ होए
have breakfast	न्हारी करो
have fun	मजा करो
have you eaten	क्या तुसें खाई लेआ
have	होना
having	होना
hazard	जोखम
haze	धुंध
headache	सिर पीड़
head	सिर
healing	ठीक होना
healthy	नरोआ
health	सेहत
heal	ठीक होना
heard	सुनेआ
heart	दिल
hear	सुनो
heat	गर्मी
heaven	सुरग
heavy	भारी
hectic	मसरूफ दिन
he has	ओह् रखदा ऐ
height	उंचाई
heir	बारस
heist	डकैती
heist	लुट्ट
he is	ओह् ऐ
held	आयोजत
hello dear	हाय जान
hello how are you doing	नमस्ते, तुंदा केह् हाल-चाल ऐ
hello how are you	नमस्ते, केह् हाल-चाल ऐ
Hello	नमस्कार
hell	नर्क
helmet	हेल्मट
helpful	मदादी
help	मदाद
hence	तां
herd	इग्गड़
herd	झुंड
here	इत्थें
heritage	बरासत
her	ओहदी
hesitate	झक्कना
Hey	बै
he	ओह्
hidden	गुज्झा
hidden	गुप्त
hide	छिप्पो
hierarchy	औहदा-क्रम
hierarchy	मैंहतशाही
highlight	मुक्ख हिस्सा
high	उच्चा
hi how are you	हाय, तुस कियां ओ
hike	बढ़ोतरी
hiking	लम्मीं पैदल जात्तरा
hilarious	हास्सेदार
hill	प्हाड़ी
him	उसी
hint	शारा
hips	गुप्फी
hips	ढाक
hips	ढाका
hip	गुफ्फी
hire	कराए पर देना
hiring	भरथी
history	इतेहास
his	ओहदा
Hi there	नमस्ते
hit	मारो
Hi	नमस्ते
Hmm	हां
hobby	शौक
hold on	खड़ोवो
hold on	रूको
hold	पकड़ो
hole	सराख
holiday	छुट्टी
hollow	खा'ल्ली
homework	घरै दा कम्म
homework	होमवर्क
home	घर
honestly	शरेआम
honest	ईमानदार
Honey	प्यारा
Honey	शैहद
honor	सनमान
hood	हुड
hook	कुंडा
hopefully	मेद ऐ जे
hopeless	ना-मेद
hopeless	बे-आस
hope	मेद
hope	हीखी
hop	टपाकी
horizontal	आढा
horn	सिंङ
horrible	डरौना
horrible	दूस
horror	कौफ
horror	दैह्‌शत
horse	घोड़ा
hospitality	खातरदारी
hospitality	परौह्‌नचारी
hospital	अस्पताल
hostile	कीनाखोर
hostile	कीनेबाज
host	मेजबान
hotel	होटल
hot	गर्म
hot	तत्ता
hours	घैंटे
hour	घैंटा
household	घर
house	घर
how about you	तुस कि'यां ओ
how are you doing today	अज्ज थुआढ़ा केह् हाल ऐ
how are you doing	थुआढ़े केह् हाल-चाल न
how are you today	अज्ज तुंदा केह् हाल-चाल ऐ
how are you	थुआढ़ा केह् हाल ऐ
how do you do	तुस कियां ओ
however	उं'आं
how is	कनेह् न
how many	किन्ने
how much	किन्ना
how often	किन्नी बारी
how old are you	थुआढ़ी उमर केह् ऐ
how was your day	थुआढ़ा दिन कनेहा लंघेआ
how was your night	थुआढ़ी रात कनेही रेही
how	कि'यां
hubby	घरै-आहला
hubby	पति
hub	हब
huge	बड्डा
huge	बशाल
hug	जप्फी
human	मनुक्ख
humble	दीन
humidity	हुम्म
humidity	हुस्सड़
humid	तर
humid	सिल्ला
hundred	सौ
hungry	भुक्खा
hunt	शकार
hurricane	झक्खड़
hurricane	तफान
hurricane	बलूह्‌ना
hurricane	बा-बरोला
hurry up	तौल करो
hurry	तौल
hurt	ठेस पजाना
husband	कैंत
husband	घरै-आहला
hustle	तुन्न
hustle	धुस्स
hut	मुड़का
hygiene	सफाई
I am fine	में ठीक आं
I am	में आं
I can't	में नेईं करी सकदा
I can	में करी सकनां
ice cream	आईस क्रीम
ice	बर्फ
ideal	आदर्श
idea	बचार
idea	सोच
identical	हू-बहू
identify	पंछान करना
identity	पंछान
idiot	बेवकूफ
idle	नकम्मा
idle	बेकार
I do not know	मिगी नेईं पता
I do not understand	में नेईं समझनां
I don't know	मिगी नेईं पता
I don’t know	मिगी नेईं पता
I don't understand what you mean	मिगी समझ नेईं आवै करदा जे तेरा मतलब केह् ऐ
I don't understand you	में तुसेंगी नेईं समझदा
I don't understand	मिगी समझ नेईं आवै करदा
I don’t understand	में नेईं समझेआ
I don't	में नेईं
I do	में करनां
if	जेकर
ignore	नजरअंदाज करना
i guess	मिगी लगदा ऐ
I had	में लैता
I have been	में कीता ऐ
I have	मेरे कोल ऐ
I hope so	मिगी मेद ऐ
I know	में जाननां
I like you	में तुगी पसंद करनां
I like	मिगी पसंद
illegal	नजैज
illness	बमारी
illness	मांदगी
ill	बमार
ill	मांदा
Ilocano	इलोकानो
I love my big brother	मिगी मेरी बड्डी भ्रा कन्नै लगाऽ ऐ।
I love my big sister	मिगी मेरी बड्डी भैनु कन्नै लगाऽ ऐ।
I love my father	में अपने पिता कन्नै प्यार करनां
I love my little brother	में अपने लौह्‌के भ्रा कन्नै प्यार करनां
I love my little sister	में अपनी लौह्‌की भैनु कन्नै प्यार करनां
I love my mother	में अपनी मां कन्नै प्यार करनां
I love you so much	में तेरे कन्नै बड़ा हिरख करनां
I love you too	में बी तेरे कन्नै हिरख करनां
I love you	में तुगी हिरख करना
I love	में हिरख करनां
image	इमेज
image	बिंब
image	बुत्त
imagine	सोचना
I mean	मेरा मतलब ऐ
I'm fine	में ठीक आं
I'm good	में ठीक आं
I'm here	में इत्थें आं
I miss you so much	में तुगी बड़ा चेता करै करनां
I miss you	मिगी थुआढ़ा चेता औंदा ऐ
immediately	फौरन
immediate	फौरन
immense	बराट-रूप
impact	असर
impatient	काहला
implement	लागू करना
important	जरूरी
import	दरामद
impose	लागू करना
impossible	ना-मुमकन
impression	असर
impressive	शानदार
impress	मतासर करना
improvement	तरमीम
improvement	सधार
improve	सुधारो
I'm sorry	मिगी माफ करो
I'm	में
I’m	में
in addition	दे अलावा
in addition	दे छुट्ट
inappropriate	ना-मनासब
incentive	प्रोत्साहन
incident	घटना
include	शामल
including	सनें
including	समेत
income	औंदन
inconvenience	तकलीफ
increased	बधामां
increase	बधाओ
incredible	राहनगी भरोचा
indeed	जकीनन
independent	अजाद
India	इंडिया
India	भारत
indicate	सारत करना
indigenous	देसी
individual	निजी
individual	माहनू
industry	उद्योग
inevitable	अटल
In fact	असल च
infant	ञ्याना
infection	इनफ़ेक्शन
infinity	बे-स्हाब तदाद
inflammation	सोज्जा
inflation	मैंहगाई
influence	असर-रसूख
influence	प्रभा
information	जानकारी
inform	जानकारी देना
in front of	दे सामनै
ingredients	समग्गरी
inheritance	बरासत
inheritance	बिरसा
initial	मुंढला
initiative	पैहल
injured	जख्मी
injury	जख्म
innocent	बेकसूर
innovation	नमांचार
in order to	दे लेई
inquiry	पड़ताल
insane	पागल
insect	कीड़ा
insecure	अ-सुरक्खत
insert	दाखल करना
inside	अंदर
insight	अंदर
insist	जोर देना
insomnia	नींदर नेईं औना
inspiration	प्रेरना
inspire	प्रेरना देना
install	इंस्टाल
install	स्थापत करना
instance	नमूना
instance	मसाल
instant	फौरी
instead of	बजाए
instead of	सगुआं
instead	बजाए
instructions	हदैतां
instrument	उपकरण
instrument	संदर
insult	बेजती
insurance	बीमा
intact	सालम
integrity	एकता
intellectual	बचारक
intellectual	बौद्धक
intelligence	अकल
intelligence	दनाई
intelligence	दमाग
intelligence	बुद्धि
intelligent	समझदार
intended	लोड़चदा
intend	लोड़चदा
intense	जबरदस्त
intention	इरादा
interaction	गल्ल-बात
interact	मेलजोल करना
interested	दिलचस्प
interesting	दिलचस्प
interest	दिलचस्पी
interfere	दखलअंजादी
intermediate	मझाटला
internal	अंदरूनी
international	अंतरराश्ट्री
international	आलमी
internship	सखलाई
interpreter	दुभाशिया
interpret	व्याख्या
interrupt	खलल पाना
interview	इंटरव्यूह्
intimate	इकसार
intimate	करीबी
intimate	गाढ़ा
into	च
introduce	पंछान करोआना
introduction	परिचे
introvert	अंतर्मुखी
intuition	भड़ाऽ
invalid	अमान्य
inventory	बीजक
inventory	सूची
invent	खोज
investigate	तफ्तीश करना
invest	निवेश
invest	रास
invitation	नींदरा
invitation	बुलावा
invite	साद्दा देना
invoice	चलान
involved	शामल होना
involve	शामल
in	च
iron	लोहा
I see	समझेआ
island	टापू
isolated	नखेड़मां
issues	मुद्दे
issue	मुद्दा
is	ऐ
items	चीजां
item	चीज
item	मद्‌द
I think	में समझना
it is	एह् ऐ
It's okay	ठीक ऐ
it's ok	ठीक ऐ
its	एहदा
it's	एह्
it was	एह् हा
it	एह्
I understand	में समझनां
I want to see you	में तुसेंगी दिक्खना चाहन्नां
I want you	में तुगी चांहन्ना
I want	में चाहन्नां
I was	मे हा
I will	में करङ
I would be	मेरा होग
I	में
jacket	जैकट
jail	जेल
jail	जेलखाना
January	जनवरी
jar	ब्याम
jar	मर्तवान
jaw	जबड़ा
jealous	जलनखोर
jerk	झटका
jewelry	टूंबा
job	कम्म
job	नौकरी
jogging	जागिंग
joint	जोड़
joint	सांझा
join	शामल होना
joke	चुटकला
journalist	पत्रकार
journey	जात्तरा
joy	नंद
joy	मजा
judge	जज
juice	जूस
july	जुलाई
jump	छाल
june	जून
junk	कचरा
just do it	सिर्फ करी ओड़
justice	इंसाफ
justice	न्यांऽ
justify	बजाहत सिद्ध करना
just	हूनै
Kalaallisut	कलाल्लिसुत
keen	उत्सुक
keen	शौंकी
keep it up	लग्गो रवो
keep	रक्खो
kept	रक्खना
kettle	केतली
key	चाबी
kick	ठुड्डा मारना
kidding	मजाक करना
kidney	गुरदा
kids	बच्चे
kid	बच्चा
kill	मारना
kinda	किसम दा
kindly	किरपा करियै
kindness	किरपा
kindness	भलाई
kind	किरपालू
kind	तरसी
king	राजा
kiss	पप्पी
kitchen	रसोई
kite	गुड्डी
kitten	बलूंगड़ा
knee	गोड्डा
knew	जानदा हा
knife	काचू
knight	जोद्धा
knowledge	ज्ञान
known	पनछानू
known	बाकफ
known	भाखा
know	जानो
Konkani	कोंकणी
Krio	क्रियो
label	ठप्पा
labor	काम्मा
labor	मजूर
labour	मजूर
lack	कमी
lack	घाट
ladder	पंजांग
lady	जनानी
laid	रक्खना
laid	लटाना
lake	झील
lamb	मेमना
lame	लंगड़ा
lamp	दिया
lamp	लैंप्प
landscape	कुदरती नजारा
land	जमीन
language	जुबान
language	भाशा
lap	गोद
lap	झोल
large	बड्डा
last but not least	अखीरी पर घट्ट नेईं
last name	अखीरी नां
last	अखीरी
last	अंतम
lately	हाल च गै
later	बाद च
latest	ताजा
late	चिरें
latter	पिछला
laughing	हस्सना
laughter	हास्सा
laugh	हास्सा
launch	लांच
laundry	धोबीघर
lawn	घा दा मदान
lawyer	बकील
law	कनून
layer	परत
layout	खाका
lay	रक्खना
lazy	सुस्त
leader	नेता
leader	लीडर
lead	प्रमुख
lead	सेध
leaf	पत्ता
leak	चोना
lean	लिस्सा
leap	छड़प्पा
learning	पढ़ाई
learn	सिक्खेआ
lease	ठेका
lease	पटा
least	घट्ट
leather	चमड़ा
leaves	पत्ते
leave	छुट्टी
leave	निकलो
left	छड्डो
legacy	बरासत
legal	कनूनी
legend	म्हान
legit	कनूनी
leg	जङ
leg	लत्त
leisure	बेहल
lend	दुहार
length	लंबाई
lesson	ध्याऽ
lesson	पाठ
less	घट्ट
letter	चिट्ठी
lettuce	लेटिश
let	जान देओ
let	मन्नी लैओ
level	लेवल
level	स्तर
leverage	लाह् कमाना
liability	देनदारी
library	लाइब्रेरी
lick	लपाका
lies	लम्में पेदे होना
lie	झूठ
life	जीवन
lift	चुक्को
lift	लिफ्ट
lightning	बिजली पौना
light	लो
likely	मुमकन
likewise	उं'आं गै
like	पसंद
line	कतार
line	पंगती
Lingala	लिंगाला
link	जोड़
link	तल्लक
link	तार
link	राबता
lion	शेर
liquid	तरल
listening	सुनना
listen	सुनो
list	फेरिस्त
list	लिस्ट
literally	सच्चे
literature	अदब
literature	साहित्य
litter	कूड़ा
little	घट्ट
little	लौहका
liver	कलेजा
lives	रौंहदा ऐ
live	जींदा
live	लाइव
living room	बैठक
living	रौहना
lizard	किरली
lizard	कोढ़-किरली
load	भार
loaf	टुक्कर
loaf	बंद-रुट्टी
loan	कर्ज
loan	लोन
local	मकामी
location	थां
location	थाहर
lockdown	तालाबंदी
lockdown	लाकडाउन
lock	जंदरा
log	लट्ठा
lol	गड़ाका मारियै हस्सना
lonely	इक्कला
long time no see	बड़े टैम थमां नेईं मिले
long	लम्मां
look	दिक्खो
loop	घरबाई
loop	लुप्पी
loose	ढिल्ला
lord	नाथ
lord	सरदार
lord	सांई
lord	साह्‌ब
lose	ढिल्ला
loss	नकसान
lost	गुआचे दा
lot	बंड
lot	हिस्सा
loud	मुखर
lounge	लाउंज
lovely	प्यारा
love you	मिगी तेरे कन्नै हिरख ऐ
love	हिरख
lower	हेठला
low	घट्ट
low	हेठ
loyalty	वफादारी
loyal	वफादार
lucky	खुशकिसमत
luck	किसमत
Luganda	लुगांडा
luggage	समान
lump	भिक्कड़
lunch	सब्हैरी
lungs	फेफड़े
luxury	आलीशान
lying	झूठ बोलना
machine	मशीन
madam	साहिबा
made	बनाए दा
mad	पागल
magazine	रसाला
magnificent	आलीशान
magnificent	शानदार
maid	टैहलन
maid	नौकरानी
maintain	बनाई रक्खना
maintenance	सांभ-सम्हाल
main	मुक्ख
Maithili	मैथिली
majority	बहुमत
major	मुक्ख
make up	मेक-अप
make up	शंगार
make	घाट
male	मर्द
mall	माल
management	प्रबंध
management	सरिस्ता
manager	मैनजर
manage	प्रबंध करना
mandatory	लाजमीं
manifest	परतक्ख
manifest	प्रगट
manipulate	अट्‌ट-नुट्‌ट करना
manipulate	कारस्तानी करना
manner	कायदा
manner	ढंग
manner	तरीका
manual	हत्थी
many many happy returns of the day	एह् दिन बार-बार आवै
many	केईं
many	मते सारे
man	माह्‌नू
march	मार्च
margin	मनाफा
margin	हाशिया
market	बजार
marriage	ब्याह्
married	ब्होतर
mask	मास्क
massive	बराट
mass	भर-भरा
master	मालक
master	मास्टर
match	मेल
match	मैच
material	समग्गरी
mate	साथी
math	स्हाब
matter	मुद्दा
maturity	म्याद पुग्गना
maybe	होई सकदा ऐ
may	होई सकदा
meal	रुट्टी
meaning	मतलब
means	जरिया
means	ढंग
meant	मतलब
meanwhile	इस्सै दरान
mean	कमीना
mean	जलील
measures	तरकीब
measures	थाह्‌
measures	पैमाना
measure	उपा
meat	मीट
medical	डाक्टरी
medical	मेडिकल
medicine	दुआई
meditation	तप
meditation	तपस्सेआ
meditation	ध्यान
medium	दरम्याना
meeting	मलाटी
meet	मिलो
Meiteilon	मैतैलोन
melt	पिघलना
memories	यादां
memory	जादाश्त
mental	जैह्‌न्नी
mental	मानसक
mentioned	जिकर कीते दा
mention	जिकर
mentor	उस्ताद
merchant	बपारी
mercy	रैहम
merely	सिर्फ
merry christmas	क्रिसमिस दियां शुभकामनां
message	सनेहा
messy	गंदा
mess	धांदली
mess	मेस
metal	धातु
method	ढंग
method	तरीका
me too	में बी
me	में
mice	चूहे
middle	बश्कार
midnight	अद्धी रात
might	होई सकदा
mild	मलैम
milestone	बुर्जी
military	फौज
milk	दुद्ध
million	दस लक्ख
million	मिलियन
mindset	मानसकता
mind	दमाग
mine	मेरा
mingle	शामल होना
minor	ना-बालग
minor	लौहका
minutes	मिंट्ट
minute	मिंट्‌ट
miracle	कमाल
miracle	करामात
mirror	शीशा
miscellaneous	फुटकर
mischievous	शतान
miserable	दीन
misery	जफर-जाल
misery	तड़फाट
misery	दीनता
missing	गुआचे दा
mission	मिशन
mission	म्हीम
miss you	तेरा चेता औंदा ऐ
miss	कुमारी
mistake	गलती
mist	धुंद
mist	धूड़
Mizo	मिजो
mobile	मोबाइल
mock	दखावटी
mock	नकली
model	नमूना
model	माडल
moderate	दरम्याना
modern	अजकना
modest	सिद्धा-सादा
moisture	नमीं
moisture	बत्तर
moist	आदरा
moist	बतरैला
moist	बत्तरा
moist	सल्हाबा
mold	बौल
mold	सांचा
mole	तिल
moment	पल
mom	मां
monday	सोमवार
money	पैहा
monitor	मानीटर
monkey	बांदर
month	म्हीना
moody	मूडी
mood	मूड
moon	चन्न
moral	खलाकी
moral	नैतक
moreover	सुआए एहदे
more	होर
morning	बड़ला
morning	भ्याग
mortgage	रैहन
mostly	ज्यादातर
most	मते
mother	मां
motion	गति
motivation	पुआध
motivation	प्रेरणा
mountain	प्हाड़
mouse	चूहा
mouth	मूंह्
movement	अंदोलन
movement	तैहरीक
move	सरक
movie	मूवी
mrs	श्रीमती
much	मता
mud	चिक्कड़
mug	मग
muscle	पट्‌ठा
museum	अजैबघर
mushroom	खुंब
mushroom	छतड़ी
music	संगीत
must	जरूर
mute	म्यूट
mute	शांत
mutual	आपसी
My dear	मेरी जान
my friend	मेरा दोस्त
My hovercraft is full of eels	मेरी होवरक्राफ्ट बाम-मच्छी कन्नै भरोची दी ऐ।
my love	मेरी जान
my name is	मेरा नां ऐ
my pleasure	मेरी खुशकिसमत
myself	आपूं
mysterious	गुज्झा
mystery	पिरब
mystery	भेत
myth	ढिच्चर
my	मेरा
nail	नैंह्
naive	बलल्ला
name	नां
narrative	अफसाना
narrative	क्हानी
narrow	तंग
nasty	बे-शकल
nationality	राश्ट्रीयता
national	कौमी
national	राश्ट्री
native	मूल
natural	कुदरती
nature	कुदरत
nausea	कैंह्‌क
nearby	नेड़मां
nearly	तकरीबन
near	कोल
near	नेड़ै
neat	साफ
necessary	जरूरी
necklace	हार
neck	मुंडी
need	लोड़
negative	नेईं
neglect	नकारे दा
negotiate	गल्ल-बात करना
negotiate	वार्ता करना
neighborhood	गुआंढ
neighbor	गुआंढी
neither	कोई नेईं
nephew	भनेहा
nerd	बेवकूफ माहनू
nervous	बे-चैन
nest	आहलड़ा
network	नेटवर्क
net	जाल
neutral	बे-लाग
never give up	कदें हौसला नेईं छोड़ो
never mind	कोई गल्ल नेईं
nevermind	कोई गल्ल नेईं
nevertheless	फ्ही बी
never	कदें नेईं
news	खबर
new	नमां
next to	दी बगल च
next	अगला
nice to meet you	थुआढ़े कन्नै मिलियै चंगा लग्गा
nice	चंगा
nice	शैल
niece	भनेई
nightmare	दबा
night	रात
nineteen	उन्नी
ninety	नब्बै
nine	नौ
nobody	कोई नेईं
noise	नक्क
noisy	शोर-शराबेदार
none	कोई नेईं
noon	दपैह्‌र
nope	नेईं
no problem	कोई परेशानी नेईं
normal	आम
north	पच्छम
nor	ते नेईं
nose	नक्क
nostalgic	घरै दी याद च दुआस
not at all	बिल्कुल नेईं
not bad	माड़ा नेईं
noted	नामी
note	नोट
nothing	किश नेईं
noticed	ध्यान
notice	इत्तलाह्
notice	नोटिस
Not now	अजें नेईं
not yet	अजें नेईं
not	नेईं
nouns	संज्ञा
noun	संज्ञा
novel	उपन्यास
november	नवंबर
nowadays	अज्जकल
no way	बिलकुल नेईं
now	हूनै
No	नेईं
nuisance	इल्लत
null	शून्य
null	सिफर
number	नंबर
numb	सुन्न
nurse	नर्स
nutmeg	जैफल
nutrition	पोशन
nut	खरोट बगैरा
oath	शपथ
oath	सगंध
obesity	मुटापा
obey	हुकम-अदूली
objective	उद्देश
object	चीज
obligation	जिम्मेबारी
obscure	क्हैबरा
observation	टिप्पनी
observe	ध्यान कन्नै दिक्खना
obsessed	फतूरी
obsession	फतूर
obsolete	चलन-बाहरी
obsolete	पराना
obstacle	अड़ंगा
obstacle	अड़चन
obtained	हासल
obtain	हासल करना
obviously	जाहर तौर पर
obvious	साफ-साफ
occasionally	कदें-कदालें
occupation	कम्म-धंदा
occupation	पेशा
occupied	कब्जाए दा
occurred	घटत
occurs	होंदा ऐ
occur	घटना होना
ocean	समुंदर
october	अक्तूबर
odds	ओपरा
odd	अजीब
of course	बेशक्क
offensive	नरादरी
offer	पेशकश
office	दफ्तर
official	सरकारी
off	बंद
often	अक्सर
of	आहला
of	दा
oh really	क्या सच्चें
Oh	हाय
oil	तेल
okay baby	ठीक ऐ जान
okay dear	ठीक ऐ जान
okay honey	ठीक ऐ जान
okay my love	ठीक ऐ मेरी जान
okay	ठीक ऐ
ok dear	ठीक ऐ जान
ok honey	ठीक ऐ जान
ok my love	ठीक ऐ मेरी जान
ok	ठीक ऐ
old	पराना
once	इक बारी
one language is never enough	इक भाशा कदें बी बत्हेरी नेईं होंदी
one	इक
onion	गंढा
online	आनलाइन
only	छड़ा
only	सिर्फ
on	पर
open	खु'ल्ला
operation	अपरेशन
opinion	मत
opinion	राय
opportunities	मौके
opportunity	मौका
opposite	उलट
optimistic	आशावान
optional	विकल्पी
option	चारा
option	विकल्प
orange	संत्तरा
order	तरतीब
order	हुकम
ordinary	ममूली
organization	इदारा
organization	संस्था
orientation	ओरीएन्टेशन
original	असली
original	मूल
origin	मुंढ
Oromo	ओरोमो
orphan	अनाथ
orphan	जतीम
or	जां
otherwise	नेईं ते
other	बाकी
other	होर
ought	चाहिदा
Our mission: to enable everyone, everywhere to understand the world and express themselves across languages.	साढ़ा मिशन : हर कुसै गी, हर थाहर दुनिया गी समझने ते भाशाएं च खुद गी बुहास्सरने च समर्थ बनाना।
Our mission: to organize the world's information and make it universally accessible and useful.	साढ़ा मिशन : दुनिया दी जानकारी गी बवस्थत करना ते इसी सार्वभौमक रूप कन्नै पुज्ज-जोग ते लाहकारी बनाना।
our	साढ़ा
outcome	नतीजा
outfit	संगठन
outgoing	बाहरी
outlet	नकास
outlet	सराख
outline	रूपरेखा
outside	बाहरी
outstanding	बकाया
out	बाहर
oven	ओवन
overall	कुल मलाइयै
overcome	काबू पाना
over there	उत्थें
overthinking	मता सोचना
overwhelmed	घबराए दा
overwhelming	भारा
overwhelming	भारू
over	उप्पर
over	खतम
owe	कर्जदार होना
owl	उल्लू
owner	मालक
own	अपना
ox	ढग्गा
ox	बलद
pace	रफ्तार
package	गंढ
pack	गंढ
pack	ढान
paid	भुगतान कीते दा
painting	चित्तरकारी
paint	पेंट
paint	रोगन
pain	पीड़
pair	जोड़ा
pale	भुस्सा
palm	तली
pandemic	महामारी
panic	भाजड़
pants	पतलून
pan	पैन
paper	कागज
paradise	सुरग
parallel	कन्नै-कन्नै
parcel	पार्सल
pardon	माफी
parents	मां-प्यौ
park	पार्क
park	बगीचा
parrot	तोता
parsley	जबैन
participate	हिस्सा लैना
particularly	खास करियै
particular	चेचा
partner	भ्गाल
party	पार्टी
part	हिस्सा
passage	रस्ता
passage	राह्‌
passage	लांघा
passed	बतीत
passionate	जनूनी
passion	जजबा
passive	न्हूस्ती
password	पासवर्ड
pass	पास
past	अतीत
patch	गंढान
patch	गांढा
patch	टाकी
patch	लुप्पी
pathetic	नां-उम्मीद
pathetic	माड़ा
path	बत्त
path	रस्ता
patience	सब्र
patient	धरेठी
patient	सील
pattern	ढंग
pattern	तरतीब
pattern	नमूना
pause	बराम
pavement	फुटपाथ
payment	भुगतान
pay	तनखाह्
peaceful	शांत
peace	रमान
peace	शांति
peach	आड़ू
peak	टीह्‌सी
pear	नाख
peas	मटर
peculiar	अजब
peculiar	नराला
peel	सिक्कड़
peers	साथी
peer	जोड़
pee	पशाब
pee	मूत्तर
pencil	पेंसिल
pending	बकाया
pen	कलम
pen	पेन
people	लोक
pepper	काले मर्च
pepper	लूनकी
perceive	समझना
perception	सूझ
perfect	पूरण
performance	कारकर्दगी
perform	कारकर्दगी करना
perhaps	कुश्वै
period	म्याद
permanent	पक्का
permanent	मुस्तकल
permission	इजाजत
permission	मंजूरी
permit	परमट
permit	मन्जूरी
perseverance	सम्हाल
persistent	जिद्दी
personality	शखसीयत
personal	निजी
person	माहनू
perspective	पारखी
persuade	राजी करना
pervert	ठर्की
pet	पालतू
phase	फेज
phase	हिस्सा
phenomenon	घटना
philosophy	दर्शनशास्तर
phone	फोन
photo	फोटू
phrase	उक्ति
phrase	वाक्य
physical	जिसमानी
pick up	चुक्कना
pick	चुनो
picture	तसवीर
pieces	टोटे
piece	टुकड़ा
piece	टोटा
pigeon	कबूतर
pig	सूर
pile	ठाला
pile	ढेर
pile	तमार
pillow	सरहैना
pilot	पायलट
pineapple	अनानास
pink	गलाबी
pin	पिन
pitch	पिच
pitch	सुर
pity	क्यास
pit	खप्पा
pit	खुड्ढा
places	थाहर
place	थां
place	थाहर
plague	प्लेग
plain	साद्दा
plane	ज्हाज
plane	साद्दा
plants	पौधे
plant	बूहटा
plan	तरकीब
plan	प्लान
plate	प्लेट
platform	प्लेटफार्म
platform	मंच
playing	खेढना
play	खेढो
play	नाटक
pleasant	नंददार
pleasant	मजेदार
pleased	खुश
pleased	परसिन्न
please	किरपा करियै
pleasure	नंद
pledge	सगंध
plenty	खासा
plenty	मता
plot	प्लाट
plug	प्लग
plumber	नलसाज
plumber	पलंबर
plum	आलूबखारा
plural	बहुवचन
podcast	पाडकास्ट
poem	कविता
poetry	कविता
poetry	काव्य
point	नुक्ता
poison	जैहर
police	पुलस
policy	नीति
policy	पालिसी
polite	तमीजदार
polite	सम्मी
pollution	प्रदूशण
pond	छप्पड़
pool	तलाऽ
poop	बेवकूफ
poor	गरीब
popular	मश्हूर
population	अबादी
pop	पाप
pork	सूरै दा मीट
porridge	दलिया
port	पोर्ट
port	बंदरगाह्
position	थां
position	थाहर
position	हालत
positive	बेफिक्र
possession	कब्जा
possessive	मालिकाना
possess	काबू करना
possess	हासल करना
possible	मुमकन
postpone	मुल्तवी करना
post	औहदा
potato	आलू
potential	थबीक
potential	समर्था
pound	पौंड
poverty	गरीबी
powerful	ताकतवर
power	ताकत
practical	ब्यहारी
practice	करत-विद्या
practice	दस्तूर
praise	तरीफ
prank	मजाक
prank	र्‌हेड़
prank	शरारत
pray	भजना
pray	शकार
precious	कीमती
precisely	जकीनन
precisely	ठीक-ठीक
precise	दरुस्त
predict	पेशीनगोई करना
preference	तरजीह्
prefer	तरजीह्
prefer	पैहल
pregnant	आशाबैंती
pregnant	गब्भन
prejudice	पक्खपात
premises	अहाता
premium	किस्त
preparation	तेयारी
prepared	तेयार
prepare	तेयार होना
preposition	पूर्वसर्ग
presence	मजूदगी
presentation	पेशकश
present	नजराना
present	मजूद
present	हाजर
preserve	सम्हालना
president	प्रधान
president	राश्ट्रीपति
pressure	जोर
pressure	दबा
press	प्रेस
pretend	ब्हान्ना करना
pretty	रूपवान
pretty	शैल
prevent	बचाओ
previous	पिछला
prey	शकार
price	कीमत
price	मुल्ल
pride	फख्र
priest	पजारी
primary	मुंढला
primary	शुरुआती
prime	मुक्ख
princess	राजकुमारी
principal	प्रिंसिपल
priority	तरजीह्
prior	पैहलें
prison	कैद
prison	जै'ल
privacy	निजता
private	निजी
privilege	स्हूलत
prize	ईनाम
probably	खबरै
problem	परेशानी
procedure	ढंग
procedure	तरीका
proceed	अग्गें बधो
process	प्रक्रिया
produce	पेश करना
produce	पैदावार
production	उत्पादन
product	उत्पाद
professional	पेशेवर
profession	पेशा
profile	प्रोफाइल
profit	फायदा
profit	लाह्
profound	गंभीर
profound	गैह्‌रा
progress	तरक्की
project	प्रोजैक्ट
prominent	मन्नेआ-परम्मनेआ
promise	कौल
promise	जबान
promote	प्रचार करना
promotion	तरक्की
prompt	शताबा
prone	झुके दा
pronouns	सर्वनाम
pronunciation	उच्चारण
proof	सबूत
properly	चंगी-चाल्ली
properties	गुण
property	जैदाद
proper	जायज
proposal	मसौदा
prospect	तुप्पना
prospect	मेद
prosperity	खुशहाली
prosperous	खुशहाल
protect	हिफाजत करना
proud	फक्र
prove	साबत करना
provided	बशर्ते
provide	मुहैया करना
province	सूबा
provision	प्रावधान
provision	सरिस्ता
puberty	जुआनी-रंभ
public	जनता
public	लोक
pull	खिच्चना
pumpkin	कद्दू
punctual	पाबंद
pupil	विद्यार्थी
purchase	खरीद
pure	शुद्ध
purple	काशनी
purpose	उद्देश
purse	पर्स
pursue	लक्ष्य रक्खना
pursuit	कसब
push	धक्का देना
put	रक्खो
qualification	काबलियत
qualification	जोगता
quality	म्यार
quantity	मिकदार
quarantine	क्वारंटाइन
quarrel	जप्फी
quarrel	लड़ाई
quarter	म्हल्ला
Quechua	केचुवा
queen	रानी
queer	बिलक्खन
query	प्रश्न
query	सुआल
question	सुआल
queue	कतार
quickly	तुर्त
quickly	फौरन
quick	फौरन
quiet	खमोश
quiet	शांत
quilt	रजाई
quite	बिलकुल
quit	छोड़ना
quiz	मकाबला
quotation	भा
quotes	उद्धरण
quote	हवाला
rabbit	खरगोश
rabbit	पत्तर-साहेआ
race	दौड़
rage	करोध
rage	करोप
rain	बरखा
raised	बधाया गेदा
raise	बधाओ
random	बे-तरतीबी
range	हद्द
ran	दोड़ेआ
rapidly	तेजी कन्नै
rapid	तेज
rapid	रैपिड
rarely	कदें-कदाएं
rare	ओपरा
rare	टामां
rash	जल्दबाज
rash	दलेर
rate	दर
rate	रेट
rather	बल्के
rational	बौद्धक
ratio	शरह्
rat	चूहा
raw	कच्चा
reached	पुज्जी गेआ
reach	पुज्ज
reaction	प्रतिक्रिया
reading	पढ़ाई
ready	तेयार
read	पढ़ो
reality	असलीयत
reality	क्हीकत
realized	अहसास होआ
realize	अहसास
really	सच्चें
real	असल
rear	पिछला
reasonable	बाजब
reason	कारण
recall	मुड़-सद्दना
receipt	रसीद
received	हासल
receive	हासल करो
recently	हालिया
recent	हालिया
reception	अगवाई
recipe	नुस्खा
reckless	जल्दबाज
reckless	दलेर
recognition	मानता
recognize	पंछानना
recommended	प्रेरत
recommend	प्रेरत
record	रिकार्ड
recovery	जब्ती
recover	बसूल करना
rectangle	आयताकार
redeem	छड़काना
redemption	खलासी
redemption	छटकारा
reduce	घट्ट करो
redundant	बेह्‌ला
red	लाल
reference	हवाला
refer	भेजना
reflection	छौरा
reflection	झलक
reflection	लशकारा
reflect	परछामां पौना
refrain	बचना
refrigerator	फ्रिज
refund	रकम-बापसी
refused	ना-मंजूर
refuse	मना करना
regarding	दे बारे च
regardless	बेपरवाह्
regards	सम्मान
regard	अदब
regard	कदर
regard	खातर
regard	मान
region	अलाका
region	खेत्तर
register	रजिस्टर
regret	अफसोस
regularly	बा-कायदा
regular	पाबंद
reject	रद्द करना
related	सरबंधत
relate	मलाना
relationship	रिश्ता
relatives	रिश्तेदार
relative	रिश्तेदार
relax	अराम
released	जारी
release	जारी करो
relevant	सरबंधत
reliable	भरोसेमंद
relief	मदाद
relieved	फारग
relieve	फारग
religion	धर्म
religion	मजहब
religious	धारमक
religious	मजहबी
reluctant	बे-मन
rely	जकीन करना
remaining	बाकी
remain	बकाया
remarkable	डाह्‌डा
remedy	अलाज
remedy	उपाऽ
remember	चेता रक्खना
reminder	चेता
remind	चेता दुआना
remote	रिमोट
remove	हटाना
render	पेश करना
rent	कराया
repair	मरम्मत
repeat	दरहाना
replace	बदल
reply	परता
report	रिपोर्ट
represent	नुमयंदगी करना
reputation	इज्जत
reputation	मान-मरजादा
request	अर्जी
required	लोड़चदा
require	लोड़चदा
rescue	बचाना
research	शोध
resemble	रलदा-मिलदा
resentment	रंजश
reservation	रोक
reservation	लकाऽ
reserve	राखमां
resident	बसनीक
resign	अस्तीफा
resilience	लचक
resilient	लचकदार
resilient	लचीला
resistance	बरोध
resist	बरोध करना
resolution	मसौदा
resolve	फैसला
resort	दुआरा
resources	संसाधन
respect	आदर-मान
respond	परता
response	परता
responsibility	जिम्मेदारी
responsible	जिम्मेदार
restaurant	रेस्टोरेंट
rest in peace	विन्रम शरधांजली
restore	मुड़-स्थापत करना
restrict	मैहदूद करना
rest	अराम
rest	बाकी
results	नतीजे
result	नतीजा
resume	परतियै शुरू
retail	परचून
retain	रक्खना
retention	ठैहराव
retired	रटैर होए दा
retreat	बापसी
retrieve	मुड़-हासल करना
return	बापस
revealed	फाश
reveal	जाहर करना
revenge	बदला
revenue	राजस्व
reverse	उलटा
review	समीक्षा
revise	तरमीम करना
revision	नजरसानी
revision	संशोधन
revolution	क्रांती
reward	ईनाम
re	मुड़
rhythm	ताल
rib	चांप
rib	पसली
rice	चौल
rice	भत्त
rich	अमीर
ride	सुआरी
ridiculous	मजाकिया
rid	छुटकारा पाना
right now	हूनै
right	स्हेई
rigid	डाह्‌डा
rigid	लक्कड़
rigid	सख्त
ring	घैंटी
ring	मुंदरी
rinse	कुल्ला
riot	घामा
riot	दंगा
riot	फसाद
riot	बद-अमनी
ripe	पक्का
rip	फाड़
rise	चढ़ेआ
risk	खतरा
risk	जोखम
rival	बैरी
river	दरेआ
road	रस्ता
roast	भुन्ने दा
robust	चटीसर
robust	चोबर
rock	कुप्पड़
rod	सलाख
role	भूमका
role	रोल
roll	लोटनी
roof	छत्त
room	कमरा
root	जड़
rope	रस्सा
rotten	दा'गी
roughly	अंदाजन
rough	खौहरा
round	गोल
route	बत्त
route	रस्ता
routine	दस्तूरी
routine	नेमी
row	कतार
row	पंगती
rubber	रबड़
rubbish	बकवास
rub	रगड़
rude	अक्खड़
rug	गलीचा
ruin	बरबाद
ruler	राजा
ruler	हाकम
rules	कनून
rules	कायदे
rule	निजम
running	दौडना
run	दौड़
rural	ग्राईं
rush	भीड़
sack	थैल्ला
sack	बोरी
sacred	पवित्तर
sacrifice	बलिदान
safe flight	सुरक्खत उड़ान
safety	सुरक्खेआ
safe	सुरक्खत
sage	रिशी
said	आक्खेआ
sailing	समुंदरी जात्तरा
sail	बादवान
sake	खातर
salary	तनखाह्
sale	बिक्री
sale	सेल
salmon	सैल्मन
salt	लून
Same here	मेरी बी इ'ऐ राय ऐ
same	इक्कै जनेहा
sample	नमूना
sand	रेत
Sanskrit	संस्कृत
sarcastic	तनजिया
sarcastic	व्यंगात्मक
sassy	सैसी
satisfaction	तसल्ली
satisfied	त्रिप्त
satisfied	परसिन्न
satisfying	तसल्लीबख्श
satisfy	परसिन्न होना
Saturday	शनिवार
sat	बेही गेआ
sausage	सासेज
savage	जंगली
savage	बेअदब
save	बचाओ
save	सहेजो
saw	आरा
saw	दिक्केआ
say	आक्खो
scale	पैमाना
scam	घोटाला
scarce	नदारद
scared	डरे दा
scarf	दपट्टा
scarf	स्कार्फ़
scary	डरौना
scar	नशान
scattered	खिल्लरे दा
scenery	नजारा
scene	नजारा
scent	अतर
scent	खशबू
schedule	शिडयूल
school	स्कूल
science	विज्ञान
science	साईंस
scientists	साईंसदान
scientist	साईंसदान
scissors	कैंची
scold	दबाड़
scold	दबाड़ा
scope	दायरा
score	स्कोर
scrap	भोर
scrap	मिक्कर
scratch	घरीट
scream	चीख
scream	डाट
screen	स्क्रीन
screw	पेच
script	लिपि
seal	मोहर
search	तपाश
season	रुत्त
seat	सीट
sea	समुंदर
second	दूआ
secret	भेत
secret	मर्म
section	सेक्शन
secure	सुरक्खत
security	सुरक्षा
security	हफाजत
seed	बीऽ
seek	मंगना
seems	लगदा ऐ
seem	लब्भना
seen	दिक्खना
see you later	बाद च मिलने आं
see you soon	तौले गै परतियै मिलगे
see you tomorrow	कल मिलने आं
see you	फ्ही मिलने आं
see	दिक्खो
seize	जब्त करना
seizure	जब्ती
seizure	पकड़
seldom	कदें-कदें
select	चुनो
self healing	अपने-आप ईलाज
selfish	खुदगर्ज
self	आपूं
self	खुद
sell	बेचना
send me your picture	मिगी अपनी फोटो भेजो
send	भेजो
senior	आला
senior	बड्डा
sense	समझ
sensible	समझदार
sensitive	भावक
sentences	वाक्य
sentence	वाक्य
sent	भेजेआ गेदा
separate	बक्खरा
Sepedi	सेपेडी
september	सितंबर
sequence	लड़ी
series	लड़ी
seriously	संजीदगी कन्नै
serious	नाजक
serious	संगीन
serve	सेवा करना
service	नौकरी
service	सेवा
session	अजलास
session	बैठक
setting	सेटिंग
settle	बस्सना
set up	सेट अप
set	सेट
seventeen	सतारां
seventy	सत्तर
seven	सत्त
several	केईं
severe	डाहडा
severe	संगीन
sew	सीना
shade	छां
shadow	छौरा
shadow	परछामां
shake	झटका
shake	झड़का
shallow	उथला
shall	करग
shame	शर्म
shape	शक्ल
share	सांझ
share	हिस्सा
sharp	तेज
sharp	त्रिक्खा
shed	बाड़ा
sheep	भिड्ड
sheet	ब'रका
she has	ओह्‌दे कोल
she is	ओह् ऐ
shelf	आला
shelf	उग्घन
shell	कोका
shell	खोल
shelter	आसरमा
she	ओह्
shield	ढाल
shift	पारी
shift	बारी
shift	शिफ्ट
shine	चमकना
shine	लिछकना
shipping	शिपिंग
ship	ज्हाज
shirt	कमीज
shoes	बूट
shoot	मारना
shopping	खरीददारी
shop	हट्टी
shore	कंढा
shortage	कमी
short	लौहका
shot	शाट
shoulder	मूंढा
should	चाहिदा
shout	बलारा
shower	न्हौना
show me	मिगी दस्सो
show	तमाशा
show	शो
shrimp	झींगा
shrink	सौंगड़ना
shut up	मूंह् बंद करो
shut	बंद करना
shy	शर्मोकल
siblings	लौहके भैन-भ्रा
sibling	लौहके भैन-भ्रा
sick	बमार
sick	मांदा
side	तरफ
sightseeing	सैर-सपाटा
sight	दक्ख
sight	नजारा
sigh	हूक
sigh	हौका
signature	दस्तखत
significant	ऐहम
significant	म्हत्तवपूर्ण
sign	दस्तखत
silence	खमोशी
silence	चुप्प-चनक
silent	खमोश
silk	सिल्क
silly	बेबकूफ
silver	चांदी
similar	इक्कै जनेहा
simple	साद्दा
simp	सिद्धड़
simultaneously	पौन-पट्ट
sincerely	थुआढ़ा अपना
sincere	दयानतदार
since	थमां
singer	गतार
singer	गवेइया
single	कल्ला
sing	गाना
sink	डुब्बना
sink	सिंक
Sir	सर
Sir	साहब
sister in law	जठानी
sister in law	साली
sister	भैन
site	थाहर
site	साइट
situation	स्थिति
situation	हालात
sit	बौहना
sixteen	सोलां
sixty	सट्ठ
six	छे
size	अकार
size	साइज
skills	हुनर
skill	हुनर
skinny	पतला
skin	चमड़ी
skip	छोड़ना
skirt	स्कर्ट
sky	शमान
slave	गुलाम
sleeping	सोना
sleepy	सुस्त
sleep	सोना
sleeve	बांह्‌
slice	टुगड़ा
slide	ढलक
slightly	थोहड़ा
slim	केह्‌रा
slim	पतला
slip	रसीद
slope	ढलान
slot	झरी
slot	रखना
slowly	आस्ता
slowly	बल्लें
slow	बल्लें
slow	मट्ठा
small	लौहका
smart	शैल
smart	सन्हाकड़ा
smell	मुश्क
smile	हास्सा
smoke	धूं
smooth	मलैम
snack	नमकीन
snack	स्नैक
snail	लड़ैं
snake	सप्प
snap	तड़ाका
snap	फोटो
snow	बर्फ
soak	डोबना
soap	साबन
sober	संजीदा
soccer	फुटबाल
social	समाजक
society	समाज
socks	जराबां
so cute	बड़ा शैला
so far	अजें तगर
software	साफ्टवेयर
soft	मलैम
soil	मिट्ठी
soldier	शपाही
sold out	बिकी गेआ
sold	बेचेआ
sole	इक्कला
solid	निग्गर
solid	मजबूत
solution	घोल
solution	समाधान
solve	नबेड़ा करना
somebody	कोई
somehow	जियां-कियां
someone	कोई
something	किश
sometimes	केईं बारी
some	चंद
song	गाना
song	गीत
soon	तौले
sophisticated	गूढ़
sophisticated	जटल
Sorani	सोरानी
sore throat	गले च खराश
sore	फलूहा
sorrow	दर्द
sorrow	बसोस
Sorry	माफ करो
sort	तालना
sought	मंगना
soulmate	हमसफर
soul	आत्मा
soul	रूह्
sound	अवाज
soup	काढ़ा
soup	सूप
source	जरिया
sour	खट्टा
south	दक्खन
so	इसलेई
space	थाहर
spam	स्पैम
Spanish	स्पेनिश
span	बस्तार
span	म्याद
spare	बाद्धू
speak	बोलो
special	खास
special	चेचा
species	जाति
species	भेद
specific	टकोहदा
spectacular	शानदार
speechless	चुप्प
speechless	ला-जवाब
speech	भाशन
speed	रफ्तार
spell	जादूं
spell	टोटका
spend	खर्चो
spent	बतीत
spent	सरफ
spent	सर्फ
spicy	मसालेदार
spike	किल्ल
spike	स्पाइक
spinach	पालक
spin	घुमना
spirit	रुह्
spirit	हिम्मत
spit	सीख
splendid	लाजवाब
split	बंडना
spoiled	खराब
spoiled	त्रट्टी-चौड़
spoil	खराब करना
spontaneous	सभावक
spoon	चिम्मचा
spot	थां
spot	थाहर
spouse	जीवन-साथी
spread	खलारो
spring	ब्हार
square	वर्ग
squeeze	नचोड़ना
squid	व्यंग्य
squirrel	गलैह्‌री
squirrel	गालढ़-चूहा
stable	थाहू
stable	स्थाई
stab	तेज हथेयार कन्नै मारना
stack	ठाला
stack	ढेर
stack	तमार
staff	अमला
stage	मंच
stage	स्टेज
stage	स्तर
stain	टिमकड़ा
stairs	पोड़ियां
stake	दाऽ
stake	बाजी
stake	शर्त
stalk	डंडल
stall	खोखा
stall	फढ़ी
stamp	मोहर
standard	मानक
standard	म्यारी
stand	थां
stand	थाहर
started	शुरू करी दित्ता ऐ
start	शुरू
starving	भुक्खे मरना
star	तारा
statement	ब्यान
state	राज्य
state	रियासत
state	सूबा
station	स्टेशन
statue	बुत्त
status	रुतबा
stay safe	सुरक्खत रवो
stay	रुकना
steady	द्रिढ़
steady	स्थिर
steak	स्टेक
steal	चोरी करना
steam	फुहान
steam	भाफ
steel	फुलाद
steel	स्टील
steep	खड़ा
stem	डंडल
stem	तना
step	गैं
stick	छड़ी
stick	सोटी
stiff	सख्त
still	तां-बी
stingy	कदित्था
stingy	झीड़ा
stingy	पाचड़
stingy	रिच्चड़
sting	सटाका
stir	घरमोल
stir	हल-चल
stock	स्टाक
stolen	चोरथू
stomach	ढिड्ड
stone	पत्थर
stood	खड़ोना
stool	टूल
stop	खड़ोबो
stop	रुको
storage	स्टोरज
store	स्टोर
storm	तफान
story	क्हानी
stove	चुल्ला
straightforward	साफ
straight	सिद्धा
strain	तनाव
stranger	पराया
strange	अजीब
strange	अनजान
strange	अनोखा
strategy	पैंतरेबाजी
strawberry	स्ट्राबेरी
straw	कक्ख
straw	तिनका
straw	तीला
streak	डोरा
streak	धारी
streak	फांट
stream	नाला
street	शिड़क
strength	ताकत
stress	जोर
stress	दबा
stretch	खिच्चना
strict	सख्त
strike	हड़ताल
string	डोर
string	डोरा
strip	टुकड़ा
strive	उद्यम करना
stroke	टनकोर
stroke	सट्ट
strong	निग्गर
strong	मजबूत
struck	घुसमुन्न मारना
structure	ढांचा
struggle	जद्दो-जैह्द
struggle	संघर्श
struggling	संघर्शी
stubborn	जिद्दी
stuck	फस्से दा
student	विद्यार्थी
studying	पढ़ै करदा
study	पढ़ाई
stuff	समग्गरी
stunning	रहानगी भरोचा
stupid	डैंजा. बेवकूफ
style	जाच
style	ढंग
style	तरीका
style	स्टाइल
subject	बिशे
submission	निश्ठा
submit	दर्ज करो
substance	तत्त
substance	सार
substitute	बदल
subtle	नाजक
subtle	बरीक
succeed	कामयाब
successful	कामयाब
success	कामयाबी
such as	जियां कि
such	ऐसा
such	नेहा
suck	चुसकी
suddenly	चानक
sudden	चानक
suffering	कतिया
suffering	जफर-जाल
suffering	तकलीफ
suffer	भुगतना
sufficient	पूरा
sufficient	सुद्धा
sugar	खंड
suggestion	मशबरा
suggestion	राए
suggestion	सुझाऽ
suggest	सुझाना
suitable	जोग्य
suitable	बाजब
suitcase	टैची
suit	पशाक
summary	सार
summer	गर्मी
summer	सोहा
summit	शिखर सम्मेलन
sum	जोड़
sunday	ऐतवार
sunny	गर्म
sunny	धुप्प
sunset	तरकाल
sunshine	धुप्प
sun	सूरज
superior	बधिया
superior	सुआया
supervisor	नगरान
super	बड़ा शैल
supper	रातीं दी रुट्टी
supply	सप्लाई
support	मदाद
supposed	ख्याली
supposed	फर्जी
suppose	ख्याल करना
suppose	मन्नी लैना
sure	निश्चत
sure	पक्का
surface	तला
surgery	सर्जरी
surge	छल्ल
surge	लैह्‌र
surname	कुल-नां
surname	सिरनामां
surprised	टऊ
surprised	र्‌हान
surprise	रहान करना
surrender	हथेयार सुट्टना
surrounding	दुआला
surveillance	निगरानी
survey	सर्वे
survive	जींदा बचना
suspect	मशकूक माहनू
suspended	मुल्तवी
suspicious	बैह्‌मन
suspicious	शक्की
sustainability	हंडनसारता
sustainable	हंडनसार
sustain	हंडना
swag	माल-असबाब
swallow	गड़प्प करना
swap	बदला
swear	सगंध खाना
sweater	स्वैटर
sweat	पसीना
sweep	ब्हारी फेरना
sweet dreams	शैल सुखनें च गुआची जाओ
sweetheart	दिलबर
sweet tooth	मठेआई दा चस्का
sweet	मिट्ठा
swelling	सोजश
swelling	सोजा
swell	बांकड़ा
swimming	तरना
swim	तरना
swing	झुलारा
swing	झूटा
switch	सुच्च
swollen	बुआरेदार
sword	तलवार
symbol	नशान
sympathy	हमदर्दी
symptoms	असार
system	करीना
system	सिस्टम
table	टेबल
tackle	निब्बड़ना
tag	टैग
tag	नत्थी करना
tail	दुंब
take away	लेई जाओ
take care	ध्यान रक्खेओ
taken	लैता
take off	उड्डना
take	लैओ
talkative	गालड़ू
talk	गल्ल
tall	लम्मां
tape	टेप
tape	फीता
tap	टूटी
target	नशाना
task	कम्म
taste	सुआद
tasty	सुआदला
taught	पढ़ाया
teacher	मास्टर
teach	सखाना
team	टीम
team	टोल्ली
tears	अत्थरूं
tear	अत्थरूं
tease	जिच्च चाढ़ना
tea	चाह्
technology	तकनीक
teeth	दंद
tell me	मिगी दस्सो
tell	दस्सो
temperature	तापमान
temper	तबीयत
temple	मंदर
temporary	आरजी
temporary	कच्चा
tenant	कराएदार
tendency	रुझान
tendency	रौं
tender	ठेका
tend	झुकना
tense	काल
tension	तनाऽ
tentative	आरजी
tentative	कच्चा
ten thousand	दस ज्हार
tent	तंबू
ten	दस
terms	शर्तां
term	म्याद
term	शब्द
terrible	डरौना
terrible	भैंकर
terrific	घोर
terrific	डाह्‌डा
territory	अलाका
test	टेस्ट
test	परख
text	पाठ
Thanks for using our app	साढ़ा ऐप इस्तेमाल करने लेई धन्नवाद
thanks	धन्नवाद
Thank you for your patience while we investigate shipment	शिपमेंट दी जांच करदे बेल्लै थुआढ़े सबर लेई धन्नवाद
thank you so much	तुं'दा मता-मता धन्नवाद
thank you very much	थुआढ़ा मता-मता धन्नवाद
thank you	थुआढ़ा धन्नवाद
thank	धन्नवाद
than	थमां
than	शा
that is	अर्थात्
that's good	एह् ठीक ऐ
that	ओह्
theft	चोरी
theft	डाका
their	उं'दा
theme	थीम
theme	बिशे
themselves	खुद
them	उनें
then	अदूं
theory	सिद्धांत
there are	उत्थें
therefore	सो
there is	उत्थें ऐ
there	उत्थें
there	तुआंह्
these	एह
they are	ओह् न
they	ओह्
the	उ'ऐ
the	एह्
the	ओह्
thick	गाढ़ा
thick	घना
thief	चोर
thigh	रान
things	चीजां
thing	चीज
think	सोचो
thin	पतला
third	त्रीआ
thirsty	त्रेहाए दा
thirteen	तेरां
thirty	त्रीह्
this is	एह् ऐ
this	एह्
thoroughly	पूरी चाल्ली कन्नै
thorough	संपूर्ण
those	ओह्
thoughtful	दलगीर
thoughts	बचार
thought	ख्याल
thought	बचार
though	भाएं
thousand	ज्हार
thread	धागा
threaten	धमकाना
threat	खतरा
three	त्रै
threshold	दुआठन
thrilled	जोश च
thrive	बधना-फुल्लना
throat	गला
throughout	हर थां
through	दे राहें
throw	सुट्टना
thumb	अंगूठा
thumb	इज्जूं
thunder	बढ़क
Thursday	बीरवार
thus	इसलेई
tick	कड़िन्न
tide	लैहर
tidy	साफ
tie	टाई
tiger	चीता
tight	कासमां
tight	तंग
Tigrinya	तिग्रिन्या
time	टैम
time	समां
timid	झुड्डू
tiny	निक्का
tips	जुगत
tip	टिप्प
tip	नोक
tired	थक्का-मांदा
tire	कपड़ा
tire	टायर
tire	टोपी
tissue	टीशू
title	औहदा
title	शीर्शक
toast	टोस्ट
to be	होने आहला
today	अज्ज
toddler	बच्चा
toes	पब्ब
together	किट्ठे
together	साथें
toilet	टायलट
told	आक्खेआ
tolerance	बरदाश्त
tolerance	सैह्‌न-शक्ति
tolerate	बरदाश्त करना
tomato	टमाटर
tomorrow	औंदे कल
tongue	जुबान
tonight	अज्ज रातीं
took	लेई लैता
tools	उपकरण
tools	संदर
tool	संदर
tooth	दंद
too	बी
topic	बिशे
topic	मजमून
top	उप्पर
torn	लीरो-लीर
torture	ज्यादती
torture	तसीहा
total	कुल
total	सारा
touch	छूहना
tough	कठन
tough	जिरड़ा
tour	सैर
towards	भेठा
toward	तगर
towel	तौलिया
towel	परना
town	नग्गर
toxic	जैहरीला
to	गी
trace	नां-नशान
track	राह्
trade	बपार
traditional	रवायती
tradition	रवाज
tradition	रवायत
traffic	ट्रैफिक
trail	बत्त
training	सखलाई
train	ट्रेन
train	रेल
traits	खासियतां
traits	लक्खन
trait	लच्छन
trait	सिफत
transfer	ट्रांसफर
transfer	बदली
transition	तबादला
translate	अनुवाद करना
transparent	निरमल
transparent	साफ
transportation	ढो-ढुआई
transport	ट्रांसपोर्ट
trap	जाल
trash	कचरा
trauma	सदमा
travel	जात्तरा
tray	ट्रे
treasure	खजाना
treatment	ईलाज
treat	ईलाज
tree	दरख्त
tree	बूहटा
tremendous	डरौना
trend	झकाऽ
trend	रझान
trial	अजमैश
trial	इम्तिहान
trick	जुगाड़
tried	जतन कीता
trigger	घोड़ा
trim	मुन्नना
trip	जात्तरा
trouble	परेशानी
trousers	तंबी
trousers	पजामां
truck	ट्रक
true	सच्च
trunk	धड़
trunk	संदूक
trust	जकीन
trust	भरोसा
truth	सच्चाई
try	कोशिश
try	जतन
Tsonga	सोंगा
tube	ट्यूब
Tuesday	मंगलवार
tuition	ट्यूशन
turkey	टर्की
turmeric	बसार
turmeric	हल्दी
turn	बारी
turtle	खचोपड़
tutor	शिक्षक
twelve	बारां
twenty-one	इक्की
twenty	बीह्
twice	दो बार
twist	पलेच
twist	पलेस
twist	बट्‌ट
twist	मोड़
Twi	ट्वी
two	दो
type	किसम
typical	चेचा
typical	बशेश
ugly	बदशक्ल
ultimate	अखीरला
ultimate	अखीरी
umbrella	छतरी
unable	असमर्थ
uncle	चाचा
uncle	मामा
unconscious	बे-होश
underneath	ख'ल्ल
underneath	हेठ
underrated	घट्ट आंकेआ गेआ
understand	समझेआ
understood	समझेआ
under	ख'ल्ल
under	मतैहत
unfortunately	बदनसीबी कन्नै
uniform	बर्दी
unique	अनोखा
unit	यूनिट
university	यूनिवर्सटी
unknown	अनजान
unknown	अन-भाखा
unless	जदूं तगर
until	जदूं तगर
unusual	अनोखा
unusual	नराला
update	अपडेट
upgrade	अपग्रेड
upgrade	उन्नत करना
upon	दे उप्पर
upset	निम्मो-झान
up to you	तुंदे पर पर मन्हस्सर करदा ऐ
up	उप्पर
urban	शैहरी
urgent	फौरन
urge	अर्ज करना
used	बरते दा
useful	लाहकारी
useless	बेकार
use	बरतून
usually	अमूमन
usual	सधारण
us	अस
utility	बरतून
vacation	छुट्टियां
vaccination	टीकाकरण
vaccine	टीका
vaccine	वैक्सीन
vacuum	खा'ल्लीपन
vague	शक्क आहला
valid	मान्य
valley	घाटी
valuable	बेशकीमती
value	कीमत
value	मुल्ल
variety	बन्न-सबन्नता
various	केईं
vary	बक्ख होना
vase	फुल्लदान
vast	बशाल
vegetables	सब्जियां
vegetable	सब्जी
vehicle	गड्डी
vendor	ताजिर
vendor	विक्रेता
venom	जैह्‌र
venture	उद्दम
venue	थाहर
verify	तसदीक करना
versatile	हरफन-मौला
version	संस्करण
vertical	लंबूतरा
very good	बड़ा शैल
very	बड़ा
vessel	भांडा
via	दे राहें
vibes	अनुभूति
vibe	अनुभूति
vicious	कबत्ता
vicious	छातर
victim	मोहरा
victim	शकार
video	विडियो
view	दिक्खना
village	ग्रां
villain	खलनायक
villain	बदमाश
vinegar	सिरका
vintage	विंटेज
violence	हिंसा
violent	उग्गर
viral	वायरल
virgin	पवित्तर
virtual	अभासी
virtue	अछाई
virtue	चंगी
virtue	नेकी
vision	लक्ष्य
visit	सैर
visual	द्रिश्श
vital	जरूरी
vivid	चटकीला
vivid	जीवंत
vocabulary	शब्दावली
voice	अवाज
void	खला
volume	मिकदार
volunteer	रजाकार
vomit	उल्टी
vomit	कै
vulnerable	बड़ा कमजोर
wages	उजरत
wage	मजूरी
waist	लक्क
waiter	वेटर
waiting	बलगना
wait	बल्गो
wake up	उट्ठना
wake	जागना
walking	टुरना
walk	टुरना
wallet	बटुआ
wall	कंध
wander	बारागर्दी करना
wanna	चाहना
wanted	चाहिदा
want	चांहना
wardrobe	लमारी
warehouse	गोदाम
warm	गर्म
warm	तत्ता
warning	चेतावनी
warn	तन्बीह्‌ करना
warrior	जोधा
warrior	सूरमा
war	जंग
war	लाम
wash	धोना
waste	बरबाद
was	हा
watch	दिक्खो
watermelon	दुहाना
water	पानी
wave	लैहर
way	बत्त
weakness	कमजोरी
weak	कमजोर
wealthy	मालदार
wealthy	मीर
wealth	संपत्ति
we are	अस आं
wearing	पाने दा
wearing	लाने दा
wear	पाओ
wear	लाओ
weather	मौसम
we can	अस करी सकने आं
wedding	ब्याह्
Wednesday	बुधवार
weed	बूटी
weekend	हफ्ते दा अखीरी दिन
week	हफ्ता
weight	जोख
weight	भार
weird	अजीब
welcome	सुआगत
welfare	बेहतरी
well done	बड़ा शैल
Well	ठीक
went	गेआ
were	हे
west	पच्छम
wet	गिल्ला
wet	सिल्ला
we	अस
whale	व्हेल
what about you	तुस केह् सोचदे ओ
what are you doing now	हून तुस केह् करै करदे ओ
what are you doing right now	हून तुस केह् करै करदे ओ
what are you doing	तुस केह् करै करदे ओ
what do you do for a living	जीने लेई तुस केह् करदे ओ
what do you do	तुस केह् करदे ओ
what do you mean	तेरा केह् मतलब ऐ
what do you want	तुस केह् चांहदे ओ
whatever	जो बी
what happened	केह् होआ
what is this	एह् केह् ऐ
what is your job	तुस केहड़ा कम्म करदे ओ
what is your name	थुआढ़ा केह् नांऽ ऐ
what is	केह् ऐ
what's up	केह् हाल ऐ
what's your name	तुंदा नां केह् ऐ
what	केह्
wheat	कनक
wheel	चक्का
wheel	पेहिया
whenever	जदूं
when	कदूं
where are you from	तुस कुत्थै रौंहदे ओ
where are you now	तुस इसलै कुत्थै ओ
where are you	तुस कुत्थें ओ
whereas	जिसलै कि
where do you live	तुस कुत्थें रौंहदे ओ
where is	कुत्थें ऐ
where	कतांह्
whether	भाएं
which	जित
which	जे
which	जो
while	तगर
while	धोड़ी
whisper	फुसर-फुसर
whistle	सीटी
white	चिट्टा
who are you	तुस कुत्थें ओ
who is this	एह् कु'न ऐ
who is	कु'न ऐ
whole	पूरा
whom	कुसी
whose	कोहदा
who	कु'न
why not	की नेईं
why	की
wicked	कबुद्धी
wicked	खरबिडल
wide	चौड़ा
widow	बिधवा
width	चौड़ाई
wife	घरै-आहली
wife	त्रीमत
wild	जंगली
willing	राजी
will	चाहना
window	दुआरी
window	बारी
windy	ब्हादार
wind	ब्हाऽ
wine	वाइन
wine	शराब
winter	स्याल
win	जित्त
wipe	पूंझना
wire	तार
wisdom	अकलमंदी
wise	समझदार
wish you all the best	शुभकामनां
wish	अकांख्या
wish	इच्छा
wish	कामना
witch	चड़ेल
witch	डैन
withdrawal	नकासी
withdraw	बापस कड्ढना
within	अंदर
without	बिजन
with	कन्नै
witness	गुआह्
witty	ठट्ठेबाज
witty	मखौली
wolf	भगेआड़
woman	जनानी
women	जनानी
wonderful	लाजवाब
wonder	रहानगी
won't	नेईं होग
won	जित्ती लैता
wood	लक्कड़ी
wool	उन्न
words	शब्द
word	शब्द
working	नौकरीशुदा
work out	कसरत
work out	नतीजा
work	कम्म
world	दुनिया
worm	कीड़ा
worn	पाए दा
worn	लाए दा
worried	दुखी
worried	निम्मोझान
worry	चैंता
worry	डर
worse	होर बी माड़ा
worship	पूजा
worst	माड़ा
worth it	एहदे लायक
worthy	जोग्य
worth	उकात
worth	कीमत
would	जो होना
wound	जख्म
Wow	बड़ा शैल
wrap	पलेस
wrap	समेटना
wrath	क्रोध
wrath	गुस्सा
wrath	तैश
wrist	डुंडू
Write here	इत्थें लिखो
write	लिखो
writing	लिखना
written	लिखित
wrong	गलत
wrote	लिखेआ हा
yard	गज्ज
yawn	जम्हानी
Yeah	हां
years	ब'रे
year	ब'रा
yeast	खमीर
yellow	पीला
yell	करलाना
yes baby	हां जान
yes dear	हां जान
yes honey	हां जान
yes my love	हा मेरी जान
yes of course	हां बिल्कुल
yesterday	पिछले रोज
Yes	हां
yet	अजें
yield	झाड़
you are beautiful	तुस बड़े शैल ओ
you are so beautiful	तूं किन्नी रूपवान ऐं
you are welcome	थुआढ़ा सुआगत ऐ
you are	तुस
you can	तुस इ'यां करी सकदे ओ
You know	तुस जानदे ओ
young	जुआन
you’re welcome	तुंदा सुआगत ऐ
you're welcome	थुआढ़ा सुआगत ऐ
yourself	थुआढ़ा
your welcome	थुआढ़ा सुआगत ऐ
your	थुआढ़ा
youth	नौजुआन
you too	तुस बी
you	तुस
you	तूं
yummy	सुआदला
zero	जीरो
zero	सिफर
