a	un
a little	un poco
a lot	un montón
a lot of	un montón de
abandon	abandonar
abandoned	abandonado
abide	cumplir
ability	habilidad
able	capaz
about	acerca de
above	arriba
abroad	exterior
absence	ausencia
absent	ausente
absolutely	absolutamente
absorb	absorber
abstract	abstracto
absurd	absurdo
abundance	abundancia
abundant	abundante
abuse	abuso
accent	acento
accept	aceptar
access	acceso
accident	accidente
accommodation	alojamiento
accomplish	lograr
accomplished	logrado
according	de acuerdo a
account	cuenta
accuracy	exactitud
accurate	preciso
accused	acusado
ache	dolor
achieve	lograr
achievement	logro
acknowledge	reconocer
acquaintance	conocido
acquire	adquirir
acquired	adquirido
acquisition	adquisición
across	en
act	acto
action	acción
active	activo
activities	actividades
activity	actividad
actor	actor
actual	actual
actually	en realidad
acute	agudo
adapt	adaptar
add	agregar
addicted	adicto
addition	suma
additional	adicional
address	dirección
adequate	adecuado
adjacent	adyacente
adjective	adjetivo
adjust	ajustar
admire	admirar
admit	admitir
adopt	adoptar
adorable	adorable
advance	ventaja
advanced	avanzado
advantage	ventaja
adventure	aventura
adverb	adverbio
advertisement	anuncio
advertising	publicidad
advice	consejo
advise	consejo
advocate	defensor
aesthetic	estético
affair	asunto
affect	afectar
affection	afecto
afford	solventar
affordable	asequible
afraid	atemorizado
after	después
afternoon	tarde
afterwards	después
again	de nuevo
against	contra
age	edad
agency	agencia
agent	agente
aggressive	agresivo
agile	ágil
ago	atrás
agree	aceptar
agreement	acuerdo
agriculture	agricultura
ahead	adelante
aid	ayuda
aim	apuntar
air	aire
airport	aeropuerto
aisle	pasillo
alarm	alarma
alcohol	alcohol
alert	alerta
alive	vivo
all	todos
all right	está bien
all the best	mis mejores deseos
allow	permitir
allowed	permitió
almost	casi
alone	solo
along	a lo largo de
already	ya
Alright	está bien
also	también
alternative	alternativa
although	a pesar de
always	siempre
am	soy
amazing	sorprendente
ambiguous	ambiguo
ambition	ambición
ambitious	ambicioso
amend	enmendar
amid	entre
among	entre
among us	entre nosotros
amount	cantidad
amusing	entretenido
an	un
analysis	análisis
ancestors	ancestros
anchor	ancla
ancient	antiguo
and	y
and you	y tú
angel	ángel
anger	enojo
angle	ángulo
angry	enojado
animal	animal
ankle	tobillo
anniversary	aniversario
announcement	anuncio
annoy	enojarse
annoyed	enojado
annoying	irritante
annual	anual
anonymous	anónimo
another	otro
answer	respuesta
anticipate	anticipar
anxiety	ansiedad
anxious	ansioso
any	cualquier
anymore	más
anyone	cualquiera
anything	cualquier cosa
anyway	de todos modos
anyways	de todos modos
apart	aparte
apartment	departamento
apologize	disculparse
apparent	aparente
apparently	aparentemente
appeal	apelar
appear	aparecer
appearance	apariencia
appeared	apareció
appetite	apetito
apple	manzana
application	solicitud
apply	aplicar
appointment	cita
appreciate	valorar
appreciation	apreciación
approach	enfoque
appropriate	adecuado
approval	aprobación
approve	aprobar
approved	aprobado
approximately	aproximadamente
april	abril
arbitrary	arbitrario
architect	arquitecto
architecture	arquitectura
archive	archivo
are	son
are you	eres
are you busy	estás ocupado
are you married	estás casado
are you married or single	eres casado o soltero
Are you still there?	estás ahí todavía
are you there	estás ahí
area	área
argue	argumentar
argument	argumento
arise	surgir
arm	brazo
army	ejército
around	alrededor
arrange	arreglar
arrangement	acuerdo
arrival	llegada
arrive	llegar
arrived	llegó
arrogant	arrogante
arrow	flecha
art	arte
article	artículo
artificial	artificial
artist	artista
as	como
as long as	mientras
as well	también
as well as	así como
ash	ceniza
ashamed	avergonzado
ask	preguntar
asked	preguntó
asleep	dormido
aspect	aspecto
Assamese	Assamese
assault	agresión
assembly	asamblea
assertive	asertivo
assess	evaluar
assessment	evaluación
asset	activo
assets	activos
assign	asignar
assignment	asignación
assist	asistir
assistant	asistente
associate	asociado
associated	asociado
association	asociación
assume	asumir
assumption	suposición
at	en
at least	al menos
ate	comió
athlete	atleta
attach	adjuntar
attached	adjunto
attachment	adjunto
attack	ataque
attempt	intentar
attend	atender
attendance	asistencia
attention	atención
attitude	actitud
attract	atraer
attraction	atracción
attractive	atractivo
attribute	atributo
audience	audiencia
august	agosto
aunt	tía
aunty	tía
authentic	auténtico
author	autor
authority	autoridad
autumn	otoño
available	disponible
average	promedio
avoid	evitar
awake	despierto
award	premio
aware	consciente
awareness	conciencia
away	lejos
awesome	impresionante
awful	horrible
awkward	extraño
Aymara	Aymara
baby	bebé
bachelor	bachiller
back	atrás
background	fondo
bad	malo
bag	bolsa
bait	cebo
bake	hornear
bakery	panadería
baking soda	bicarbonato
balance	balance
ball	pelota
Bambara	Bambara
banana	banana
band	banda
bang	golpe
bank	banco
bar	bar
barely	apenas
bargain	oferta
bark	ladrido
barley	cebada
barrier	barrera
base	base
based	basado
basement	sótano
basic	básico
basically	básicamente
basil	albahaca
bastard	bastardo
batch	lote
bath	baño
bathroom	baño
battery	batería
battle	batalla
bay	bahía
be	ser
be careful	ten cuidado
beach	playa
beam	haz
beans	frijoles
bear	soportar
beard	barba
bearing	cojinete
beast	bestia
beat	vencer
beautiful	hermoso
beauty	belleza
became	convertirse
because	porque
become	convertirse
bed	cama
bedroom	dormitorio
bee	abeja
beef	carne de res
been	estado
beer	cerveza
before	antes
began	comenzó
begin	comenzar
beginning	comienzo
behalf	beneficio
behave	comportarse
behavior	comportamiento
behaviour	comportamiento
behind	detrás
being	ser
belief	creencia
believe	creer
belly	barriga
belong	pertenecer
beloved	querido
below	abajo
belt	cinturón
bench	banco
bend	doblar
beneath	debajo
benefit	beneficio
benefits	beneficios
beside	al lado de
besides	además
best	mejor
best of luck	toda la suerte
best regards	saludos
better	mejor
between	entre
beverage	bebida
beyond	más allá de
Bhojpuri	Bhojpuri
bias	sesgo
biased	sesgado
bicycle	bicicleta
bid	licitación
big	grande
bike	bicicleta
bill	factura
bind	unir
bird	pájaro
birthday	cumpleaños
bit	poco
bite	morder
bitter	amargo
black	negro
blade	cuchilla
blame	culpa
blank	blanco
blanket	frazada
blast	explosión
bleach	lejía
blend	mezclar
bless	bendecir
blessed	bendecido
blind	ciego
bliss	dicha
block	bloquear
blood	sangre
bloom	floración
blow	explotar
blue	azul
blunt	descortés
board	junta
boat	bote
body	cuerpo
boil	hervir
bold	atrevido
bond	vínculo
bone	hueso
book	libro
boost	impulsar
booster	refuerzo
boot	bota
boots	botas
border	borde
bore	aburrir
bored	aburrido
boring	aburrido
born	nacido
borrow	pedir prestado
boss	jefe
both	ambos
bother	molestar
bottle	botella
bottom	abajo
bought	compró
bounce	rebotar
bound	vinculado
boundaries	límites
bow	arco
bowl	recipiente
box	caja
boy	chico
boyfriend	novio
bracelet	pulsera
brain	cerebro
branch	sucursal
brand	marca
brave	corajudo
breach	incumplimiento
bread	pan
break	romper
breakfast	desayuno
breast	mama
breath	aliento
breathe	respirar
breed	criar
brick	ladrillo
bride	novia
bridge	puente
brief	breve
bright	brillante
brilliant	brillante
bring	traer
bro	hermano
broad	amplio
broadcast	transmitir
broke	rompió
broken	roto
broom	escoba
brother	hermano
brother in law	cuñado
brought	trajo
brown	marrón
brush	cepillar
bucket	balde
buddy	compañero
budget	presupuesto
bug	error
build	construir
building	edificio
built	construido
bulk	bulto
bull	toro
bully	matón
bump	bulto
bunch	racimo
bundle	paquete
burden	carga
buried	enterrado
burn	quemar
burst	explosión
bury	enterrar
bus	autobús
bush	arbusto
business	negocio
bust	busto
busy	ocupado
but	pero
butter	manteca
butterfly	mariposa
button	botón
buy	comprar
by	por
by the way	de paso
bye	adiós
cabbage	repollo
cabinet	gabinete
cage	jaula
cake	torta
calf	becerro
call	llamar
call me	llámame
called	llamó
calm	calma
came	vino
campaign	campaña
can	poder
can't	no puedo
Cancel	Cancelar
cancer	cáncer
capable	capaz
capacity	capacidad
capital	capital
caption	subtítulo
capture	captura
car	auto
career	carrera
careful	cuidadoso
carefully	cuidadosamente
careless	descuidado
caring	cariñoso
carpenter	carpintero
carpet	alfombra
carrot	zanahoria
carry	llevar
carry on	continuar
carry out	realizar
case	caso
cash	dinero
cast	elenco
castle	castillo
casual	casual
cat	gato
catch	atrapar
category	categoría
cattle	ganado
caught	capturado
cause	causa
caution	precaución
cautious	precavido
cave	cueva
cease	cesar
ceiling	techo
celebrate	celebrar
cell	celúla
center	centro
century	siglo
cereal	cereal
ceremony	ceremonia
certain	determinado
certainly	ciertamente
certificate	certificado
chain	cadena
chair	silla
challenge	desafío
chance	oportunidad
change	cambiar
chaos	caos
character	personaje
characteristics	características
charge	cargar
charity	caridad
charming	encantador
chart	cuadro
chase	perseguir
chat	charlar
cheap	barato
cheat	engañar
cheating	tramposo
check	controlar
cheek	mejilla
cheer	alegría
cheerful	alegre
cheers	salud
cheese	queso
chemistry	química
cherish	apreciar
chess	ajedrez
chest	tórax
chew	masticar
chicken	pollo
chief	jefe
child	niño
childhood	infancia
children	niños
chill	frío
chimneys	chimeneas
chin	mentón
chocolate	chocolate
choice	elección
choose	elegir
chop	picar
chores	quehaceres
chubby	regordete
church	iglesia
cinnamon	canela
circle	círculo
circumstances	circunstancias
citizen	ciudadano
city	ciudad
claim	reclamar
clarify	aclarar
class	clase
clay	arcilla
clean	limpio
clear	claro
clerk	oficinista
clever	inteligente
client	cliente
cliff	acantilado
climate	clima
climb	trepar
clingy	pegajoso
clock	reloj
close	cerrar
closet	armario
cloth	paño
clothes	ropa
cloud	nube
cloudy	nuboso
clown	payaso
clue	clave
clumsy	torpe
cluster	grupo
coach	entrenador
coal	carbón
coast	costa
coat	abrigo
coffee	café
cognitive	cognitivo
coincidence	coincidencia
cold	frío
collapse	colapsar
collar	cuello
colleague	colega
colleagues	colegas
collect	recopilar
collection	recopilación
college	colega
color	color
colorless green ideas slept furiously	las ideas verdes incoloras duermen furiosamente
colour	color
column	columna
comb	peine
combination	combinación
combine	combinar
come	venir
come here	ven aquí
come on	vamos
comfort	comodidad
comfortable	cómodo
coming	próximo
coming soon	muy pronto
command	dominio
comment	comentario
commercial	comercial
commission	comisión
commit	comprometerse
commitment	compromiso
committed	comprometido
commodity	producto
common	común
communicate	comunicar
communication	comunicación
community	comunidad
commute	desplazarse
companion	compañero
company	compañía
compare	comparar
comparison	comparación
compassion	compasión
compassionate	compasivo
compatible	compatible
compete	competir
competent	competente
competition	competencia
competitive	competitivo
complain	quejarse
complaint	queja
complement	complementar
complete	completo
completely	completamente
complex	complejo
compliance	cumplimiento
complicated	complicado
compliment	cumplido
comply	cumplir
composition	composición
compound	compuesto
comprehension	comprensión
comprehensive	integral
compromise	compromiso
compulsory	obligatorio
computer	computadora
concentrate	concentrarse
concept	concepto
concern	inquietud
concerned	preocupado
concert	concierto
conclusion	conclusión
concrete	concreto
condition	condición
conditions	condiciones
conduct	conducta
conference	conferencia
confess	confesar
confidence	confianza
confident	seguro
confirm	confirmar
conflict	conflicto
confused	confundido
confusion	confusión
congrats	felicitaciones
congratulation	felicitación
congratulations	felicitaciones
conjunction	conjunción
connect	conectar
conquer	conquistar
conscious	consciente
consciousness	conciencia
consent	consentir
consequences	consecuencias
conservation	conservación
conservative	conservador
consider	considerar
considered	consideró
consist	consistir
consistency	consistencia
consistent	coherente
constant	constante
constantly	constantemente
constipation	constipación
construction	construcción
consume	consumir
consumption	consumo
contact	contacto
contagious	contagioso
contain	contener
contains	contiene
contemporary	contemporáneo
contempt	desprecio
content	contenido
contest	concurso
context	contexto
continent	continente
continue	continuar
contract	contrato
contrast	contraste
contribute	contribuir
contribution	contribución
control	control
controversial	controversial
convenience	conveniencia
convenient	conveniente
conversation	conversación
convert	convertir
convey	transmitir
convince	convencer
convinced	convencido
cook	cocinar
cooking	cocinando
cool	fresco
cooperation	cooperación
cope	lidiar
copper	cobre
core	núcleo
corn	maíz
corner	esquina
correct	correcto
cost	costo
costume	traje
cottage	cabaña
cotton	algodón
couch	sofá
cough	tos
could	podría
council	concejo
count	contar
counter	mostrador
country	país
countryside	campo
couple	pareja
courage	coraje
course	curso
court	corte
courtesy	cortesía
cousin	primo
cover	cubrir
cow	vaca
coward	cobarde
cozy	acogedor
crab	cangrejo
crack	grieta
craft	artesanía
crap	tonterías
crash	chocar
craving	deseo
crawl	gatear
crazy	loco
create	crear
creative	creativo
credit	crédito
creep	arrastrarse
creepy	espeluznante
crew	multitud
crime	delito
cringe	avergonzarse
crisis	crisis
criteria	criterios
critical	crítico
criticism	crítica
crop	cultivo
crops	cultivos
cross	cruzar
crow	cuervo
crowd	multitud
crowded	saturado
crown	corona
crucial	crucial
cruel	cruel
cruise	crucero
crush	triturar
cry	llorar
cucumber	pepino
cuddle	acurrucarse
culture	cultura
cunning	astuto
cup	taza
cupboard	armario
curb	frenar
cure	curar
curfew	toque de queda
curiosity	curiosidad
curious	curioso
curly	ondulado
currency	moneda
current	actual
currently	actualmente
curse	maldición
curtain	cortina
cushion	almohadón
custom	disfraz
customer	cliente
customs	aduanas
cut	cortar
cute	lindo
cycle	ciclo
cycling	ciclismo
dad	papá
daddy	papá
daily	diariamente
dairy	lácteos
dam	presa
damage	daño
damn	maldición
damp	húmedo
dance	danza
danger	peligro
dangerous	peligroso
dark	oscuro
darling	querido
dash	estrellarse
data	datos
date	fecha
daughter	hija
day	día
dead	muerto
deadline	fecha límite
deaf	sordo
deal	trato
dear	estimado
Dear All	Estimados
Dear Customer	Estimado cliente
Dear Parents	Estimados padres
Dear Sir	Estimado
Dear students	Estimados alumnos
Dear Team	Estimado equipo
death	muerte
debate	debate
debit	débito
debris	escombros
debt	deuda
decade	década
decay	decadencia
deceased	fallecido
deceive	engañar
december	diciembre
decent	decente
decide	decidir
decided	decidido
decision	decisión
deck	cubierta
decline	rechazar
decrease	disminuir
dedicated	dedicado
dedication	dedicación
deed	escritura
deep	profundo
deer	ciervo
default	por defecto
defeat	vencer
defend	defender
define	definir
definitely	definitivamente
definition	definición
degree	grado
delay	demora
delayed	demorado
delete	borrar
deliberate	adrede
delicate	delicado
delicious	delicioso
delight	deleitar
delighted	encantado
deliver	entregar
delivered	entregado
delivery	entrega
demand	demanda
demanding	demandante
democracy	democracia
demon	demonio
demonstrate	demostrar
denied	denegado
density	densidad
dentist	dentista
deny	denegar
department	departamento
departure	partida
depend	depender
deploy	desplegar
deposit	depósito
depressed	deprimido
depression	depresión
depth	profundidad
describe	describir
description	descripción
desert	desierto
deserve	merecer
design	diseño
designation	designación
desire	deseo
desk	escritorio
despair	desesperación
desperate	desesperado
despite	a pesar de
dessert	postre
destination	destino
destiny	destino
destroy	destruir
destruction	destrucción
detail	detalle
details	detalles
detect	detectar
determination	determinación
determine	determinar
determined	determinado
devastated	devastado
develop	desarrollar
developed	desarrollado
development	desarrollo
device	dispositivo
devil	demonio
devoted	dedicado
Dhivehi	Dhivehi
diabetes	diabetes
diarrhea	diarrea
diary	diario
dictionary	diccionario
did	hizo
die	morir
died	murió
diet	dieta
difference	diferencia
different	diferente
difficult	difícil
dig	excavar
dignity	dignidad
diligent	diligente
dinner	cena
dip	salsa
direct	directo
direction	dirección
director	director
dirt	suciedad
dirty	sucio
disable	deshabilitar
disabled	discapacitado
disappear	desaparecer
disappointed	desilusionado
disaster	desastre
discard	desechar
discharge	descargar
discipline	disciplina
discount	descuento
discover	descubrir
discrimination	discriminación
discuss	conversar
discussion	discusión
disease	enfermedad
diseases	enfermedades
disguise	ocultar
disgusting	desagradable
dish	plato
dishes	platos
dismiss	despedir
dispatch	despacho
display	mostrar
disposal	desecho
dispute	disputar
distance	distancia
distinct	distinto
distinguish	distinguir
distress	angustia
distribution	distribución
district	distrito
disturb	molestar
ditch	zanja
dive	buceo
diverse	diverso
diversity	diversidad
divide	dividir
divine	divino
divorce	divorcio
dizzy	mareado
do	hacer
do you love me	me amas
doctor	doctor
document	documento
does	hace
dog	perro
Dogri	Dogri
doing	haciendo
doll	muñeca
domain	dominio
domestic	doméstico
dominant	dominante
don't	no
Don't worry	no te preocupes
donate	donar
done	hecho
donkey	burro
dope	marihuana
double	doble
doubt	duda
dough	masa
down	abajo
download	descargar
draft	borrador
drag	arrastrar
drain	fuga
drama	drama
draw	dibujar
drawer	cajón
drawing	dibujo
dread	miedo
dream	sueño
dress	vestido
drill	perforar
drink	bebida
drive	manejar
drop	gota
dropped	cayó
drought	sequía
drunk	ebrio
dry	seco
duck	pato
dude	dudar
due	adeudado
due to	debido a
dull	aburrido
dumb	mudo
dump	vertedero
duration	duración
during	durante
dust	polvo
duty	deber
dwell	habitar
dying	muriendo
each	cada
each other	entre sí
eager	ansioso
eagle	águila
ear	oído
earlier	más temprano
early	temprano
earn	ganar
ears	oídos
earth	tierra
earthquake	terremoto
ease	facilitar
easily	fácilmente
east	este
easy	fácil
eat	comer
eating	comiendo
economic	económico
economy	economía
edge	borde
edit	editar
education	educación
effect	efecto
effective	eficaz
efficiency	eficiencia
efficient	eficiente
effort	esfuerzo
egg	huevo
eggplant	berenjena
ego	ego
eight	ocho
eighteen	dieciocho
eighty	ochenta
either	o
elaborate	elaborar
elbow	codo
elder	mayor
elderly	mayor
elegant	elegante
element	elemento
elephant	elefante
eleven	once
eligible	elegible
eliminate	eliminar
else	más
embarrassed	avergonzado
embarrassing	embarazoso
embrace	abrazar
emerge	surgir
emergency	emergencia
emotional	emocional
empathy	empatía
emphasis	énfasis
emphasize	enfatizar
employee	empleado
employees	empleados
employer	empleador
employment	empleo
empty	vacío
enable	permitir
encounter	encontrar
encourage	alentar
end	fin
endangered	en peligro
endeavor	empeño
endurance	resistencia
endure	perdurar
enemy	enemigo
energy	energía
engage	comprometer
engaged	comprometido
engagement	compromiso
engine	motor
engineer	ingeniero
English	inglés
enhance	mejorar
enjoy	disfrutar
enormous	enorme
enough	suficiente
ensure	asegurar
enter	ingresar
entertainment	entretenimiento
enthusiasm	entusiasmo
enthusiastic	entusiasta
entire	entero
entitled	con derecho
entity	entidad
entrance	entrada
entrepreneur	emprendedor
envelope	sobre
environment	medioambiente
envy	envidiar
epic	épico
epidemic	epidemia
equal	igual
equipment	equipo
equity	equidad
equivalent	equivalente
eraser	borrador
error	error
escape	escapar
especially	especialmente
essay	ensayo
essence	esencia
essential	básico
establish	establecer
established	establecido
estate	bienes
estimate	estimar
estimated	estimado
etc	etc.
eternal	eterno
ethics	ética
evaluate	evaluar
evaluation	evaluación
even	incluso
even though	a pesar de
evening	noche
event	evento
eventually	eventualmente
ever	alguna vez
every	cada
everybody	todos
everyone	todos
everything	todo
evidence	evidencia
evil	demonio
evolution	evolución
evolve	evolucionar
Ewe	Ewe
ex	ex
exact	exacto
exactly	exactamente
exam	examen
examine	examinar
example	ejemplo
exceed	superar
excellent	excelente
except	excepto
exception	excepción
excess	exceso
excessive	excesivo
exchange	intercambio
excited	excitado
excitement	excitación
exciting	excitante
exclusive	exclusivo
excuse	disculpar
excuse me	disculpe
execute	ejecutar
execution	ejecución
executive	ejecutivo
exercise	ejercicio
exhaust	escape
exhausted	exhausto
exhibit	anexo
exhibition	exhibición
exist	existir
existence	existencia
existing	existente
exit	salida
expand	expandir
expect	esperar
expected	esperado
expenses	gastos
expensive	caro
experience	experiencia
experiment	experimento
expert	experto
expired	venció
explain	explicar
explanation	explicación
exploit	explotar
explore	explorar
export	exportar
expose	exponer
exposed	expuesto
exposure	exposición
express	expresar
expression	expresión
extend	extender
extended	extendido
extension	extensión
extent	medida
external	externo
extinct	extinguido
extra	extra
extract	extracto
extraordinary	extraordinario
extreme	extremo
extremely	extremadamente
eye	ojo
eyes	ojos
fabric	tela
fabulous	fabuloso
face	rostro
facilitate	facilitar
facilities	instalaciones
facility	instalación
fact	hecho
factor	factor
factory	fábrica
facts	hechos
fade	marchitarse
fail	fallar
failed	falló
failure	falla
faint	débil
fair	justo
fairly	justamente
fairy	hada
faith	fe
faithful	fiel
fake	falso
fall	caer
false	falso
fame	fama
familiar	familiar
family	familia
famine	hambruna
famous	famoso
fan	admirador
fancy	fantasía
fantastic	fantástico
far	lejos
farewell	despedida
farm	granja
farmer	agricultor
fascinating	fascinante
fashion	moda
fast	rápido
fat	gordo
fatal	fatal
fate	destino
father	padre
fatigue	fatiga
fault	falla
favorite	favorito
favour	favor
favourite	favorito
fear	miedo
feast	banquete
feather	pluma
feature	rasgo
features	características
february	febrero
fed up	harto
fee	tarifa
feed	alimentar
feedback	comentario
feel	sentir
feeling	sentimiento
feet	pies
fell	cayó
fellow	compañero
felt	sintió
female	femenino
fence	cerca
fertile	fértil
festival	festival
fetch	buscar
fever	fiebre
few	pocos
fewer	menos
fiance	prometido
fiction	ficción
field	campo
fierce	feroz
fifteen	quince
fifty	cincuenta
fight	luchar
fighting	luchando
figure	cifra
figure out	averiguar
file	archivo
fill	llenar
filled	completado
film	película
filthy	sucio
finally	finalmente
finance	finanzas
financial	financiero
find	encontrar
find out	descubrir
fine	bien
finger	dedo
finish	finalizar
finished	terminado
fire	fuego
firm	firme
first	primero
first name	primer nombre
fish	pez
fit	adaptar
five	cinco
fix	reparar
fixed	fijado
flag	bandera
flash	destello
flat	plano
flaw	defecto
flawless	impecable
flee	huir
flesh	carne
flew	voló
flex	doblar
flexible	flexible
flight	vuelo
flip	voltear
flirt	coquetear
flirting	galanteo
float	flotar
flood	inundación
floor	piso
flour	harina
flow	fluir
flower	flor
flu	gripe
fluent	fluido
fluently	con fluidez
fluffy	suave
fluid	líquido
fly	volar
focus	enfoque
fog	niebla
foggy	nublado
fold	doblar
folks	amigos
follow	seguir
follow up	seguir
following	siguiente
food	alimento
fool	tonto
foolish	necio
foot	pie
football	fútbol
for	para
For example	Por ejemplo
for instance	por ejemplo
for you	para ti
forbidden	prohibido
force	fuerza
forecast	pronóstico
forehead	frente
foreign	extranjero
forest	bosque
forever	para siempre
forget	olvidar
forgive	perdonar
forgot	olvidó
fork	tenedor
form	forma
formal	formal
former	anterior
fortunately	afortunadamente
fortune	fortuna
forty	cuarenta
forty-two	cuarenta y dos
forward	adelante
foster	alentar
fought	luchó
found	encontró
foundation	base
four	cuatro
fourteen	catorce
fox	zorro
fragile	frágil
frame	marco
framework	marco
fraud	fraude
freak	fenómeno
free	libre
freedom	libertad
freeze	congelar
frequency	frecuencia
frequent	frecuente
frequently	frecuentemente
fresh	fresco
friday	viernes
fridge	refrigerador
friend	amigo
friendly	amigable
friends	amigos
friendship	amistad
frightened	atemorizado
frightening	alarmante
frog	rana
from	desde
front	frente
frozen	congelado
fruit	fruta
frustrated	frustrado
fuel	combustible
Fulfulde	Fulfulde
full	lleno
fun	divertido
function	función
fundamental	fundamental
funeral	funeral
funny	divertido
fur	piel
furious	furioso
furniture	muebles
further	más
furthermore	además
future	futuro
gain	ganar
game	juego
gap	brecha
garage	cochera
garbage	basura
garden	jardín
garlic	ajo
gate	puerta
gather	reunir
gathering	reunión
gauge	medir
gave	dio
gear	engranaje
gender	género
general	general
generally	generalmente
generate	generar
generation	generación
generous	generoso
genius	genio
genre	género
gentle	amable
genuine	genuino
gesture	gesto
get	conseguir
get dressed	vestirse
get up	levantarse
get well soon	que te mejores pronto
getting	conseguir
ghost	fantasma
ghosting	imagen fantasma
giant	gigante
gift	regalo
ginger	jengibre
girl	chica
girlfriend	novia
give	dar
give up	abandonar
given	dado
glad	contento
glance	vistazo
glass	vidrio
glasses	anteojos
glimpse	vistazo
global	global
gloomy	sombrío
gloves	guantes
glow	brillo
glow up	iluminar
glue	pegamento
go	ir
go ahead	adelante
go away	vete
go to bed	irse a dormir
goal	objetivo
goals	objetivos
goat	cabra
god	dios
god bless you	que Dios te bendiga
goes	va
going	yendo
going to	ir a
gold	oro
gone	ido
gonna	ir a
goo	viscosidad
good	bien
good afternoon	buenas tardes
good bye	adiós
good day	buen día
good evening	buenas noches
good job	buen trabajo
good looking	buen mozo
good luck	buena suerte
good morning	buen día
good morning my love	buen día, mi amor
good night	buenas noches
goodbye	adiós
goodnight	buenas noches
goods	bienes
Google	Google
Google Translate	Google Translate
goose	ganso
gorgeous	espléndido
gossip	chisme
got	consiguió
got it	entiendo
government	gobierno
grab	agarrar
grade	grado
gradually	gradualmente
graduate	graduado
grain	grano
grant	otorgar
granted	otorgada
grapes	uvas
grasp	comprender
grass	hierba
grateful	agradecido
gratitude	gratitud
grave	tumba
gray	gris
great	excelente
greed	codicia
greedy	codicioso
green	verde
greet	saludar
greeting	saludo
greetings	saludos
grey	gris
grid	red
grief	pena
grind	moler
grip	agarre
grocery	tienda de comestibles
groom	novio
gross	bruto
ground	suelo
group	grupo
grow	crecer
growth	crecimiento
grumpy	gruñón
Guarani	guaraní
guarantee	garantizar
guard	guardia
guess	adivinar
guest	invitado
guidance	guía
guide	guía
guilty	culpable
guy	tipo
guys	tipos
gym	gimnasia
habit	hábito
habitat	hábitat
had	tuvo
hail	granizo
hair	cabello
half	mitad
hall	sala
hand	mano
handle	manejar
handsome	elegante
hang	colgar
hang out	pasar el tiempo
happen	suceder
happened	sucedió
happiness	felicidad
happy	feliz
happy birthday	feliz cumpleaños
happy birthday to you	feliz cumpleaños
happy new year	feliz año nuevo
hard	duro
hardly	difícilmente
hardly ever	prácticamente nunca
harm	daño
harmful	dañino
harmony	armonía
harsh	duro
harvest	cosecha
has	tiene
hate	odio
have	tener
have a good day	que tengas un buen día
have a nice day	que tengas un lindo día
have breakfast	desayunar
have fun	diviértete
have you eaten	has comido
having	tener
hazard	peligro
haze	bruma
he	él
he has	él tiene
he is	él es
head	cabeza
headache	dolor de cabeza
heal	sanar
healing	cura
health	salud
healthy	saludable
hear	escuchar
heard	escuchó
heart	corazón
heat	calor
heaven	cielo
heavy	pesado
hectic	agitado
height	altura
heir	heredero
heist	robo
held	sostuvo
hell	infierno
Hello	Hola
hello dear	hola, querido
hello how are you	hola, cómo estás
hello how are you doing	hola, cómo estás
helmet	casco
help	ayudar
helpful	útil
hence	por lo tanto
her	su
herd	rebaño
here	aquí
heritage	patrimonio
hesitate	dudar
Hey	¡ey!
Hi	Hola
hi how are you	hola, cómo estás
Hi there	hola
hidden	oculto
hide	esconder
hierarchy	jerarquía
high	alto
highlight	resaltar
hike	caminata
hiking	senderismo
hilarious	hilarante
hill	colina
him	a él
hint	pista
hip	cadera
hips	caderas
hire	contratar
hiring	contratación
his	su
history	historia
hit	golpear
Hmm	Mmm
hobby	pasatiempo
hold	sostener
hold on	esperar
hole	agujero
holiday	vacación
hollow	hueco
home	hogar
homework	tareas para el hogar
honest	honesto
honestly	honestamente
Honey	Miel
honor	honor
hood	capucha
hook	gancho
hop	saltar
hope	esperanza
hopefully	ojalá
hopeless	desesperanzado
horizontal	horizontal
horn	bocina
horrible	horrible
horror	horror
horse	caballo
hospital	hospital
hospitality	hospitalidad
host	anfitrión
hostile	hostil
hot	caliente
hotel	hotel
hour	hora
hours	horas
house	casa
household	hogar
how	cómo
how about you	y tú
how are you	cómo estás
how are you doing	cómo está
how are you doing today	cómo está hoy
how are you today	cómo estás hoy
how do you do	cómo estás
how is	cómo es
how many	cuántos
how much	cuánto
how often	con qué frecuencia
how old are you	cuántos años tiene
how was your day	cómo estuvo tu día
how was your night	cómo te fue anoche
however	sin embargo
hub	centro
hubby	afición
hug	abrazo
huge	gigante
human	humano
humble	humilde
humid	húmedo
humidity	humedad
hundred	ciento
hungry	hambriento
hunt	caza
hurricane	huracán
hurry	apuro
hurry up	apúrate
hurt	herir
husband	marido
hustle	ajetreo
hut	cabaña
hygiene	higiene
I	yo
I am	soy
I am fine	estoy bien
I can	puedo
I can't	no puedo
I do	sí
I do not know	no sé
I do not understand	no entiendo
I don't	yo no
I don't know	no sé
I don't understand	no entiendo
I don't understand what you mean	no entiendo lo que quieres decir
I don't understand you	no te entiendo
I don’t know	no sé
I don’t understand	no entiendo
i guess	supongo
I had	tuve
I have	tengo
I have been	Estuve
I hope so	eso espero
I know	lo sé
I like	me gusta
I like you	me gustas
I love	me encanta
I love my big brother	amo a mi hermano mayor
I love my big sister	amo a mi hermana mayor
I love my father	amo a mi padre
I love my little brother	amo a mi hermanito
I love my little sister	amo a mi hermanita
I love my mother	amo a mi madre
I love you	te amo
I love you so much	Te amo mucho
I love you too	yo también te amo
I mean	quiero decir
I miss you	Te extraño
I miss you so much	te extraño mucho
I see	ya veo
I think	pienso
I understand	entiendo
I want	deseo
I want to see you	quiero verte
I want you	te deseo
I was	estuve
I will	lo haré
I would be	Sería
I'm	soy
I'm fine	estoy bien
I'm good	estoy bien
I'm here	estoy aquí
I'm sorry	lo siento
ice	hielo
ice cream	helado
idea	idea
ideal	ideal
identical	idéntico
identify	identificar
identity	identidad
idiot	estúpido
idle	inactivo
if	si
ignore	ignorar
ill	enfermo
illegal	ilegal
illness	enfermedad
Ilocano	Ilocano
image	imagen
imagine	imaginar
immediate	inmediato
immediately	inmediatamente
immense	inmenso
impact	impacto
impatient	impaciente
implement	implementar
import	importar
important	importante
impose	imponer
impossible	imposible
impress	impresionar
impression	impresión
impressive	impresionante
improve	mejorar
improvement	mejora
in	en
in addition	además
In fact	En realidad
in front of	en frente de
in order to	para
inappropriate	inadecuado
incentive	incentivo
incident	incidente
include	incluir
including	incluido
income	ingreso
inconvenience	inconveniencia
increase	aumentar
increased	aumentó
incredible	increíble
indeed	por cierto
independent	independiente
India	India
indicate	indicar
indigenous	indígena
individual	individual
industry	industria
inevitable	inevitable
infant	niño
infection	infección
infinity	infinidad
inflammation	inflamación
inflation	inflación
influence	influencia
inform	informar
information	información
ingredients	ingredientes
inheritance	herencia
initial	inicial
initiative	iniciativa
injured	lesionado
injury	lesión
innocent	inocente
innovation	innovación
inquiry	consulta
insane	loco
insect	insecto
insecure	inseguro
insert	insertar
inside	dentro
insight	percepción
insist	insistir
insomnia	insomnio
inspiration	inspiración
inspire	inspirar
install	instalar
instance	instancia
instant	instante
instead	en cambio
instead of	en lugar de
instructions	instrucciones
instrument	instrumento
insult	insulto
insurance	seguro
intact	intacto
integrity	integridad
intellectual	intelectual
intelligence	inteligencia
intelligent	inteligente
intend	pretender
intended	destinado
intense	intenso
intention	intención
interact	interactuar
interaction	interacción
interest	interés
interested	interesado
interesting	interesante
interfere	interferir
intermediate	intermedio
internal	interno
international	internacional
internship	pasantía
interpret	interpretar
interpreter	intérprete
interrupt	interrumpir
interview	entrevista
intimate	íntimo
into	en
introduce	introducir
introduction	introducción
introvert	introvertido
intuition	intuición
invalid	inválido
invent	inventar
inventory	inventario
invest	invertir
investigate	investigar
invitation	invitación
invite	invitar
invoice	factura
involve	involucrar
involved	involucrado
iron	hierro
is	es
island	isla
isolated	aislado
issue	tema
issues	problemas
it	él
it is	es
it was	fue
it's	eso
it's ok	está bien
It's okay	está bien
item	artículo
items	elementos
its	su
I’m	soy
jacket	chaqueta
jail	cárcel
January	enero
jar	tarro
jaw	mandíbula
jealous	celoso
jerk	tirón
jewelry	joyas
job	trabajo
jogging	trote
join	unirse
joint	junta
joke	broma
journalist	periodista
journey	viaje
joy	alegría
judge	juez
juice	jugo
july	julio
jump	saltar
june	junio
junk	basura
just	justo
just do it	hazlo
justice	justicia
justify	justificar
Kalaallisut	Kalaallisut
keen	afecto
keep	mantener
keep it up	avanza
kept	mantuvo
kettle	tetera
key	llave
kick	patada
kid	niño
kidding	bromear
kidney	riñón
kids	niños
kill	matar
kind	tipo
kinda	un tanto
kindly	amablemente
kindness	amabilidad
king	rey
kiss	beso
kitchen	cocina
kite	cometa
kitten	gatito
knee	rodilla
knew	sabía
knife	cuchillo
knight	caballero
know	saber
knowledge	conocimiento
known	conocido
Konkani	Konkani
Krio	Krio
label	etiqueta
labor	trabajo
labour	mano de obra
lack	falta
ladder	escalera
lady	dama
laid	establecido
lake	lago
lamb	cordero
lame	cojo
lamp	lámpara
land	tierra
landscape	paisaje
language	idioma
lap	regazo
large	largo
last	último
last but not least	por último, pero no menos importante
last name	apellido
late	tarde
lately	últimamente
later	más tarde
latest	el último
latter	último
laugh	reír
laughing	reír
laughter	risa
launch	lanzar
laundry	lavadero
law	ley
lawn	césped
lawyer	abogado
lay	poner
layer	capa
layout	disposición
lazy	vago
lead	dirigir
leader	líder
leaf	lámina
leak	fuga
lean	inclinarse
leap	salto
learn	aprender
learning	aprendizaje
lease	arrendar
least	el menos
leather	cuero
leave	dejar
leaves	hojas
led	condujo
left	izquierda
leg	pierna
legacy	legado
legal	legal
legend	leyenda
legit	legal
leisure	tiempo libre
lend	prestar
length	longitud
less	menos
lesson	lección
let	dejar
letter	carta
lettuce	lechuga
level	nivel
leverage	aprovechar
liability	responsabilidad
library	biblioteca
lick	lamer
lie	mentir
lies	mentiras
life	vida
lift	levantar
light	luz
lightning	iluminación
like	gustar
likely	probable
likewise	asimismo
line	línea
Lingala	Lingala
link	enlace
lion	león
liquid	líquido
list	lista
listen	escuchar
listening	escuchar
literally	literalmente
literature	literatura
litter	lecho
little	pequeño
live	vivir
liver	hígado
lives	vidas
living	vivir
living room	sala de estar
lizard	lagarto
load	carga
loaf	pan
loan	préstamo
local	local
location	ubicación
lock	cerrar
lockdown	confinamiento
log	registro
lol	lol
lonely	solitario
long	largo
long time no see	mucho tiempo sin verlo
look	mirar
loop	bucle
loose	perder
lord	caballero
lose	perder
loss	pérdida
lost	perdido
lot	montón
loud	alto
lounge	salón
love	amar
love you	te amo
lovely	hermoso
low	bajo
lower	más bajo
loyal	leal
loyalty	lealtad
luck	suerte
lucky	afortunado
Luganda	Luganda
luggage	equipaje
lump	bulto
lunch	almuerzo
lungs	pulmones
luxury	lujo
lying	situado
machine	máquina
mad	loco
madam	señora
made	hecho
magazine	revista
magnificent	magnífico
maid	mucama
main	principal
maintain	mantener
maintenance	mantenimiento
Maithili	Maithili
major	principal
majority	mayoría
make	hacer
make up	constituir
male	masculino
mall	centro comercial
man	hombre
manage	administrar
management	gestión
manager	gerente
mandatory	obligatorio
manifest	manifiesto
manipulate	manipular
manner	manera
manual	manual
many	muchos
many many happy returns of the day	que cumplas muchos muchos años más
march	marzo
margin	margen
market	mercado
marriage	casamiento
married	casado
mask	mascarilla
mass	masa
massive	masivo
master	maestro
match	juego
mate	compañero
material	material
math	matemáticas
matter	importar
maturity	madurez
may	puede
maybe	tal vez
me	a mí
me too	yo también
meal	comida
mean	significar
meaning	significado
means	significa
meant	quiso decir
meanwhile	mientras tanto
measure	medir
measures	medidas
meat	carne
medical	médico
medicine	medicina
meditation	meditación
medium	medio
meet	reunir
meeting	reunión
Meiteilon	Meiteilon
melt	derretir
memories	recuerdos
memory	memoria
mental	mental
mention	mencionar
mentioned	mencionado
mentor	mentor
merchant	comerciante
mercy	merced
merely	meramente
merry christmas	feliz navidad
mess	lío
message	mensaje
messy	desordenado
metal	metal
method	método
mice	ratones
middle	medio
midnight	medianoche
might	podría
mild	leve
milestone	hito
military	militar
milk	leche
million	millón
mind	mente
mindset	mentalidad
mine	mío
mingle	mezclar
minor	menor
minute	minuto
minutes	minutos
miracle	milagro
mirror	espejo
miscellaneous	misceláneas
mischievous	travieso
miserable	miserable
misery	miseria
miss	extrañar
miss you	te extraño
missing	perdido
mission	misión
mist	niebla
mistake	error
Mizo	Mizo
mobile	móvil
mock	imitar
model	modelo
moderate	moderado
modern	moderno
modest	modesto
moist	húmedo
moisture	humedad
mold	moho
mole	lunar
mom	mamá
moment	momento
monday	lunes
money	dinero
monitor	monitor
monkey	mono
month	mes
mood	ánimo
moody	malhumorado
moon	luna
moral	moral
more	más
moreover	además
morning	mañana
mortgage	hipoteca
most	mayoría
mostly	principalmente
mother	madre
motion	movimiento
motivation	motivación
mountain	montaña
mouse	ratón
mouth	boca
move	mover
movement	movimienot
movie	película
mrs	sra.
much	mucho
mud	lodo
mug	tazón
muscle	músculo
museum	museo
mushroom	hongo
music	música
must	debe
mute	silenciar
mutual	mutual
my	mi
My dear	Estimado
my friend	mi amigo
My hovercraft is full of eels	Mi aerodeslizador está lleno de anguilas
my love	mi amor
my name is	mi nombre es
my pleasure	un placer
myself	mí mismo
mysterious	misterioso
mystery	misterio
myth	mito
nail	uña
naive	ingenuo
name	nombre
narrative	narrativo
narrow	angosto
nasty	asqueroso
national	nacional
nationality	nacionalidad
native	nativo
natural	natural
nature	naturaleza
nausea	náuseas
near	cerca
nearby	cercano
nearly	cerca de
neat	pulcro
necessary	necesario
neck	cuello
necklace	collar
need	necesidad
negative	negativo
neglect	descuido
negotiate	negociar
neighbor	vecino
neighborhood	vecindario
neither	ni
nephew	sobrino
nerd	nerd
nervous	nervioso
nest	nido
net	neto
network	red
neutral	neutral
never	nunca
never give up	nunca abandones
never mind	no importa
nevermind	no importa
nevertheless	sin embargo
new	nuevo
news	noticias
next	próximo
next to	junto a
nice	lindo
nice to meet you	encantado de conocerlo
niece	sobrina
night	noche
nightmare	pesadilla
nine	nueve
nineteen	diecinueve
ninety	noventa
No	No
no problem	ningún problema
no way	de ningún modo
nobody	nadie
noise	ruido
noisy	ruidoso
none	ninguno
noon	mediodía
nope	no
nor	ni
normal	normal
north	norte
nose	nariz
nostalgic	nostálgico
not	no
not at all	de nada
not bad	no está mal
Not now	no ahora
not yet	no todavía
note	nota
noted	anotado
nothing	nada
notice	observar
noticed	observó
noun	sustantivo
nouns	sustantivos
novel	novedoso
november	noviembre
now	ahora
nowadays	hoy en día
nuisance	tontería
null	nulo
numb	adormecer
number	número
nurse	enfermero
nut	tuerca
nutmeg	nuez moscada
nutrition	nutrición
oath	juramento
obesity	obesidad
obey	obedecer
object	objeto
objective	objetivo
obligation	obligación
obscure	oscuro
observation	observación
observe	observar
obsessed	obsesionado
obsession	obsesión
obsolete	obsoleto
obstacle	obstáculo
obtain	obtener
obtained	obtenido
obvious	obvio
obviously	obviamente
occasionally	ocasionalmente
occupation	ocupación
occupied	ocupado
occur	ocurrir
occurred	ocurrió
occurs	ocurre
ocean	océano
october	octubre
odd	extraño
odds	posibilidades
of	de
of course	por supuesto
off	apagado
offensive	ofensivo
offer	oferta
office	oficina
official	oficial
often	a menudo
Oh	Vaya
oh really	en serio
oil	aceite
ok	de acuerdo
ok dear	de acuerdo, querido
ok honey	de acuerdo, cariño
ok my love	de acuerdo, mi amor
okay	de acuerdo
okay baby	de acuerdo, bebé
okay dear	de acuerdo, querido
okay honey	de acuerdo, cariño
okay my love	de acuerdo, mi amor
old	viejo
on	en
once	una vez
one	uno
one language is never enough	un solo idioma nunca es suficiente
onion	cebolla
online	en línea
only	solo
open	abierto
operation	operación
opinion	opinión
opportunities	oportunidades
opportunity	oportunidad
opposite	opuesto
optimistic	optimista
option	opción
optional	opcional
or	o
orange	naranja
order	ordenar
ordinary	común
organization	organización
orientation	orientación
origin	origen
original	original
Oromo	Oromo
orphan	huérfano
other	otro
otherwise	de lo contrario
ought	debería
our	nuestro
Our mission: to enable everyone, everywhere to understand the world and express themselves across languages.	Nuestra misión: Permitir que todos, en todas partes, conozcan el mundo y se expresen en todos los idiomas.
Our mission: to organize the world's information and make it universally accessible and useful.	Nuestra misión: organizar la información del mundo y hacer que sea accesible y útil.
out	fuera
outcome	resultado
outfit	vestimenta
outgoing	saliente
outlet	salida
outline	describir
outside	fuera
outstanding	pendiente
oven	horno
over	encima
over there	allí
overall	general
overcome	superar
overthinking	cavilaciones
overwhelmed	abrumado
overwhelming	abrumador
owe	deber
owl	búho
own	propio
owner	propietario
ox	buey
pace	paso
pack	embalar
package	paquete
paid	pagado
pain	dolor
paint	pintar
painting	pintura
pair	par
pale	pálido
palm	palmera
pan	cacerola
pandemic	pandemia
panic	pánico
pants	pantalones
paper	papel
paradise	paraíso
parallel	paralelo
parcel	parcela
pardon	indulto
parents	padres
park	parque
parrot	loro
parsley	perejil
part	parte
participate	participar
particular	particular
particularly	particularmente
partner	socio
party	fiesta
pass	pasar
passage	paso
passed	pasó
passion	pasión
passionate	apasionado
passive	pasivo
password	contraseña
past	pasado
patch	parche
path	camino
pathetic	patético
patience	paciencia
patient	paciente
pattern	patrón
pause	pausa
pavement	acera
pay	pagar
payment	pago
peace	paz
peaceful	pacífico
peach	durazno
peak	pico
pear	pera
peas	guisantes
peculiar	peculiar
pee	orinar
peel	cáscara
peer	par
peers	pares
pen	lapicera
pencil	lápiz
pending	pendiente
people	gente
pepper	pimienta
perceive	percibir
perception	percepción
perfect	perfecto
perform	realizar
performance	rendimiento
perhaps	tal vez
period	período
permanent	permanente
permission	permiso
permit	permiso
perseverance	perserverancia
persistent	persistente
person	persona
personal	personal
personality	personalidad
perspective	perspectiva
persuade	persuadir
pervert	pervertido
pet	mascota
phase	fase
phenomenon	fenómeno
philosophy	filosofía
phone	teléfono
photo	foto
phrase	frase
physical	físico
pick	recoger
pick up	pasar a buscar
picture	imagen
piece	pedazo
pieces	piezas
pig	cerdo
pigeon	paloma
pile	montón
pillow	almohada
pilot	piloto
pin	clavo
pineapple	piña
pink	rosa
pit	foso
pitch	paso
pity	lástima
place	lugar
places	lugares
plague	plaga
plain	plano
plan	plan
plane	avión
plant	planta
plants	plantas
plate	placa
platform	plataforma
play	jugar
playing	jugando
pleasant	placentero
please	por favor
pleased	complacido
pleasure	placer
pledge	prometer
plenty	infinidad
plot	trama
plug	enchufe
plum	ciruela
plumber	plomero
plural	plural
podcast	podcast
poem	poema
poetry	poesía
point	punto
poison	veneno
police	policía
policy	política
polite	educado
pollution	contaminación
pond	estanque
pool	piscina
poop	caca
poor	pobre
pop	estallido
popular	popular
population	población
pork	cerdo
porridge	papilla
port	puerto
position	posición
positive	positivo
possess	poseer
possession	posesión
possessive	posesivo
possible	posible
post	publicar
postpone	posponer
potato	papa
potential	potencial
pound	libra
poverty	pobreza
power	fuerza
powerful	poderoso
practical	práctico
practice	práctica
praise	elogio
prank	broma
pray	orar
precious	precioso
precise	preciso
precisely	precisamente
predict	predecir
prefer	preferir
preference	preferencia
pregnant	embarazada
prejudice	prejuicio
premises	instalaciones
premium	de primera calidad
preparation	preparación
prepare	preparar
prepared	preparado
preposition	preposición
presence	presencia
present	presente
presentation	presentación
preserve	preservar
president	presidente
press	prensa
pressure	presión
pretend	pretender
pretty	bonito
prevent	prevenir
previous	previo
prey	presa
price	precio
pride	orgullo
priest	sacerdote
primary	primario
prime	principal
princess	princesa
principal	principal
prior	previo
priority	prioridad
prison	prisión
privacy	privacidad
private	privado
privilege	privilegio
prize	premio
probably	probablemente
problem	problema
procedure	procedimiento
proceed	proceder
process	proceso
produce	producir
product	producto
production	producción
profession	profesión
professional	profesional
profile	perfil
profit	ganancia
profound	profundo
progress	progreso
project	proyecto
prominent	prominente
promise	promesa
promote	promover
promotion	promoción
prompt	oportuno
prone	propenso
pronouns	pronombres
pronunciation	pronunciación
proof	prueba
proper	correcto
properly	adecuadamente
properties	propiedades
property	propiedad
proposal	propuesta
prospect	prospecto
prosperity	prosperidad
prosperous	próspero
protect	proteger
proud	orgulloso
prove	probar
provide	proporcionar
provided	provisto
province	provincia
provision	disposición
puberty	pubertad
public	público
pull	tirar
pumpkin	calabaza
punctual	puntual
pupil	alumno
purchase	compra
pure	puro
purple	púrpura
purpose	objetivo
purse	monedero
pursue	buscar
pursuit	buscar
push	empujar
put	poner
qualification	calificación
quality	calidad
quantity	cantidad
quarantine	cuarentena
quarrel	disputa
quarter	trimestre
Quechua	quechua
queen	reina
queer	raro
query	consulta
question	pregunta
queue	cola
quick	rápido
quickly	rápidamente
quiet	tranquilo
quilt	colcha
quit	abandonar
quite	bastante
quiz	prueba
quotation	cotización
quote	cotizar
quotes	cotizaciones
rabbit	conejo
race	raza
rage	furia
rain	lluvia
raise	elevar
raised	aumentó
ran	corrió
random	aleatorio
range	rango
rapid	rápido
rapidly	rápidamente
rare	extraño
rarely	poco frecuentemente
rash	erupción
rat	rata
rate	tasa
rather	en lugar de
ratio	relación
rational	racional
raw	crudo
re	re
reach	alcanzar
reached	alcanzó
reaction	reacción
read	leer
reading	lectura
ready	listo
real	real
reality	realidad
realize	darse cuenta
realized	se dio cuenta
really	realmente
rear	trasero
reason	razón
reasonable	razonable
recall	recordar
receipt	recibo
receive	recibir
received	recibió
recent	reciente
recently	recientemente
reception	recepción
recipe	receta
reckless	imprudente
recognition	reconocimiento
recognize	reconocer
recommend	recomendar
recommended	recomendado
record	registro
recover	recuperar
recovery	recuperación
rectangle	rectángulo
red	rojo
redeem	canjear
redemption	redención
reduce	reducir
redundant	redundante
refer	referirse
reference	referencia
reflect	reflejar
reflection	reflexión
refrain	abstenerse
refrigerator	refrigerador
refund	reembolso
refuse	rechazar
refused	rechazado
regard	respecto
regarding	acerca de
regardless	independientemente
regards	saludos
region	región
register	registro
regret	arrepentirse
regular	regular
regularly	regularmente
reject	rechazar
relate	relatar
related	relacionado
relationship	relación
relative	relativo
relatives	parientes
relax	relax
release	liberar
released	liberado
relevant	importante
reliable	confiable
relief	alivio
relieve	relevar
relieved	aliviado
religion	religión
religious	religioso
reluctant	reacio
rely	confiar
remain	permanecer
remaining	restante
remarkable	notable
remedy	recurso
remember	recordar
remind	recordar
reminder	recordatorio
remote	remoto
remove	remover
render	prestar
rent	alquiler
repair	reparar
repeat	repetir
replace	reemplazar
reply	responder
report	informe
represent	representar
reputation	reputación
request	solicitar
require	requerir
required	solicitado
rescue	rescate
research	investigación
resemble	parecerse
resentment	resentimiento
reservation	reserva
reserve	reservar
resident	residente
resign	renunciar
resilience	resiliencia
resilient	resiliente
resist	resistir
resistance	resistencia
resolution	resolución
resolve	resolver
resort	complejo
resources	recursos
respect	respeto
respond	responder
response	respuesta
responsibility	responsabilidad
responsible	responsable
rest	descansar
rest in peace	que descanse en paz
restaurant	restaurante
restore	restaurar
restrict	restringir
result	resultado
results	resultados
resume	resumir
retail	minorista
retain	retener
retention	retención
retired	jubilado
retreat	retiro
retrieve	recuperar
return	devolver
reveal	revelar
revealed	reveló
revenge	venganza
revenue	ganancia
reverse	reverso
review	revisar
revise	revisar
revision	revisión
revolution	revolución
reward	premio
rhythm	ritmo
rib	costilla
rice	arroz
rich	rico
rid	librar
ride	conducir
ridiculous	ridículo
right	bien
right now	en este momento
rigid	rígido
ring	anillo
rinse	enjuagar
riot	disturbio
rip	rotura
ripe	maduro
rise	elevar
risk	riesgo
rival	rival
river	río
road	camino
roast	tostar
robust	robusto
rock	rock
rod	varilla
role	role
roll	rollo
roof	techo
room	habitación
root	raíz
rope	soga
rotten	podrido
rough	bruto
roughly	apenas
round	redondo
route	ruta
routine	rutina
row	fila
rub	frotar
rubber	goma
rubbish	basura
rude	brusco
rug	alfombra
ruin	ruina
rule	regla
ruler	regla
rules	reglas
run	correr
running	correr
rural	rural
rush	correr
sack	bolsa
sacred	sagrado
sacrifice	sacrificio
safe	seguro
safe flight	vuelo seguro
safety	seguridad
sage	sabio
said	dijo
sail	navegar
sailing	navegar
sake	bien
salary	salario
sale	venta
salmon	salmón
salt	sal
same	mismo
Same here	igual aquí
sample	muestra
sand	arena
Sanskrit	Sanskrit
sarcastic	sarcástico
sassy	atrevido
sat	sentó
satisfaction	satisfacción
satisfied	satisfecho
satisfy	satisfacer
satisfying	satisfactorio
Saturday	sábado
sausage	embutido
savage	salvaje
save	guardar
saw	vio
say	decir
scale	escala
scam	estafa
scar	cicatriz
scarce	escaso
scared	asustado
scarf	bufanda
scary	aterrador
scattered	disperso
scene	escena
scenery	escenario
scent	aroma
schedule	cronograma
school	escuela
science	ciencia
scientist	científico
scientists	científicos
scissors	tijeras
scold	regañar
scope	alcance
score	puntaje
scrap	chatarra
scratch	rascar
scream	gritar
screen	pantalla
screw	tornillo
script	guion
sea	mar
seal	sello
search	búsqueda
season	estación
seat	asiento
second	segundo
secret	secreto
section	sección
secure	seguro
security	seguridad
see	ver
see you	nos vemos
see you later	te veo luego
see you soon	te veo pronto
see you tomorrow	te veo mañana
seed	semilla
seek	buscar
seem	parecer
seems	parece
seen	visto
seize	tomar
seizure	convulsión
seldom	rara vez
select	seleccionar
self	ser
self healing	autosanación
selfish	egoísta
sell	vender
send	enviar
send me your picture	envíame tu foto
senior	sénior
sense	sentido
sensible	sensitivo
sensitive	sensible
sent	enviado
sentence	oración
sentences	oraciones
separate	separado
Sepedi	Sepedi
september	septiembre
sequence	secuencia
series	serie
serious	serio
seriously	seriamente
serve	servir
service	servicio
session	sesión
set	establecer
set up	configurar
setting	entorno
settle	asentarse
seven	siete
seventeen	diecisiete
seventy	setenta
several	varios
severe	severo
sew	coser
shade	sombra
shadow	sombra
shake	sacudir
shall	va a
shallow	poco profundo
shame	verguenza
shape	forma
share	compartir
sharp	agudo
she	ella
she has	ella tiene
she is	ella es
shed	galpón
sheep	oveja
sheet	hoja
shelf	estante
shell	caparazón
shelter	refugio
shield	escudo
shift	turno
shine	brillar
ship	barco
shipping	envío
shirt	camisa
shoes	zapatos
shoot	disparar
shop	comercio
shopping	compras
shore	costa
short	corto
shortage	escasez
shot	tiro
should	debe
shoulder	hombro
shout	gritar
show	mostrar
show me	muéstrame
shower	ducha
shrimp	camarón
shrink	encoger
shut	cerrar
shut up	callarse la boca
shy	tímido
sibling	hermano
siblings	hermanos
sick	enfermo
side	lado
sigh	suspiro
sight	vista
sightseeing	pasear
sign	firmar
signature	firma
significant	significativo
silence	silencio
silent	silencioso
silk	seda
silly	tonto
silver	plata
similar	similar
simp	simp
simple	simple
simultaneously	simultáneamente
since	desde
sincere	sincero
sincerely	sinceramente
sing	cantar
singer	cantante
single	soltero
sink	pileta
Sir	Señor
sister	hermana
sister in law	cuñada
sit	sentarse
site	sitio
situation	situación
six	seis
sixteen	dieciséis
sixty	sesenta
size	tamaño
skill	habilidad
skills	habilidades
skin	piel
skinny	flaco
skip	saltear
skirt	falda
sky	cielo
slave	esclavo
sleep	dormir
sleeping	durmiendo
sleepy	somnoliento
sleeve	manga
slice	rebanada
slide	deslizar
slightly	ligeramente
slim	delgado
slip	resbalar
slope	pendiente
slot	ranura
slow	lento
slowly	lentamente
small	pequeño
smart	elegante
smell	oler
smile	sonrisa
smoke	fumar
smooth	suave
snack	bocadillo
snail	caracol
snake	víbora
snap	siesta
snow	nieve
so	entonces
so cute	tan lindo
so far	tan lejos
soak	remojar
soap	jabón
sober	sobrio
soccer	fútbol
social	social
society	sociedad
socks	medias
soft	suave
software	software
soil	suelo
sold	vendido
sold out	agotado
soldier	soldado
sole	único
solid	sólido
solution	solución
solve	resolver
some	alguno
somebody	alguien
somehow	de alguna manera
someone	alguien
something	algo
sometimes	a veces
song	canción
soon	pronto
sophisticated	sofisticado
Sorani	Sorani
sore	úlcera
sore throat	dolor de garganta
sorrow	pena
Sorry	Lo siento
sort	tipo
sought	buscado
soul	alma
soulmate	alma gemela
sound	sonido
soup	sopa
sour	agrio
source	fuente
south	sur
space	espacio
spam	correo basura
span	durar
Spanish	español
Spanish	castellano
spare	sobrante
speak	hablar
special	especial
species	especies
specific	específico
spectacular	espectacular
speech	habla
speechless	sin habla
speed	velocidad
spell	deletrear
spend	gastar
spent	gastó
spicy	picante
spike	espiga
spin	girar
spinach	espinaca
spirit	espíritu
spit	escupir
splendid	espléndido
split	dividir
spoil	arruinar
spoiled	arruinado
spontaneous	espontáneo
spoon	cuchara
spot	punto
spouse	cónyuge
spread	desparramar
spring	primavera
square	cuadrado
squeeze	estrujar
squid	calamar
squirrel	ardilla
st	calle
stab	puñalada
stable	estable
stack	pila
staff	personal
stage	etapa
stain	mancha
stairs	escaleras
stake	participación
stalk	acechar
stall	parar
stamp	estampilla
stand	permanecer
standard	estándar
star	estrella
start	comenzar
started	comenzó
starving	morirse de hambre
state	estado
statement	declaración
station	estación
statue	estatua
status	estado
stay	permanecer
stay safe	mantenerse seguro
steady	estable
steak	churrasco
steal	robar
steam	vapor
steel	acero
steep	empinado
stem	provenir
step	paso
stick	vara
stiff	tieso
still	todavía
sting	picadura
stingy	tacaño
stir	remover
stock	existencias
stolen	robado
stomach	estómago
stone	piedra
stood	soportó
stool	heces
stop	detener
storage	almacenamiento
store	almacenar
storm	tormenta
story	historia
stove	estufa
straight	directo
straightforward	directo
strain	tensión
strange	extraño
stranger	extraño
strategy	estrategia
straw	paja
strawberry	fresa
streak	trazo
stream	corriente
street	calle
strength	fortaleza
stress	estrés
stretch	estirar
strict	estricto
strike	huelga
string	cadena
strip	tira
strive	luchar
stroke	ataque
strong	fuerte
struck	golpeado
structure	estructura
struggle	luchar
struggling	luchando
stubborn	tenaz
stuck	atascado
student	alumno
study	estudiar
studying	estudiando
stuff	cosa
stunning	impresionante
stupid	tonto
style	estilo
subject	sujeto
submission	envío
submit	enviar
substance	sustancia
substitute	sustituto
subtle	sutil
succeed	tener éxito
success	éxito
successful	exitoso
such	tal
such as	tal como
suck	chupar
sudden	repentino
suddenly	de repente
suffer	sufrir
suffering	sufrimiento
sufficient	suficiente
sugar	azúcar
suggest	sugerir
suggestion	sugerencia
suit	traje
suitable	adecuado
suitcase	valija
sum	suma
summary	resumen
summer	verano
summit	cumbre
sun	sol
sunday	domingo
sunny	soleado
sunset	atardecer
sunshine	luz solar
super	súper
superior	superior
supervisor	supervisor
supper	cena
supply	suministrar
support	soporte
suppose	suponer
supposed	supuesto
sure	seguro
surface	superficie
surge	sobretensión
surgery	cirugía
surname	apellido
surprise	sorpresa
surprised	sorprendido
surrender	rendirse
surrounding	circundante
surveillance	vigilancia
survey	encuesta
survive	sobrevivir
suspect	sospechar
suspended	suspendido
suspicious	sospechoso
sustain	sostener
sustainability	sostenibilidad
sustainable	sostenible
swag	botín
swallow	tragar
swap	intercambio
swear	jurar
sweat	sudor
sweater	suéter
sweep	barrer
sweet	dulce
sweet dreams	dulces sueños
sweet tooth	goloso
sweetheart	cariño
swell	hinchar
swelling	hinchazón
swim	nadar
swimming	nadar
swing	ritmo
switch	cambiar
swollen	hinchado
sword	espada
symbol	símbolo
sympathy	compasión
symptoms	síntomas
system	sistema
table	mesa
tackle	abordar
tag	etiqueta
tail	cola
take	tomar
take away	llevar
take care	cuidarse
take off	despegar
taken	tomado
talk	hablar
talkative	conversador
tall	alto
tap	tocar
tape	cinta
target	objetivo
task	tarea
taste	sabor
tasty	sabroso
taught	enseñó
tea	té
teach	enseñar
teacher	maestro
team	equipo
tear	lágrima
tears	lágrimas
tease	molestar
technology	tecnología
teeth	dientes
tell	decir
tell me	dime
temper	temperamento
temperature	temperatura
temple	templo
temporary	temporario
ten	diez
ten thousand	diez mil
tenant	arrendatario
tend	tender
tendency	tendencia
tender	licitación
tense	tenso
tension	tensión
tent	carpa
tentative	tentativo
term	término
terms	términos
terrible	horrible
terrific	fantástico
territory	territorio
test	prueba
text	texto
than	que
thank	agradecer
thank you	gracias
Thank you for your patience while we investigate shipment	Gracias por su paciencia mientras averiguamos sobre el envío
thank you so much	muchas gracias
thank you very much	muchas gracias
thanks	gracias
Thanks for using our app	Gracias por usar nuestra aplicación
that	que
that is	eso es
that's good	está bien
the	él
theft	robo
their	sus
them	a ellos
theme	temática
themselves	ellos mismos
then	luego
theory	teoría
there	allá
there are	hay
there is	hay
therefore	por lo tanto
these	estos
they	ellos
they are	son
thick	grueso
thief	ladrón
thigh	muslo
thin	delgado
thing	cosa
things	cosas
think	pensar
third	tercero
thirsty	sediento
thirteen	trece
thirty	treinta
this	este
this is	esto es
thorough	minucioso
thoroughly	minuciosamente
those	aquellos
though	aunque
thought	pensamiento
thoughtful	reflexivo
thoughts	pensamientos
thousand	mil
thread	hilo
threat	amenaza
threaten	amenazar
three	tres
threshold	umbral
thrilled	encantado
thrive	prosperar
throat	garganta
through	a través de
throughout	a lo largo de
throw	tirar
thumb	pulgar
thunder	trueno
Thursday	jueves
thus	de este modo
tick	marcar
tide	marea
tidy	ordenado
tie	atar
tiger	tigre
tight	ajustado
Tigrinya	Tigrinya
time	tiempo
timid	tímido
tiny	diminuto
tip	consejo
tips	consejos
tire	neumático
tired	cansado
tissue	tejido
title	título
to	a
to be	ser
toast	tostada
today	hoy
toddler	niño pequeño
toes	dedos del pie
together	juntos
toilet	baño
told	dijo
tolerance	tolerancia
tolerate	tolerar
tomato	tomate
tomorrow	mañana
tongue	lengua
tonight	esta noche
too	también
took	tomó
tool	herramienta
tools	herramientas
tooth	diente
top	arriba
topic	tema
torn	rasgado
torture	tortura
total	total
touch	toque
tough	pese
tour	recorrido
toward	hacia
towards	hacia
towel	toalla
town	pueblo
toxic	tóxico
trace	rastro
track	rastrear
trade	comercio
tradition	tradición
traditional	tradicional
traffic	tráfico
trail	camino
train	tren
training	capacitación
trait	rasgo
traits	rasgos
transfer	transferir
transition	transición
translate	traducir
transparent	transparente
transport	transporte
transportation	transporte
trap	trampa
trash	basura
trauma	trauma
travel	viaje
tray	bandeja
treasure	tesoro
treat	tratar
treatment	tratamiento
tree	árbol
tremendous	enorme
trend	tendencia
trial	ensayo
trick	truco
tried	intentó
trigger	generar
trim	recortar
trip	viaje
trouble	problema
trousers	pantalones
truck	camión
true	verdadero
trunk	trompa
trust	confianza
truth	verdad
try	intentar
Tsonga	Tsonga
tube	tubo
Tuesday	martes
tuition	matrícula
turkey	pavo
turmeric	cúrcuma
turn	doblar
turtle	tortuga
tutor	tutor
twelve	doce
twenty	veinte
twenty-one	veintiuno
Twi	Twi
twice	dos veces
twist	girar
two	dos
type	tipo
typical	típico
ugly	feo
ultimate	último
umbrella	paraguas
unable	incapaz
uncle	tío
unconscious	inconsciente
under	bajo
underneath	debajo
underrated	subestimado
understand	entender
understood	entendí
unfortunately	desafortunadamente
uniform	uniforme
unique	único
unit	unidad
university	universidad
unknown	desconocido
unless	a menos que
until	hasta
unusual	inusual
up	arriba
up to you	tú decides
update	actualizar
upgrade	mejora
upon	sobre
upset	decepcionado
urban	urbano
urge	urgir
urgent	urgente
us	a nosotros
use	usar
used	usado
useful	útil
useless	inútil
usual	habitual
usually	generalmente
utility	utilidad
vacation	vacación
vaccination	vacunación
vaccine	vacuna
vacuum	vacío
vague	impreciso
valid	válido
valley	valle
valuable	valioso
value	valor
variety	variedad
various	varios
vary	variar
vase	florero
vast	vasto
vegetable	verdura
vegetables	verduras
vehicle	vehículo
vendor	proveedor
venom	veneno
venture	empresa
venue	evento
verify	verificar
versatile	versátil
version	versión
vertical	vertical
very	muy
very good	muy bien
vessel	buque
via	a través de
vibe	onda
vibes	vibras
vicious	vicioso
victim	víctima
video	video
view	vista
village	aldea
villain	villano
vinegar	vinagre
vintage	antiguo
violence	violencia
violent	violento
viral	viral
virgin	virgen
virtual	virtual
virtue	virtud
vision	visión
visit	visita
visual	visual
vital	vital
vivid	vívido
vocabulary	vocabulario
voice	voz
void	vacío
volume	volumen
volunteer	voluntario
vomit	vomitar
vulnerable	vulnerable
wage	salario
wages	salarios
waist	cintura
wait	esperar
waiter	mozo
waiting	esperando
wake	despertar
wake up	despertar
walk	caminar
walking	caminando
wall	pared
wallet	billetera
wander	vagar
wanna	quiero
want	desear
wanted	buscado
war	guerra
wardrobe	placard
warehouse	depósito
warm	cálido
warn	advertir
warning	advertencia
warrior	guerrero
was	fue
wash	lavar
waste	desperdiciar
watch	mirar
water	agua
watermelon	sandía
wave	ola
way	forma
we	nosotros
we are	somos
we can	podemos
weak	débil
weakness	debilidad
wealth	riqueza
wealthy	saludable
wear	usar
wearing	usando
weather	clima
wedding	boda
Wednesday	miércoles
weed	hierba
week	semana
weekend	fin de semana
weight	peso
weird	extraño
welcome	bienvenido
welfare	bienestar
Well	Bueno
well done	bien hecho
went	fue
were	estuvo
west	oeste
wet	húmedo
whale	ballena
what	qué
what about you	qué pasa contigo
what are you doing	qué haces
what are you doing now	qué hace ahora
what are you doing right now	que estás haciendo en este momento
what do you do	qué haces
what do you do for a living	de qué vives
what do you mean	qué quieres decir
what do you want	qué deseas
what happened	qué sucedió
what is	qué es
what is this	qué es esto
what is your job	de qué trabajas
what is your name	cómo te llamas
what's up	qué pasa
what's your name	cómo te llamas
whatever	lo que sea
wheat	trigo
wheel	rueda
when	cuándo
whenever	en cualquier momento
where	dónde
where are you	dónde estás
where are you from	de dónde eres
where are you now	dónde estás ahora
where do you live	dónde vives
where is	dónde es
whereas	mientras
whether	si
which	cuál
while	mientras
whisper	susurro
whistle	silbato
white	blanco
who	quién
who are you	quién eres
who is	quién es
who is this	quién es
whole	entero
whom	a quién
whose	cuyo
why	por qué
why not	por qué no
wicked	malvado
wide	ancho
widow	viuda
width	ancho
wife	esposa
wild	salvaje
will	voluntad
willing	deseoso
win	ganar
wind	viento
window	ventana
windy	ventoso
wine	vino
winter	invierno
wipe	limpiar
wire	cable
wisdom	sabiduría
wise	inteligente
wish	desear
wish you all the best	te deseo lo mejor
witch	bruja
with	con
withdraw	retirar
withdrawal	retiro
within	dentro
without	sin
witness	testigo
witty	ingenioso
wolf	lobo
woman	mujer
women	mujer
won	ganó
won't	no va a
wonder	preguntarse
wonderful	maravilloso
wood	madera
wool	lana
word	palabra
words	palabras
work	trabajar
work out	elaborar
working	trabajando
world	mundo
worm	gusano
worn	usado
worried	preocupado
worry	preocuparse
worse	peor
worship	culto
worst	el peor
worth	valor
worth it	vale la pena
worthy	valioso
wound	herida
Wow	Guau
wrap	envolver
wrath	ira
wrist	pulsera
write	escribir
Write here	Escribe aquí
writing	escritura
written	escrito
wrong	equivocado
wrote	escribió
yard	patio
yawn	bostezo
Yeah	sí
year	año
years	años
yeast	levadura
yell	gritar
yellow	amarillo
Yes	Sí
yes baby	sí, bebé
yes dear	sí, querido
yes honey	sí, cariño
yes my love	sí, mi amor
yes of course	sí, claro
yesterday	ayer
yet	todavía
yield	rendir
you	tú
you are	tú eres
you are beautiful	eres hermoso
you are so beautiful	eres tan hermoso
you are welcome	de nada
you can	puedes
You know	sabes
you too	tú también
you're welcome	de nada
young	joven
your	su
your welcome	de nada
yourself	tú mismo
youth	juventud
you’re welcome	de nada
yummy	delicioso
zero	cero
