abandoned	si wogblẽ ɖi
abandon	gble ɖi
abide	nɔ anyi
ability	ŋutete
able	te ŋu
about	ku ɖe
above	dzi me
abroad	ablotsi
absence	aƒetsitsi
absent	tsi aƒe
absolutely	blibo
absorb	no
abstract	totoɖeme
absurd	si gɔme menyase o
abundance	do agbogbo
abundant	si sɔgbɔ
abuse	wᴐ funyafunya
accent	gbetete
accept	lɔ̃ ɖe edzi
access	mᴐnu
accident	afɔku
accommodation	nᴐƒe
accomplished	wu nu nu
accomplish	wu enu
according	le enu
account	akᴐnta
accuracy	ɖoɖonunɔnɔ
accurate	de
accused	sedzidala
ache	vevesese
achieve	kpᴐ ŋudzedze
achievement	dzidzedzekpɔkpɔ
acknowledge	de dzesi
acquaintance	ame si wodo goe
acquired	xɔ
acquire	ƒle
acquisition	nu ƒeƒle
across	to eme
action	nuwɔwɔ
active	le dɔwɔm
activities	nuwɔnawo
activity	nuwɔna
actor	fefewɔla
actually	li fifia
actual	si li fia
act	wɔ nu
acute	si kɔ dzi
adapt	trɔ
addicted	zu numame
additional	si kpe ɖe eŋu
addition	kpekpeɖeŋu
add	kpee ɖe eŋu
address	adrɛs
adequate	si de
adjacent	de axa
adjective	nyaɖɔnya
adjust	wɔ ɖɔɖɔɖo
admire	dzᴐa dzi
admit	xᴐ
adopt	xɔ
adorable	nyo ŋutᴐ
advanced	de ŋgɔ
advance	do ŋgᴐ
advantage	ŋusẽkpᴐkpᴐ
adventure	numetoto
adverb	dɔwɔnyaɖɔnya
advertisement	boblododo
advertising	le boblodom
advice	aɖaŋu
advise	ɖo aɖaŋu
advocate	nyaxɔɖeakɔla
aesthetic	tugbedzedze
affair	nya
affection	lɔlɔ̃ɖeɖefia
affect	wᴐ dᴐ ɖe edzi
affordable	si mexɔ asi o
afford	ate ŋu aƒle
afraid	vɔvɔm
after	emegbe
afternoon	ŋdᴐ
afterwards	emegbe
again	ake
against	tsi tsitre ɖe eŋu
age	ƒe
agency	alɔdze
agent	dɔla
aggressive	kple ŋusẽ
agile	zã
ago	si va yi
agree	lɔ̃ ɖe edzi
agreement	nublabla
agriculture	agbledede
ahead	le ŋgɔ
aid	kpeɖeŋu
aim	taɖodzi
airport	yameʋudzeƒe
air	ya
aisle	gbedoxɔme mɔ
alarm	gbeɖiɖi
alcohol	ahasesẽ
alert	ŋute
a little	ʋee
alive	le agbe
all	katã
allow	ɖe asi le eŋu
allowed	ɖe asi
all right	enyo
all the best	eme nenyo
almost	kloẽ
alone	akogo
along	le eŋu
a lot	geɖe
a lot of	geɖe
already	do ŋgɔ xoxo
Alright	Enyo
also	hã
alternative	nu bubu
although	togbɔ be
always	ɣe sia ɣi
amazing	wɔ nuku
ambiguous	si me mekɔ o
ambition	didi
ambitious	doa nutami
amend	wɔ tɔtrɔ
amid	wodome
am	nye
among us	miadome
among	wo dome
amount	home
amusing	ɖi kokoe
analysis	numedzodzro
ancestors	tɔgbeawo
anchor	seke
ancient	xoxo
and	kple
and you	kple wò
angel	mawudɔla
anger	dziku
angle	gɔglɔƒe
angry	kpᴐ dziku
animal	lã
ankle	afɔkpodzui
anniversary	dzigbezã
announcement	gbeƒãɖeɖe
annoy	doa dziku
annoyed	kpɔ dziku
annoying	kuadzi
annual	ƒe sia ƒe
anonymous	si ŋu ŋkɔ mele o
another	bubu
answer	ŋuɖoɖo
anticipate	kpɔ mɔ
anxiety	dzitsitsi
anxious	tsi dzi
any	aɖe
anymore	ake o
anyone	ame sia ame
anything	nu sia nu
anyway	ɖe sia ɖe ko
anyways	ɖe sia ɖe hã
apart	dome didi
apartment	xɔhaya
apologize	ɖe kuku
apparently	eme kɔ be
apparent	si me kɔ
appeal	kukuɖeɖe
appearance	dzedzeme
appear	dze
appeared	dze
appetite	nudzroame
apple	apel
application	mᴐbibia
apply	tsᴐe wᴐ dᴐ
appointment	gbeɖoɖi
appreciate	na ŋudzedzekpɔkpɔ
appreciation	ŋudzedzekpɔkpɔ
approach	te ɖe
appropriate	si dze
approval	asi dada ɖe nu dzi
approve	da asi ɖe edzi
approved	da asi ɖe edzi
approximately	anᴐ abe
april	afɔfie
arbitrary	ale si wolɔ̃
architecture	xɔtata
architect	xɔtala
archive	nudzraɖoƒe
area	teƒe
are	enye
are you busy	ele nane wɔm mahã
are you	èle
are you married	eɖe srɔ̃a
are you married or single	srɔ̃ le asiwò lo alo wò ɖeka koe li
Are you still there?	Ega le afima?
are you there	èle afi ma
argue	he nya
argument	nyahehe
arise	tso
arm	abɔ
army	aʋakɔ
around	le wo dome
arrange	ɖo
arrangement	ɖoɖo
arrival	ɖoɖo
arrived	ɖo
arrive	va ɖo
arrogant	dze aglã
arrow	aŋtrɔe
article	nu
artificial	ame ƒe nuwɔwɔ
artist	nutala
art	nutata
as	abe
ashamed	si ŋu kpe
ash	dzofi
ask	bia
asked	bia
asleep	dɔ alɔ̃
as long as	zi ale si
aspect	akpa
Assamese	Assamese
assault	ƒo
assembly	ƒuƒoƒo
assertive	si me kakaɖedzi le
assess	do kpɔ
assessment	dodokpᴐ
asset	nunɔamese
assets	nunɔamesiwo
assign	de dɔ asi
assignment	dᴐdeasi
assistant	kpeɖeŋutɔ
assist	kpeɖeŋu
associated	si de ha kple
associate	wɔ ɖeka
association	habɔbɔ
assume	bui
assumption	nu si wobu
as well as	hekpe ɖe
as well	hã
ate	ɖu
athlete	duƒula
at	le
at least	ne mede kura o la
attached	kpeɖeŋu
attach	le ɖe eŋu
attachment	lele ɖe nu ŋu
attack	dze avu
attempt	tee kpᴐ
attendance	teƒedede
attend	de
attention	ŋuɖoɖo
attitude	nɔnɔme
attract	he
attraction	nuhehe
attractive	si hea ame
attribute	ŋutinu
audience	nuselawo
august	dasiamime
aunt	tasi
aunty	tasi
authentic	atsiatsia
authority	ŋusẽ
author	nuŋlɔla
autumn	nuŋeɣi
available	eli
average	ve dome
avoid	de axa
awake	nyɔ
award	nunana
awareness	nyanya
aware	nya
away	na
awesome	nya kpɔ ŋutɔ
awful	menyo o
awkward	mesᴐ ŋku me o
Aymara	Aymara
baby	vidzĩ
bachelor	tre
background	nu si de megbe
back	megbe
bad	gbegblẽ
bag	kotoku
bait	ƒunulã
bake	me
bakery	abolomeƒe
baking soda	na
balance	le te
ball	bɔl
Bambara	Bambara
banana	akɔɖu
band	hadziha
bang	ɣli sesẽ
bank	gadzraɖoƒe
bar	ahanoƒe
barely	kpᴐtᴐ vie ko
bargain	ƒo asi
bark	wò
barley	na
barrier	mɔxexe
based	ku ɖe
basement	sã gɔme
base	teƒe
basically	kpuie ko
basic	gɔmedzenu
basil	na
bastard	gbɔmeya
batch	hatsotso
bath	le tsi
bathroom	tsileƒe
battery	batri
battle	aʋa
bay	na
beach	ƒuta
beam	xɔgbãti
beans	ayi
beard	ge
bearing	vevienyenye
bear	sisiblisi
beast	gbemelã
beat	ƒo
beautiful	dze tugbe
beauty	tugbedzedze
became	va zu
be careful	kpɔ ɖokuiwò dzi
because	elabena
become	zu
bed	aba
bedroom	xɔgãme
bee	anyi
beef	nyilã
been	nye
be	enye
beer	biya
before	do ŋgɔ
began	dze egɔme
begin	dze egᴐme
beginning	gɔmedzedze
behalf	ɖe eteƒe
behave	wɔ nyuie
behavior	nuwᴐna
behaviour	nuwɔna
behind	emegbe
being	nu gbagbe
belief	dzixɔse
believe	xᴐe se
belly	ƒodo
belong	nye etᴐ
beloved	lɔlɔ̃tɔ
below	été
belt	alidziblaka
bench	zikpuilegbe
bend	bɔ
beneath	le egɔme
benefits	viɖe
benefit	viɖe
beside	kpeɖe eŋu la
besides	kpeɖe eŋu
best	nyuietᴐ
best of luck	eme nenyo
best regards	medogbe na wò
better	nyo wu
between	titina
beverage	nunono
beyond	gbɔ eŋu
Bhojpuri	Bhojpuri
bias	akpa ɖeka dzidede
biased	de akpa ɖeka dzi
bicycle	gasɔ̃
bid	asidodo
big	lolo
bike	gasɔ̃
bill	febugbalẽ
bind	bla
bird	xe
birthday	dzigbe
bit	ɖu
bite	ɖu
bitter	le vevem
black	yibᴐ
blade	nulãnu
blame	bu fɔ̃
blanket	avɔtsɔtsɔ
blank	le ƒuƒlu
blast	gbã
bleach	klɔ ŋuti
blend	tsaka
blessed	si woyra
bless	yra
blind	gbã ŋku
bliss	dzidzeme
block	xe mɔ
blood	ʋu
bloom	le keklem
blow	kᴐ
blue	bluᴐ
blunt	tsi kpo
board	ati gbadza
boat	tɔdziʋu
body	ŋutilã
boil	fie
bold	kalẽtᴐe
bond	kpe
bone	ƒu
book	agbalẽ
boost	de ŋusẽ eme
booster	nu si doa nu ɖe ŋgɔ
boot	afɔkpa
boots	afɔkpawo
border	liƒo
bored	mo dzaka
bore	ŋɔ do
boring	me vivim o
born	wo dzi
borrow	do nu
boss	amegã
bother	ɖe fu
both	wo ame eve la
bottle	atukpa
bottom	gᴐme
bought	ƒle
bounce	dzodzo
boundaries	liƒowo
bound	bla
bow	bᴐbᴐ
bowl	agba
box	aɖaka
boyfriend	ahiãvi ŋutsu
boy	ŋutsuvi
bracelet	alɔnuga
brain	hɔhɔ̃
branch	alɔdze
brand	nudzadzra ŋkɔ
brave	kalẽ
breach	da le se dzi
bread	abolo
breakfast	ŋdi nuɖuɖu
break	gbã
breast	no
breathe	gbɔ ya
breath	gbɔgbɔ
breed	nyi
brick	kpe
bride	ŋgbɛtɔ
bridge	agbasasã
brief	kpuie
bright	klẽ
brilliant	si nya nu
bring	tsɔe vɛ
broadcast	nyakaka
broad	keketa
broke	ɖoko
broken	gbã
bro	nɔvi ŋutsu
broom	xa
brother in law	nyo
brother	nᴐvi ŋutsu
brought	tsᴐe va
brown	kɔdzẽ
brush	aɖuklɔnu
bucket	tɔkpɔ
buddy	xɔ̃
budget	gaɖaŋu
bug	nugbagbevi
building	xɔ
build	tu
built	tu
bulk	le agbɔsɔsɔ me
bull	nyitsu
bully	ŋutasẽla
bump	kpo
bunch	kpo
bundle	babla
burden	agba
buried	ɖi
burn	bi dzo
burst	wo
bury	ɖi
bush	gbeme
business	dᴐwᴐna
bust	akᴐta
bus	ʋugã
busy	le dɔ wɔm
but	gake
butter	bᴐta
butterfly	akpakpaluʋui
button	awunugbui
buy	ƒle
bye	xede nyuie
by the way	ke ɖee
cabbage	na
cabinet	nudzraɖoƒe
cage	xadza
cake	akpɔnɔ
calf	nyivi
called	yᴐ
call me	yɔm
call	yᴐ
calm	li kpo
came	va
campaign	gbeƒaɖeɖe
can	ate ŋu
Cancel	Te fli ɖe eme
cancer	kansa
can't	mate ŋui o
capable	ate ŋu
capacity	ŋutete
capital	toxɔdu
caption	tanya
capture	le
career	dᴐwᴐna
careful	kpɔe nyuie
carefully	le dzigbɔɖi me
careless	ɖematsɔleme
caring	leabe na nu
carpenter	atikpala
carpet	anyigbãvɔ
carrot	karɔt
carry on	yi edzi
carry out	wɔe
carry	tsᴐ
car	ʋu
case	goe
cash	ga
cast	da
castle	mɔ
casual	si mede to o
catch	lé
cat	dadi
category	hatsotso
cattle	nyiwo
caught	lé
cause	wᴐe be
caution	ŋkumekaka
cautious	le wɔwɔm nyuie
cave	agado
cease	tɔte
ceiling	agbakɛ
celebrate	ɖu azã
cell	gaxɔ
center	titina
century	ƒe alafa ɖeka
cereal	blinu
ceremony	azãnuwɔna
certain	ka ɖe edzi
certainly	godoo
certificate	ɖasɛɖigbalẽ
chain	kɔsɔkɔsɔ
chair	zikpui
challenge	ʋli ho
chance	aklama
change	trɔ
chaos	ʋunyaʋunya
characteristics	nɔnɔmewo
character	nᴐnᴐme
charge	febubu
charity	dɔmenyo
charming	nyakpɔ ŋutɔ
chart	agbalẽgbadza
chase	ti yome
chat	ɖo dze
cheap	mexᴐ asi o
cheat	ba ame
cheating	amebaba
check	le ŋku ɖe eŋu
cheek	alɔgo
cheerful	le dzidzɔ kpɔm
cheer	kpɔ dzidzɔ
cheers	dzidzᴐkpᴐkpᴐ
cheese	notsibabla
chemistry	atike ŋuti nusɔsrɔ̃
cherish	kpɔdzidzɔ
chess	na
chest	akᴐta
chew	ɖu
chicken	koklo
chief	fia
child	ɖevi
childhood	ɖevinyenye
children	ɖeviwo
chill	fa mia
chimneys	dzudzɔti
chin	glã
chocolate	tsokolɛti
choice	tiatia
choose	tia
chop	lã
chores	aƒemedɔ
chubby	kpɔ lame
church	sɔleme
cinnamon	na
circle	fli nogo
circumstances	nᴐnᴐme
citizen	dumevi
city	dugã
claim	xɔ
clarify	ɖe eme
class	nusrɔ̃ƒe
clay	anyi
clean	dzadzɛ
clear	me kᴐ
clerk	klaki
clever	nya nu
client	asisi
cliff	kplekɔkɔ
climate	na
climb	lia dzi
clingy	lena ɖe nu ŋuti
clock	gaƒoɖokui
closet	bebeƒe
close	tu
cloth	avɔ
clothes	nudodowo
cloud	lilikpo
cloudy	alilikpowo le
clown	fefewɔla
clue	dzesi
clumsy	wɔ nyamaa
cluster	ƒuƒoƒo
coach	hehenala
coal	aka
coast	ƒuta
coat	dziwui
coffee	kɔfi
cognitive	le susume
coincidence	nudzɔɖenunu
cold	fa
collapse	dze anyi
collar	kɔla
colleague	hati
colleagues	hatiwo
collection	nuƒoƒu
collect	lɔ
college	kɔledzi
color	amadede
colorless green ideas slept furiously	gbemu tamesusuwo dɔ alɔ̃ kple adã
colour	amadede
column	akpa
comb	ayiɖa
combination	nuƒoƒu
combine	ƒoƒu
come here	va afi
come on	tso
come	va
comfortable	dzidzeme
comfort	dzidzeme
coming	gbɔna
coming soon	egbɔna kpuie
command	gbeɖeɖe
comment	nutsotso
commercial	si wole dzadzram
commission	nuʋuʋu
commitment	ɖokuitsᴐtsᴐna
committed	tsɔ eɖokui na
commit	tsɔ na
commodity	nudzadzra
common	nu bɔbɔ
communicate	ka nyata
communication	nyatakaka
community	hatsotso
commute	ɖo ʋu
companion	kpeɖeŋutɔ
company	hã
compare	tsɔe sɔ
comparison	nusɔnu
compassionate	nublanukpɔkpɔ
compassion	dɔmenyo
compatible	sɔ ɖe edzi
competent	nya dɔ
compete	ʋliho
competition	hoʋiʋli
competitive	le ho ʋlim
complain	nyatoto
complaint	nyatoto
complement	kafukafu
completely	blibo
complete	wu enu
complex	si me nu geɖe le
compliance	sedziwᴐwᴐ
complicated	si me nuwo le fũu
compliment	kafukafu
comply	wɔ edzi
composition	nuƒoƒu
compound	xɔxɔnu
comprehension	nugɔmesese
comprehensive	de blibo
compromise	ɖe ɖe le eme
compulsory	nye sedede
computer	kɔmpuita
concentrate	susu nɔ nu ɖeka ŋuti
concept	nunya
concern	dzitsitsi
concerned	tsᴐ ɖe le eme
concert	fefe
conclusion	nyanuwuwuw
concrete	kɔkreti
condition	nᴐnᴐme
conditions	nɔnɔme
conduct	agbenᴐnᴐ
conference	takpekpe
confess	ʋu eme
confidence	kakaɖedzi
confident	ka ɖe edzi
confirm	ɖo kpe edzi
conflict	dzre
confused	tᴐtᴐ
confusion	tɔtɔ
congrats	dɔnɔɔ
congratulation	dɔnɔɔ
congratulations	dɔnɔɔ
conjunction	nyatsyãnya
connect	doka
conquer	ɖu dzi
conscious	le ŋute
consciousness	ŋutenɔnɔ
consent	mᴐɖeɖe
consequences	metsonu vɔ̃wo
conservation	nu lele ɖi
conservative	tɔtrɔgbela
consider	bu eŋu
considered	bu eŋu
consistency	mɔ ɖeka toto
consistent	to mɔ ɖeka dzi
consist	woawoe nye
constantly	edziedzi
constant	si dzɔna ɖa
constipation	miléle
construction	xɔtutu
consume	ɖu
consumption	nu ɖuɖu
contact	kadodo
contagious	si nye dɔxɔleameŋu
contain	le eme
contains	le eme
contemporary	tsidzi nu
contempt	vlododo
content	eme nuwo
contest	hoʋiʋli
context	nu si nɔa edzi yim
continent	anyigbãga
continue	yi edzi
contract	nubabla
contrast	de vovototo
contribute	dzᴐ nu
contribution	wɔƒe
control	dziɖuɖu
controversial	si nye nyahehe
convenience	dzidzeme
convenient	dze na ame
conversation	dzeɖoɖo
convert	trɔ dzime
convey	tsɔe yi
convinced	ƒoe ɖe enu
convince	ƒoe ɖe enu
cook	ɖa ŋu
cooking	nuɖaɖa
cool	fa
cooperation	alɔdodo
cope	ato eme
copper	gadzẽ
core	tometi
corn	bli
corner	dzogoe
correct	de
cost	asixᴐxᴐ
costume	awu
cottage	agblexɔ
cotton	ɖetsifu
couch	xɔmezikpui legbe
cough	kpe
could	te ŋu
council	dudzikpɔha
counter	nudaɖoƒe
country	dukᴐ
countryside	kɔƒe
count	xlẽ
couple	srɔ̃tɔwo
courage	dzideƒo
course	mᴐ
courtesy	bubudeame
court	ʋᴐnu
cousin	nɔvi
cover	akpa
coward	vɔvɔnɔtɔ
cow	nyi
cozy	dzidzeme
crab	agalã
crack	gbagbãƒe
craft	asinudɔ
crap	nu maɖinu
crash	gbã
craving	didi veviẽ
crawl	te
crazy	ku tsu
create	wᴐ
creative	wɔa aɖaŋu
credit	gadodo
creep	ƒo mo ɖe
creepy	si tsana
crew	dɔwɔha
crime	nuvɔ
cringe	ŋe ɖe eme
crisis	kuxigã
criteria	afɔɖeɖe
critical	nye nu sesẽ
criticism	nyahehe
crop	nuku
crops	nukuwo
cross	atitsoga
crow	akpavia
crowd	ameha
crowded	ƒo kᴐ
crown	fiakuku
crucial	hiã ŋutᴐ
cruel	se tame
cruise	tsidzizɔzɔ̃
crush	gbã
cry	fa avi
cucumber	na
cuddle	mimi
culture	dekᴐnu
cunning	dze ayɛ
cupboard	agbalẽɖaka
cup	kplu
curb	tsi enu
cure	yɔ dɔ
curfew	zã se
curiosity	numekpɔkpɔ
curious	lea ŋku ɖe nu me
curly	gɔdɔ
currency	ga
current	fifia
currently	fifi
curse	fiƒode
curtain	xɔmetsovɔ
cushion	nu bɔbɔe
custom	dekᴐnu
customer	asisi
customs	dekɔnuwo
cute	kpokploe
cut	lã
cycle	si yina gagbɔna
cycling	gasɔ̃dodo
daddy	papa
dad	papa
daily	gbe sia gbe
dairy	nyinotsi
damage	nugbegblẽ
dam	dam
damn	si wobu fɔ̃
damp	ƒo tsi
dance	ɖu ɣe
danger	ŋɔdzi
dangerous	dziŋᴐ
dark	nyrɔ
darling	lᴐlɔ̃tᴐ
dash	fli
data	na
date	ŋkeke
daughter	vi nyᴐnu
day	ŋkeke
dead	ku
deadline	nuwuwu game
deaf	tokunɔ
deal	nuɖoɖo
Dear All	lɔlɔ̃tɔwo
Dear Customer	Asisi lɔlɔ̃a
dear	lɔlɔ̃tɔ
Dear Parents	Dzila lɔlɔ̃wo
Dear Sir	Amega lɔlɔ̃a
Dear students	Nusrɔ̃la lɔlɔ̃wo
Dear Team	Dɔwɔha lɔlɔ̃
death	ku
debate	nyahehe
debit	nugbegblẽ
debris	gbeɖuɖɔ
debt	fe
decade	ƒe ewo
decay	nyinyɔ
deceased	si ku
deceive	ble
december	dzome
decent	dze ani
decided	ɖoe
decide	tso nyame
decision	nyametsotso
deck	sãdzi
decline	yi anyi
decrease	yi anyi
dedicated	si wotsᴐ na
dedication	tsɔtsɔdesi
deed	nuwɔwɔ
deep	goglo
deer	sẽ
default	gᴐmedzeƒe
defeat	anyidzedze
defend	ʋli ta
define	ɖe egɔme
definitely	kokooko
definition	gɔmeɖeɖe
degree	ɖoƒe
delayed	he ɖe megbe
delay	hehe ɖe megbe
delete	ɖe ɖa
deliberate	nu ɖoɖo
delicate	si mesẽ o
delicious	ele aɖe
delight	dzidzɔnu
delighted	kpɔ dzidzɔ
delivered	woɖee
deliver	tsɔ yi
delivery	vidzidzi
demand	bia
demanding	le biabiam
democracy	ablɔɖegbadza
demon	gbɔgbɔvɔ̃
demonstrate	ɖe fia
denied	xe mɔ na
density	toto
dentist	aɖu ɖɔkta
deny	xe mᴐ
department	dɔwɔƒe ƒe alɔdze
departure	dzodzo
depend	kpɔ ame dzi
deploy	de dɔ asi
deposit	dae ɖi
depressed	de ɖe anyi
depression	teteɖeanyi
depth	goglome
describe	ɖᴐ
description	nuɖᴐɖᴐ
desert	dzogbe
deserve	dze na
design	aɖaŋudɔ
designation	dzesidede
desire	dzimedidi
desk	kplᴐ
despair	dziɖeameƒo
desperate	tsi dzi
despite	togbɔ
dessert	numeɖenu
destination	deƒe
destiny	dzɔgbe
destroy	gblẽ
destruction	nugbegblẽ
detail	emenuwo
details	emenuwo
detect	de dzesi
determination	kutrikuku
determine	aɖoe
determined	ɖoe kplikpa
devastated	wɔ nublanui
developed	tsi ɖe edzi
development	ŋgᴐyiyi
develop	yi ŋgᴐ
device	mᴐ
devil	abosaŋu
devoted	tsɔ eɖokui na
Dhivehi	Dhivehi
diabetes	suklidɔ
diarrhea	dɔmetɔtrɔ
diary	nuleɖigbalẽ
dictionary	nyadigbalẽ
did	wᴐe
died	ku
die	ku
diet	nuɖuɖu ɖoɖo
difference	vovototo
different	to vovo
difficult	sesẽ
dig	ku do
dignity	bubu
diligent	ku kutri
dinner	fiɛ̃ nuɖuɖu
dip	dee eme
direction	mɔfiame
director	dɔdzikpɔla
direct	tẽe
dirt	ɖi
dirty	ƒo ɖi
disable	de dzo le eme
disabled	si me woɖe dzo le
disappear	bu
disappointed	dzi gbã
disaster	dzɔgbevɔ̃e
discard	tsɔe ƒu gbe
discharge	ɖe agba
discipline	hehe
discount	ɖedzi
discover	ʋu go
discrimination	azitiazime
discuss	dzro eme
discussion	numedzodzro
disease	dᴐléle
diseases	dɔlélewo
disguise	de ba mo
disgusting	nyɔŋu
dishes	nuɖaɖawo
dish	nuɖuɖu
dismiss	ɖe asi le eŋu
dispatch	dɔ
display	ɖeɖe fia
disposal	nu ƒugbe
dispute	nyahehe
distance	didiƒe
distinct	to vovo
distinguish	de vovototo
distress	nuteɖeamedzi
distribution	nu mama
district	nuto
disturb	ɖe fu
ditch	ʋe
dive	do ɖi
diverse	vovovowo
diversity	vovototo
divide	ma
divine	mawume nu
divorce	srɔgbegbe
dizzy	mo le tɔtrɔm
doctor	ɖɔkta
document	agbalẽ
doesn't	mewɔ
does	wᴐa
dog	avu
Dogri	Dogri
doing	le ewɔm
doll	atividzĩ
domain	dziɖuƒe
domestic	aƒe me
dominant	si ɖu wo kata dzi
donate	na nu
done	wɔe vɔ
donkey	tedzi
don't	gawɔe o
Don't worry	Mega tsi dzi o
dope	movitɔ
double	le eve
doubt	ɖikeke
dough	amɔ
down	anyi
download	hee ɖa anyi
do	wɔ
do you	elɔ̃a
do you love me	Ele lɔ̃nyem mahã
draft	tata gbãtɔ
drag	he
drain	no
drama	fefe
drawer	drɔ̃
drawing	nutata
draw	ta nu
dread	do ŋɔdzi
dream	drɔ̃e
dress	awu
drill	ŋɔ do
drink	no
drive	ku ʋu
drop	ge
dropped	dae ɖi
drought	kuɖiɖi
drunk	mu aha
dry	ƒu
duck	kpakpaxe
dude	ame
due	si li
due to	tso egbɔ
dull	syiɔ̃
dumb	aɖe tutu
dump	kᴐe ɖi
duration	ɣeyiɣi didime
during	le esime
dust	ʋuʋudedi
duty	dᴐdeasi
dwell	nɔ
dying	le kukum
each	ɖe sia ɖe
each other	wo nɔeawo
eager	le klalo
eagle	hɔ̃
earlier	do ŋgɔ
early	kaba
earn	kpᴐ ga
ears	towo
earth	anyigba
earthquake	anyigbãʋuʋu
ear	to
ease	bɔbɔe
easily	bɔbɔe
east	ɣedzeƒe
easy	bᴐbᴐe
eat	ɖu
eating	le nu ɖum
economic	ga nya
economy	ga ŋuti nya
edge	to
edit	wɔ tɔtrɔ
education	susᴐsrɔ̃
effect	ƒe dᴐwᴐna
effective	wɔa dɔ
efficiency	dɔ wɔwɔ nyuie
efficient	wᴐ dᴐ nyuie
effort	ŋtete
egg	koklozi
eggplant	agbitsa
ego	amenyenye
eighteen	wuienyi
eight	enyi
eighty	blaenyi
either	eya loo
elaborate	ɖe eme
elbow	abɔkuglui
elder	ametsitsi
elderly	amegaxoxo
elegant	nyakpɔ ŋutɔ
element	na
elephant	atiglinyi
eleven	wuiɖɛkɛ
eligible	kpᴐ ŋudzedze
eliminate	ɖee ɖa
else	bubu
embarrassed	ŋu kpee
embarrassing	nye ŋukpe
embrace	kpla asi akᴐ
emerge	dze go
emergency	kpomenya
emotional	se seselelãme
empathy	vevesese ɖe amebubu teƒe
emphasis	gbetete ɖe nu dzi
emphasize	te gbe ɖe edzi
employee	dᴐwᴐla
employees	dɔwɔlawo
employer	dɔtɔ
employment	dɔwɔɖua
empty	ƒuƒlu
enable	ɖe mᴐ na
encounter	gododo
encourage	de dzi ƒo na
endangered	si le xaxa me
endeavor	dze agbagba
end	nuwuwu
endurance	dzidodo
endure	dodzi
enemy	futɔ
energy	ŋusẽ
engage	de dɔ asi na
engaged	mele vovome o
engagement	srɔɖeɖe
engineer	aɖaŋudɔwɔla
engine	mɔ
English	iŋlisi
enhance	do ɖe ŋgᴐ
enjoy	kpɔ dzidzɔ nyuie
enormous	lolo ŋutᴐ
enough	ede
ensure	kpᴐ egbᴐ be
enter	geɖe eme
entertainment	modzakaɖeɖe
enthusiasm	dzidzɔkpɔkpɔ
enthusiastic	kple dzidzɔ
entire	katã
entitled	kpɔ gome
entity	dɔwɔƒe
entrance	mɔnu
entrepreneur	asitsala
envelope	agbalẽkotoku
environment	xexeãme
envy	ŋubiabiã
epic	ŋutinya legbe
epidemic	dɔtsatsa
equal	sɔ
equipment	dᴐwᴐnu
equity	sɔsɔ
equivalent	si sɔ kple
eraser	nuŋɔŋlɔtutunu
error	vodada
escape	si
especially	kã
essay	nyadutsotso
essence	veviẽnyenye
essential	si hiã
establish	ɖoe anyi
established	ɖoe anyi
estate	aƒe
estimate	bui
estimated	si wobu
etc	kple bubuwo
eternal	mavɔmavɔ
ethics	sedziwɔwɔ
evaluate	bu akɔnta
evaluation	dodokpɔ
even	hã
evening	fiɛ̃
even though	togbɔ be
event	nudzᴐdzᴐ
eventually	mlᴐeba
ever	tegbe
everybody	ame sia ame
every	ɖe sia ɖe
everyone	ame sia ame
everything	nu sia nu
evidence	kpeɖodzi
evil	vɔ̃
evolution	tɔtrɔ
evolve	trɔ
Ewe	Eʋegbe
exactly	tututu
exact	tututu
exam	dodokpɔ
examine	do kpɔ
example	kpɔɖeŋu
exceed	gbɔ edzi
excellent	enyo ŋutᴐ
except	ɖe ko
exception	esi do le emm
excessive	si gbɔ eme
excess	si tsi edzi
exchange	ɖɔli
excited	kpɔ dzidzɔ
excitement	dzidzɔkpɔkpɔ
exciting	doa dzidzᴐ
exclusive	ɖe ɖe aga
excuse	kukuɖeɖe
excuse me	ago nam
execute	tsɔ wɔ dɔ
execution	dɔwɔwɔ
executive	kplɔlawo
exercise	kamedede
exhausted	ɖeɖi te eŋu
exhaust	te ɖeɖi
exhibit	ɖe ɖe go
exhibition	nu ɖeɖe ɖe go
existence	anyinɔnɔ
existing	si li
exist	li
exit	do
expand	keke
expected	si wokpɔ mɔ na
expect	kpɔ mɔ
expenses	gagbegblẽ
expensive	xᴐ asi
experience	nuteƒekpɔkpɔ
experiment	kasakasa
expert	nunyala
expired	si ƒe ŋkeke de
explain	ɖe eme
explanation	numeɖeɖe
exploit	zã
explore	tsa le eme
export	ɖoe ɖa
exposed	ɖe ɖe go
expose	ɖe de go
exposure	ɖeɖe ɖe go
express	ɖe eme
expression	nyagbɔgblɔ
ex	si megali o
extended	si me wo he
extend	he ɖe ŋgɔ
extension	nu hehe
extent	ɖoƒe
external	le egodo
extinct	megali o
extract	ɖe le eme
extra	dedzii
extraordinary	si to vovo sã
extremely	veviẽ ŋutɔ
extreme	si gbɔ eme
eye	ŋku
eyes	ŋkuwo
fabric	avɔ
fabulous	wɔ nuku
face	mo
facilitate	kpeɖeŋu
facilities	kpeɖeŋunuwo
facility	nuwɔƒe
fact	nu si le eteƒe
factor	memanu
factory	dɔwɔƒe
facts	nyateƒewo
fade	klo
fail	dze anyi
failed	dze anyi
failure	madzedzi
faint	yi ɖi me
fair	ekɔ
fairly	si kaɖe eme
fairy	glĩmenɔla
faithful	toa anukuarɛ
faith	xᴐse
fake	alakpanu
fall	dze anyi
false	alakpa
fame	amenyenye
familiar	si wonya
family	ƒome
famine	dɔwuame
famous	nyanyɛ
fancy	atsyᴐnu
fan	papa
fantastic	nyo ŋutɔ
farewell	hedenyuie
farm	agble
farmer	agbledela
far	si gbᴐ didi
fascinating	si wɔ nuku
fashion	tsidzinu
fast	kabakaba
fatal	ku nya
fat	da ami
fate	nyadzᴐɖeamedzi
father	tᴐ
fatigue	ɖeɖiteameŋu
fault	vodada
favorite	si wodina
favour	amenuveve
favourite	veviẽtɔ
fear	vᴐvɔ̃
feast	azãɖuɖu
feather	xefu
feature	ŋutinu
features	ŋutinuwo
february	dzodze
fed up	nu ti kɔ nɛ
feedback	nutsotso
feed	na nuɖuɖu
fee	fe
feeling	seselelãme
feel	se le lame
feet	afᴐwo
fell	dze anyi
fellow	xɔ̃
felt	se le lãme
female	asi
fence	kpɔtɔtɔ
fertile	aɖu le eme
festival	azãɖuɖu
fetch	ku
fever	asrã
fewer	ʋɛ aɖe
few	ʋee
fiance	ahiãvi
fiction	nyakpakpa
field	gbadzaƒe
fierce	wɔ adã
fifteen	wuiatɔ̃
fifty	blaatɔ̃
fighting	le kɔ dam
fight	wᴐ avu
figure	nu
figure out	se nu si wonye me
file	agbalẽ
filled	yɔ
fill	yɔ
film	sinii
filthy	ƒoɖi
finally	mlᴐeba
finance	ga zazã
financial	ga nya
find	di
find out	ke ɖe eŋu
fine	enyo
finger	asibidɛ
finished	wu enu
finish	wu enu
fire	dzo
firm	le tenu
first	gbã
first name	ŋkɔ gbãtɔ
fish	tɔmelã
fit	sᴐ
five	atɔ̃
fixed	le teƒe ɖeka
fix	wɔ
flag	flaga
flash	dzokekle
flat	gbadza
flaw	kpɔtsɔtsɔ
flawless	maɖifɔ
flee	si
flesh	ŋutilã
flew	dzo
flex	do eɖokui ɖe dzi
flexible	si bɔbɔ
flight	dzodzo
flip	ti kpo
flirting	ahiãwɔwɔ
flirt	wɔ ahiã
float	nɔ tsi dzi
flood	tsiɖᴐɖᴐ
floor	anyigbã
flour	wɔ
flower	seƒoƒo
flow	si
fluently	memie
fluent	memie
fluffy	futufutu
fluid	tsi nu
flu	wɔɖi
fly	dzo
focus	nu kpɔkpɔ
fog	afu
foggy	afu xe
fold	ŋe
folks	nɔviwo
following	le eyome
follow	kplᴐe ɖo
follow up	do afɔ
food	nuɖuɖu
fool	bometsila
foolish	abunɛ nu
foot	afᴐ
football	bɔl
forbidden	si ŋu mɔ mele o
force	ŋusẽ
forecast	gblɔe ɖi
forehead	ŋgonu
foreign	duta
forest	ave
forever	tegbee
For example	Le kpɔɖeŋu me
forget	ŋlᴐe be
forgive	tsɔe ke
forgot	ŋlɔ be
for instance	le kpɔɖeŋu me
fork	gaflo
formal	si le se nu
former	xoxo
form	nᴐnᴐme
fortunately	dzɔgbenyuie tɔe
fortune	gbetsi nyui
forty	blaene
forty-two	blaene-vɔ-eve
forward	ŋgᴐgbe
for you	na wò
foster	de dzi ƒo
fought	wɔ aʋa
foundation	gɔmeɖokpe
found	kpᴐe
four	ene
fourteen	wuiene
fox	abei
fragile	ate ŋu agbã bɔbɔe
frame	ati
framework	ɖoɖo
fraud	adzodada
freak	ame si trɔa susu kabakaba
freedom	ablɔɖe
free	femaxe
freeze	fa
frequency	xexlẽme
frequent	edziedzi
frequently	edziedzi
fresh	le mumu
friday	fiɖa
fridge	nufamɔ
friendly	wɔa xɔlɔ̃
friendship	xɔlɔ̃wɔwɔ
friends	xɔlɔ̃wo
friend	xɔ̃
frightened	vɔ̃
frightening	dziŋɔ
frog	akpɔkplɔ
from	tso
front	ŋgɔ
frozen	do kpe
fruit	atikutsetse
frustrated	ɖeɖi te eŋu
fuel	nake
Fulfulde	Fulfulde
full	yᴐ
function	wᴐ dᴐ
fundamental	gɔmeɖonu
funeral	tsyɔ̃
fun	nukoko
funny	ɖi kokoe
furious	kpɔ dziku
fur	lãfu
furniture	nunᴐdzi
further	kpe ɖe eŋu
furthermore	kpeɖe eŋu la
future	tsᴐ si gbᴐna
gain	nukpᴐkpᴐ
game	hoʋiʋli
gap	memama
garage	ʋunɔƒe
garbage	gbeɖuɖɔ
garden	abɔ
garlic	ayo
gate	agbo
gather	ƒoƒu
gathering	ƒuƒoƒo
gauge	dzidzenu
gave	na
gear	giya
gender	na
general	gbadza
generally	gbadzaa
generate	wɔ
generation	dzidzime
generous	dzime kᴐ
genius	susu ɖaɖɛ
genre	ƒomevi
gentle	bɔkɔ
genuine	atsiatsi
gesture	asidada
get dressed	ɖo awu
getting	le exɔm
get up	tso
get well soon	wò lãme nasẽ kaba
get	xɔ
ghosting	zãmenɔnɔ
ghost	ŋɔli
giant	amedzɔtsu
gift	nunana
ginger	gumetakui
girlfriend	ahiãvi nyɔnu
girl	nyᴐnuvi
give	na
given	na
give up	ɖe asi
glad	dzidzᴐ
glance	da ŋku ɖe edzi
glass	ahuhɔ̃e
glasses	gaŋkui
glimpse	ŋkulɔnu
global	si le xexeame
gloomy	le blanui
gloves	asiwuiwo
glow	klẽ dzo
glow up	klẽ
glue	nulenu
go ahead	yi ŋgɔ
goal	age
goals	taɖodziwo
goat	gbɔ̃
go away	dzo le afima
god bless you	mawu neyra wò
god	mawu
goes	yina
going to	yina ɖe
going	yina
gold	sika
gone	dzo
gonna	na
goo	ade
good afternoon	ŋdᴐ
goodbye	de nyuie
good bye	hede nyui
good day	ŋkekea me nenyo
good	enyo
good evening	fiɛ̃
good job	ewɔe nyuie
good looking	nya le kpɔkpɔm
good luck	dzᴐgbe nyuie
good morning my love	ŋdi na wò nye lɔlɔ̃tɔ
good morning	ŋdi
good night	dɔ agbe
goodnight	dɔ agbe
goods	nudzadzrawo
Google	Google
Google Translate	google ɖe egɔme
goose	gbekpakpaxe
gorgeous	dzeani
gossip	amenya
got it	see
go to bed	yi namlɔ anyi
got	xᴐ
government	dziɖuɖu
go	yi
grab	le
grade	ɖoƒe
gradually	blewu
graduate	do le suku
grain	nukui
granted	tsɔe be
grant	na
grapes	aŋuti
grasp	le
grass	gbe
grateful	le akpe dam
gratitude	akpedada
grave	yɔdo
gray	fu
great	nyo ŋutɔ
greed	ŋukeklẽ
greedy	kleaŋu
green	gbemu
greet	do gbe
greeting	gbedoname
greetings	gbedoname
grey	fu
grid	gaɖɔ
grief	avifafa
grind	tu
grip	le
grocery	nuzazãwo
groom	ŋugbɛtɔsrɔ̃
gross	agbɔsɔsɔ
ground	anyigbã
group	ha
growth	tsitsi
grow	tsi
grumpy	si kpɔa dziku
Guarani	Guarani
guarantee	kakaɖedzi
guard	dzɔla
guess	bui
guest	amedzro
guidance	mɔfiame
guide	fia afɔɖoƒe
guilty	dze agᴐ
guy	ɖekakpui
guys	nɔviwo
gym	kamedeƒe
habitat	nɔƒe
habit	numame
had	nᴐ esi
hail	kafu
hair	ɖa
half	afa
hall	xɔlegbe
hand	asi
handle	alᴐ
handsome	dze ɖeka
hang	ku ɖe nu ŋuti
hang out	do ɖe gota
happen	dzɔ
happened	dzɔ va yi
happiness	dzidzɔkpɔkpɔ
happy birthday	dzigbe zã nyuie na wò
happy birthday to you	dzigbezã nyuie nawò
happy	dzidzɔ kpɔm
happy new year	ƒe yeye na wò
hardly ever	medzɔna o
hardly	sesẽna ŋutɔ
hard	sesẽ
harmful	nye hlɔ̃nu
harm	nuveviewɔme
harmony	ɖekawɔwɔ
harsh	sesẽ
harvest	nuŋeŋe
has	le esi
hate	tsri
have a good day	ŋkekea me nenyo
have a nice day	ŋkekea me nenyo
have breakfast	ɖu ŋdi nu
have fun	kpɔ dzidzɔ
have	le esi
have you eaten	eɖu nua
having	le esi
hazard	ŋɔdzinu
haze	afu
headache	taɖuame
head	ta
healing	dɔyɔyɔ
health	lãmesẽ
healthy	le lãmesẽ me
heal	yɔ dɔ
heard	see
hear	se nu
heart	dzi
heat	dzoxᴐxᴐ
heaven	dziƒo
heavy	kpekpem
hectic	ɖodɔ
he	e
he has	ele esi
height	kᴐkᴐme
heir	domenyila
he is	enye
heist	adzodada
held	lé ɖe asi
hell	dzomavᴐ
hello dear	hello lᴐtɔ̃tᴐ
Hello	Hello
hello how are you doing	hello efɔ̃a
hello how are you	hello efɔ̃a
helmet	gakuku
helpful	kpe ɖe ame ŋu
help	kpekpeɖeŋu
hence	esia ta
herd	lãha
here	afi sia
her	eƒe
heritage	domenyinu
hesitate	he ɖe megbe
Hey	Hee
Hi	Alekee
hidden	si le ɣaɣlame
hide	be
hierarchy	ɖoɖo ɖe kɔkɔme nu
high	kɔ
highlight	nyati
hi how are you	aleke, efɔ̃a
hike	lia to
hiking	to lialia
hilarious	ɖi koke
hill	togbɛ
him	nɛ
hint	dzesidenu
hip	aklito
hips	gbi
hire	da
hiring	nu dada
his	eƒe
history	nyadzɔdzɔ
Hi there	Medo gbe na mi
hit	lᴐ
Hmm	hmm
hobby	modzakadɔ
hold	lee
hold on	do dzi
hole	do
holiday	mɔkeke
hollow	si me do le
home	aƒeme
homework	aƒemedɔ
honestly	le nyateƒe me
honest	toa nyateƒe
Honey	Anyitsi
honor	bubu
hood	tatsɔnu
hook	ƒu
hop	dzo
hopefully	le mɔkpɔkpɔ me
hopeless	mɔkpɔkpɔ bu
hope	mɔkpɔkpɔ
horizontal	si mlɔ anyi
horn	lãdzo
horrible	ɖi vɔvɔ̃
horror	ŋɔdzi
horse	sɔ̃
hospitality	amedzroxɔxɔ
hospital	kɔ̃dzi
host	aƒetᴐ
hostile	le avu wɔm
hotel	amedzrodzeƒe
hot	xᴐ dzo
hour	gaƒoƒo
hours	gaƒoƒowo
house	aƒe
household	aƒekɔ
how about you	ke wò ya ɖɛ
how	alekee
how are you doing	efɔ̃ sesiẽa
how are you doing today	aleke nèfɔ̃ egbe
how are you	efɔ̃a
how are you today	alekee nèfɔ̃ egbe
how do you do	eli nyuiea
however	gake la
how is	alekee nye
how many	nenie
how much	nenie
how often	zi nenie
how old are you	ƒe nenie nèxɔ
how was your day	alekee nye wò ŋkekea
how was your night	alekee nye wò dɔdɔ
hubby	srɔ̃ ŋutsu
hub	nudeƒe
huge	gã ŋutɔ
hug	kplᴐ asi akᴐ
human	ame
humble	bᴐbᴐ eɖokui
humid	ƒo tsi
humidity	tsiƒoƒo
hundred	alafa
hungry	dɔ wum
hunt	da ade
hurricane	ahom
hurry	ɖe abla
hurry up	ʋã
hurt	xɔ abi
husband	srɔ̃ ŋutsu
hustle	tso hlolui
hut	agblegbadɔ
hygiene	dzadzɛnyenye
I am fine	meli nyuie
I am	menye
I can	mate ŋu
I can't	nye mate ŋui o
ice cream	aiskrim
ice	tsikpe
ideal	si dze nyuie
idea	susu
identical	sɔ kple wo nɔeawo
identify	de dzesi
identity	dzeside
idiot	movitɔ
idle	si mele dɔ wɔm o
I do	Mewɔnɛ
I do not know	Nye menya o
I do not understand	Nye mese egɔme o
I don't know	nye menya o
I don’t know	Nye menya o
I don't	Nye me
I don’t understand	nye mese egɔme o
I don't understand	Nye mese egɔme o
I don't understand what you mean	Nye mese nu si gblɔm nèle la gɔme o
I don't understand you	Nye mese gɔwòme o
if	nenye be
ignore	ɖe asi le eŋu
i guess	mebui
I had	Mekpɔ
I have been	Menɔ
I have	le asinye
I hope so	Mebui nenema
I know	Menya
I like	Melɔ̃
I like you	Melɔ̃ wò
illegal	mele se nu o
ill	le dᴐ lém
illness	dɔléle
Ilocano	Ilocano
I love	melɔ̃
I love my big brother	Melɔ̃ fonye
I love my big sister	Melɔ̃ daanye
I love my father	Melɔ̃ fofonye
I love my little brother	Melɔ̃ nɔvinye ŋutsuvi
I love my little sister	Melɔ̃ nɔvinye nyɔnuvi
I love my mother	Melɔ̃ danye
I love you	Melɔ̃ wò
I love you so much	Melɔ̃ wò ŋutᴐ
I love you too	melɔ̃ wò
image	nɔnɔmetata
imagine	bu eŋu
I mean	mele gbɔgblɔm be
I'm fine	mefɔ̃
I'm good	mefɔ̃
I'm here	Mele afi sia
I miss you	nye mega kpᴐ wò kpᴐ o
I miss you so much	Mekpɔ wò edidi
immediate	emumake
immediately	enumake
immense	si keketa
I'm	menye
I’m	Menye
impact	wᴐ dᴐ ɖe nu dzi
impatient	dzimagbɔɖi
implement	tsɔ de dɔwɔwɔ me
important	le veviẽ
import	dɔ nu
impose	ɖo nu ame dzi
impossible	mate ŋu adzɔ o
impression	nugɔmesese
impressive	nya se ŋutɔ
impress	na ŋudzedze
improvement	ŋgɔyiyi
improve	yi ŋgɔ
I'm sorry	medze agᴐ
in addition	kpeɖe eŋu la
inappropriate	si mesɔ ɖe edzi o
incentive	ŋusedoamenu
incident	nudzɔdzɔ
include	dometᴐ nye
including	si ha le eme
income	gakpɔkpɔ
inconvenience	dzimadzeme
increased	sɔgbɔ ɖe edzi
increase	dzi ɖe edzi
incredible	si dzi womaxᴐ ase o
indeed	le nyateƒe me
independent	le eɖokui si
India	India
indicate	fiã
indigenous	anyigbatitɔ
individual	ame ɖeka
industry	dɔ
in	eme
inevitable	si nu womate ŋu asi le o
In fact	le nyateƒe me
infant	vifɛ̃
infection	dɔdzedze
infinity	mavɔmavɔ
inflammation	nutete
inflation	dziyiyi
influence	wᴐ dᴐ ɖe nu dzi
information	numeɖeɖe
inform	na kaklã
in front of	le ŋgɔ
ingredients	nuɖanuwo
inheritance	domenyinu
initial	gɔmedzeƒe
initiative	dze nu gɔme
injured	xɔ abi
injury	abixɔxɔ
innocent	maɖifɔ̃
innovation	nutoto
in order to	be woanye
inquiry	nutabiabia
insane	tagbᴐ gblẽ
insect	nudzodzoe
insecure	mele dedie o
insert	dee eme
inside	eme
insight	numesese
insist	te gbe ɖe edzi
insomnia	alɔ̃ madɔmadɔ
inspiration	dzodeame me
inspire	de dziƒo
install	ɖoe anyi
instance	ɣeyiɣi
instant	enumake
instead	ɖe eteƒe
instead of	ɖe eteƒe
instructions	sedede
instrument	mɔ
insult	dzu
insurance	insiɔrans
intact	le dedie
integrity	blibodede
intellectual	nunyala
intelligence	aɖaŋudede
intelligent	ƒe susu ɖa
intend	ɖo
intended	si wowɔ na
intense	sẽŋu
intention	nu ɖoɖo
interact	do ka
interaction	dzeɖoɖo
interest	didi
interested	le edim
interesting	vivi
interfere	geɖe eme
intermediate	dome
internal	si le eme
international	duta nu
internship	dɔsɔsrɔ̃
interpret	ɖe nya me
interpreter	nyagɔmeɖela
interrupt	geɖe nya me
interview	gbebiabia
intimate	te ɖe wo nɔawo ŋu
into	ɖe eme
introduce	doe ɖa
introduction	kpɔkplɔyiɖeme
introvert	amenikpĩ
intuition	seselelãme
invalid	mesɔ o
inventory	nunɔamesiwo ƒe agbalẽ
invent	to nu
invest	de ga dɔwɔna me
investigate	ku nu me
invitation	kpekpe
invite	kpe
invoice	febugbalẽ
involved	le eme
involve	le eme
I	Nye
iron	ga
I see	mekpɔ
is	enye
island	ƒukpo
isolated	ɖe ɖe aga
issue	nya
issues	nyawo
it	e
item	nu
items	nuwo
I think	mebui be
it is	enye
its	eƒe
it's	enye
It's okay	Enyo
it's ok	enyo
it was	enye
I understand	mese egᴐme
I want	medi
I want to see you	medi be makpɔ wò
I want you	Mele diwòm
I was	menye
I will	mawᴐe
I would be	Maanye
jacket	awutitri
jail	gaxɔ
January	Dzove
jar	zɔ
jaw	glã
jealous	ʋã ŋu
jerk	dzodzo nyanyanya
jewelry	atsyɔɖonu
job	dɔ
jogging	le du ƒum
join	ge ɖe eme
joint	kpeƒe
joke	nukokoenya
journalist	nyadzɔdzɔŋlɔla
journey	mᴐzɔ̃zᴐ
joy	dzidzɔ
judge	dᴐ ʋᴐnu
juice	atikutsetsetsi
july	siamlɔm
jump	dzokpo
june	masa
junk	gbeɖuɖɔ
just do it	wɔe ko
justice	ʋɔnudɔdrɔ nyuie
justify	ʋli eta
just	ko
Kalaallisut	Kalaallisut
keen	le didim
keep it up	yi edzi nenema
keep	le aɖe asi
kept	dzra ɖo
kettle	tsiɖodzuinu
key	asafui
kick	tu afɔ
kidding	beble
kid	gbɔ̃vi
kidney	ayiku
kids	ɖeviwo
kill	wu
kinda	ƒomevi
kindly	dɔmenyotɔe
kindness	dɔmenyo
kind	nyo dɔme
king	fia
kiss	ɖuɖɔ nu
kitchen	dzodoƒe
kite	aʋako
kitten	dadivi
knee	klo
knew	nya
knife	hɛ
knight	asrafo
knowledge	sidzedze
known	si wonya
know	nya nu
Konkani	Konkani
Krio	Krio
label	nuŋutigbalẽ
labor	dɔwɔwɔ
labour	dɔwɔna
lack	manᴐanyi
ladder	li
lady	ɖetugbui
laid	ɖo aba
lake	tɔgbada
lamb	alẽvi
lame	si tu
lamp	akaɖi
land	anyigbã
landscape	anyigbã ƒe kpɔkpɔme
language	gbegbᴐgblᴐ
lap	ata dzi
large	lolo
last but not least	mlɔetɔ gake menye gblɔetɔ o
last name	ƒome ŋkɔ
last	nᴐ anyi didi
lately	le ŋkeke siawo me
later	emegbe
latest	mlɔ̃etɔ
late	tsi megbe
latter	megbetɔ
laughing	le nu kom
laugh	ko nu
laughter	nukoko
launch	ɖoe anyi
laundry	nunyaƒe
lawn	gbemumu
law	se
lawyer	senyala
lay	ɖoe anyi
layer	ɖoɖo
layout	nɔnɔme
lazy	kuvia
leader	ŋgɔnɔla
lead	nɔ ŋgɔ
leaf	aŋgba
leak	tsra
lean	blɔ
leap	tikpo
learning	nusɔsrɔ̃
learn	srɔ̃ nu
lease	haya
least	suetᴐ kekiake
leather	lãgbalẽ
leave	aŋgba
leaves	aŋgbawo
led	kplɔ
left	mia me
legacy	domenyinu
legal	le senu
leg	ata
legend	kalẽtɔ
legit	nye nyateƒe nu
leisure	modzkaɖeɖe
lend	do nu
length	didime
less	do le eme
lesson	nufiafia
let	na
letter	lɛta
level	gbadzaa
leverage	zã
liability	fenyinyi
library	agbalẽdzraɖoƒe
lick	ɖuɖɔ
lie	alakpa
lies	alakpa
life	agbe
lift	kᴐe dzi
light	kekeli
lightning	dzikedzo
like	di
likely	si ate ŋu adzɔ
likewise	ema ke
line	fli
Lingala	Lingala
link	kadodo
lion	dzata
liquid	tsi nu
listen	ɖo to
listening	toɖoɖo
list	nuleɖi
literally	le nyagbᴐgblᴐa nu
literature	nuxexlẽ
litter	kaka gbe
little	sue
live	nɔ agbe
liver	aklã
lives	le agbe
living	agbenɔnɔ
living room	akpata
lizard	adoglo
load	de agba
loaf	abolo
loan	gadodo
local	duametɔ
location	teƒe
lockdown	agbotutu
lock	tu
log	atikpo
lol	na
lonely	le akogo
long	didi
long time no see	mekpɔ wò edidi
look	kpᴐ
loop	xatsa
loose	tu
lord	aƒetɔ
lose	bu
loss	nububu
lost	bu
lot	gbogbo
loud	sesiẽ
lounge	dzudzɔƒe
love	lɔ̃
lovely	nyo ŋutᴐ
love you	lɔ̃ wò
low	bᴐbᴐ
lower	bɔbɔ
loyalty	nyateƒetoto
loyal	xᴐ ame dzi se
luck	dzɔgbenyuie
lucky	kpɔ aklama
Luganda	Luganda
luggage	agba
lump	kɔ
lunch	ŋdᴐ nuɖuɖu
lungs	dzitodzito
luxury	ga nu
lying	le alakpa dam
machine	mɔ
madam	aƒenɔ
mad	dze aɖaʋa
made	wᴐ
magazine	nyadɔdzɔgbalẽ
magnificent	nya kpɔ
maid	nyɔnuvi
main	ŋutᴐ
maintain	to
maintenance	nu dzadzraɖo
Maithili	Maithili
majority	akpa gãtɔ
major	ŋutɔŋutɔ
make up	modzadzraɖo
make	wɔ
male	atsu
mall	fiasegã
manage	kpɔ edzi
management	dzikpɔkpɔ
manager	dzikpɔla
mandatory	si nye dzizizi nu
manifest	ɖe eɖokui fia
manipulate	trɔ to eme
manner	nɔnɔme
man	ŋutsu
manual	asi nu
many	geɖewo
many many happy returns of the day	ɖagbe neva le ŋkeke sia me
march	ɖe zɔ̃
margin	axadzi
market	asime
marriage	srɔ̃ɖeɖe
married	ɖe srɔ̃
mask	momo
massive	sɔgbɔ
mass	lolome
master	aƒetɔ
match	hoʋiʋli
mate	kpeɖeŋutɔ
material	nu
math	akɔnta
matter	nu
maturity	tsitsi
may	ate ŋu
maybe	ɖewohĩ
meal	nuɖuɖu
mean	egɔmee nye
meaning	gɔmeɖeɖe
means	gᴐme nye
meant	gɔme nye
meanwhile	le esime esia le edzi yim la
measure	dzidze
measures	dzidzenuwo
meat	adelã
medical	dɔyɔyɔ
medicine	atike
meditation	ŋugbledede
medium	le vedome
meet	do go
meeting	takpekpe
Meiteilon	Meiteilon
melt	lolõ
memories	susuwo
memory	susu
mental	le susume
mentioned	si woyɔ
mention	yᴐ
mentor	hehenala
me	nye
merchant	asitsala
mercy	nublanuikpɔkpɔ
merely	ʋee ko
merry christmas	blunya nawò
message	gbedeasi
mess	gbegblẽ
messy	si menyo o
metal	ga
method	nuwɔmɔnu
me too	nye hã
mice	afiwo
middle	titina
midnight	zã titina
might	ate ŋu
mild	mesẽŋu o
milestone	agbadroƒekpe
military	asrafowo
milk	notsi
million	akpeakpe
mindset	susuɖoɖo
mind	susu
mine	tɔnye
mingle	habɔbɔ
minor	si le sue
minute	aɖabaƒoƒo
minutes	aɖabaƒoƒo
miracle	nukunu
mirror	ahuhɔ̃e
miscellaneous	nu bubuwo
mischievous	nuɖianu
miserable	wᴐ nublanui
misery	fukpekpe
miss	da ƒu
missing	bu
mission	dɔdeasi
miss you	le susuwom
mist	afu
mistake	vodada
Mizo	Mizo
mobile	si tsana
mock	ko
model	kpɔɖeŋu
moderate	le ve dome
modern	egbe nu
modest	si le sue
moist	ƒo tsi
moisture	yametsi
mold	nuto
mole	atɔ
mom	dada
moment	ɣeyiɣi
monday	dzoɖa
money	ga
monitor	ɖia
monkey	kese
month	ɣleti
mood	seselelãme
moody	le blanui
moon	dzinu
moral	nufiame
more	gawu
moreover	kpeɖe eŋu la
morning	ŋdi
mortgage	na
most	kekiake
mostly	zi geɖe
mother	nᴐ
motion	zɔɖeɖe
motivation	dzideƒo
mountain	to
mouse	afi
mouth	nu
move	ɖe zᴐ
movement	zɔzɔ̃
movie	sinii
mrs	aƒenɔ
much	sᴐgbᴐ
mud	ba
mug	kplu
muscle	lãmeka
museum	tsãnuwonɔƒe
mushroom	ŋɔlixexi
music	hadzidzi
must	dze be
mute	zi ɖoɖoe
mutual	si ame sia ame xɔ
My dear	nye lɔlɔ̃tɔ
my friend	xɔ̃nye
my love	nye lɔlɔ̃tɔ
my name is	ŋkɔ nyee nye
my	nye
my pleasure	nye dzidzɔ
myself	nye ŋutɔ
mysterious	nye amlima
mystery	nuɣaɣla
myth	amlima
nail	gatagbadzɛ
naive	mese naneke gɔme o
name	ŋkɔ
narrative	nyatoto
narrow	me xe
nasty	nyaŋu
national	dukɔmetɔ
nationality	dumevinyenye
native	dumetᴐ
natural	dzɔdzɔme nu
nature	dzᴐdzᴐme
nausea	xeɖeɖe
nearby	si teɖe mía gbɔ
near	egbᴐ
nearly	vie ko
neat	dza
necessary	hiã
neck	kɔ
necklace	kɔga
need	hiã
negative	si menyo o
neglect	gblẽ ɖi
negotiate	ƒo asi
neighbor	aƒelika
neighborhood	goloɔgui
neither	menye esia o
nephew	nyruiyᴐvi
nerd	ametsibome
nervous	le vᴐvᴐm
nest	atɔ
net	ɖɔ
network	kadodo
neutral	si mede akpa aɖeke dzi o
never	gbɛɖɛ
never give up	dzi megaɖe le ƒo wò o
nevermind	megadee tame o
never mind	megatsidzi o
nevertheless	gake hã
news	nyadzɔdzɔ
new	yɛye
next	esi kplᴐe ɖo
next to	le egbɔ
nice	enya kpɔ
nice to meet you	enyo be míedo go
niece	nyruiyᴐvi nyᴐnu
nightmare	ŋɔdzi drɔẽ
night	zã
nine	asiɛkɛ
nineteen	wuiasiɛkɛ
ninety	blaasiɛkɛ
No	Ao
nobody	ame aɖeke o
noise	ɣli
noisy	le ɣli dom
none	ɖeke o
noon	ŋdɔ
nope	gbeɖɛ
no problem	megblẽ naneke o
nor	alo
normal	gbe sia gbe ƒe nu
north	dziehe
nose	ŋɔti
nostalgic	ŋkuɖodzi
not at all	gbɛɖɛ
not bad	megblẽ o
noted	mexɔe de eme
note	ɖo ŋku edzi
nothing	naneke o
noticed	kpɔ dzesi
notice	kaklãnana
Not now	Menye fifia o
not	o
not yet	haɖe o
noun	nkɔnya
nouns	ŋkɔnyawo
novel	ŋutinyagbalẽ
november	adamekpɔxɛ
nowadays	ŋkeke siawo me
no way	mɔ meli o
now	fifia
nuisance	fuɖename
null	ƒuƒlu
number	xexlẽdzesi
numb	ku trikpa
nurse	dᴐnᴐdzikpᴐla
nut	azi
nutmeg	na
nutrition	nunyiame ŋuti nunya
oath	atam
obesity	amidada
obey	wɔ edzi
objective	taɖodzi
object	nu
obligation	nuteɖeamedzi
obscure	si be
observation	nukpɔkpɔ
observe	le ŋku ɖe eŋu
obsessed	dze aɖaʋa ɖe eme
obsession	nudzeamedzi
obsolete	do xoxo
obstacle	mɔxenu
obtained	xɔ
obtain	xᴐ
obviously	eme kᴐ
obvious	si me kᴐ
occasionally	ɣeaɖewoɣi
occupation	dɔwɔna
occupied	le dɔ wɔm
occur	dzᴐ
occurred	dzɔ
occurs	dzɔna
ocean	atsiaƒu
october	kele
odd	mesᴐ o
odds	na
of course	nyateƒee
offensive	ɖia ame nu
offer	na
office	dɔwɔƒe
official	dɔwɔla
off	tsi
often	often
Oh	O
oh really	o nyateƒea
oil	ami
okay baby	enyo lɔlɔ̃tɔ
okay dear	enyo lᴐlɔ̃tᴐ
okay	enyo
okay honey	lᴐlɔ̃tᴐ enyo
okay my love	nye lᴐlɔ̃tᴐ enyo
ok dear	enyo lɔlɔ̃tɔ
ok	Enyo
ok honey	enyo lɔlɔ̃tɔ
ok my love	enyo nye lɔlɔ̃tɔ
old	tsitsi
once	zi ɖeka
on	edzi
one	ɖeka
one language is never enough	gbegbɔgblɔ ɖeka mede gbɛɖɛ o
onion	sabala
online	le kadzi
only	ko
open	ʋu
operation	nuwɔna
opinion	tamesusu
opportunities	mɔnukpɔkpɔwo
opportunity	mɔnukpɔkpɔ
opposite	esi dze ŋgᴐ
optimistic	le mɔkpɔm
optional	le tiatia me
option	tiatia
or	alo
orange	aŋuti
order	gbeɖeɖe
ordinary	gbe sia gbe nu
organization	nu ɖoɖo
orientation	susutɔtrɔ
original	gbãtɔ
origin	dzɔtsoƒe
Oromo	Oromo
orphan	tsyɔẽvi
other	bubu
otherwise	ne menye nenem o la
ought	dze be
our	míaƒe
Our mission: to enable everyone, everywhere to understand the world and express themselves across languages.	Míaƒe dɔdeasi: míana be ame sia ame, le afi sia afi nase xexeame gɔme eye woaƒonu be gbe bubu dolawo hã nase.
Our mission: to organize the world's information and make it universally accessible and useful.	Míaƒe dɔdeasi: míade xexeame nyadzɔdzɔwo ɖoɖo me aha wɔe be woanɔ alɔdzi ahaɖevi na ame sia ame si le xexeame.
outcome	metsonu
out	do do
outfit	awudodo
outgoing	si le dzodzom
outlet	dodoƒe
outline	ɖoɖo
outside	gota
outstanding	tsi anyi
oven	numekpo
overall	si ƒo wo katã ta
overcome	ɖu dzi
over there	le afima
overthinking	tamebubu fũu
over	to eta
overwhelmed	wui
overwhelming	si wu ale sidze
owe	nyi fe
owl	adzexe
owner	nutɔ
own	le esi
ox	tedzitsu
pace	ɖiɖime
package	nu babla
pack	ƒoƒu
paid	xe fe
paint	aŋɔ
painting	aŋɔsisi
pain	vevesese
pair	nu eve
pale	fu
palm	asiƒome
pan	agba gbadza
pandemic	dᴐxᴐtsatsa
panic	vɔvɔ̃
pants	godui
paper	pɛpa
paradise	paradiso
parallel	si le sɔsɔnu
parcel	nubabla
pardon	tsɔtsɔke
parents	dzilawo
park	gbadzaƒe
parrot	ako
parsley	na
part	akpa
participate	kpɔ gome
particularly	abe ame ɖeka
particular	ma
partner	hati
party	dunyaheha
passage	nuŋlɔɖi
passed	kpɔ ŋudzedze
passionate	kple seselelãme
passion	seselelãme sesẽ
passive	si metsɔ ɖeke le eme o
pass	to eme
password	safuinya
past	tsã
patch	tre nu
path	afᴐmᴐ
pathetic	wɔ nublanui
patience	dzigbᴐɖi
patient	dzigbɔɖi
pattern	ɖoɖome
pause	tɔ vie
pavement	mɔtokpe
payment	fexexe
pay	xe fe
peaceful	le ŋutifafa me
peace	ŋutifafa
peach	na
peak	kɔkɔƒe
pear	pɛya
peas	ayi
peculiar	nye nu ɖeka tɔ
pee	aɖuɖɔ
peel	kle
peer	hati
peers	hatiwo
pencil	nuŋlɔti
pending	le lalam
pen	nuŋlɔti
people	amewo
pepper	atadi
perceive	kpɔ nu
perception	nukpᴐkpᴐ
perfect	de blibo
performance	dᴐwᴐwᴐ
perform	wᴐ nu
perhaps	ɖewòhĩ
period	ɣeyiɣi
permanent	si li tegbee
permission	mᴐɖeɖe
permit	ɖe mɔ
perseverance	kutrikuku
persistent	edziedzi
personal	ame ɖeka ƒe nu
personality	ame tɔxɛ
person	ame
perspective	nukpɔkpɔ
persuade	ble enu
pervert	ŋunyɔ
pet	ameƒelã
phase	akpa
phenomenon	nudzɔdzɔ
philosophy	nunya
phone	kaƒomɔ
photo	foto
phrase	nyatiatia
physical	ŋutilã me
pick	fɔ
pick up	tsᴐe
picture	nutata
piece	nu kakɛ
pieces	nu kakɛwo
pigeon	ahɔnɔe
pig	ha
pile	ƒo kɔ
pillow	suɖi
pilot	yameʋukula
pin	abui
pineapple	atɔtɔ
pink	dzẽ
pitch	gbadzaƒe
pit	ʋe
pity	nublanui
places	teƒewo
place	teƒe
plague	dɔxɔleameŋu
plain	si me kᴐ
plan	ɖoɖo
plane	gbadza
plant	ati
plants	atiwo
plate	nuɖugba
platform	nugbadza
play	fe fefe
playing	le fefem
pleasant	nya se
pleased	kpɔ ŋudzedze
please	taflatsɛ
pleasure	dzidzᴐkpᴐkpᴐ
pledge	ɖe adzɔgbe
plenty	sɔgbɔ
plot	babla
plug	katsyiãnu
plum	atɔ
plumber	tsidɔwɔla
plural	agbɔsɔsɔ
podcast	na
poem	hakpanya
poetry	hakpanya ŋuti nunya
point	asitɔƒe
poison	aɖi
police	kpovitɔ
policy	ɖoɖo
polite	bua ame
pollution	ɖiƒoƒo
pond	tsi ʋe
pool	tsi xaxa
poop	mí
poor	da ahe
pop	pɔp
popular	nyanyɛ
population	amehawo
pork	halã
porridge	dzogbɔ
port	ʋudzeƒe
position	ɖoƒe
positive	si nyo
possession	nunɔamesi
possessive	nutɔnyeye
possess	lé
possible	ate ŋu adzᴐ
post	dzɔƒe
postpone	dae ɖe gbebugbe
potato	nagoti
potential	ŋutete
pound	pɔŋ
poverty	ahedada
powerful	ŋusẽtɔ
power	ŋusẽ
practical	asidɔwɔwɔ
practice	kasa
praise	kafu
prank	amebeble
pray	do gbe ɖa
precious	tᴐxɛ
precisely	tututu
precise	tututu
predict	gblɔ nya ɖi
preference	tiatia
prefer	tiã
pregnant	fɔfu
prejudice	nazã
premises	nyagɔmenya
premium	si xɔ asi
preparation	dzadzraɖo
prepared	dzraɖo
prepare	dzrãɖo
preposition	nya ŋgɔnya
presence	amegbɔnɔnɔ
presentation	nunana
present	fifia
preserve	le ɖi
president	dukplɔla
press	te ɖe anyi
pressure	nuteɖeamedzi
pretend	wᴐ abe
pretty	nya kpɔ
prevent	xe mᴐ
previous	si do ŋgᴐ
prey	xeƒonu ƒe nuɖuɖu
price	asi
pride	dada
priest	trɔ̃nua
primary	gɔmedzeƒe
prime	xɔ asi
princess	fiavinyɔnu
principal	nua ŋutɔ
prior	do ŋgɔ
priority	nu si le veviẽ
prison	mɔ
privacy	adzame
private	ame ŋutᴐ ƒe
privilege	mɔnukpɔkpɔ tɔxɛ
prize	dziɖufiakuku
probably	ɖewòhĩ
problem	kuxi
procedure	afᴐɖeɖe
proceed	yi edzi
process	nuwᴐna
produce	wɔ
production	nuwɔwɔ
product	nu si wowɔ
professional	dɔnyala
profession	dɔwɔwɔ
profile	ŋuti nya
profit	viɖe
profound	si me goglo
progress	ŋgᴐyiyi
project	dɔwɔna
prominent	le ŋgɔ
promise	ŋgbedodo
promote	do ɖe ŋgɔ
promotion	dodoɖe ŋgɔ
prompt	ka fee
prone	mlɔ anyi legbe
pronouns	ŋkɔteƒenɔnyawo
pronunciation	nyayɔyɔ
proof	kpeɖodzi
properly	nyuie
proper	nyuietᴐ
properties	nunɔamesiwo
property	nunᴐamesi
proposal	nyadoɖa
prospect	ŋgɔkpɔkpɔ
prosperity	nudzedziname
prosperous	hotsuikpɔkpɔ
protect	tɔ kpɔ ƒo xlã
proud	dana
prove	ɖo kpe edzi
provided	ne esɔ ko
provide	na
province	nutoga
provision	nuhiahiawo
puberty	ɖetugbivãvã
public	amedome
pull	hee
pumpkin	na
punctual	le game dzi
pupil	nusrɔ̃vi
purchase	ƒle
pure	si me kɔ
purple	dzẽ
purpose	taɖodzi
purse	gakotoku
pursue	tsi eyome
pursuit	ti eyome
push	tutu
put	da ɖi
qualification	ŋudzedzekpɔkpɔ
quality	nyonyo
quantity	agbɔsɔsɔ
quarantine	ɖeɖe ɖe aga
quarrel	dzre
quarter	kuata
Quechua	Quechua
queen	fianyɔnu
queer	si to vovo
query	biabia
question	biabia
queue	fli
quick	kaba
quickly	kaba
quiet	zi ɖoɖoe
quilt	na
quit	do le eme
quite	abe
quiz	dodokpɔ
quotation	nyatoto
quotes	nyatotowo
quote	to nya
rabbit	fɔmizi
race	ɖimekeke
rage	do dɔmedzui
rain	tsidzadza
raised	kɔ ɖe dzi
raise	kᴐe ɖe dzi
random	si mele ɖoɖonu o
ran	ƒu du
range	kekeme
rapid	kabakaba
rapidly	kabakaba
rarely	medzᴐna zi geɖe o
rare	mebᴐ o
rash	ŋutsetsi
rat	alegeli
rate	asixᴐxᴐ
rather	boŋ
ratio	ɖoɖo
rational	le susunu
raw	mumu
reached	de
reach	te ɖe egbɔ
reaction	ŋuɖoɖo
reading	nuxexlẽ
read	xlẽ
ready	le ŋudzᴐ
reality	nyateƒe
realized	de dzesi
realize	kpɔe be
really	nyateƒea
real	ŋutᴐ
rear	nyi
reasonable	le susu nu
reason	susu
recall	gayɔ
receipt	fexegbalẽ
received	xᴐ
receive	xᴐ
recently	medidi o
recent	si gbɔ medidi o
reception	amexɔƒe
recipe	nuɖaɖa ŋuti ɖoɖo
reckless	maɖɔʋu
recognition	dzesidede
recognize	de dzesi
recommend	ɖo aɖaŋu
recommended	doe ɖa
record	nyaleɖi
recover	xɔe gbɔ
recovery	hayahaya
rectangle	aɖaka legbee
red	dzẽ
redeem	ɖe
redemption	ɖeɖekpɔkpɔ
reduce	ɖe edzi
redundant	si tsi edzi
refer	ɖo ɖa
reference	ɖeɖe fiã
reflection	dzedze
reflect	klẽ
refrain	dzudzɔ
refrigerator	nufamɔ
refund	gbugbɔ ga na
refused	gbe
refuse	gbe
regarding	le enu
regard	kpɔ
regardless	si ŋu womebu o
regards	gbedoname
region	nuto
register	ŋlɔ ŋkɔ
regret	se veve
regular	edzidzi
regularly	edziedzi
reject	gbe
related	do ƒome
relate	do ƒome
relationship	ƒomedodo
relative	ƒometɔ
relatives	ƒometɔwɔ
relax	gbɔdzi ɖi
released	si ŋuti woɖe asi le
release	ɖe asi le
relevant	le veviẽ
reliable	woaka ɖe edzi
relief	gbᴐɖeme
relieved	kpɔ gbɔɖeme
relieve	na gbɔɖeme
religion	subɔsubɔ
religious	subɔsubɔ nu
reluctant	mele lɔlɔm o
rely	ɖo ŋu
remaining	si kpɔtɔ
remain	tsi anyi
remarkable	si dze
remedy	atike
remember	ɖo ŋku edzi
remind	ɖo ŋku edzi
reminder	ŋkuɖodzi
remote	si gbɔ dzi dzi
remove	ɖee le eme
render	tsɔ na
rent	haya
repair	dzrae ɖo
repeat	gawɔe ake
replace	ɖo eteƒe
reply	ɖo eŋu
report	nutsotso
represent	si le eteƒe
reputation	bubudede
request	bia
required	si hiã
require	hiã
rescue	ɖe le fu me
research	numekuku
resemble	ɖi
resentment	dɔmedzoedodo
reservation	megbedede
reserve	si woda ɖi
resident	dumenɔla
resign	ɖe asi le dɔ ŋuti
resilience	tenɔnɔ
resilient	si seŋu
resistance	agladzedze
resist	gbe
resolution	nuɖoɖo
resolve	le avu
resort	amedzrodzeƒe
resources	nunɔamesiwo
respect	bu ame
respond	ɖo eŋu
response	ŋuɖoɖo
responsibility	dɔdeasi
responsible	wᴐ nuteƒe
restaurant	nuɖuƒe
rest	dzudzᴐ
rest in peace	dzudzɔ le ŋutifafa me
restore	ɖoe eteƒe
restrict	xe mɔ
result	metsonu
results	metsonu
resume	gadze egᴐme
retail	agbadzi nudzadzra
retain	le ɖi
retention	nuléleɖi
retired	xɔ dzudzɔ
retreat	yi megbe
retrieve	xɔegbɔ
return	trᴐ gbᴐ
reveal	ɖe ɖe go
revealed	si woɖe ɖe go
revenge	teƒeɖoɖo
revenue	gakpᴐkpᴐ
reverse	yi megbe
review	dzro eme
revise	wɔ tɔtrɔ
revision	ɖɔɖɔɖo
revolution	tɔtrɔ yeye
reward	fetu
rhythm	ʋugbe
rib	axadameƒu
rice	mᴐli
rich	kpᴐ ga
rid	ɖe ɖa
ride	ku
ridiculous	ɖi kokoe
right now	fifi laa
right	nyui
rigid	si dzeti
ring	asigɛ
rinse	kpala
riot	aglãdzedze
ripe	ɖi
rip	klɔ nu le nu ŋutsi
rise	yi dzi
risk	ŋɔdzi
rival	atsusi
river	tɔsisi
road	mɔ
roast	me
robust	si sẽ
rock	ahliha
rod	kpo
role	wɔƒe
roll	mli
roof	xɔgbagbã
room	xɔ
root	ke
rope	ka
rotten	gblẽ
rough	ƒlatsa
roughly	lɔƒo
round	nogo
route	mɔ
routine	gbe sia gbe nuwɔna
row	akpa
rubber	aŋe
rubbish	gbeɖuɖɔ
rub	si
rude	dze aglã
rug	ɖovu
ruin	gblẽ edome
ruler	dziɖula
rule	se
rules	sewo
run	ƒu du
running	le du dzi
rural	kɔƒeme
rush	si du
sack	kotoku
sacred	si ŋuti kɔ
sacrifice	vɔsa
safe flight	yameʋuɖoɖo dedie
safe	le dedie
safety	dedienɔnɔ
sage	nunyala
said	gblᴐ
sailing	le tsidzi zɔm
sail	zɔ tɔdzi
sake	ta
salary	fetu
sale	nudzadzra
salmon	sama
salt	dze
same	ema ke
Same here	afi sia hã
sample	kpɔɖeŋunu
sand	ke
Sanskrit	Sanskrit
sarcastic	alɔmeɖenya
sassy	dzetugbe
satisfaction	ƒoɖiɖi
satisfied	ɖi ƒo
satisfy	ɖi ƒo
satisfying	le ƒo ɖim
sat	nɔ anyi
Saturday	Memlɛɖa
sausage	na
savage	tso gbe me
save	dzrae ɖo
saw	kpᴐ
say	gblᴐ
scale	dudanu
scam	adzodamɔnu
scar	abikukuteƒe
scarce	si mebɔ o
scared	vɔ̃
scarf	taku
scary	do ŋɔdzi
scattered	kaka
scene	nukpɔkpɔ
scenery	nukpɔkpɔ
scent	ʋeʋe
schedule	ɖoɖo si dzi woazɔ
school	suku
science	dzᴐdzᴐme ŋuti nusᴐsrɔ̃
scientist	dzɔdzɔmeŋutinunyala
scientists	dzɔdzɔmeŋutinunyalawo
scissors	sakisi
scold	gbenya
scope	kekeme
score	do age
scrap	nu gbagbã
scratch	kukɔ nu ŋu
scream	do ɣli
screen	mɔxenu
screw	gatagbadze totro
script	nuŋlɔɖi
sea	atsyiaƒu
seal	nutrenu
search	di
season	ɣeyiɣi
seat	zikpui
second	evelia
secret	nuɣaɣla
section	akpa
secure	le dedie
security	dedienɔnɔ
seed	nuku
seek	di
see	kpɔ
seem	dze ame
seems	dze abe
seen	kpɔ
see you later	miado go emegbe
see you	miado go
see you soon	miado go
see you tomorrow	tsɔ míado go
seize	zi nu dzi
seizure	nudzisesẽ
seldom	si medzᴐna edziedzi o
select	tia
self	ame ŋutɔ
self healing	yɔadɔ eɖokui
selfish	di eɖokui tᴐ
sell	dzra
send	dᴐ
send me your picture	ɖo wò nɔnɔmetata ɖem
senior	ametsitsi
sense	susu
sensible	si me susule
sensitive	sea nu
sent	dɔ
sentence	nyagbe
sentences	nyagbewo
separate	to vovo
Sepedi	Sepedi
september	anyɔnyɔ
sequence	yomenuwo
series	siwo kplɔ wo nɔewo ɖo
seriously	veviẽ
serious	moveviẽ
serve	subɔ
service	dɔ
session	akpa
set	ɖoe
setting	ɖoɖo
settle	dze anyi
set up	ɖo anyi
seven	adrẽ
seventeen	wuiadrẽ
seventy	blaadrẽ
several	geɖe
severe	seŋu
sew	tɔ
shade	vɔvɔli
shadow	vɔvɔli
shake	ʋuʋu
shall	na
shallow	megoglo o
shame	ŋkpe
shape	dzedzeme
share	ma
sharp	ɖaɖɛ
shed	agbadɔ
she	e
sheep	alẽ
sheet	agbalẽ kakɛ
she has	le esi
she is	eyae nye
shelf	agba
shell	dzato
shelter	bebeƒe
shield	akpoxɔnu
shift	te yi
shine	klẽ
ship	mɛli
shipping	agbaɖoɖo ɖa
shirt	awu
sh	na
shoes	afɔkpawo
shoot	da
shop	fiase
shopping	nuƒeƒle
shore	tɔto
shortage	mademade
short	kpuie
shot	dada
shoulder	abɔta
shout	do ɣli
show	ɖe fia
shower	tsinyɔnyɔ
show me	fiam
shrimp	bɔlu
shrink	no ɖe eme
shut	tu
shut up	zi ɖoɖoe
shy	ŋukpem
sibling	nɔvi
siblings	nᴐviwo
sick	le dɔ lém
side	axa
sigh	ɖe hũu
sight	nukpᴐkpᴐ
sightseeing	ŋkutsatsa
signature	asinu dzesi
sign	dzesi
significant	le veviẽ
silence	ɖoɖoezizi
silent	zi ɖoɖoe
silk	ɖetsi
silly	abunɛ
silver	klosalo
similar	sᴐ
simp	abunɛtɔ
simple	ɖagbuie
simultaneously	enumake
since	esi wònye
sincerely	le nyateƒe me
sincere	toa nyateƒe
sing	dzi ha
singer	hadzila
single	ɖeka
sink	yi to
Sir	amega
sister in law	nɔvi ŋutsu srɔ̃
sister	nᴐvi nyᴐnu
site	teƒe
sit	nɔ anyi
situation	ɣeyiɣi
six	adẽ
sixteen	wuiadẽ
sixty	blaadẽ
size	lolome
skill	aɖaŋuwɔwɔ
skills	aɖaŋuwɔwɔ
skinny	nye ƒu ɖeɖe
skin	ŋutigbalẽ
skip	dzo to eta
skirt	siketi
sky	yame
slave	kluvi
sleep	dᴐ alɔ̃
sleeping	le alɔ̃dɔm
sleepy	alɔ̃ le etsɔm
sleeve	awubɔ
slice	kpakpɛ
slide	ɖiɖi
slightly	vie ko
slim	tsralɛ
slip	agbalẽvi
slope	aga
slot	nudeƒe
slow	blewu
slowly	blewu
small	sue
smart	zãzɛ̃
smell	ʋeʋẽ
smile	alɔgbɔnu
smoke	dzudzɔ
smooth	zrɔ̃
snack	numeɖenu
snail	abɔbɔ
snake	dã
snap	to dɔ
snow	sno
soak	de tsi
soap	adzalẽ
sober	se nu gɔme
soccer	bɔl ƒoƒo
social	hame
society	du
socks	afɔwui
so cute	nyakpɔ ŋutɔ
so	eyata
so far	va se ɖe fifia
soft	bᴐbᴐ
software	sɔƒtwɛ
soil	ke
sold	dzra
soldier	asrafo
sold out	wodzrae
sole	ɖeka
solid	nu sesẽ
solution	ŋuɖoɖo
solve	ɖo eŋu
somebody	ame aɖe
some	ɖe
somehow	ɖewuiɖewui
someone	ame aɖe
something	nane
sometimes	ɣeaɖewoɣi
song	ha
soon	madidi o
sophisticated	si me nu geɖe le
Sorani	Sorani
sore	abi
sore throat	vemexɔabi
sorrow	konyifafa
Sorry	Babaa
sort	ɖo
sought	di
soul	luʋɔ̃
soulmate	na
sound	gbeɖiɖi
soup	detsi
source	dzᴐtsoƒe
sour	le vevem
south	anyiehe
space	teƒe gbadza
spam	na
Spanish	Spaniagbe
span	lũ
spare	kpeɖeŋu
speak	ƒo nu
special	tᴐxɛ
species	ƒome
specific	si dzi wotᴐ asi
spectacular	nukpɔla
speechless	mate ŋu aƒo nu o
speech	nuƒoƒo
speed	dusisi
spell	yɔ ŋɔŋlɔdzesiwo
spend	zã
spent	zã
spicy	le aɖe
spike	ŋu
spinach	ama
spin	tro
spirit	gbɔgbɔ
spit	ɖe ta
splendid	nyakpɔ ŋutɔ
split	ma
spoiled	gblẽ
spoil	gblẽ
spontaneous	enumake
spoon	gatsi
spot	teƒe
spouse	srɔ̃
spread	kaka
spring	gagᴐdɔ̃e
square	dzogoe ene
squeeze	mía
squid	bosrã
squirrel	adɔ
stable	dze mo anyi
stab	tɔ hɛ
stack	nuƒoƒu
staff	dᴐwᴐlawo
stage	fefewɔƒe
stain	ɖi
stairs	trakpui
stake	ati si wotu
stalk	ɖia ame
stall	tɔ kplo
st	amekɔkɔe
stamp	nutredzesi
standard	dzidzenu
stand	tso
star	ɣletivi
start	dze egᴐme
started	dze egɔme
starving	dɔ le wuwum
state	dukɔ
statement	nyadu
station	ʋuɖoƒe
statue	kpetata
status	ɖoƒe
stay	nᴐ anyi
stay safe	nɔ dedie
steady	dzɔ
steak	nyilãmeme
steal	fi
steam	dzudzɔ
steel	ga
steep	si glɔ̃
stem	ati
step	afɔɖeɖe
stick	ati
stiff	dzeti
still	kokooko
sting	te
stingy	nye dɔnuitɔ
stir	blu
stock	asigba
stolen	si wofi
stomach	ƒodo
stone	kpe
stood	tso
stool	zikui
stop	tᴐ
storage	nudzadzraɖo
store	fiase
storm	ahom
story	ŋutinya
stove	mlekpui
straight	dzɔ
straightforward	yi tẽe
strain	he eɖokui
stranger	amedzro
strange	si womekpᴐ kpᴐ o
strategy	ayɛ
strawberry	na
straw	gbekui
streak	flitsotsowo
stream	tᴐsisi
street	mɔdodo
strength	ŋusẽ
stress	nuteɖeamedzi
stretch	he eme
strict	ƒe nyame sẽ
strike	ƒo
string	ka
strip	ɖe le eŋu
strive	do ŋusẽ nu
stroke	gbagbãdᴐ
strong	sẽ
struck	ƒo
structure	nɔnɔme
struggle	ʋli
struggling	le fu kpem
stubborn	dze aglã
stuck	tsi teƒe ɖeka
student	nusrɔ̃la
studying	le nusrɔm
study	srɔ̃ nu
stuff	nuwo
stunning	wᴐ nuku
stupid	abunɛ
style	atsyiã
subject	nyati
submission	nu tsɔtsɔ yi
submit	tsᴐe yi
substance	nu
substitute	teƒenɔla
subtle	le aye me
succeed	kpɔ dzidzedze
success	dzidzedzekpᴐkpᴐ
successful	dze edzi
such	abe
such as	abe
suck	no
sudden	emumake
suddenly	tete
suffering	fukpekpe
suffer	kpe fu
sufficient	de
sugar	sukli
suggest	doe ɖa
suggestion	nudodoɖa
suitable	si nyo
suitcase	potomato
suit	dziwui
sum	home
summary	totoɖeme
summer	dzomeŋɔli
summit	takpekpegã
sunday	kɔsiɖa
sun	ɣe
sunny	ŋdɔkutsu
sunset	ɣetoɖoɖo
sunshine	ɣedzedze
superior	si de ŋgɔ wu
super	nyo ŋutɔ
supervisor	dzikpɔla
supper	fiɛ̃ nuɖuɖu
supply	nunana
support	de megbe
suppose	bui be
supposed	bui be
sure	ka ɖe edzi
surface	ŋkume
surgery	amekoko
surge	yi dzi
surname	ƒome ŋkɔ
surprised	wɔ nuku
surprise	si do le kpome
surrender	na ta
surrounding	nu siwo ƒo xlã
surveillance	gbetakpɔkpɔ
survey	le ŋku ɖe eŋu gbadza
survive	tsi agbe
suspect	bu nazã
suspended	si dzi woɖo asi
suspicious	nye nu vɔɖi wɔla
sustainability	anyinɔnɔ didi
sustainable	si ate ŋu anɔ anyi
sustain	le ɖe te
swag	xɔmetsovɔ legbe
swallow	mi
swap	tutu eme
swear	ka atam
sweat	dze fifia
sweater	vuvɔmewu
sweep	kplɔ nu
sweet dreams	ku droẽ viviwo
sweetheart	lɔlɔ̃tɔ
sweet tooth	numevivi
sweet	vivi
swelling	tete
swell	te
swim	ƒutsi
swimming	tsiƒuƒu
swing	dayidagbɔe
switch	si
swollen	te
sword	yi
symbol	dzesi
sympathy	akɔfafa
symptoms	dɔléle dzesi
system	mɔnu
table	kplɔ̃
tackle	afɔdeme
tag	dzesidekpe
tail	asikɛ
take away	ɖee le eme
take care	lebenɛ
taken	tsɔ
take off	dze mɔ
take	tsɔ
talkative	ƒoa nukpoloe
talk	ƒo nu
tall	kᴐkᴐ
tape	nudzidzeka
tap	ƒo edzi
target	taɖodzinu
task	dɔ
taste	ɖᴐe kpᴐ
tasty	le aɖe
taught	fia nu
teacher	nufiala
teach	fia nu
team	dɔwɔha
tear	aɖatsi
tears	aɖatsiwo
tease	ɖia ame nu
tea	tii
technology	mɔɖaŋu
teeth	aɖuwo
tell	gblᴐ
tell me	gblᴐe nam
temperature	dzoxɔxɔ
temper	dziku
temple	gbedoxɔ
temporary	manᴐ anyi adidi o
tenant	xɔhayala
tendency	ŋutete
tender	bᴐbᴐ
tend	tea ŋu
ten	ewo
tense	kpɔ̃ɔ
tension	dzimaɖeɖi
tent	agbadɔ
tentative	si dzi womeɖo kpee o
ten thousand	akpe ewo
term	nya
terms	ɖoɖowo
terrible	ɖi vᴐvɔ̃
terrific	si sẽŋu
territory	anyigbã
test	dodokpɔ
text	nuŋɔɖi
thank	akpe
thanks	akpe
Thanks for using our app	Akpe be nèzã app sia
thank you	akpe na wò
Thank you for your patience while we investigate shipment	Akpe be nègbɔ dzi ɖi na mí le esime míenɔ nugɔmekuku la wɔm
thank you so much	akpe na wò kakaaka
thank you very much	akpe na wò kakaaka
than	wu
that is	ema nye
that	nu ma
that's good	ema nyo
theft	fififi
their	woƒe
theme	nyati
themselves	woawo ŋutɔ
them	wo
then	ɣe ma ɣi
theory	agbalẽmenya
there	afi ma
there are	wo li
therefore	eya ta
there is	nane le
these	nu siawo
the	the
they are	woawoe nye
they	wo
thick	tri
thief	fiafi
thigh	atagba
thing	nu
things	nuwo
think	bu tame
thin	lɛe
third	etɔ̃lia
thirsty	tsikɔ le wum
thirteen	wuietɔ̃
thirty	blaetɔ̃
this is	esia nye
this	nu sia
thoroughly	memie
thorough	memie
those	emawo
thought	bui be
thoughtful	bua tame
though	togbɔ
thoughts	tamesusuwo
thousand	akpe
thread	ka
threaten	do vɔvɔ̃
threat	ŋᴐdzidodo
three	etɔ̃
threshold	kpui
thrilled	do dzidzɔ
thrive	le agbe tim
throat	vetome
throughout	katã me
through	to eme
throw	da
thumb	degblefetsu
thunder	dziɖegbe
Thursday	Yawoɖa
thus	eya ta
tick	de dzesi
tide	ƒudada
tidy	le dzadzɛ
tie	sa kᴐ
tiger	kpɔ̃
tight	mía
Tigrinya	Tigrinya
time	ɣeyiɣi
timid	vɔna
tiny	sue
tip	nunana
tips	aɖaŋuɖoɖowo
tired	ɖeɖi te eŋu
tire	te ɖeɖi
tissue	ayi
title	tanya
toast	ɖo dze
to be	nyenye
today	egbe
toddler	vitata
toes	afɔbidɛ
together	ɖekae
toilet	afɔdzi
told	gblɔ
tolerance	dzigbɔɖi
tolerate	ɖe mɔ
tomato	tomatre
tomorrow	tsɔ si gbɔna
tongue	aɖe
tonight	fiɛ̃ sia
too	hã
took	tsᴐ
tool	dɔwɔnu
tools	dɔwɔnuwo
tooth	aɖu
top	dzi
topic	nyati
torn	vuvu
torture	funyafunya
total	ƒuƒoƒo
touch	ka asi
tough	sẽ ŋu
tour	tsaɖiɖi
toward	ɖo ta
towards	ɖo ta
towel	papaŋu
town	du
toxic	nye aɖi
to	yi
trace	ti eyome
track	gbememᴐ
trade	asitsatsa
traditional	dekɔnu nu
tradition	dekɔnu
traffic	trafik
trail	le megbe
training	hehe
train	na hehe
trait	nɔnɔme
traits	nɔnɔmewo
transfer	tsɔ yi teƒe bubu
transition	dodo le eme
translate	ɖe gbe gɔme
transparent	si me kɔ
transportation	ʋuɖoɖo
transport	de ʋu
trap	mɔ
trash	gbeɖuɖɔ
trauma	vevesesegã
travel	zɔ̃ mᴐ
tray	agbagbadzɛ
treasure	kesinɔnu
treatment	dᴐyᴐyᴐ
treat	wɔ nu ɖe
tree	ati
tremendous	si lolo ŋutɔ
trend	le tsi dzi
trial	dodokpᴐ
trick	ayɛ
tried	dze agbagba
trigger	daƒe
trim	lũ
trip	mᴐzɔ̃zᴐ
trouble	kuxi
trousers	atalegbe
truck	keke
true	nyateƒe
trunk	nugo
trust	ka ɖe edzi
truth	nyateƒe
try	dze agbagba
Tsonga	Tsonga
tube	nuto
Tuesday	blãɖa
tuition	nufiafia
turkey	dɔkɔ
turmeric	na
turn	trᴐ
turtle	klo
tutor	nufiala
twelve	wuieve
twenty	blaeve
twenty-one	blaeve-vɔ-ɖɛkɛ
Twi	Blugbe
twice	zi eve
twist	tro
two	eve
type	ƒomevi
typical	ŋutɔŋutɔ
ugly	vlo
ultimate	le nuwuwu
umbrella	xexi
unable	mate ŋui o
uncle	nyrui
unconscious	yi ɖime
under	egɔme
underneath	gɔme
underrated	da ɖe anyi
understand	se egᴐme
understood	se egɔme
unfortunately	dzᴐgbevᴐetᴐ
uniform	si sɔ
unique	tɔxɛ
unit	nu ɖeka
university	yunivesiti
unknown	si womenya o
unless	negbe
until	va se ɖe
unusual	si womekpɔ kpɔ o
update	doe ɖe ŋgᴐ
up	dzi me
upgrade	do ɖe ŋgɔ
upon	na
upset	kpɔ dziku
up to you	ele gbɔwò
urban	dugãme
urgent	si hiã enumake
urge	xlɔ̃ nu
used	si wozã
useful	ɖe vi
useless	si ŋu ŋudɔwɔnu aɖeke mele o
use	zã
us	mí
usually	zi geɖe
usual	si dzɔna
utility	ŋudɔwɔnu
vacation	mᴐkeke
vaccination	abuidodo
vaccine	abuitike
vacuum	nu ɖi gbɔlo
vague	si me mekɔ o
valid	le enu
valley	bali
valuable	si xɔ asi
value	asixᴐxᴐ
variety	vovovowo
various	vovovo
vary	to vovo
vase	agba
vast	si keke
vegetable	amagbewo
vegetables	amagbewo
vehicle	ʋu
vendor	nudzrala
venom	aɖi
venture	dze agbagba
venue	nuwɔƒe
verify	ɖo kpe edzi
versatile	si wɔa nu geɖe
version	nukpɔkpɔ
vertical	tsi tsitre
very good	nyo ŋutɔ
very	ŋtᴐ
vessel	nugo
via	to eme
vibes	dzidzᴐ nyawo
vibe	seselelãme
vicious	vɔɖi
victim	fukpela
video	video
view	kpᴐ
village	kɔƒe
villain	amevɔ̃ɖi
vinegar	ahatsitsi
vintage	si xɔ ŋkɔ
violence	avuwɔwɔ
violent	si wɔ avu
viral	si le kakam
virgin	ɖetugbui si menya ŋutsu o
virtual	na
virtue	nu nyuie
vision	nukpɔkpɔ
visit	sasrã
visual	nukpɔkpɔ
vital	le veviẽ
vivid	si mekɔ nyuie
vocabulary	nya nyanya
voice	gbeɖiɖi
void	ɖi ƒuƒlu
volume	ɣlidodo
volunteer	tsɔ ɖokui na
vomit	ɖe xe
vulnerable	gbᴐdzᴐ
wage	fetu
wages	fetu
waist	ali
waiter	subɔla
waiting	le lalam
wait	lala
wake	nyɔ
wake up	nyɔ
walking	le zɔzɔm
walk	zɔ̃
wallet	gakotoku
wall	glĩ
wander	tsa
wanna	di be
want	di
wanted	wo di
war	aʋa
wardrobe	awudzraɖoƒe
warehouse	agbaxɔ
warm	xɔ dzo
warn	ɖo afɔ afɔta
warning	kpɔnyuiedodo
warrior	aʋawɔla
wash	nya nu
was	nye
waste	gbeɖuɖᴐ
watch	kpɔ
watermelon	dzamatre
water	tsi
wave	ƒutsotsoe
way	mᴐ
weak	gbᴐdzᴐ
weakness	gbɔdzɔgbɔdzɔ
wealth	hotsuikpᴐkpᴐ
wealthy	gatɔ
wear	do
we are	míawoe nye
wearing	do
weather	ya me
we can	míate ŋu
wedding	srɔ̃ɖeɖe
Wednesday	Kuɖa
weed	gbe
weekend	kɔsiɖanuwuwu
week	kᴐsiɖa
weight	kpekpeme
weird	to vovo
welcome	woezɔ̃
welfare	dedienɔnɔ
well done	ewɔ nyuie
Well	Vudo
we	mí
went	yi
were	wonye
west	ɣetodoƒe
wet	ƒo tsi
whale	boso
what about you	ke wò ya ɖɛ
what are you doing now	nu ka wɔm nèle fifia
what are you doing	nu ka wɔm nèle
what are you doing right now	nu ka wɔm nèle fifia
what do you do	dɔ ka wɔm nèle
what do you do for a living	dɔ kae nèwɔna
what do you mean	egᴐme ɖe
what do you want	nu ka dim nèle
whatever	esi wònye ko
what happened	nu kae dzᴐ
what is	nu kae nye
what is this	nu kae nye esia
what is your job	dɔ kae le asiwò
what is your name	ŋkɔwò ɖɛ
what	nu ka
what's up	nukae le dzɔdzɔm
what's your name	ŋkɔwò ɖɛ
wheat	lu
wheel	kekefɔti
whenever	ɣe sia ɣi
when	ɣe ka ɣi
where	afi ka
where are you	afi kae nèle
where are you from	afi kae nètso
where are you now	afi ka nèle
whereas	evᴐ la
where do you live	afi kae wò aƒeme le
where is	afi kae
whether	ɖe
which	nu ka
while	esi me
whisper	dali
whistle	kpe
white	ɣi
who	ame ka
who are you	ame kae nenye
who is	ame kae nye
who is this	ame kae nye esia
whole	blibo
whom	ame si
whose	ame ka tᴐ
why not	aleke wɔ
why	nu ka ta
wicked	tagbɔsesẽtɔ
wide	keke
widow	ahosi
width	kekeme
wife	srɔ̃ nyᴐnu
wild	le gbe me
willing	le lᴐlᴐm
will	lɔlɔ̃nu
window	fesre
wind	ya
windy	le ya ƒom
win	ɖu dzi
wine	wain
winter	vuvᴐŋᴐli
wipe	tutu
wire	galɛ
wisdom	nunya
wise	nya nu
wish	didi
wish you all the best	medi dzɔgbenyuie na wò
witch	adzetɔ
withdrawal	ɖe le eme
withdraw	ɖee ɖa
within	wo dome
with	kple
without	manᴐmee
witness	gbɔdzɔgbɔdzɔ
witty	nyanu
wolf	amegaxi
woman	nyɔnu
women	nyɔnuwo
wonderful	wᴐ nuku
wonder	nukunu
won	ɖu dzi
won't	maawɔe o
wood	ati
wool	alẽfu
word	nya
words	nyawo
work	dɔ
working	le dɔwɔm
work out	de kame
world	xexeame
worm	ŋɔvi
worn	nyi
worried	tsi dzi
worry	dzitsitsi
worse	gblẽ wu
worship	subɔsubɔ
worst	si gblẽ wu
worth it	nyo nɛ
worth	xɔ asi
worthy	dze
wound	abi
Wow	eii
wrap	bla
wrath	adã
wrist	alɔnu
Write here	Ŋlɔe ɖe afi sia
write	ŋlᴐ
writing	nuŋɔŋlɔ
written	wo ŋlɔ
wrong	mede o
wrote	ŋlɔ
yard	dzidzenu
yawn	haha
Yeah	Ee
year	ƒe
years	ƒewo
yeast	nuʋãnu
yell	do ɣli
yellow	aŋgbaɖiɖi
yes baby	ɛ̃ vinye
yes dear	ɛ̃ lɔlɔ̃tɔ
Yes	Ɛ̃
yes honey	ɛ̃ lᴐlɔ̃tᴐ
yes my love	ɛ̃ nye lᴐlɔ̃
yes of course	tututu
yesterday	tsᴐ si va yi
yet	haɖe o
yield	tse
you are beautiful	edze tugbe
you are	ènye
you are so beautiful	edze tugbe ŋutɔ
you are welcome	wòezᴐ
you can	ate ŋu
You know	Ènya
young	nye ɖevi
you're welcome	wòe zɔ
you’re welcome	wòezɔ
yourself	wò ŋutɔ
your welcome	wòe wɔ̃
your	wò
youth	sɔhɛ
you too	wo hã
you	wò
yummy	vivi
zero	naneke o
