a	ᐅᓇ
a	ᐊ
a little	ᒥᑭᔪᒥ
a lot	ᐊᔅᓱᐊᓗᒃ
a lot of	ᐊᒥᓱᑦ
abandon	ᕿᒪᐃᓐᓇᐃᓂᖅ
abandoned	ᐃᒃᓯᓐᓇᐃᓂᖅ
abide	ᒪᓕᑦᑎᐊᕐᓂᖅ
ability	ᐱᔪᓐᓇᕐᓂᖅ
able	ᐱᔪᓐᓇᖅᑐᖅ
about	ᖃᓂᑦᑐᑦ
about	ᒥᒃᓵᓄᑦ
above	ᖁᓛᓂ
abroad	ᑲᓇᑕᐅᑉ ᓯᓚᑖᓂ
absence	ᐅᐸᙱᓐᓂᖅ
absent	ᐅᐸᙱᑦᑕᕆᐊᖃᖅᑐᖅ
absolutely	ᐄᑦᑎᐊᒻᒪᕆᒃ
absorb	ᐱᔭᐅᔪᖅ
abstract	ᐃᓱᒪᒋᔭᐅᔪᖅ
absurd	ᑐᑭᖃᙱᑦᑐᖅ
absurd	ᐃᓱᒪᐃᑦᑐᖅ
abundance	ᐊᒥᒐᙱᑦᑐᖅ
abundant	ᐊᒥᓲ ᐊᒥᓲᓂᖏᑦ
abuse	ᐱᓂᕐᓗᒃᑕᐅᓂᖅ
accent	ᑎᐱᖓ
accept	ᐊᖏᖅᑐᖅ
access	ᐊᑐᐃᓐᓇᖃᕐᓂᖅ
accident	ᐊᓇᐅᑖᖅᑐᖅ
accommodation	ᑐᔪᕐᒥᔾᔪᑏᑦ
accomplish	ᐊᓂᒍᖅᑎᑕᐅᔪᑦ
accomplished	ᐱᔭᕇᖅᑕᐅᓯᒪᔪᑦ
according	ᒪᓕᒡᓗᒍ
account	ᑮᓇᐅᔭᖁᑎᖃᕐᕕᒃ
accuracy	ᓇᓛᒎᑦᑎᐊᕐᓂᖅ
accurate	ᑕᒻᒪᖅᓯᒪᙱᑦᑐᑦ
accused	ᐸᓯᔭᐅᔪᖅ
ache	ᕿᓕᖓᔪᖅ
achieve	ᐊᓂᒍᐃᓂᖅ
achievement	ᐱᓕᕆᐊᖑᖃᑦᑕᖅᓯᒪᔪᑦ
acknowledge	ᓇᓗᓇᐃᕐᓗᒍ
acquaintance	ᖃᐅᔨᒪᙱᓐᓂᖅ
acquire	ᐱᑖᕆᑦ
acquired	ᓂᐅᕕᐊᖑᓯᒪᔪᑦ
acquisition	ᓂᐅᕕᕐᓂᐊᕐᓂᖅ
across	ᐊᑭᐊᓂ
act	ᐱᖁᔭᖅ
action	ᐱᓕᕆᐊᖅ
active	ᐆᒻᒪᕆᒃᑐᖅ
activities	ᐱᓕᕆᐊᒃᓴᑦ
activity	ᐱᓕᕆᐊᒃᓴᑦ
actor	ᑭᓇᐅᙳᐊᕐᓂᖅ
actual	ᐊᑭᓪᓚᕆᐊ
actually	ᐊᓱᐃᓛᒃ
acute	ᐱᕕᖅᑐᖅ
adapt	ᓱᖏᐅᑎᓂᖅ
add	ᐃᓚᓗᒍ
addicted	ᐅᐃᕆᓯᒪᓂᖅ
addition	ᐃᓚᒋᐊᖅᑕᖅ
additional	ᐃᓚᒃᑲᓐᓂᖏᑦ
address	ᑐᕌᕈᑎᖓ
adequate	ᓈᒻᒪᒃᑐᖅ
adjacent	ᖃᓂᒋᔭᖓ
adjective	ᑐᕌᒐᖅ
adjust	ᐋᖅᑭᒋᐊᕐᓗᒋᑦ
admire	ᐱᒃᑯᒋᔭᖅ
admit	ᐸᓯᓂᖅ
adopt	ᐊᑐᓕᕐᓂᖅ
adorable	ᓈᒻᒪᑦᑎᐊᖅᑐᖅ
advance	ᓯᕗᓂᐊᒍᑦ
advanced	ᓯᕗᕙᓯᒃᑐᖅ
advantage	ᐊᑲᕐᕉᑎᑦ
adventure	ᖃᓄᐃᓕᐅᕈᓘᔭᕐᓂᖅ
adverb	ᐅᖃᕐᕕᒃ
advertisement	ᒪᓂᓴᐅᑎᑦ
advertising	ᓴᖅᑭᔮᖅᑎᑦᑎᓂᖕᒧᑦ
advice	ᐅᖃᐅᔾᔨᓂᖅ
advise	ᐅᖃᐅᔾᔨᓂᖅ
advocate	ᑭᒡᒐᖅᑐᐃᔨ
aesthetic	ᑕᐅᑦᑐᖓᒍᑦ
affair	ᓂᖀᑦ
affect	ᐊᒃᑑᑎᔪᖅ
affection	ᐊᒃᑐᐃᔪᖅ
afford	ᓂᐅᕕᕈᓐᓇᕐᓂᖅ
affordable	ᐊᑭᑐᓗᐊᙱᑦᑐᑦ
afraid	ᑲᑉᐱᐊᓱᖕᓂᖅ
after	ᑭᖑᓂᐊᓂ
afternoon	ᐅᓪᓗᑯᑦ
afterwards	ᑭᖑᓂᖓᒍᑦ
again	ᐱᒃᑲᓐᓂᕐᓂᖅ
again	ᓱᓕᒃᑲᓐᓂᖅ
against	ᐊᑭᕋᖅᑐᖅᑐᖅ
age	ᐅᑭᐅᖓ
agency	ᐱᒍᔨᓴᕐᕕ
agent	ᐱᓕᕆᔨ
aggressive	ᓲᖑᔪᖅ
agile	ᐃᒡᒑᖅᑐᖅ
ago	ᐅᐊᑦᑎᐊᓵᖅ
agree	ᐊᖏᖅᑐᖅ
agreement	ᐊᖏᖃᑎᒌᒍᑎ
agriculture	ᐱᕈᖅᓰᓂᖅ
ahead	ᓯᕗᓂᐊᒍᑦ
aid	ᐃᑲᔪᖅᑕᐅᓂᖅ
aim	ᑐᕌᕆᔭᖅ
air	ᐊᓂᕐᓂᒃᓴᖅ
airport	ᒥᕝᕕᒃ
aisle	ᓯᓕᔅ
alarm	ᖁᖁᐊᕈᑎ
alcohol	ᐃᒥᐊᓗᒃ
alert	ᐅᔾᔨᖅᓴᖅᑐᖅ
alive	ᐆᒪᓂᖅ
all	ᑕᒪᕐᒥᒃ
all right	ᐊᓱᐃᓛᒃ
all the best	ᐱᐅᓛᒃᑰᕐᓗᓯ
allow	ᐱᕕᖃᖅᑎᓐᓂᖅ
allowed	ᐱᔪᓐᓇᖅᑎᑕᐅᔪᖅ
almost	ᑲᓱᑲᓴᒃᑐᖅ
alone	ᐃᓄᑐᐊᖅ
along	ᐃᓚᖃᕐᓗᓂ
already	ᐱᓯᒫᓂᓕᖅᑐᖅ
Alright	ᐊᖏᑐᐃᓐᓇᖅᑐᖅ
also	ᐊᒻᒪ
also	ᐊᒻᒪᓗ
alternative	ᐊᓯᐊᒍᖔᖅ
although	ᐃᒪᐃᒃᑲᓗᐊᖅᑎᓪᓗᒍ
although	ᑕᐃᒪᐃᒃᑲᓗᐊᖅᑎᓪᓗᒍ
always	ᓱᓕᓐᓈᖅᓱᒻ
always	ᒐᔪᒃᑐᖅ
am	ᐅᕙᖓ
amazing	ᐅᒃᐱᕐᓇᖏᑦᑐᖅ
ambiguous	ᑐᑭᓯᓇᙱᑦᑐᖅ
ambition	ᐱᓂᐊᕈᒪᓂᖅ
ambitious	ᐱᔪᒪᓂᖃᕐᓂᖅ
amend	ᐋᖅᑭᒋᐊᕐᓗᒍ
amid	ᐊᒪᐃᑦ
among	ᐅᑯᓇᓂ
among us	ᐅᕙᑦᑎᓐᓂ
amount	ᖃᑎᓪᓗᒋᑦ
amusing	ᒥᑕᕐᓂᖅ
an	ᐊᑕᐅᓯᖅ
analysis	ᕿᒥᕐᕈᓂᖅ
ancestors	ᓯᕗᕚᕗᑦ
anchor	ᑭᓴᐅᑦ
anchor	ᑭᓴᕐᕕᒃ
ancient	ᐃᑦᑕᕐᓂᑕᐃᑦ
ancient	ᐅᐊᑦᑎᐊᕈᕐᓂᓴᖅ
and	ᐊᒻᒪ
and	ᐊᒻᒪᓗ
and you	ᐃᕝᕕᓪᓗ
angel	ᓂᕐᓕᖅ
anger	ᓂᙵᐅᒪᓂᖅ
angle	ᑎᕆᖅᑯᖅ
angry	ᒪᒥᐊᓱᒃᑐᖅ
angry	ᓂᙵᒃᑐᖅ
animal	ᐆᒪᔪᖅ
ankle	ᓯᖏᕐᓂᖅ
anniversary	ᓇᓪᓕᐅᓯᒪᔪᖅ
announcement	ᑐᓴᒐᒃᓴᖅ
annoy	ᓇᓗᓈᒋᔪᖅ
annoyed	ᑲᖐᒋᔭᖃᙱᑦᑐᖅ
annoying	ᐸᕝᕕᓴᕐᓂᖅ
annual	ᐊᕌᕐᒍᑕᒫᑦ
anonymous	ᑭᓇᐅᖕᒪᖔᑦ ᖃᐅᔨᔭᐅᔮᙱᑦᑐᖅ
another	ᐊᓯᐊ
answer	ᑭᐅᔾᔪᑎ
answer	ᑭᐅᓂᖅ
anticipate	ᓂᕆᐅᒋᔭᖅ
anxiety	ᐃᓱᒫᓗᓐᓂᖅ
anxious	ᓯᕘᕋᔪᖅ
any	ᓇᓕᐊᑐᐃᓐᓇᖅ
anymore	ᓱᓕᒃᑲᓐᓂᖅ
anyone	ᑭᓇᑐᐃᓐᓇᖅ
anything	ᑭᓱᑐᐃᓐᓇᖅ
anyway	ᖃᓄᑐᐃᓐᓇᖅ
anyway	ᓱᑐᐃᓐᓇᑦᑎᐊᖅ
anyways	ᓱᑐᐃᓐᓇᑦᑎᐊᖅ
apart	ᐅᖓᓯᒌᒃ
apartment	ᑲᑎᙵᐅᖅᑐᑦ
apologize	ᒪᒥᐊᑉᐳᖓ
apparent	ᑕᑯᒃᓴᐅᔪᖅ
apparently	ᓱᓇᐅᕝᕙ
appeal	ᐊᔪᐃᓐᓇᕆᐊᑲᓐᓂᕐᓂᖅ
appear	ᓴᖅᑭᓐᓂᖅ
appear	ᑕᑯᒃᓴᐅᔪᖅ
appearance	ᑕᑯᓐᓇᕐᓂᖓ
appeared	ᓴᖅᑭᖅᑐᖅ
appetite	ᓂᕆᔪᒪᓂᖅ
apple	ᐋᐳ
application	ᐊᑐᖅᑎᑕᐅᓂᖓ
apply	ᐃᓕᓯᓂᖅ
appointment	ᐃᓂᒃᓴᖅ
appreciate	ᐃᑉᐱᒍᓱᒃᑐᖅ
appreciate	ᐊᓕᐊᓇᐃᓱᓐᓂᖅ
appreciation	ᐊᑭᑐᓕᖅᐸᓪᓕᐊᓂᖅ
approach	ᖃᒡᓕᕙᓪᓕᐊᓂᖅ
approach	ᑐᕌᖅᑕᐅᓇᓱᒃᑐᖅ
appropriate	ᓈᒻᒪᒃᑐᖅ
approval	ᐊᖏᖅᑕᐅᓂᖓ
approve	ᐊᖏᖅᑕᖅ
approved	ᐊᖏᖅᑕᐅᓯᒪᔪᖅ
approximately	ᓪᓗᐊᖅ
april	ᐊᐃᕆᓕ
april	ᑎᕆᓪᓗᓕᐅᑦ
arbitrary	ᐃᓱᒪᖅᓲᑕᐅᔪᖅ
architect	ᐃᒡᓗᐃᑦ ᓴᓇᒪᓂᖏᓐᓂᑦ
architecture	ᓴᓇᒪᓂᖓ
archive	ᑐᖅᑯᖅᑕᐅᓯᒪᔪᑦ
are	ᑖᒃᑯᐊᖑᕗᑦ
are you	ᐃᒪᐃᑦᑑᕕᑦ
are you busy	ᐱᓕᕆᕖᑦ
are you married	ᑲᑎᑎᑕᐅᓯᒪᕖᑦ
are you married or single	ᑲᑎᑎᑕᐅᓯᒪᕕᑦ ᐅᕝᕙᓘᓐᓃᑦ ᐊᐃᑉᐸᖃᖅᐱᑦ
Are you still there?	ᓱᓕ ᑕᐃᑲᓃᑉᐱᑦ?
are you there	ᑕᐃᑲᓃᑉᐱᑦ
area	ᐃᓂᒋᔭᐅᔪᖅ
argue	ᐊᐃᕙᓂᖅ
argument	ᐊᐃᕙᓂᖅ
arise	ᓴᖅᑭᖅᑐᖅ
arm	ᑕᓕᖅ
army	ᐅᓇᑕᖅᑐᒃᓴᖅ
around	ᓇᒥᓗᒃᑖᖅ
arrange	ᐋᖅᑭᒃᓯᓂᖅ
arrangement	ᐋᖅᑭᒃᓯᒪᓂᖓ
arrival	ᑎᑭᑉᐸᑦ
arrive	ᑎᑭᓐᓂᖅᑐᖅ
arrived	ᑎᑭᖦᖢᓂ
arrogant	ᖃᕐᔪᙳᐊᖅ
arrow	ᖃᕐᔪᙳᐊᖅ
art	ᓴᓇᐅᒐᓕᕆᓂᖅ
article	ᑎᑎᕋᖅᓯᒪᔪᖅ
artificial	ᐱᓪᓚᑦᑖᙳᐊᖅ
artist	ᓴᓇᙳᐊᖅᑎ
as	ᑎᑐᑦ
as	ᐃᒻᒪᑐᑦ
as long as	ᑭᓯᐊᓂᓕ
as well	ᐊᒻᒪᓗᑦᑕᐅᖅ
as well as	ᐊᒻᒪᓗᑦᑕᐅᖅ
ash	ᐊᕐᔭᑦ
ashamed	ᑲᙳᓱᒃᓯᒪᔪᖅ
ask	ᐊᐱᕆ
asked	ᐊᐱᕆᔭᖅ
asleep	ᓯᓂᒃᑐᖅ
aspect	ᐃᓗᓕᖏᑦ
Assamese	ᐊᓴᒦᔅ
assault	ᐱᒋᐊᖅᓯᔪᖅ
assembly	ᒪᓕᒐᓕᐅᕐᕕᒃ
assertive	ᒪᓂᑐᐃᓐᓇᕐᓂᖅ
assess	ᖃᐅᔨᓴᕐᓗᒍ
assessment	ᖃᐅᔨᓴᕐᓂᖅ
asset	ᐱᒋᔭᑦ
assets	ᐱᖁᑎᑦ
assign	ᑐᓂᓯᓂᖅ
assignment	ᐱᓕᕆᐊᒃᓴᑦ
assist	ᐃᑲᔪᕐᓂᖅ
assistant	ᐃᑲᔪᖅᑎ
associate	ᐃᓚᒋᔭᐅᔪᖅ
associated	ᐊᒃᑐᐊᓂᓖᑦ
association	ᑲᑐᔾᔨᖃᑎᒌᑦ
assume	ᑕᐃᒪᓐᓇᐃᓐᓇᓱᒋᔭᖃᕐᓂᖅ
assumption	ᑲᖐᒋᔭᐅᔪᖅ
at	ᑖᕙᓂ
at least	ᐊᒃᓱᓪᓘᓐᓃᑦ
ate	ᓂᕆᔪᖅ
athlete	ᐱᙳᐊᖅᑎ
attach	ᐃᓚᓕᐅᑎᓯᒪᔪᖅ
attached	ᐊᑕᔪᖅ
attachment	ᐃᓚᓕᐅᑎᓯᒪᔪᖅ
attack	ᐱᒋᐊᖅᓯᔪᖅ
attempt	ᐱᓇᓱᖕᓂᖅ
attend	ᐃᓚᒋᔭᐅᓂᖅ
attendance	ᐅᐸᖃᑦᑕᖅᑐᑦ
attention	ᖃᐅᔨᒪᖁᔨᓂᖅ
attitude	ᖃᓄᐃᓕᖓᓂᖓ
attract	ᐅᐸᒍᒥᓇᖅᑐᖅ
attraction	ᐅᐸᒍᒥᓇᖅᑐᖅ
attractive	ᑕᑯᔪᒥᓇᖅᑐᖅ
attribute	ᓇᓗᓇᙱᔾᔪᑎᖏᑦ
audience	ᓈᓚᒃᑎᑦ
august	ᐊᐅᔭᓕᕈᑦ
august	ᐅᒍᔅᓯ
aunt	ᐊᑦᑕᒃ
aunty	ᐊᑦᑕᑎᖓ
authentic	ᓱᓕᑦᑎᐊᖅᑐᖅ
author	ᑎᑎᕋᖅᑎ
authority	ᐱᔪᓐᓇᕐᓂᓕᒃ
autumn	ᐅᑭᐊᖅ
available	ᑕᐃᒪᐃᔪᑦ
available	ᐊᑐᐃᓐᓇᖅ
average	ᐊᑯᓐᓂᖅᓱᖅᑐᖅ
avoid	ᐱᑦᑕᐃᓕᓂᖅ
awake	ᐃᖅᑯᒻᒪᕐᓂᖅ
award	ᑐᓂᔭᐅᔪᖅ
award	ᐃᓕᑕᖅᓯᓂᖅ
aware	ᐅᔾᔨᕈᓱᖕᓂᖅ
awareness	ᐅᔾᔨᕈᓱᖕᓂᖅ
away	ᕿᒪᒃᓯᔪᖅ
awesome	ᐱᐅᔪᒻᒪᕆᒃ
awful	ᐱᐅᙱᑦᑐᖅ
awkward	ᐃᓱᕆᙱᑦᑐᖅ
Aymara	ᐊᒪᕋ
baby	ᓄᑕᕋᓛᖅ
bachelor	ᐃᒡᓗᕈᓯᑕᐃᓐᓇᖅ
back	ᑐᓄ
background	ᐱᓕᕆᐊᖑᓯᒪᔪᑦ
bad	ᐱᐅᙱᑦᑐᖅ
bag	ᐴᖅ
bait	ᓇᕆᐊᖃᐃᑦ
bake	ᐆᓪᓗᒍ
bakery	ᐃᒐᐅᑉ ᐃᓗᐊᓂ ᐆᑕᐅᓂᖅ
baking soda	ᐃᓚᒃᓴᐅᑦ ᓲᑕ
balance	ᐊᒥᐊᒃᑯᐊ
ball	ᐊᖅᓴᖅ
Bambara	ᐸᒻᐳᕋ
banana	ᐸᓈᓇ
band	ᓇᒡᒍᐊᕐᒥ
bang	ᐸᖓᖅ
bank	ᑮᓇᐅᔭᒃᑯᕕᒃ
bar	ᐃᒥᕐᕕᒃ
barely	ᐸᑎᖓᔪᖅ
bargain	ᓯᕐᓚᔪᖅ
bark	ᐹᒃ
barley	ᐹᓕ
barrier	ᐊᒡᕕᐊᕈᑎ
base	ᑐᙵᕕᖓ
based	ᑐᙵᕕᖃᖅᖢᓂ
basement	ᑐᙵᕕᖓ
basic	ᓈᒻᒪᒃᑐᖅ
basically	ᐱᓗᐊᖅᑐᖅ
basil	ᐲᓱᓪ
bastard	ᕙᔅᑖᑦ
batch	ᑲᓱᖅᑐᖅ
bath	ᐅᕕᓂᖕᓂᐊᕐᓂᖅ
bathroom	ᐊᓇᕐᕕᒃ
battery	ᐹᑕᓖᖓ
battle	ᐸᑎᖅ
bay	ᑕᓯᐅᔭᖅ
be	ᔪᓐᓇᖅ
be careful	ᖃᐅᔨᒪᑦᑎᐊᕆᑦ
beach	ᓯᒡᔭᖓ
beam	ᐅᓪᓛᕈᒥᑕᖅ
beans	ᓂᓕᕐᓇᐃᑦ
bear	ᓇᓄᖅ
beard	ᐅᒥᒃ
bearing	ᕿᓄᐃᓵᕐᓂᖅ
beast	ᓯᒃᑲᖓᔪᖅ
beat	ᓵᓚᑦ
beautiful	ᐃᓂᖁᓇᖅᑐᖅ
beautiful	ᐱᐅᔪᖅ
beauty	ᑲᔾᔮᓇᖅᑐᖅ
became	ᐱᒋᐊᖅᑐᖅ
because	ᐱᔾᔪᑎᒋᓪᓗᒍ
because	ᓲᖃᐃᒻᒪ
become	−ᖑᖅᑐᖅ
bed	ᐃᒡᓕᖅ
bedroom	ᐃᒡᓗᕈᓯᖅ
bee	ᐱ
beef	ᑐᒃᑐᕙᒃ
been	−ᓯᒪᔪᖅ
beer	ᐱᐊ
before	ᓯᕗᓂᐊᓂ
before	ᖃᖅᑎᓐᓇᒍ
began	ᐱᒋᐊᖅᑐᖅ
begin	ᐱᒋᐊᕐᓂᖅ
beginning	ᐱᒋᐊᕐᓂᖅ
behalf	ᑭᒡᒐᖅᑐᖅᑐᖅ
behave	ᐃᓕᖅᑯᓯᖃᕐᓂᖅ
behavior	ᐃᓕᖅᑯᓯᖓ
behaviour	ᐃᓕᖅᑯᓯᖅ
behind	ᑐᓄᐊᓂ
being	ᖃᓄᐃᓐᓂᖅ
belief	ᐅᒃᐱᕈᓱᖕᓂᖅ
believe	ᐅᒃᐱᕈᓱᖕᓂᖅ
belly	ᓯᓕᖅᑐᖅ
belong	ᐱᒋᔭᐅᔪᖅ
beloved	ᓇᒡᓕᒍᓱᒃᑐᖅ
below	ᐊᑖᓂ
belt	ᑎᕆᒃᓯᐅᑦ
bench	ᐃᒃᓯᕙᕐᕕᒃ
bend	ᓇᒃᑭᑕᖅᑐᖅ
beneath	ᐃᓗᑐᔪᖅ
benefit	ᐃᑲᔫᑎᑦ
benefits	ᐃᑲᔫᑕᐅᔪᑦ
beside	ᓴᓂᐊᓃᑦᑐᖅ
besides	ᓴᓂᑦᑎᐊᖓᓂ
best	ᐱᐅᓛᖅ
best of luck	ᑲᔪᓯᑦᑎᐊᕐᓂᐊᖅᐳᑎᑦ
best regards	ᐃᓚᓐᓇᕆᔭᐃᑦ
better	ᐱᐅᓂᖅᓴᖅ
between	ᐊᑯᓐᓂᖓ
beverage	ᓂᐅᖅᑲᕐᓇᖅ
beyond	ᐅᖓᑖᓄᑦ
Bhojpuri	ᐳᔾᐴᕆ
bias	ᐃᓚᐃᓐᓈᕐᓂᖅ
biased	ᐃᓚᐃᓐᓈᕐᓂᖅ
bicycle	ᑐᒃᑲᕆᐊᓕᒃ
bicycle	ᐱᓲᑎ
bid	ᐊᑭᑦᑐᕋᐅᑎᓂᖅ
big	ᐊᖏᔪᖅ
bike	ᑐᒃᑲᕆᐊᓕᒃ
bill	ᐊᑭᓕᒃᓴᖅ
bind	ᐸᓚᐅᒐᖅ
bird	ᑎᖕᒥᐊᖅ
birthday	ᓇᓪᓕᐅᑎᔪᖅ
bit	ᓯᕐᓚᕈᓗᒃ
bite	ᑮᔭᐅᓪᓗᓂ
bitter	ᓯᒃᑲᖓᔮᖅᑐᖅ
black	ᕿᕐᓂᖅᑐᖅ
blade	ᓴᓕᒎᑎ
blame	ᐸᓯᒃᖠᖅᑐᖅ
blank	ᑎᑎᕋᕐᕕᒋᓯᒪᙱᑦᑐᖅ
blanket	ᕿᐱᒃ
blast	ᖄᖅᑎᑦᑎᖃᑦᑕᕐᓂᖅ
bleach	ᔮᕖᒃᓯ
blend	ᑲᑎᐅᖅᑐᖅ
bless	ᓴᐃᒻᒪᖅᑎᑕᐅᓂᖅ
blessed	ᓯᖃᑦᑎᑕᐅᓯᒪᔪᖅ
blind	ᑕᐅᑐᙱᖦᖢᓂ
bliss	ᐅᖏᓚᒃᑐᖅ
block	ᐃᓱᕈᖓ
blood	ᐊᐅᒃ
bloom	ᐳᕕᖅᑕᖅᑐᖅ
blow	ᓱᐱᓯᔪᖅ
blue	ᑐᖑᔪᖅᑐᖅ
blunt	ᓇᒃᓱᒃᑐᖅ
board	ᑲᑎᒪᔩᑦ
boat	ᐅᒥᐊᖅ
body	ᑎᒥ
boil	ᖃᓛᓕᖅᑎᓪᓗᒍ
bold	ᑲᑉᐱᐊᑦᑕᐃᑦᑐ
bond	ᐊᑕᔪᖅ
bone	ᓴᐅᓂᖅ
book	ᐅᖃᓕᒫᒐᒃᓴᖅ
book	ᐃᓂᒃᓴᓕᐅᕐᓂᖅ
boost	ᐱᒋᐊᕐᓂᖅ
booster	ᐱᒋᐊᖅᓯᔪᖅ
boot	ᑲᓐᓄᔭᖅ
boots	ᑲᒫᓗᐃᑦ
border	ᑭᒡᓕᖓ
bore	ᑭᒍᑕᖏᖅᑐᖅ
bored	ᑭᐱᙳᔪᖅ
boring	ᓱᓪᓗᙱᑦᑐᖅ
born	ᐃᓅᔪᖅ
borrow	ᐊᑐᖅᑐᐊᖅᑕᖅ
boss	ᐸᓴᔅ
both	ᑕᒪᒃᑭᒃ
bother	ᐊᓂ
bottle	ᐊᓕᒍᖅ
bottom	ᐊᑖᓂ
bought	ᓂᐅᕕᐊᑦ
bounce	ᐊᐅᓐᓯ
bound	ᑭᒡᓕᓕᖅᑕᐅᔪᖅ
boundaries	ᑭᒡᓕᖃᕐᕖᑦ
bow	ᑕᒋᐅᑦ
bowl	ᐊᓗᒡᕕᒃ
box	ᑎᑎᖅᑲᒃᑯᕕᐊ
boy	ᓄᑲᑉᐱᐊᖅ
boyfriend	ᐊᖑᑎᖓ ᐱᖃᓐᓈᖓ
bracelet	ᑕᓕᐊᖅ
brain	ᖃᕋᓴᖅ
branch	ᐊᕕᒃᑐᖅᓯᒪᓂᖓ
brand	ᓇᓗᓇᐃᒃᑯᑕᖅ
brave	ᑲᑉᐱᐊᑦᑕᐃᑦᑐᖅ
breach	ᓯᖁᒥᑦᑎᓂᖅ
bread	ᓂᐊᖂᔭᖅ
break	ᓯᖁᒥᑦᑐᖅ
break	ᓱᕋᒃᑐᖅ
breakfast	ᐅᓪᓛᕈᒥᑕᖅ
breast	ᐃᕕᐊᖏᖅ
breath	ᐊᓂᕐᓂᑭᓪᓗᓂ
breathe	ᐊᓂᖅᑎᕆᔪᖅ
breed	ᐃᒡᔪᕋᖅᑐᖅ
brick	ᐅᔭᕋᐃᑦ ᐃᔾᓗᓕᐅᕐᓂᕐᒧᑦ
bride	ᓄᓕᐊᒃᓴᖅ
bridge	ᐃᑳᕐᕕᒃ
brief	ᓇᐃᑦᑐᖅ
bright	ᖃᐅᒪᔪᖅ
brilliant	ᐳᕈᓕᐊᓐᑦ
bring	ᓇᒃᓴᕐᓗᑎᑦ
bro	ᐊᓂᙳᐊᖅ
broad	ᐱᔭᕆᑐᔪᖅ
broadcast	ᓈᓚᐅᑎᒃᑯᑦ
broke	ᓱᕋᒃᑕᖅ
broken	ᐋᒥᖅᑐᖅ
broom	ᓴᓂᐅᑎ
brother	ᐊᓂᒃ
brother	ᐊᖓᔪᒃ
brother in law	ᐊᐃᕌᕐᔪᒃ
brought	ᓇᒃᓴᖅᑕᖅ
brown	ᑲᔪᖅ
brush	ᑭᒍᑎᓯᐅᕈᑦ
bucket	ᖃᑦᑕᖅ
buddy	ᐱᖃᓐᓇᕆᔭᖅ
budget	ᑮᓇᐅᔭᑦ
bug	ᑯᒪᒃ
build	ᓴᓇᓂᖅ
building	ᐃᒡᓗᕐᔪᐊᖅ
built	ᓴᓇᔭᐅᔪᖅ
bulk	ᐃᓗᐃᒃᑲᖅ
bull	ᐸᖕᓂᖅᑐᖅ
bully	ᓲᖑᓴᒃᑎ
bump	ᕿᓕᖅᓯᓇᐅᔭᕐᓗᖕᓂᖅ
bunch	ᐸᓚᐅᒐᖅ
bundle	ᐸᑎᐅᔭᖅ
burden	ᐅᖁᒪᐃᒃᓴᕐᓂᖅ
buried	ᓴᐅᓯᒪᔪᖅ
burn	ᐆᑕᖅᑐᖅ
burst	ᖄᖅᑐᖅ
burst	ᓯᖅᑯᖅᑐᖅ
bury	ᓴᐅᓯᓂᖅ
bus	ᐸᓯ
bush	ᐊᔭᒃᓯᓂᖅ
business	ᓇᖕᒥᓂᖃᖅᑐᖅ
bust	ᐃᕕᐊᖏᑦ
busy	ᓄᖅᑲᕈᓐᓇᙱᑦᑐᖅ
busy	ᐱᓕᕆᐊᖃᒻᒪᕆᒃᑐᖅ
but	ᑭᓯᐊᓂ
butter	ᐃᒻᒨᔮᖅᑐᖅ
butterfly	ᑕᕐᕋᓕᑭᑖᖅ
button	ᐃᓯᕆᐅᑦ
buy	ᓂᐅᕕᕐᓂᖅ
by	ᐆᒧᖓ
by the way	ᐊᒻᒪᓗᑦᑕᐅᖅ
bye	ᐸᐃ
cabbage	ᑳᐱᔾ
cabinet	ᒥᓂᔅᑕᐃᑦ ᑲᑎᒪᔨᖏᑦ
cage	ᕿᑯᖅ
cake	ᑮᒃ
calf	ᓄᕐᕋᖅ
call	ᐅᖃᓗᓐᓂᖅ
call	ᐅᖄᓚᓂᖅ
call me	ᐅᖃᓗᒡᕕᒋᙵ
called	ᐅᖄᓚᔪᖅ
calm	ᐅᐃᒪᔪᓐᓃᕐᓂᖅ
came	ᖃᐃᔪᖅ
campaign	ᑐᕌᒐᕆᔭᖅ
can	ᔪᓐᓇᖅᑐᖅ
can	ᐱᔪᓐᓇᖅᑐᖅ
can't	ᐊᔪᖅᑐᖅ
Cancel	ᖁᔭᓈᕐᓂᖅ
cancer	ᐃᒃᐱᓐᓇᐃ
capable	ᐊᔪᙱᑦᑐᖅ
capacity	ᐃᓂᒋᔭᐅᔪᓇᕐᓂᖓ
capital	ᐊᑭᑐᔫᑎᑦ
caption	ᐅᖃᖅᑕᐅᔪᖅ
capture	ᑎᒍᓯᓂᖅ
car	ᓄᓇᓯᐅᑎ
car	ᓄᓇᒃᑰᕈᑦ
career	ᐃᖅᑲᓇᐃᔮᖃᕐᓂᖅ
careful	ᐋᒥᓕ
carefully	ᐅᔾᔨᖅᓱᑦᑎᐊᕐᓗᑎᑦ
careless	ᐃᒃᓯᖕᓇᐃᔪᖅ
caring	ᑲᒪᑦᑎᐊᕐᓂᖅ
carpenter	ᕿᔪᓕᕆᔨ
carpet	ᓇᑎᕌᓗᒃ
carrot	ᐅᑭᐊᖅ
carry	ᑎᒍᒥᐊᕐᓂᖅ
carry on	ᑲᔪᓯᑐᐃᓐᓇᕆᑦ
carry out	ᑲᔪᓯᑎᑦᑎᓂᖅ
case	ᐱᔾᔪᑎ
cash	ᑮᓇᐅᔭᑦ
cast	ᑳᔅᑦ
castle	ᑲᐱᑕᐃᔪᖅ
casual	ᐃᖅᑲᓇᐃᔭᑲᐃᓐᓇᖅᑐᖅ
cat	ᐳᓯᑳᑦ
catch	ᐊᖑᔭᒐᖅ
category	ᖃᓄᐃᑦᑑᓂᖏᑦ
cattle	ᒥᑭᓪᓕᑎᖅᓯᒪᓗᓂ
caught	ᐊᑯᑦᑕᖓ
cause	ᐱᔾᔪᑎᖓ
caution	ᐅᔾᔨᖅᓱᕆᐊᓕᑦ
cautious	ᐅᔾᔨᖅᓱᖅᑑᔪᖅ
cave	ᑳᐱᑐᕐᓂᖅ
cease	ᓄᖅᑲᖅᑐᖅ
ceiling	ᖁᓛ
celebrate	ᖁᕕᐊᓲᑎᒋᓗᒍ
cell	ᐃᔭᕈᕙᐅᔭᖅ
center	ᕿᑎᐊᓂ
century	100 ᐅᑭᐅᑦ
cereal	ᐅᓪᓛᒃᑯᑐᒐᖅ
ceremony	ᖁᕕᐊᓲᑎᖃᖕᓂᖅ
certain	ᖃᐅᔨᒪᔭᐅᔪᑦ
certainly	ᐄᑦᑎᐊᖅ
certificate	ᓇᓗᓇᐃᒃᑯᑕᖅ
chain	ᐊᖅᓵᖅᑑᔭᖅ
chair	ᐃᒃᓯᕙᐅᑕᖅ
challenge	ᐱᓇᔪᓐᓂᖅ
chance	ᐱᕕᖃᕐᓂᖅ
change	ᐊᓯᔾᔨᕐᓂᖅ
chaos	ᑎᕆᖅᑯᐃᑦ
character	ᖃᓄᐃᑦᑑᓂᖓ
characteristics	ᖃᓄᐃᑦᑑᓂᕆᔭᖏᑦ
charge	ᐊᑭᓕᒐᒃᓴᖅ
charity	ᑮᓇᐅᔭᓕᐅᖅᑎᐅᙱᑦᑐᑦ
charming	ᐃᖃᓗᒃᑐᖅ
chart	ᑎᑎᖅᑑᔭ
chase	ᓴᒡᕕᒃᑯᑦ
chat	ᐅᖃᖃᑎᒌᒃᓗᑎᒃ
cheap	ᐊᑭᑭᑦᑐᖅ
cheat	ᑲᔪᖅ
cheating	ᑕᓗᕈᖅᑐᐃᓂᖅ
check	ᑎᑎᕐᓗᒍ
cheek	ᐅᓗᐊᒃ
cheer	ᐃᑲᔪᖅᑐᐃᔪᖅ
cheerful	ᖁᕕᐊᓱᒃᑐᖅ
cheers	ᐃᑲᔪᖅᑐᐃᔪᖅ
cheese	ᓰᓯ
chemistry	ᐃᓚᐅᕈᑎᒃᓴᓕᕆᓂᖅ
cherish	ᐱᐅᓴᖅᑐᖅ
chess	ᐱᙳᐊᕈᑦ
chest	ᓴᒡᕕᒃ
chew	ᑕᒧᐊᔭᒐᖅ
chicken	ᐊᕿᒡᒋᕐᔪᐊᖅ
chief	ᐊᖓᔪᖅᑳᖅ
child	ᓄᑕᕋᖅ
childhood	ᓄᑕᕋᐅᓂᖅ
children	ᓄᑕᖅᑲᑦ
chill	ᐱᓐᓇᔭᒃ
chimneys	ᑐᖅᖢᐊᖏᑦ
chin	ᑕᓪᓗᐃᑦ
chocolate	ᑯᑯᓕᒃ
choice	ᓂᕈᐊᕆᔭᖅ
choose	ᓂᕈᐊᕐᓂᖅ
chop	ᐊᒡᒍᐃᓂᖅ
chores	ᐱᓕᕆᐊᒃᓴᑦ
chubby	ᓴᒡᕕᐊ
church	ᑐᒃᓯᐊᕐᕕᒃ
cinnamon	ᓯᓇᒪᓐ
circle	ᐊᐅᒪᓗᖅᑐᖅ
circumstances	ᖃᓄᐃᓕᖓᓂᖏᑦ
citizen	ᓄᓇᓕᖕᒥᐅᑕᖅ
city	ᓄᓇᓕᐸᐅᔭᖅ
claim	ᐱᔪᓐᓇᐅᑎ
clarify	ᑐᑭᓯᓇᖅᓯᑎᓪᓗᒍ
class	ᐃᓕᓐᓂᐊᕐᕕᒃ ᐃᓪᓗᕈᓯᖅ
clay	ᒪᕐᕋᖅ
clean	ᓴᓗᒪᓗᓂ
clear	ᑐᑭᓯᓇᑦᑎᐊᖅᑐᖅ
clerk	ᐊᓪᓚᑦᑎ
clever	ᓯᓚᐃᑦᑐᖅ
client	ᐱᔨᑦᑎᕋᖅᑕᐅᔪᖅ
cliff	ᐃᓐᓈᕈᖅ
climate	ᓯᓚᐅᑉ ᖃᓄᐃᓐᓂᖓ
climb	ᒪᔪᕋᕐᓂᖅ
clingy	ᐅᖓᔪᖅ
clock	ᖃᐅᔨᓴᐅᑦ
close	ᖃᓂᑦᑐᖅ
closet	ᐊᓐᓄᕌᒃᑯᕕᒃ
cloth	ᐊᓪᓚᕈᑦ
clothes	ᐊᓐᓄᕌᑦ
cloud	ᓄᕗᔭ
clown	ᐃᓐᓈᕈᖅ
clue	ᐃᓐᓈᕈᓕᒃ
clumsy	ᐱᑦᑎᐊᙱᑦᑐᖅ
cluster	ᑲᑎᖅᓱᖅᑕᐅᓯᒪᔪᑦ
coach	ᐃᓕᓴᐃᔨ
coal	ᐊᐅᒫᓗᒃ
coast	ᓯᒡᔭᖅ
coat	ᑲᓈᑦ
coffee	ᑳᐱ
cognitive	ᐃᓱᒪᒃᑯᑦ
coincidence	ᐊᑕᐅᑦᑎᒃᑰᖃᑎᖃᕐᓂᖅ
cold	ᓄᕙᒃᑐᖅ
collapse	ᑲᓱᒃᑕᖅᑐᖅ
collar	ᖁᖓᓯᕈᖅ
colleague	ᐃᖅᑲᓇᐃᔭᖃᑎᖓ
colleagues	ᐃᖅᑲᓇᐃᔭᖃᑎᒃᑲ
collect	ᓄᐊᑦᓯᓂᖅ
collection	ᓄᐊᑦᓯᓂᖅ
college	ᓯᓚᑦᑐᖅᓴᕐᕕᒃ
color	ᑲᓚ
color	ᐊᒥᐊᖅ
colorless green ideas slept furiously	ᑕᖅᓴᖃᙱᑦᑐᑦ ᑐᖑᔪᕈᔪᒃᑐᑦ ᐃᓱᒪᒋᔭᒃᓴᑦ ᓯᓂᒃᓯᒪᔪᑦ
colour	ᑕᖅᓴᖓ
column	ᑭᑉᑯᒪᑖ
comb	ᐃᓪᓚᐃᓕᕋᓛᖅ
combination	ᑲᑎᖦᖢᒋᑦ
combine	ᑲᑎᓪᓗᒋᑦ
come	ᖃᐃᒋᑦ
come here	ᖃᐃᒋᑦ
come on	ᐊᑏ
comfort	ᐃᖢᕐᕆᓂᖅ
comfortable	ᐊᑲᐅᒋᔭᖅ
coming	ᖃᐃᔪᖅ
coming soon	ᖃᐃᓂᐊᓕᖅᑐᖓ
command	ᑎᓕᐅᕆᔪᖅ
comment	ᐅᖃᐅᓯᒃᓴᖅ
commercial	ᑮᓇᐅᔭᓕᐅᕋᓱᐊᖅᑎᑦ
commission	ᑲᑎᒪᔩᑦ
commit	ᐱᓂᐊᕐᓂᕋᕐᓂᖅ
commitment	ᐱᓂᐊᕐᓂᖅ
committed	ᐊᖏᖅᓯᒪᔪᑦ
commodity	ᑕᐅᖅᓰᔭᐅᕙᒃᑐᒥᑦ
common	ᐊᑐᖅᑕᐅᒐᔪᒃᑐᑦ
communicate	ᑐᓴᐅᒪᑎᑦᑎᓂᖅ
communication	ᑐᓴᐅᒪᖃᑦᑕᐅᑎᓂᖅ
community	ᓄᓇᓕᒃ
commute	ᑐᓴᖅᑎᑦᑎᓂᖅ
companion	ᐱᖃᑎᖃᕐᓂᖅ
company	ᐊᑎᖅᓴᖅ
compare	ᒥᒃᓴᐅᑦᑎᓂᖅ
comparison	ᖃᓄᖅ ᐊᔾᔨᖃᖅᑎᒋᖕᒪᖔᑕ
compassion	ᓇᒡᓕᒍᓱᖕᓂᖅ
compassionate	ᓇᒡᓕᒍᓱᖕᓂᖅ
compatible	ᓈᒻᒪᒍᓐᓇᖅᑐᖅ
compete	ᐊᑭᒻᒪᑎᔪᖅ
competent	ᐊᑭᒻᒪᑎᔪᖅ
competition	ᓵᓚᖃᕋᓱᖕᓃᑦ
competitive	ᐊᑭᑦᑐᕋᐅᑎᓂᖅ
complain	ᐅᓐᓂᕐᓗᑎ
complaint	ᐅᓐᓂᕐᓘᑎ
complement	ᐊᑕᖐᔪᖅ
complete	ᐊᑕᖏᖅᓯᒪᔪᖅ
complete	ᐱᐊᓂᒃᑐᖅ
completely	ᐊᑕᖐᑦᑎᐊᖅᑐᖅ
complex	ᓇᓗᓇᖅᑐᖅ
compliance	ᒪᓕᑦᑎᐊᕐᓂᖅ
complicated	ᐱᔭᕆᑐᔪᖅ
compliment	ᐅᐱᒋᔭᐅᔪᑦ
comply	ᒪᓕᑦᑎᐊᖅᑐᖅ
composition	ᖃᓄᐃᓕᖓᓂᖓ
compound	ᓇᕐᕈᔪᖅ
comprehension	ᑐᑭᓯᐊᔭᖃᕐᓂᖅ
comprehensive	ᐊᑕᖐᑦᑎᐊᖅᑐᓂᑦ
compromise	ᐊᖏᖃᑎᒌᒍᓐᓇᐃᓪᓕᓂᖅ
compulsory	ᐱᑐᐃᓐᓇᕐᓂᖅ
computer	ᖃᕋᓴᐅᔭᖅ
concentrate	ᐱᐅᙱᓐᓃᔭᖅᑐᖅ
concept	ᐃᓱᒪᒋᔭᖓ
concern	ᐃᓱᒫᓘᑎ
concerned	ᐃᓱᒫᓗᓐᓂᖅ
concert	ᓂᔾᔭᐅᓯᔭᖅᑐᑦ
conclusion	ᐱᐊᓂᒍᑎᒋᓗᒍ
concrete	ᕿᑯᖅ
condition	ᖃᓄᐃᓕᖓᓂᖓ
conditions	ᖃᓄᐃᓕᖓᓂᖏᑦ
conduct	ᐱᓕᕆᑎᑦᑎᔪᑦ
conference	ᑲᑎᒪᕕᒡᔪᐊᕐᓂᖅ
confess	ᐊᓇᕈᓱᒃᑎ
confidence	ᖁᓱᙱᓐᓂᖅ
confident	ᖁᓚᙱᑦᑐᖅ
confident	ᖃᐅᔨᒪᔪᖅ
confirm	ᓇᓗᓇᐃᔭᐃᓂᖅ
conflict	ᐊᑲᐅᙱᓪᓕᐅᕈᑎᑦ
confused	ᐅᐃᒻᒪᒃᓯᒪᔪᖅ
confusion	ᓇᓗᓕᐅᒪᓂᖅ
congrats	ᐊᓕᐊᓇᐃᒍᓱᖃᑎᖃᖅᐳᓯ
congratulation	ᐊᓕᐊᓇᐃᒍᓱᖃᑎᒋᕙᔅᓯ
congratulations	ᐊᓕᐊᓇᐃᒍᓱᖃᑎᒋᕙᔅᓯ
conjunction	ᐊᖏᖃᑎᒌᖕᓂᖅ
connect	ᑲᓲᑎᓂᖅ
conquer	ᐊᓂᒍᐃᓂᖅ
conscious	ᐅᔾᔨᕈᓱᖕᓂᖅ
consciousness	ᐅᔾᔨᕈᓱᖕᓂᖅ
consent	ᐊᖏᕐᓂᖓ
consequences	ᖃᓄᐃᔾᔪᑕᐅᔪᖅ
conservation	ᐸᐸᑦᑎᑦᑎᐊᕐᓂᖅ
conservative	ᐱᐅᖅᓱᐊᕐᓂᖅ
consider	ᐃᓱᒪᒃᓴᖅᓯᐅᕐᓂᖅ
considered	ᐃᓱᒪᒋᔭᐅᔪᑦ
consist	ᒪᑯᓂᖓ
consistency	ᑕᐃᒪᐃᑦᑕᐃᓇᓕᔪᖅ
consistent	ᑕᐃᒪᐃᑦᑕᐃᓇᓕ
constant	ᑕᐃᒪᐃᖏᓐᓇᖅᑐᖅ
constantly	ᑕᐃᒪᐃᖏᓐᓇᐅᔭᖅᑐᖅ
constipation	ᐊᓇᕈᓐᓇᐃᓪᓕᓂᖅ
construction	ᓴᓇᔭᐅᓂᖓ
consume	ᐃᒥᕐᓂᖅ
consumption	ᓂᐅᖅᑲᕐᓂᖅ
contact	ᖃᐅᔨᒋᐊᕐᕕᒃᓴᖅ
contagious	ᐊᐃᑦᑐᕐᓗᐃᔪᓐᓇᖅᑐᖅ
contain	ᐃᓗᓕᖃᖅᑐᖅ
contains	ᐃᓗᓕᖃᖅᑐᖅ
contemporary	ᒫᓐᓇᓕᓴᖅ
contempt	ᐃᓱᒪᒋᔭᐅᙱᑦᑐᖅ
content	ᐃᓗᓕᖏᑦ
contest	ᓵᓚᒃᓴᕋᓱᖕᓂᖅ
context	ᐃᓗᓕᖏᑦ
continent	ᐱᑐᖃᖅ
continue	ᑲᔪᓯᓗᑎᑦ
contract	ᐊᖏᖃᑎᒌᒍᑎ
contrast	ᓇᓕᖅᑭᑖᖅᑐᖅ
contribute	ᐃᑲᔪᖅᓯᔪᖅ
contribution	ᐃᑲᔫᑎᒃᓴᑦ
control	ᐊᐅᓚᑦᑎᓂᖅ
controversial	ᐊᑲᐅᙱᓪᓕᐅᕈᑕᐅ
convenience	ᐊᑲᕐᕉᑎᖃᕐᓂᖅ
convenient	ᐊᑲᐅᔪᖅ
conversation	ᐅᖃᖃᑎᒌᖕᓂᖅ
convert	ᐊᓯᔾᔨᖅᑐᖅ
convey	ᐅᖃᐅᓯᖃᖅᑐᖅ
convince	ᐅᒃᐱᕈᓱᓕᕐᓂᖅ
convinced	ᐅᒃᐱᕈᓱᓕᕐᓂᖅ
cook	ᓂᖅᖠᐅᖅᑎ
cooking	ᓂᖅᖠᐅᕐᓂᖅ
cool	ᓂᓪᓕᓇᖅᑐᖅ
cooperation	ᐱᓕᕆᖃᑎᒌᖕᓂᖅ
cope	ᕿᓄᐃᓵᕐᓂᖅ
copper	ᑲᓐᓄᔭᖅ
core	ᐱᓪᓗᐊᑕᖅ
corn	ᑯᐊᓐ
corner	ᑎᕆᖅᑯᐊᓂ
correct	ᑕᐃᒫᑦᑎᐊᖅ
cost	ᐊᑭᖓ
costume	ᐊᑭᒋᓇᔭᙳᐊᖅᑕᖓ
cottage	ᐃᒡᓗᕈᑦ
cotton	ᐳᐊᓗᙳᐊᖅ
couch	ᐃᔅᓯᕙᐅᑕᑯᑖᒃ
cough	ᖁᐃᖅᓱᖅᐸᒡᓗᓂ
could	ᔪᓐᓇᕐᓂᖅ
could	ᐱᔪᓐᓇᕈᑦ
council	ᑲᑎᒪᔩᑦ
count	ᑲᑎᓪᓗᒋᑦ
counter	ᑭᐳ
country	ᓄᓇᓕᐸᐅᔭᖅ
countryside	ᓄᓇᑐᐃᓐᓇᕐᒥ
couple	ᐊᐃᑉᐸᕇᒃ
courage	ᓴᐱᖅᑕᐃᓕᓂᖅ
course	ᐃᓕᓐᓂᐊᒐᒃᓴᖅ
court	ᐃᖅᑲᖅᑐᐃᕕᒃ
courtesy	ᐱᑦᑎᐊᖅᑐᖅ
cousin	ᐃᓪᓗᖅ
cover	ᕐᑳᖓ
cow	ᐊᕐᓇᓪᓗᒃ
coward	ᑲᑦᑖᓗᒃ
cozy	ᐃᖢᕐᕆᔪᖅ
cozy	ᓱᐃᓛᖅᑭᓂᖅ
crab	ᐳᔾᔫᑎ
crack	ᓄᑎᒃᓯᒪᔪᖅ
craft	ᓴᓇᐅᒐᖅ
crap	ᓱᕙᓕᑭᐊᖅ
crap	ᐱᐅᙱᑦᑐᖅ
crash	ᓇᔅᓱᑦᑐᖅ
craving	ᖀᓕᕐᓂᖅ
crawl	ᐹᕐᖑᕐᕕᖓ
crazy	ᐃᓱᒪᐃᑦᑐᖅ
create	ᓴᓇᓗᑎᑦ
creative	ᓴᓇᑐᓂᖅ
credit	ᐊᑭᓕᒃᓴᖃᐅᑎ
creep	ᐊᐅᓚᔪᖅ ᓱᒃᑲᐃᑦᑐᖅ
creepy	ᑲᑉᐱᐊᓱᖕᓂᖅ
crew	ᐱᓕᕆᔩᑦ
crime	ᐱᕋᔭᖕᓂᖅ
cringe	ᑲᙳᓇᖅᑐᖅ
crisis	ᑐᐊᕕᕐᓇᖅᑐᖅ
criteria	ᒪᓕᒃᑕᐅᔪᒃᓴᑦ
critical	ᐱᕕᒡᔪᐊᖅ
criticism	ᐊᑭᕋᖅᑐᕐᓂᖅ
crop	ᑲᑎᙵᔪᑦ
crop	ᐱᕈᖅᓱᐃᓂᖅ ᓇᔪᕐᕕᒃ
crops	ᐱᕈᖅᑕᐅᓯᒪᔪᑦ ᑲᑎᖅᓱᖅᓯᒪᔪᑦ
cross	ᐃᑳᕐᕕᒃ
crow	ᐃᕿᔪᖅ
crowd	ᐃᓄᒋᐊᓗᐊᖅᑐᑦ
crowded	ᐃᓄᒋᐊᓗᐊᖅᑐᖅ
crown	ᑭᒍᑎᐅᑉ ᐃᓱᐃ
crucial	ᐱᔭᕆᐊᖃᓪᓚᕆᑦᑐᖅ
cruel	ᓯᖃᓪᓕᑎᔪᖅ
cruise	ᐅᒥᐊᕐᔪᐊᒃᑯᑦ
crush	ᓯᖃᓪᓕᑎᕈᑦ
cry	ᕿᐊᔪᖅ
cucumber	ᖂᖅᓱᔫᖅ
cuddle	ᓇᑉᐸᖅᑕᖅ
culture	ᐃᓕᖅᑯᓯᖅ
cunning	ᑳᐱᖕ
cup	ᐃᕐᖑᓯᖅ
cupboard	ᕿᑐᑦᑐᒐᐅᔭᖅ
curb	ᑕᖏᖅᓯᖅ
cure	ᐋᖅᑭᒡᓗᒍ
curfew	ᐊᕗᑎᔪᖅ
curiosity	ᖃᐅᔨᔪᒪᓂᖅ
curious	ᖃᐅᔨᒪᔪᖅ
curious	ᐃᓕᒪᔪᖅ
curly	ᑕᓗᕈᕙᖓ
currency	ᑮᓇᐅᔭᓄᑦ
current	ᒫᓐᓇᐅᔪᖅ
currently	ᒫᓐᓇᐅᔪᖅ
curse	ᒪᒥᑉᐸᓪᓕᐊᓂᖅ
curtain	ᓴᖑᖓᔪᖅ
cushion	ᓂᕈᒻᒫᒃᑯᓯᖅ
custom	ᐃᓕᖅᑯᓯᖅ
customer	ᐊᑭᓕᖅᓱᐃᔪᖅ
customs	ᐱᖅᑯᓯᑦ
cut	ᓇᑲᑎᕐᓗᒍ
cute	ᐃᓂᖁᓇᖅᑐᖅ
cute	ᒪᐃᑦᓯᐊᖅ
cycle	ᐃᖏᕐᕋᓂᖅ
cycling	ᑐᒃᑲᕆᐊᓕᒃᑯᑦ
dad	ᐊᑖᑕᒐ
daddy	ᐊᑖᑕ
daily	ᖃᐅᑕᒫᑦ
dairy	ᐃᒻᒧᒃᑐᖅ
dam	ᓯᒥᒃᑕᐅᑎᒧᑦ
damage	ᓱᕋᒃᓯᒪᔪᖅ
damn	ᓯᒥᒃᑕᐅᑦ
damp	ᕿᐅᒃᑲᖓᔪᖅ
dance	ᒧᒥᕐᓂᖅ
danger	ᐊᑦᑕᕐᓇᖅᑐᖅ
dangerous	ᐊᑦᑕᕐᓇᖅᑐᖅ
dark	ᑖᖅᑐᖅ
darling	ᐱᐅᒋᔭᖅ
dash	ᐃᐸᕋᖅᑐᖅ
data	ᑎᑎᕋᖅᓯᒪᔪᑦ ᖃᐅᔨᓴᖅᑕᐅᓂᑯᐃᑦ
date	ᐅᓪᓗᖓ
daughter	ᐸᓂᒃ
day	ᐅᓪᓗᖅ
dead	ᑐᖁᖓᔪᖅ
deadline	ᐃᓱᓕᕝᕕᐊ
deaf	ᑐᓵᙱᑦᑐᑦ
deal	ᑲᒪᓂᖅ
dear	ᐱᖃᓐᓇᕆᔭᖅ
Dear All	ᐊᐃᖓᐃ ᑕᒪᕐᒥᒃ
Dear Customer	ᑎᑎᕋᕐᕕᒋᔭᐅᔪᖅ ᐱᔨᑦᑎᕋᖅᑕᐅᔪᖅ
Dear Parents	ᐊᖓᔪᖅᑳᕆᔭᐅᔪᓄᑦ
Dear Sir	ᐊᐃᖓᐃ
Dear students	ᐃᓕᓐᓂᐊᖅᑎᓄᑦ
Dear Team	ᐃᓕᒌᓄᑦ
death	ᑐᖁᓂᖅ
debate	ᐊᐃᕙᓂᖅ
debit	ᐊᑖᕈᐊᖅᑕᐅᔪᖅ
debris	ᓴᓃᑦ
debt	ᐊᑭᓕᒃᓴᖅ
decade	ᖁᓖᑦ
decay	ᑎᓪᓕᕐᓂᖅ
deceased	ᐃᓅᔪᓐᓃᖅᑐᖅ
deceive	ᐱᙱᔭᐃᔪᖅ
december	ᐊᒡᔪᓕᐅᕐᕕᒃ
december	ᑎᓯᐱᕆ
decent	ᑎᐱᖓ
decide	ᐃᓱᒪᓕᐅᕐᓗᑎᑦ
decided	ᐃᓱᒪᓕᐅᕆᓂᖅ
decision	ᐃᓱᒪᒃᓴᖅᓯᐅᕐᓂᖅ
deck	ᒥᑎᖅ
decline	ᐅᓄᕈᓐᓃᖅᐸᓪᓕᐊᔪᑦ
decrease	ᐅᓄᕈᓐᓃᕆᐊᖅᑐᑦ
dedicated	ᐱᓕᕆᓪᓚᕆᒍᒪᔪᖅ
dedication	ᐱᓕᕆᓪᓚᕆᒍᒪᓂᖅ
deed	ᖃᓄᐃᓕᐅᕐᓂᖅ
deep	ᐃᑎᔪᖅ
deer	ᓴᓗᕋᖅᑐᖅ
default	ᐊᑮᑦᑐᐃᙱᓐᓂᖅ
defeat	ᓵᓚᑦ
defend	ᓴᐳᔾᔨᓂᖅ
define	ᓇᓗᓇᐃᕐᓗᒍ
definitely	ᐄᑦᑎᐊᒻᒪᕆᒃ
definition	ᑐᑭᖓ
degree	ᐊᓂᒍᐃᔾᔪᑎ
delay	ᑭᖑᕙᕆᐊᖅᓯᒪᔪᖅ
delayed	ᑭᖑᕙᕆᐊᖅᓯᒪᔪᖅ
delete	ᐲᔭᖅᑕᐅᔪᖅ
deliberate	ᐱᔮᕆᓪᓗᓂ
delicate	ᓴᒡᓗᔪᖅ
delicious	ᒪᒪᖅᑐᖅ
delight	ᖁᕕᐊᓱᒃᑐᖅ
delighted	ᖁᕕᐊᓱᑦᑐᖅ
deliver	ᑲᔪᓯᑎᑦᓯᓂᖅ
delivered	ᑲᔪᓯᑎᑕᐅᔪᖅ
delivery	ᑲᔪᓯᑎᑦᑎᓂᖅ
demand	ᑎᓕᓯᓂᖅ
demanding	ᐱᖁᔨᔪᖅ
democracy	ᓂᕈᐊᕐᕕᖃᕈᓐᓇᕐᓂᖅ
demon	ᑎᒪᓐ
demonstrate	ᑕᑯᒃᓴᐅᑎᑦᑎᓗᓂ
denied	ᐊᖏᙱᑦᑐᑦ
density	ᐅᓄᕐᓂᖏᑦ
dentist	ᑭᒍᑎᓕᕆᔨ
deny	ᐊᖏᖅᑐᖅ
department	ᐱᓕᕆᕝᕕᒃ
departure	ᐊᐅᓪᓚᕐᕕᒃᓴᖓ
depend	ᑐᕚᕆᔭᖃᕐᓂᖅ
deploy	ᐊᑐᖅᑎᑦᑎᓂᖅ
deposit	ᑮᓇᐅᔭᒃᑯᕕᖕᒨᖅᓯᓂᖅ
depressed	ᓂᑲᓪᓗᖓᓂᖅ
depression	ᓂᑲᓪᓗᖓᓂᖅ
depth	ᐃᑎᓂᖓ
describe	ᓇᓗᓇᐃᔭᕐᓗᒍ
description	ᐃᓗᓕᖏᑦ
desert	ᓰᕐᓇᖅᑐᖅ
deserve	ᐱᔭᕆᐊᓕᒃ
design	ᓴᓇᒪᓂᖓ
designation	ᑎᒃᑯᐊᖅᑕᐅᓯᒪᔪᖅ
desire	ᐱᔪᒪᓂᖃᕐᓂᖅ
desk	ᐊᓪᓚᕝᕕᒃ
despair	ᓴᐸᖓᔪᖅ
desperate	ᐊᒃᓱᕈᖅᑐᖅ
despite	ᐃᒪᐃᒃᑲᓗᐊᖅᑎᓪᓗᒍ
despite	ᖃᓄᐃᒃᑲᓗᐊᖅᑎᓪᓗᒍ
dessert	ᓰᕐᓇᖅᑐᑦ
destination	ᓇᒧᙵᕐᕕᒃ
destiny	ᑐᕌᓐᓂᕐᓴᖅ
destroy	ᓱᕋᒃᑎᖅᑕ
destruction	ᓱᕋᒃᑎᖅᑕᐅᔪᖅ
detail	ᐃᓗᓕᖏᑦ
details	ᐃᓗᓕᖏᑦ
detect	ᓇᓂᓯᔾᔪᑎ
determination	ᐱᔪᒪᓂᖃᕐᓂᖅ
determine	ᐱᔪᒪᓂᖅ
determine	ᐋᖅᑭᒃᓯᔪᒪᓂᖅ
determined	ᐱᔪᒪᓂᖃᓪᓚᕆᖕᓂᖅ
determined	ᓇᓗᓇᐃᖅᓯᔾᔪᑎᒪᔪᖅ
devastated	ᖁᐊᖅᓵᖅᑐᖅ
develop	ᐱᕙᓪᓕᐊᓂᖅ
develop	ᓴᖅᑭᑎᑦᑎᕙᓪᓕᐊᓂᖅ
developed	ᐋᖅᑭᒃᓱᖅᑕᐅᓯᒪᔪᖅ
development	ᐱᕙᓪᓕᐊᓂᖅ
development	ᓴᖅᑭᑎᑦᑎᓂᖅ
device	ᐅᖃᓘᑎᕋᓛᖅ
devil	ᓵᑖᓇᓯ
devoted	ᐱᓕᕆᓪᓚᕆᐊᓗᒃ
Dhivehi	ᑎᐊᐱ
diabetes	ᐊᐅᒃᑯᑦ ᓱᑲᖃᓗᐊᕐᓂᖅ
diarrhea	ᐊᕿᑦᑐᖅᓱᕐᓂᖅ
diary	ᐅᖃᓕᒫᒐᖅ
dictionary	ᐅᖃᐅᓰᑦ ᑐᑭᖏᑦ
did	ᑕᐃᒪᐃᓚᐅᖅᑐᖅ
die	ᑐᖁᓂᖅ
died	ᑐᖁᔪᖅ
diet	ᓂᕆᕙᒃᑕᑦ
difference	ᐊᔾᔨᒌᖏᓐᓂᖓ
different	ᐊᔾᔨᐅᙱᑦᑐᖅ
difficult	ᐊᔪᕐᓇᖅᑐᖅ
dig	ᖃᓗᕋᖅᑐᖅ
dignity	ᐱᑦᑎᐊᓕᓂᖅ
diligent	ᐱᓪᓚᕆᙱᑦᑐᖅ
dinner	ᐅᓐᓄᒍᒥᑕᕐᓇᖅ
dip	ᒥᓱᒃᑕᕐᓂᖅ
direct	ᑐᕋᐃᓐᓇᖅᑐᖅ
direction	ᓇᑭᙶᕐᓂᖓ
director	ᑐᑭᒧᐊᒃᑎᑦᑎᔨ
dirt	ᐃᑉᐸᒃ
dirty	ᓴᓗᒪᐃᑦᑐᖅ
dirty	ᐃᑉᐸᒃᑐᖅ
disable	ᑎᒥᒥᒍᑦ ᐊᔪᕈᑎᖃᙱᑦᑐᑦ
disabled	ᑎᒥᒥᒍᑦ ᐊᔪᕈᑎᓖᑦ
disappear	ᕿᐅᒃᑲᖓᔪᖅ
disappointed	ᐊᐃᑦᑖᕈᓱᒃᑐᖅ
disaster	ᐱᕐᓗᐊᕿᓂᖅ
discard	ᐃᒋᑕᒃᓴᖅ
discharge	ᑕᐃᒫᖅᑕᐅᔪᖅ
discipline	ᐃᓂᖅᑎᕆᓂᖅ
discount	ᐊᑭᑭᓪᓕᒋᐊᖅᑐᖅ
discover	ᓇᓂᔭᑦ
discrimination	ᐃᓚᐃᓐᓇᖅᓯᐅᕐᓂᖅ
discuss	ᐅᖃᖃᑎᒌᓐᓂᖅ
discussion	ᐅᖃᖃᑎᒌᖕᓂᖅ
disease	ᐋᓐᓂᐊᖅ
diseases	ᐋᓐᓂᐊᑦ
disguise	ᐊᐃᕙᓂᖅ
disgusting	ᐊᐃᕙᓂᖅ
dish	ᓂᕐᕆᓯ
dishes	ᓂᕐᕆᓯᑦ
dismiss	ᓄᖅᑲᖅᑎᑕᐅᓂᖅ
dispatch	ᐅᖂᑕᕐᓂᖅ
display	ᓴᖅᑭᔮᖅᑎᑕᐅᓂᖓ
disposal	ᐃᒋᑕᐅᓂᖅ
dispute	ᐊᖏᖃᑎᒌᙱᓐᓂᖅ
distance	ᐅᖓᓯᖕᓂᖓ
distinct	ᐊᔾᔨᐅᙱᓐᓂᖓ
distinguish	ᑕᑯᙶᖅᑐᖅ
distress	ᐊᒃᓱᕈᖅᑐᖅ
distribution	ᑐᓂᐅᖅᑲᐃᓂᖅ
district	ᐊᕕᑦᑐᖅᓯᒪᔪᑦ
disturb	ᐸᒡᕕᓇᖅᑐᖅ
ditch	ᒥᓱᒃᑕᕐᓂᖅ
dive	ᑭᓂᖅᑎᔪᖅ
diverse	ᐊᔾᔨᒌᙱᕈᓘᔭᖅᑐᑦ
diversity	ᐊᔾᔨᒌᙱᕈᓘᔭᖅᑐᑦ
divide	ᐊᒡᒍᕐᓗᒍ
divine	ᐃᓂᖁᓇᓪᓚᕆᒃᑐᖅ
divorce	ᐊᕕᑦᑎᓂᖅ
dizzy	ᐅᐃᔾᔭᙳᔪᖅ
do	ᐱᔭᒃᓴᖅ
do you	ᐃᒫᒃ ᐱᕙᑉᐱᑦ
do you love me	ᓇᓪᓕᒋᕕᙵ
doctor	ᓘᒃᑖᖅ
document	ᑎᑎᖅᑲᖅ
does	ᐃᒪᐃᓲᖅ
doesn't	ᐃᒪᐃᙱᑦᑐᖅ
dog	ᕿᒻᒥᖅ
Dogri	ᑐᖅᓲᑦ
doing	ᑕᐃᒪᐃᓕᐅᕐᓂᖅ
doll	ᕿᑐᕐᖓᐅᔭᖅ
domain	ᑑᕐᖓᐃᑦ
domestic	ᐊᖏᕐᕋᖅ
dominant	ᐱᓗᐊᖅᑐᖅ
don't	ᐃᒪᐃᓕᐅᖏᓪᓗᑎᑦ
Don't worry	ᐃᓱᒫᓗᙱᓪᓗᑎᑦ
donate	ᑐᓂᓯᓂᖅ
done	ᐱᐊᓂᒃᑐᖅ
done	ᐱᔭᕇᖅᑐᖅ
donkey	ᑑᑭ
dope	ᐄᔭᒐᖅ
double	ᒪᕐᕈᐃᖅᑕᕐᓗᒍ
doubt	ᐅᑉᐱᕈᓱᙱᑦᑐᖅ
dough	ᐊᕿᕐᕈᔪᐊᒃᓴᔭᖅ
down	ᐊᒻᒧᒋᐊᖅᑐᖅ
download	ᒥᓇᕆᓗᒍ
draft	ᑎᑎᕋᖅᑕᐅᕐᖓᖅᑐᖅ
drag	ᐃᐱᕋᖅᑐᖅ
drain	ᑯᕕᕝᕕᒃ
drama	ᐱᓪᓚᑦᑖᖅᑐᖅ
draw	ᑎᑎᖅᑐᕋᕐᓂᖅ
drawer	ᐊᒧᔭᖅᑐᖅ
drawing	ᑎᑎᖅᑐᒐᖅ
dread	ᕿᑦᑐᕆᐊᑦ
dream	ᓯᓐᓇᒃᑑᒪ
dress	ᐊᑕᔪᖅ
drill	ᑲᐃᕗᖅᑐᖅ
drink	ᐃᒥᕐᓗᑎᑦ
drive	ᐊᖁᓪᓗᓂ
drop	ᑲᑕᐃᔪᖅ
dropped	ᖁᔭᓈᖅᑕᐅᔪᖅ
drought	ᐸᓂᖅᑐᖅ
drunk	ᐋᖓᔮᖅᑐᖅ
dry	ᐸᓂᖅᑐᖅ
duck	ᒥᑎᖅ
dude	ᓄᑲᑉᐱᐊᕋᖅ
due	ᐊᑭᓕᖅᑕᐅᔭᕆᐊᖃᖅᑐᖅ
due to	ᐱᔾᔪᑎᒋᓗᒋᑦ
dull	ᐃᐲᒃᑐᖅ
dumb	ᑐᑭᖃᙱᑦᑐᖅ
dump	ᐊᒃᑕᕐᕕᒃ
duration	ᐊᑯᓂᐅᓂᖓ
during	ᐅᑯᓇᓂ
dust	ᐳᔪᕐᓗᒃ
duty	ᐱᓕᕆᐊᒃᓴᖏᑦ
dwell	ᐅᕕᓗ
dying	ᑐᖁᕙᓪᓕᐊᓂᖅ
each	ᐊᑐᓂ
each other	ᑖᒃᑯᐊ ᐊᑐᓂᒃ
eager	ᐱᔪᒪᔪᖅ
eagle	ᓇᒃᑐᕋᓕᒃ
ear	ᓯᐅᑦ
earlier	ᐅᐊᑦᑎᐊᓵᖅ
early	ᐱᒋᐊᖅᓵᓕᓂᖅ
earn	ᑮᓇᐅᔭᓕᐊᖅ
ears	ᓯᐅᑎᒃᑯᑦ
earth	ᓄᓇᕐᔪᐊᖅ
earthquake	ᓴᔪᒃᑐᖅ
ease	ᖃᓱᖓᓕᖅ
easily	ᐊᔪᕐᓇᙱᑦᑐᖅ
east	ᐅᐊᓐᓂᖅ
easy	ᐊᔪᕐᓇᙱᑦᑐᖅ
eat	ᓂᕆᓂᖅ
eating	ᓂᕆᓂᖅ
economic	ᒪᑭᒪᔾᔪᑎᒃᓴᑦ
economy	ᑮᓇᐅᔭᓕᐅᕈᑎᑦ
edge	ᓯᓈᖓ
edit	ᐋᖅᑭᒋᐊᖅᑕᐅᔪᖅ
education	ᐃᓕᓐᓂᐊᕐᓂᖅ
effect	ᐊᒃᑑᑎᔪᖅ
effective	ᐊᑑᑎᖃᑦᑎᐊᖅᑐᖅ
efficiency	ᐊᑐᕈᓐᓇᑦᑎᐊᕐᓂᖓ
efficient	ᐊᑑᑎᖃᑦᑎᐊᖅᑐᖅ
effort	ᐱᕚᓪᓕᕐᓂᖅ
egg	ᒪᓐᓂᒃ
eggplant	ᒪᓐᓂᒃᑕᖅ
ego	ᐃᒍ
eight	ᓯᑕᒪᐅᔪᕐᑐᑦ
eighteen	ᑕᓪᓕᒪᐅᔪᕐᑐᓗ ᓯᑕᒪᐅᔪᕐᑐᓗ
eighty	ᐊᕙᑏᑦ ᓯᑕᒪᐅᔪᕐᑐᑦ
either	ᓇᓕᐊᑐᐃᓐᓇᖅ
elaborate	ᐅᖃᐅᓯᕆᒋᐊᒃᑲᓐᓂᕐᓗᒍ
elbow	ᐃᑯᓯᒃ
elder	ᐃᓐᓇᖅ
elderly	ᐃᓐᓇᕐᓂᒃ
elegant	ᑭᒡᒐᖅᑐᐃᔪᖅ
element	ᐃᓗᓕᖏᑦ
elephant	ᐃᓕᕕᓐᑦ
eleven	ᑕᓪᓕᒪᐅᔪᕐᑐᓗ ᐊᑕᐅᓯᕐᓗ
eligible	ᐊᔪᙱᑦᑐᑦ
eliminate	ᐲᕐᓗᒍ
else	ᐊᓯᐊ
embarrassed	ᑲᙳᑦᑎᓯᒪᔪᖅ
embarrassing	ᑲᙳᑦᑎᓂᖅ
embrace	ᐃᕿᓯᓯᒪᒋᑦ
emerge	ᓴᖅᑭᑉᐸᓪᓕᐊᔪᖅ
emergency	ᑐᐊᕕᕐᓇᖅᑐᖅ
emotional	ᕿᓕᕐᓛᖅᑐᖅ
empathy	ᓇᒡᓕᒍᓱᖕᓂᖅ
emphasis	ᐱᔾᔪᑎᒋᓪᓗᐊᑕᖅᑕᖓ
emphasize	ᐅᔾᔨᕆᑦᑎᐊᕐᓗᒍ
employee	ᐃᖅᑲᓇᐃᔭᖅᑎ
employees	ᐃᖅᑲᓇᐃᔭᖅᑏᑦ
employer	ᐃᖅᑲᓇᐃᔭᕐᕕᒃ
employment	ᐃᖅᑲᓇᐃᔮᖃᕐᓂᖅ
empty	ᐃᓗᓕᖃᖏᑦᑐᖅ
enable	ᐱᔪᓐᓇᖅᑎᑦᑎᓂᖅ
encounter	ᐊᐴᑎᓂᖅ
encourage	ᑎᓕᐅᕆᓂᖅ
end	ᐃᓱᐊ
endangered	ᓄᖑᕈᑎᓯᒪᔪᑦ
endeavor	ᐱᓇᓱᐊᕐᓂᖅ
endurance	ᐊᑐᕈᓐᓇᐃᓪᓕᓂᖅ
endure	ᐊᑐᕐᓂᖓ
enemy	ᐱᙱᙳᐊᖅᑐᖅ
energy	ᐆᒻᒪᖅᑯᑎ
engage	ᐃᓚᐅᓂᖅ
engaged	ᐃᓚᐅᔪᖅ
engagement	ᐃᓚᐅᑎᑦᑎᓂᖅ
engine	ᐊᐅᓚᐅᑎᑦ
engineer	ᓴᓇᔨᒻᒪᕆᒃ
English	ᖃᓪᓗᓈᖅ
enhance	ᐱᐅᓯᒋᐊᖅᑎᑦᑎᓂᖅ
enhance	ᐱᕚᓪᓕᕐᓂᖅ
enjoy	ᖁᕕᐊᓱᒃᑐᖅ
enjoy	ᐊᓕᐊᓇᐃᒍᓱᒃᑐᖅ
enormous	ᓯᑎᔪᖅ
enough	ᐅᓄᖅᑐᖅ
enough	ᓈᒻᓴᒃᓯᔪᖅ
ensure	ᖃᐅᔨᒪᒋᐊᕐᓗᑎᑦ
enter	ᐃᓯᕐᓂᖅ
entertainment	ᖁᙱᐊᖅᑎᑦᑎᓂᖅ
enthusiasm	ᐱᔪᒃᓯᓂᖅ
enthusiastic	ᐱᔪᒪᓂᖃᑦᑎᐊᖅᑐᖅ
entire	ᐊᑕᖐᔪᖅ
entitled	ᐊᑎᖃᖅᑐᖅ
entity	ᑎᒥᐅᔪᖅ
entrance	ᑐᖅᓲᒃ
entrepreneur	ᓇᒻᒥᓂᖃᖅᑎ
envelope	ᐴᒃᓴᐅᑦ
environment	ᐊᕙᑎᓕᕆᔨᒃᑯᑦ
envy	ᑐᓱᒃᑐᖅ
epic	ᐊᔾᔨᙳᐊᓕᒃ
epidemic	ᐊᐃᑦᑐᐃᓐᓇᖅᑐᒥᒃ ᐊᐃᑦᑐᐃᓐᓇᖅᑐᒥᒃ
equal	ᓇᓕᒧᒃᓲᑎᔪᖅ
equipment	ᓱᓇᒃᑯᑖᖅ
equity	ᓇᖕᒥᓂᖁᑎᖃᖅᑎᐅᑉ
equivalent	ᐊᔾᔨᒐᓚᖓ
eraser	ᑎᕆᖅᓴᖅᑐᖅ
error	ᑕᒻᒪᖅᑐᖅ
escape	ᕿᒪᕉᑎᓂᖅ
especially	ᐱᓗᐊᖅᑐᒥᑦ
essay	ᑎᑎᕋᖅᓯᒪᔪᑦ
essence	ᐱᙱᔅᓱᖅᑐᖅ
essential	ᐱᔭᕆᐊᖃᓪᓚᕆᑦᑐᖅ
establish	ᐋᖅᑭᒃᓯᓗᑎᒃ
established	ᐋᖅᑭᒃᑕᐅᓚᐅᖅᓯᒪᔪᖅ
estate	ᕿᒻᒪᑯᒋᔭᐅᑯ
estimate	ᓇᓚᐅᑖᖅᑕᐅᔪᖅ
estimated	ᓇᓚᐅᑦᑖᖅᑕᐅᔪᖅ
etc	ᐊᓯᖏᓪᓗ
eternal	ᐃᖅᑭᓕᒃ
ethics	ᐱᑦᑎᐊᕆᐊᖃᕐᓂᕐᒧᑦ
evaluate	ᖃᐅᔨᓴᕐᓂᖅ
evaluation	ᖃᐅᔨᓴᖅᑕᐅᓂᖓ
even	ᐊᔾᔨᒌᒃᑐᑦ
even though	ᐃᒪᐃᒃᑲᓗᐊᖅᑎᓪᓗᒍ
evening	ᐅᓐᓄᒃᓴᖅ
event	ᐱᓕᕆᐊᖑᔪᖅ
eventually	ᐊᓱᐃᓪᓛᓗᒃ
ever	ᑕᐃᒪᐃᓚᐅᖅᓯᒪᙱᑦᑐᖅ
every	ᑕᒪᐃᓐᓂᒃ
everybody	ᑭᒃᑯᓕᒫᑦ
everyone	ᑭᒃᑯᓕᒫᑦ
everything	ᑭᓱᓕᒫᑦ
evidence	ᖃᐅᔨᔾᔪᑕᐅᔪᓐᓇᖅᑐᑦ
evil	ᕕᐅᓪ
evolution	ᐊᓯᔾᔨᖅᐸᓪᓕᐊᓂᖅ
evolve	ᐊᓯᔾᔨᖅᑐᖅ
Ewe	ᐃᕗ
ex	ᓇᕿᒃᑲᓐᓂᕐᓗᒍ
exact	ᑕᐃᒪᐃᓪᓚᑦᑖᖅᑐᖅ
exactly	ᐄᑦᑎᐊᒻᒪᕆᐊᓗᒃ
exam	ᖃᐅᔨᓴᖅᑕᐅᓂᖅ
examine	ᖃᐅᔨᓴᕐᓗᒍ
example	ᐆᒃᑑᑎᒋᓗᒍ
exceed	ᖄᖏᐅᑎᔪᖅ
excellent	ᐱᐅᔪᒻᒪᕆᐊᓗᒃ
except	ᑭᓯᐊᓂ
exception	ᑭᑭᑕᐅᔪᑦ
excess	ᐅᖓᑖᓄᑦ
excessive	ᐅᖓᑕᐅᔾᔨᔪᖅ
exchange	ᑕᐅᖅᓰᓂᖅ
excited	ᖁᕕᐊᓱᑦᑎᐊᖅᐳᖓ
excitement	ᖁᕕᐊᓱᑦᑐᖅ
exciting	ᖁᕕᐊᓇᑦᑎᐊᖅᑐᖅ
exclusive	ᑖᓐᓇᑐᐊᖑᓪᓗᓂ
excuse	ᐱᙱᔾᔪᑎ
excuse me	ᒪᒥᐊᓇᖅ
execute	ᐊᑐᓕᖅᑎᑕᐅᓂᖓ
execution	ᐊᑐᓕᖅᑎᑕᐅᓂᖓ
executive	ᓯᕗᓕᖅᑎ
exercise	ᐃᖃᐃᓕᓴᕐᓂᖅ
exhaust	ᐊᓇᕈᓱᒃᑐᖅ
exhausted	ᑕᖃᓯᒪᔪᖅ
exhibit	ᑕᑯᒃᓴᐅᑎᑦᑎᓂᖅ
exhibition	ᑕᑯᒃᓴᐅᑎᑦᑎᓂᖅ
exist	ᐱᑕᖃᖅᑐᖅ
existence	ᐱᑕᖃᕐᓂᖓ
existing	ᐱᑕᖃᕇᖅᑐᑦ
exit	ᐊᓂᕝᕕᒃ
expand	ᐊᖏᒡᓕᒋᐊᕐᓗᒍ
expect	ᓂᕆᐅᒋᔭᖅ
expected	ᓂᕆᐅᒋᔭᐅᔪᖅ
expenses	ᐊᑭᓕᖅᓱᕆᐊᓖᑦ
expensive	ᐊᑭᑐᔪᖅ
experience	ᖃᐅᔨᒪᔪᖅ
experience	ᐃᓕᓯᒪᔪᖅ
experiment	ᐆᒃᑐᕋᕐᓂᖅ
expert	ᖃᐅᔨᒪᔨᑕᒻᒪᕆᒃ
expired	ᐃᓱᓕᕝᕕᐊ
explain	ᓇᓗᓇᐃᔭᕐᓗᒍ
explanation	ᓇᓗᓇᐃᔭᐅᑎ
exploit	ᖄᖅᑕᔫᖅ
explore	ᕿᒥᕐᕈᓂᖅ
export	ᑲᓇᑕᐅᑉ ᓯᓚᑖᓄᑦ
expose	ᓴᖅᑭᔮᖅᑐᖅ
exposed	ᓴᖅᑭᔮᖅᑐᖅ
exposure	ᓴᖅᑭᔮᕐᕕᐅᓂᖅ
express	ᐅᖃᐅᓯᕆᓗᒍ
expression	ᐅᖃᐅᓯᖃᕐᓂᖅ
extend	ᐅᖓᕙᕆᐊᖅᓯᓂᖅ
extended	ᐅᐃᒍᒋᐊᖅᑕᖅ
extension	ᐅᖓᕙᕆᐊᖅᓯᓂᖅ
extent	ᐊᖏᑎᒋᔪᖅ
external	ᓯᓚᑖᓂᙶᖅᑐᑦ
extinct	ᓄᖑᑦᑐᖅ
extra	ᐃᓚᒃᑲᓐᓂᖓ
extract	ᐲᖅᓯᓂᖅ
extraordinary	ᑕᑯᖅᑭᒃᓯᒪᔪᖅ
extreme	ᐱᕐᔪᐊᖅᑐᖅ
extremely	ᐱᓗᐊᖅᑐᖅ
eye	ᐃᔨ
eyes	ᐃᔩᒃ
fabric	ᖃᓪᓗᓈᖅᑕᖅ
fabulous	ᑲᖐᓇᖅᑐᖅ
face	ᑮᓇᖅ
facilitate	ᐊᐅᓚᑦᑎᔪᖅ
facilities	ᐃᓂᒋᔭᐅᔪᑦ
facility	ᐱᔨᑦᑎᕐᕕᒃ
fact	ᓱᓕᔪᖅ
factor	ᐱᔾᔪᑎᖓ
factory	ᐱᔾᔪᑕᐅᔪᖅ
facts	ᓱᓕᔪᑦ
fade	ᐸᓚᐅᒑᖅ
fail	ᐊᔪᖅᑐᖅ
failed	ᑲᔪᓯᙲᓐᓇᖅᑐᖅ
failure	ᐊᔪᓕᖅᑐᑦ
faint	ᓯᖒᔭᖅᑐᖅ
fair	ᓈᒻᒪᑐᖅ
fair	ᐊᔾᔨᒌᒃᑎᑦᑎᓂᖅ
fairly	ᐊᔾᔨᒌᒃᑎᑦᑎᔪᖅ
fairy	ᐊᔾᔨᒌᒃᑎᑦᑎᓂᖅ
faith	ᐅᒃᐱᕐᓂᖅ
faithful	ᐅᒃᐱᕐᓇᑦᑎᐊᖅᑐᖅ
fake	ᐆᔪᖕᓂᖅ
fall	ᐅᑭᐊᒃᓵᖅ
fall	ᐃᓐᓇᖅᑐᖅ
false	ᓱᓕᙱᑦᑐᖅ
fame	ᐅᖃᐅᓯᕆᔭᐅᔪᖅ
familiar	ᓱᖏᐅᙵᔪᖅ
family	ᐃᓚᒌᑦ
famine	ᓴᙲᓐᓇᖅᑐᖅ
famous	ᖃᐅᔨᒪᔭᐅᔪᖅ
fan	ᐊᒡᒐᒃᑯᑦ ᓂᓪᓕᓇᕈᑎ
fancy	ᐱᐅᒃᓴᖅᑐᖅ
fantastic	ᖁᕕᐊᓇᖅᑐᖅ
far	ᐅᖓᓯᒃᑐᖅ
farewell	ᑕᕝᕙᐅᕗᑏᖅᑐᖅ
farm	ᐱᕈᖅᓰᕕᒃ
farmer	ᐱᕈᖅᓰᔨ
fascinating	ᐱᐅᒃᓴᕐᓂᖅ
fashion	ᐊᓐᓄᕌᑦ
fast	ᓱᒃᑲᔪᖅ
fat	ᐅᖅᓱᖅ
fatal	ᐃᓅᔪᓐᓃᕈᑕᐅᔪᑦ
fate	ᓂᕆᔪᖅ
father	ᐊᑖᑕᒃ
fatigue	ᑕᖃᖓᓗᓂ
fault	ᐱᒃᑲᖅᑎ
favorite	ᒪᒪᕆᓛᕆᔭᕋ
favour	ᓈᒻᒪᓴᖅᑐᑦ
favourite	ᒪᒪᕆᓛᖓ
fear	ᑲᑉᐱᐊᓱᓐᓂᖅ
feast	ᓂᕆᕕᒡᔪᐊᖅᑐᑦ
feather	ᓱᓗᖓ
feature	ᓴᖅᑭᔮᖅᑐᑦ
features	ᑕᑯᓐᓇᕐᓂᖏᑦ
february	ᐊᕗᓐᓂᕕᒃ
february	ᕕᕗᐊᕆ
fed up	ᓂᕆᔪᖅ
fee	ᐊᑭᓕᒐᒃᓵᕐᔪᑦ
feed	ᓂᕆᑎᑦᑎᓂᖅ
feedback	ᐅᖃᐅᓯᐅᔪᑦ
feel	ᐃᒃᐱᒋᔪᖅ
feeling	ᐃᒃᐱᖕᓂᖅ
feet	ᐃᓯᒐᐃᑦ
fell	ᐅᕐᕈᔪᖅ
fellow	ᐊᓗᒃᑲᖅ
felt	ᐃᒃᐱᒃᓯᒪ
female	ᐊᕐᓇᖅ
fence	ᐊᕙᓗᐊᕈᑕᖅ
fertile	ᐃᒍᓇᖅ
festival	ᖁᕕᐊᓱᖃᑎᒌᖕᓂᖅ
fetch	ᐊᓇᖅ
fever	ᐆᑎᕐᓇᕐᓗᓂ
few	ᐊᒥᓲᙱᑦᑐᑦ
few	ᐅᓄᙱᑦᑐᑦ
fewer	ᐅᓄᙱᓐᓂᖅᓴᐃᑦ
fiance	ᓱᓕᙱᓐᓂᖅ
fiction	ᓱᓕᓂᖏᔾᔪᑎ
field	ᐱᓕᕆᕝᕕᒃ
fierce	ᓴᙱᔪᖅ
fifteen	ᑕᓪᓕᒪᐅᔪᕐᑐᓗ ᑕᓪᓕᒪᓪᓗ
fifty	ᐊᕙᑏᑦ ᑕᓪᓕᒪᑦ
fight	ᐅᓇᑕᕐᓂᖅ
fighting	ᐅᓇᑕᕐᓂᖅ
figure	ᓈᓴᐅᑎᖓ
figure out	ᖃᐅᔨᓗᑎᑦ
file	ᑐᖅᑯᖅᓯᒪᔪᖅ
fill	ᐃᓗᓪᓕᖅᓱᕐᓗᒍ
filled	ᐃᓄᖃᓕᖅᑐᑦ
film	ᑕᕐᕆᔮᒃᓴᖅ
filthy	ᓴᓗᒻᒪᒃᓯᒪᔪᖅ
finally	ᑭᖑᓪᓕᖅᐹᒥ
finance	ᑮᓇᐅᔭᓕᕆᓂᖅ
financial	ᑮᓇᐅᔭᓕᕆᓂᖅ
find	ᓇᓂᓯᓗᑎᑦ
find out	ᖃᐅᔨᔪᖅ
fine	ᖃᓄᐃᙱᑦᑐᖅ
fine	ᐊᑭᔨᐅᑎᒃᓴᖅ
finger	ᐃᓄᒐᙳᐊᑦ
finish	ᐱᐊᓂᒡᕕᖓ
finished	ᐱᔭᕇᖅᓯᒪᔪᖅ
fire	ᐃᑭᑦᑐᖅ
firm	ᑎᒥᐅᔪᖅ
first	ᓯᕗᓪᓕᖅ
first name	ᓯᕗᓪᓕᖅ ᐊᑎᖅ
fish	ᐃᖃᓗᒃ
fit	ᓈᒻᒪᒋᔭᑦ
five	ᑕᓪᓕᒪᑦ
fix	ᐋᖅᑭᒃᑕᐅᔪᖅ
fixed	ᐋᖅᑭᒃᓯᒪᔪᖅ
flag	ᓴᐃᒻᒪᑎ
flash	ᖃᐅᒻᒪᒃᑕ
flat	ᒪᓂᓚᔪᖅ
flat	ᓵᑦᑐᖅ
flaw	ᓴᒡᓗᔪᖅ
flawless	ᓴᙲᑦᑐᖅ
flee	ᓇᓪᓚᔪᖅ
flesh	ᓂᖀᑦ
flew	ᖃᖓᑕᔪᖅ
flex	ᐊᓯᔾᔨᖅᑐᖅ
flexible	ᐊᓯᔾᔨᒐᒃᓴᐅᔪᖅ
flight	ᖃᖓᑕᓂᖅ
flip	ᑎᑎᕋᕐᕕᒃᓴᕐᔪᐊᖅ
flirt	ᕐᑳᖅᑐᖅ
flirting	ᐳᕕᓕᕐᓂᖅ
float	ᐳᒃᑕᓛᕐᓂᖅ
flood	ᐃᒻᒪᖅᑐᖅ
floor	ᓇᑎᖅ
flour	ᐸᓚᐅᒑᒃᓴᖅ
flow	ᑰᓐᓂᖓ
flower	ᐱᕈᖅᓯᐊᖅ
flu	ᓴᐅᓂᙳᓇᖅ
fluent	ᐅᖃᕈᓐᓇᑦᑎᐊᕐᓂᖅ
fluently	ᐅᖃᕈᓐᓇᑦᑎᐊᖅᑐᖅ
fluffy	ᓂᐊᖀᑦ
fluid	ᐃᒪᖓ
fly	ᖃᖓᑕᔪᖅ
focus	ᑐᕌᒐᖅ
fog	ᐃᓯᕕᖓ
foggy	ᑕᒃᓯᖅᑐᖅ
fold	ᐱᕆᓯᒪᑎᓪᓗᒍ
folks	ᐃᓄᐃᑦ
follow	ᒪᓕᒡᓗᒍ
follow up	ᖃᐅᔨᒋᐊᒃᑲᓐᓂᕐᓂᖅ
following	ᒪᓕᒃᑐᖅ
food	ᓂᖀᑦ
fool	ᓂᐸᖓᔪᖅ
foolish	ᑐᑭᖃᙱᑦᑐᖅ
foot	ᐃᓯᒐᑦ
football	ᐊᖅᓴᖅ
for	−ᒧᑦ
for	−ᑯᖓ
For example	ᓲᕐᓗ ᐃᒪᓐᓇ
for instance	ᓲᕐᓗ
for you	ᐃᓕᓐᓄᑦ
forbidden	ᐃᔨᖅᓯᒪᔪᖅ
force	ᑎᓕᐅᕆᓂᖅ
forecast	ᓇᓚᐅᑦᑖᕆᔭᐅᔪᖅ
forehead	ᖃᐅᖅ
foreign	ᑲᓇᑕᐅᑉ ᓯᓚᑖᓂᙶᖅᑐᖅ
forest	ᓇᐹᖅᑐᖅ
forever	ᐃᓱᖃᙱᑦᑐᒧᑦ
forget	ᐳᐃᒍᖅᑐᖅ
forgive	ᐃᓱᒪᒋᔪᓐᓇᐃᖅᑕᐅᔪᖅ
forgot	ᐳᐃᒍᖅᑐᖅ
fork	ᑲᑭᐊᒃ
form	ᑕᑕᑎᕆᐊᓕᒃ
formal	ᐱᓪᓚᑦᑖᕌᓘᑉ
former	ᑭᖑᓂᑦᑎᐊᖓᓂ
fortunately	ᖁᕕᐊᓇᖅᑐᖅ
fortune	ᓇᓚᐅᑦᑖᕈᑦ
forty	ᐊᕙᑏᑦ ᓯᑕᒪᑦ
forty-two	ᓯᑕᒪᒃ ᐊᒡᒐᐃᑦ ᒪᕐᕉᒡᓗ
forward	ᓯᕗᒻᒧᑦ
foster	ᑎᒍᐊᙳᐊᖅ
fought	ᐅᓇᑕᖅᓯᒪᔪᑦ
found	ᓇᓂᔭᑦ
foundation	ᑐᙵᕕᖓ
four	ᓯᑕᒪᑦ
fourteen	ᑕᓪᓕᒪᐅᔪᕐᑐᓗ ᓯᑕᒪᓪᓗ
fox	ᑎᕆᒐᓂᐊᖅ
fragile	ᑲᑉᐱᐊᓱᖕᓂᖅ
frame	ᐊᕙᓗ
framework	ᐋᖅᑭᒃᓯᒪᓂᖓ
fraud	ᐱᕋᔭᖕᓂᖅ
freak	ᐃᒍᓇᖅ
free	ᐊᑭᖃᙱᑦᑐᖅ
freedom	ᐃᓱᒪᖅᓱᕐᓂᖅ
freeze	ᖁᐊᕐᓂᖅ
frequency	ᐊᑯᓚᐃᑦᑕᕐᓂᖓ
frequent	ᐱᒐᔪᒃᑕᖓ
frequently	ᐊᑐᒐᔪᒃᓗᓂ
fresh	ᓄᑖᖅ
friday	ᓂᕿᑦᓯᑐᑦ
fridge	ᓂᒡᓕᓇᖅᑐᒃᑯᕕᒃ
friend	ᐃᓚᓐᓈᖅ
friendly	ᐱᖃᓐᓇᖅᑐᖅ
friends	ᐱᖃᓐᓇᕆᔭᑦ
friendship	ᐱᖃᓐᓇᕇᖕᓂᖅ
frightened	ᑲᑉᐱᐊᓱᒃᑐᖅ
frightening	ᑲᕐᔨᔪᖅ
frog	ᖁᐊᖅᑐᖅ
from	ᓇᑭᙶᖅᑐᖅ
from	ᓇᑭᙶᕐᓂᖓ
from	ᐃᑲᙵᑦ
front	ᓯᕗᓂᐊᓃᑦᑐᑦ
frozen	ᖁᐊᖅ
fruit	ᓰᕐᓇᖅᑐᑦ
frustrated	ᐊᑲᐅᒃᓴᙱᓐᓂᖅ
fuel	ᐅᖅᓱᐊᓗᒃ
Fulfulde	ᓂᑲᒍᓱᒃᑐᖅ
full	ᐊᑕᖐᔪᖅ
fun	ᖁᕕᓇᖅᑐᖅ
function	ᐊᐅᓚᓂᖅ
fundamental	ᐊᑐᓪᓗᐊᑕᖅᑐᖅ
funeral	ᐃᓗᕕᖅᓯᓂᖅ
funny	ᐃᔪᕐᓇᖅᑐᖅ
fur	ᒥᖅᑯᓕᒃ
furious	ᒥᖅᑯᓕᒃ
furniture	ᐃᒡᓗᒥᓯᐅᑎᑦ
further	ᐅᖓᓯᓐᓂᖅᓴᖅ
further	ᓱᓕᒃᑲᓐᓂᖅ
furthermore	ᓱᓕᒃᑲᓐᓂᖅ
future	ᓯᕗᓂᒃᓴᒥ
gain	ᐱᕚᓪᓕᕐᓂᖅ
game	ᐱᙳᐊᖅ
gap	ᐱᑕᖃᙱᓐᓂᐅᔪᖅ
garage	ᓄᓇᓯᐅᑎᖃᕐᕕᒃ
garbage	ᐊᒃᑕᑯᑦ
garden	ᒍᕇᑕᓐ
garlic	ᒑᓕᒃ
gate	ᓂᐸᖓ
gather	ᑲᑎᓐᓂᖅ
gathering	ᑲᑎᓐᓂᖅ
gauge	ᖃᐅᔨᓇᐅᑦ
gave	ᑐᓂᓯᔪᖅ
gear	ᐊᓐᓄᕌᑦ
gender	ᐊᕐᓇᐅᖕᒪᖔᑦ ᐊᖑᑕᐅᖕᒪᖔ
general	ᑭᓱᑐᐃᓐᓇᑦ
generally	ᐃᒪᓐᓇᐅᒐᔪᒃᑐᖅ
generate	ᐊᐅᓚᔾᔭᒋᐊᖅᑐᖅ
generation	ᐆᒻᒪᖅᑯᓯᐅᕐᓂᖓ
generous	ᐃᑲᔪᕈᒪᓂᖅ
genius	ᓯᕗᓕᕕᓂᕗᑦ
genre	ᓇᑭᙶᖅᑐᖅ
gentle	ᓯᕐᓚᔪᖅ
genuine	ᔨᓄᐃᓐ
gesture	ᑎᒥᒃᑯᑦ ᐅᖃᕈᓯᖅ
get	ᐱᒍᒃ
get dressed	ᐊᓐᓄᕌᕆᑦ
get up	ᒪᑭᒋᑦ
get well soon	ᐋᕐᕿᓴᐅᑎᖁᓇᕐᐳᑎᑦ
getting	ᐱᓂᖅ
ghost	ᑑᕐᖓᖅ
ghosting	ᑲᑉᐱᐊᓵᕆᓂᖅ
giant	ᐃᓄᒃᐸᓱᒡᔪᖅ
gift	ᑐᓐᓂᖅᑯᓯᐊᖅ
ginger	ᔨᓐᔨ
girl	ᐊᕐᓇᖅ
girlfriend	ᐱᖃᓐᓈᕇᒃ
give	ᑐᓂᓯᔪᖅ
give up	ᓴᐱᓕᕐᓂᖅ
given	ᓇᒃᓯᐅᔾᔭᖅ
glad	ᖁᕕᐊᓇᖅ
glance	ᑕᐅᑐᒡᓗᒍ
glass	ᐃᒥᐅᑦ
glasses	ᐃᒡᒑᒃ
glimpse	ᑕᑯᙳᐊᕐᓂᖅ
global	ᓄᓇᕐᔪᐊᖅ
gloomy	ᓂᐱᓗᒃᑐᖅ
gloves	ᐊᒡᒑᒃ
glow	ᖃᐅᒪᓂᖅ
glow up	ᖁᖅᓱᖅᑕᖅ
glue	ᓂᐱᑎᕈᑦ
go	ᐊᑏ
go	ᐊᐅᓪᓚᖅ
go ahead	ᐊᑏ
go away	ᑕᒫᓂᖕᖏᓚᐅᕆᑦ
go to bed	ᐅᓯᕐᑎᓕᕆᑦ
goal	ᑐᕌᒐᖅ
goals	ᑐᕌᒐᐃᑦ
goat	ᒑᑦ
god	ᒎᑎ
god bless you	ᑯᑎᐅᑉ ᓭᒻᒪᑎᓕᑎᑦ
goes	ᖁᔭᓐᓇᒦᒃ
going	ᐃᖏᕐᕋᐃᓐᓇᖅᑐᖅ
going to	ᐅᕗᙵᐅᔪᖅ
gold	ᒎᓗ
gone	ᐱᑕᖃᕈᓐᓃᖅᑐᖅ
gonna	ᐅᕗᙵᐅᔪᖅ
goo	ᒎᒎ
good	ᒪᐃᑦᑎᐊᖅ
good	ᒪᐃᑦᓯᐊᖅ
good	ᐱᐅᔪᖅ
good afternoon	ᐅᓪᓗᓯᐅᑦᑎᐊᕆᑦ
good bye	ᖃᖓᑦᑕᐅᖅ
good day	ᐅᓪᓗᒃᑯᑦ
good evening	ᐅᓐᓄᖃᑦᑎᐊᕐᓂᖅ
good job	ᐱᑦᓯᐊᐳᑎᑦ
good looking	ᐱᐅᔪᒻᒪᕆᒃ
good luck	ᑲᔪᓯᑦᑎᐊᖁᕙᒋᑦ
good morning	ᐅᑉᓛᒃᑯᑦ
good morning	ᐅᓪᓛᒃᑯᑦ
good morning my love	ᐅᓪᓛᒃᑯᑦ ᓇᒡᓕᒋᔭᕋ
good night	ᐅᓐᓄᖃᑦᑎᐊᕐᓂᖅ
goodbye	ᐊᑦᓱᓀ
goodnight	ᐅᓐᓄᑦᑎᐊᕙᒃᑯᑦ
goods	ᐱᖁᑎᑦ
Google	ᒍᒍᓪ
Google Translate	Google ᑐᑭᓕᐅᕆᓂᖅ
goose	ᓂᕐᓕᖅ
gorgeous	ᐱᐅᔪᒻᒪᕆᐊᓗᒃ
gorgeous	ᐃᓂᖁᓇᑦᑎᐊᖅᑐᖅ
gossip	ᐊᐅᑉ ᓯᖒᑉ
got	ᐱᖃᖅᑐᖅ
got it	ᐱᕙᕋ
government	ᒐᕙᒪᑐᖃᒃᑯᑦ
grab	ᑎᒍᒻᒥᕕᒃ
grade	ᖁᕝᕙᓯᓐᓂᖓ
gradually	ᓱᒃᑲᐃᑦᑐᒥᒃ
graduate	ᐊᓂᒍᐃᔪᖅ
grain	ᐸᓚᐅᒑᒃᓴᔭᖅ
grant	ᐊᐃᑦᑑᑎᑦ
granted	ᑐᓂᔭᐅᔪᑦ
grapes	ᐸᓚᐅᒑᒃᓴᔭᐃᑦ
grasp	ᐸᓚᐅᒑᖅ
grass	ᐃᕕᒃᓱᒐᖅ
grateful	ᖁᔭᓕᓂᖅ
gratitude	ᖁᔭᓕᓂᖅ
grave	ᐃᓗᕕᖅ
gray	ᕿᕐᓂᓱᒃᑐᖅ
great	ᐅᓄᖅᑐᖅ
great	ᐊᖏᔪᖅ
greed	ᓯᕐᓈᖅᑎ
greedy	ᑭᓯᒻᖏᐅᕐᓂᖅ
green	ᑐᖑᔪᕈᔪᒃᑐᖅ
greet	ᑐᙵᓱᒃᑎᑦᑎᓂᖅ
greeting	ᑐᙵᓱᒃᑎᑦᑎᓂᖅ
greetings	ᑐᙵᓱᒃᑎᑦᑎᓂᖅ
grey	ᓯᐊᕐᓇᖅ
grid	ᐅᐊᔭᑯᑖᑦ
grief	ᕿᒃᓵᒃᑐᖅ
grind	ᓯᖃᖅᑎᕈᑦ
grip	ᑎᒍᓯᓂᖅ
grocery	ᓂᖀᑦ
groom	ᐊᕐᓇᖅ
gross	ᑲᑎᖦᖢᒋᑦ
ground	ᒪᓂᕋᖅ
group	ᑲᑎᙵᔪᓄᑦ
grow	ᐱᕈᕐᓗᑎᑦ
growth	ᐱᕈᖅᐸᓪᓕᐊᓂᖅ
grumpy	ᓂᖓᓱᒃᑐᖅ
Guarani	ᒍᐊᕐᓂ
guarantee	ᓱᓕᓂᐊᕐᓂᕋᕈᑎ
guard	ᐅᐊᔅᓯᔨ
guess	ᓇᓚᐅᑦᑖᖅᑐᖅ
guest	ᖃᐃᖁᔭᐅᓯᒪᔪᖅ
guidance	ᐊᔪᕆᖅᓯᐅᔾᔨᓂᖅ
guide	ᖃᐅᔨᒪᔾᔪᑎ
guilty	ᐸᓯᔭᒃᓴᖅ
guy	ᐊᖑᑦ
guys	ᐊᖑᑏᑦ
gym	ᐃᖃᐃᓕᓴᕐᕕᒃ
habit	ᐅᐃᕆᓯᒪᓂᖅ
habitat	ᓇᔪᖅᐸᒃᑕᖏᑦ
had	−ᒋᐊᖃᓚᐅᖅᑐᖅ
hail	ᑲᖏᖅᓴᐅᔭᖅ
hair	ᓄᔭᑦ
half	ᓇᑉᐸᖅ
hall	ᐱᙳᐊᕐᕕᒃ
hand	ᐊᒡᒐᑦ
handle	ᑲᒪᓂᖅ
handsome	ᐃᓂᖁᓇᖅᑐᖅ ᐊᖑᑦ
hang	ᓂᕕᖓᔪᖅ
hang out	ᑲᑎᙵᖃᑎᖃᖅ
happen	ᐊᑐᖅᑐᖅ
happened	ᖃᓄᐃᑦᑐᖃᓚᐅᖅᑐᖅ
happiness	ᖁᕕᐊᓱᖕᓂᖅ
happy	ᖁᕕᐊᓱᒃᑐᖅ
happy birthday	ᐃᓅᓕᕐᓯᕝᕕᐅᑦᓯᐊᕆᑦ
happy birthday to you	ᓇᓪᓕᐅᑎᑦᑎᐊᖁᕙᒋᑦ
happy new year	ᐊᕐᕌᒍᕐᕕᒃ ᓄᑖᖅ
hard	ᑎᓯᔪᖅ
hardly	ᐱᒡᒐᖅᑐᖅ
hardly ever	ᐊᑐᒐᔪᙱᑦᑐᒻᒪᕆᐊᓗᒃ
harm	ᐋᓐᓂᖅᑐᖅ
harmful	ᐅᓗᕆᐊᓇᖅᑐᖅ
harmony	ᐃᓅᖃᑎᒌᑦᑎᐊᕐᓂᖅ
harsh	ᐃᒃᑮᖅᑐᖅ
harvest	ᐊᖑᓇᓱᒃᑕᑦ
has	ᐱᖃᖅᑐᖅ
has	ᐱᓯᒪᔪᖅ
hate	ᖀᒥᒍᓱᒃᑐᖅ
have	ᖃᖅ
have	ᐱᖃᕐᓂᖅ
have a good day	ᐅᓪᓗᖃᑦᑎᐊᕆᑦ
have a nice day	ᐅᓪᓗᓯᐅᑦᓯᐊᓚᖓᕗᑎᑦ
have breakfast	ᐅᓪᓛᕈᒥᑕᕐᓗᑎᒃ
have fun	ᐊᓕᓇᐃᑦᑐᒃᑰᕆᑦ
have you eaten	ᓂᕆᓯᒪᕖᑦ
having	ᐱᖃᕐᓂᖅ
hazard	ᐅᓗᕆᐊᓇᖅᑐᖅ
haze	ᑲᔪᖅ
he	ᐆᒪ
he	ᐃᓐᓇ
he has	ᐱᓯᒪᔪᖅ
he is	ᐊᖑᑦ ᑕᐃᒪᐃᑦᑐᖅ
head	ᓂᐊᖁᖅ
headache	ᓂᐊᖁᙳᓂᖅ
heal	ᒪᒥᓴᕐᓂᖅ
healing	ᓯᖅᐊᑦᑐᔪᖅ
health	ᐋᓐᓂᐊᖃᕐᓇᙱᑦᑐᓕᕆᔨᒃᑯᑦ
healthy	ᖃᓄᐃᙱᑦᑎᐊᖅᑐᖅ
hear	ᑐᓵᓂᖅ
heard	ᑐᓴᖅᑕᑦ
heart	ᐆᒻᒪᑎ
heat	ᐆᓇᖅᑐᖅ
heaven	ᕼᐊᕕᓐ
heavy	ᐅᖁᒪᐃᑦᑐᖅ
heavy	ᐅᕿᙱᑦᑐᖅ
hectic	ᐆᒻᒪᕆᒃᑐᖅ
height	ᐳᖅᑐᓂᖓ
heir	ᕼᐃᐅ
heist	ᑎᒡᓕᒃᑎ
held	ᑎᒍᒥᐊᖅᑕᐅᔪᖅ
held	ᐱᓯᒪᔭᐅᔪᖅ
hell	ᕼᐃᐅᓪ
Hello	ᐊᐃᖓᐃ
hello dear	ᐊᐃᖓᐃ ᐊᐃᖓᐃ
hello how are you	ᐊᐃᖓᐃ ᖃᓄᐃᑉᐱᑦ
hello how are you doing	ᐊᐃᖓᐃ ᖃᓄᐃᓕᖅᐱᑦ
helmet	ᓇᓴᖅ ᓇᓴᖅ
help	ᐃᑲᔪᖅ
helpful	ᐃᑲᔫᑎᖃᖅᑐᖅ
hence	ᕼᐅᐊᔅ
her	ᐅᓇ
her	ᐆᒪ
herd	ᑐᒃᑐᐃᑦ
here	ᐅᕙᓂ
here	ᑕᒫᓂ
heritage	ᐃᑦᑕᕐᓂᓴᓕᕆᓂᖅ
hesitate	ᓇᑦᔨᔪᖅ
Hey	ᐊᐃᖓᐃ
Hi	ᐊᐃᖓᐃ
hi how are you	ᐊᐃᖓᐃ ᖃᓄᐃᑉᐱᑦ
Hi there	ᐊᐃᖓᐃ
hidden	ᐃᔨᖅᓯᒪᔪᖅ
hide	ᐃᔨᕐᓂᖅ
hide	ᐊᒥᕋᐃᖓ
hierarchy	ᖁᑦᑎᒃᓯᕙᓪᓕᐊᓂᖓ
high	ᖁᑦᑎᒃᑐᖅ
highlight	ᐅᔾᔨᕐᓇᖅᓯᑎᓪᓗᒍ
hike	ᐱᓱᔪᖕᓂᖅ
hiking	ᐱᓱᔪᖕᓂᖅ
hilarious	ᐃᔪᕐᓇᖅᑐᖅ
hill	ᖃᖅᑲᔮᖅ
him	ᑕᐃᓐᓇ ᐊᖑᑦ
hint	ᐱᓱᒃᑐᖅ
hip	ᓯᕝᕕᐊᖅ
hips	ᓯᕝᕕᐊᑦ
hire	ᐃᖅᑲᓇᐃᔭᖅᑎᑖᕐᓂᖅ
hiring	ᐃᖅᑲᓇᐃᔭᖅᑎᑦᑎᓂᖅ
his	ᐆᒪ
history	ᐱᐅᓯᕆᔭᐅᕙᓚᐅᖅᑐᑦ
hit	ᐊᓇᐅᔪᖅ
hit	ᐃᑦᓯᖅᑐᖅ
Hmm	ᕼᐄᒻ
hobby	ᖁᕕᐊᒋᔭᖅ
hold	ᓄᖅᑲᖓᔪᖅ
hold	ᑎᒍᒥᐊᕐᒡᔨᒡ
hold on	ᑎᒍᒻᒥᒋᑦ
hole	ᐅᑭᑎᖅ
holiday	ᕿᑲᕐᓇᖅ
hollow	ᖁᖅᓱᖅᑐᖅ
home	ᐊᖕᖏᕋᖅ
homework	ᐊᖏᕐᕋᒥ ᐱᓕᕆᐊᒃᓴᑦ
honest	ᓱᓕᓂᖅ
honestly	ᓱᓕᓪᓗᖓ
Honey	ᕼᐊᓂ
honor	ᐅᐱᒍᓱᒃᐳᖓ
hood	ᓇᓴᖅ
hook	ᓂᒃᓯᖃᖅ
hop	ᕼᐋᑦ
hope	ᓂᕆᐅᖕᓂᖅ
hopefully	ᓂᕆᐅᓇᖅᐳᖅ
hopeless	ᓂᕆᐅᖕᓂᖃᕈᓐᓃᕐᓂᖅ
horizontal	ᓴᓂᒨᖓᔪᖅ
horn	ᐃᒡᓗ
horrible	ᓂᖅᑐᕐᓇᖅᑐᖅ
horror	ᕼᐅᕐᕈ
horse	ᕿᒻᒥᕐᔪᐊᖅ
hospital	ᐋᓐᓂᐊᕐᕕᒃ
hospitality	ᑐᖓᓱᒃᑎᑦᑎᓂᖅ
host	ᑐᙵᓱᒃᑎᑦᑎᔨ
hostile	ᑐᖓᓱᒃᑐᖅ
hot	ᐅᖅᑰ
hot	ᐆᓇᖅᑐᖅ
hotel	ᑐᔪᕐᒥᕕᒃ
hour	ᐃᑲᕐᕋᖅ
hours	ᐃᑲᕐᕋᐃᑦ
house	ᐃᒡᓗ
household	ᐃᒡᓗᒥᐅᖃᑎᒌᑦ
how	ᖃᓄᖅ
how about you	ᐃᒡᕕᓪᓕ
how are you	ᖃᓄᕆᒃᐱᑦ
how are you	ᖃᓄᐃᑉᐱᓐ
how are you doing	ᖃᓄᐃᑉᐱᑦ
how are you doing	ᖃᓄᕆᒃᐱᑦ
how are you doing today	ᖃᓄᐃᑉᐱᑦ ᐅᓪᓗᒥ
how are you today	ᖃᓄᐃᑉᐱᑦ ᐅᓪᓗᒥ
how do you do	ᖃᓄᖅ ᐱᖃᑦᑕᖅᐱᑦ
how is	ᖃᓄᖅ
how many	ᖃᔅᓯᓂᒃ
how much	ᖃᔅᓯᑐᖅᐸ
how much	ᓱᓇᐅᕙ ᐊᑭᖓ
how often	ᖃᓄᖅ ᐊᑯᓚᐃᑎᒋᔪᖅ
how old are you	ᖃᓄᖅ ᐅᑭᐅᖃᖅᐱᓐ
how old are you	ᖃᔅᓯᓂᒃ ᐅᑭᐅᖃᖅᐱᑦ
how was your day	ᐅᓪᓗᕆᑫᓐᓇᑌᓪᓕ ᖃᓄᐃᑫᓐᓇᖃ
how was your night	ᖃᓄᖅ ᐅᓐᓄᐊᖅ
however	ᖃᓄᑐᐃᓐᓇᖅ
however	ᑭᓯᐊᓂ
hub	ᐃᓄᒃᑯᕕᒃ
hubby	ᐃᓄᑐᐊᒃᑯᕕᒃ
hug	ᐃᕿᑦᑎᓗᓯ
huge	ᐊᖏᔪᖅ
human	ᐃᓄᐃᑦ
humble	ᐃᑉᐱᒋᑦᑎᐊᙱᓐᓂᖅ
humid	ᕿᐅᒃᑲᖓᔪᖅ
humidity	ᕿᐅᒃᑲᖓᓂᖅ
hundred	ᐊᕙᑏᑦ ᑕᓪᓕᒪᑦ
hungry	ᑳᒃᑐᖅ
hunt	ᐊᖑᓇᓱᖕᓂᖅ
hurricane	ᐊᓄᕆᕐᔪᐊ
hurry	ᑐᐊᕐᕕᕆᑦ
hurry up	ᐅᐃᒪ
hurt	ᐋᓐᓂᖅᑐᖅ
husband	ᐅᐃᒃ
husband	ᐊᖑᑎᒋᔭᖅ
hustle	ᑐᐊᕕᕐᓂᖅ
hut	ᕼᐅᑦ
hygiene	ᓴᓗᒪᓂᖅ
I	ᐅᕙᖓ
I am	ᐅᕙᖓ
I am fine	ᖃᓄᐃᙱᑦᑐᖓ
I can	ᐱᔪᓐᓇᖅᑐᖓ
I can't	ᐱᔪᓐᓇᙱᑦᑐᖓ
I do	ᑕᐃᒪᐃᑉᐳᖓ
I do not know	ᖃᐅᔨᒪᙱᓚᖓ
I do not understand	ᑐᑭᓯᙱᑦᑐᖓ
I don't	ᐃᒪᐃᙱᓚᖓ
I don't know	ᖃᐅᔨᒪᙱᑦᑐᖓ
I don't understand	ᑐᑭᓯᐊᙱᑦᑐᖓ
I don't understand what you mean	ᑐᑭᓯᙱᓐᓇᒪ ᖃᓄᖅ ᑐᑭᖃᕐᒪᖔᖅᐱᑦ
I don't understand you	ᑐᑭᓯᙱᓐᓇᒃᑭᑦ
I don’t know	ᖃᐅᔨᒪᑦᔭᖏᓪᓚᖓ
I don’t understand	ᑐᑭᓯᑦᔭᖏᓪᓚᖓ
i guess	ᐄᖃᐃ
I had	ᐱᓯᒪᔭᕋ
I have	ᐱᓯᒪᔭᒃᑲ
I have been	ᐱᓯᒪᓕᖅᑐᖓ
I hope so	ᑕᐃᒪᑐᖅ
I know	ᖃᐅᔨᒪᕗᖓ
I like	ᐱᐅᒃᓴᖅᑐᖓ
I like you	ᐱᐅᒋᕙᒋᑦ
I love	ᓇᓪᓕᒋᔭᕋ
I love my big brother	ᐊᖏᔪᒐ ᓇᓪᓕᒋᔭᕋ
I love my big sister	ᓇᓪᓕᒋᔭᕋ ᐊᖏᔪᒐ
I love my father	ᐊᑖᑕᒐ ᓇᓪᓕᒋᔭᕋ
I love my little brother	ᓇᓪᓕᒋᔭᕋ ᓄᑲᕋ
I love my little sister	ᓇᓪᓕᒋᔭᕋ ᓇᔭᒐ
I love my mother	ᐊᓈᓇᒐ ᓇᓪᓕᒋᔭᕋ
I love you	ᓇᒡᓕᒋᕙᒋᑦ
I love you	ᐋᑯᓗᒃ
I love you so much	ᓇᒡᓕᒋᕙᒋᑦ ᐊᖏᔪᒥᒃ
I love you so much	ᓇᒡᓕᒋᑦᑎᐊᖅᑕᒋᑦ
I love you too	ᓇᓪᓕᒋᕙᒋᑦᑕᐅᖅ or ᓇᓪᓕᒋᒋᕙᒋᑦ
I mean	ᐃᒪᓐᓇ ᐅᖃᖅᐳᖓ
I miss you	ᐸᐃᙳᕐᓂᖅ
I miss you so much	ᑭᖑᓂᖃᕆᒻᒪᕆᒃᐸᒋᑦ
I see	ᐊᓱᑯᓗᒃ
I think	ᐃᓱᒪᔪᖓ
I understand	ᑐᑭᓯᐊᔪᖓ
I want	ᐱᔪᒪᔪᖓ
I want to see you	ᑕᑯᔪᒪᕙᒋᑦ
I want you	ᐱᒍᒪᕙᒋᑦ
I was	ᐃᒪᐃᓚᐅᖅᐳᖓ
I will	ᐃᒪᐃᓕᐅᕐᓂᐊᖅᐳᖓ
I would be	ᑕᐃᒪᐃᓐᓇᔭᖅᑐᖓ
I'm	ᐅᕙᖓ
I'm fine	ᖃᓄᐃᙱᑦᑐᖓ
I'm good	ᖃᓄᐃᙱᑉᐳᖓ
I'm here	ᑕᕝᕙᓃᑉᐳᖓ
I'm sorry	ᐃᑯᓘᖅᑐᖓ
ice	ᓯᑯ
ice cream	ᐊᐃᔅ ᑯᕇᒻ
idea	ᐃᓱᒪᒋᔭᖅ
ideal	ᐱᔪᒥᓇᖅᑐᖅ
identical	ᐊᔾᔨᑐᐃᓐᓇᖓ
identify	ᓇᓗᓇᐃᕐᓗᒍ
identity	ᑭᓇᐅᓂᖓ
idiot	ᐃᑎᕈᖅ
idle	ᓱᓕᙱᑦᑐᖅ
idle	ᓄᖅᑲᖓᓂᖅ
if	ᐃᒪᐃᑉᐸᑦ
ignore	ᓱᖁᑎᒋᙱᕐᓗᒍ
ill	ᐋᓐᓂᐊᖅᑐᖅ
illegal	ᒪᓕᒐᕐᒥᒃ ᓱᕋᐃᔪᖅ
illness	ᐋᓐᓂᐊᖅᑐᖅ
Ilocano	ᐃᓗᑳᓄ
image	ᐊᔾᔨᙳᐊᖅ
imagine	ᑕᐅᑐᙳᐊᕐᓗᒍ
immediate	ᐃᕐᖐᓐᓇᖅ
immediately	ᒫᓐᓇᓵᖅ
immense	ᐊᖏᔪᖅ
impact	ᐊᒃᑑᑎᔪᑦ
impatient	ᐅᖓᑎᓗᐊᕇᖅᑐᖅ
implement	ᐊᑐᓕᖅᑎᑕᐅᔪᖅ
import	ᑲᓇᑕᐅᑉ ᓯᓚᑖᓂ
important	ᐱᒻᒪᕆᐅᔪᖅ
impose	ᐊᑐᓕᖅᑎᑦᑎᔪᖅ
impossible	ᐊᔪᕐᓇᖅᑐᖅ
impress	ᐱᒃᑯᒋᔭᖅ
impression	ᑲᖑᓱᒃᑐᖅ
impressive	ᐱᒃᑯᓇᖅᑐᖅ
improve	ᐱᐅᓯᕚᓪᓕᕐᓗᒍ
improvement	ᐱᐅᓯᒋᐊᖅᑕᐅᓂᖏᑦ
in	ᐃᓗᐊᓂ
in addition	ᓱᓕᒃᑲᓐᓂᖅ
In fact	ᐊᒡᓛᑦ
in front of	ᓵᖓᓂ
in order to	ᐃᒪᐃᖁᓪᓗᒍ
inappropriate	ᓈᒻᒪᙱᑦᑐᖅ
incentive	ᐊᔭᐅᕆᒋᐊᕈᑎ
incident	ᖃᓄᐃᓐᓂᕆᔭᐅᔪᖅ
include	ᐃᓚᓕᐅᑎᓗᒍ
including	ᐱᖃᓯᐅᑎᓪᓗᓂ
income	ᑮᓇᐅᔭᓕᐊᕆᔭᑦ
inconvenience	ᐊᑲᐅᖖᒋᓕᐅᕈᑎᖃᕐᓂᖅ
increase	ᐃᓚᒋᐊᖅᑕᖅ
increased	ᐊᖏᒡᓕᒋᐊᖅᑐᖅ
incredible	ᒪᐃᑦᑎᐊᒻᒪᕆᒃ
indeed	ᐄᒻᒪᕆᒃ
indeed	ᐄᑦᑎᐊᖅ
independent	ᐃᒻᒥᒃᑰᖅᑐᖅ
India	ᐃᓐᑎᐊ
indicate	ᓇᓗᓇᐃᕐᓗᒍ
indigenous	ᓄᓇᖃᖅᑳᖅᓯᒪᔪᑦ
individual	ᐃᓄᑐᐃᓐᓇᖅ
industry	ᓴᓇᕝᕖᑦ
inevitable	ᐱᓴᕋᐃᑦᑐᖅ
infant	ᓄᑕᕋᓛᖅ
infection	ᓱᕈᖅᓯᒪᔪᖅ
infinity	ᓇᓗᓕᐅᒪᔪᖅ
inflammation	ᐳᕕᑦᑐᖅ
inflation	ᑭᓱᑐᐃᓐᓇᐃᑦ ᐊᑭᑦᑐᖅᐸᓪᓕᐊᓂᖏᑦ
influence	ᐊᒃᑐᐃᓂᖅ
inform	ᑐᓴᖅᑕᐅᑎᓪᓗᒍ
information	ᑐᓴᐅᒪᔾᔪᑎᒃᓴᑦ
ingredients	ᓂᖅᖠᐊᒐᑦ
inheritance	ᐃᓇᖐᓂᖅ
initial	ᐊᑎᖅᐱᑦ ᐱᒋᐊᕐᓂᖓ
initiative	ᐱᓕᕆᐊᖑᔪᖅ
injured	ᐋᓐᓂᖅᑐᖅ
injury	ᐋᓐᓂᖅᑐᖅ
innocent	ᑎᐱᖃᙱᑦᑐᖅ
innovation	ᐱᐅᓯᒋᐊᖅᑎᑦᑎᓂᖅ
inquiry	ᖃᐅᔨᓴᕐᓂᖅ
insane	ᐃᑎᖅᓴᖅ
insect	ᖁᐱᕐᕈᐃᓪᓗ ᑯᒪᐃᓪᓗ
insecure	ᓇᓗᓕᕐᓂᖅ
insert	ᐃᓕᓗᒐ
inside	ᐃᓗᐊᓂ
insight	ᐃᓱᒪᒋᔭᖅ
insist	ᐱᔨᔪᖅ
insomnia	ᐃᑎᒪᓂᖅ
inspiration	ᑲᔪᖏᖅᓴᐃᓂᖅ
inspire	ᑲᔪᖏᖅᓴᐃᔪᖅ
install	ᐋᖅᑭᓱᖅᑕᐅᓂᖓ
instance	ᓲᕐᓗ
instant	ᐃᕐᖐᓐᓇᖅ
instead	ᐃᒪᓐᓇᖔᕐᓕ
instead	ᖔᖅ
instead of	ᐆᒥᖓᐅᙱᖔᖅᑐᖅ
instructions	ᓇᓗᓇᐃᔭᐃᔾᔪᑎᑦ
instrument	ᐱᓕᕆᔾᔪᑎ
insult	ᑲᙳᓵᕆᓂᖅ
insurance	ᓇᓪᓕᐅᒃᑯᒻ
intact	ᑕᖏᖃᕐᓂᖅ
integrity	ᓱᓕᓂᖅ
intellectual	ᐃᓱᒪᑐᓂᖅ
intelligence	ᓯᓚᑐᓂᖅ
intelligent	ᓯᓚᑐᔪᖅ
intend	ᐱᓂᐊᕈᒪᓂᖅ
intended	ᑐᕌᖅᑕᐅᓇᓱᒃᑐᖅ
intense	ᐱᕐᔪᐊᖅᑐᖅ
intention	ᐱᓂᐊᕐᓂᕋᕐᓂᖅ
interact	ᐃᓅᖃᑎᖃᕈᓐᓇᕐᓂᖅ
interaction	ᐃᓅᖃᑎᖃᕈᓐᓇᕐᓂᖅ
interest	ᐊᑐᖅᑐᐊᕐᓂᕐᒧᑦ ᐊᑭᓕᐅᑎᑦ
interest	ᐱᔪᒥᓇᖅᑐᖅ
interested	ᐱᔪᒪᔪᑦ
interesting	ᑐᓴᕈᒥᓇᖅᑐᖅ
interfere	ᐸᒡᕕᓇᖅᑐᖅ
intermediate	ᐊᑯᓐᓂᖅᓱᖅᑐᑦ
internal	ᐃᓗᐊᓂ
international	ᓄᓇᕐᔪᐊᖅ
internship	ᐃᖅᑲᓇᐃᔭᓯᓐᓈᑦ ᐃᓕᓐᓂᐊᕐᓂᖅ
interpret	ᑐᑭᓕᐅᕆᓂᖅ
interpreter	ᑐᓵᔨ
interrupt	ᐅᓚᕕᓴᐃᓂᖅ
interview	ᐊᐱᖅᓱᖅᑕᐅᓂᖅ
intimate	ᐱᖑᓪᓕᖅ
into	ᐅᑯᓇᓂ
introduce	ᑭᓇᐅᓂᖓ ᖃᐅᔨᔭᐅᑎᓪᓗᒍ
introduction	ᓇᓗᓇᐃᔭᐅᑎᑦ
introvert	ᐱᒋᐊᕈᑎ
intuition	ᐊᓯᔾᔨᖅᑐᖅ
Inuktitut	ᐃᓄᒃᑎᑐᑦ
invalid	ᐊᑐᙱᓐᓂᖅ
invent	ᓴᓇᓂᖅ ᓇᒻᒥᓂᖅ
inventory	ᓈᓴᖅᓯᒪᔪᑦ ᓇᖕᒥᓂᖁᑎᒋᔭᑦ ᐱᖁᑎᖏᑦ
invest	ᑮᓇᐅᔭᓕᐅᕋᓱᐊᕐᓂᖅ
investigate	ᖃᐅᔨᓴᕐᓂᖅ
invitation	ᖃᐃᖁᔨᓂᖅ
invite	ᖃᐃᖁᔨᓂᖅ
invoice	ᐊᑭᓕᒐᒃᓴᖅ
involve	ᐃᓚᐅᑎᓪᓗᒍ
involved	ᐃᓚᐅᔪᑦ
iron	ᐊᐅᒋᒃᓴᐅᑎ
is	ᐃᒫᒃ
island	ᕿᑭᖅᑕᖅ
isolated	ᐃᓄᑑᑎᑕᐅᓂᖅ
issue	ᐊᑲᐅᙱᓕᐅᕈᑎ
issue	ᑐᓂᔭᐅᔪᖅ
issues	ᐊᑲᐅᙱᓕᐅᕈᑏᑦ
it	ᐅᓇ
it is	ᑕᐃᒪᐃᑦᑐᖅ
it was	ᑕᐃᒪᐃᓚᐅᖅᑐᖅ
it's	ᐃᒪᐃᒻᒪᑦ
it's ok	ᓇᒻᒫᒃᑐᖅ
It's okay	ᑖᓐᓇ ᓈᒻᒪᒃᑐᖅ
item	ᐃᓗᓕᖓ
items	ᑭᓱᒃᕈᑏᑦ
its	ᐆᒪ
I’m	ᐅᕙᖓ
jacket	ᔭᐃᑲᒃ
jail	ᐊᓄᓪᓚᒃᓰᕕᒃ
January	ᓇᓕᖅᑲᐃᖅᑐᖅ
January	ᔭᓄᐊᕆ
jar	ᐃᐳᐃᑦᑐᖅ
jaw	ᐊᒡᓕᕈ
jealous	ᓯᓇᕐᔪᖅ
jerk	ᐊᓕᒍᖅ
jewelry	ᑕᑯᒥᓴᐅᑎᑦ
job	ᐃᖅᑲᓇᐃᔮᖓ
jogging	ᐊᑉᐸᖕᓂᖅ ᐱᖃᐃᓕᓴᖅ
join	ᐃᓚᐅᕝᕕᒋᓗᒋᑦ
joint	ᓇᒡᒍᐊᖅ
joke	ᒥᑕᖅᑐᖅ
journalist	ᐱᕙᓪᓕᐊᔪᓕᕆᔨ
journey	ᐃᖏᕐᕋᓂᖅ
joy	ᖁᕕᐊᓱᖕᓂᖅ
judge	ᐃᖅᑲᖅᑐᐃᔨ
juice	ᐃᒥᒐᒃᓴᖅ
july	ᔪᓚᐃ
july	ᑐᕙᐃᔮᕈᑦ
jump	ᕿᒡᒋᕐᓂᖅ
june	ᒪᓐᓂᓕᐅᑦ
june	ᔫᓂ
junk	ᓱᖓᐅᓯᖅᑐᖅ
just	ᑐᐃᓐᓇᖅ
just	ᕋᑖᖅ
just do it	ᑕᐃᒪᐃᓕᐅᑐᐃᓐᓇᕆᑦ
justice	ᒪᓕᒐᓕᕆᔨᒃᑯᑦ
justify	ᓱᓕᓂᕆᑦᑎᐊᕐᓗᒍ
Kalaallisut	ᑲᓛᓪᓕᓱᑦ
keen	ᑲᖑᓱᒃᑑᒃ
keep	ᐱᓯᒪᓗᒍ
keep it up	ᐊᖑᒻᒪᑎᓗᒍ
kept	ᐱᓯᒪᐃᓐᓇᖅᑐᖅ
kettle	ᑐᖅᖢᐊᓕᒃ
key	.key
kick	ᐃᑎᒻᒥᓂᖅ
kid	ᓄᑕᕋᖅ
kidding	ᐅᖃᙳᐊᕐᓂᖅ
kidney	ᑕᖅᑐ
kids	ᓄᑕᖅᑲᑦ
kill	ᑐᖁᑕᐅᔪᑦ
kind	ᖃᓄᐃᑦᑑᓂᖓ
kind	ᐱᐅᓂᖓ
kinda	ᐄᒐᓚᒃ
kindly	ᖁᔭᓐᓇᒦᒃ
kindness	ᐃᓄᑦᑎᐊᕙᐅᓂᖅ
king	ᑭᙴᒪᔪᖅ
kiss	ᑯᓂᔅ
kitchen	ᐃᒐᕝᕕᒃ
kitchen	ᓂᖅᖠᐅᕐᕕᒃ
kite	ᑲᐃᑦ
kitten	ᑲᐃᑦᑕᓐ
knee	ᓰᖅᑯᖅ
knew	ᖃᐅᔨᒪᔪᖅ
knife	ᓴᕕᒃ
knight	ᐅᓐᓄᐊᒃᑯᑦ
know	ᖃᐅᔨᒪ
knowledge	ᖃᐅᔨᒪᓂᖅ
known	ᖃᐅᔨᒪᔭᐅᔪᖅ
Konkani	ᑯᖕᒃᓂ
Krio	ᑭᐅᕈ
label	ᓇᓗᓇᐃᒃᑯᑕᖅ
labor	ᐃᕐᓂᓱᒃᑐ
labour	ᐃᕐᓂᓱᒃᑐᓕᕆᓂᖅ
lack	ᐱᑕᖃᙱᓐᓂᐅᔪᖅ
ladder	ᒪᔪᕋᐅᑦ
lady	ᐊᕐᓇᖅ
laid	ᑕᓗᕈᑦ
lake	ᑕᓯᖅ
lamb	ᓂᕐᔪᑦ ᓛᒻ
lame	ᕿᓚᓗᖅ
lamp	ᖃᐅᒻᒪᖅᑯᑦ
land	ᓄᓇ
landscape	ᓄᓇᐅᑉ ᑕᐅᑦᑐᐊ
language	ᐅᖃᐅᓯᖅᑕᖅ
lap	ᐸᑦᑕᒃ
large	ᐊᖏᔪᖅ
last	ᑭᖑᓪᓕᖅᐹᖅ
last but not least	ᑭᖑᓪᓕᖅᐸᖅ ᑭᓯᐊᓂ ᒥᑭᓂᖅᐸᐅᖏᑦᑐᖅ
last name	ᐊᑎᕈᓯᐊ
late	ᑭᖑᕙᖅᑐᖅ
lately	ᑭᖑᓂᑦᑎᐊᖓᒍᑦ
later	ᐅᐊᑦᑎᐊᕈᒃᑲᓐᓂᖅ
latest	ᓄᑖᖑᓛᖅ
latter	ᑭᖑᓕᖅᐹᖅ
laugh	ᐃᒡᓚᖅᑐᖅ
laughing	ᐃᒡᓚᑲᑕᒃᑐᖅ
laughter	ᐃᓪᓚᖅᑐᖅ
launch	ᓴᖅᑭᑕᐅᓂᖓ
laundry	ᐊᓐᓄᕌᓄᑦ ᐅᐊᓴᕐᕕᒃ
law	ᒪᓕᒐᖅ
lawn	ᐃᕐᓂᐊᖑᔭᖅ
lawyer	ᒪᓕᒐᓕᕆᔨ
lay	ᐋᖅᑭᑦᓯᒪᓂᖓ
layer	ᖃᓕᕇᑦ
layout	ᐋᖅᑭᒃᓯᒪᓂᖓ
lazy	ᓴᓚᐅᓱᒃᑐᖅ
lead	ᓴᕕᕋᔭᒃᓴᖅ
leader	ᓯᕗᓕᖅᑎ
leaf	ᓖᕝ
leak	ᑯᑐᒃᑐᖅ
lean	ᓂᓕᕐᓇᖅ
leap	ᓯᓂᒃᑐᖅ
learn	ᐃᓕᑦᑎᓂᖅ
learning	ᐃᓕᓐᓂᐊᕐᓂᖅ
lease	ᐊᑐᖅᑐᐊᕐᓂᕐᒧᑦ
least	ᐱᓗᐊᖅᑐᖅ
leather	ᕿᓯᐅᔭᖅᑐᖅ
leave	ᐊᓂ
leave	ᐊᐅᓪᓚᖅ
leaves	ᓄᖅᑲᖓᔪᖅ
led	ᐊᐅᓚᑦᑎᔪᖅ
left	ᓴᐅᒥ
left	ᐊᓂᔪᖅ
leg	ᓂᐅ
legacy	ᐃᖅᑲᐅᒪᔭᒃᓴᖅ
legal	ᒪᓕᒐᖅᑎᒍᑦ
legend	ᐅᓂᒃᑳᖅᑐᐊᖅ
legit	ᓂᐅᖅ
leisure	ᓴᐃᓕᓂᖅ
lend	ᐊᑐᖅᑐᐊᖅᑐᖅ
length	ᑕᑭᓂᖓ
less	ᐊᒥᓲᙱᓐᓂᖅᓴᐃᑦ
less	ᐅᓄᙱᓐᓂᖅᓴᖅ
lesson	ᐃᓕᓴᐃᔾᔪᑦ
let	ᐱᑎᓪᓕ
letter	ᑎᑎᖅᑲᖅ
lettuce	ᐱᕈᖅᑐᕕᓂᖅ
level	ᖁᑦᑎᖕᓂᖓ
leverage	ᐱᔪᓐᓇᕐᓂᖃᕐᓂᖅ
liability	ᐊᑭᓕᕆᐊᓖᑦ
library	ᐅᖃᓕᒫᒐᖃᕐᕕᒃ
lick	ᐊᓗᒃᑐᖅ
lie	ᓴᒡᓗᔪᖅ
lies	ᓴᒡᓗᔪᖅ
life	ᐃᓅᓯᖅ
lift	ᑭᕕᒃᓯᓂᖅ
light	ᐅᕿᑦᑐᖅ
lightning	ᑲᓪᓕᖅᑐᖅ
like	ᓲᕐᓗ
likely	ᑕᐃᒪᐃᑐᐃᓐᓇᕆᐊᓕᒃ
likewise	ᑕᐃᒫᑦᑕᐅᖅ
line	ᑐᑭᓕᐊᖅᑐᖅ
Lingala	ᓕᖓᓚ
link	ᐊᑦᑕᑕᕐᕕᒃᓴ
lion	ᓕᐊᓐ
liquid	ᐃᒪᖅ
list	ᑎᑎᕋᖅᓯᒪᔪᑦ
listen	ᑐᓵᓂᖅ
listen	ᓈᓚᓐᓂᖅ
listening	ᓈᓚᖕᓂᖅ
literally	ᐱᓗᐊᖅᑐᖅ
literature	ᐅᖃᓕᒫᒐᓕᕆᓂᖅ
litter	ᐃᒋᑕᐅᒥᐊᖅᐸᒃᑐᑦ
little	ᒥᑭᔪᖅ
live	ᐆᒪᔪᖅ
liver	ᑎᖑᒃ
lives	ᐃᓅᓯᖅ
living	ᐃᓅᓂᖅ
living room	ᐳᓛᕐᕕᒃ
lizard	ᓕᓱᑦ
load	ᐅᓯᓕᖅᓱᖅᑕᖅ
loaf	ᐸᓚᐅᒑᖅ
loan	ᐊᑐᖅᑐᐊᒐᖅ
local	ᓄᓇᓕᖕᓂ
location	ᐃᓂᒋᔭᐅᔪᖅ
lock	ᑮᒍᑎᓯᒪᓂᖅ
lockdown	ᑮᒍᔾᔭᐅᓯᒪᓂᖅ
log	ᓇᐹᖅᑐᖅ
lol	ᐃᒡᓚᖅᑐᖅ
lonely	ᐃᓄᑑᔪᖅ
long	ᑕᑭᔪᖅ
long time no see	ᑕᑯᓇᓵᖅᑕᒋᑦ
look	ᑕᑯᓗᒍ
loop	ᓂᐊᖂᑉ
loose	ᖃᓱᖓᔪᖅ
lord	ᓗᑦᑖᖅ
lose	ᑕᒻᒪᐃᔪᖅ
loss	ᐊᓯᐅᔨᓂᖅ
lost	ᐊᓯᐅᔨᔪᖅ
lost	ᑕᒻᒪᖅᑐᖅ
lot	ᓄᓇ
loud	ᓂᐱᖅᑯᖅᑐᔪᖅ
lounge	ᑳᐱᑐᕐᕕᒃ
love	ᑕᑯᑦᓱᒍᓱᒃᑐᖅ
love	ᓇᒡᓕᒃ
love you	ᓇᒡᓕᒋᕙᒋᑦ
lovely	ᓇᒡᓕᒍᓱᒃᑐᖅ
low	ᐊᑦᑎᒃᑐᖅ
lower	ᐊᑦᑎᖕᓂᖅᓴᖅ
loyal	ᓇᓪᓕᖅᑐᖅ
loyalty	ᓂᑲᓪᓗᖅᑐᖅ
luck	ᑲᔪᓯᑦᑎᐊᕆᑦ
lucky	ᐊᓗᒐᖅᑐᖅ
Luganda	ᓗᒐᓐᑕ
luggage	ᕿᔪᖁᑎᑦ
lump	ᐃᓗᐃᒃᑲᖅ
lunch	ᐅᓪᓗᕈᒥᑕᒃᓴᖅ
lungs	ᐳᕙᐃᑦ
luxury	ᓗᒃᓯᕆ
lying	ᓴᒡᓗᔪᖅ
machine	ᓯᑭᑑᖅ
mad	ᓂᕐᖓᖅᑐᖅ
mad	ᒪᒥᐊᓱᖕᓂᖅ
madam	ᒪᑖᒻ
made	ᓴᓇᔭᐅᓯᒪᔪᖅ
magazine	ᕿᒥᕐᕈᐊᒐᖅ
magnificent	ᓂᐱᙵᑕᖅ
maid	ᓴᓗᒻᒪᖅᓴᐃᔨ
main	ᐱᓪᓗᐊᑕᖅ
maintain	ᑲᔪᓯᑎᑦᑎᓂᖅ
maintain	ᐋᖅᑭᐅᒪᑎᑦᑎᓂᖅ
maintenance	ᑲᔪᓯᑎᑦᑎᓂᖅ
maintenance	ᐋᖅᑭᐅᒪᑎᑦᑎᓂᖅ
Maithili	ᒫᑦᕼᐃᓕ
major	ᐊᖏᔪᖅ
majority	ᐅᓄᕐᓂᖅᓴᐃᑦ
make	ᓴᓇᓂᖅ
make up	ᒪᑭᒋᐊᕐᓗᑎᑦ
male	ᐊᖑᑦ
mall	ᒪᓂᕋᖅ
man	ᐊᖑᑦ
manage	ᐊᐅᓚᑦᑎᓂᖅ
management	ᐊᐅᓚᑦᑎᓂᖅ
manager	ᐊᐅᓚᑦᑎᔨ
mandatory	ᐱᔾᔭᕆᐊᖃᖅᑐᑦ
mandatory	ᑎᓕᓯᓂᖅ
manifest	ᐊᖑᑎᐅᑉ ᐃᓂᐊ
manipulate	ᓯᓚᐃᕐᕆᔪᖅ
manner	ᐃᓕᖅᑯᓯᖅ
manual	ᐅᖃᓕᒫᒐᖅ
many	ᐊᒥᓱᑦ
many many happy returns of the day	ᐊᒥᓱᑦ ᖁᕕᐊᓇᖅᑐᑦ ᐅᑎᖅᑐᑦ ᐅᓪᓗᕐᒧᑦ
march	ᓇᑦᓯᐊᓕᐅᑦ
march	ᒪᔨ
margin	ᐅᓚᒥᖅᑐᖅ
market	ᓂᐅᕐᕈᑎᖃᕐᓂᖅ
marriage	ᑲᑎᑎᑕᐅᓂᖅ
married	ᑲᑎᑎᑕᐅᓯᒪᔪᖅ
mask	ᑮᓇᑉᐸᒃ
mass	ᐃᓄᒋᐊᓗᐊᖅᑐᖅ
massive	ᐊᖏᔪᖅ
master	ᐸᕐᓇᐅᑎᓪᓗᐊᑕᖅ
match	ᐃᒡᓗᒌᒃ
mate	ᐱᖃᓐᓈᕇᒃ
material	ᓱᓇᒃᑯᑏᑦ
math	ᓈᓴᐅᓯᕆᓂᖅ
matter	ᐱᔾᔪᑕᐅᔪᖅ
maturity	ᐃᓐᓇᕈᖅᓯᒪᓂᖅ
may	ᓄᕐᕋᓕᐅᑦ
may	ᒪᐃ
maybe	ᐃᒻᒪᖄ
me	ᐅᕙᖓ
me too	ᐅᕙᖓᓗ
meal	ᓂᕆᔭᒃᓴᑦ
mean	ᑐᑭᖓ
mean	ᐱᑦᑎᐊᙱᑦᑐᖅ
meaning	ᑐᑭᖓ
means	ᑐᑭᖃᖅᑐᖅ
meant	ᑐᑭᖃᖅᑐᖅ
meanwhile	ᑐᑭᖃᖅᑐᖅ
measure	ᐆᒃᑐᕋᕐᓂᖅ
measures	ᐆᒃᑐᕋᐅᑏᑦ
meat	ᓂᖀᑦ
medical	ᐋᓐᓂᐊᖅᑐᓕᕆᓂᕐᒧᑦ
medicine	ᐃᓅᓕᓴᐅᑎᑦ
meditation	ᐃᓱᒪᒃᓴᖅᓯᐅᕐᓂᖅ
medium	ᐊᑯᓐᓂᖅᓱᖅᑐᖅ
meet	ᑲᑎᓐᓂᖅ
meeting	ᑲᑎᒪᓂᖅ
Meiteilon	ᒥᑎᓚᓐ
melt	ᐊᐅᒃᐸᓪᓕᐊᔪᖅ
memories	ᐃᖅᑲᐅᒪᓇᖅᑐᑦ
memory	ᐳᐃᒍᑐᓂᖅ
mental	ᐃᓱᒪᒃᑯᑦ
mention	ᐅᖃᐅᓯᕆᓗᒍ
mentioned	ᐅᖃᐅᓯᐅᔪᑦ
mentor	ᑲᔪᖏᖅᓴᐃᔨ
merchant	ᓂᐅᕕᖅᑎ
mercy	ᒥᕐᓯᔪᖅ
merely	ᐅᕙᙶᖅᑐᖅ
merry christmas	ᖁᕕᐊᓱᒋᑦ ᖁᕕᐊᓱᒡᕕᖕᒥ
mess	ᓴᓗᒪᙱᑦᑐᖅ
message	ᑐᓴᖅᑕᐅᔪᒃᓴᖅ
messy	ᑎᔅᓯᓈᕿᔪᖅ
metal	ᓴᕕᕋᔭᒃ
method	ᖃᓄᐃᓕᖓᓂᖓ
mice	ᑯᒪᒃ
middle	ᕿᑎᖅ
midnight	ᕿᑎᒐᕐᑐᖅ ᐅᓐᓄᐊᑯᑦ
might	ᑐᐃᓐᓇᕆᐊᓕᒃ
mild	ᐱᓗᐊᖅᑐᖅ
milestone	ᓇᓗᓇᐃᒃᑯᑕᖅ
military	ᐅᓇᑕᖅᑐᒃᓴᑦ
milk	ᐃᒻᒧᒃ
million	ᒥᓕᐊᓐ
mind	ᐃᓱᒪ
mindset	ᐃᓱᒪᐃᕈᑎᓂᖅ
mine	ᐱᒐ
mingle	ᒥᖑᖅᑐᖅ
minor	ᐅᑭᐅᑭᑦᑐᖅ
minute	ᒥᓂᑦᓯ
minutes	ᑎᑦᑕᑯᓗᐃᑦ
miracle	ᒥᒃᑯᓕᐊᕆᔪᖅ
mirror	ᑕᕐᕋᖅᑑᑦ
miscellaneous	ᑭᓱᑐᐃᓐᓇᕐᓄᑦ
mischievous	ᐃᓕᒪᓱᓐᓂᖅ
miserable	ᐱᑲᒻᒪᒃᑕᖅ
misery	ᐱᑲᒻᒪᒃᑐᖅ
miss	ᓂᕕᐊᖅᓯᐊᖅ
miss you	ᑕᑯᔪᒪᓕᖦᖤᖅᐸᒋᑦ
missing	ᐱᑕᖃᙱᓐᓂᐅᔪᖅ
mission	ᐱᓕᕆᐊᒃᓴᕆᑎᑕᐅᔪᑦ
mist	ᐱᙱᙳᐊᖅᑐᖅ
mistake	ᑕᒻᒪᖅᓯᒪᔪᖅ
Mizo	ᒥᓲ
mobile	ᐅᖄᓚᐅᑎᕋᓛᖅ
mock	ᒥᑎᖅ
model	ᖃᓄᐃᑦᑑᓂᖓ
moderate	ᐱᓗᐊᖅᑐᖅ
modern	ᐅᓪᓗᒥᓕᓴᖅ
modest	ᒪᓂᕋᐅᑉ ᓯᕕᖓᖓᔪᖅ
moist	ᕿᐅᒃᑲᖓᔪᖅ
moisture	ᕿᐅᒃᑲᖓᔪᖅ
mold	ᐅᖁᒃ
mole	ᐅᕕᖓᔪᖅ
mom	ᐊᓈᓇᐅᔪᖅ
moment	ᐃᒃᓯᖕᓇᐃ
monday	ᐊᓪᓕᕆᕐᑐᑦ
money	ᑮᓇᐅᔭᖅ
monitor	ᐃᒐᓛᖑᔭᖅ
monkey	ᒪᓐᑭ
month	ᑕᖅᑭᖅ
mood	ᖃᓄᐃᖓᓂᖅ
moody	ᒪ'ᓇᓪᓕᖅᑐᖅ
moon	ᑕᖅᑭᖅ
moral	ᐃᓅᖃᑎᒌᖕᓂᖅ
more	ᓱᓕᒃᑲᓐᓂᖅ
moreover	ᓱᓕᒃᑲᓐᓂᕐᓗ
morning	ᐅᓪᓛᑯᑦ
mortgage	ᐃᒡᓗᖁᑎᑖᕋᓱᖕᓂᕐᒧᑦ ᓄᓇ
most	ᑕᒪᕐᒥᑲᓴᒃ
mostly	ᐱᓗᐊᖅᑐᒥᑦ
mother	ᐊᓈᓇᒃ
motion	ᐱᖁᔨᕗᖔᕈᑦ
motivation	ᐆᒻᒪᕆᖕᓂᖅ
mountain	ᖃᖅᑲᖅ
mouse	ᐊᕕᙵᙳᐊᖅ
mouth	ᖃᓂᖅ
move	ᓅᓐᓂᖅ
movement	ᓇᒧᙵᐅᕙᖕᓂᖏᑦ
movie	ᑕᕐᕆᔭᖅ
mrs	ᒥᓯᔅ
much	ᐱᓗᐊᖅᑐᖅ
mud	ᒪᕋᖅ
mug	ᑯᒪᒃ
muscle	ᓄᑭᒃ
museum	ᑕᑯᔭᒐᖃᕐᕕᒃ
mushroom	ᐃᒃᑯᑎᑦ
music	ᓂᔾᔭᐅᑦ
must	ᒋᐊᖃᕐᓂᖅ
must	ᐱᔭᕆᐊᖃᖅᑐᑦ
mute	ᓂᓪᓕᐊᔪᖅ
mutual	ᑕᒪᐃᓐᓄᑦ
my	ᐱᒐ
My dear	ᓇᒡᓕᒋᔭᕋ
my friend	ᐱᖃᓐᓇᕆᔭᕋ
My hovercraft is full of eels	ᐊᒃᓴᓗᐊᕋ ᑕᑖᖅᑐᖅ ᒥᑎᕐᓂᒃ
my love	ᓇᒡᓕᒐ
my name is	ᐅᔪᖓ
my pleasure	ᖁᕕᐊᒋᖅᑲᐅᕙᕋ
myself	ᐅᕙᖓ
mysterious	ᑲᖐᒋᔭᖅ
mystery	ᓇᓗᓕᖅᑕᐅᔪᖅ
myth	ᐅᓂᒃᑳᖅᑐᐊᑦ
nail	ᑭᑭᐊᒃ
naive	ᓇᒡᕚᖅ
name	ᐊᑎᖓ
narrative	ᐅᓂᒃᑲᐅᓯᐅᓂᖓ
narrow	ᑐᐊᑦᑐᑯᑖᒃ
nasty	ᓱᓪᓗᐃᑦ
national	ᑲᓇᑕᓕᒫᒥ
nationality	ᑲᓇᑕᓕᒫᒥ
native	ᓄᓇᖃᖅᑳᖅᓯᒪᔪᑦ
natural	ᑕᐃᒪᐃᓪᓚᑦᑖᖅᑐᖅ
nature	ᖃᓄᐃᑦᑑᓂᖓ
nausea	ᒥᕆᐊᙳᓂᖅ
near	ᖃᓂᑦᑐᖅ
near	ᖃᓂᐊᓂ
nearby	ᖃᓂᒋᔭᖓᓂ
nearly	ᐊᔅᓱᑲᓴᑦᑎᐊᖅ
neat	ᒪᐃᑦᑎᐊᖅ
necessary	ᐊᑐᐃᓐᓇᐅᔪᖅ
necessary	ᐱᖃᕆᐊᖃᖅᑐᑦ
neck	ᖁᖓᓯᖅ
necklace	ᐅᔭᒥᒃ
need	ᐱᖃᕆᐊᖃᖅᑐᖅ
need	ᑭᙴᒪᒋᔭᖅ
negative	ᐱᐅᙱᑦᑐᖅ
neglect	ᐃᓖᔭᕆᔭᐅᔪᖅ
negotiate	ᐋᔩᖃᑎᖃᕐᓂᖅ
neighbor	ᓴᓂᓪᓕᖓ
neighborhood	ᓴᓂᓪᓕᖏᑦ
neither	ᓇᓕᖅᓯ
nephew	ᖃᖏᐊᖅ
nerd	ᐅᖓᑎᑦᑎᐊᖓ
nervous	ᑯᒃᓴᓱᒃᑐᖅ
nest	ᐃᕙᕝᕖᑦ
net	ᒪᑦᑎᑦᑕᐅᑎ
network	ᐱᓕᕆᔨᓄᑦ ᑐᓴᐅᒪᖃᑦᑕᐅᑎᖃᑎᒌᒍᑎᓂᒃ
neutral	ᐊᑭᕋᖅᑐᐃᔪᖅ
never	ᐊᑐᓚᐅᖅᓯᒪᙱᑦᑐᖅ
never give up	ᓴᐱᓕᖅᑕᐃᓕᒋᑦ
never mind	ᖁᔭᓇ
nevermind	ᓄᖅᑲᐃᓂᖅ
nevertheless	ᑕᐃᒪᐃᒃᑲᓗᐊᕐᑎᓪᓗᒍ
new	ᓄᑖᖅ
news	ᐱᕙᓪᓕᐊᔪᑦ
next	ᑭᖑᓪᓕᖅ
next to	ᑭᖑᓂᐊᒍᑦ
nice	ᒪᐃᑦᑎᐊᖅ
nice	ᐱᐅᔪᖅ
nice to meet you	ᑲᑎᒃᒐᒃᑭᑦ ᖁᕕᐊᓇᖅ
niece	ᐅᔪᕈᖓ
night	ᐅᓐᓄᐊᑯᑦ
nightmare	ᐅᒻᒪᑎᖓ
nine	ᑕᓪᓕᒪᐅᔪᖏᒐᕐᑐᑦ
nineteen	ᑕᓪᓕᒪᐅᔪᕐᑐᓗ ᑕᓪᓕᒪᐅᔪᖏᒐᕐᑐᓗ
ninety	ᐊᕙᑏᑦ ᑕᓪᓕᒪᐅᔪᖏᒐᕐᑐᑦ
No	ᓇᐅᒃ
No	ᐋᒃᑲ
no problem	ᖃᓄᐃᙱᑦᑐᖅ
no way	ᐋᒃᑲᑦᑎᐊᖅ
nobody	ᑭᓇᒧᒃᑭᐊᖅ
noise	ᓂᐱᖁᖅᑐᔪᖅ
noisy	ᓂᐱᓗᒃᑐᖅ
none	ᐱᑕᖃᔮ
noon	ᕿᑎᒐᕐᑐᖅ ᐅᓪᓗᑯᑦ
nope	ᓇᐅᒃ
nor	ᐅᕝᕙᓘᓐᓃᑦ
normal	ᓈᒻᒪᒃᑐᖅ
north	ᑕᕐᕋᖅ
nose	ᕿᖓᖅ
nostalgic	ᓄᑮᖅᑎᕈᑏᑦ
not	ᐋᒃᑲ
not at all	ᐃᓱᒫᓘᒋᙱᑕᕋ
not bad	ᖃᓄᐃᓗᐊᙱᑦᑐᖅ
Not now	ᒫᓐᓇᐅᙱᑦᑐᖅ
not yet	ᐋᒃᑲ ᓱᓕ
note	ᐅᔾᔨᕆᔭᕆᐊᓕᒃ
noted	ᓇᓗᓇᐃᖅᑕᖅ
nothing	ᐱᑕᖃᙱᑦᑐᖅ
notice	ᐅᔾᔨᕈᓱᓐᓂᖅ
notice	ᑐᓴᒐᒃᓴᖅ
noticed	ᐅᔾᔨᕆᔭᐅᔪᖅ
noun	Noun
nouns	ᐅᖃᐅᓯᖅ ᐊᑦᑎᖅᑐᑦ
novel	ᐅᖃᓕᒫᒐᖅ
november	ᐊᕐᓇᓕᙴᑎᕝᕕᒃ
november	ᓄᕕᒻᐱᕆ
now	ᒫᓐᓇ
nowadays	ᒫᓐᓇᐅᓕᖅᑐᖅ
nuisance	ᐸᒡᕕᓇᖅᑐᖅ
null	ᖃᖅᑯᐊᒐᖅ
numb	ᖃᖅᑯᐊᒐᖅ
number	ᓈᓴᐅᑦ
nurse	ᐃᓗᐊᖅᓴᐃᔨ
nut	ᑭᑭᐊᒧᑦ ᓄᖅᑲᕈᑦ
nutmeg	ᓇᑦᒦᒡ
nutrition	ᓂᕿᑦᑎᐊᕙᓕᕆᓂᖅ
oath	ᓱᓕᓂᐊᕐᓂᕋᕈᑦ
obesity	ᖁᐃᓂᓗᐊᕐᓂᖅ
obey	ᐃᓖᒃᑐᖅ
object	ᐱᔾᔪᑖ
objective	ᑎᑭᑕᐅᓇᓱᐊᖅᑐᖅ
obligation	ᐊᑐᓪᓚᕆᒋᐊᖃᖅᑐᑦ
obscure	ᖃᐅᔨᒪᔭᐅᙱᑦᑐᖅ
observation	ᐅᔾᔨᖅᑐᕐᓂᖅ
observe	ᑕᐅᑐᒡᓗᒍ
obsessed	ᖁᐃᓂᓗᐊᕐᓂᖅ
obsession	ᐃᓕᒪᓱᓐᓂᖅ
obsolete	ᐊᑐᕈᓐᓇᐃᓪᓕᔪᖅ
obstacle	ᐊᒡᕕᐊᕈᑎ
obtain	ᐱᓂᖅ
obtained	ᐱᔭᐅᔪᖅ
obvious	ᓇᓗᓇᙱᑦᑎᐊᖅᑐᖅ
obviously	ᓇᓗᓇᙱᑦᑐᖅ
obviously	ᑐᑭᓯᓇᖅᑐᖅ
occasionally	ᐃᓛᓐᓂᓚᐅᓱᖓᖅ
occupation	ᐃᖅᑲᓇᐃᔮᖓ
occupied	ᐃᓄᖃᖅᑐᖅ
occur	ᐊᑐᖅᑕᖅᑐᖅ
occurred	ᐊᑐᓚᐅᖅᑐᖅ
occurs	ᐊᑐᖅᑐᖃᖅᐸᒃᐳᖅ
ocean	ᑕᕆᐅᖅ
october	ᐅᒃᑐᐱᕆ
october	ᓇᔾᔪᐃᔭᕐᕕᒃ
odd	ᐊᓪᓚ
odds	ᐅᓚᒥᖅᑕᖅᑐᖅ
of	ᑖᒃᑯᓇᖓᑦ
of course	ᓲᖃᐃᒻᒪ
off	ᖃᒥᓪᓗᒍ
offensive	ᐊᑭᕋᖅᑐᖅᑐᖅ
offer	ᑐᓂᓯᓂᖅ
office	ᑎᑎᕋᕐᕕᒃ
official	ᐱᓕᕆᔨ
often	ᒐᔪᒃᑐᖅ
often	ᑕᐃᒪᐃᒐᒃᔪᖅᑐᖅ
Oh	ᐅᕼ
oh really	ᕼᐄᒎᖅ
oil	ᐅᖅᓱᖅ
ok	ᐊᑏ
ok	ᐄᒥᐊᖅ
ok dear	ᐆᑮ ᓇᒡᓕᒃ
ok honey	ᐆᑮ ᕼᐊᓂ
ok my love	ᖃᓄᐃᙱᑦᑐᖅ ᓇᓪᓕᒋᔮᒃ
okay	ᐊᑏ
okay	ᐄ
okay	ᐄᒥᐊᖅ
okay baby	ᖃᓄᐃᙱᑦᑐᖅ ᓄᑕᕋᓛᖅ
okay dear	ᖃᓄᐃᖏᑦᑎᐊᕆᖓ
okay honey	ᐆᑮ ᕼᐊᓂ
okay my love	ᐄ ᓇᒡᓕᒐ
old	ᓄᑕᐅᙱᑦᑐᖅ
on	ᖄᖓᓂ
once	ᐊᑕᐅᓯᐊᖅ
one	ᐊᑕᐅᓯᖅ
one language is never enough	ᐊᑕᐅᓯᕐᒥᒃ ᐅᖃᐅᓯᕐᒥᒃ ᓈᒻᒪᓚᐅᖅᓯᒪᙱᑦᑐᖅ
onion	ᐊᓂᐊᓐ
online	ᖃᕆᑕᐅᔭᒃᑯᑦ
only	−ᑐᐃᓐᓇᖅ
open	ᒪᑐᐃᙶᖅᑐᖅ
operation	ᐊᐅᓚᓂᖅ
opinion	ᐃᓱᒪᒋᔭᕗᑦ
opportunities	ᐱᕕᒃᓴᐃᑦ
opportunity	ᐱᕕᖃᕐᓂᖅ
opposite	ᐃᒡᓗᐊᒍᑦ
optimistic	ᓂᕆᐅᖕᓂᖃᑦᑎᐊᕐᓂᖅ
option	ᐊᑐᖅᑕᐅᖔᕈᓐᓇᖅᑐᖅ
optional	ᐊᑐᖅᑕᐅᖔᕈᓐᓇᖅᑐᖅ
or	ᐅᕝᕙᓘᓐᓃᑦ
orange	ᐊᐅᒪᐅᔭᖅ
order	ᑎᓕᓯᔾᔪᑦ
ordinary	ᐊᑐᖅᑕᐅᒐᔪᒃᑐᖅ
organization	ᑲᑐᔾᔨᖃᑎᒌᑦ
orientation	ᖃᐅᔨᒪᓕᖅᑎᑕᐅᒃᑲᓐᓂᕐᓂᖅ
origin	ᓇᑭᙶᕐᓂᖓ
original	ᐱᓪᓚᕆᒃ
Oromo	ᐅᕉᒨ
orphan	ᐃᓕᐊᕐᔪᒃ
other	ᐊᓯᖏᑦ
otherwise	ᑕᐃᒪᐃᙱᑉᐸᑦ
ought	ᕿᓕᕆᐊᖅ
our	ᐱᕗᑦ
our	ᐅᕙᒍᑦ
Our mission: to enable everyone, everywhere to understand the world and express themselves across languages.	ᑐᕌᒐᕆᔭᕗᑦ: ᑭᒃᑯᓕᒫᑦ, ᓇᓂᑐᐃᓐᓇᖅ ᑐᑭᓯᔪᓐᓇᖅᓯᓗᑎᒃ ᓄᓇᕐᔪᐊᕐᒥ ᐊᒻᒪ ᓇᖕᒥᓂᖅ ᐅᖃᐅᓯᖃᕈᓐᓇᖅᓯᓗᑎᒃ ᐅᖃᐅᓯᖃᑎᒌᙱᑦᑐᓂᒃ.
Our mission: to organize the world's information and make it universally accessible and useful.	ᑐᕌᒐᕆᔭᕗᑦ: ᐋᖅᑭᒃᓱᐃᓗᑕ ᓄᓇᕐᔪᐊᑉ ᑐᓴᐅᒪᔾᔪᑎᒃᓴᖏᓐᓂᒃ ᐊᒻᒪᓗ ᐊᑐᐃᓐᓇᐅᑎᓪᓗᒍ ᐊᒻᒪᓗ ᐊᑑᑎᖃᓕᕐᓗᓂ.
out	ᐊᓂᔪᖅ
outcome	ᖃᓄᐃᓕᖓᓂᖓ
outfit	ᐊᐅᓪᓚᕐᓂᖅ
outgoing	ᐊᓂᕙᓪᓕᐊᓂᖅ
outlet	ᑲᐳᔾᔭᕐᕕᒃ
outline	ᓇᓗᓇᐃᔭᐅᑏᑦ
outside	ᓯᓚᒥ
outstanding	ᐊᒥᐊᑦᑯᑦ
outstanding	ᐱᔭᕇᖅᑕᐅᓯᒪᙱᑦᑐᑦ
oven	ᐃᒐ
over	ᐅᖓᑖᓂ
over	ᖁᓛᓂ
over there	ᐃᑲᓂ
overall	ᐊᑕᖐᓪᓗᓂ
overcome	ᐊᓂᒍᖅᑕᐅᔪᖅ
overthinking	ᐃᓱᒪᓗᐊᕐᓂᖅ
overwhelmed	ᐅᖁᒪᐃᒃᓴᖅᑐᖅ
overwhelming	ᐅᐊᑲᓪᓚᒃᑐᖅ
owe	ᐊᑭᓕᑦᓴᖅ
owl	ᐊᓗᒡᕕᒃ
own	ᓇᖕᒥᓂᖁᑎᖃᕐᓂᖅ
owner	ᓇᖕᒥᓂᖃᖅᑎᐅᔪᖅ
ox	ᐸᒃᔅ
pace	ᓱᒃᑲᓂᖓ
pack	ᐴᖅᑲᖅᓯᒪᔪᑦ
package	ᐴᖅᑲᖅᓯᒪᔪᑦ
paid	ᐊᑭᓕᖅᑕᐅᔪᖅ
pain	ᐋᓐᓂᐊᕐᓂᖅ
paint	ᐊᒥᐊᖅ
painting	ᐊᒥᐊᕆᓂᖅ
pair	ᐃᒡᓗᒌᒃ
pale	ᐃᒥᖅᑕᐅᑦ
palm	ᐊᒡᒐᒃ
pan	ᐆᑦᑎᓯ
pan	ᐃᐳᐊᓕᒃ
pandemic	ᓄᓇᕐᔪᐊᕐᒥ ᖃᓂᒻᒪᒍᑕᐅᕙᓪᓕᐊᔪᖅ
panic	ᐅᐃᒻᒪᒃᓴᕋᐃᓪᓗᓂ
pants	ᖃᕐᓖᒃ
paper	ᐸᐃᑉᐹᖅ
paradise	ᐅᐃᒻᒪᒃᓯᒪᔪᖅ
parallel	ᓴᓂᓕᕇᒃ
parcel	ᒍᓘᓯᐊ
pardon	ᐃᓱᒪᒋᔪᓐᓇᐃᕐᓂᖅ
parents	ᐊᖓᔪᖅᑳᑦ
park	ᒥᕐᖑᐃᖅᓯᕐᕕᒃ
parrot	ᐸᓚᐅᑦ
parsley	ᐸᑦᔅᓕ
part	ᐃᓚᖓ
participate	ᐃᓚᐅᓂᖅ
particular	ᐱᓗᐊᖅᑐᒥᑦ
particularly	ᐱᓗᐊᖅᑐᒥ
partner	ᐊᐃᑉᐸᖅ
party	ᐱᓕᕆᖃᑎᒌᑦ
pass	ᐊᓂᒍᐃᓂᖅ
pass	ᖄᖏᖅᓂᖅ
passage	ᐊᖅᑯᑕᐅᔪᖅ
passed	ᑲᔪᓯᔪᖅ
passion	ᖁᕕᐊᒋᔭᖃᕐᓂᖅ
passionate	ᐱᔪᒪᓂᖃᑦᑎᐊᕐᓂᖅ
passive	ᐊᓂᒍᐃᔪᖅ
password	ᐃᓯᕈᓐᓇᐅᑎᖓ
past	ᑭᖑᓂᙶᑦᑎᓐᓂ
patch	ᑎᒥᒧᑦ ᓂᐱᑎᒐᖅ
path	ᐊᖅᑯᑎᒃᓴᖅ
pathetic	ᖁᐱᕐᕈᐊᕐᔪᐃᑦ
patience	ᕿᓄᐃᓵᕐᓂᖅ
patient	ᐆᑕᖅᑭᓂᖅ
patient	ᐋᓐᓂᐊᕕᓕᐊᖅᓯᒪᔪᖅ
pattern	ᐃᒃᓯᕋᖅ
pause	ᓄᖅᑲᖓᓚᐅᑲᖕᓂᖅ
pavement	ᖁᐊᖅᑎᑕᒐᖅ
pay	ᐊᑭᓕᖅᑕᐅᓂᖅ
payment	ᐊᑭᓕᐅᑎᑦ
peace	ᓴᐃᓕᓂᖅ
peaceful	ᓴᐃᒪᔪᖅ
peach	ᐲᔅ
peak	ᖁᑦᑎᓛᖅ
pear	ᐱᐅᕐ
peas	ᐲᔅ
peculiar	ᐃᓕᒪᔪᖅ
pee	ᖁᐃᔪᖅ
peel	ᖄᖏᔭᖅᑐᖅ
peer	ᐃᓕᓐᓂᐊᖃᑎᒌᑦ
peers	ᐃᓕᓐᓂᐊᖃᑎᒌᑦ
pen	ᑎᑎᕋᐅᑦ ᐃᒪᓕᒃ
pencil	ᑎᑎᕋᐅᑦ ᐃᒪᓕᒃ
pending	ᓇᓗᓇᐃᕆᐊᓖᑦ
people	ᐃᓄᐃᑦ
pepper	ᐸᐸ
perceive	ᐃᓱᒪᑐᔪᖅ
perception	ᐃᓱᒪᒋᔭᖅ
perfect	ᐱᐅᔪᖅ
perform	ᐱᓕᕆᓂᖅ
performance	ᐊᐅᓚᑦᑎᐊᕐᓂᕐᒧᑦ ᑕᑯᑎᑦᑎᓂᖅ
perhaps	ᐃᒻᒪᖃ
period	ᓄᖅᑲᕈᑎ
permanent	ᐊᑕᐃᓐᓇᖅᑐᖅ
permission	ᐊᖏᕈᑕᐅᔪᖅ
permit	ᐱᔪᓐᓇᐅᑎ
perseverance	ᓴᐱᓕᖅᓴᕐᓂᖅ
persistent	ᓴᐱᓕᓱᐃᑦᑐᑦ
person	ᐃᓄᒃ
personal	ᐃᒻᒥᓐᓅᖓᔪᑦ
personality	ᐃᓕᖅᑯᓯᖓ
perspective	ᑕᐅᑐᒃᑕᒃᑯᑦ
persuade	ᑎᓕᓯᓂᖅ
pervert	ᓴᖑᖓᓂᖓ
pet	ᑎᒍᐊᖅ
phase	ᐱᓕᕆᐊᖑᓂᖓ
phenomenon	ᐸᐃᓐᒥᓐ
philosophy	ᐅᒃᐱᕆᔭᐅᔪᑦ
phone	ᐅᖄᓚᐅᑎ
photo	ᐊᔾᔨᙳᐊᖅ
phrase	ᐅᖃᕈᓯᖅ
physical	ᑎᒥᒃᑯᑦ
pick	ᓂᕈᐊᕐᓗᑎᒃ
pick up	ᐊᐃᒃᖠᕐᓂᖅ
picture	ᐊᔾᔨᙳᐊᖅ
piece	ᐊᒡᒍᖅᑐᖅ
pieces	ᐊᒡᒍᖅᓯᒪᔪᑦ
pig	ᑰᑯᓯ
pigeon	ᐱᔾᔫᖅ
pile	ᑲᑎᙵᔪᑦ
pillow	ᐊᑭᓯᖅ
pilot	ᖃᖓᑕᓲᖅᑎ
pin	ᑲᑭᖅᑯᐊᖅ
pineapple	ᐸᐃᓐᐋᐳᓪ
pink	ᐊᐅᐸᔪᒃᑐᖅ
pit	ᐃᓗᑦᑐᖅᑎᖅᓯᒪᔪᖅ
pitch	ᐃᓗᑦᑐᖅᑎᓯᒪᔪᖅ
pity	ᓂᑲᒍᓱᖕᓂᖅ
place	ᐃᓂ
places	ᓄᓇᐃᑦ
plague	ᓯᖒᔭᖅᑐᖅ
plain	ᑐᑭᓯᓇᖅᑐᖅ
plan	ᐸᕐᓇᐅᑎ
plane	ᖃᖓᑕᓲᖅ
plant	ᐆᒻᒪᖅᑯᑎᖃᕐᕕᒃ
plants	ᐱᕈᖅᑐᕕᓃᑦ
plate	ᐸᓕᐊᖅ
platform	ᑐᙵᕕᐊ
play	ᐱᙳᐊᕐᓂᖅ
playing	ᐱᙳᐊᕐᓂᖅ
pleasant	ᖁᕕᐊᓇᖅ
please	ᐊᑏ
please	ᐊᑏᑐᖅ
pleased	ᖁᕕᐊᓱᒃᑐᖅ
pleasure	ᖁᕕᐊᓱᒋᑦ
pledge	ᓱᓕᓂᐊᕐᓂᕋᕐᓂᖅ
plenty	ᐊᒥᓱᑦ
plot	ᐃᓂ
plug	ᑲᐳᔾᔭᕐᕕᒃ
plum	ᐸᐅᙵᕐᔪᐊᖁᑖᖅ
plumber	ᓱᓪᓗᓕᕆᔨ
plural	ᖃᖅᓴᐅᑦ
podcast	ᓈᓚᐅᑎᕋᓛᖅ
poem	ᐅᓂᒃᑳᖅᑐᐊᖅ
poetry	ᖃᕆᐊᑦ
point	ᓄᕗᐊ
poison	ᑐᖁᓐᓇᖅᑐᖅ
police	ᐸᓖᓯ
policy	ᐊᑐᐊᒐᖅ
polite	ᐃᒃᑭᑎᓕᒃ
pollution	ᓱᕈᕐᓇᖅᑐᖅ
pond	ᑕᓯᐊᕐᔪᒃ
pool	ᐳᐃᔾᔪᕋᕐᕕᒃ
poop	ᐊᓇᖅ
poor	ᐊᔪᖅᓴᖅᑐᖅ
pop	ᐃᒥᒐᖅ
popular	ᐱᔭᐅᔪᒪᔪᖅ
population	ᐃᓄᒋᐊᖕᓂᖏᑦ
pork	ᑰᑰᓯ
porridge	ᑐᖅᑐᐊᕐᕕᒃ
port	ᑐᓚᒃᑕᕐᕕᒃ
position	ᐃᖅᑲᓇᐃᔮᖓ
positive	ᐱᐅᔪᑦ
possess	ᐱᓯᒪᒃᖠᖅᑐᖅ
possession	ᐱᓯᒪᒃᖠᕐᓂᖅ
possessive	ᐱᓯᒪᒃᖠᖅᑐᖅ
possible	ᐊᔪᕐᓇᙱᑐᐃᓐᓇᕆᐊᓕᒃ
post	ᓴᖅᑭᑕᐅᔪᒃᓴᖅ
postpone	ᑭᖑᕙᕆᐊᖅᑕᐅᓂᖓ
potato	ᐸᑏᑎ
potential	ᑕᐃᒪᐅᑐᐃᓐᓇᕆᐊᓕᒃ
potential	ᐱᑐᐃᓐᓇᕆᐊᓕᒃ
pound	ᐸᐅᓐ
poverty	ᐊᔪᖅᓴᕐᓂᖅ
power	ᐆᒻᒪᖅᑯᑎ
powerful	ᓴᖖᒋᔪᖅ
practical	ᐊᑐᕐᓂᖃᕈᓐᓇᑦᑎᐊ
practice	ᐱᓕᒻᒪᒃᓴᕐᓂᖅ
praise	ᐅᐱᒍᓱᖕᓂᖅ
prank	ᒥᖒᔭᖅᑐᖅ
pray	ᑐᒃᓯᐊᕐᓂᖅ
precious	ᐊᑭᑐᓂᓕᒃ
precise	ᓯᐊᕈᐊᖅᑐᖅ
precisely	ᐄᑦᑎᐊᖅ
predict	ᓇᓚᐅᑦᑖᕐᓂᖅ
prefer	ᓂᕈᐊᕐᓂᖅ
preference	ᐱᔪᒥᒋᔭᐅᓂᖅᓴᑦ
pregnant	ᓇᔾᔨᔪᖅ
prejudice	ᐊᑭᕋᖅᑐᕐᓂᖅ
premises	ᐃᓂᒋᔭᐅᔪᖅ
premium	ᓇᓕᕆᐊᖑᒃᑲᓐᓂᖅᑐᑦ
preparation	ᐱᕙᒌᔮᕐᓂᖅ
prepare	ᐱᕙᒌᔭᖅᓯᒪᓂᖅ
prepared	ᐱᕙᒌᔭᖅᓯᒪᔪᖅ
preposition	ᐅᖃᐅᓯᖅ ᓇᓗᓇᐃᔭᐅᑎᑦ
presence	ᐱᑕᖃᕐᓂᖓ
present	ᒫᓐᓇᐅᔪᖅ
presentation	ᐅᓂᒃᑳᕆᐊᖅᑐᖅᑐᑦ
preserve	ᔭᒐᔾᔭᐃᕐᓗᒍ
president	ᐊᖓᔪᖅᑳᖅ
press	ᐱᕙᓪᓕᐊᔪᖅ
pressure	ᓴᙱᓂᖓ
pretend	ᓯᕗᓂᐊᒍᑦ
pretty	ᐃᓂᖁᓇᖅᑐᖅ
pretty	ᐱᐅᔪᖅ
prevent	ᐱᑦᑕᐃᓕᑎᑦᑎᓂᖅ
previous	ᑭᖑᓂᖔᑦᑎᓐᓂ
prey	ᓂᖀᑦ
price	ᐊᑭᖓ
pride	ᐅᐱᒍᓱᖕᓂᖅ
priest	ᐃᒃᓯᕋᕐᔪᐊᖅ
primary	ᓯᕗᓪᓕᖅ
prime	ᐱᒻᒪᕆᐅᔪᖅ
princess	ᐃᑎᖅᓴᑦ
principal	ᐃᓕᓴᐃᔨᓄᑦ ᐊᖓᔪᖅᑳᖅ
prior	ᓯᕗᓂᐊᓂ
priority	ᓯᕗᓪᓕᐅᑎᔭᕆᐊᓖᑦ
prison	ᐊᓄᓪᓚᒃᓰᕕᒃ
privacy	ᑲᙳᓇᖅᑐᑦ
private	ᐃᒻᒥᒃᑰᖅᑐᖅ
privilege	ᐱᕕᖃᕐᓂᖅ
prize	ᓵᓚᒃᓴᐅᓯᐊᒃᓴᖅ
probably	ᐃᒻᒪᖄ
problem	ᐊᑲᐅᙱᓕᐅᕈᑎ
procedure	ᐱᓕᕆᔾᔪᓯᖅ
proceed	ᑲᔪᓯᓗᑎᑦ
process	ᐱᒋᐊᕈᑕᐅᔪᑦ
produce	ᓴᖅᑭᑦᑎᔪᖅ
product	ᓂᖀᑦ
production	ᓴᓇᔭᐅᓂᖓ
profession	ᐃᖅᑲᓇᐃᔮᕆᓪᓚᕆᒃᑕᖓ
professional	ᐱᓕᕆᔪᓐᓇᓪᓚᕆᒃᑐᑦ
profile	ᖃᓄᐃᓕᖓᓂᖓ
profit	ᑮᓇᐅᔭᓕᐊᑦ
profound	ᐃᑉᐱᓐᓇᕐᔪᐊᖅᑐᖅ
profound	ᖃᐅᔨᒪᔨᒻᒪᕆᒃ
progress	ᖃᓄᐃᑉᐸᓪᓕᐊᓂᖓ
project	ᐱᓕᕆᐊᖅ
prominent	ᓴᖅᑭᔮᖅᑐᖅ
promise	ᓱᓕᓂᐊᕐᓂᕋᕐᓂᖅ
promote	ᖁᕝᕙᖅᐹᓪᓕᖅᑎᓪᓗᒍ
promotion	ᖁᕝᕙᖅᓴᖅᑕᐅᓂᖓ
prompt	ᐱᑲᐅᑦᑐᕆᐊᓕᒃ
prone	ᓂᐊᖅᑭᖓᔪᖅ
pronouns	ᐅᖃᐅᓯᖅ ᐅᖃᐅᓯᕆᔭᖅ
pronunciation	ᐅᖃᑦᑎᐊᕐᓂᖅ
proof	ᓇᓗᓇᐃᕈᑦ
proper	ᓈᒻᒪᒃᑐᖅ
properly	ᑕᒻᒪᖓᙱᖦᖢᓂ
properties	ᐱᖁᑎᒋᔭᐅᔪᑦ
property	ᐱᖁᑎᒋᔭᐅᔪᖅ
proposal	ᑐᒃᓯᕋᐅᑦ
prospect	ᐅᔭᕋᒃᓯᐅᕐᓂᖅ
prosperity	ᐊᔪᖅᓴᕈᓐᓃᕐᓂᖅ
prosperous	ᐱᕈᖅᐸᓪᓕᐊᔪᖅ
protect	ᓴᐳᔾᔨᓯᒪᓂᖅ
proud	ᓴᕆᒪᓱᒃᑐᖅ
prove	ᓇᓗᓇᐃᖅᓯᓂᖅ
provide	ᑐᓂᓯᔪᑦ
provide	ᐱᒋᐊᕈᑦ
provided	ᐱᑎᑕᐅᔪᖅ
province	ᐊᕕᒃᑐᖅᓯᒪᓂᖓ
provision	ᒪᓕᒋᐊᓖᑦ
puberty	ᐃᔾᔨᐅᕐᓂᖅ
public	ᑭᒃᑯᑐᐃᓐᓇᑦ
pull	ᓄᑦᑑᔾᔪᐊᕐᓂᖅ
pumpkin	ᒥᓪᓗᐊᕈᑦ
punctual	ᑭᖑᕙᖅᑐᖅ
pupil	ᐃᓕᓐᓂᐊᖅᑎ
purchase	ᓂᐅᕕᐊᑦ
pure	ᐃᓚᒃᓴᖃᙱᑦᑐᖅ
purple	ᑐᙳᑑᖅᑐᖅ
purpose	ᐱᔾᔪᑎ
purse	ᐊᕐᓇᐅᑉ ᐴᖓ
pursue	ᐱᓇᓱᐊᕐᓂᖅ
pursuit	ᐱᓇᓱᐊᕐᓂᖅ
push	ᐊᔭᒃᓯᓂᖅ
put	ᐃᓕᓗᒍ
qualification	ᐊᔪᙱᓐᓂᕆᔭᐅᔪᑦ
quality	ᐱᐅᓂᕆᔭᖓ
quantity	ᖃᔅᓯᐅᓂᖏ
quarantine	ᐊᓂᑦᑕᐃᓕᔭᕆᐊᖃᖅᑎᑕᐅᔪᑦ
quarrel	ᐊᑭᕋᖅᑑᑎᔪᑦ
quarter	ᑕᖅᑮᑦ ᐱᖓᓱᑦ ᓈᑎᓪᓗᒋᑦ
Quechua	ᑯᐊᑐᐊ
queen	ᑯᐃᓐ
queer	ᐊᖑᑎᖃᑎᒧᐊᓱᖅᑐᖅ
queer	ᐊᕐᓇᖃᑎᒥᓄᐊᓱᖅᑐᖅ
query	ᑭᒡᒍᓯᖅ
question	ᐊᐱᖅᑯᑎ
queue	ᐅᑕᖅᑭᕝᕕᒃ
quick	ᑐᐊᕕᕐᓗᑎᑦ
quickly	ᑐᐊᕕᖅᑐᖅ
quiet	ᓂᐱᑭᓪᓗᓂ
quilt	ᖂᔪᓕᒃ
quit	ᓄᖅᑲᕐᓂᖅ
quite	ᐄᒻᒪᕆᒃ
quite	ᐊᒃᓱᐊᓗᒃ
quiz	ᐊᐱᖅᓲᑎ
quotation	ᐊᑭᒃᓴᓄᑦ
quote	ᐅᖃᕐᓗᒍ
quotes	ᐅᖃᐅᓯᐅᔪᑦ
rabbit	ᐱᖦᖤᙱᓴᕐᓂᖅ
race	ᓱᒃᑲᓴᐅᔾᔪᐊᖅᑐᑦ
rage	ᖃᒥᙶᖅᑐᖅ
rain	ᒪᖁᒃᑐᖅ
raise	ᖁᕝᕙᖅᓯᓂᖅ
raised	ᐱᕈᖅᓴᔪᖅ
ran	ᐅᓪᓚᓚᐅᖅᑐᖅ
random	ᓇᑭᑐᐃᓐᓇᖅ
range	ᐊᑕᓂᖃᖅᑐᑦ
rapid	ᓱᒃᑲᔪᖅ
rapidly	ᓱᒃᑲᔪᒥᒃ
rare	ᐱᒐᔪᙱᑦᑐᖅ
rarely	ᐱᒐᔪᙱᑦᑐᖅ
rash	ᐊᒥᕐᓗᒃᑐᖅ
rat	ᐸᓚᐅᒐᖅ
rate	ᖃᔅᓯᐅᓂᖓ
rather	ᐃᒪᓐᓇᖔᖅ
rather	ᑎᐊᒪᓇᖔᖅ
ratio	ᖃᔅᓯᐅᓂᖏᑦ
rational	ᐊᔾᔨᒌᓕᖅᑎᑕᐅᓂᖅ
raw	ᐃᒐᓯᒪᙱᑦᑐᖅ
re	ᐱᔾᔪᑎᓕᒃ
reach	ᑎᑭᓪᓗᒍ
reached	ᑎᑭᓯᒪᔪᖅ
reaction	ᖃᓄᐃᔾᔪᑎᖃᕐᓂᖅ
read	ᐅᖃᓕᒫᕐᓂᖅ
reading	ᐅᖃᓕᒫᕐᓂᖅ
ready	ᐱᔭᕇᖅᓯᒪᔪᖅ
real	ᐱᓪᓚᕆᒃ
reality	ᐱᓪᓚᑦᑖᖅᑐᑦ
realize	ᐅᔾᔨᕈᓱᓕᕐᓂᖅ
realized	ᐅᔾᔨᕆᔭᐅᔪᖅ
really	ᒻᒪᕆᒃ
really	ᐊᓱᐃᓛᒃ
rear	ᑐᓄᐊᓂ
reason	ᐱᔾᔪᑎ
reasonable	ᓈᒻᒪᒃᑐᖅ
recall	ᐃᖅᑲᐅᒪᓂᖅ
receipt	ᐊᑭᓕᒃᓴᖅ
receive	ᐱᔪᖅ
received	ᐱᔭᐅᔪᖅ
recent	ᖃᖓᑦᑎᐊᓕᓴᖅ
recently	ᒫᓐᓇᓵᖅ
reception	ᑎᑎᕋᖅᑎ
recipe	ᓂᖅᖠᐅᒐᒃᓴᖅ
reckless	ᐅᖏᓚᖕᓇᙱᑦᑐᖅ
recognition	ᐃᓕᑕᕆᓗᒍ
recognize	ᐃᓕᓴᖅᓯᓂᖅ
recommend	ᐊᑐᓕᖁᔭᐅᔪᑦ
recommended	ᐊᑐᓕᖁᔭᐅᔪᑦ
record	ᑎᑎᕋᖅᑕᐅᓯᒪᓂᖏᑦ
recover	ᐅᑎᖅᑐᖅ
recovery	ᐊᓐᓇᒃᐸᓪᓕᐊᓂᖅ
rectangle	ᑎᕆᖅᑯᐊᖅ
red	ᐊᐅᐸᖅᑐᖅ
redeem	ᐊᐅᐸᖅᑐᖅ
redemption	ᐅᑎᖅᑎᑦᑎᓂᖅ
reduce	ᒥᑭᓪᓕᕚᓪᓕᕆᐊᕐᓂᖅ
redundant	ᐊᑑᑎᖃᙱᑦᑐᖅ
refer	ᑐᓐᓂᖅᑯᑎᒋᓗᒍ
reference	ᑐᓴᕆᐊᕐᕕᐅᔪᓐᓇᖅᑐᑦ
reflect	ᐃᖅᑲᒍᓱᒃᑐ
reflection	ᐃᓱᒪᒃᓴᖅᓯᐅᕐᓂᖅ
refrain	ᐱᑦᑕᐃᓕᓂᖅ
refrigerator	ᖁᐊᒃᑯᕕᒃ
refund	ᐅᑎᖅᑐᒃᓴᑦ
refuse	ᐋᒡᒑᖅᑐᖅ
refused	ᕿᐱᓗᒃᑕᐅᔪᖅ
regard	ᐅᕙᙶᖅᑐᖅ
regarding	ᐱᔾᔪᑎᓕᒃ
regardless	ᖃᓄᐃᒐᓗᐊᖅᑎᓪᓗᒍ
regards	ᐅᕙᙶᖅᑐᖅ
region	ᐊᕕᒃᑐᖅᓯᒪᓂᖓ
register	ᐊᑎᓕᐅᕐᕕᒃ
regret	ᓯᕐᓕᕿᔪᖅ
regular	ᐊᑐᒐᔪᒃᑐᖅ
regularly	ᖃᖓᙳᑐᐊᕌᖓᑦ
reject	ᐱᙲᓐᓇᖅᑐᖅ
relate	ᐊᒃᑐᐊᓂᖃᖅᑐᖅ
related	ᐊᒃᑐᐊᓂᓕᒃ
relationship	ᐃᓅᖃᑎᒌᖕᓂᖅ
relative	ᐃᓚᖓ
relatives	ᖃᑕᙳᑎᒋᔭᐅᔪᑦ
relax	ᓴᐃᓕᓂᖅ
release	ᓴᒃᑯᑕᐅᓂᖅ
released	ᓴᒃᑯᑕᐅᔪᖅ
relevant	ᑖᓐᓇᓪᓚᕆᒃ
reliable	ᑕᑎᒋᔭᒃᓴᐅᔪᖅ
relief	ᐃᑲᔪᖅᑕᐅᓂᖅ
relieve	ᖃᓱᖓᔪᖅ
relieved	ᖃᓱᔪᖅ
religion	ᐅᒃᐱᕐᓂᖅ
religious	ᐅᒃᐱᕐᓂᖅ
reluctant	ᐃᖢᕆᒃᑐᖅ
rely	ᑕᑎᖃᕐᓂᖅ
remain	ᓱᓕ
remaining	ᐊᒥᐊᒃᑯᐊ
remarkable	ᐱᐅᔪᑦ
remedy	ᐋᖅᑭᒐᒃᑎᒋᐊᕈᑎ
remember	ᐃᖅᑲᐃᓂᖅ
remember	ᐃᖅᑲᐅᒪᓂᖅ
remind	ᐃᖅᑲᐃᑎᑦᑎᓂᖅ
reminder	ᐃᖅᑲᐃᑎᑦᑎᔾᔪᑎ
remote	ᐅᖓᓯᒃᑐᒥᑦ
remove	ᐲᕐᓗᒍ
render	ᑕᓗᕈᒃᑯᑎ
rent	ᐊᑐᖅᑐᐊᕈᑎᒧᑦ
repair	ᐋᖅᑭᒃᓱᖅᑕᐅᓂᖓᓄᑦ
repeat	ᐅᖃᒃᑲᓐᓂᕐᓗᒍ
replace	ᐊᓯᔾᔨᕐᓗᒍ
reply	ᑭᐅᓂᖅ
report	ᐅᓂᒃᑳᖅ
represent	ᑭᒡᒐᖅᑐᐃᓂᖅ
reputation	ᖃᐅᔨᒪᔭᐅᓂᖓ
request	ᑐᒃᓯᕋᐅᑎ
require	ᐱᔭᕆᐊᓕᒃ
required	ᐱᖁᔭᐅᓯᒪᔪᑦ
rescue	ᐸᖅᓴᖅᑕᐅᔪᑦ
research	ᖃᐅᔨᓴᕐᓂᖅ
resemble	ᑲᑎᒃᑲᓐᓂᕆᑦ
resentment	ᓂᑲᒍᓱᓐᓂᖅ
reservation	ᐃᓂᒃᓴᓕᐅᕐᓂᖅ
reserve	ᓴᓂᕐᕙᒃᑕᐅᓯᒪᔪᑦ
resident	ᓄᓇᖃᖅᑐᖅ
resign	ᓄᖅᑲᕐᓂᖅ
resilience	ᓴᐱᓕᖅᓴᕋᐃᙱᓐᓂᖅ
resilient	ᓴᐱᓕᖅᓴᕋᐃᙱᓐᓂᖅ
resist	ᐱᑦᑕᐃᓕᓂᖅ
resistance	ᐱᑦᑕᐃᓕᓂᖅ
resolution	ᐱᒋᐊᖅᑎᑦᑎᔪᖅ
resolve	ᐋᖅᑭᒐᓱᐊᕐᓗᒍ
resort	ᐅᐸᒐᒃᓴᖅ
resources	ᐃᑲᔫᑎᒃᓴᑦ
respect	ᐃᒃᐱᒍᓱᑦᑎᐊᕐᓂᖅ
respond	ᑭᐅᓗᑎᒃ
response	ᑭᒡᒍᓯᐊ
responsibility	ᑲᒪᒋᔭᒃᓴᑦ
responsible	ᑲᒪᒋᔭᖃᕐᓂᐊᖅᑐᖅ
rest	ᑕᖃᐃᖅᓯᕐᓂᖅ
rest in peace	ᑕᖃᐃᖅᓯᕐᓗᑎᑦ ᓴᐃᓕᓂᕐᒥᒃ
restaurant	ᓂᕆᕝᕕᒃ
restore	ᐅᑎᖅᑎᑦᑎᓂᖅ
restrict	ᑭᒡᓕᖃᖅᑎᑕᐅᔪᑦ
result	ᖃᓄᐃᓕᖓᓕᕐᓂᕆᔭᖏᑦ
results	ᖃᓄᐃᓕᖓᓂᖏᑦ
resume	ᐃᖅᑲᓇᐃᔮᕆᓯᒪᔭᖏᑦ ᑎᑎᕋᖅᓯᒪᔪᑦ
retail	ᓂᐅᕕᕐᕕᒃ
retain	ᐸᐸᑦᑎᓂᖅ
retention	ᐸᐸᑦᑎᓂᖅ
retired	ᐃᓐᓇᐅᓕᕐᓂᕐᒧᑦ ᐃᖅᑲᓇᐃᔭᕈᓐᓃᖅᑐᖅ
retreat	ᑲᑎᓐᓂᐅᔪᖅ
retrieve	ᐱᓂᖅ
return	ᐅᑎᖅᑐᖅ
reveal	ᖃᐅᔨᑎᑦᑎᓂᖅ
revealed	ᖃᐅᔨᔭᐅᔪᖅ
revenge	ᐱᒋᐊᒃᑲᓐᓂᖅᑐᖅ
revenue	ᑮᓇᐅᔭᖅᑖᖑᕙᓪᓕᐊᔪᑦ
reverse	ᑭᖑᑉᐱᐊᕐᓗᒍ
review	ᕿᒥᕐᕈᐊᕐᓂᖅ
revise	ᐋᖅᑭᒋᐊᕐᓗᒍ
revision	ᐋᖅᑭᒋᐊᖅᑕᐅᔪᖅ
revolution	ᐊᓯᔾᔨᖅᐸᓪᓕᐊᓂᖅ
reward	ᑐᓐᓂᖅᑯᓯᐊᑦ
rhythm	ᑲᓱᒃᑕᖅᑐᖅ
rib	ᑐᓕᒫᖏᑦ
rice	ᐊᓛᓯ
rich	ᐊᒃᖢᐃᖅᑐᖅ
rid	ᓴᒃᑯᐃᓂᖅ
ride	ᐃᑭᒪᓂᖅ
ridiculous	ᐱᓪᓗᕆᒃᑐᖅ
right	ᑕᓕᖅᐱᒃ
right	ᑕᒻᒪᙱᑦᑐᖅ
right now	ᒫᓐᓇ
rigid	ᐃᒡᔪᕋᖅᑐᖅ
ring	ᓇᒡᒍᐊᕐᒥᒃ
rinse	ᐃᕐᕈᖅᑐᕐᓗᒍ
riot	ᐸᑎᕋᖅᑐᖅ
rip	ᐊᓕᒃᑐᖅ
ripe	ᓂᖀᑦ
rise	ᒪᑭᓐᓂᖅ
risk	ᐊᑦᑕᕐᓇᖅᑑᔪᖅ
rival	ᐊᑭᕋᖓ
rival	ᖃᐅᔨᒪᔭᐅᑲᐅᑎᔪᖅ
river	ᑰᒃ
road	ᐊᖅᑯᑦ
roast	ᐃᒐᐅᑉ ᐃᓗᐊᓂ ᐆᔪᒃᑐᖅ
robust	ᐆᒻᒪᕆᒃᑐᖅ
rock	ᐅᔭᕋᒃ
rod	ᓂᕐᓕᒃ
role	ᐱᓕᕆᐊᒃᓴᑦ
roll	ᐃᒧᓯᒪᔪᖅ
roof	ᖁᓛ
room	ᐃᒡᓗᕈᓯᖅ
root	ᓇᑭᙶ ᓇᑭᙶ ᓇᑭᙶᕐᓂᖓ
rope	ᐊᒃᖢᓈᖅ
rotten	ᐃᒍᓇᖅ
rough	ᒪᓃᑦᑐᖅ
rough	ᑎᑎᕋᕐᖓᖅᑕᐅᔪᖅ
roughly	ᐃᓱᐃᓚᓗᒃ
round	ᐊᖕᒪᓗᖅᓯᓯᒪᔪᖅ
route	ᐊᖅᑯᑖ
routine	ᐊᑐᒐᔪᒃᑕᖓ
row	ᑐᑭᓕᕇᒃᑐᑦ
rub	ᐅᐊᓴᕐᕕᒃ
rubber	ᕿᐊᕋᐅᑎᑦ
rubbish	ᐃᖑᓚᒐᖅ
rude	ᐱᑦᑎᐊᙱᑦᑐᖅ
rug	ᐊᓗᕐᓗᐃᔭᐅᑦ
ruin	ᓱᕋᒃᑐᖅ
rule	ᒪᓕᒐᖅ
ruler	ᐆᒃᑐᕋᐅᑖ
rules	ᒪᓕᒐᒃᓴᐃᑦ
run	ᐊᑉᐸᒃᑐᖅ
run	ᐅᓪᓚᒃᑐᖅ
running	ᐅᓪᓚᒃᑐᖅ
rural	ᓄᓇᓕᒡᔪᐊᖑᙱᓐᓂᖅᓴᑦ
rush	ᑐᐊᕕᕐᓂᖅ
sack	ᐴᖅ
sacred	ᐊᓂᕐᓂᑦᑎᐊᖅ
sacrifice	ᑐᓂᓯᓂᖅ
safe	ᐊᑦᑕᕐᓇᙱᑦᑐᖅ
safe flight	ᖃᖓᑕᑦᑎᐊᕐᓂᖅ
safety	ᐊᑦᑕᕐᓇᖅᑕᐃᓕᒪᓂᖅ
sage	ᒥᓱᒃ
said	ᐅᖃᖅᐳᖅ
sail	ᐅᒥᐊᕋᓛᖅ
sailing	ᑯᓂᒃᑐᖅ
sake	ᑐᖑᔪᖅ
salary	ᑮᓇᐅᔭᓕᐊᖅ
sale	ᓂᐅᕕᐊᒃᓴᖃᕐᓂᖅ
salmon	ᓵᓚᒪᓐ
salt	ᑕᕆᐅᖅ
same	ᐊᔾᔨᑐᐃᓐᓇᖓ
Same here	ᐊᔾᔨᖓ ᐅᕙᓂ
sample	ᐆᒃᑑᑎᒃᓴᖅ
sand	ᓯᐅᕋᖅ
Sanskrit	ᓵᓐᔅᑯᕆᑦ
sarcastic	ᐅᖃᐅᓯᖃᑦᑎᐊᙱᓐᓂᖅ
sassy	ᓴᔪᒃᑐᖅ
sat	ᐃᒃᓯᕚᖅᑐᖅ
satisfaction	ᓈᒻᒪᒃᓴᕐᓂᖅ
satisfied	ᓇᒻᒪᒋᔭᖅ
satisfy	ᓈᒻᒪᒋᔭᖅ
satisfying	ᓈᒻᒪᒃᓴᕐᓂᖅ
Saturday	ᐊᓪᓕᖏᓱᖓᕐᑐᑦ
sausage	ᐅᓲᔭᖅ
savage	ᐆᒪᔪᑦ
save	ᐱᐅᓕᒃᖠᓂᖅ
saw	ᑕᑯᔪᖅ
say	ᐅᖃᕐᓂᖅ
say	ᐅᖃᖅᑐᖅ
scale	ᓈᓴᐅᑦ
scam	ᓴᒡᓗᔪᖅ
scar	ᑭᓕᕐᓂᑯ
scarce	ᐊᔪᖅᓴᕐᓂᖅ
scared	ᑲᑉᐱᐊᓱᖅᑐᖅ
scarf	ᖁᖓᓯᕈᖅ
scary	ᑲᑉᐱᐊᓇᖅᑐᖅ
scattered	ᓯᖃᓕᓯᒪᔪᖅ
scene	ᑕᑯᕝᕕᐅᔪᖅ
scenery	ᑲᖏᖅᑐᖅ
scent	ᑎᐱᖓ
schedule	ᐸᕐᓇᐅᑦ
schedule	ᑐᓄᐊᓂ ᑎᑎᕋᖅᓯᒪᔪᑦ
schedule	ᐃᓂᒃᓴᖅ
school	ᐃᓕᓐᓂᐊᕐᕕᒃ
science	ᖃᐅᔨᓴᖅᑐᓕᕆᓂᖅ
scientist	ᖃᐅᔨᓴᖅᑎ
scientists	ᖃᐅᔨᓴᖅᑎᑦ
scissors	ᑭᔾᔭᐅᑏᒃ
scold	ᓯᓪᓗᔪᖅ
scope	ᐊᖏᑎᒋᓂᖓ
score	ᓈᓴᐅᑎ
scrap	ᐊᒥᐊᒃᑯᐃᑦ
scrap	ᓱᕙᓕᑭᐊᖅ
scratch	ᕿᑦᓱᒃ
scream	ᓴᒡᓗᔪᖅ
screen	ᐃᒐᓛᖑᔭᖅ
screw	ᕿᔾᔮᖅ
script	ᑎᑎᕋᖅᓯᒪᔪᑦ
sea	ᑕᕆᐅᖅ
seal	ᓇᑦᑎᖅ
search	ᕿᓂᕐᓂᖅ
season	ᐊᕐᕌᒎᑉ ᐃᓚᖓᓂ
seat	ᐃᒃᓯᕙᐅᑕᖅ
second	ᐊᐃᑉᐸᖓ
secret	ᐃᔨᕋᖅᑐᖅ
section	ᐊᒡᒍᖅᓯᒪᓂᖓ
secure	ᐱᔭᐅᔾᔭᐃᖅᓯᒪᓂᖅ
security	ᓇᐅᑦᑎᖅᓱᖅᑎᑦ
see	ᑕᑯᓗᒍ
see you	ᑕᑯᓂᐊᕆᕙᒋᑦ
see you later	ᑕᑰᑎᓛᕆᕗᒍᒃ(ᑦ)
see you soon	ᑕᑯᓂᐊᕆᕗᒍᑦ
see you tomorrow	ᖃᐅᒃᐸᑦᑕᐅᖅ
seed	ᐱᕈᖅᓯᐊᒃᓴᖅ
seek	ᕿᓂᕐᓂᖅ
seem	ᐃᒪᓐᓇᐅᖅᑰᔨᔪᖅ
seems	ᐃᒪᓐᓇᐅᖅᑰᔨᔪᖅ
seen	ᑕᑯᔭᐅᔪᖅ
seize	ᑎᒍᓯᓂᖅ
seldom	ᐊᑐᒐᔪᐃᖅᑐᖅ
select	ᓂᕈᐊᕐᓂᖅ
self	ᓇᖕᒥᓂᖅ
self healing	ᐃᒻᒥᓂᒃ ᒪᒥᓴᕐᓂᖅ
selfish	ᐃᖕᒥᓂᒃ ᐱᔪᖅ
sell	ᓂᐅᕐᕈᑎᖃᕐᓂᖅ
send	ᓇᒃᓯᐅᑎᓂᖅ
send	ᐊᐅᓪᓚᖅᑎᓐᓂᖅ
send me your picture	ᐊᔾᔨᖁᑎᑦ ᓇᒃᓯᐅᑎᙵ
senior	ᐊᖓᔪᒃᖡᑦ
sense	ᑐᑭᓯᓇᖅᑐᖅ
sensible	ᑐᑭᓯᓇᖅᑐᖅ
sensitive	ᐃᒃᐱᒍᓱᒃᓴᕋᐃᑦᑐᖅ
sent	ᓇᒃᓯᐅᔾᔭᖅ
sentence	ᖃᓄᐃᓕᔭᐅᓂᖅ
sentences	ᐊᓄᓪᓚᒃᓯᕐᓃᑦ
separate	ᐊᑐᓃᖓᔪᖅ
Sepedi	ᓯᐱᑎ
september	ᐊᒥᕋᐃᔭᐅᑦ
september	ᓯᑉᑎᒻᐱᕆ
sequence	ᑭᖑᓕᕆᖕᓂᖏᑦ
series	ᑭᖑᓕᕇᑦ
serious	ᓴᒡᓗᙱᑦᑐᖅ
seriously	ᐱᒻᒪᕆᐊᓗᒃ
serve	ᓂᕆᑎᑕᐅᓂᖅ
service	ᐱᔨᑦᑎᕐᓂᖅ
session	ᐃᓕᓐᓂᐊᕐᓇᖅ
set	ᐋᖅᑭᑦᓯᒪᓂᖓ
set up	ᐋᖅᑭᒃᓱᐃᓂᖅ
setting	ᐋᖅᑭᒃᓯᒪᓂᖓ
settle	ᐋᖅᑭᒃᓯᒪᓂᖓ
seven	ᓯᑕᒪᐅᔪᖏᒐᕐᑐᖅ
seventeen	ᑕᓪᓕᒪᐅᔪᕐᑐᓗ ᓯᑕᒪᐅᔪᖏᒐᕐᑐᓗ
seventy	ᐊᕙᑏᑦ ᓯᑕᒪᐅᔪᖏᒐᕐᑐᑦ
several	ᖃᔅᓯᑲᓪᓚᐃᑦ
severe	ᐱᕐᔪᐊᖅᑐᖅ
sew	ᒥᖅᓱᕐᓂᖅ
sh	.sh
shade	ᑕᖅᓯᖅ
shadow	ᐃᖅᓴᖓ
shake	ᓴᔪᖕᓂᖅ
shall	ᐃᒪᐃᓐᓂᐊᖅᐳᖅ
shallow	ᐃᒃᑲᑦᑐᑯᑖᒃ
shame	ᑲᓐᖑᓇᖅ
shape	ᓴᓇᒪᓂᖓ
share	ᐊᒥᖅᑳᖃᑎᖃᕐᓂᖅ
sharp	ᐃᐱᒃᑐᖅ
she	ᐅᓇ
she has	ᐱᓯᒪᔪᖅ
she is	ᑕᐃᒪᐃᑦᑐᖅ
shed	ᓯᕐᓗᐊᖅ
sheep	ᓯᓕᑉ
sheet	ᑎᑎᕋᕐᕕᒃᓴᖅ
shelf	ᖁᓕᕈᐊᖅ
shell	ᓯᐅᓪᑎᐅᓪ
shelter	ᐃᓂᒃᓴᖅ
shield	ᓴᐳᒻᒥᔾᔪᑎ ᑎᒥᒧᑦ
shift	ᓇᖑᓚᔪᖅ
shine	ᓯᓕᒃᑐᖅ
ship	ᐅᒥᐊᕐᔪᐊᖅ
shipping	ᐊᐅᓪᓚᖅᑎᑕᐅᔾᔪᑎᖏᑦ
shirt	ᐃᑭᐊᖅᖠᖅ
shoes	ᐃᓯᒐᐅᔭᑦ
shoot	ᖁᑭᕆᐊᕐᓂᖅ
shop	ᓴᓇᕝᕕᒃ
shopping	ᓂᐅᕕᕆᐊᕐᓂᖅ
shore	ᓯᒡᔭ
short	ᓇᐃᑦᑐᖅ
shortage	ᐊᒥᒐᖅᓯᓂᖅ
shot	ᖁᑭᕆᐊᖅᓯᓂᖅ
should	ᓇᔭᕐᒪᑦ
shoulder	ᑐᐃ
shout	ᑐᖅᖢᓚᔪᖅ
show	ᑕᑯᒃᓴᐅᑎᑦᑎᓂᖅ
show me	ᑕᑯᑎᙵ
shower	ᐅᕕᓂᓐᓂᐊᕐᓂᖅ
shrimp	ᑭᖑᒃᐸᒃ
shrink	ᐃᕿᓱᒃᑐᖅ
shut	ᒪᑐᓗᒍ
shut up	ᓂᐱᖃᙱᓚᐅᕆᑦ
shy	ᑲᙳᓱᒃᑐᖅ
sibling	ᖃᑕᙳᑎ
siblings	ᖃᑕᙳᑎᑦ
sick	ᖃᓂᒪᔪᖅ
side	ᓴᓂᕋᖅ
sigh	ᓯᒡᒑᒃ
sight	ᑕᐅᑐᖕᓂᖅ
sightseeing	ᑕᐅᑐᖕᓂᖅ
sign	ᐃᑎᓕᐅᕈᓯᖅ
sign	ᓇᓗᓇᐃᒃᑯᑕᖅ
signature	ᐊᑎᓕᐅᕈᓯᖅ
significant	ᐱᒻᒪᕆᐅᔪᖅ
silence	ᓂᐸᐃᓐᓂᖅ
silent	ᓂᐱᖃᖏᑦᑐᖅ
silk	ᐱᓱᔪᒃ
silly	ᑐᑭᖃᙱᙳᐊᖅᑐᖅ
silver	ᖃᑯᕐᓕᖅ
similar	ᐊᔾᔨᐸᓗᐊ
simp	ᓯᕐᒥᓕᕐᓂᖅ
simple	ᐊᔪᕐᓇᙱᑦᑐᖅ
simultaneously	ᐊᑕᐅᑦᑎᒃᑯᓪᓗ
since	ᑕᐃᒪᙵᓂᑦ
sincere	ᐅᕙᙶᖅᑐᖅ
sincerely	ᐅᕙᙶᖅᑐᖅ
sing	ᐃᙱᕐᓂᖅ
singer	ᐃᙱᖅᑎ
single	ᐃᓄᑐᐊᖅ
single	ᐊᑕᐅᓯᑐᐊᖅ
sink	ᐅᐊᓴᕐᕕᒃ
Sir	ᐊᖑᑦ
sister	ᓄᑲᖅ
sister	ᓇᔭ
sister in law	ᐅᑯᐊᖅ
sit	ᐃᒃᓯᕚᑐᐃᓐᓇᕐᓂᖅ
site	ᐃᓂᖓ
situation	ᖃᓄᐃᓐᓂᕆᔭᐅᔪᖅ
six	ᐱᖓᓲᔪᕐᑐᖅ
six	ᐊᕐᕕᓂᓖᑦ
sixteen	ᑕᓪᓕᒪᐅᔪᕐᑐᓗ ᐱᖓᓲᔪᕐᑐᓗ
sixty	ᐊᕙᑏᑦ ᐱᖓᓲᔪᕐᑐᑦ
size	ᐊᖏᓂᖓ
skill	ᐊᔪᙱᑕᖏᑦ
skills	ᐊᔪᙱᑕᖃᕐᓂᖅ
skin	ᐊᒥᖅᑐᖅ
skinny	ᓴᓗᒃᑐᖅ
skip	ᓯᐊᕐᕆᓯᖅ
skirt	ᐊᖏᔪᖅᑕᖅ
sky	ᕿᓚᒃ
slave	ᓯᓚᐃᕐᕆᔪᖅ
sleep	ᓯᓂᖕᓂᖅ
sleeping	ᓯᓂᖕᓂᖅ
sleepy	ᐅᐃᕐᖓᖅᑐᖅ
sleeve	ᑕᓕᕕ
slice	ᓯᖃᒃᑎᔪᖅ
slide	ᐊᔾᔨᙳᐊᖅ
slightly	ᓯᕐᓚᕈᓗᒃ
slim	ᖃᒧᑎ
slip	ᖁᐊᔭᕿᔪᖅ
slope	ᓯᕕᖓᓂᖓ
slot	ᐃᓂᖓ
slow	ᓱᒃᑲᐃᑦᑐᖅ
slowly	ᓱᒃᑲᐃᑦᑐᖅ
small	ᒥᑭᑦᑐᖅ
smart	ᓯᓚᑐᔪᖅ
smell	ᓇᐃᖓ
smile	ᖁᖓᑦᑐᖅ
smoke	ᐳᔪᖅ
smooth	ᒪᓐᓇᕆᒃ
smooth	ᒪᓂᑦᑐᖅ
snack	ᑕᒧᓗᒐᒃᓴᑦ
snail	ᑯᑭᖓ
snake	ᐃᒃᑭᖅ
snap	ᓯᓂᓚᐅᑲᒃ
snow	ᐊᐳᑦ
so	ᓲᕐᓗ
so cute	ᐱᐅᔪᑯᓗᒃ
so far	ᒫᓐᓇᒧᑦ ᑎᑭᖦᖢᒍ
soak	ᓴᙲᑦᑐᑯᓘᒃ
soap	ᐅᐊᓴᐅᑎ
sober	ᓱᓐᓂᐅᒪᓂᖅ
soccer	ᐊᖅᓴᕐᓂᖅ
social	ᐃᓅᖃᑎᒌᑦ
society	ᑲᑐᔾᔨᖃᑎᒌᑦ
socks	ᐊᓕᖅᓯᖅ
soft	ᐊᕿᑦᑐᖅ
software	ᖃᕆᓴᐅᔭᓕᕆᔾᔪᑎ
soil	ᐃᔾᔪᖅ
sold	ᓂᐅᕐᕈᑕᐅᔪᑦ
sold out	ᓂᐅᕐᕈᑕᐅᔪᑦ
soldier	ᐅᓇᑕᖅᑐᒃᓴᖅ
sole	ᐱᑦᑕᑐᐊᖅᑐᖅ
solid	ᑕᖏᓕᒃ
solution	ᐋᖅᑭᒋᐊᕈᑎᒃᓴᖅ
solve	ᐋᖅᑭᒍᓯᖅ
some	ᐃᓚᐃᓐᓇᖏᑦ
some	ᐃᓚᖏᑦ
somebody	ᑭᓇᒥᑭᐊᖅ
somehow	ᖃᓄᑭᐊᖅ
someone	ᑭᓇᒧᒃᑭᐊᖅ
something	ᑭᓱᑭᐊᖅ
sometimes	ᐃᓛᓐᓂᒃᑯᑦ
song	ᐃᙱᐅᑎᑦ
soon	ᐅᐊᑦᑎᐊᕈᑦᑎᐊᖅ
sophisticated	ᐱᔭᕆᑐᔪᖅ
Sorani	ᓱᕌᓂ
sore	ᐱᙱᓈᖅᑐᖅ
sore throat	ᐃᒡᒋᐊᕐᓗᒃ
sorrow	ᖃᓗᕋᖅᑐᖅ
Sorry	ᒪᒥᐊᓇᖅ
Sorry	ᐄᑯᓗᒃ
sort	ᐋᖅᑭᒃᑕᖅ
sought	ᕿᓂᕐᓂᖅ
soul	ᑕᕐᓂᖅᑐᖅ
soulmate	ᓇᒡᓕᒋᔭᖃᕐᓂᖅ
sound	ᓂᐱ
soup	ᖃᔪᒃᓴᖅ
sour	ᓰᕐᓇᖅᑐᖅ
source	ᓇᑭᙶᕐᕕᒃ
south	ᓯᕿᓂᖅ
space	ᐃᓂᐅᔪᖅ
spam	ᑎᕝᕗᐊᕐᓂᖅ
span	ᐃᑎᖅᓴᖅ
Spanish	ᓯᐹᓂᔅ
spare	ᐱᙱᓈᖅᓯᔪᖅ
speak	ᐅᖃᓪᓚᒡᓗᑎᑦ
special	ᐱᒻᒪᕆᒃ
species	ᐆᒪᔪᑦ ᐊᔾᔨᒌᖕᓂᖏᑦ
specific	ᐱᔾᔪᑎᒋᔭᖅ
specific	ᑐᕌᒐᓪᓚᕆᒃ
spectacular	ᑲᙳᓇᖅᑐᖅ
speech	ᐅᖃᓪᓚᖕᓂᖅ
speechless	ᐅᖃᕈᓐᓇᐃᓕᓂᖅ
speed	ᓇᑭᙶᖅᑐᖅ
spell	ᑎᕝᕗᐊᖅᑐᖅ
spend	ᑮᓇᐅᔭᑦ ᐊᑐᖅᑕᐅᔪᑦ
spent	ᑮᓇᐅᔭᑦ
spicy	ᓯᐸᖓᔪᖅ
spike	ᖁᑉᐸᖅᑯᑦ
spin	ᕿᒥᕐᓗ
spinach	ᐱᕈᖅᓯᐊᖅ ᔅᐱᓂᑦᔅ
spirit	ᑕᕐᓂᓕᕆᓂᖅ
spit	ᑎᕝᕗᐊᖅᑐᖅ
splendid	ᓯᓪᓗᔪᖅ
split	ᐊᕕᒃ
spoil	ᓱᓗᓕᒃ
spoiled	ᓱᖏᐅᖅᑐᖅ
spontaneous	ᐊᑕᐅᑦᑎᒃᑰᖅᑐᖅ
spoon	ᐊᓘᑦ
spot	ᐃᓂᕐᕈᑦ
spouse	ᐊᐃᑉᐸᖅ
spread	ᓯᐊᒻᒪᒃᐸᓪᓕᐊᔪᖅ
spring	ᐅᐱᕐᖔᖅ
square	ᑭᑉᐹᕆᑦᑐᖅ
squeeze	ᓱᑲᖓᓂᖅ
squid	ᐊᒥᑯ
squirrel	ᓯᒃᓯᒃ ᐸᒥᐅᑯᑖᓕᒃ
st	ᓴᐃᓐᑦ
stab	ᔅᑖᑉ
stable	ᓱᕐᕌᙱᑦᑐᑦ
stack	ᑐᖅᖢᕋᖅ
staff	ᐃᖅᑲᓇᐃᔭᖅᑏᑦ
stage	ᓇᓃᓐᓂᖓ
stain	ᐸᓚᐅᒐᖅ
stairs	ᒪᔪᕋᐅᑎᑦ
stake	ᓇᐹᖅᑐᖅ ᓇᓗᓇᐃᒃᑯᑕᖅ ᑭᒡᓕᖃᕐᕕᒃ
stalk	ᑐᑎᕆᐊᖅ
stall	ᓱᓐᓂᐅᒪᔪᖅ
stall	ᓄᖅᑲᑐᐃᓐᓇᖅᑐᖅ
stamp	ᓇᓗᓇᐃᒃᑯᑕᖅ
stand	ᓇᖏᕐᓂᖅ
standard	ᐱᐅᓯᖅ
star	ᐅᓪᓗᕆᐊᖅ
start	ᐱᒋᐊᕐᕕᖓ
started	ᐱᒋᐊᕐᕕᖓ
starving	ᐱᕐᓕᓐᓂᖅ
state	ᓇᓗᓇᐃᕐᓗᒍ
statement	ᐅᖃᐅᓯᐅᔪᖅ
station	ᑐᑦᑕᕐᕕᒃ
statue	ᒪᓕᒐᖅᑎᒎᖅᑐᖅ
status	ᖃᓄᐃᓕᖓᓂᖓ
stay	ᑕᐃᑲᓃᓐᓂᖅ
stay safe	ᐊᑦᑕᕐᓇᖅᑐᒧᐊᖅᑕᐃᓕᒋᑦ
steady	ᓱᕐᕌᙱᑦᑐᖅ
steak	ᓵᑦᑐᐱᐊᖅ
steal	ᑎᒡᓕᖅᑐᖅ
steam	ᐳᔫᖅᑐᖅ
steel	ᓴᕕᕋᔭᒃ
steep	ᓯᕕᖓᔪᖅ
stem	ᐱᒋᐊᙵᔪᖅ
step	ᒪᓕᒃᐸᓪᓕᐊᓂᖅ
stick	ᕿᔪᒃ
stiff	ᓯᑎᔪᖅ
still	ᓄᖅᑲᖓᔪᖅ
still	ᑕᐃᒪᓐᓇᐃᒐᓗᐊᖅᑎᓪᓗᒍ
sting	ᐃᙱᖅᑐᖅ
stingy	ᑐᖅᑭᔪᖅ
stir	ᐃᖑᓚᕐᓗᒍ
stock	ᖃᔪᒃᓴᖅ
stolen	ᑎᒡᓕᒃᑕᐅᔪᖅ
stomach	ᓈᖅ
stone	ᐅᔭᖅᑲᖅ
stood	ᓇᖏᕐᓂᖅ
stool	ᐊᓇᖅ
stop	ᓄᖅᑲᕆᑦ
storage	ᑐᖅᑯᐃᕕᒃ
store	ᓂᐅᕕᕐᕕᒃ
storm	ᐱᖅᓯᖅᑐᖅ
story	ᐅᓂᒃᑳᖅ
stove	ᐃᒐ
straight	ᑐᑭᓕᐊᖅᑐᖅ
straightforward	ᑐᑭᓯᓇᖅᑐᖅ
strain	ᓄᓱᒃᓯᓂᖅ
strange	ᑕᑯᙵᕐᓂᖅ
strange	ᐊᓪᓚᖓᔪᖅ
stranger	ᐋᓪᓚ
strategy	ᖃᓄᐃᓕᐅᕈᑕᐅᔪᒪᔪᑦ
straw	ᑕᖅᓯᖅ
strawberry	ᔅᑐᕌᐱᐅᕆ
streak	ᓴᔪᖕᓂᖅ
stream	ᐃᖏᕐᕋᓂᕆᔭᖓ
street	ᐊᖅᑯᑦ
strength	ᓴᙱᓂᖅ
stress	ᐊᒃᓱᕈᕐᓂᖅ
stretch	ᑕᓯᔭᖅᑐᖅ
strict	ᓲᖑᔪᖅ
strike	ᓄᖅᑲᖓᓂᖅ
string	ᐊᒥᕕᖅ
strip	ᑭᔾᔭᖅᑐᖅᓯᒪᔪᖅ
strive	ᐱᓇᔪᐃᓐᓇᕐᓂᖅ
stroke	ᐆᒻᒪᓯᕆᔪᖅ
strong	ᓴᙱᔪᖅ
struck	ᐃᐱᕋᖅᑐᖅ
structure	ᐋᖅᑭᒃᓯᒪᓂᖓ
struggle	ᐊᒃᓱᕈᕐᓂᖅ
struggling	ᐊᒃᓱᕈᕐᓂᖅ
stubborn	ᔪᒪᙱᑦᑐᖅ
stuck	ᐊᔪᖅᓯᐅᖅᑲᔪᖅ
student	ᐃᓕᓐᓂᐊᖅᑎ
study	ᖃᐅᔨᓴᕐᓂᖅ
studying	ᖃᐅᔨᓴᕐᓂᖅ
stuff	ᑭᓱᑐᐃᓐᓇᑦ
stunning	ᑕᓗᕈᓱᒃᑐᖅ
stupid	ᑐᑭᖃᙱᑦᑐᖅ
style	ᓴᓇᕐᕈᐊᕈᓯ
subject	ᐱᔾᔪᑎᖓ
submission	ᑐᓂᔭᐅᔪᖅ
submit	ᑐᓂᓯᓂᖅ
substance	ᓱᕐᓇᖅᑐᖅ
substitute	ᐃᓇᖐᔪᖅ
subtle	ᐅᓂᕐᕈᐊᖅ
succeed	ᑲᔪᓯᑦᑎᐊᖅᑐᖅ
success	ᑲᔪᓯᓂᖃᑦᑎᐊᕐᓂᖅ
success	ᐱᐊᓂᑦᑎᐊᕐᓂᖅ
successful	ᑲᔪᓯᑦᑎᐊᖅᑐᖅ
such	ᓲᕐᓗ
such as	ᓲᕐᓗ
suck	ᒥᓱᒃᑕᖅᑐᖅ
sudden	ᓱᑕᓪᓚᑲᓪᓚᒃ
suddenly	ᑕᒡᕙᐃᓐᓇᖅ
suffer	ᐊᒃᓱᕈᖅᑐᖅ
suffering	ᐃᐱᔪᖅ
sufficient	ᓈᒻᒪᒃᑐᖅ
sugar	ᓱᑲᖅ
suggest	ᐃᒪᐃᖁᔨᔪᖅ
suggest	ᐅᖃᐅᔾᔪᙳᐊᕐᓂᖅ
suggestion	ᖃᓄᐃᓕᐅᖁᔨᓂᖅ
suit	ᔭᐃᑲᒃᑕᕇᒃ
suitable	ᓈᒻᒪᒃᑐᖅ
suitcase	ᐃᑦᑎᕐᕕᒃ
sum	ᐱᑖᖑᔪᑦ
summary	ᓇᐃᓈᖅᓯᒪᔪᖅ
summer	ᐊᐅᔭᖅ
summit	ᑲᑎᒪᓂᖅ
sun	ᓯᕿᓂᖅ
sunday	ᐊᓪᓕᑐᑦ
sunny	ᓯᕿᓐᓂᖅᑐᖅ
sunset	ᓯᕿᓂᖅ ᓂᐱᔪᖅ
sunshine	ᓯᕿᓐᓂᖅᑐᖅ
super	ᐊᖓᔪᖅᑳᖅ
superior	ᓯᓚᓪᓕᖅ
supervisor	ᐊᖓᔪᖅᑳᖅ
supper	ᓂᕆᕝᕕᒃ
supply	ᐱᖁᑎᑖᕆᔭᐅᕙᒃᑐᑦ
support	ᐃᑲᔪᖅᑐᐃᓐᓂᖅ
suppose	ᓱᐱᔪᖅ
supposed	ᑕᐃᒪᐃᓪᓗᐊᖅᑐᖅ
sure	ᐊᖏᕐᓂᖅ
sure	ᓱᓕᓂᖅ
surface	ᖄᖓ
surge	ᐱᓚᒃᑐᐃᔨ
surgery	ᐱᓚᒃᑐᐃᓂᖅ
surname	ᐊᑎᕈᓯᖅ
surprise	ᓂᕆᐅᓇᙱᑦᑐᖅ
surprised	ᓂᕆᐅᓇᙱᑦᑐᖅ
surrender	ᓴᒃᑯᑦᑎᓂᖅ
surrounding	ᐊᕙᓗ ᐊᕙᓗᒃ
surveillance	ᓇᐅᑦᑎᖅᓱᕐᓂᖅ
survey	ᖃᐅᔨᓴᕐᓂᖅ
survive	ᐊᓐᓇᐅᒪᓂᖅ
suspect	ᒪᓗᒍᓱᒃᑐᖅ
suspended	ᓄᖅᑲᖓᑎᑕᐅᔪᖅ
suspicious	ᐸᓴᒍᓱᒃᑐᖅ
sustain	ᑲᔪᓯᑎᑦᑎᓂᖅ
sustainability	ᑲᔪᓰᓐᓇᕈᓐᓇᕐᓂᖅ
sustainable	ᑲᔪᓰᓐᓇᕈᓐᓇᖅᑐᖅ
swag	ᐄᔭᖅᑐᖅ
swallow	ᐄᔭᐅᔭᖅ
swap	ᐳᐃᔾᔪᕋᕐᓂᖅ
swear	ᑲᒫᓗᒃ
sweat	ᐅᖁᒪᐃᒃᓴᖅᑐᖅ
sweater	ᐅᖅᑰᔪᖁᑦ
sweep	ᒪᑦᑐᓯᖅᑐᖅ
sweet	ᓰᕐᓇᕐᑐᖅ
sweet dreams	ᓯᓇᑐᒪᑦᓯᐊᖁᓇᕐᐳᑎᑦ
sweet tooth	ᓰᕐᓇᖅᑐᖅ ᑭᒍᑎ
sweetheart	ᓇᒡᓕᒋᔭᖅ
swell	ᐳᕕᓕᕐᓂᖅ
swelling	ᐳᕕᓕᕐᓗᓂ
swim	ᐳᐃᔾᔪᕋᕐᓂᖅ
swimming	ᐳᐃᔾᔪᕋᕐᕕᒃ
swing	ᐊᐅᓚᑲᑦᑖᕐᓂᖅ
switch	ᐃᑭᑦᑕᐅᑎ
swollen	ᐳᕕᑦᑐᖅ
sword	ᐊᖏᖅᑎᑕᐅᔪᖅ
symbol	ᓇᓗᓇᐃᒃᑯᑕᖅ
sympathy	ᓇᒡᓕᒍᓱᖕᓂᖅ
symptoms	ᐋᓐᓂᐊᕈᓰᑦ
system	ᐱᓕᕆᔾᔪᓯᖅ
table	ᓵ
tackle	ᑲᒪᒋᓂᖅ
tag	ᓂᕕᖓᑖᖅ
tail	ᐸᒥᐅᖓ
take	ᑎᒍᓯᓂᖅ
take away	ᐲᕐᓗᒍ
take care	ᑲᒪᒋᔭᖃᕐᓂᖅ
take care	ᖃᓄᐃᙱᑦᑎᐊᕆᑦ
take off	ᑕᒫᓃᑦᑐᓐᓃᕆᑦ
taken	ᐱᔭᐅᔪᖅ
talk	ᐅᖃᓗᒃ
talkative	ᐅᖃᓪᓚᖕᓂᖅ
tall	ᑕᑭᔪᖅ
tap	ᑯᕕᓯᕕᖓ
tape	ᓂᐱᐅᑎ
target	ᑎᑭᑕᐅᔪᒪᔪᖅ
task	ᐱᓕᕆᐊᒃᓴᑦ
taste	ᑎᐱᖓ
tasty	ᑕᖅᓯᖅ
taught	ᐃᓕᓴᐃᓂᖅ
tea	ᑏ
teach	ᐃᓕᓴᐃᓂᖅ
teacher	ᐃᓕᓐᓂᐊᖅᑎ
teacher	ᐃᓕᓴᐃᔨ
team	ᐱᓕᕆᖃᑎᒌᑦ
tear	ᐊᓕᒃᑐᖅ
tears	ᕿᐊᔪᖅ
tease	ᐃᓱᐃᓵᕐᓂᖅ
technology	ᖃᕆᓴᔭᐅᓕᕆᔾᔪᑏᑦ
teeth	ᑭᒍᑎ
tell	ᐅᖃᕐᓂᖅ
tell me	ᐅᖃᐅᑎᙵ
temper	ᐃᒧᔭᖅᑐᖅ
temperature	ᐆᓇᕐᓂᖓ
temple	ᑐᖑᔪᐊᖓᔪᖅ
temporary	ᐊᑕᑲᐃᓐᓇᖅᑐᖅ
ten	ᑕᓪᓕᒪᐅᔪᕐᑐᑦ
ten thousand	10000
tenant	ᐊᑐᖅᑐᐊᖅᑎ
tend	ᐱᒐᔪᒃᑕᖓ
tendency	ᐊᑐᒐᔪᒃᑕᖓ
tender	ᐊᑭᑦᑐᕋᐅᑕᐅᔪᖅ
tense	ᓱᑲᖓᓂᖓ
tension	ᓱᑲᒃᑲᖓᓂᖅ
tent	ᑐᐱᖅ
tentative	ᑐᐱᖅ
term	ᖃᖓᒃᑰᓂᖓ
terms	ᑕᐃᒍᓰᑦ
terrible	ᐅᖁᒪᐃᑦᑐᑦ
terrible	ᐱᐅᙱᑦᑐᖅ
terrific	ᐸᑎᕋᐃᑦ
territory	ᐊᕕᒃᑐᖅᓯᒪᓂᖓ
test	ᖃᐅᔨᓴᕈᑎ
text	ᑎᑎᖅᑲᖅ
than	−ᖔᖅ
thank	ᖁᔭᓐᓇᒦᒃ.
thank you	ᖁᐊᓇ ᒪ'ᓇ
thank you	ᖁᔭᓐᓇᒦᒃ
Thank you for your patience while we investigate shipment	ᒪ'ᓇ ᐅᑕᖅᑭᔪᓐᓇᕋᕕᑦ ᖃᐅᔨᓴᖅᑎᓪᓗᑕ ᑎᑭᓴᖅᑕᐅᔪᓂᒃ
Thank you for your patience while we investigate shipment	ᖁᔭᓐᓇᒦᒃ ᕿᓄᐃᓵᕈᓐᓇᕋᕕᑦ ᖃᐅᔨᓴᖅᑎᓪᓗᑕ ᐊᐅᓪᓚᖅᑎᑕᐅᔪᓂᒃ
thank you so much	ᖁᔭᓐᓇᒦᒻᒪᕆᐊᓗᒃ
thank you very much	ᖁᔭᓐᓇᒦᒻᒪᕆᐊᓗᒃ
thanks	ᒪ'ᓇ
thanks	ᖁᐊᓇ
thanks	ᖁᔭᓐᓇᒦᒃ
Thanks for using our app	ᖁᔭᓐᓇᒦᒃ ᐊᑐᕋᑦᑎ ᖃᕋᓴᐅᔭᓕᕆᔾᔪᑎᑦᑎᓐᓂᒃ
that	ᑕᐃᓐᓇ
that	ᐃᓐᓇ
that is	ᑕᐃᒪᐃᒻᒪᑦ
that's good	ᑕᒪᓐᓇ ᐱᐅᕗᖅ
the	ᐅᓇ
the	ᑖᓐᓇ
theft	ᑎᒡᓕᖕᓂᖅ
their	ᐱᖏᑦ
their	ᐱᖓᑦ
them	ᑖᒃᑯᐊ
theme	ᐱᔾᔪᑕᐅᔪᖅ
themselves	ᓇᖕᒥᓂᖅ
then	ᑖᕙ
theory	ᐃᓱᒪᒋᔭᐅᔪᑦ ᓇᓚᐅᑦᑖᕐᓂᖅ
there	ᐃᑲᓂ
there	ᑕᐃᑲᓂ
there are	ᐱᑕᖃᖅᐳᖅ
there is	ᐱᑕᖃᑦᑐᖅ
therefore	ᑕᐃᒫᒃ
these	ᑖᒃᑯᐊ
they	ᐃᒃᑯᐊ
they	ᑖᐃᒃᑯᐊ
they are	ᐅᑯᐊᖑᕗᑦ
thick	ᓯᓕᒃᑐᖅ
thief	ᐅᖏᓚᖕᓇᖅᑐᖅ
thigh	ᖁᒃᑐᕌᒃ
thin	ᓵᑦᑐᖅ
thing	ᑭᓱ
things	ᑭᓱᑐᐃᓐᓇᐃᑦ
think	ᐃᓱᒪᓂᖅ
third	ᐱᖓᔪᖓᑦ
thirsty	ᐃᒥᕈᓱᒃᑐᖅ
thirteen	ᑕᓪᓕᒪᐅᔪᕐᑐᓗ ᐱᖓᓱᓪᓗ
thirty	ᐊᕙᑏᑦ ᐱᖓᑐᑦ
this	ᐅᓇ
this	ᑖᓐᓇ
this is	ᐅᓇ
this is	ᑕᒪᓐᓇ
thorough	ᐊᑕᖐᔪᖅ
thoroughly	ᐊᑕᖐᑦᑎᐊᖅᑐᖅ
those	ᑕᐃᒃᑯᐊ
though	ᒐᓗᐊᖅ
though	ᑲᓗᐊᖅ
though	ᕋᓗᐊᖅ
thought	ᐃᓱᒪ
thoughtful	ᐃᓱᒪᑐᔪᖅ
thoughts	ᐃᓱᒪᒋᔭᑦ
thousand	ᑕᐅᓴᑦ
thread	ᐃᕙᓗ
threat	ᓯᕘᕋᓵᕆᔪᖅ
threaten	ᑲᑉᐱᐊᓵᕆᔪᖅ
three	ᐱᖓᓱᑦ
threshold	ᑭᒡᓕᒋᑎᑕᐅᔪᑦ
thrilled	ᖁᕕᐊᓱᖅᑐᖅ
thrive	ᐱᕈᑦᑎᐊᖅᑐᖅ
throat	ᐃᒡᒋᐊᕐᓗᖕᓂᖅ
through	ᐅᕘᓇ
through	ᑕᐃᑰᓇ
throughout	ᑖᕗᖓᓕᒫᖅ
throw	ᐃᒋᑎᓂᖅ
thumb	ᑯᓪᓗ
thunder	ᑐᖅᓱᓐᓂᖅ
Thursday	ᓯᑕᒻᒥᑐᑦ
thus	ᑕᐃᒪᐃᒻᒪᑦ
tick	ᖁᒡᓗᕆᐊᖅ
tide	ᑎᓂᙵᑎᓪᓗᒍ
tidy	ᐃᕆᒃᑐᖅ
tie	ᖁᖓᓯᕈᖅ
tiger	ᑎᖑᒃ
tight	ᓱᑲᖓᔪᖅ
Tigrinya	ᑎᒡᓂᔭ
time	ᖃᐅᔨᓴᐅᑦ
time	ᖃᖓᒃᑰᓂᖓ
timid	ᐃᒻᒪᖅᑐᖅ
tiny	ᓯᕐᓚᑯᓗᒃ
tip	ᐃᑲᔫᑎ
tips	ᖃᐅᔨᒪᔭᒃᓴᑦ
tire	ᐊᒃᓴᓗᐊᖅ
tired	ᓴᐱᖅᑐᖅ
tired	ᑕᖃᔪᖅ
tissue	ᑲᒃᑭᐅᑎᒃᓴᖅ
title	ᑕᐃᒎᓯᐊ
to	ᐃᑯᖓ
to be	ᑕᐃᒪᐃᓐᓂᖅ
to be	−ᒋᐊᖃᕐᓂᖅ
toast	ᕿᖂᔭᖅ ᐆᓯᒪᔪᖅ
toast	ᐊᕿᕈᕐᔪᐊᖅ ᐆᓯᒪᔪᖅ
today	ᐅᓪᓗᒥ
toddler	ᓄᑕᕋᑯᓗᒃ
toes	ᐳᑐᒍᐃᑦ
together	ᐊᑕᐅᑦᑎᒃᑯᑦ
toilet	ᖁᕐᕕᒃ
told	ᐅᖃᐅᔾᔨᔪᖅ
tolerance	ᐊᑐᖁᔭᐅᙱᓐᓂᖅ
tolerate	ᓱᖁᓯᖅᑐᖅ
tomato	ᑐᒫᑐ
tomorrow	ᐊᖃᒍ
tomorrow	ᖃᐅᒃᐸᑦ
tongue	ᐅᖃᖅ
tonight	ᐅᓐᓄᒃ
too	ᐃᓚᓕᐅᑎᓂᖅ
took	ᐱ ᐱ ᐱᔪᖅ
tool	ᓴᓇᕐᕈᑎ
tools	ᓴᓇᕐᕈᑎᑦ
tooth	ᑭᒍᑎ
top	ᖁᓛᓂ
topic	ᐱᔾᔪᑎᓕᒃ
torn	ᐃᕐᓂᖅᑐᖅ
torture	ᓯᖁᓪᓗᐃᔪᖅ
total	ᑲᑎᖦᖢᒋᑦ
touch	ᐊᒃᑐᖅᓯᓂᖅ
tough	ᐃᔪᕐᓇᖅᑐᖅ
tour	ᐳᓛᕋᕐᓂᖅ
toward	ᑐᕌᕋᓱᒃᑕᖅ
towards	ᑐᕌᖅᐸᓪᓕᐊᔭᑦ
towel	ᐊᓪᓚᕈᑦ
town	ᓄᓇᓕᒃ
toxic	ᑐᖁᓐᓇᖅᑐᖅ
trace	ᑐᕋᒐᖅ
track	ᐃᕕᐊᖅᓴᕐᓂᖅ
trade	ᑕᐅᖅᓰᓂᖅ
tradition	ᐃᓕᖅᑯᓯᑐᖃᖅ
traditional	ᐃᓕᖅᑯᓯᕆᔭᐅᔪᒃᑯᑦ
traffic	ᐃᖏᕐᕋᔭᒃᑐᑦ
trail	ᐃᒡᓕᓂᖅ
train	ᐱᓕᒻᒪᒃᓴᕐᓂᖅ
training	ᐱᓕᒻᒪᒃᓴᕐᓂᖅ
trait	ᑐᕋᐃᑦ
traits	ᑭᓇᐅᓂᖅ
transfer	ᓅᑕᐅᓂᖓ
transition	ᓅᑉᐸᓪᓕᐊᓂᖅ
translate	ᑐᑭᓕᐅᕐᓗᒍ
transparent	ᓴᖅᑭᔮᕐᓂᖅ
transport	ᐃᖏᕐᕋᔾᔪᑎᓄᑦ
transportation	ᐃᖏᕐᕋᔾᔪᑎᓄᑦ
trap	ᒥᑭᒋᔾᔨᕐᓂᖅ
trash	ᐊᒃᑕᕐᓗᑯ
trauma	ᖁᐊᖅᓵᖅᓯᒪᓂᖅ
travel	ᐃᖏᕐᕋᓂᖅ
travel	ᐊᐅᓪᓚᖅᑐᖅ
tray	ᓵᑦᑑᔭᖅ
treasure	ᐱᐅᔪᖅ
treat	ᐊᑐᖅᑕᐅᔪᑦ
treatment	ᐃᖢᐊᖅᓴ
tree	ᓇᐹᖅᑐᖅ
tremendous	ᐊᖏᔪᒻᒪᕆᒃ
trend	ᖃᓄᐃᓕᕙᓪᓕᐊᓂᖓ
trial	ᐃᖅᑲᖅᑐᐃᓂᖅ
trick	ᒥᓱᒃᑕᕐᓂᖅ
tried	ᐆᒃᑐᖅᑐᖅ
trigger	ᐱᒋᐊᖅᑎᑦᑎᔪᖅ
trim	ᑎᕆᖅᑯᖅ
trip	ᐃᖏᕐᕋᓂᖅ
trip	ᐊᐅᓪᓚᕐᓂᖅ
trouble	ᐊᑲᐅᖖᒋᓕᐅᕈᑎᖃ
trousers	ᐃᖂᑎᓖᑦ
truck	ᓄᓇᓯᐅᑦ
true	ᓱᓕᔪᖅ
trunk	ᓱᓐᓂᐅᒪᔪᖅ
trust	ᐅᒃᐱᕈᓱᖕᓂᖅ
truth	ᓱᓕᔪᖅ
try	ᐆᒃᑐᕐᓂᖅ
Tsonga	ᑦᓱᖓ
tube	ᓱᓪᓗᓕᒃ
Tuesday	ᐁᑉᐱᑐᑦ
tuition	ᐃᓕᓐᓂᐊᕈᑎᓄᑦ
turkey	ᑑᕐᑭ
turmeric	ᑐᖅᓱᐊᕆᔪᖅ
turn	ᑭᖑᑉᐱᐊᖅᑐᖅ
turn	ᐅᑎᖅᑐᖅ
turtle	ᑐᐱᐅᔭᖅ
tutor	ᐃᓕᓴᐃᔨ
twelve	ᑕᓪᓕᒪᐅᔪᕐᑐᓗ ᒪᕐᕉᓗ
twenty	ᐊᕙᑎᑦ
twenty-one	ᒪᕐᕈᒃ ᐊᒡᒑᒃ ᐊᑕᐅᓯᕐᓗ
Twi	ᑐᐃ
twice	ᒪᕐᕈᐃᕐᓗᒍ
twist	ᑲᐃᕕᓐᓂᖓ
two	ᒪᕐᕉᒃ
type	ᖃᓄᐃᑦᑑᓂᖓ
typical	ᐊᑐᒐᔪᒃᑐᖅ
ugly	ᐃᓂᖁᓇᙱᑦᑐᖅ
ultimate	ᐅᓚᒥᖅᑐᖅ
umbrella	ᖃᓪᓗᖅ
unable	ᐊᔪᖅᑐᖅ
uncle	ᐊᒃᑲᒃ
unconscious	ᖃᐅᔨᒪᙱᑦᑐᖅ
under	ᐅᑯᑎᒎᓇ
underneath	ᐊᑖᓂ
underrated	ᙱᓗᐊᖅᑐᖅ
understand	ᑐᑭᓯᐅᒪᓂᖅ
understood	ᑐᑭᓯᐅᒪᔪᖅ
unfortunately	ᐊᐃᑦᑖᖑᒐᓗᐊᖅ
uniform	ᐊᓐᓄᕌᑦ
unique	ᐊᔾᔨᐅᙱᑦᑐᖅ
unit	ᐃᒡᓗ
university	ᓯᓚᑦᑐᓴᕐᕕᔾᔪᐊᖅ
unknown	ᓇᓗᔭᐅᔪᖅ
unless	ᑭᓯᐊᓂ
until	ᑎᑭᓪᓗᒍ
unusual	ᐊᑐᒐᔪᙱᑦᑐᖅ
up	ᖁᓛᓂ
up to you	ᐃᕝᕕᑦ ᐃᓱᒪᖅᓲᑎᒋᕙᐃᑦ
update	ᑐᓴᒐᒃᓴᖅ
upgrade	ᓄᑖᙳᕆᐊᖅᓯᓂᖅ
upon	ᐅᕘᓇ
upset	ᓂᙵᒃᓯᒪᓂᖅ
urban	ᐃᒃᑭᖅ
urge	ᑎᓕᐅᕆᓂᖅ
urgent	ᑐᐊᕕᕐᓇᖅᑐᖅ
us	ᐅᕙᒍᑦ
use	ᐊᑐᕐᓗᒍ
used	ᐊᑐᖅᑕᐅᔪᖅ
useful	ᐊᑑᑎᖃᑦᑎᐊᖅᑐᖅ
useless	ᐊᑑᑎᖃᙱᑦᑐᖅ
usual	ᐊᑐᒐᔪᒃᑐᖅ
usually	ᐱᔭᐅᒐᔪᒃᑐᑦ
utility	ᐆᒻᒪᖅᑯᑎᓄᑦ
vacation	ᒥᙳᐃᖅᓯᓂᖅ
vacation	ᕿᑲᕐᓂᖅ
vaccination	ᐋᓐᓂᐊᓕᕇᒃᑯᑎᓕᖅᑕᐅᓂᖅ
vaccine	ᐋᓐᓂᐊᓕᕇᒃᑯᑎ
vacuum	ᒥᓗᒃᓯᓂᖅ
vague	ᑐᑭᓯᓇᖅᑐᖅ
valid	ᐊᑐᖅᑐᖅ
valley	ᓇᖅᓴᖅ
valuable	ᐱᒻᒪᕆᐅᔪᖅ
value	ᐊᑑᑎᓕᒃ
variety	ᐊᔾᔨᒌᙱᑦᑐᑦ
various	ᐊᔾᔨᒌᙱᑦᑐᑦ
vary	ᐊᔾᔨᒌᖏᑦᑐᑦ
vase	ᒥᓗᒃᓯᔪᖅ
vast	ᐊᖏᔪᖅ
vegetable	ᐱᕈᖅᑐᑦ
vegetables	ᐱᕈᖅᑐᕕᓃᑦ
vehicle	ᓄᓇᓯᐅᑎᑦ
vendor	ᓂᐅᕕᖅᑎᑦᑎᔨ
venom	ᑐᖁᓐᓇᖅᑐᖅ
venture	ᓇᖕᒥᓂᖃᕐᓂᖅ
venue	ᑲᑎᒪᕝᕕᒃ
verify	ᓇᓗᓇᐃᕐᓗᒍ
versatile	ᓱᖏᐅᑎᓂᖅ
version	ᖃᓄᐃᑦᑑᓂᖓ
vertical	ᑐᑭᓕᐊᖅᑐᖅ
very	ᐊᒃᓱᐊᓗᒃ
very good	ᐱᐅᔪᒻᒪᕆᒃ
vessel	ᐅᒥᐊᖅ
via	ᐅᑯᑎᒎᓇᖅ
vibe	ᐃᑉᐱᒍᓱᒃᑐᖅ
vibes	ᖃᓄᐃᓐᓂᕆᔭᖅ ᑕᑯᑎᑦᑎᓪᓗᓂ
vicious	ᓂᑲᒍᓱᒃᑐᖅ
victim	ᐱᕋᔭᒃᑕᐅᔪᖅ
video	ᑕᕐᕆᔮᒃᓴᖅ
view	ᑕᐅᑐᖕᓂᖅ
village	ᓄᓇᓕᕋᓛᑦ
villain	ᕕᓂᐃᓐ
vinegar	ᕕᓂᒐ
vintage	ᖃᖓᓂᑕᖅ
vintage	ᐱᑐᖃᖅ
violence	ᐋᓐᓂᖅᓯᕆᓂᖅ
violent	ᓂᖓᕐᓂᖅ
viral	ᐊᔾᔨᙳᐊᖅ ᓴᖅᑭᑕᐅᑲᐅᑎᒋᔪᖅ
virgin	ᕘᕐᒋᓐ
virtual	ᖃᕆᑕᐅᔭᒃᑯᑦ
virtue	ᐱᐅᑦᑎᐊᖅᑐᖅ
vision	ᑕᐅᑐᖅᑰᖅᑕᐅᔪᑦ
visit	ᐳᓛᕆᐊᕐᓂᖅ
visual	ᑕᑯᑦᓴᐃᑦ
vital	ᐱᒻᒪᕆᐊᓗᒃ
vivid	ᑕᐅᑐᕐᕉᕐᓂᖅ
vocabulary	ᐅᖃᐅᓰᑦ
voice	ᓂᐱ
void	ᐊᑐᕈᓐᓃᖅᑐᖅ
volume	ᐊᖏᑎᒋᔪᖅ
volunteer	ᐊᑭᓕᖅᓱᖅᑕᐅᙱᖦᖢᑎᒃ
vomit	ᒥᕆᐊᑦ
vulnerable	ᐊᑦᑕᕐᓇᖅᑐᑦ
wage	ᑮᓇᐅᔭᓕᐊᑦ
wages	ᑮᓇᐅᔭᓕᐊᑦ
waist	ᕿᑎᖅ
wait	ᐅᑕᖅᑭᓂᖅ
waiter	ᐱᔨᑲᑖᖅ
waiting	ᐅᑕᖅᑭᔪᖅ
wake	ᑐᐹᖅᓯᓗᓂ
wake up	ᑐᐸᓕᕆᑦ
walk	ᐱᓱᒃ
walking	ᐱᓱᖕᓂᖅ
wall	ᐊᑭᓐᓇᖅ
wallet	ᑮᓇᐅᔭᒃᑯᕕᒃ
wander	ᐅᐃᔾᔮᖅᑐᖅ
wanna	ᐃᒪᐃᒍᒪᔪᖅ
want	ᐱᔪᒪᔪᖅ
wanted	ᐱᔪᒪᔪᖅ
war	ᐅᓇᑕᕐᓂᖅ
wardrobe	ᐊᓐᓄᕌᓄᑦ ᑐᖅᑰᓯᕝᕕᒃ
warehouse	ᓯᕐᓗᐊᖅ
warm	ᐆᓇᔪᒃᑐᖅ
warn	ᐅᔾᔨᖅᓱᖁᔨᔪᖅ
warning	ᐅᔾᔨᖅᓱᕆᑦ
warrior	ᐅᓇᑕᖅᑎ
was	ᓚᐅᖅᑐᖅ
wash	ᐅᐊᓴᕐᓂᖅ
waste	ᐊᑦᑕᑯᑦ
watch	ᑕᐅᑐᒡᓗᒍ
water	ᐃᒥᖅ
watermelon	ᐃᒪᐅᑉ ᓯᓕᓂᖓ
wave	ᒪᓪᓕᖅᑐᖅ
way	ᐊᖅᑯᑖ
we	ᐅᕙᒍᑦ
we are	ᐅᕙᒍᑦ
we can	ᐊᔪᙱᑦᑐᒍᑦ
weak	ᓴᙲᑦᑑᓪᓗᓂ
weakness	ᓴᙲᓐᓂᖓ
wealth	ᐊᔪᖅᓴᖏᓐᓂᖅ
wealthy	ᐊᔪᖅᓴᖏᓐᓂᖅ
wear	ᐊᑐᕐᓂᖅ
wearing	ᐊᑐᕐᓂᖅ
weather	ᓯᓚ
wedding	ᑲᑎᑎᑕᐅᓂᖅ
Wednesday	ᐱᖓᑦᓯᑐᒡᑦ
weed	ᖃᐅᓯᖅᑐᖅ
week	ᐱᓇᓱᐊᕈᓯᖅ
weekend	ᐱᓇᓱᐊᕈᓯᐅᑉ ᓄᙳᐊ
weight	ᐅᖁᒪᐃᓐᓂᖓ
weird	ᐃᓱᒪᓇᙱᑦᑐᖅ
weird	ᐃᓕᖅᑯᓯᐅᙱᑦᑐᖅ
welcome	ᑐᙵᓱᒋᑦ
welfare	ᑲᒪᑦᑎᐊᕐᓂᖅ
Well	ᒪᐃᑦᑎᐊᖅ
Well	ᐱᐅᔪᖅ
well done	ᐱᓕᕆᑦᑎᐊᖅᑐᖅ
went	ᐊᓂᔪᖅ
went	ᖓᖅᑐᖅ
were	ᓚᐅᖅᑐᑦ
west	ᓂᒡᒋᖅ
wet	ᑭᓂᐸᔪᖅ
wet	ᖃᐅᓯᖅᑐᖅ
whale	ᕿᓚᓗᒐᖅ
what	ᓱᓇ
what	ᓱᕙ
what about you	ᐃᓕᔅᓯᓕ
what are you doing	ᓱᓕᕆᕕᑦ
what are you doing now	ᓱᓕᕆᕕᑦ ᒫᓐᓇ
what are you doing now	ᖃᓄᐃᓕᐅᕋᕕᑦ ᒫᓐᓇ
what are you doing right now	ᒫᓐᓇ ᖃᓄᐃᓕᐅᖅᐱᑦ
what do you do	ᖃᓄᐃᓕᐅᕐᓂᐊᖅᐱᑦ
what do you do for a living	ᑭᓱᓕᕆᔨᐅᕕᑦ
what do you mean	ᖃᓄᖅ ᑐᑭᓕᐅᖅᐱᑦ
what do you want	ᑭᓱᒥᒃ ᐱᔪᒪᕕᑦ
what happened	ᓱᔪᖅ
what is	ᓱᓇᐅᕙ
what is this	ᐅᓇ ᑭᓲᕙ
what is your job	ᑭᓱᒥ ᐃᖅᑲᓇᐃᔮᖃᕋᕕᑦ
what is your name	ᑭᓇᐅᕕᑦ
what's up	ᓱᕕᑦ
what's your name	ᑭᓇᐅᕕᑦ
whatever	ᓱᓇᑐᐃᓐᓇᖅ
whatever	ᑭᓱᑐᐃᓐᓇᖅ
wheat	ᑲᔫᖅᑐᖅ
wheel	ᐊᒃᓴᓗᐊᖅ
when	ᖃᖓ
when	ᖃᑯᒍ
whenever	ᖃᖓᑐᐃᓐᓇᖅ
where	ᓱᒥ
where	ᓇᒥ
where are you	ᓇᓂᕐᐲᑦ
where are you from	ᓇᒥᕐᒥᐅᑕᐅᕕᑦ
where are you now	ᓇᓃᑉᐱᑦ ᒫᓐᓇ
where do you live	ᓇᒥ ᓄᓇᖃᖅᐱᑦ
where is	ᓇᐅᓕ
whereas	ᐃᒪᐃᒻᒪᓐ
whether	ᐃᒪᐃᒃᑲᓗᐊᖅᐸᑦ
which	ᓇᓕᐊᒃ
while	ᒐᓗᐊᖅ
while	ᑕᐃᒪᐃᑎᓪᓗᒍ
whisper	ᐃᔾᔭᙳᓱᒃᑐᖅ
whistle	ᐅᕕᙱᐊᖅᑐᖅ
white	ᖃᐅᓪᓗᖅᑐᖅ
white	ᖃᑯᖅᑐᖅ
who	ᑭᒃᑯᑦ
who	ᑭᓇ
who are you	ᑭᓇᐅᕖᑦ
who is	ᑭᓇᐅᖕᒪᑦ
who is this	ᑭᓇᐅᒻᒪᑦ
whole	ᐃᓗᐃᑦᑑᓪᓗᒍ
whom	ᑭᓇ
whose	ᑭᓇ
why	ᕼᐅᒻᒪᓐ
why	ᖃᓄᐃᒻᒪᑦ
why	ᓱᒻᒪᑦ
why not	ᐊᑏᑐᐃᓐᓇᖅ
wicked	ᐃᖅᑯᒻᒪᖅᑐᖅ
wide	ᓯᓕᒃᑐᖅ
widow	ᐅᐃᒡᒐᖅᑐᖅ
width	ᓯᓕᒃᑐᖅ
wife	ᓄᓕᐊᒃ
wild	ᓄᓇᑐᐃᓐᓇᕐᒥ
will	ᐱᓂᐊᖅᑐᖅ
will	ᐃᒪᐃᓐᓂᐊᖅᑐᖅ
willing	ᐱᔪᒪᓂᖃᕐᓂᖅ
win	ᓵᓚᒃᓴᖅᑐᖅ
wind	ᐊᓄᕆ
window	ᐃᒐᓛᖅ
windy	ᐊᓄᕆᒃᑐᖅ
wine	ᕙᐃᓂ
winter	ᐅᑭᐅᖅ
wipe	ᐊᓪᓚᖅᑐᐃᔾᔪᑎ
wire	ᐅᐊᔭ
wisdom	ᓯᓚᑐᓂᖅ
wise	ᓯᓚᑐᔪᖅ
wish	ᕿᓐᓅᑦ
wish	ᐱᔪᒪᔪᖅ
wish you all the best	ᖃᓄᐃᙱᑦᑎᐊᖁᕙᔅᓯ
witch	ᐅᐃᔾᔮᖅᑐᖅ
with	ᐃᓚᒋᔭᖅ
with	ᐃᓚᓕᐅᑎᓗᒍ
withdraw	ᖁᔭᓈᖅᓯ
withdrawal	ᐊᑐᕈᓐᓃᕐᓂᖅ
within	ᐃᓗᐊᓂ
without	ᐱᑕᖃᖏᑦᑐᖅ
witness	ᑕᐅᑐᒃᑐᖅ
witty	ᐅᐃᒻᒪᒃᑐᖅ
wolf	ᐊᒪᕈᖅ
woman	ᐊᕐᓇᖅ
women	ᐊᕐᓇᐃᑦ
won	ᓵᓚᒃᓴᖅᑐᖅ
won't	ᑕᐃᒪᐃᔾᔮᖏᑦᑐᖅ
wonder	ᓇᐅᓕᖅ
wonder	ᐃᓱᒪᓂᖅ
wonderful	ᐱᐅᔪᒻᒪᕆᐊᓗᒃ
wood	ᕿᔪᒃ
wool	ᐊᓇᖅ
word	ᐅᖃᐅᓯᖅ
words	ᐅᖃᐅᓰᑦ
work	ᐱᓕᕆᐊᖅ
work out	ᑲᔪᓯᑦᑎᐊᖅᑐᖅ
working	ᐃᖅᑲᓇᐃᔭᕐᓂᖅ
world	ᓯᓚᕐᔪᐊᖅ
world	ᓄᓇᕐᔪᐊᖅ
worm	ᖁᐱᕐᕈᖅ
worn	ᐃᖅᑯᒻᒪᖅᑐᖅ
worried	ᐃᓱᒫᓗᒃᑐᖅ
worry	ᐃᓱᒫᓗᖕᓂᖅ
worse	ᐱᐅᙱᓂᖅᓴᖅ
worship	ᓂᖅᑐᐃᓂᖅ
worst	ᐱᐅᙱᓛᖅ
worth	ᐊᑑᑎᖃᑦᑎᐊᖅᑐᖅ
worth it	ᐊᑑᑎᖃᑦᑎᐊᖅᑐᖅ
worthy	ᐊᑑᑎᖃᑦᑎᐊᖅᑐᖅ
would	ᐃᒪᓐᓇᐃᓐᓇᔭᖅᑐᖅ
would	ᑕᐃᒪᐃᓐᓇᔭᖅᑐᖅ
wound	ᐃᑭᖓ
Wow	ᒪᐄ
wrap	ᐃᒧᓯᒪᔪᖅ
wrath	ᐅᖏᓚᖕᓇᖅᑐᖅ
wrist	ᐸᒡᕕᒃ
write	ᑎᑎᕋᕐᓂᖅ
Write here	ᐅᕙᓂ ᑎᑎᕋᕐᓗᑎᑦ
writing	ᑎᑎᕋᕐᓂᖅ
written	ᑎᑎᕋᖅᓯᒪᔪᖅ
wrong	ᑕᒻᒪᖅᑐᖅ
wrote	ᑎᑎᕋᖅᑕᖅ
yard	ᓯᓚᑎᖓ
yawn	ᐊᒡᓕᕈᐊ
Yeah	ᐄ
year	ᐊᕐᕌᒍ
years	ᐊᕐᕌᒍᓂ
yeast	ᐳᒃᑐᖅᑎᕈᑎ
yell	ᑐᖅᖢᓚᒃᑐᖅ
yellow	ᖁᖅᓱᖅᑐᖅ
Yes	ᐄ
yes baby	ᐄ ᓄᑕᕋᓛᖅ
yes dear	ᔨᐊ ᑎᐊ
yes honey	ᔨᐊ ᕼᐊᓂ
yes my love	ᐄ ᓇᓪᓕᒋᔭᖅ
yes of course	ᐄᑦᑎᐊᒻᒪᕆᒃ
yesterday	ᐃᑉᐸᒃᓴᖅ
yet	ᓱᓕ
yield	ᓂᐱᑎᕈᑦ
you	ᐃᕝᕕᑦ
you are	ᐃᕝᕕᑦ
you are beautiful	ᐱᐅᔪᐊᐱᐅᕗᑎᑦ
you are so beautiful	ᐱᓐᓂᖅᑐᓪᓚᕆᐊᓘᔪᑎᑦ
you are welcome	ᑐᙵᓱᒃᐳᑎᑦ
you can	ᐱᔪᓐᓇᖅᑐᑎᑦ
You know	ᖃᐅᔨᒪᔪᑎᑦ
you too	ᐃᕝᕕᓪᓗ
you're welcome	ᐃᓛᓕ
young	ᒪᒃᑯᒃᑐᖅ
your	ᐃᕝᕕᑦ
your welcome	ᑐᙵᓱᒋᑦᑎ
yourself	ᐃᓕᖕᓄᑦ
youth	ᒪᒃᑯᒃᑐᑦ
you’re welcome	ᐃᓛᓕ
yummy	ᐃᒧᔭᖅᑐᖅ
zero	ᔨᕈ
