a	ا
a little	کینٛہہ
a lot	واریاہ
a lot of	واریاہ کینٛہہ
abandon	ترٛاوٗن
abandoned	ترک کردین
abide	روزٕ
ability	اہلیت
able	قٲبل
about	اتھ متعلق
above	ہیرٕ
abroad	بیرون ملک
absence	غٲر موجودگی
absent	غٲر موجود
absolutely	بالکل
absorb	جذب کرنا
abstract	تجریدی
absurd	مضحکہ خیز
abundance	کثرت
abundant	واریاہ زیادٕ
abuse	غلط استعمال
accent	فنہ تعمیٖرات
accept	قبول کر
access	رسٲئی
accident	حٲدثہٕ
accommodation	رہائش
accomplish	پورٕ کر
accomplished	کامیاب
according	مطٲبق
account	اکاونٹ
accuracy	درستگی
accurate	درست
accused	الزام تراشی
ache	ژھایہ
achieve	حٲصل کر
achievement	کامیٲبی
acknowledge	تسلیم کر
acquaintance	واقفیت
acquire	حٲصل کر
acquired	حٲصل کرکھ
acquisition	خریدٲری
across	أنٛد پٔکھۍ
act	ایکٹ
action	کاروٲیی
active	فعال
activities	سرگرمیہٕ
activity	سرگرمی
actor	اداکار
actual	اصلی
actually	اصلس منز
acute	تیز
adapt	ایڈاپٹ
add	ایڈ کر
addicted	نشٲنی
addition	اضافہٕ
additional	اضٲفی
address	پتہ
adequate	کٲفی
adjacent	نزدیکی
adjective	صفت
adjust	ایڈجسٹ کر
admire	تعریف کر
admit	تسلیم کر
adopt	اپناو
adorable	پریٚتھ
advance	پیشگی
advanced	ایڈوانسڈ
advantage	فأئدٕ
adventure	ایڈونچر
adverb	ایڈورب
advertisement	اشتہار
advertising	اشتہار بازی
advice	مشورٕ
advise	مشورٕ
advocate	ایڈوکیٹ
aesthetic	آرکیٹیکچرل
affair	معملہٕ
affect	متٲثر کرن
affection	محبت
afford	فراہم کر
affordable	سستہٕ
afraid	ڈرو
after	امہ پتہٕ
afternoon	دوپہر
afterwards	پتہٕ
again	دوبارٕ
against	خلاف
age	عمر
agency	ایجنسی
agent	ایجنٹ
aggressive	جارحانہ
agile	اگل
ago	برونٹھ
agree	اتفاق کر
agreement	معاہدٕ
agriculture	زراعت
ahead	برٛونٛہہ کن
aid	امداد
aim	مقصد
air	ہوا
airport	ہوائی اڈے
aisle	ہہہہہہہہہ
alarm	الارم
alcohol	شراب
alert	الرٹ
alive	زندٕ
all	سٲری
all right	ٹھیک چھ
all the best	تمام بہترین
allow	اجازت دیو
allowed	اجازت
almost	تقریبا
alone	اکیلا
along	سۭتۍ سۭتۍ
already	گۄڈٕ پیٚٹھٕ
Alright	ٹھیک چھ
also	تہ تہ
alternative	متبادل
although	حالانٛکہ
always	ہمیشہٕ
am	آیم
amazing	حیرت انگیز
ambiguous	مبہم
ambition	عزائم
ambitious	مہتواکانکشی
amend	بدلاو
amid	درمیان
among	یمن منز
among us	اسہ درمیان
amount	رقم
amusing	مزٕ دار
an	ا
analysis	تجزیہ
ancestors	جد
anchor	اینکر
ancient	پرٲنۍ
and	تہٕ
and you	تہٕ توہہہ
angel	فرشتہ
anger	شرارت
angle	زاویہ
angry	ناراضگی
animal	جانور
ankle	ٲٹھۍ ٲٹھۍ
anniversary	سالانہٕ تقریبات
announcement	اعلان
annoy	ناراضگی
annoyed	ناراضگی
annoying	پریشان کن
annual	پریتھ وأری
anonymous	ناواقف
another	بیاکھ اکھ
answer	جواب
anticipate	پیشین گوئی کر
anxiety	اضطراب
anxious	پریشان
any	کانٛہہ تہ
anymore	بیٚیہ
anyone	کانہہ تہ
anything	کانٛہہ تہ
anyway	وونہ گو٘
anyways	وونہ گو٘
apart	الگ الگ
apartment	اپارٹمنٹ
apologize	درخاست کر
apparent	واضح
apparently	واضح طور پٲٹھۍ
appeal	اپیل
appear	وچھنہٕ چھ یوان
appearance	شکٕل
appeared	آو ؤچھنہٕ
appetite	بھوک
apple	ایپل
application	ایپلیکیشن
apply	لاگو کر
appointment	اپائنٹمنٹ
appreciate	تعریف کر
appreciation	تعریف
approach	نقطہ نظر
appropriate	موزوں
approval	منظوری
approve	منظوٗری
approved	منظور شدٕ
approximately	لگ بگ
april	اپریل
arbitrary	صوابدیدی
architect	آرکیٹیکٹ
architecture	فن تعمیر
archive	آرکائیو
are	چھ
are you	کیا تہۍ چھو ؟
are you busy	کیا تہۍ چھو مصروف
are you married	کیا تہۍ چھو خانٛدر کٔرتھ
are you married or single	کیا تہۍ چھو خانٛدر کٔرتھ یا وٲحد
Are you still there?	کیا تہۍ چھوٕ ونہٕ تہٕ ییٚتہ ؟
are you there	کیا تہۍ چھو ییٚتہ ؟
area	علاقہٕ
argue	بحث کر
argument	دلیل
arise	وٮ۪تُھن
arm	بانہٕ
army	فوج
around	أنٛد پٔکھۍ
arrange	انتظام کر
arrangement	انتظام
arrival	آمدٕ
arrive	ووت
arrived	آو
arrogant	حٲران
arrow	تیر
art	آرٹ
article	مضمون
artificial	مصنوعی
artist	فنکار
as	یتھ کٕنہ
as long as	یوتتھ تام ز
as well	تہ تہ
as well as	تہ تہ
ash	ایش
ashamed	شرمسار
ask	پرژھ
asked	پرٛژھ
asleep	سونٛچھ
aspect	پہلو
Assamese	آسامیہ
assault	حملہ
assembly	اسمبلی
assertive	زور دار
assess	تشخیص
assessment	تشخیص
asset	اثاثہ جات
assets	اثاثہ جات
assign	تفویض کر
assignment	تفویض
assist	مدد کر
assistant	معاونین
associate	ایسوسی ایٹ
associated	وابستہٕ
association	ایسوسی ایشن
assume	فرض کر
assumption	مفروضہٕ
at	پیٹھ
at least	کم از کم
ate	کھٮ۪وان
athlete	ایتھلیٹ
attach	اٹیچ کر
attached	منسلک
attachment	اٹیچمنٹ
attack	حملہٕ
attempt	کوشش کر
attend	حاضر
attendance	حاضری
attention	توجہ
attitude	رویہٕ
attract	کشش کرن
attraction	کشش
attractive	پرکشش
attribute	خصوصیت
audience	سامعیٖن
august	اگست
aunt	آنٹی
aunty	آنٹی
authentic	اصلی
author	مصنف
authority	اتھارٹی
autumn	موسم خزاں
available	دستیاب
average	اوسط
avoid	بچاو
awake	جاگایہ
award	ایوارڈ
aware	جان
awareness	آگہی
away	دور
awesome	بہت خوب
awful	خوفناک
awkward	ناگوار
Aymara	امیری
baby	بچہٕ
bachelor	باسلر
back	واپس
background	پس منظر
bad	خراب
bag	بیگ
bait	باٹ
bake	پکاو
bakery	بیکری
baking soda	بیکنگ سوڈا
balance	توازن
ball	بال
Bambara	بمبرا
banana	کیلہٕ
band	بینٛڈ
bang	بنگ
bank	بینک
bar	بار
barely	بمشکل
bargain	سودا
bark	چھلکہ
barley	بارلی
barrier	رکاوٹ
base	بنیاد
based	پیٹھ مبنی
basement	تہہ خانہ
basic	بنیٲدی
basically	بنیٲدی طور پٲٹھۍ
basil	ببر
basil	بیسیل
bastard	بکارڈ
batch	بیچ
bath	باتھ روم
bathroom	باتھ روم باتھ روم
battery	بیٹری
battle	لڑایہ
bay	باے
be	آسن
be careful	احتیاط کریو
beach	بیچ
beam	بیم
beans	بینہٕ
bear	بیور
beard	ژھاڑٕ
bearing	بارنہٕ
beast	جانور
beat	بیٹ
beautiful	خوبرو
beauty	خوبصورتی
became	بنییہ
because	کیازٕکہ
become	بنیوو
bed	بیڈ
bedroom	بیڈروم
bee	بی بی
beef	گاڑٕ
been	اوس
beer	بیئر
before	امہ برٛونٛہہ
began	شروٗع کٔر
begin	شروٗع کر
beginning	شروعات
behalf	طرفہٕ
behave	برتاو کر
behavior	طرز عمل
behaviour	برتاو
behind	پتہٕ
being	آسن
belief	عقیدٕ
believe	یقین
belly	پیٹ
belong	تعلق چھ
beloved	محبوب
below	بۄن چھ
belt	بیلٹ
bench	بنچ
bend	بانٛڑ
beneath	بۄن
benefit	فأئدٕ
benefits	فائدٕ
beside	بغٲر
besides	امہ علاوٕ
best	بہتٔریٖن
best of luck	بہت خوش قسمت
best regards	بہت بہت نیک خواہشات
better	بہتر
between	درمیان
beverage	مشروبات
beyond	امہ نیبر
Bhojpuri	بھوجپوری
bias	پاگل پن
biased	متعصبانہ
bicycle	سایکل
bid	بولی
big	بجہ
bike	سایکل
bill	بل
bind	بانڈ
bird	پردٕ
birthday	زینہٕ دوہ
bit	تھوڑا سا
bite	ژوپ
bitter	کریر
black	کالا
blade	بلیڈ
blame	الزام تراو
blank	خالی
blanket	کمبل
blast	دھماکہٕ
bleach	بلیچ
blend	ملاو
bless	آشیرواد
blessed	آشیرواد
blind	اندٕ
bliss	مزیٖد
block	بلاک
blood	خون
bloom	بلوم
blow	بلہ
blue	نیلا
blunt	چپ چاپ
board	بورڈ
boat	ناو
body	جسمہٕ
boil	بولاو
bold	بولڈ
bond	بانڈ
bone	ہڈی
book	کتاب
boost	بڑاو
booster	بوسٹر
boot	بوٹ
boots	بوٹس
border	سرحدٕ
bore	بورو
bored	بورٕ
boring	بورنگ
born	پیدٲیش
borrow	ادھار
boss	باس
both	دۄشوٕے
bother	پریشان کرن
bottle	بوتل
bottom	بوم
bought	کنن
bounce	اچھن
bound	بانڈ
boundaries	حدود
bow	کمان
bowl	باول
box	ڈبہ
boy	لڑکا
boyfriend	بوائے فرینڈ
bracelet	قؤر
brain	دماغ
branch	شاخہ
brand	برانڈ
brave	بہادر
breach	خلاف ورزی
bread	روٹی
break	پھٹراو
breakfast	ناشتہ
breast	چھاتی
breath	سان
breathe	شاہ کھیو
breed	نسل
brick	بریک
bride	مہرنہ
bridge	پل
brief	مختصر
bright	روشن
brilliant	شاندار
bring	انۍ
bro	برو
broad	وسیع تر
broadcast	نشریہ
broke	پھٹکھ
broken	ژٹتھ ژٹتھ
broom	جھاڑو
brother	بوے بوے
brother in law	دُری
brought	انۍ
brown	برۄنۍ
brush	بروس
bucket	بالٹن
buddy	یار
budget	بجٹ
bug	بگ
build	بناو
building	عمارت تعمیر
built	بناوتھ
bulk	تھوک
bull	بلہ
bully	بٗللی
bump	بمپ
bunch	بنچ
bundle	بنڈل
burden	بوجھ
buried	دفن کردین
burn	جلاو
burst	پھٹراو
bury	دفن کر
bus	بس
bush	بش
business	کاربار
bust	بسٹ
busy	مصروف
but	مگر
butter	مکھن
butterfly	چمگادڑ
button	بٹن
buy	کن
by	ذریعہ
by the way	وونہ گو٘
bye	الوداع
cabbage	کبوتر کبوتر
cabinet	کابینہ
cage	کیج
cake	کیک
calf	کاپھ
call	کال کر
call me	مےٚ کر کال
called	کال کر
calm	پرسکون
came	آو
campaign	مہم
can	ہٮ۪کہٕ کٔرتھ
can't	بہٕ ہیٚکہٕ نہٕ کٔرتھ
Cancel	رد کر
cancer	کینسر
capable	قٲبل
capacity	صلاحیت
capital	کیپٹل
caption	کیپشن
capture	رٹن
car	کار
career	پیشور
careful	احتیاط
carefully	احتیاط سان
careless	لاپرواہ
caring	دیکھ بھال
carpenter	کارپینٹر
carpet	کارپیٹ
carrot	کریٹ
carry	ننننن
carry on	جٲری تھوو
carry out	چلاو
case	کیس
cash	نقد رقم
cast	کاسٹ
castle	قلعہ
casual	معموٗلی
cat	کیت
catch	رٹن
category	زمرہ جات
cattle	مویشی
caught	پکٔمتھ
cause	وجہ
caution	احتیاط
cautious	احتیاط
cave	غار
cease	رکاو
ceiling	چھت
celebrate	جشن مناو
cell	سیل
center	مرکز
century	صدی
cereal	اناج
ceremony	تقریب
certain	یقینی
certainly	یقینی طور
certificate	سرٹیفکیٹ
chain	چین
chair	کرسی
challenge	چیلنج
chance	موقعہ
change	بدلاو
chaos	افراتفری
character	کردار
characteristics	خصوصیات
charge	چارج کر
charity	خیراتی کام
charming	دلکش
chart	چارٹ
chase	پیچھا کر
chat	چیٹ کر
cheap	سستہٕ
cheat	دھوکہ دہی
cheating	دھوکہ دہی
check	چیک کر
cheek	چیخ
cheer	چایٔر
cheerful	مزٕ دار
cheers	چایٔر
cheese	چیز چیز
chemistry	کیمسٹری
cherish	مزیٖد کر
chess	شطرنج
chest	چھاتی
chew	چبانہٕ
chicken	چکن چکن
chief	چیف
child	بچہٕ
childhood	بچپن
children	بچہٕ
chill	ٹھنڈا
chimneys	چمنی
chin	چن
chocolate	چاکلیٹ
choice	چن
choose	ژارنہٕ
chop	نِکراوُن
chores	کٲم
chubby	چبوتر
church	گرجہ گھر
cinnamon	دالچٮ۪ن
circle	دائرٕ
circumstances	حالات
citizen	شہری
city	شہر
claim	داواہ
clarify	وضاحت کر
class	کلاس
clay	میژ
clean	صاف
clear	صاف
clerk	کلرک
clever	چالاک
client	کلائنٹ
cliff	کلف
climate	آب و ہوا
climb	چڑھو
clingy	کلنگ
clock	گھنٛٹہٕ
close	بند کر
closet	کوٹھ
cloth	پوشاک
clothes	پلو
cloud	کلاؤڈ
cloudy	کلاؤڈی
clown	جوکُر
clue	کٗلو
clumsy	کلیمسی
cluster	کلسٹر
coach	کوچ
coal	کول
coast	ساحلی علاقہٕ
coat	کوٹ
coffee	کافی کافی
cognitive	نفسیٲتی
coincidence	اتفاقن
cold	سرد
collapse	ژٹتھ
collar	کالر
colleague	سٲتھی
colleagues	سٲتھی کارکنان
collect	جمع کر
collection	مجموعہٕ
college	کالج
color	رنگ
colorless green ideas slept furiously	بے رنگ سبز خیالات سوے غصہٕ سان
colour	رنگ
column	کالم
comb	کمب
combination	امتزاج
combine	یکجا کر
come	آو
come here	ٮ۪ٮ۪ور ٮ۪ۍ
come on	آو
comfort	آرام
comfortable	آرام دہ
coming	پیشین گوئی کر
coming soon	جلدی ینۍ
command	کمانڈ
comment	تبصرٕ
commercial	تجٲرتی
commission	کمیشن
commit	کر
commitment	وابستگی
committed	عہد بند
commodity	سامان
common	عام
communicate	کتھ باتھ کر
communication	کمیونیکیشن
community	کمیونٹی
commute	آمد و رفت کر
companion	سٲتھی
company	کمپنی
compare	موازنہ کر
comparison	موازنہ
compassion	ہمدردی
compassionate	رحم دل
compatible	ہم آہنگ
compete	مقابلہٕ کر
competent	قٲبل
competition	مقابلہٕ
competitive	مسابقتی
complain	شکایت کر
complaint	شکایت
complement	تکمیلی
complete	پوٗرٕ
completely	مکمل طور پر
complex	کمپلیکس
compliance	تعمیل
complicated	پیچیدٕ
compliment	تعریفیں
comply	تعمیل کر
composition	کمپوزیشن
compound	کمپاؤنڈ
comprehension	تفہیم
comprehensive	مکمل طور پر
compromise	سمجھوتہٕ
compulsory	ضٔروٗری
computer	کمپیوٹر
concentrate	توجہ مرکوز کرنا
concept	تصور
concern	فکر
concerned	فکر مند
concert	کنسرٹ
conclusion	نتیجہٕ
concrete	کنکریٹ
condition	حالت
conditions	حالات
conduct	طرز عمل
conference	کانفرنس
confess	اعتراف
confidence	ٹرٛنٹیشن
confident	بھروسہ
confirm	تصدیق کر
conflict	تنازعہ
confused	الجھنس منز
confusion	الجھن
congrats	مبارک باد
congratulation	مبارک باد
congratulations	مبارک باد
conjunction	کنجکشن
connect	کنیکٹ کر
conquer	فتح کر
conscious	آگہی
consciousness	شعور خیٲلی
consent	قبولیت
consequences	نتیجہٕ
conservation	بچاو
conservative	کنزرویٹو
consider	غور کریو
considered	غور کرتھ
consist	شٲمل
consistency	مستقل مزاجی
consistent	مستقل
constant	مستقل
constantly	لگاتار
constipation	قبضہٕ
construction	تعمیر
consume	کھیوان
consumption	کھپت
contact	رٲبطہٕ
contagious	متعدی
contain	اتھ منٛز چھ شٲمل
contains	اتھ منٛز چھ شٲمل
contemporary	معاصر
contempt	بے عزتی
content	مواد
contest	مقابلہٕ
context	تناظرس منز
continent	براعظم
continue	جٲری تھوو
contract	معاہدٕ
contrast	تضاد
contribute	تعاون کریو
contribution	حصہٕ
control	کنٹرول
controversial	تنازعہ
convenience	سہولت
convenient	آرام دہ
conversation	کتھ باتھ
convert	بدلاو
convey	بٲگراو
convince	یقین دہانی
convinced	یقین دہانی
cook	پکاو
cooking	کھین پکاون
cool	ٹھنڈا
cooperation	باہمی تعاون
cope	سمبھالتھ
copper	کاپر
core	کور
corn	مرغی
corner	کٗنن
correct	ٹھیک چھ
cost	قۭمت
costume	پوشاک
cottage	کاٹیج
cotton	کپاس
couch	سوٚپھ
cough	ژاس
could	ہیکہ ٲستۍ
council	کونسل
count	شمار کر
counter	کاؤنٹر
country	ملک
countryside	دیہی علاقہٕ
couple	جوٗرۍ
courage	ہمت
course	کورس
court	عدالت
courtesy	شائستگی
cousin	کزن
cover	کور
cow	گاؤ
coward	کاورڈ
cozy	کوزی
crab	کریب
crack	کریک
craft	کرافٹ
crap	بکواس
crash	کریش
craving	درٛاوٗن
crawl	کرال
crazy	پاگل پن
create	بناو
creative	تخلیقی
credit	کریڈیٹ
creep	کریپ
creepy	کریٚپ
crew	منیجر
crime	جرم
cringe	کرنٛگہ
crisis	کراس
criteria	معیارات
critical	تنقیدی
criticism	تنقیٖد
crop	فصل
crops	فصلہٕ
cross	کراس
crow	کووا
crowd	ہجوم
crowded	بھڈ
crown	تاج
crucial	اہم
cruel	کرول
cruise	کروز
crush	کرش
cry	رٮ۪وان
cucumber	ککڑی
cuddle	نالہ مُت کرُن
culture	ثقافت
cunning	چنک
cup	کپ
cupboard	چمچہ
curb	کرب
cure	علاج
curfew	کرفیو
curiosity	تجسس
curious	تجسس
curly	کرلی
currency	کرنسی
current	موجودٕ
currently	ونکینس
curse	لعنت
curtain	پردٕ
cushion	کوٹھ
custom	کسٹم
customer	کسٹمر
customs	رسم و رواج
cut	ژٹتھ
cute	خوبرو
cycle	سایکل
cycling	سایکل چلاو
dad	مٲلۍ
daddy	مٲلہ
daily	پرٛٮ۪تھ دۄہ
dairy	ڈایری
dam	ڈیم
damage	نقصان
damn	لعنتی
damp	نم
dance	ڈانس
danger	خطرٕ
dangerous	خطرناک
dark	تاریک
darling	مہربٲنی
dash	ڈیش
data	ڈیٹا
date	تٲریخ
daughter	کوٗر
day	دۄہہ
dead	مٔرتھ
deadline	ڈیڈ لائن
deaf	بوٕڑ
deal	سودا
dear	مہربٲنی
Dear All	پریٚے سٲری
Dear Customer	ٹوٹھ کسٹمر
Dear Parents	پیارے مول موج
Dear Sir	مہربٲنی سر
Dear students	پرآرہو طٲلبہ علمو
Dear Team	مہربٲنی ٹیم
death	موت
debate	بحث
debit	ڈبٹ
debris	کھنڈرات
debt	قرضہ
decade	دہ ورھے
decay	ڈیک
deceased	مٔرتھ
deceive	دھوکہ دیو
december	دسمبر
decent	شانٛدار
decide	فٲصلہٕ کر
decided	فٲصلہٕ
decision	فٲصلہٕ
deck	ڈیک
decline	کم کرن
decrease	کم کر
dedicated	وقف
dedication	وقف
deed	عمل
deep	سرٛن
deer	مرغی
default	ڈیفالٹ
defeat	شکست
defend	بچاو
define	وضاحت کر
definitely	یقینی طور
definition	تعریف
degree	ڈگری
delay	تاخیر
delayed	تاخیر
delete	ڈیلیٹ کر
deliberate	ارادٕ سان
delicate	حٔقیقت
delicious	مزٕ دار
delight	مزیٖد
delighted	مزیٖد
deliver	ڈلیور کر
delivered	ڈلیور
delivery	ڈلیوری
demand	منٛگ
demanding	منٛگ کرن
democracy	جمہوریت
demon	ڈیمن
demonstrate	نمٲئش کر
denied	انکار
density	ڈینسٹی
dentist	تجاویز
deny	انکار
department	محکمہٕ
departure	نیرٗن
depend	انحصار
deploy	تعینات کر
deposit	ڈپازٹ
depressed	ڈپریشن
depression	ڈپریشن
depth	سرٛن
describe	بیان کر
description	وضاحتیں
desert	صحرا
deserve	قابل
design	ڈزاین
designation	نامزدگیاں
desire	چاہت
desk	میز
despair	مایوسی
desperate	مایوس
despite	امہ باوجود
dessert	ڈیسرٹ
destination	منزل
destiny	تقدیر
destroy	تباہ کر
destruction	تباہ کن
detail	تفصیل
details	تفصیلات
detect	پتہ لگاو
determination	ارادٕ
determine	طے کر
determined	طے شدہ
devastated	تباہ کن
develop	ترقی
developed	تیار کرکھ
development	ترقی
device	ڈیوائس
devil	شیطانن
devoted	وقف
Dhivehi	دھیوی
diabetes	ذیابطیس
diarrhea	ڈایریا
diary	ڈایری
dictionary	ڈکشنری
did	کرکھ
die	مران
died	مٔرتھ
diet	غذا
difference	فرق
different	مختٔلف
difficult	مشکل
dig	حھنُن
dignity	وقار
diligent	مستعد
dinner	ڈنر
dip	ڈب
direct	براہ راست
direction	ڈایریکشن
director	ڈائریکٹر
dirt	میژ
dirty	گندھک
disable	غیر فعال کر
disabled	غیر فعال
disappear	غٲئب
disappointed	مایوس
disaster	آفات
discard	تراوکھ
discharge	ڈسچارج
discipline	نظم و ضبط
discount	رعایت
discover	دریافت کر
discrimination	تفریق
discuss	کتھ باتھ کر
discussion	بحث
disease	کم
diseases	بٮ۪مار
disguise	بھٮ۪س بدلاوُن
disgusting	ناگوار
dish	ڈش
dishes	پکوان
dismiss	رد کریو
dispatch	سوز
display	ڈسپلے کر
disposal	تخفیف
dispute	تنازعہ
distance	فاصلہٕ
distinct	الگ الگ
distinguish	فرق کر
distress	تکلیف
distribution	تقسیم کرنا
district	ضلعہٕ
disturb	پریشان کرن
ditch	ڈچ
dive	ڈائیونگ
diverse	مختٔلف
diversity	تنوع
divide	تقسیٖم کر
divine	دیوی
divorce	طلاق
dizzy	چکرٕ
do	کر
do you	کیا تہۍ چھوٕ
do you love me	کیٛاہ ژٕ چُکھ مےٚ پیار کران
doctor	ڈاکٹر
document	دستاویز
does	چھ کران
doesn't	چھنہٕ کران
dog	کٗنہ
Dogri	ڈوگری
doing	کران
doll	ڈول
domain	ڈومین
domestic	گھریلو
dominant	غلبہٕ دار
don't	کر نہٕ
Don't worry	فکر کریو مت
donate	ڈونیٹ کر
done	کرکھ
donkey	گاڑٕ
dope	ڈوپ
double	دۄگنہٕ
doubt	شک
dough	ڈول
down	بۄن
download	ڈاؤن لوڈ
draft	ڈرافٹ
drag	ڈریگ
drain	ڈرین
drama	ڈراما
draw	تراو
drawer	ڈراور
drawing	مصوری
dread	ڈراو
dream	خواب
dress	پلو
drill	ڈرل
drink	پیوٗن
drive	ڈرائیو کر
drop	ڈراپ
dropped	ترٲوتھ
drought	خشک سالی
drunk	شراب پیتھ
dry	خشک
duck	ڈک
dude	یار
due	واجب الادا
due to	امہ کہ وجہ سۭتۍ
dull	دمٲغی
dumb	گونٛب
dump	ڈمپ
duration	دورانیہ
during	دوران
dust	دھول
duty	ڈیوٹی
dwell	ڈول
dying	مران چھ
each	پرٛٮ۪تھ کانٛہہ
each other	اکھ اکس خٲطرٕ
eager	حٲران
eagle	عقاب
ear	کان
earlier	گۄڈے
early	جلدی
earn	کماو
ears	کَن
earth	زمین
earthquake	زلزلہ
ease	آرام
easily	آسان
east	مشرق کہ طرفہٕ
easy	سہل
eat	کھٮ۪ن
eating	کھٮ۪وان
economic	معٲشی
economy	اکانومی
edge	کنارٕ
edit	ترمیم کر
education	تدریس خصوصی
effect	اثر
effective	اثر دار
efficiency	کارکردگی
efficient	کارآمد
effort	کوشش
egg	انڈٕ
eggplant	بینکن
ego	اگو
eight	ٲٹھ
eighteen	ارداہ
eighty	شٮ۪تھ
either	یا تہ
elaborate	تفصیل
elbow	ہہہہہہہہہ
elder	بوڑ
elderly	بوڑٕ
elegant	شانٛدار
element	عنصر
elephant	ہاتھی
eleven	ژوٗرۍ
eligible	اہل
eliminate	ہٹاو
else	بیٚیہ
embarrassed	شرمسار
embarrassing	شرمناک
embrace	گلے لگاو
emerge	ابھرن
emergency	ایمرجنسی
emotional	جذبٲتی
empathy	ہمدردی
emphasis	زور
emphasize	زور
employee	کارکنان
employees	کارکنان
employer	ملٲزم
employment	نوکریاں
empty	خالی
enable	چالو کر
encounter	ملاقات
encourage	حوصلہٕ افضٲیی
end	ٲخٕری
endangered	خطرس منز
endeavor	کوشش کر
endurance	تحمل برداشت
endure	برداشت کر
enemy	دشمن
energy	توانٲئی محفوظ
engage	شٲمل کر
engaged	مصروف
engagement	منگنی
engine	انجن
engineer	انجینئر چھ
English	انگریز
enhance	بڑاو
enjoy	مزٕ کر
enormous	بجہ
enough	کٲفی
ensure	یقینی بناو
enter	دٲخل کر
entertainment	تفریح
enthusiasm	جوش
enthusiastic	پرجوش
entire	پوٗرٕ
entitled	عموٗمن
entity	ہستی
entrance	اژھو اندر اژنچ جاے
entrepreneur	کارٕبٲرۍ
envelope	لفافہ
environment	بہتری
envy	شرارت
epic	مہاکاوی
epidemic	مہاماری
equal	برابر
equipment	سازوسامان
equity	اکویٹی
equivalent	مساوی
eraser	ایراسر
error	غلطی
escape	ژلن
especially	خاص طور پٲٹھۍ
essay	تجربہٕ
essence	معموٗل
essential	ضروری
establish	قٲیم کر
established	قٲئم کر
estate	جائیداد
estimate	تخمینہ
estimated	اندازٕ
etc	وغیرہ
eternal	ابدی
ethics	اخلاقیات
evaluate	اندازٕ لگاو
evaluation	تشخیص
even	یوتتھ تام ز
even though	حالانٛکہ
evening	شام
event	واقعہٕ
eventually	ٲخر کار
ever	زانٛہہ تہ
every	پرٛٮ۪تھ کانٛہہ
everybody	پرٛٮ۪تھ کانٛہہ
everyone	پرٛٮ۪تھ کانٛہہ
everything	تمام چیز
evidence	ثبوت
evil	شر
evolution	ارتقاء
evolve	ارتقا
Ewe	گب
ex	سابقہ
exact	صحیح
exactly	بالکل
exam	امتحان
examine	جٲیزٕ
example	مثال
exceed	زیادٕ
excellent	بہت خوب
except	بجز
exception	مستثنی
excess	اضٲفی
excessive	حد کھوتہٕ زیادٕ
exchange	تبادلہٕ
excited	پرجوش
excitement	جوش
exciting	پرجوش
exclusive	خصوصی
excuse	معاف کر
excuse me	معاف کر
execute	چلاو
execution	ادایگی
executive	ایگزیکٹو
exercise	ورزش
exhaust	تھکُن
exhausted	تھکاوٹ
exhibit	نمٲئش
exhibition	نمٲئش
exist	موجود
existence	وجود
existing	موجودٕ
exit	نٮ۪بر
expand	بڑاو
expect	توقع
expected	توقعات
expenses	اخراجات
expensive	قۭمتی
experience	تجربہٕ
experiment	تجربہٕ
expert	تجربہٕ کار
expired	میعاد ختم
explain	وضاحت کر
explanation	وضاحت
exploit	استحصال کرن
explore	ژھار
export	برآمدات
expose	افشا کر
exposed	ہاونہٕ آمت
exposure	نمائش
express	ایکسپریس
expression	اظہار
extend	بڑاو
extended	بڑھوو
extension	ایکسٹینشن
extent	حدٕ
external	بیرونی
extinct	معدوم
extra	اضٲفی
extract	کڑن
extraordinary	غیر معمولی
extreme	انتہٲئی
extremely	انتہٲئی
eye	ٲچھ
eyes	ٲچھ
fabric	کپڑا
fabulous	شاندار
face	مو٘کھ
facilitate	سہولت فراہم کر
facilities	سہولیات
facility	سہولت
fact	حقیقت
factor	فیکٹر
factory	فیکٹری
facts	حقائق
fade	چکراو
fail	ناکام
failed	ناکام
failure	ناکٲمی
faint	دمٲغی
fair	معموٗلی
fairly	معموٗلی
fairy	پری
faith	عقیدٕ
faithful	وفادار
fake	فرضی
fall	ژلن
fall	وٮ۪س پٮ۪ون
FALSE	فایل
fame	شہرت
familiar	واقف
family	خاندان
famine	قحط
famous	مشہور
fan	فین
fancy	فینسی
fantastic	شاندار
far	دور
farewell	الوداع
farm	فارم
farmer	کاشتکار
fascinating	دلچسپ
fashion	فیشن
fast	تیز
fat	چربی
fatal	مہلک
fate	قسمت
father	مٲلۍ
fatigue	تھکاوٹ
fault	غلطی
favorite	پسندیدٕ
favour	فیور
favourite	پسندیدٕ
fear	خوف
feast	ضیافت
feather	پنکھ
feature	خصوصیت
features	خصوصیات
february	فروری
fed up	تھکاوٹ
fee	فیس
feed	کھٮ۪ن
feedback	فیڈ بیک
feel	محسوس کر
feeling	احساس
feet	پاٹھۍ
fell	درٛاو
fellow	سٲتھی
felt	آو محسوس کرنہٕ
female	زنانہٕ
fence	فنہ تعمیٖرات
fertile	زرخیزی
festival	تہوار
fetch	حٲصل کر
fever	بخار
few	کینٛہہ
fewer	کم
fiance	منگیتر
fiction	فکشن
field	مٲدان
fierce	سخت
fifteen	پنٛدہ
fifty	پنژاہ
fight	لڑو
fighting	لڑایہ
figure	فگر
figure out	ژھانٛڑو
file	فایل
fill	بھرتھ
filled	بھرتھ
film	فلم
filthy	گندھک
finally	ٲخر کار
finance	مالیات
financial	مٲلی
find	ژھار
find out	ژھانٛڑو
fine	ٹھیک چھ
finger	اُنگج
finish	ٲخٕری
finished	ختم کرکھ
fire	نار
firm	فرم
first	گۄڈے
first name	اصلی ناو
fish	گاڈٕ
fit	فٹ
five	پانژھ
fix	ٹھیک کر
fixed	فکسڈ
flag	جھنڈٕ
flash	فلیش
flat	فلیٹ
flaw	غلطی
flawless	بے عیب
flee	ژلن
flesh	ژاس
flew	اڑان
flex	فلیکس
flexible	لچکدار
flight	پرواز
flip	پلٹاو
flirt	فلرٹ
flirting	چھیڑ چھاڑ
float	فلوٹ
flood	سیلاب
floor	فرش
flour	آٹا
flow	بہاؤ
flower	پوش
flu	فلو
fluent	چاپلوسی
fluently	چاپلوسی
fluffy	فلفی
fluid	فلیوڈ
fly	اڑان
focus	توجہ مرکوز
fog	وُنل
foggy	دھند
fold	تہہ کر
folks	لوک
follow	پلے کر
follow up	فالو اپ کر
following	امہ پتہٕ
food	کھٮ۪ن
fool	بے وقوف
foolish	بے وقوف
foot	پاٹھ
football	فٹ بال
for	باپتھ
For example	مثلا
for instance	مثالہٕ پٲٹھۍ
for you	تۄہہ باپتھ
forbidden	ممنوع
force	طاقت
forecast	پیشن گویی
forehead	کھوپٕر
forehead	ڈیک
foreign	غٲر ملکی
forest	جنگل
forever	ہمیشہٕ خٲطرٕ
forget	بھولیو
forgive	معاف کر
forgot	بھولیو مت
fork	فورک
form	فارم
formal	رسمی
former	پرٲنۍ
fortunately	خوش قسمتی سان
fortune	بدقسمت
forty	ژتجی
forty-two	دٮ۪تآچی
forward	برٛونٛہہ کن
foster	پھراو
fought	لڑایہ
found	ملٮ۪وٚو
foundation	فاؤنڈیشن
four	ژور
fourteen	ژوٛدہ
fox	فاکس
fragile	کمزور
frame	فریم
framework	فریم ورک
fraud	فراڈ
freak	پریک
free	مفت
freedom	آزادی
freeze	فریز
frequency	تعدد
frequent	اکثر
frequently	اکثر
fresh	نوٚو
friday	جمعہ دۄہ
fridge	فریج
friend	دوست
friendly	دوستانہٕ
friends	دوستین
friendship	دوستی
frightened	خوفزدہ
frightening	خوفزدہ
frog	مینڈک
from	پیٹھہٕ
front	برٛونٛہہ کن
frozen	فریزر
fruit	پھل
frustrated	ناراضگی
fuel	ایندھن
Fulfulde	مکمل طور پر
full	پوٗرٕ
fun	مزٕ
function	فنکشن
fundamental	بنیادی
funeral	آخری رسومات
funny	مزٕ دار
fur	سورٕ
furious	غصہٕ دار
furniture	فنہ تعمیٖرات
further	امہ علاوٕ
furthermore	امہ علاوٕ
future	مستقبل
gain	نفع
game	گیم
gap	فرق
garage	گیراج
garbage	کچھر
garden	باغ
garlic	لہسن
gate	دروازٕ
gather	جمع کر
gathering	جمح کرن
gauge	گیج
gave	دیوٗت
gear	گیٔر
gender	جنسہٕ
general	جنرل
generally	عام طور پر
generate	بناو
generation	جنریشن
generous	فراخ دل
genius	جینیئس
genre	جینر
gentle	نرم
genuine	اصلی
gesture	حرکتہٕ
get	حٲصل کر
get dressed	پلو لٮ۪گٮ۪و
get up	وٮ۪تھٮ۪و
get well soon	جلدی ٹھیک گژھ
getting	ملٮ۪وٚو
ghost	بھوت
ghosting	گھوسٹنگ
giant	بوڈ
gift	تحفہٕ
ginger	ادرک
girl	کور
girlfriend	گرل فرینڈ
give	دیو
give up	ترٛاو
given	دنہٕ آمت
glad	خوش
glance	نظرٕ
glass	گلاس
glasses	شیشہٕ
glimpse	جھلک
global	عالمگیریت
gloomy	دمٲغی
gloves	دستانٕ
glow	چمک
glow up	چمکاو
glue	گوند
go	گژھ
go ahead	برٛۄنٛہہ گژھ
go away	چلاو دور
go to bed	بسترس پٮ۪ٹھ گژھ
goal	مقصد
goals	اہداف
goat	گوٹھ
god	بھگوان
god bless you	خدا کرنۓ رحم
goes	گژھان چھ
going	گژھان چھ
going to	یوان
gold	سونہٕ
gone	چلاو
gonna	کرٗن
goo	گو
good	اصل
good afternoon	گڈ افٹر نون
good bye	الوداع
good day	اصل دۄہ
good evening	گڈ نائٹ
good job	اصل کٲم
good looking	اصل نظر
good luck	خوش قسمت
good morning	گُڈ مارننگ
good morning	صُبح بخٮ۪ر
good morning my love	گڈ مارننگ ماے لو
good night	گڈ نائٹ
goodbye	الوداع
goodnight	گڈ نائٹ
goods	سامان
Google	گوگل
Google Translate	گوگل ترجمہٕ
goose	گوس
gorgeous	خوبرو
gossip	چیخ چیخ
got	ملٮ۪وٚو
got it	ملٮ۪وٚو
government	حکومت
grab	پکڑو
grade	درجہٕ بندی
gradually	بتدریج
graduate	گریجویٹ
grain	دانہ
grant	گرانٹ
granted	عطا کرکھ
grapes	ادرک
grasp	سمجنہٕ
grass	گھاس
grateful	شکر گزار
gratitude	تشکر زیاد
grave	قبر
gray	گرے
great	زبردست
greed	شرارت
greedy	لالچی
green	سبز رنگ
greet	سلام
greeting	سلام
greetings	سلام
grey	گرے
grid	گرڈ
grief	غم
grind	کریو پیسو
grip	گرپ
grocery	گروسری
groom	دولہا
gross	ہچکچاو
ground	مٲدان
group	گروپ
grow	بڑھو
growth	بڑھو
grumpy	کرومبی
Guarani	گوارانی
guarantee	گارنٹی
guard	گارڈ
guess	اندازٕ لگاو
guest	مہمان
guidance	ہدایت
guide	گائیڈ
guilty	مجرم
guy	یار
guys	یاران
gym	جم
habit	عادت
habitat	رہائش گاہ
had	اوس
hail	ہیلہ
hair	مس
half	نصف
hall	ہال
hand	اتھہ
handle	ہینڈل
handsome	خوبرو
hang	ٹھٲرو
hang out	ہینگ آوٹ
happen	چھ گژھان
happened	گوٚو
happiness	خوشی
happy	خوش
happy birthday	ہیپی برتھ ڈے
happy birthday to you	تۄہہ چھ برتھ ڈے مبارک
happy new year	ہیپی نیو یئر
hard	سخت
hardly	مشکل سان
hardly ever	بمشکل کنہ ساتہٕ
harm	نقصان
harmful	نقصان دہ
harmony	ہم آہنگی
harsh	سخت
harvest	فصلچ کٹائی
has	چھ
hate	نفرتہٕ
have	آسہٕ
have a good day	اکھ اصل دۄہ
have a nice day	اکھ اصل دۄہ
have breakfast	ناشتہ کر
have fun	مزٕ کر
have you eaten	کیٛاہ تۄہہ چھو کھٲومت
having	آسن
hazard	خطرٕ
haze	چپات
he	سہ
he has	أمس چھ
he is	یہ چھ
head	ہیڈ
headache	سردرد
heal	شفا
healing	شفا یابی
health	صحت
healthy	صحت مند
hear	بوزن
heard	بوزن
heart	دل چھ
heat	گرمی
heaven	آسمان
heavy	ہیور
hectic	حٲران
height	اونچٲئی
heir	مٲلس ماجہٕ
heist	ہیسٹ
held	منعقد کرنہٕ آمت
hell	جہنم
Hello	ہیلو
hello dear	ہیلو مہربٲنی
hello how are you	ہیلو ، ژٕ کیتھ چھ ؟
hello how are you doing	ہیلو ، توہہ کیتھ چھو
helmet	ہیلمٹ
help	مدد کر
helpful	مددگار
hence	لحاذا
her	تس
herd	ریوڑ
here	یتہٕ
heritage	وراثت
hesitate	ہچکچاو
Hey	ہیلو
Hi	ہیلو
hi how are you	ہیلو ، ژٕ کیتھ چھ ؟
Hi there	ہیلو تتہٕ
hidden	چھپاو
hide	چھپاو
hierarchy	ہائرارکی
high	اونچی
highlight	نمایاں کر
hike	پیدل پکن
hiking	پیدل سفر
hilarious	مزٕ دار
hill	پہاڑ
him	أمس
hint	ہینڈ
hip	ہپ
hips	چھٹھ
hire	کرایہ
hiring	کرایہ دٲری
his	تمہ سند
history	تٲریخ
hit	ہٹ
Hmm	اممم
hobby	شوق
hold	تھٲیو
hold on	ٹھہرو
hole	کھوکھلہٕ
holiday	چھٹی
hollow	کھوکھلہٕ
home	گرٕ
homework	ہوم ورک
honest	ایماندار
honestly	دیانت سان
Honey	مہربٲنی
honor	عزت
hood	ہوڈ
hook	ہک
hop	ہاپ
hope	امیدٕ
hopefully	آسہٕ
hopeless	نا امید
horizontal	افقی
horn	ہارن
horrible	خوفناک
horror	خوفناک
horse	گرٕ
hospital	ہسپتال
hospitality	مہمان نواز
host	میزبان
hostile	دشمن
hot	گرم
hotel	ہوٹٕل
hour	گھنٹہٕ
hours	گھنٹہٕ
house	گھر
household	گھرٕ
how	کتھ کٔنہ چھ
how about you	تۄہہ کیٛاہ چھ
how are you	ژۭ چُکھ ٹھٮ۪ک؟
how are you doing	ژٕ کیٛاہ چُکھ کران
how are you doing today	از کیتھ چھو توہہ ؟
how are you today	از کیتھ چھو ژٕ ؟
how do you do	ژٕ کتھ کٔنہ چھی پٮ۪ۍ
how is	کیتھ چھ ؟
how many	کۭتیہ چھ
how much	کۭتیہ چھ
how often	کۭتیہ چھ یوان
how old are you	توہہ کۭتیہ وہر چھو ؟
how was your day	تہنٛد دۄہ کیتھ اوس ؟
how was your night	تہنز راتھ کیتھ ٲس ؟
however	وونہ گو٘
hub	ہب
hubby	خاندار
hug	گلے لگاو
huge	بجہ
human	انسان
humble	معموٗلی
humid	مرطوب
humidity	نمی
hundred	ہتھ
hungry	بھوکھ
hunt	شکار
hurricane	ہریکین
hurry	جلدی کر
hurry up	جلدی کریو
hurt	زخم
husband	خانٛدار
hustle	ہسٹل
hut	کوٹھ
hygiene	حفظان صحت
I	بہٕ
I am	بہٕ چَۭھس
I am fine	بہٕ چھس ٹھیک
I can	بہٕ ہیٚکہٕ کٔرتھ
I can't	بہٕ ہیٚکہٕ نہٕ یہ کٔرتھ
I do	بہٕ چھس کَران
I do not know	مہ چھن پائی
I do not understand	سمجھہ نہٕ آمژٕ
I don't	بہٕ ہیٚکہٕ نہٕ یہ کٔرتھ
I don't know	مٮے چھنٕہ پتٕہ
I don't understand	سمجھہ نہٕ آمژٕ
I don't understand what you mean	بہٕ چھس نہٕ سمجان ز تہنٛد مطلب کیا چھ
I don't understand you	مےٚ اوس نہٕ زانٛہہ سوٗنٛچمت
I don’t know	مہ چھون پاے
I don’t understand	سمجھہ نہٕ آمژٕ
i guess	بہٕ چھس سونٛچان
I had	مےٚ اوس
I have	مےٚ چھ
I have been	بہٕ آسہٕ
I hope so	بہٕ چھس امید کران ز
I know	مےٚ چھ خبر
I like	مےٚ چھ پسند
I like you	بہٕ چھس یژھان تۄہہ پسند کران
I love	مے چھ محبت
I love my big brother	بہٕ چھس پننس بڑس بٲیس سۭتۍ محبت کران
I love my big sister	مےٚ چھےٚ پنٛنہ بٔڑ بینہ سۭتۍ محبت
I love my father	بہٕ چھس پننس مٲلس سۭتۍ محبت کران
I love my little brother	بہٕ چھس پننس لۄکٹس بٲیس پیار کران
I love my little sister	بہٕ چھس پننس لۄکٹس بینس پیار کران
I love my mother	بہٕ چَۭھس پَنٛنہِ مَاجہِ سۭتۍ محبت کَران
I love you	بٮے چُھسٮٮۍ ژٕ محبت کران مہ چٌھ چون موحبت
I love you so much	جاننننننننننن
I love you too	بہ تہ چھسی ژی محبت کران
I mean	بہٕ چھس مطلب
I miss you	بہٕ چھس تۄہہ مس کران
I miss you so much	بہٕ چھس تۄہہ واریاہ یاد کران
I see	بہٕ چھس ؤچھان
I think	بہٕ چھس سونٛچان
I understand	بہٕ چھس سمجان
I want	بہٕ چھس یژھان
I want to see you	بہٕ چھس یژھان تۄہہ وچھنہٕ
I want you	بہٕ چھس یژھان ژٕ
I was	اوس بہٕ
I will	بہٕ گژھہٕ
I would be	بہٕ آسہا
I'm	بہٕ چَھس
I'm fine	بہٕ چھس ٹھیک
I'm good	بہٕ چھس اصل
I'm here	بہٕ چَۭھس یٔیتٛۍ
I'm sorry	بہٕ چھس افسوس کران
ice	آیسک
ice cream	آئس کریم
idea	خیال
ideal	آئیڈیل
identical	یکساں
identify	شناخت کر
identity	شناخت
idiot	بے وقوف
idle	بیکار
if	اگر
ignore	نظر انداز کر
ill	بیمار
illegal	غٲر قونوٗنی
illness	بیمار
Ilocano	ایلوکانو
image	تصویرٕ
imagine	تصور کریو
immediate	فورا
immediately	فورا
immense	بڑٕ
impact	اثر
impatient	بے صبری
implement	لاگو کر
import	امپورٹ
important	اہم
impose	لگاو
impossible	ناممکن
impress	متٲثر کرن
impression	تاثرات
impressive	متاثر کن
improve	بہتر بناو
improvement	بہتری
in	اتھ منز
in addition	امہ علاوٕ
In fact	در حقیقت
in front of	برونٹھ
in order to	اتھ خٲطرٕہ
inappropriate	نامناسب
incentive	ترغیب
incident	واقعہٕ
include	شٲمل
including	یمن منز زن
income	آمدٲنی
inconvenience	تکلیف
increase	بڑاو
increased	بڈھاوُن
incredible	ناقابل یقین
indeed	حٔقیقت
independent	آزاد
India	ہندوستان
indicate	ظٲہر کر
indigenous	مقٲمی
individual	انفرادی
industry	صنعت
inevitable	ناگزیر
infant	بچہٕ
infection	انفیکشن
infinity	لامحدود
inflammation	سوجن
inflammation	ورم
inflation	افراط زر
influence	اثر و رسوخ
inform	اطلاع دیو
information	معلومات
ingredients	اجزاء
inheritance	وراثت
initial	ابتدٲئی
initiative	پہل
injured	زخمی
injury	زخم
innocent	بے قصور
innovation	اختراعات
inquiry	جٲیزٕ
insane	پاگل پن
insect	کیٚمۍ
insecure	غیر محفوظ
insert	دٲخل کر
inside	اندٕ اندٕ
insight	تفہیم
insist	اصرار
insomnia	انسومنیا
inspiration	ترغیب
inspire	متٲثر کرن
install	انسٹال کر
instance	مثالہٕ
instant	فوری
instead	امہ بجایہ
instead of	امہ بجایہ
instructions	ہدایت
instrument	سازوسامان
insult	بے عزتی
insurance	انشورنس
intact	غیر محفوظ
integrity	عموٗلیت
intellectual	فکری
intelligence	ذہانت
intelligent	ذہین
intend	ارادٕ
intended	ارادٕ
intense	شدید
intention	ارادٕ
interact	رٲبطہٕ
interaction	تعامل
interest	دلچسپی
interested	دلچسپی
interesting	دلچسپ
interfere	مداخلت کر
intermediate	انٹرمیڈیٹ
internal	اندرونی حصص
international	بین الاقوٲمی
internship	انٹرن شپ
interpret	تشریح کر
interpreter	ترجمہٕ کار
interrupt	رکاو
interview	انٹرویو
intimate	نزدیکی
into	اتھ منز
introduce	تعارف
introduction	تعارف
introvert	انٹروورٹ
intuition	وجدان
invalid	ناکارٕہ
invent	ایجاد کر
inventory	انوینٹری
invest	سرمایہ کٲری کر
investigate	تحقیق کر
invitation	مشٲہدٕ
invite	مدعو کر
invoice	انوائس
involve	شٲمل کر
involved	شٲمل
iron	آیٔرن
is	چھ
island	جزیرٕ
isolated	الگ تھلگ
issue	مسلہٕ
issues	مسٲئل
it	یہ
it is	یہ چھ
it was	اوس یہ
it's	یہ چھ
it's ok	یہ چھ ٹھیک
It's okay	یہ چھ ٹھیک
item	چیز
items	اشیاء
its	امکہ
I’m	بہٕ چَھس
jacket	جیکٹ
jail	جیل
January	جنوری
jar	جوار
jaw	دنٛدِ ووٹ
jealous	شرارت
jerk	کرک
jewelry	زیورات
job	کٲم
jogging	جاگنگ
join	شٲمل گژھن
joint	مشترکہٕ
joke	جوک
journalist	صحافی
journey	سفر
joy	خوشی
judge	جج
juice	رس
july	جولائی
jump	جمپ
june	جون
junk	جنک
just	صرف
just do it	بس کر یہ
justice	انصاف
justify	جواز پیش کرن
Kalaallisut	کالایلسوٹ
Kashmiri	کشمیری
keen	خوشۍ
keep	تھوو
keep it up	یہ تھٲیو تھوو تھوو
kept	تھاونہٕ آمت
kettle	کیٹل
key	چابی
kick	کک
kid	شُر
kidding	مزٕ کران
kidney	گردٕ
kids	بچہٕ
kill	مارنہٕ
kind	قٕسم
kinda	کینڈا
kindly	مہربٲنی سان
kindness	رحمدلی
king	بادشاہ
kiss	بوسہ
kitchen	کچن
kite	پتنگ
kitten	بٮ۪ار بچہٕ
knee	کوٹھۍ
knew	جان ٲس
knife	چھری
knight	نائٹ
know	جان
knowledge	علم
known	زاننہٕ چھ یوان
Konkani	کونکنی
Krio	کریو
label	لیبل
labor	کٲم
labour	لیبر
lack	کمی
ladder	لیڑٕ
lady	زنانہ
laid	تراوکھ
lake	جھیل
lamb	لمبٕ
lame	لنگہٕ
lamp	لیمپ
land	زمین
landscape	زمینک تزئین
language	زبان زبان
lap	کوٹھ
large	بجہ
last	ٲخٕری
last but not least	ٲخٕری مگر کم کھوتہٕ کم
last name	ٲخری ناو چھ
late	ژیر
lately	حال حالٕے
later	پتہٕ
latest	ٲخٕری
latter	مؤخر الذکر
laugh	ہنس
laughing	ہنسان
laughter	ہنس
launch	لانچ کر
laundry	لانڈری
law	زٕ
lawn	لارن
lawyer	وکیل
lay	لاے
layer	تہہ
layout	ترتیب
lazy	سست
lead	لیڈ
leader	رہنما
leaf	پتہٕ
leak	لٮ۪کھ
lean	زیٹھ
leap	چھلانگ
learn	ہیٚچھو
learning	ہیچھان
lease	کرایہ
least	کم از کم
leather	چمچہ
leave	تر٘او
leaves	پتے
led	لیڈ
left	دٔچھنہ
leg	ٹانگ
legacy	میراث
legal	قونوٗنی
legend	لیجنڈ
legit	قانونی
leisure	فرصت
lend	ادھار
length	زیچھر
less	کم
lesson	سبق
let	چٕھ
letter	لیٹر
lettuce	لیٹوس
level	سطح
leverage	لیوریج
liability	ذمہٕ دٲری
library	کتب خانہٕ
lick	چاٹ
lie	جھوٹھ
lies	جھوٹھ
life	زندگی
lift	لفٹ
light	روشنی
lightning	بجلی
like	یتھ کٔنۍ
likely	امکان چھ
likewise	اتھۍ پٲٹھۍ
line	لٲنہ
Lingala	لنگالا
link	ربط
lion	شیر
liquid	مائع
list	فہرست
listen	بوزن
listening	بوزن
literally	لفظی طور پر
literature	ادبیات
litter	لیٹر
little	لٹل
live	زندٕ
liver	لور
lives	زندگی
living	زندٕ
living room	روزنک کمرہ
lizard	چھپکلۍ
load	لوڈ کر
loaf	ژوٹ
loan	قرضہ
local	مقٲمی
location	مقام
lock	لاک
lockdown	لاک ڈاؤن
log	لاگ
lol	لول
lonely	اکیلا
long	زیٹھ
long time no see	واریاہ کال چھنہٕ وچھنہٕ آمت
look	وچھیو
loop	لوپ
loose	ڈھیلا
lord	مٮ۪لک
lose	ہارنہٕ
loss	نقصان
lost	ہارنہٕ آمٕژ
lot	واریاہ
loud	زور
lounge	لاؤنج
love	محبت
love you	مےٚ چُھ چۄن لۄ ل(محبت)
lovely	مہربٲنی
low	کم
lower	کم کر
loyal	وفادار
loyalty	وفادار
luck	قسمت
lucky	خوش قسمت
Luganda	لوگنڈا
luggage	سامان
lump	گانٹھ
lunch	لنچ
lungs	شوش
luxury	لگژری
lying	جھوٹ بوزن
machine	مشین
mad	پاگل
madam	میڈم
made	بنٲوۍ
magazine	میگزین
magnificent	شاندار
maid	نوکرانی
main	اہم
maintain	برقرار تھونہٕ
maintenance	دیکھ بھال
Maithili	میتھلی
major	میجر
majority	اکثریت
make	بناو
make up	بناو
male	مرد
mall	مال
man	انسان
manage	انتظام کر
management	انتظام
manager	منیجر
mandatory	ضروری
manifest	ظٔہر کر
manipulate	جوڑ توڑ کر
manner	طریقہٕ
manual	دستی
many	واریاہ
many many happy returns of the day	دۄہہ ہنٛد واریاہ زیادٕ خوشگوار واپسی
march	مارچ
margin	مارجن
market	بازر
marriage	ازدواجیہ
married	خانٛدر کٔرتھ
mask	ماسک
mass	ماس
massive	بٔڑس پیمانس پٮ۪ٹھ
master	ماسٹر
match	میچ
mate	یار
material	مواد
math	ریاضی
matter	چیز
maturity	پختگی
may	ہیکہ ٲستۍ
maybe	شاید
me	مے
me too	مےٚ تہ
meal	کھٮ۪ن
mean	مطلب
meaning	معنی
means	مطلب چھ
meant	مطلب
meanwhile	اتھ دوران
measure	پیمٲیش
measures	اقدامات
meat	مرغی
medical	طبی
medicine	دوا
meditation	مراقبہ
medium	میڈیم
meet	ملن
meeting	میٹنگ
Meiteilon	مایتیلاون
melt	پلن
memories	یادداشتہٕ
memory	یاد داشت
mental	ذہنی
mention	ذکر کر
mentioned	ذکر کرنہٕ آمت
mentor	سرپرست
merchant	سوداگر
mercy	رحم کر
merely	صرف
merry christmas	میری کرسمس
mess	میس
message	میسج
messy	میزی
metal	دھات
method	طریقہٕ
mice	ماؤس
middle	وسط
midnight	آدھی رات
might	ہیکہ گژھتھ
mild	ہلکہٕ
milestone	سنگ میل
military	فوٗجی
milk	دودھ پلاو
million	دہ لچھ
mind	ذہن
mindset	ذہنیت
mine	میٲنۍ
mingle	منگلا
minor	نابالغ
minute	منٹ
minutes	منٹ
miracle	معجزات
mirror	شیشہ
miscellaneous	متفرق
mischievous	شرارتی
miserable	دکھی
misery	شرارت
miss	مس
miss you	تۄہہ چھوٕ یاد یوان
missing	لاپتہ
mission	مشن
mist	دھند
mistake	غلطی
Mizo	میزو
mobile	موبل
mock	موک
model	ماڈل
moderate	اعتدال پسند
modern	ماڈرن
modest	معموٗلی
moist	مرطوب
moisture	نمی
mold	مولڈ
mole	مول
mom	ماما
moment	مومنٹ
monday	سوموار
money	پونٛسہٕ
monitor	نگرٲنی کر
monkey	مرغی
month	رٮ۪تہٕ
mood	موڈ
moody	موڈی
moon	زوون
moral	مورکل
more	زیادٕ
moreover	امہ علاوٕ
morning	صبح
mortgage	گروی رکھ
most	زیٛادٕ تر
mostly	زیادٕ تر
mother	ماما
motion	حرکت
motivation	محرکات
mountain	پہاڑ
mouse	ماؤس
mouth	بوتھ
move	چلاو
movement	نقل و حرکت
movie	فلم
mrs	مس
much	واریاہ
mud	مڈ
mug	مگن
muscle	مژھ
museum	میوزیم
mushroom	ہٮ۪ڈر
mushroom	مشروم
music	موسیقی
must	پزنۍ
mute	خاموش کر
mutual	بٲہمی
my	میٲنۍ
My dear	مہربٲنی
my friend	میٚون دوست
My hovercraft is full of eels	میٚٲنۍ ہوور کرافٹ چھ ایلن سۭتۍ بھرتھ
my love	میٲنۍ محبت
my name is	میٚون ناو چھ
my pleasure	میٲنۍ خوشی
myself	بہٕ چھس پانۍ
mysterious	رازدارانہ
mystery	راز
myth	فرضٮی داستان
nail	کیل
naive	بے حیائی
name	ناو
narrative	بیانیہ
narrow	تنگ
nasty	بدصورت
national	قومی
nationality	قومیت
native	مقٲمی
natural	بہٕ چھس یژھان
nature	فطرت
nausea	دمٲغی
near	نزدیک
nearby	نزدیک
nearly	لگ بگ
neat	صاف
necessary	ضروری
neck	گردن
necklace	ہار ہار
need	ضرورت
negative	منفی
neglect	نظر انداز کرنا
negotiate	کتھ باتھ
neighbor	ہمسایہ
neighborhood	ہمسایہٕ
neither	نہ تہ
nephew	بٲیس
nerd	نیرڈ
nervous	نروس
nest	نیسٹ
net	نیٹ
network	نیٹ ورک
neutral	غیر جانبدار
never	زانٛہہ تہ
never give up	زانٛہہ تھٲیو مت
never mind	کانٛہہ تہ خیال
nevermind	چھنہٕ کران
nevertheless	تاہم
new	نوٚو
news	خبرٕ
next	پتہٕ
next to	امہ پتہٕ
nice	اچھ
nice to meet you	تۄہہ ملتھ گوٚو خوشی
niece	نننننن
night	راتھ
nightmare	ڈراؤنا خواب
nine	نو
nineteen	کنوہ
ninety	نمت
No	نہ
no problem	کانٛہہ مسلہٕ
no way	کانٛہہ طریقہٕ
nobody	کانٛہہ تہ نہٕ
noise	شور
noisy	شور
none	کانٛہہ تہ نہٕ
noon	دپہر
nope	ناے
nor	نہ تہ
normal	نارمل
north	شمال مشرق
nose	ناکہٕ
nostalgic	نوسٹالجک
not	نہٕ
not at all	بالکل نہ
not bad	خراب چھنہٕ
Not now	وینکینس چھنہٕ
not yet	وونہ گو٘
note	نوٹ
noted	نوٹ کرکھ
nothing	کانٛہہ تہ نہٕ
notice	اطلاع
noticed	مشٲہدٕ
noun	اسم ناو
nouns	ناو
novel	ناول
november	نومبر
now	وۄنۍ
nowadays	از کل
nuisance	پریشان کن
null	نلہ
numb	ننن
number	نمبر
nurse	نرسیں
nut	نٹ
nutmeg	نٹمیگ
nutrition	غذائیت
oath	حلف
obesity	موٹاپا
obey	اطاعت کر
object	چیز
objective	مقصد
obligation	ذمہٕ دٲری
obscure	غٲر واضح
observation	مشٲہدٕ
observe	مشٲہدٕ کر
obsessed	حٲران
obsession	جنونی
obsolete	معدوم
obstacle	رکاوٹ
obtain	حٲصل کر
obtained	حٲصل کٔرۍ
obvious	واضح
obviously	واضح طور پٲٹھۍ
occasionally	کنہ ساتہٕ
occupation	پیشے
occupied	قبضہٕ
occur	چھ گژھان
occurred	گوٚو
occurs	چھ گژھان
ocean	سمندر
october	اکتوبر
odd	عجیب
odds	اوڈس
of	کس کس
of course	بلکل
off	بنٛد
offensive	اشتعال انگیز
offer	پیشکش
office	دفتر
official	سرکٲری افسر
often	اکثر
Oh	اوہہ
oh really	او واقعی
oil	تیل
ok	اوکے
ok dear	اوکے مہربٲنی
ok honey	اوکے مایہ
ok my love	اوکے میٲنۍ محبت
okay	ٹھیک چھ
okay baby	اوکے بیبی
okay dear	ٹھیک چھ مہربٲنی
okay honey	اوکے مایہ
okay my love	ٹھٮ۪ک چھو زُوا
old	پرٛانہ
on	اتھ پیٹھ
once	اکہ لٹہ
one	اکھ
one language is never enough	اکھ زبان چھ نہٕ کٲفی کینٛہہ
onion	پیاز
online	آن لائن
only	صرف
open	کھول
operation	آپریشن
opinion	رائے
opportunities	مواقع
opportunity	موقعہ
opposite	برعکس
optimistic	پرامید
option	انتخاب
optional	اختیاری
or	یا
orange	نارنجی
order	آرڈر
ordinary	ناقابل یقین
organization	تنظیم تنظیم
orientation	سمت بندی
origin	اصل
original	اصلی
Oromo	ارومو
orphan	یتیم
other	باقی
otherwise	بصورت دیگر
ought	آسن
our	اسہ
Our mission: to enable everyone, everywhere to understand the world and express themselves across languages.	سٲنۍ مشن: پرٛٮ۪تھ کٲنٛسہ ، پرٛٮ۪تھ جایہ دنیا سمجنس تہٕ زبانن منٛز پنن اظہار کرنس قٲبل بناون
Our mission: to organize the world's information and make it universally accessible and useful.	سانہ مشن چھ دنیاہچ معلومات منظم کرٕن تہٕ اتھ عالمی سطحس پیٹھ دستیاب تہٕ کارآمد بناون
out	نیبرٕ
outcome	نتیجہٕ
outfit	پوشاک
outgoing	نٮ۪بر گژھان
outlet	آؤٹ لیٹ
outline	خاکہ
outside	نیبرم
outstanding	نمایاں
oven	اوون
over	اتھ پٮ۪ٹھ
over there	اتھہ پیٹھ
overall	مجموعی طور پر
overcome	قابو کٔرن
overthinking	حدٕ کھوتہٕ زیادٕ سوچ
overwhelmed	مغلوب
overwhelming	زبردست
owe	واجب الادا
owl	اوول
own	پنن پان
owner	مٲلکہٕ
ox	داند
pace	رفتارٕ
pack	پیک
package	پیکج
paid	ادا
pain	دگ
paint	پینٹ
painting	پینٹنگ
pair	جورٕ
pale	پایہ رنگ
palm	پام
pan	پین
pandemic	پانڈیمک
panic	گھبراو
pants	پینٹ
paper	کاغذ
paradise	جنت
parallel	متوازی
parcel	پارسل
pardon	معاف کر
parents	مٲلس ماجہٕ
park	پارک
parrot	طوطا
parsley	مرسیدس بنز
part	حصہٕ
participate	شرکت کر
particular	خاص پٲٹھۍ
particularly	خاص پٲٹھۍ
partner	پارٹنر
party	پارٹی
pass	پاس کر
passage	گزرگاہ
passed	گزری
passion	شوق
passionate	پرجوش
passive	غیر فعال
password	پاس ورڈ
past	پٔتمہ
patch	پیچ
path	وتھ
pathetic	شرمناک
patience	تحمل
patient	مریضہ
pattern	نمونہٕ
pause	رک
pavement	پاتھ پاتھ
pay	پے کر
payment	ادایگی
peace	امن
peaceful	پر امن
peach	پیور
peak	پیک
pear	پایہ
peas	مٹر
peculiar	خاص
pee	ژھایہ
peel	ژول
peer	پیر
peers	پیئرز
pen	پین
pencil	پینسل
pending	زیر التوا
people	لوک
pepper	کالی مرچ
perceive	سمجھن
perception	تصورات
perfect	کامل
perform	اداکٲری کر
performance	کارکردگی
perhaps	شاید
period	مدت
permanent	مستقل
permission	اجازت
permit	اجازت نامہٕ
perseverance	تحمل
persistent	مستقل
person	شخص
personal	ذٲتی
personality	شخصیت
perspective	نقطہ نظر
persuade	قائل کرنا
pervert	بدکردار
pet	پاٹھ
phase	مرحلہٕ
phenomenon	واقعہ
philosophy	فلسفیانہٕ عمل
phone	فون
photo	فوٹو
phrase	فقرہ
physical	فزیکل
pick	چن
pick up	پک اپ کر
picture	تصویر
piece	ٹکرٕ
pieces	ٹکڑٕ
pig	سور
pigeon	کبوتر
pile	پیپل
pillow	کھوپٕر
pilot	پائلٹ
pin	پن
pineapple	وایرل
pink	گلابی رنگ
pit	پاٹھ
pitch	پچ
pity	افسوس
place	جاے
places	جائے
plague	پلےگ
plain	سادٕہ
plan	منصوبہٕ
plane	ہوٲئی جہاز
plant	کل
plant	پودٕ
plants	قؤل
plants	پودٕ
plate	پائیدار
platform	پلیٹ فارم
play	پلے کر
playing	گنٛدن
pleasant	مزٕ دار
please	مہربٲنی کٔرتھ
pleased	خوش
pleasure	مزیٖد
pledge	وعدٕ
plenty	واریاہ
plot	پلاٹ
plug	پلاگ
plum	پلم
plumber	پلمبر
plural	کثرت
podcast	پوڈ کاسٹ
poem	نظم
poetry	شاعری
point	پوائنٹ
poison	زہر
police	پلیس
policy	پالیسی
polite	شائستہ
pollution	آلودگی
pond	تالاب
pool	تالاب
poop	پوپ
poor	غریب
pop	پاپ
popular	مقبول
population	آبٲدی
pork	سورک سور
porridge	چنہٕ چنہٕ
port	پورٹ
position	پوزیشن
positive	پوزیٹیو
possess	ملکیت
possession	ملکیت
possessive	ملکیت
possible	ممکن
post	پوسٹ
postpone	موخر کر
potato	پوٹلو
potential	ممکن
pound	پاؤنڈ
poverty	غربت
power	پاور
powerful	طاقتور
practical	پریکٹیکل
practice	پریکٹس
praise	تعریفیں
prank	شرارت
pray	دعا کر
precious	قۭمتی
precise	عین مطابق
precisely	بالکل ٹھیک
predict	پیشن گویی
prefer	ترجیٖح
preference	ترجیٖح
pregnant	حاملہ
prejudice	تعصب
premises	احاطہ
premium	پریمیم
preparation	تیار کرن
prepare	تیار کر
prepared	تیار
preposition	پریپوزیشن
presence	موجودگی
present	موجود
presentation	پیشکش
preserve	بچاو
president	صدر
press	پریس کر
pressure	دباو
pretend	دکھاوا کر
pretty	خوبرو
prevent	رکاو
previous	پٔتمہ
prey	پرے
price	قۭمت
pride	فخریہ
priest	پادرین
primary	بنیٲدی
prime	پرٛایم
princess	راجکماری
principal	پرنسپل
prior	برٛونٛہہ کنہ
priority	ترجیحی
prison	جیل
privacy	پرائیویسی
private	پرائیویٹ
privilege	استحقاق
prize	انعام
probably	شاید
problem	مسلہ
procedure	طریقہ کار
proceed	برٛۄنٛہہ پکۍ
process	عمل
produce	پروڈکشن
product	پروڈکٹ
production	پروڈکشن
profession	پیشے
professional	پیشورانہٕ
profile	پروفائل
profit	نفع
profound	سرٛن
progress	پیش رفت
project	پروجیکٹ
prominent	نمایاں
promise	وعدٕ کر
promote	فروغ دین
promotion	پروموشن
prompt	پرامپٹ
prone	پراونٹ
pronouns	ضمٮ۪ر
pronunciation	ترجمہٕ
proof	ثبوت
proper	اصل
properly	اصل پٲٹھۍ
properties	خصوصیات
property	ملکیت
proposal	تجاویز
prospect	امکان
prosperity	خوشحالی
prosperous	خوشبٲنی
protect	بچاو
proud	فخر
prove	ثٲبت کر
provide	فراہم کر
provided	فراہم کردہ
province	صوبہٕ
provision	پروویژن
puberty	بلوغت
public	عوٲمی
pull	پل
pumpkin	کبوتر کبوتر
punctual	وقتا فوقتا
pupil	شاگرد
purchase	خرید
pure	خالص
purple	جامنی رنگ
purpose	مقصد
purse	پرس
pursue	پیچھا کر
pursuit	تعاقب
push	پش کر
put	تھوو
qualification	اہلیت
quality	کوالٹی
quantity	مقدار
quarantine	قرنطینہ
quarrel	لڑایہ
quarter	ژوٗرم حصہٕ
Quechua	کیوا کیوا
queen	ملکہ
queer	کویر
query	سوال
question	سوال
queue	لٲنہ
quick	جلدی
quickly	جلدی
quiet	چپ
quilt	لٮ۪نف
quit	بنٛد کر
quite	کٲفی
quiz	کوئز
quotation	اقتباس
quote	اقتباس
quotes	تبصرٕ
rabbit	خرگوش
race	ریسہ
rage	شرارت
rain	رود
raise	بڑاو
raised	بڑھوو
ran	بھگوان
random	بے ترتیب
range	رینج
rapid	تیز
rapidly	جلدی
rare	نایاب
rarely	شاذ و نادر
rash	ژاس
rat	راٹ
rate	شرح
rather	امہ بجایہ
ratio	تناسب
rational	عقلی
raw	راے
re	ری
reach	واتہ
reached	واتہ
reaction	رد عمل
read	پڑھو
reading	پرن
ready	تیار
real	اصلی
reality	حقیقت
realize	احساس
realized	احساس
really	اصلس منز
rear	پٔتمہ طرفہٕ
reason	وجہ
reasonable	معقول
recall	یاد کرن
receipt	رسید
receive	وصول کر
received	موصول
recent	حالٕے
recently	حالٕے
reception	استقبالیہ
recipe	ریسیپی
reckless	آشیرواد
recognition	شناخت
recognize	پہچان
recommend	تجویز کریو
recommended	تجویز کردہ
record	رکارڈ
recover	بازیافت
recovery	بازیافت
rectangle	مستطیل
red	وزل
redeem	بچاو
redemption	چھٹکارا
reduce	کم کر
redundant	لاحاصل
refer	ریفر کر
reference	حوالہ جات
reflect	عکاس کر
reflection	عکاس
refrain	رٗکاو
refrigerator	ریفریجریٹر
refund	واپسی
refuse	انکار کر
refused	انکار
regard	خیال
regarding	متعلقہٕ
regardless	قطع نظر
regards	احترام
region	علاقہٕ
register	رجسٹر کر
regret	افسوس
regular	باقٲعدٕ
regularly	باقٲعدگی سان
reject	رد کر
relate	متعلقہٕ
related	متعلقہٕ
relationship	رٲبطہٕ
relative	رشتہ دار
relatives	رشتہ دار
relax	آرام کر
release	رہا کر
released	آو جٲری کرنہٕ
relevant	متعلقہٕ
reliable	بھروسہ مند
relief	راحت
relieve	آرام
relieved	آرام دہ
religion	مذہب
religious	مذہبی
reluctant	ہچکچاہٹ
rely	بھروسہ کر
remain	روزٕ
remaining	باقٕی
remarkable	قابل ذکر
remedy	علاج
remember	یاد تھٲیو
remind	یاد کراو
reminder	یاد دہانی
remote	دور دراز
remove	ہٹاو
render	پیش کر
rent	کرایہ
repair	مرمت
repeat	دہراو
replace	بدلاو
reply	جواب دیو
report	رپوٹ
represent	نمایندگی
reputation	شہرت
request	درخاست
require	ضرورت
required	ضرورت
rescue	بچاو
research	تحقیق
resemble	ہیوے
resentment	ناراضگی
reservation	ریزرویشن
reserve	ریزرو
resident	بسکیٖن
resign	مستعفی گژھن
resilience	لچکدار
resilient	لچکدار
resist	مزاحمت کر
resistance	مزاحمت
resolution	حل
resolve	حل کر
resort	ریزورٹ
resources	وایسیل
respect	احترام
respond	جواب دیو
response	جواب
responsibility	ذمہٕ دٲری
responsible	ذمہٕ دار
rest	آرام کر
rest in peace	آرام کریو امنس منز
restaurant	ریسٹورانٹ
restore	بحال کر
restrict	محدوٗد
result	نتیجہٕ
results	نتیجہٕ
resume	کرکھ شروع
retail	خردہ فروش
retain	رٹن
retention	رکھن
retired	رٹایٔرٹ
retreat	پتھ کھسن
retrieve	بازیافت
return	واپس
reveal	ظٲہر کر
revealed	ظٲہر کرکھ
revenge	بدلہ
revenue	آمدنی
reverse	ریورس
review	جٲیزٕ
revise	نظر ثانی کر
revision	نظر ثانی
revolution	انقلاب
reward	انعام
rhythm	رتھ
rib	اٮ۪ڈج
rice	چاول
rich	امیر
rid	ہٹاو
ride	سوار
ridiculous	مضحکہ خیز
right	دٔچھنہ
right now	وینکینس
rigid	سخت
ring	رنٛگ
rinse	کلۍ کٔٹۍ
riot	ہنگامہ
rip	رپی
ripe	پکۍ
rise	بڑھو
risk	خطرٕ
rival	حریف
river	ژاسہٕ
road	روڈ
roast	روسٹ
robust	مضبوط
rock	کئن
rock	راک
rod	راڈ
role	کردار
roll	رول
roof	چھت
room	کمرہ
root	روٹ
rope	راگ
rotten	سڈٮ۪مت
rough	سخت
roughly	تقریبا
round	راونڈ
route	وتھ
routine	معموٗل
row	لٲنہ
rub	رگڑ
rubber	ربڑ
rubbish	کچھر
rude	بدکردار
rug	راگ
ruin	تباہ کرن
rule	اصول
ruler	حکمران
rules	قواعد
run	چلاو
running	چلٲوتھ
rural	دیہی علاقہٕ
rush	جلدی کر
sack	چوک
sacred	مقدس
sacrifice	قربانی
safe	محفوظ
safe flight	محفوظ پرواز
safety	حفاظت
sage	سیج
said	وون
sail	بحری جہاز
sailing	جہاز رانی
sake	باپتھ
salary	تنخواہ
sale	کٕنن
salmon	سامن
salt	نمکین
same	ہیوے
Same here	یتہٕ تہ چھ یژھ
sample	نمونہٕ
sand	سیٚکہ
Sanskrit	سنسکرت
sarcastic	شرارتی
sassy	ساسی
sat	سیٹ
satisfaction	تسکین
satisfied	مطمئن
satisfy	مطمئن کرن
satisfying	اطمینان بخش
Saturday	ہفتہٕ وار
sausage	ساسیج
savage	وحشی
save	سیو کر
saw	وچھ
say	ونۍ
scale	پیمانہٕ
scam	سکام
scar	داغ
scarce	کم چھ
scared	ڈراوان
scarf	سکارف
scary	ڈراوان
scattered	بکھرنہٕ آمت
scene	منظر
scenery	منظر کشی
scent	بوٕ
schedule	شیڈول
school	سکول
science	سائنس
scientist	سائنس دان
scientists	ساینس دان
scissors	قینچی
scold	رُوب
scope	سکوپ
score	سکور
scrap	کڑن
scratch	خرگوش
scream	چیخ
screen	سکرین
screw	سکرو
script	سکرپٹ
sea	سمندر
seal	مہرٕ
search	ژھار
season	سیزن
seat	نشٲنی
second	دویم
secret	راز
section	سیکشن
secure	محفوظ
security	سیکیورٹی
see	وچھیو
see you	توہہ وچھو
see you later	پتہٕ وچھو
see you soon	جلدی وچھو
see you tomorrow	پلے ملو
seed	بیج
seek	ژھار
seem	باسان چھ
seems	باسان چھ
seen	وچھتھ
seize	قبضہٕ کر
seizure	ضبطی
seldom	شاذ و نادر
select	ژارنہٕ
self	پانہٕ
self healing	سیلف ہیلنگ
selfish	خو٘د خو٘د
sell	کٕنن
send	سوز
send me your picture	مےٚ سوز پنٕنۍ فوٹو
senior	سینئر
sense	احساس
sensible	سمجھدار
sensitive	حساسیت
sent	سوز
sentence	جملہٕ
sentences	جملہٕ
separate	الگ الگ
Sepedi	زیٹھۍ
september	ستمبر
sequence	ترتیب
series	سیریز
serious	سخٕت
seriously	سخٕت
serve	خدمت کر
service	خدمت
session	اجلاس
set	سیٹ کر
set up	سیٹ اپ کر
setting	سیٹنگ
settle	طے کر
seven	ستھ
seventeen	سداہ
seventy	ستتھ
several	واریاہ
severe	شدید
sew	سلائی کر
sh	ش
shade	سایڈ
shadow	سایہٕ
shake	شیک کر
shall	کر
shallow	کھوکھلہٕ
shame	شرمسار
shape	شکل
share	شییر
sharp	تیز
she	سۄ چھےٚ
she has	أمس چھ
she is	سۄ چھےٚ
shed	پنڈال
shed	شٮ۪ڈ
sheep	گاڑٕ
sheet	شیٹ
shelf	شیلف
shell	شیل
shelter	پناہ گاہ
shield	ڈھال
shift	شفٹ
shine	چمک
ship	جہاز
shipping	شپنگ
shirt	شرٹ
shoes	جوتے
shoot	شوٹ کر
shop	دکان
shopping	خریدٲری
shore	سمنٛدری
short	مختصر
shortage	کمی
shot	شوٹ
should	کرٕنہ
shoulder	فٮُ۪ک
shout	راون
show	ہاو
show me	مےٚ ہاو
shower	شاور
shrimp	شیٚمپ
shrink	ژٹتھ
shut	بنٛد
shut up	چپ تھوو
shy	شرمسار
sibling	بٲیس
siblings	بوے بوے
sick	بیمار
side	طرف
sigh	شاہ
sight	نظرٕ
sightseeing	سیر و سیاحت
sign	نشان
signature	دستخط
significant	اہم
silence	ژھپ
silent	چپ
silk	سلک
silly	بے وقوف
silver	سلور
similar	یتھیہ
simp	سمپ
simple	سہل
simultaneously	اکی وقتہٕ
since	امہ پیٹھہٕ
sincere	دیانتدار
sincerely	جان سان
sing	گٮ۪ون
singer	گلوکارہ
single	اکیلا
sink	سنک
Sir	سر
sister	بینہ
sister in law	زام
sit	بیٹھیہ
site	سایٹہ
situation	حالت
six	شیہہ
sixteen	شراہ
sixty	شیٹھ
size	سایز
skill	ہنر
skills	ہنر
skin	چمچہ
skinny	چکن چکن
skip	سکیپ کر
skirt	سکرٹ
sky	آسمان
slave	غلام
sleep	سونٛچھ
sleeping	شگھت
sleepy	سونٛگہ
sleeve	نٕر
slice	سلائس
slide	سلائڈ
slightly	ہلکہٕ
slim	زیٹھ
slip	سلپ
slope	سلوپ
slot	سلاٹ
slow	سست
slowly	وارٕ وار
small	لکٹہ
smart	ہوشیار
smell	بوٕ
smile	مسکراو
smoke	دوہ
smooth	ہموار
snack	ناشتہ
snail	سنیل
snake	صرف
snake	سرٛپھ
snap	سنیپ
snow	شین
so	یتھ کٔنۍ
so cute	تیوٗت مہربٲنی
so far	تانہ تام
soak	وَزناوُن
soap	صابن
sober	سوبر
soccer	فٹ بال
social	سمٲجی
society	سماج
socks	موزے
soft	نرم
software	سافٹ ویئر
soil	میژ
sold	کٕنن
sold out	کٕننہٕ آو
soldier	سپاہی
sole	وٲحد
solid	سخٕت
solution	حل
solve	حل کر
some	کینٛہہ
somebody	کٲنہہ
somehow	کنہ کنہ طریقہٕ
someone	کٲنہہ
something	کینٛہہ
sometimes	کنہ ساتہٕ
song	بٲتھ
soon	جلدی
sophisticated	نفیس
Sorani	سورانی
sore	ژاس
sore throat	ژھایہ منٛز زخم
sorrow	غم
Sorry	افسوس
sort	قٕسم
sought	ژھانٛڑ
soul	روح چھ
soulmate	ساؤتھ میٹ
sound	آواز
soup	سوپ
sour	سورٕ
source	ماخذ
south	جنوب مشرق
space	سپیس
spam	سپیم
span	سپان
Spanish	ہسپانوی
spare	بچاو
speak	بوزن
special	خاص
species	انواع چھ
specific	مخصوص
spectacular	شاندار
speech	تقریر
speechless	بے کلام
speed	رفتار
spell	سپیل
spend	خرٕچ کر
spent	خرٕچ
spicy	مسالے دار
spike	سپیک
spin	سپن
spinach	سپناچ
spirit	روح چھ
spit	تھوٚتھ
splendid	بہت خوب
split	تقسیٖم
spoil	خراب کرٕنہ
spoiled	ژلنہٕ آمت
spontaneous	اتپریرک
spoon	چمچہ
spot	سپاٹ
spouse	زوجہ
spread	پھیلاو
spring	بہار
square	مربع
squeeze	ژٹتھ
squid	سکویڈ
squirrel	مرسیدس بنز
st	سینٹ
stab	شُر
stable	مستحکم
stack	سٹیک
staff	عملہ
stage	سٹیج
stain	سٹین
stairs	ھرے
stake	سٹاک
stalk	سٹانک
stall	سٹال
stamp	ڈاک ٹکٹ
stand	کھڑا
standard	معیار
star	سٹار
start	شروٗع کر
started	شروع کر
starving	فاقہ کشی
state	ریاست
statement	بیان
station	سٹیشن
statue	مجسمہٕ
status	حالت
stay	روزن
stay safe	محفوظ روزن
steady	مستحکم
steak	سٹیک
steal	چوری کر
steam	سٹیم
steel	سٹیل
steep	سٮ۪ٹھ
stem	گؤڈ
stem	سٹیم
step	قدم
stick	ٹھٹھۍ
stiff	سخت
still	وۄنہ تہ
sting	سٹینگ
stingy	سنگی
stir	ہلٲیو
stock	سٹاک
stolen	ژوٗر
stomach	پیٹ
stone	سٹون
stood	کھڑا
stool	سٹول
stop	رکاو
storage	ذخیرٕ
store	دکان
storm	طوفان
story	دٔلیٖل
stove	چولہا
straight	سیود
straightforward	سیدھا
strain	سٹرین
strange	عجیب
stranger	اجنبی
strategy	حکمت عملی
straw	گھاسہِ
strawberry	سٹرابیری
streak	سٹرائیک
stream	سٹریم
street	سٹریٹ
strength	طاقت
stress	تناو
stretch	سٹریچ
strict	سخت
strike	ہملہٕ کر
string	سٹرنگ
strip	سٹرپ
strive	کوشش کر
stroke	سٹروک
strong	مضبوٗط
struck	لگٲوۍ
structure	ساخت
struggle	جدوجہد
struggling	جدوجہد کرنا
stubborn	مضطرب
stuck	چپچپا
student	طٲلبہ علم
study	مطٲلعہٕ
studying	مطٲلعہٕ
stuff	چیز
stunning	حیرت انگیز
stupid	بے وقوف
style	سٹائل
subject	موضوع: موضوع
submission	پیش کرنا , جمع کروں
submit	جمع کراو
substance	مواد
substitute	متبادل
subtle	سٮ۪ٹھا
succeed	کامیاب
success	کامیٲبی
successful	کامیاب
such	یتھ کٔنۍ
such as	یتھ کٔنۍ ز
suck	چوس
sudden	اچانک
suddenly	اچانک
suffer	تکلیف
suffering	تکلیف
sufficient	کٲفی
sugar	شکر
suggest	تجویز کریو
suggestion	تجویٖز
suit	سوٹ
suitable	موزوں
suitcase	سوٹ کیس
sum	جمح
summary	خلاصہٕ
summer	رٮ۪تہٕ رٮ۪تہٕ
summit	سمٹ
sun	آفتاب
sunday	ریتہٕ وار
sunny	دھوپ
sunset	غروب آفتاب
sunshine	دھوپ
super	سپر
superior	بہتر
supervisor	سپروائزر
supper	ڈنر
supply	سپلائی
support	سپورٹ
suppose	مانٛچو
supposed	مانٛنہٕ آمت
sure	یقینی
surface	سطح
surge	بڑھو
surgery	آپریشن
surname	کنی ناو
surprise	حٲران
surprised	حٲران
surrender	ہتھیار ڈالنا
surrounding	اوند پوکھ
surveillance	نگرٲنی
survey	سروے
survive	زِندٕ
suspect	ہہہہہ
suspended	معطل
suspicious	مشکوک
sustain	برقرار تھونہٕ
sustainability	بقایا پن
sustainable	پائیدار
swag	سویگ
swallow	نژن
swap	سویپ
swear	قسم کھیو
sweat	پسینہٕ
sweater	سویٹر
sweep	سویپ
sweet	میٹھا
sweet dreams	رُت خآب
sweet tooth	میٹھا دانت
sweetheart	مہربٲنی
swell	ورم
swelling	سوجن
swim	ترٲیو
swimming	سمنٛدٔری
swing	جھولان
switch	بدلاو
swollen	سوجہ
sword	تلوار
symbol	علامت
sympathy	ہمدردی
symptoms	علامتہٕ
system	نظام
table	ٹیبل
tackle	ٹیکل کر
tag	ٹیگ
tail	ٹائل
take	تل
take away	نیہ کڑتھ
take care	خیال تھٲیو
take off	نٮ۪بر کڑ
taken	تلتھ
talk	کتھ کر
talkative	کتھ باتھ
tall	تھو٘ڈ
tap	ٹیپ کر
tape	ٹیپ
target	ٹارگیٹ
task	ٹاسک
taste	ذائقہ
tasty	مزٕ دار
taught	ہیٚچھناوٕنۍ
tea	چائے
teach	ہیٚچھناو
teacher	ٹیچر
team	ٹیم
tear	ژوٗر
tears	اوٚش
tease	چڑھاؤ
technology	ٹیکنالوجی
teeth	دانت
tell	ونۍ
tell me	مےٚ ون
temper	مزاج
temperature	درجہ حرارت
temple	مندر
temporary	عارضی
ten	دہہ
ten thousand	دہ ساس
tenant	کرایہ دار
tend	ٹینڈ
tendency	رجحان
tender	ٹینڈر
tense	تناؤ
tension	تناؤ
tent	خیمہ
tentative	عارضی
term	ٹرم
terms	اصطلاحات
terrible	خوفناک
terrific	خصوصیات یک مدل
territory	علاقہٕ
test	ٹیسٹ
text	متن
than	امہ کھوتہٕ
thank	شکریہ
thank you	شکرٮ۪ہ
Thank you for your patience while we investigate shipment	ییٚلہ أسۍ سامانٕچ چھان بین کران چھو ، تہنٛد صبرک شکریہ
thank you so much	تشکر زیاد
thank you very much	تشکر زیاد
thanks	تشکر زیاد
Thanks for using our app	سانہ ایپ استعمال کرنہٕ خٲطرٕ چھ شکریہ
that	یہ چھ
that is	یہ چھ
that's good	یہ چھ اصل
the	خاص
theft	ژوٗر
their	تہنز
them	تمن
theme	تھیم
themselves	پانہٕ
then	پتہٕ
theory	تھیوری
there	تتہٕ
there are	اتھہ چھ
there is	چھ
therefore	لحاذا
these	یم چھ
they	تم چھ
they are	تم چھ
thick	گاڑٕ
thief	چور
thigh	مندُل
thin	پتلا
thing	چیز
things	چیزٕ
think	سونٛچو
third	ترٛیٚیم
thirsty	پیاسہ
thirteen	ترواہ
thirty	تر٘ہہ
this	یہ چھ
this is	یہ چھ
thorough	مکمل طور پر
thoroughly	پوٗرٕ پٲٹھۍ
those	یم چھ
though	حالانٛکہ
thought	سونٛچ
thoughtful	فکر مند
thoughts	خیالات
thousand	ساس
thread	تھریڈ
threat	خطرٕ
threaten	خطرٕ
three	ترٛیٚیہ
threshold	حد بندی
thrilled	پرجوش
thrive	ترقی کر
throat	گرٕ
through	ذریعہ
throughout	پوٗرٕ جایہ
throw	ترٛاو
thumb	تھمب
thunder	تھنڈر
Thursday	بوہرس وار
thus	یتھ کٔنۍ
tick	ٹکہٕ
tide	ٹایڈ
tidy	صفٲیی
tie	ٹایٔی
tiger	ٹائیگر
tight	تنگ
Tigrinya	تگرینیا
time	ٹایم
timid	شرمسار
tiny	زیٹھ
tip	ٹپ
tips	تجاویز
tire	ٹایٔر
tired	تھکن
tissue	ٹشو
title	ٹایٹل
to	تام
to be	بنن
toast	ٹاس
today	از چھ
toddler	بچہٕ
toes	ٹٲٹھۍ
together	اکوٹے
toilet	باتھ روم باتھ روم
told	وونمٗت
tolerance	تحمل
tolerate	برداشت کر
tomato	ٹماٹر
tomorrow	صُبن
tongue	زبان زبان
tonight	آز شامس
too	تہ تہ
took	تل
tool	ٹول
tools	آلات
tooth	دانت
top	ٹاپ
topic	موضوع
torn	ژٹتھ
torture	تشددٕ
total	کل
touch	ٹچ
tough	سخت
tour	ٹور
toward	طرفہٕ
towards	طرفہٕ
towel	ٹاور
town	شہر
toxic	زہریلی
trace	ٹریس
track	ٹریک
trade	تجٲرتی
tradition	رٮ۪وایت
traditional	روایتی
traffic	ٹریفک
trail	ٹرٛیل
train	ٹرین
training	ٹریننگ
trait	خصوصیت
traits	خصوصیات
transfer	ٹرانسفر
transition	ٹرانزیشن
translate	ترجمہٕ کر
transparent	صاف ستھرا
transport	نقل و حمل
transportation	نقل و حمل
trap	ٹرٛاپ
trash	کچھر
trauma	صدمہٕ
travel	سفر
tray	ٹرٛے
treasure	خزانہٕ
treat	علاج کر
treatment	علاج
tree	کلۍ
tremendous	زبردست
trend	رجحان
trial	ٹرائل
trick	چال
tried	آزماو
trigger	ٹرگر
trim	ٹرٛیم
trip	سفر
trouble	دقتہٕ
trousers	ٹراؤزر
truck	ٹرک ٹرک
TRUE	سہی
trunk	ٹرٛانک
trust	ٹرسٹ
truth	حٔقیقت
try	آزمٲیو
Tsonga	سونگا
tube	ٹیوب
Tuesday	بوموار دۄہ
tuition	ٹیوشن
turkey	ترکیہ
turmeric	لٮ۪در
turn	موڑ
turtle	کچھوٕ
tutor	ٹیچر
twelve	باہ
twenty	ویژاہ
twenty-one	اکوُہ
Twi	تیوی
twice	دۄیہ لٹہ
twist	طرفہٕ
two	زٕ
type	قٕسم
typical	عام
ugly	بدصورت
ultimate	ٲخر کار
umbrella	چھتری
unable	بہٕ ہیٚکہٕ نہٕ یہ کٔرتھ
uncle	انکل
unconscious	لاعلمی
under	اتھ تحت
underneath	بۄن چھ
underrated	تخفیف شدہ
understand	سمجن
understood	سمجنہٕ
unfortunately	بدقسمت
uniform	وردی
unique	منفرد
unit	اکٲیی
university	یونیورسٹی پریس
unknown	ناواقف
unless	اگر نہٕ
until	یوتتھ تام
unusual	غٲر معموٗلی
up	اپ
up to you	تو٘ہہ تام
update	اپڈیٹ کر
upgrade	اپگریڈ
upon	پٮ۪ٹھ
upset	پریشان
urban	شہری
urge	درخاست
urgent	فوری
us	اسہ
use	استعمال کر
used	استعمال شدہ
useful	کارآمد
useless	ناکارٕ
usual	معموٗلی
usually	عموٗمن
utility	یوٹیلٹی
vacation	چھٹی
vaccination	ویکسنیشن
vaccine	ویکسیٖن
vacuum	ویکیوم
vague	مبہم
valid	درست
valley	وادی
valuable	دور دراز
value	قدر
variety	مختٔلف قٕسم
various	مختٔلف
vary	مختٔلف
vase	گلدستہٕ
vast	وصیح
vegetable	سبزی
vegetables	سبزیاں
vehicle	گاڑٕ
vendor	فروخت کنندگان
venom	ونوم
venture	وینچر
venue	مقام
verify	تصدیٖق کر
versatile	ورسٹائل
version	ورژن
vertical	ورٹیکل
very	وارٮ۪اہ
very good	واریاہ اصل
vessel	جہاز
via	وتہ
vibe	وائب
vibes	وبس
vicious	بدکردار
victim	شکار
video	ویڈیو
view	وٕچھو
village	گام
villain	ولن
vinegar	سرکہ
vintage	ونٹیج
violence	تشدد
violent	پرتشدد
viral	وایرل
virgin	ورجن
virtual	ورچوئل
virtue	حیکمت
vision	وجن
visit	وزٹ کر
visual	بصری
vital	اہم
vivid	وایڈ
vocabulary	کیپٹل
voice	آواز
void	وایڈ
volume	حجم
volunteer	رضاکار
vomit	اُلٹی
vulnerable	کمزور
wage	تنخواہ
wages	ٹرٛیم
waist	کمر
wait	ٹھہرو
waiter	ویٹر
waiting	انتظار کرن
wake	وٮ۪تُھن
wake up	وتھو
walk	پکن
walking	پیدل پکن
wall	دیوار
wallet	ویلٹ
wander	پھیرن
wanna	یژھان چھو
want	یژھان چھو
wanted	چاہان ٲس
war	جنگ
wardrobe	الماری
warehouse	گودام
warm	گرم
warn	خبردار کر
warning	انتباہ
warrior	جنگجو
was	اوس
wash	دھوٕنہ
waste	فضلہ
watch	وٕچھو
water	آب
watermelon	تربوز
wave	لہر
way	وتہ
we	اسہ
we are	اسہ چھ
we can	بہٕ ہیٚکہٕ کٔرتھ
weak	کمزور
weakness	کمزوری
wealth	دولت
wealthy	دولت مند
wear	لاگن
wearing	پلوتھ
weather	موسم
wedding	خانٛدرٕ
Wednesday	بود وار دۄہ
weed	دٔریاو
week	ہفتہٕ
weekend	ہفتہٕ ٲخرس
weight	وزن
weird	عجیب
welcome	خوش آمدید
welfare	فلاح و بہبود
Well	ٹھیک چھ
well done	بہت خوب
went	گوٚو
were	آسہٕ
west	مغرب
wet	اوٚتھ
whale	وہیل
what	کیٛاہ
what about you	تۄہہ کیٛاہ چھ
what are you doing	ژٕ کیٛاہ چُکھ کران
what are you doing now	ژٕ کیٛاہ چھ کران وۄنۍ
what are you doing right now	ژٕ کیٛاہ چھو وینکینس کران
what do you do	ژٕ کیٛاہ چھو کران
what do you do for a living	تو٘ہہہ کیٛاہ چھو روزنہٕ خٲطرٕ کران
what do you mean	تۄہہ کیا مطلب چھ ؟
what do you want	تۄہہ کیٛاہ چھ یژھان
what happened	کیٛاہ گوٚو
what is	کیٛاہ چھ
what is this	یہ کیٛاہ چھ
what is your job	تہنٛد کٲم کیٛاہ چھ
what is your name	تہنٛد ناو کیٛاہ چھ
what's up	کیٛاہ چھ
what's your name	تہنٛد ناو کیٛاہ چھ
whatever	کانٛہہ تہ آسہ
wheat	گندھک
wheel	وہیل
when	کۭتیہ
whenever	ییلہ کنہ ساتہٕ
where	کتہ چھ
where are you	تہۍ کتہ چھو ؟
where are you from	ژٕ کتہ چُکھ ؟
where are you now	وۄنہ کتہ چھو تہۍ
where do you live	تہۍ کتہ چھو روزان
where is	کتہ چھ ؟
whereas	ییٚلہ زن
whether	کیٛاہ
which	کمہ
while	ییٚلہ زن
whisper	چیخ چیخ
whistle	وایسٹل
white	سفید
who	کُس چھ
who are you	ژٕ کس چھ ؟
who is	کس چھ ؟
who is this	یہ کس چھ ؟
whole	پوٗرٕ
whom	کس کس
whose	کس کس
why	کیٛاز چھو
why not	کیٛاز چھنہٕ
wicked	بدکردار
wide	وسیع
widow	بیواہ
width	چوڑائی
wife	زنانہ
wild	وایلڈ
will	کر
willing	تیار
win	زینہٕ
wind	ہوہٕ
window	کھڑکی
windy	ہوا دار
wine	شراب
winter	ونٛدس منٛز
wipe	پوٚپ کر
wire	تار
wire	وایر
wisdom	دانشمندی
wise	عقلمند
wish	یژھ
wish you all the best	تۄہہ چھوٕ بہتٔریٖن دعا
witch	ڈچ
with	اتھ سۭتۍ
withdraw	پتھ کڑ
withdrawal	تخفیف
within	اندٕ اندٕ
without	بغٲر
witness	گواہن
witty	وٹٹی
wolf	ولف
woman	زنانہ
women	زنانہٕ
won	زیوٗن
won't	کر نہٕ
wonder	تعجب
wonderful	بہت خوب
wood	ووڈس
wool	وول
word	لفظ
words	الفاظ
work	کٲم
work out	کٲم کر
working	کٲم کران
world	ورلڈ
worm	ورم
worn	لٲگتھ
worried	پریشان
worry	فکر
worse	بدتر
worship	عبادت کر
worst	بدتر
worth	قدر
worth it	یہ چھ قابل قدر
worthy	قابل
would	کرہا
wound	زخم
Wow	واوو
wrap	راپ
wrath	شرارت
wrist	گرٕ
write	لکھو
Write here	یتہٕ لیکھو
writing	لیکھتھ
written	لیکھتھ
wrong	غلط
wrote	لیوٗکھ
yard	یارڈ
yawn	یاون
Yeah	آہا
year	ؤری
years	ؤری وادن
yeast	خمیر
yell	چیٚنۍ
yellow	یلو
Yes	جی ہاں
yes baby	ہا بیبی
yes dear	ہا مہربٲنی
yes honey	ہا ماے
yes my love	ہا میٲنۍ محبت
yes of course	ہا چھ بلکل
yesterday	راتھ
yet	وونہ گو٘
yield	پٲداوار
you	تو٘ہہ
you are	توہہ چھو
you are beautiful	تہۍ چھو خوبصورت
you are so beautiful	تو٘ہہ چھو واریاہ خوبصورت
you are welcome	تۄہہ چھو استقبال
you can	ژٕ ہٮ۪کہٕ کٔرتھ
You know	تۄہہ چھو خبر
you too	توہہ تہ
you're welcome	تۄہہ چھو استقبال
young	پوٗرٕ
your	تہنز
your welcome	خوش آمدید
yourself	پانہٕ
youth	جوان
you’re welcome	تۄہہ چھو استقبال
yummy	یمی
zero	صفر
