a	अख
a little	अख लोकुट
a lot	वार्या
a lot of	वार्या
abandon	तर्क करून
abandoned	येल त्रावुन
abide	रोजुन
ability	सलाहियत
able	क़ाबिल
able	अहल
about	मुत्लिक
above	पेठ
abroad	बैरून मुल्क
absence	गैरहजअरी
absent	गअर हाजिर
absolutely	बिलकुल
absorb	जज़्ब गसून
abstract	खुलासा
absurd	बेतुक
abundance	वार्या
abundant	वाफर
abuse	बदसलूकी
accent	लहज़ह
accept	मानुन
access	रसाई
accident	एक्सीडेंट
accommodation	रोज़न जाय
accomplish	पूरह
accomplished	पूरह
according	मुताबिक
account	एकाउंट
account	खातह
accuracy	दृस्तगी
accurate	बराबर
accused	मुलजिम
ache	दोद
achieve	हासिल करून
achievement	कामयाबी
acknowledge	तस्लीम करून
acquaintance	वाकफियत
acquire	हासिल करून
acquired	हासिल कोर्मुत
acquisition	हसूल
across	अमिपत
across	आरपार
act	अमल
action	अमल
active	फआल
activities	अम्लह
activity	अमलह
actor	अदाकार
actual	हक़की
actually	असली
acute	शदीद
adapt	मुताबिक बनावुन
add	शामिल करून
addicted	आदी
addition	इजाफः
additional	मजीद
address	रोजन जाय
adequate	काफी
adjacent	नज़दीक
adjective	सिफ़अत
adjust	ठीक करून
admire	तारीफ करयिन
admit	तस्लीम
adopt	मंगतह
adorable	दिलकश
advance	तरकी याफ्तः
advance	पेशगी
advanced	तक्कीयाफ्त
advantage	फअयदह
adventure	मुहम ज्वाई
adverb	फअल
advertisement	इश्तिहार
advertising	इश्तिहार दियुन
advice	मशवर
advise	मश्वरा
advocate	वकील
aesthetic	जमालियाती
affair	मामलह
affect	असर अंदाज़
affection	पियार
afford	बर्दाश्त करून
affordable	बाज्याफ्त
afraid	खोचुन
after	अमि पत
afternoon	पेशुन
afterwards	पततह
again	दुबारह
against	खिलाफ
age	उम्र
agency	एजेंसी
agent	एजेंट
aggressive	जारिहना
agile	तेज़
ago	गोडह
agree	मानून
agree	मंज़ूर
agreement	समझौतह
agriculture	ज़िमान्दारी
ahead	ब्रोंठ कुन
aid	आमद
aim	मकसद
air	हवा
airport	हवाई अड़ड
aisle	गलियार
alarm	अलार्म
alcohol	शराब
alert	खबरदार
alive	ज़िन्दह
all	सअरी
all	तमाम
all right	बिलकुल ठीक
all the best	गचस लस
allow	इजाज़त
allowed	इजाज़त
almost	तकरीबन
alone	कुनन्य
along	साथ
already	गोड पेठ
Alright	ठीक छु
also	बेयय
alternative	मुत्बदिल
although	अगर चि
always	हमेश्य
am	छुस
amazing	हारान करन वोल
ambiguous	मुबहम
ambition	मक्सद
ambitious	वमेद
ambitious	उम्मीद
amend	तरमीम
amid	मंज़
among	दरमियान
among us	एशि मंज़
amount	रकम
amusing	दिलकशी
an	अख
analysis	तज्ज़िय्ह
ancestors	जद अजदाद
anchor	एंकर
ancient	कदीम
and	बेय
and you	बाय तुहुय
angel	फिरिशतः
anger	शरारत
angle	राव्ह
angry	शरारती
animal	जानवर
ankle	टखनों
anniversary	सालगिरह
announcement	ऐलान
annoy	जेर
annoyed	नाराज़
annoying	परेशान करनवोल
annual	सालाना
anonymous	गुमनाम
another	बियाख
answer	जवाब
anticipate	अंदाज़ लगावुन
anxiety	बेचैनी
anxious	फिक्र मंद
any	कांह ति
anymore	अब और
anyone	कांह ति
anything	केंह ति
anyway	वैसे तह
anyways	बहरहाल
apart	अलग
apartment	अपार्टमेंट
apologize	माफ़ी मंगइन
apparent	ज़ाहिर
apparently	जाहिरा तौर पान्ठ
appeal	दरखौस्त करून
appeal	अपील
appear	बअसून
appear	हिस नियुन
appearance	ज़ाहिरी
appearance	हाज़िर
appeared	ज़ाहिर गसून
appetite	बोछ
apple	छोंठ
application	दरखास्त
apply	लागू करून
appointment	मुक़र्रर करून
appreciate	तारीफ
appreciation	तारीफ
approach	सुफरिश
approach	नुक्ता नजर
appropriate	मुनासिब
approval	मंजोरी
approve	मंज़ूरी
approved	मंज़ूर शुद
approximately	तकरीबन
april	अप्रैल
arbitrary	मनमानी
architect	मयाद
architecture	कलाकारी
archive	महफूज़ शुद
are	आस्य
are	छि
are	छे
are you	क्या तुहुय
are you busy	क्या तुहुय छिवा आवअर
are you married	क्या तुहुय छिवा खान्दर कोर्मुत
are you married or single	क्या तुहुय छुवा खान्दर कोर्मुत या अन्हुर छिव
Are you still there?	क्या तुहुय छिवा विनी येती
are you there	क्या तुहुय छिवा मौजूद
area	रक्भह
argue	बहस
argument	दलील
arise	वत्हून
arm	नअर
army	फौज
around	आस पास
arrange	दस्तियाब करुन
arrangement	इन्तिज़ाम
arrival	यियुन
arrive	वातुन
arrived	वोतमुत
arrogant	घमंडी
arrow	एरो
art	कारीगरी
article	मज़मून
artificial	नकली
artist	कलाकार
artist	फनकार
as	पान्ठ
as long as	तोत ताम
as well	बअह
as well as	अथ सीत
ash	सूर
ashamed	शर्मिंद
ask	प्रीछुन
asked	प्रिछुन
asleep	संगिथ
aspect	पहलू
Assamese	असमिया
assault	हम्लह
assembly	असेंबली
assertive	मुतमईन वोल
assess	अंदाज़ लगावुन
assessment	ताज्ज़ियः
asset	असासह
assets	असासह
assign	कअम
assignment	सुपुर्दगी
assist	मदद करून
assistant	मददगार
associate	मुंसलिक
associated	मुंसलिक
association	तहरीक
assume	फ़र्ज़ करून
assumption	मानुन
at	पेठ
at least	कम अज़ कम
ate	खोयुन
athlete	खिलअड़
attach	मुंसलिक
attached	मुंसलिक
attachment	लगाव
attack	हमलह
attempt	कोशिश
attend	शिरकत
attendance	हअजारी
attention	ध्यान
attitude	रावयिः
attract	मुतासिर
attract	खिचाव
attraction	कशिश
attractive	दिलकश
attractive	पुरकश
attribute	वस्फ़
audience	सामईन
august	अगस्त
aunt	पेचियन
aunty	पेचिन
authentic	मुस्तद
author	मुसअनिफ
authority	इक्तिदार
autumn	हरुद
available	दस्तियाब
average	औसत
avoid	बचुन
awake	बेदार
awake	होशियार
award	पुरस्कार
aware	आगा
awareness	बाखबरी
awareness	आगाही
away	दूर
awesome	ज़बरदस्त
awful	खोफ्नाक
awkward	अजीब
Aymara	आइमारा
baby	बच्ह
bachelor	अन्हुर
back	पतकियन
background	पसिमंजर
bad	खराब
bag	बेग
bait	चारा
bake	बुजुन
bakery	बेकरी
baking soda	बेकिंग सोडा
balance	बकायत
ball	बाल
Bambara	बंबारा
banana	केअल
band	बैंड
bang	दमाकः
bank	बोठ
bank	बैंक
bar	बार
barely	मुश्किल सान
bargain	सोदा
bark	छाल
barley	युस
barrier	रुकावट
base	बुनियाद
based	बुन्यादस पेठ
basement	इहातः
basic	बुनयादी
basically	बुनयअदी
basil	तर्सीली
bastard	हरामी
batch	बैच
bath	सरान
bathroom	सरानकुठ
battery	बैटरी
battle	जंग
bay	बेय
be	गसी
be careful	ध्यान सान
beach	साहिल
beam	बीम
beans	हेमबह
bear	हापुत
beard	दाअड
bearing	असर
beast	जानवर
beat	मारून
beautiful	खूबसूरत
beauty	खूबसूरती
became	बनियोमुत
because	तिक्याज़ी
become	बनियोव
bed	बेड
bedroom	सोंगनुक कमरह
bee	तुलअर
beef	गायह हियुन्द माज़
been	सीत
beer	हापुत
before	गोडह
began	शुरुआत
begin	शुरू कर
beginning	आगाज़
behalf	तर्फः
behave	बर्ताव
behavior	मिज़ाज
behaviour	बर्ताव
behind	पअथ कुन
being	आसून
belief	आश
believe	यकीन
belly	येड
belong	तालुक
beloved	टोठ
below	बोनकेन
belt	बेल्ट
bench	बेंच
bend	जुकावुन
beneath	मंज़इ
benefit	फाईदह
benefits	फ़ैअदह
beside	एमि निश
besides	अमि अलावह
best	बेहतरीन
best of luck	गचस लस
best regards	नेक तमन्ना सान
better	बेहतर
between	मंज़
between	दरमियान
beverage	खेन चीज़
beyond	पअथ
Bhojpuri	भोजपुरी
bias	तासुब
biased	मुतअसाब
bicycle	साइकिल
bid	बूलियह
big	बोड
bike	बाइक
bill	बिल
bind	ओन
bird	चअर
birthday	ज़ाहदोह
bit	थोडा सा
bite	छोप
bitter	टियोठ
black	किहुन
blade	ब्लेड
blame	इलज़ाम
blank	खअली
blanket	कमल
blast	दमाकह
bleach	ब्लीच
blend	मिलावुन
bless	बरकत
blessed	मुबारक
blessed	किस्मतवोल
blind	ओन
bliss	ब्लिस
block	ब्लाक
blood	खून
bloom	खीलुन
blow	दचकह
blue	नियूल
blunt	कंद
board	बोर्ड
boat	नाव
body	जिस्म
boil	उबलुन
boil	ग्रख
bold	बोल्ड
bold	चालक
bond	बांड
bone	अडीज
book	किताब
boost	बढ़ावुन
booster	बूस्टर
boot	बूट
boots	बूट
border	बोर्डेर
bore	बोर गसून
bored	बोर
boring	बोअर करन वोल
born	पादह गसून
borrow	वज़ुम
boss	बॉस
both	दुश्व्य
bother	बोय
bottle	बोतल
bottom	तलकेन
bottom	चोकिसतल
bought	हियोतमुत
bounce	उछाल
bound	पाबंद
boundaries	सीमाएँ
bow	जुकुन
bowl	कटोरह
box	डब्ब
boy	लड़कह
boyfriend	यार
bracelet	कोर
brain	दिमाग
branch	शाख़
brand	ब्रांड
brave	बहादुर
breach	न मानून
bread	च्होत
break	फड़रावुन
breakfast	नाश्तः
breast	छाअत
breath	शाह
breathe	शाह नियुन
breed	नस्ल
brick	सीर
bride	महरियिन
bridge	कदल
brief	मुख़्तसर
bright	साफ़
bright	चमकुवुन
brilliant	शानदार
bring	अनुन
bro	बोय
broad	वसी
broad	खोल
broadcast	चालवुन
broke	फुटमुत
broken	फुटून
broom	जाडू
brother	बोय
brother in law	बेममह
brother in law	हहर
brought	अनुन
brown	लकरी रंग
brush	ब्रश
bucket	बालटीन
buddy	दोस्त
budget	बजट
bug	बग
build	बनावुन
building	इमारत
built	बनावुन
bulk	ढेर
bulk	वार्या
bull	साँड़
bully	बदमाश
bump	उभार
bunch	गुच्छा
bundle	बंडल
burden	बोज
buried	दफन करिथ
burn	दजुन
burst	फाटून
bury	दफ़नावुन
bus	बस
bush	दोफ
business	कारोबार
business	कारबार
bust	फुटून
busy	मसरूफ
but	मगर
butter	थअयन
butterfly	तितली
butterfly	पमपोपूर
button	बटन
buy	हियोन
by	तर्फः
by the way	वैसे
bye	बाय
cabbage	गोबी
cabinet	काबीनह
cage	पिन्जरह
cake	केक
calf	वोच्छ
call	कॉल
call me	कॉल कर मअ
called	आलव
called	वनान
calm	खामोश
came	यियुन
campaign	मुहिम
can	आसि
can't	करिथ हेकोव नह
Cancel	मंसूख
cancer	कन्सर
cancer	कैंसर
capable	क़ाबिल
capacity	कुवत
capital	सरमाय
caption	उनवान
capture	कब्जह
car	कार
car	गाडय
career	करियर
careful	होशियार
carefully	होशियारी सान
careless	लापरवाह
caring	देखभाल करन वोल
carpenter	छान
carpet	कालीन
carrot	गाजअर
carry	तुलुन
carry on	जारी ताईव
carry out	कअम करयिन
case	केस
cash	नकद
cast	कास्ट
castle	किलह
casual	पुरसकून
cat	बियआर
catch	रटून
category	हिससह
cattle	गुपन
caught	रटून
cause	वजह
caution	होशियार
cautious	होशियार
cave	गोफ
cease	बंद
ceiling	छत
celebrate	मनावुन
cell	सेल
center	मर्क़ज़
century	हथ
cereal	अनाज
ceremony	तकरीब
certain	यकीनी
certainly	यकानी
certainly	असली
certificate	सर्टिफिकेट
chain	ज़ंजीर
chair	कुर्सी
challenge	मुकाबलह
chance	मौकः
change	बदलवून
chaos	अफरातफरी
character	किरदार
characteristics	खसुसियात
charge	चार्ज
charity	सदका
charming	दिलकश
chart	चार्ट
chase	पीछा
chat	बात करयिन
cheap	सस्तह
cheat	दोखह
cheating	बेईमानी करइन
check	चेक
cheek	गाल
cheer	खोश
cheerful	हंसमुख
cheers	खुशआमद
cheese	चामअन
chemistry	किमियाई
cherish	असल लगुन
chess	शतरंज
chest	सीनह
chew	चआपुन
chicken	कोकुर
chief	सस्त
child	बच्चह
childhood	बचपन
children	बच्चह
chill	ठण्ड
chimneys	बुखारिअ
chin	होंगिन
chocolate	चॉकलेट
choice	पसंद
choose	चुनुन
chop	चअटून
chores	कामकाज
chubby	गोलमटोल
church	चर्च
cinnamon	दालचीन
circle	दआयरह
circumstances	हालात
citizen	शेहरी
city	शेहर
claim	दावा
clarify	वाज़ियाह
class	क्लास
class	चाटहाल
clay	मेचछ
clean	साफ
clear	साफ़
clerk	क्लर्क
clever	चालाक
client	क्लाइंट
cliff	थोंग
climate	आबहवा
climb	खासुन
clingy	क्लिंग्य
clock	गअर
close	बंद करून
closet	अलमअर
cloth	कपुर
clothes	पलव
cloud	अबुर
cloudy	अबूरदार
clown	मसखर
clue	इशारह
clumsy	अनाडी
cluster	झुरमठ
coach	कोच
coal	चिनिह
coast	बोठ
coast	साहिल
coat	कोट
coffee	कॉफ़ी
cognitive	अमली
coincidence	संयोग
cold	सर्द
collapse	ख़त्म गोव
collar	कालर
colleague	मुलाअजिम
colleagues	साथी
collect	जमा
collection	मज्मू
college	कॉलेज
color	रंग
colorless green ideas slept furiously	बेरंग सब्ज़ ख्याल शरारत सीत शोंग
colour	रंग
column	खम्बह
comb	कंगुव
combination	मिलायिथ
combine	येक्जा
come	वोल
come here	वोल योर
come on	पख सा
comfort	आराम
comfortable	आरामदेह
coming	यिवान
coming soon	यि जल्दी
command	हुक्म
comment	राय
commercial	तिजारती
commission	कमीशन
commit	अज़म
commitment	वादः
committed	अजम
commodity	अजनास
common	आम
communicate	कथ बाथ
communication	मुवासिलत
community	बरादारी
commute	यिउन गसुन
companion	सअथी
company	कंपनी
compare	मुवाज़नह
comparison	मुकबल्ह करून
compassion	हमदर्दी
compassionate	हमदर्दी
compatible	हम आहंग
compete	मुकम्मल
competent	क़ाबिल
competition	मुकाबलह
competitive	मानमानी
complain	शिकायत
complaint	शिकायत
complement	तकमील
complete	मुक्कमल
completely	पुरः पान्ठ
complex	पेचीदा
compliance	मानून
complicated	पीचीदः
compliment	तअरीफ़
comply	मानून
composition	मर्तब
compound	मर्काब
comprehension	फहम
comprehensive	वसी
compromise	समझौतह
compulsory	ज़रूरी
computer	कंप्यूटर
concentrate	तवाजः दियुन
concept	तसव्वुर
concern	मुताल्कः
concerned	मुतल्लिक
concert	कॉन्सर्ट
conclusion	नतीजह
concrete	पोखतः
condition	हालत
conditions	हालत
conduct	मुनकद करून
conduct	मौसूल
conference	कांफ्रेंस
confess	अपराध मानून
confidence	ऐतमाद
confident	एतिमाद
confirm	ताज्दीक
conflict	तानाजः
confused	उल्जनि मंज़
confusion	उलझाव
congrats	मुबारक
congratulation	मुबारक
congratulations	मुबारक
conjunction	जमघट
connect	जोडून
conquer	ज़ेनुन
conscious	होश
consciousness	ज़मीर
consent	रजामंदी
consent	इजाज़त
consequences	नतीजह
conservation	कथबाथ
conservative	प्रियानेन खयालन हियिंद
consider	गोर कर्यिव
considered	समझान छि
consist	मुश्तमिल
consistency	मुस्तकिली
consistent	लगातार
constant	लगातार
constant	मुसलसल
constantly	मुसलसल
constipation	कब्ज़
construction	बनावुन
consume	इस्तेमाल करून
consumption	खर्च गसन वोल
contact	राबितः
contagious	वबह
contain	रुकावुन
contains	मुश्तमिल
contemporary	हम असर
contempt	तोहीन
content	मवाद
contest	मुकबल्ह
context	सबक
continent	बरिअज्म
continue	जारी
contract	माहदः
contrast	बरअक्स
contribute	दियोत
contribution	शिरकत
control	इख्तियार
controversial	फितनह
convenience	सुहोलिय्त
convenient	आसान
conversation	कथ्बात
convert	बदलावुन
convey	वानुन
convince	काइल
convinced	कईल
cook	रनुन
cooking	रनुन
cool	ठण्डह
cooperation	ताआवुन
cope	निम्नटा
copper	ट्राम
core	ख़ास
corn	मकाई
corner	कूनह
correct	सही
correct	दरुस्त
cost	लगत
costume	पलव
cottage	कॉटेज
cotton	कपास
couch	गाडय
cough	चास
could	करिथ हेकोव
council	कौंसिल
count	शुमार
counter	काउंटर
country	मुल्क
countryside	दिही इलाकह
couple	जोर
courage	बहादुरी
course	कोर्स
court	अदालत
courtesy	शुक्रगुज़री
cousin	पितअर बआय
cover	कवर
cow	गाव
coward	बुजदिल
cozy	आराम देह
crab	कियोम
crack	फटरावुन
craft	कला
crap	बकवास
crash	ख़त्म गछुन
craving	मजबूत इरादः
crawl	यड सीत पकुन
crazy	पागल
create	बनावुन
creative	तख्लीकी
credit	क्रेडिट
creep	खखरी पकुन
creepy	खोचनावुन
crew	कामिवआल
crime	गोनह
cringe	क्रिंज
crisis	बोहरान
criteria	मयाद
critical	संजीदह
criticism	तनकीद
crop	फसल
crop	लोनुन
crops	फसल
cross	क्रॉस
crow	काव
crowd	भीड़
crowded	हजूम
crown	ताज
crucial	नाज़ुक
cruel	ज़अलिम
cruise	समुद्र में यात्रा करना
crush	कुचलुन
cry	वदुन
cucumber	लआर
cuddle	नालमोत करून
culture	सक़ाफत
cunning	चालाक
cup	पियालह
cupboard	अलमआर
curb	रुकावुन
cure	इलाज
curfew	कर्फ्यू
curiosity	तजस
curious	मुत्जस
curly	कोंकल
currency	करेंसी
current	मौजूद
currently	मौजूद
curse	लानत
curtain	परदह
cushion	तअकी
custom	पन्नय मर्ज़ी मुताबिक
customer	ग्राहक
customs	रिवाज
cut	चटून
cute	खूबसूरत
cycle	साइकिल
cycling	साइकिल चालवुन
dad	मौल
daddy	मोल
daily	दोहय
dairy	डेरी
dam	डैम
damage	नुक्सआन
damn	लानत
damp	नम
dance	डांस
danger	खतरह
dangerous	खतरनाक
dark	अनीगअट
darling	टोठ
darling	यार
darling	दोस्त
dash	डैश
data	डाटा
date	तारिख
daughter	कूर
day	दोह
dead	मोरमुत
deadline	मोक्लावुन वख
deaf	जोओर
deal	सोदा
dear	टोठ
Dear All	तमाम अज़ीज़
Dear Customer	टोथ ग्राहक
Dear Parents	टअठ वालिदेन
Dear Sir	टओठ वस्ताद
Dear students	टाठियोव शागिरदोव
Dear Team	टअठ टीम
death	मरून
debate	बहस
debit	खर्चह
debris	मलबह
debt	क़र्ज़
decade	दशक
decay	क्षय
deceased	मुतवाकः
deceive	धोखह
december	दिसम्बर
decent	मुहज़िब
decent	मौकूल
decide	फआसलह
decided	फैसलह गोमूत
decision	फासलह
deck	डेक
decline	कमी
decrease	कमी
dedicated	वक्फ
dedication	खात्र
deed	कअम
deep	सोन
deer	हिरन
default	डिफ़ॉल्ट
defeat	हारून
defend	हिफाज़त
define	वज़ाहत
definitely	यकीनी
definition	तारीफ
degree	डिग्री
delay	ताखीर
delayed	पथ करून
delete	मंसूख
deliberate	जान बूज कर
delicate	नाज़ुक
delicious	मजदार
delight	मज़
delighted	खुश
deliver	वातनावुन
delivered	वातनावुन
delivery	तरसील
demand	मुताल्बह
demand	मंग
demanding	मुताल्बह करून
democracy	जम्हूरियत
demon	शैतान
demonstrate	मुजाहिरह
denied	इनकार करून
density	मुकाम
dentist	दंद डॉक्टर
deny	इनकार
department	शोबह
departure	रवानगी
depend	बरोसस पेठ
deploy	तैनात
deposit	जमा
depressed	परेशानी
depression	देमागी दबाव
depression	जेहनी
depth	सनेयर
describe	बयान करून
description	वज़ाहत
desert	रेगिस्तान
deserve	मुसतहिक
design	डिजाईन
designation	ओहदह
desire	खाहिश
desk	डेस्क
despair	नाउम्मीद
desperate	बेताब
despite	बावजूद
dessert	मायठी
destination	मुकाम
destiny	तकदीर
destroy	तबह
destruction	ख़त्म
detail	तफसील
details	तफसील
detect	पता करुन
determination	तअयुन
determine	तईन
determined	मज़बूत
devastated	तबह ग्सून
develop	तरकी
developed	तरकी याफ्त
development	तरकी
device	आलः
devil	शैतान
devoted	वक्फ
Dhivehi	दिवेही
diabetes	मोचर
diarrhea	दस्त
diarrhea	मुसिल
diary	डायरी
dictionary	डिक्शनरी
did	कोर
die	मरून
died	मूद
diet	खुराक
diet	खेन
difference	फरक
different	मुख्तलिफ
difficult	मुश्किल
dig	खननुन
dignity	वेकार
diligent	नरमी
dinner	शामुक खेन
dip	डुबावुन
direct	बराईरास्त
direct	हुक्म
direction	सिम्त
director	डायरेक्टर
dirt	गर्द
dirty	मुकुर
disable	नाकाम
disabled	माजूर
disappear	गयिब
disappointed	मायूस
disaster	आफत
discard	खारिज करुन
discharge	नेरून
discipline	नज़्मओज़ब्त
discount	छूट
discover	दरयाफ्त
discrimination	राय करयिन
discuss	बहस करून
discussion	बहस
disease	बेअमाआर
diseases	बेमअर
disguise	बयेस
disgusting	नागुवार
dish	दिश
dishes	पकवान
dismiss	ख़ारिज
dispatch	सोजुन
display	डिस्प्ले
disposal	निपटावुन
dispute	फितनह
distance	दूरी
distinct	ख़ास
distinguish	अलग करयन
distress	तकलीफ
distribution	तकसीम
district	जिलह
disturb	परेशान करून
ditch	खाय
dive	डून्ज
diverse	मतनू
diversity	किस्मवार
divide	अलग करून
divine	इल्हामी
divorce	तलाक
dizzy	चकरयून
do	कोर
do you	क्या तुहुय
do you love me	चुह छुखा मेअ मोहब्बत करान
doctor	डॉक्टर
document	कागज़
does	करान छु
doesn't	केंह कर नह
dog	हून
Dogri	डोगरी
doing	करान
doll	गुड़िया
domain	डोमेन
domestic	घरेलू
dominant	ग़ालिब
don't	मह कर
Don't worry	फ़िक्र मअ कर
donate	अतियः
done	गोव
donkey	खर
dope	नश वोल दवा
double	दोगनह
doubt	शक
dough	मंअडित ओट
down	बोन
download	डाउनलोड
draft	मसौदा
drag	खखरि नियुन
drain	नआयल
drama	ड्रामा
draw	बनावुन
drawer	दराज
drawing	ड्राइंग
dread	खोफ
dream	ख्वाब
dress	पलव
dress	लिबास
drill	गोद करून
drink	चौन
drive	चलावुन
drop	त्रावुन
drop	फियोर
dropped	त्रावुन
drought	खुशक्साली
drunk	चेथ
dry	खोश्क
duck	बतुख
dude	यार
dude	दोस
due	वाजिब
due to	हक़दार छे
dull	सस्त
dumb	अहमक़
dumb	ज़ोर
dump	डंब
duration	मुदत
during	दोरान
dust	गर्द
duty	ड्यूटी
duty	फ़र्ज़
dwell	रोजुन
dying	मरान
each	प्रेत
each other	पान वयेन
eager	बेताब
eagle	गांठ
ear	कन
earlier	गोडह
early	गोडय
early	जल्द
earn	ज़ेनुन
earn	कमावुन
ears	कन
earth	ज़मीन
earthquake	बुनियुल
ease	आसानी
easily	आसानी सान
east	मशरिक
easy	आसान
eat	खियोन
eating	खियोन
economic	इक्त्सअदी
economy	मअशियत
edge	कून्ह
edge	एज
edit	एडिट करून
education	तालीम
effect	असर
effective	असरदार
efficiency	कारकर्दगी
efficient	मोवसिर
efficient	क़ाबिल
effort	कोशिश
egg	ठूल
eggplant	वांगन
ego	घमंड
eight	अआठ
eighteen	अरदह
eighty	शीत
either	या चि
elaborate	वस्तार सां वनुन
elbow	खोनवअट
elder	बुज़र्ग
elderly	बुज़ुर्ग
elegant	खूबसूरत
element	अनसुर
elephant	होस
eleven	काह
eligible	अहल
eliminate	खत्म
else	बेय
embarrassed	शर्मंद
embarrassing	शर्मंद गसून
embrace	नाल्मोत करुन
emerge	उबरून
emergency	इमरजेंसी
emotional	जज्बाती
empathy	हमदर्दी
emphasis	जोर
emphasize	ख़लीज
employee	मुलअजिम
employees	मुलाअज़िम
employer	आजिज़
employment	रोज़गार
empty	खाली
enable	फआल
encounter	सामना
encourage	होसला अफजाई
end	खत्म
endangered	खटरस मंज़
endeavor	कोशिश
endurance	कोशिश
endure	कोशिश
enemy	दुश्मन
energy	तवानाई
engage	कामि पेठ लगुन
engaged	मसरूफ
engaged	आवुर
engagement	निशाअन
engagement	मसरूफियत
engine	इंजन
engineer	इंजिनियर
English	अंग्रेजी
enhance	बडावुन
enjoy	मज़ कर्यिव
enormous	वार्या ज्यादह
enough	हद खोत ज्याद
enough	हद
ensure	लअज़मी
enter	दाखल करून
entertainment	तफरी
enthusiasm	जोश
enthusiastic	जोश सान
entire	पूरह
entitled	हक़दार
entity	इकाई
entrance	दअखलह
entrepreneur	बापअयर
envelope	लिफ़ाफ़े
environment	माहोल
envy	हसद
epic	बोडकलाम
epidemic	वबाह
equal	बराबर
equipment	सामान
equity	मुसावरत
equivalent	मसावी
eraser	रबड़
error	गलती
escape	फरार
especially	ख़ास पान्ठ
essay	मज़मून
essence	जोहर
essential	ज़रूरी
establish	कायिम
established	बुनियाद
estate	एस्टेट
estimate	तखमीनह
estimated	अंदाज़न
etc	वागअर
eternal	अबदी
ethics	शऊर
evaluate	जान्चुन
evaluation	तशखीस
even	अगर चि
even though	चाहे
evening	शाम
event	वाकः
event	तकरीब
eventually	आखरकार
ever	कुनिसात
every	हर कोई
everybody	प्रेथ कांह
everyone	प्रेथ कांह
everything	प्रेथ्ह केंह
evidence	सबूत
evidence	गवाह
evil	बुराई
evolution	इर्तिका
evolve	तैयार
Ewe	एवै
ex	साबिक
exact	असली
exactly	बिलकुल
exam	इम्तिहान
examine	इम्तिहान
example	मिसाल
exceed	हद खोत ज्याद
excellent	वार्या असल
except	बागआर
except	सिवाय
exception	रिआयत
excess	वार्या
excessive	वार्या
exchange	अदल-बदल
exchange	बदलावुन
excited	जोश सन
excitement	ख़ुशी
exciting	दिलकश
exclusive	ख़सूसी
excuse	माफ़ कर्यिव
excuse me	माफ़ कर्यिव
excuse me	यिकुन बोज़
excuse me	बेय वन
execute	फंसी
execution	अमल दरामद
executive	करनवोल
exercise	कसरत
exhaust	थकुन
exhausted	थकुन
exhausted	खत्म
exhibit	हावुन
exhibition	नुमाइश
exist	मौजूद
existence	वजूद
existing	मौजूद
exit	बाहर नेरून
expand	फअलावुन
expect	तव्काह
expected	मुतवकः
expenses	अखरजात
expensive	कअमती
experience	तजरुब
experiment	कोशिश
experiment	एक्स्पेरिमंत
expert	माहिर
expired	मैयाद खत्म
explain	वज़ाहत
explanation	वज़ाहत दियिन
exploit	ज़ुल्म करून
explore	दरयाफ्त करून
export	बरामद
expose	अनावृत करना
exposed	बे नकाब
exposure	नेबअर द्राव
express	इज़हार
expression	इज़हार
extend	बढ़ावुन
extended	बड़ोमुत
extension	तव्सी
extent	हद ताम
external	नेब्रिम
extinct	गआब
extra	मजीद
extract	कडुन
extraordinary	गअरमामूली
extreme	हद
extremely	इन्तिहाई
eye	अच्छ
eyes	आच्छ
fabric	कपुड
fabulous	शानदार
face	बुथ
facilitate	आसान करुन
facilities	सहूलियत
facility	सहूलियत
fact	पजर
factor	अनसुर
factory	कारखान
facts	हकाइक
fade	फीकह
fail	नाकाम
failed	नाकाम
failure	नाकामी
faint	बेहोश
fair	सही
fairly	असल पान्ठ
fairy	परी
faith	ईमान
faithful	वफादार
fake	नकली
fall	वअस्य पियोन
false	गलत
fame	शोहरत
familiar	वाकिफ
family	अयाल
famine	कहत
famous	मशहूर
fan	फेन
fancy	पसंद
fantastic	लाजवाब
far	दूर
farewell	अलग गासुन
farm	फार्म
farm	ज़मीन
farmer	किसान
fascinating	दिलकश
fashion	फैशन
fast	तेज़
fat	चरबी
fat	मोट
fatal	मोहलिक
fate	किस्मत
father	मोल
fatigue	थकावट
fault	गलती
favorite	पसंदीदः
favour	अहसान
favourite	पसंदीदः
fear	खौफ
feast	दावत
feather	पखह
feature	ख़सूसी
features	खसुसियात
february	फरवरी
fed up	तंग यून
fee	फीस
feed	राय
feed	चारह
feedback	राय
feedback	तासुर
feel	महसूस
feeling	अहसास
feet	खोर
fell	पत्थर पियोन
fellow	साथी
felt	महसूस करून
female	ज़नान
fence	फेंस
fertile	जरखेज़
festival	बोडदोह
fetch	अनुन
fever	तफ
few	केंह
fewer	कम
fiance	मंगेतर
fiction	अफसान
field	मैदान
fierce	शदीद
fifteen	पनदह
fifty	पनचाह
fight	लड़आय
fighting	लड़ाईय
figure	एदाद शुमार
figure out	पता करून
file	फ़ाइल
fill	भरून
filled	बरिथ
film	फिल्म
filthy	गन्दह
finally	आखर कार
finance	मअलियत
financial	मअली
find	छाडून
find out	छारून
fine	ठीक
finger	अनगज
finish	खत्म
finished	खत्म
fire	नार
firm	मजबूती सान
first	गोडनियुक
first name	गोडनियुक नाव
fish	गाड
fit	बराबर
fit	फिट
five	पानचह
fix	हल करुन
fixed	ते शुद
flag	झंडह
flash	फ़्लैश
flat	फ्लैट
flaw	खामी
flawless	आअब बगअर
flee	फरार
flesh	माज़
flew	चअलून
flex	फ्लेक्स
flexible	लचकदार
flight	परवाज़
flip	पलटून
flirt	थअयन करयिन
flirting	चालू
float	छानठ
flood	सअलाब
floor	फर्श
flour	ओटह
flow	बहाव
flower	पोश
flu	फ्लू
fluent	फर फर दार
fluently	रवानी सान
fluffy	तेज़
fluid	स्याल
fly	परवाज़
focus	फोकस
fog	वअनर
foggy	वअनर
fold	गोन
folks	लुख
follow	पाबंद रोजुन
follow	पैरवी करयिन
follow up	जारी थावुन
following	यिम
following	दर्ज जेल
food	खेन
fool	बेवक़ूफ़
foolish	बेवकूफ
foot	खोर
football	फूटबाल
for	खात्र
For example	मसलन
for instance	मसलन
for you	तुहुय खात्र
forbidden	मम्नूह
force	ताक़त
forecast	पेशनगोई
forehead	डेकह
foreign	बेरुनी
forest	जंगल
forever	हमेशखात्र
forget	मश्रावुन
forgive	काफ करून
forgot	मश्रावुन
fork	कानटह
form	फॉर्म
formal	रस्मी
former	साबिक
fortunately	खुश किस्मती
fortune	खुश किस्मत
forty	चतजी
forty-two	दोयतअजी
forward	ब्रोंठकुन
foster	रसाई
fought	लडून
found	लबुन
foundation	बुनियाद
four	चोअर
fourteen	चोहदह
fox	शाल
fragile	कमज़ोर
frame	फ्रेम
framework	अक्स
fraud	धोखह
freak	पागल
free	आज़ाद
freedom	आज़ादी
freeze	शिशुर
frequency	बेय त बेय
frequent	बार बार
frequently	बार-बार
fresh	ताजः
friday	जुमाह
fridge	फ़्रिज
friend	दोस्त
friendly	दोस्ताना
friends	दोस
friendship	दोस्ती
frightened	खोफनाक
frightening	खौफनाक
frog	मियिन
from	सेय
front	ब्रोंठकेनिह
frozen	शिशुर लोग्मुत
fruit	मेवह
frustrated	मायूस
fuel	तील
Fulfulde	फ़ुलफ़ुल्दे
full	बरिथ
fun	मज़ह
function	तकरीब
fundamental	असली
funeral	जिनाजः
funny	मसखर
fur	खाल
furious	शरारत
furniture	फर्नीचर
further	मजीद
furthermore	मज़ीद
future	मुस्तकबिल
gain	कमावून
game	खेल
gap	खला
garage	गैरेज
garbage	रदी
garden	बाग़
garlic	रुहुन
gate	गेट
gather	जमा
gathering	महफ़िल
gauge	गेज
gave	आर
gear	गियर
gender	संफ
general	आम
generally	आम तौर पान्ठ
generate	बनावुन
generation	पीढ़
generous	बेलोस
genius	तेज़ दिमाग वोल
genre	स्टाइल
gentle	नर्म
genuine	असली
gesture	इशारह
get	रटीव
get dressed	तैयार गस
get up	वथुन
get well soon	जल्दी गस ठीक
getting	हासिल करून
ghost	भूत
ghosting	भूत
giant	दियोव
gift	तोह्फः
ginger	अदरक
girl	कूर
girlfriend	गर्लफ्रेंड
give	दियिव
give up	हारून
given	दियिथ
glad	ख़ुशी
glance	झलक
glass	शीशह
glasses	शीशह
glimpse	झलक
global	आलमी
gloomy	उदास
gloves	अथपंज
glow	बडून
glow up	चमक
glue	ग्लू
go	गसिव
go ahead	पख ब्रोंठ
go away	नेबर गसुन
go to bed	गस शोंग
goal	इराद
goals	मकसद
goat	छावअज
god	खुदा
god bless you	खुदाई थयन्य सलामत
goes	गोव
going	गसून
going to	गसान छुस
gold	सोन
gone	गोव
gonna	करनवोल
goo	लारवुन
good	असल
good afternoon	सलाम
good afternoon	मंदीयून वख
good bye	खुदा हाफिज
good day	असल दोह
good evening	शाम बखैर
good job	असल आला
good looking	खूबसूरत
good luck	असल किस्मत
good morning	सुबह-खैर
good morning	सलाम
good morning	आदाब
good morning my love	सुबहखैर मियोन टोठ
good night	शबाखैर
goodbye	खुदा हाफिज
goodnight	शबहखैर
goods	सामान
Google	गूगल
Google Translate	गूगल तरजुम
goose	बत्तख
gorgeous	खूबसूरत
gossip	गपशप
got	मेलुन
got it	मिलियोव
government	हुकूमत
grab	झपटून
grade	ग्रेड
gradually	वारह वारह
graduate	ग्रेजुएट
grain	अनाज
grant	अता करून
granted	दियून
grapes	दच्छ
grasp	रटून
grass	गासह
grateful	शुक्रगुज़ार
gratitude	शुकुर करुन
grave	कब्र
gray	सूरय
great	ज़बर
greed	लालच
greedy	लालची
green	सब्ज़
greet	सलाम
greet	आदाब
greeting	सलाम
greetings	सलामती
grey	सुरय
grid	ग्रिड
grief	मुसीबत
grind	पिशुन
grip	पकड़
grocery	सोदा
groom	महराज
gross	मज्मूई
ground	मैदान
group	जुंड
grow	बडून
growth	तरकी
grumpy	चिड़चिड़ा
Guarani	गुआरानी
guarantee	ज़मानत
guard	गार्ड
guess	अंदाज़ लगावुन
guest	मेहमान
guidance	रहुन्माई
guide	गाइड
guilty	कसूरवार
guy	लड़कह
guys	यार
gym	जिम
habit	आदत
habitat	आदतन
had	ओस
hail	डूओंठ
hair	मस
half	नेसब
hall	हाल
hand	अथह
handle	हैंडल
handsome	खूबसूरत
hang	लटकावुन
hang out	नेबर
happen	गसुन
happened	गोव
happiness	ख़ुशी
happy	खोश
happy birthday	ज़ायदोह मुबारक
happy birthday to you	ज़ायदोह मुबारक तुहुय
happy new year	नोव वरी मुबारक
hard	सख्त
hardly	मुश्किल सान
hardly ever	शदीद कुनिसात
harm	नुक्सान
harmful	नुक्सानदेह
harmony	हम अहंगी
harsh	सख्त
harvest	फसल
has	आसि
hate	नफरत
have	आसि
have a good day	तुहुंद दोह आसिन असल
have a nice day	तुहुंद दोह गुज़रीन असल
have breakfast	नाशत कर
have fun	मज़ करयिव
have you eaten	क्या तुहुय खियोवह
having	आसुन
hazard	खतरह
haze	वअनर
he	हु
he	सु
he has	तमिस छु
he is	सु छु
head	कलह
headache	कलदोद
heal	ठीक गासुन
healing	बलुन
health	सेहत
healthy	सेहतमंद
hear	बोजुन
heard	बूज़ुम
heart	दिल
heat	तचर
heaven	जानत
heavy	बोड
heavy	गोब
hectic	आवुर
height	थज़र
heir	वारिस
heist	लूट
held	मुनकद
hell	जह्न्म
Hello	हेल्लो
hello dear	हेल्लो टाठिया
hello how are you	हेल्लो ठीक छिवा
hello how are you doing	हेलो क्या छिव करान
helmet	हेलमेट
help	मदद
helpful	मददगार
hence	इस लिए
her	तेम सुन्द
herd	रेवड़
here	येतन
heritage	विरासत
hesitate	हिचकिचाहट
Hey	हेय
Hi	हाई
hi how are you	ह्य क्या हाल छु
Hi there	सलाम
hidden	छुपिथ
hide	चुपावुन
hierarchy	दर्जबंदी
high	थोद
highlight	हावुन
hike	खटित
hiking	पैदल
hilarious	मजदार
hill	पहाड़
him	सु
hint	इशारः
hip	रोंख
hips	रोंख
hire	किरायस पेठ नियुन
hiring	भरती
his	तेमसिंज
history	तारिख
hit	मारुन
Hmm	हम्म
hobby	शोक
hold	रटून
hold on	रुकन
hole	ज़दह
holiday	छुट्टी
hollow	खोखलह
home	घरह
homework	घरकअम
honest	ईमानदार
honestly	ईमानदारी
Honey	माछ
honor	इज्ज़त
hood	हुड
hook	हुक
hop	हॉप
hope	उम्मीद
hopefully	उम्मीद छे
hopeless	नाउम्मीद
horizontal	खड़ा
horn	हॉर्न
horrible	खोफनाक
horror	वेह्शत
horse	गुर
hospital	हस्पताल
hospitality	महमान नवाज़ी
host	मेज़बान
hostile	बंदी
hot	गर्म
hotel	होटल
hour	गंटह
hours	घंटह
house	माकन
household	घरेलु
how	क्या
how about you	तुहुय छिवा ठीक
how are you	तुह्य छिवा ठीक
how are you doing	क्या सा ठीक छिव
how are you doing today	तुहुय क्या छिव करान
how are you today	तुहुंद क्या हाल छु अज़
how do you do	तुहुय छिवा ठीक
how is	कीथ छिव
how many	कअतिया
how much	कूततः
how often	कआतिहाय लटी
how old are you	तुहुय काचाह वांस छव
how was your day	तुहुय दोह कियुथ गुजरियोव
how was your night	तुहुन्ज़ राथ किछ आस
however	हालांकि
hub	मरकज़
hubby	खानदार
hug	नालमोत
huge	बोड
human	इन्सान
humble	आजिज़
humid	मरतूब
humidity	नमी
hundred	हथ
hungry	बोछहोत
hunt	शिकार करुन
hurricane	तुफान
hurry	जल्दी
hurry up	जल्दी कर
hurt	लगुन
hurt	ज़ख़्मी
husband	खानदार
hustle	धक्का-मुक्की करयन
hut	हट
hygiene	साफ़ सफाई
I	मेअ
I	बअ
I am	बअ छुस
I am fine	बअ छुस ठीक
I can	बअ करह
I can't	बअ हेक्ह नह करिथ
I do	बअ कररह
I do not know	मेअ छे न पता
I do not understand	मअ समझ नह
I don't	बअ कर नह
I don't know	मेअ छे नह पता
I don't understand	मेअ आव नह समझ
I don't understand what you mean	मअ आव नह चोन मतलब समझ केंह
I don't understand you	मअ आय नह तुहुन्ज़ कथ समझ
I don’t know	मेअ छे न पता
I don’t understand	मेअ आव नह समझ
i guess	मेअ छु बसान
I had	मेअ ओस
I have	मेअ निश
I have been	बअ छुस रूदमुत
I hope so	मअ छे उम्मीद
I know	मेअ छा पता
I like	मेअ छु पसंद
I like you	मअ छुख पसंद
I love	मअ छु पसंद
I love my big brother	बअ छुस पन्निस बडीस बायीस सीत मोहब्बत करान
I love my big sister	बअ छुस पन्नी बज्जि बेनि सीत मोहब्बत करान
I love my father	बअ छुस पन्निस मालिस सीत मोहब्बत करान
I love my little brother	बअ छुस पन्निस लोकटिस बायीस सीत मोहब्बत करान
I love my little sister	बअ छुस पन्नी लोकचि बेनि सीत मोहब्बत करान
I love my mother	बअ छुस पन्नी माजि सीत मोहब्बत करान
I love you	मेह छु मोहब्बत तुह्यसीत
I love you so much	मेअ तुहुय सीत वार्याह मोहब्बत
I love you too	बअ ति छुस तुहुय सीत मोहब्बत करान
I mean	मियोन मतलब छु
I miss you	बअ छुसत छह याद करान
I miss you so much	बअ छुसथ च्हे याद करान
I see	अच्छा
I think	मेय्निस खयाल्स मंज़
I understand	मेअ आव समझ
I want	बअ छुस येछान
I want to see you	बअ छुस येचान चेह वुछुन
I want you	मेअ छुख पसंद
I was	बअ ओसुस
I will	बअ करह
I would be	बअ आसह
I'm	बअ छुस
I'm fine	बअ छुस ठीक
I'm good	बअ छुस ठीक
I'm here	बअ छुस येतन
I'm sorry	माफ़ी दियिव
I'm sorry	मेअ गय मआफ़ी
ice	शिशुर
ice cream	मलाई कुल्फी
idea	ख्याल
ideal	आदर्श
identical	हिवुय
identify	पर्जनावुन
identity	शनाख्त
idiot	बेवकूफ़
idle	बेकार
if	अगर
ignore	नज़र अंदाज़ करून
ill	बेमार
illegal	गैरकानूनी
illness	बेमाअरी
Ilocano	इलोकानो
image	शक्ल
imagine	खयाली
immediate	फोरी
immediately	जल्दी
immense	बेपनाह
impact	असर
impatient	बे सब्र
implement	अमलि मंज़ अनुन
import	दरामद
important	ज़रूरी
important	अहम
impose	मुसललत
impossible	नामुमकिन
impress	मुतासिर करून
impression	तासुर
impressive	असरदार
improve	बेहतर बनावुन
improvement	बेहतरी
in	पेठ
in addition	एमि अलावः
In fact	असल मंज़
in front of	ब्रोंठ केन
in order to	करन्ह खात्र
inappropriate	नमुनासिब
incentive	तरगीब
incident	वाका
include	शामिल
including	ब्शमोल
income	आमदनी
inconvenience	तकलीफ
increase	इज़ाफः
increased	इज़ाफ़ी
incredible	ज़बरदस्त
indeed	बेशक
independent	आज़ाद
India	भारत
indicate	इशारह करून
indigenous	स्वदेशी
individual	अकुय
individual	कुन
industry	इंडस्ट्री
inevitable	नगरीज़
infant	शीरखार
infection	इन्फेक्शन
infinity	हद रोस्त्य
inflammation	सोज़िश
inflation	द्रोजर
influence	रसूक
inform	जानकारी
information	ज़ानकारी
ingredients	अज्जाह
inheritance	वरासत
initial	इब्तिदाई
initiative	पहल
injured	ज़ख़्मी
injury	ज़ख्म
innocent	मासूम
innovation	ईजाद करून
inquiry	तहकीक
insane	पागल
insect	कियोम
insecure	गैर महफूज़
insert	त्रावुन
inside	अंदर
insight	बसीरत
insist	इसरार
insomnia	इनसोम्निया
inspiration	तयार करून
inspire	होस्ल्ह अफज़ाई
install	इनस्टॉल
instance	मिसाल
instant	जल्दी
instead	एमी बदलह
instead of	एमि बगअर
instructions	हिदायत
instrument	अवजार
instrument	आलः
insult	बेएज्ज़त करून
insurance	इन्शुरन्स
intact	बरकरार
integrity	साल्मियत
intellectual	ज़िहेनियत
intelligence	ज़हानत
intelligence	क़ाबिल
intelligent	क़ाबिल
intelligent	होशियार
intend	इराद
intended	इरादह
intense	शदीद
intention	इरादा
interact	कथ बात
interaction	इंटरैक्शन
interest	दिलचस्पी
interest	सूद
interested	पसंदीदः
interesting	दिलचस्प
interfere	मुदाखलत
intermediate	मअयारी
internal	अंदरूनी
international	बैनुल अक्वामी
internship	इंटर्नशिप
interpret	मतलब कडुन
interpreter	मंजिम
interrupt	रुकावट अनयन
interview	इंटरव्यू
intimate	मुबाश्रत
into	मंज़
introduce	तारुफ़
introduction	तारुफ़
introvert	रूहअनी
intuition	वजदान
invalid	गलत
invent	इय्जाद
inventory	इन्वेंट्री
invest	सरमाय
investigate	जाँच करून
invitation	दावत
invite	दावत
invoice	रसीद
involve	शामिल
involved	वाबस्तः आसून
iron	शिसतर
is	छे
island	द्वीप
isolated	अलग थलग
issue	मसला
issues	मसलह
it	यि
it is	यि छु
it was	यि ओस
it's	यि छु
it's ok	ठीक छु
It's okay	कांह मसलह छु नह
item	चीज़
items	सामान
its	एमि सुन्द
I’m	बअ छुस
jacket	जैकेट
jail	जेल
January	जनवरी
jar	जार
jaw	प्राचह
jealous	हसद
jerk	जटकह
jewelry	सौन
job	नौकरी
jogging	जॉगिंग
join	शामिल गसून
joint	यिकवट
joke	जोक
joke	चुटकुला
journalist	सहाफी
journey	सफ़र
joy	ख़ुशी
judge	जज
juice	रस
july	जुलाई
jump	वोठ
june	जून
junk	रदी
just	सिर्फ
just do it	बस कर्यिव
justice	इन्साफ
justify	जवाज़ पेश करून
Kalaallisut	कलाल्लिसुत
Kashmiri	कॉशुर
keen	कोठ
keep	थावुन
keep it up	जारी थायिव
kept	थावुन
kettle	केटटल
key	चाबी
kick	लाथ दियिन
kid	बच्चह
kidding	मज़ाक
kidney	बोकवट
kids	बच्चह
kill	मारुन
kind	शरीफ
kinda	किन्दा
kindly	मेहरबानी करिथ
kindness	महरबानी
king	बादशाह
kiss	बोसह
kitchen	किचन
kite	पतंग
kitten	ब्रारिबच्चह
knee	कोठ
knew	जानुन
knife	शारपअज
knight	नाईट
know	जानुन
knowledge	इल्म
known	जानुन
Konkani	कोंकणी
Krio	क्रियो
label	लेबल
labor	मजदूर
labour	मजूररि
lack	कमी
ladder	हेयर
lady	ज़नान
laid	पथर पेथ
lake	झील
lamb	छीरह
lame	लंगड़ा
lamp	चिराग
land	ज़मीन
landscape	हमवार
language	ज़बान
lap	खोनि
large	बोड
last	आखरी
last but not least	आखरी मगर कम अज कम नह केंह
last name	आखरी नाव
late	चेयेर
lately	हाल ही मंज़
later	पततह
latest	नोव
latter	पतपहमथन
laugh	असुन
laughing	असुन
laughter	अस्सुन
launch	लांच
laundry	धोबहवान
law	कानून
lawn	घासुक मअदान
lawyer	वकील
lay	वथरावुन
layer	परत
layout	लेआउट
lazy	सुस्त
lead	लीड
leader	नेता
leaf	वथ्र
leak	नेरून
lean	मोट
leap	छलांग
learn	हेछुन
learning	हेछुन
lease	लीज़
least	कम अज कम
leather	दालह
leave	गसिव
leave	त्रायिव
leaves	पनवथ्र
led	लेड
left	खोवुर
leg	जंग
legacy	रेवाज
legal	कानूनी
legend	ख़ास
legit	कानूनी
leisure	तफरी
lend	क़र्ज़ दियुन
length	ज़ेछर
less	कम
lesson	सबक
let	चलो
letter	ख़त
lettuce	लेटिष
level	मयार
level	स्तर
leverage	बेगआनह
liability	ज़िम्मेदारी
library	किताब घर
lick	चाट
lie	अपुज़
lies	अपुज़
life	ज़िन्दगी
lift	तुलुन
light	गाश
lightning	बिजली
like	पसंद
likely	इमकान
likewise	एमि पान्ठ
line	लकीर
Lingala	लिंगाला
link	जोडडून
lion	सअह
liquid	तरल
list	शुमार
listen	बोजुन
listening	बोजुन
literally	अदबी
literature	अदब
litter	कूडह
little	थोडा
live	जिंदा
liver	जिगर
lives	ज़िन्दगी
living	ज़िन्दह
living room	रोज़न कमरह
lizard	क्रेंकलअट
load	लोड
loaf	चोओट
loan	क़र्ज़
local	मुकामी
location	मुकाम
lock	कुलुफ
lockdown	हड़ताल
log	लोग
lol	लोल
lol	वाई
lonely	तनहा
long	ज़ियूठ
long time no see	वार्या दोह गय तुहुय विछ्न्स
look	विच्छ
loop	लूप
loose	कमज़ोर
lord	खुदा
lord	रब
lose	हारून
loss	नुकसान
lost	रावुन
lot	वार्याह
loud	जोरसान
lounge	कमरह
love	मुहब्बत
love you	च्हे सीत छु मोहब्बत
lovely	टोठ
low	कम
low	बॉन
lower	बनिम
loyal	वफादार
loyalty	वफादारी
luck	किस्मत
lucky	खुश किस्मत
Luganda	लुगांडा
luggage	सामान
lump	लम्प
lunch	कोज
lunch	भौजन
lungs	शुष
luxury	ज़बरदस्त
lying	अपुज़ वनुन
machine	मशीन
mad	पागल
madam	मेडम
made	बनावुन
magazine	मगज़ीन
magnificent	शानदार
maid	नौकरआयन
main	असली
main	गूज
maintain	बरक़रार
maintenance	बरकार थावुन
Maithili	मैथिली
major	अहम
majority	अक्सरियत
make	बनावुन
make up	पूरह करून
male	मोहनियुव
mall	माल
man	मोहनियुव
manage	इन्तिज़ाम
management	इन्तिज़ाम
manager	मेनेजर
mandatory	ज़रूरी
manifest	ज़अहिर
manipulate	जोडून
manner	अंदाज़
manual	दस्ती
many	वार्याह
many many happy returns of the day	सालगिरह हच वार्या वार्या मुबारक
march	मार्च
margin	मार्जिन
market	बाज़र
marriage	खान्दर
married	खान्दर वोल
mask	मास्क
mass	बडिस पैमांस पेठ
massive	बडिस पैमानस पेठ
master	मास्टर
match	मैच
mate	साथी
material	मवाद
math	हिसाब
matter	मुआम्लह
maturity	पुख्तगी
may	हो सकता
maybe	शायद
me	मेयय
me too	बअ ति
meal	खेन
mean	मतलब
mean	मानी
meaning	मतलब
means	वतह
meant	मतलब
meanwhile	अथिमंज़
measure	मेनुन
measures	इकदाम
meat	माज़
medical	तिबी
medicine	दावा
meditation	इबादत कर्यन
medium	दरमियान
meet	मिलुन
meeting	मीटिंग
Meiteilon	मैतैलोन
melt	पिघलवुन
memories	यादेह
memory	याद
mental	दिमागी
mention	ज़िक्र
mentioned	ज़िक्र आमुत
mentor	वोस्ताद
merchant	सौदागर
mercy	इन्साफ
merely	महज़
merry christmas	क्रिसमस मुबारक
mess	जमघट
mess	मेस
message	पैगाम
messy	मुकुर
metal	शिशतर
method	तरीकह
mice	गगर
middle	मंज़बाग़
midnight	निस्फ़रात
might	शायद
mild	मुतअद
milestone	संगमील
military	मिलिट्री
milk	दोद
million	दह लछ
mind	दिमाग
mindset	ज़हानत
mine	मियोन
mingle	मिलुन
minor	कमसिन
minor	मामूली
minute	मिनट
minutes	मिनट
miracle	चमत्कार
mirror	शीशह
miscellaneous	मिलायिथ
mischievous	शरारती
miserable	सख्ती मंज़
misery	मुसीबत
miss	रावुन
miss	मिस
miss you	तुहुन्ज़ याद छे यिवान
missing	रोमुत
mission	मिशन
mist	दोब्द
mistake	गलती
Mizo	मिज़ो
mobile	मोबाइल
mock	मज़ाक
model	नमूनह
moderate	दरमियानह
modern	जदीद
modest	मामूली
moist	अदुर
moisture	नमी
mold	ढालना
mole	तिल
mom	मौज
moment	लमहह
monday	चन्द्रवार
money	पोंसह
monitor	मॉनिटर
monkey	पोंज़
month	रेथ
mood	मूड
mood	मिज़ाज
moody	मजाज़
moon	जून
moral	इखलाकी
more	मजीद
moreover	एमि मजीद
morning	सुबह
mortgage	जेहन
most	ज्यादह
mostly	अक्सर
mother	मौज
motion	गति
motivation	होस्लह अफज़ाई
mountain	पहाड़
mouse	गगुर
mouth	चोंठ
move	पकुन
movement	तहरीक
movie	फिल्म
mrs	मोहतरमा
much	वार्याह
mud	रअब
mug	मग
muscle	मसल
museum	अजायबघर
mushroom	मशरूम
music	मौसिकी
must	ज़रूरी
mute	खामोश
mutual	बाहमी
my	मियोन
my	मेयन
My dear	मियोन टोठ
my friend	मियोन दोस
My hovercraft is full of eels	मियोन होवुरक्राफ्ट ईल्स मंज़ नेबर
my love	मियोन मोहब्बत
my name is	मियोन नाव छु
my pleasure	मिएन खुशकिस्मती
myself	पानह
mysterious	पुरअसरार
mystery	इसरार
myth	मिथक
nail	नम
naive	बोली
name	नाव
narrative	वज़ाहती
narrow	तंग
nasty	मुकुर
national	कोमी
nationality	कोमियत
native	मकामी
natural	कुदरती
nature	कुद्रत
nature	फितरत
nausea	मतली
near	करीब
near	नज़दीक
nearby	आस-पास
nearly	लगभग
neat	साफ़
necessary	ज़रूरी
neck	गर्दन
necklace	गरदनि हियुन्द हार
need	ज़रूरत
negative	मांफी
neglect	गफलत
negotiate	बराबरी करयिन
neighbor	हमसाय
neighborhood	हमसाय
neither	न सा
neither	न ही
nephew	बापथर
nerd	पढ़ाकू
nervous	गब्राहत
nest	ओल
net	नेट
network	नेटवर्क
neutral	आम
never	नहज़
never give up	जांह नह हेम्मत हारेन
never mind	कांह मसलह छुनह
nevermind	कांह मसलह छुनह
nevertheless	एमिबावजूद
new	नोव
news	खबर
next	बियाख
next to	एमि पत
nice	ज़बर
nice to meet you	तुहुय मीलिथ गई ख़ुशी
niece	बावज़ह
night	रात
nightmare	गलत अहसास
nine	नव
nineteen	कुनवुह
ninety	नमथ
No	नअ
no problem	कांह मसलह नह
no way	हरगिज़ नह
nobody	कांह नह
noise	शोअर
noisy	शोर वोल
none	किहीनह
noon	दुहल
nope	न
nor	बेय न
normal	आम
north	शुमाल
nose	नस
nostalgic	प्रियेन यादगार
not	न
not at all	बिल्कुल नह
not bad	बुरह छुनह
Not now	वियेन केन नह
not yet	वनि नह केंह
note	नोट
noted	लेखित
nothing	कीहीनः
notice	इत्लाह
noticed	महसूस करून
noun	नाव
noun	इसम
nouns	इसम
novel	नावल
november	नवम्बर
now	विन्केन
nowadays	अज़कल
nuisance	परेशानी
null	खअली
numb	सुन्न
number	नंबर
nurse	नर्स
nut	डून
nutmeg	ज़ईफल
nutrition	ग्ज्ज़ियत
oath	शपथ
obesity	मोचर
obey	मानून
object	चीज़
objective	मकसद
obligation	फ़र्ज़
obscure	गैर वाकः
observation	तहकीक
observation	निगरअनी
observe	मुशाहिदह करून
obsessed	पागल
obsessed	डोल्मुत
obsession	जानून
obsolete	न चलन वोल
obstacle	रूकावट
obtain	हासिल करून
obtained	हासिल करूँ
obvious	लअज़मी
obviously	ज़रूरी
occasionally	कभी कुबार
occupation	पेशह
occupied	कब्ज़ह करून
occur	वाकः
occurred	वाकः गसुन
occurs	गसान छु
ocean	समंदर
october	अक्टूबर
odd	ताक़
odds	मुश्किलात
of	कि
of course	बिलकुल
off	बंद
offensive	जारिहना
offer	पेशकश
office	दफ्तर
official	सरकारी
often	अक्सर
Oh	ओह
oh really	ओह वाकी
oil	तील
ok	ठीक
ok dear	ओके टोठ
ok honey	ठीक छु
ok my love	ठीक छु मियोन टोठ
okay	ठीक छु
okay baby	ठीक छु बच्चहअ
okay dear	ठीक छु टाठिया
okay honey	ठीक छु जानू
okay my love	ठीक छु मियोन ज़ुव
old	प्रियोन
on	मंज़
once	अकिलटी
one	अख
one language is never enough	अख ज़बान छेनह ज़िहय काफ़ी
onion	गंड
online	ऑनलाइन
only	सिर्फ
only	खाली
open	येलह
operation	ऑपरेशन
opinion	राय
opportunities	मौकः
opportunity	मौकः
opposite	बरक्स
optimistic	पुरउमेद
option	मुत्बदिल
optional	इख्तियारी
or	बेय
orange	संगतर
order	तरतीब
ordinary	आम
organization	तंजीम
orientation	वाकफियत
origin	असल
original	असली
Oromo	ओरोमो
orphan	यतीम
other	बाकी
otherwise	अमि पत
ought	चाहे
our	पनुन
Our mission: to enable everyone, everywhere to understand the world and express themselves across languages.	सौन मिशन: हर कांसी रसाई दियिन, प्रेथशाय ज़ि दुनिया समझ्नुक तः इज़हार करनुक प्रेत ज़बनि मंज़
Our mission: to organize the world's information and make it universally accessible and useful.	सौन मिशन: दुनियाहच ज़ानकारी दियेन तरतीब तः अथ आलमी सतह पेठ काबिलि रसाई बनावुन
out	नेबर
outcome	नतीजह
outfit	पोशाक
outgoing	नेबर नेरून वोल
outlet	दुकान
outline	खाकह
outside	नेबर
outstanding	शानदार
oven	तनदरः
over	खत्म
over	पेएठ
over there	ततेन
overall	कुल मिलायिथ
overcome	काबू करुन
overthinking	ज्याद सोचुन
overwhelmed	खुश किस्मत
overwhelmed	मग्लूब
overwhelming	ज़बरदस्त
owe	वाजिब अदा
owl	रातमंगुल
own	पनुन
owner	मालिक
ox	दांद
pace	रफ़्तार
pack	पैक
package	पैकेट
paid	अदा गोमूत
pain	दोद
paint	रंग
painting	पेंटिंग
pair	जोरह
pale	पेल
palm	मंज़ अथ
pan	पैन
pandemic	वबह
panic	घबड़ाहट
pants	कुउलय
paper	कागज़
paradise	जन्नत
parallel	मुत्वाज़ी
parcel	पार्सल
pardon	माफ़ी
parents	वालिदैन
park	पार्क
parrot	तोतह
parsley	अजमोद
part	हिसह
participate	शमूलियत करयिन
particular	ख़ास पांठ
particularly	ख़ास पांठ
partner	सअथी
partner	साथी
party	पार्टी
pass	पास
passage	वथ
passed	पास
passion	चस्कः
passionate	पुरजोश
passive	बेकार
password	पासवर्ड
past	पोतकाल
patch	पैबंद
path	पाथ
path	वथ
pathetic	दिलकश
patience	सब्र
patience	बर्दाश्त
patient	सब्र
pattern	तर्ज़
pattern	पैटर्न
pause	रुकाव
pavement	फर्श
pay	अदाईगी
payment	भुगतान करून
peace	शांति
peace	सकून
peace	अमन
peaceful	अमन
peach	चनुन
peak	चोटी
pear	जोड़
peas	मटर
peculiar	अजीब
pee	पेशाब
peel	ज़अलुन
peer	कमरह
peers	साथी
pen	कलम
pencil	पेंसिल
pending	पथ कुन
people	लुख
pepper	क्रेहेन मरचवांगन
perceive	समझुन
perception	राय
perfect	कामिल
perform	अंजाम दियुन
performance	कारकरदगी
perhaps	शायद
period	अवकात
permanent	मुस्तकिल
permission	इजाज़त
permit	इजाज़त
perseverance	मजबूती
persistent	मुसलसल
persistent	लगातार
person	नफ़र
person	शख्स
personal	ज़ाती
personality	शखसियत
perspective	नुक्तएनजर
persuade	क़ाइल करून
pervert	गुमराह आदमी
pet	पालतू
phase	मरहल
phenomenon	रुझान
philosophy	फलसफः
phone	फ़ोन
photo	फोटो
phrase	कथ
physical	जिस्मानी
pick	चुनुन
pick up	तुलुन
picture	शक्ल
piece	टुकड़ह
pieces	टुकडह
pig	सुअर
pigeon	कोतर
pile	डेर
pillow	शांद
pilot	पायलट
pin	पिन
pineapple	अनानास
pink	गुलअब
pit	खोड
pitch	पिच
pity	अफ़सोस
place	जाय
places	मुकामात
plague	तोऊन
plain	प्लेन
plan	मन्सूबह
plane	जहाज़
plant	कुल
plants	कुअएल
plate	प्लेट
platform	प्लैटफ़ॉर्म
play	गिनदुन
playing	गिंदान
pleasant	खुशगवार
please	महरबानी
pleased	खुश
pleasure	ख़ुशी
pledge	अहद
plenty	काफ़ी
plot	प्लाट
plug	प्लग
plum	आलूबुखार
plumber	फिटर
plural	जमआ
podcast	पॉडकास्ट
poem	नज़्म
poetry	शायरी
point	पॉइंट
poison	ज़हर
police	पुलिस
policy	पालिसी
polite	नर्म
polite	साइस्तः
pollution	आलोदगी
pond	पोंड
pool	पूल
poop	पूप
poor	गरीब
pop	जल्दी यियुन
popular	मशहूर
population	आबादी
pork	सुअर सुन्द माज़
porridge	दल्यः
port	पोर्ट
position	पोजीशन
positive	मस्बत सोंच
possess	काबू करून
possession	क़ब्जः
possessive	हक़दार
possible	मुमकिन
post	डाक
postpone	मुल्तवी
potato	आलवः
potential	ख़ासपांठ
potential	मुमकिनः
pound	पौंड
poverty	गरीबी
power	ताक़त
powerful	ताकतवर
practical	अमली
practice	मश्क
praise	ताअरीफ
prank	मज़ाक
pray	दुआ
precious	कअमती
precise	एमि मुताबिक
precisely	बिलकुल
predict	पेशगोई
prefer	तरजी
preference	तरजीह
pregnant	बेज़ुव
prejudice	तासुब
premises	इहातः
premium	प्रीमियम
preparation	तैयारी
prepare	तैयार
prepared	तैयार
preposition	हर्फ़ रब्त
presence	मौजूदगी
present	मौजूद
presentation	पेशकश
preserve	महफूज़ करून
president	सदर
press	प्रेस
pressure	दबाव
pretend	दिखावह
pretty	खूबसूरत
prevent	रुकावुन
previous	पतिम
prey	शिकार
price	कअमत
pride	फखर
priest	पादअर
primary	बुनियादी
prime	मुख्य
princess	राजकुमारी
principal	प्रिंसिपल
prior	पतिम
priority	तरजी
prison	कारागार
privacy	राज़दारी
private	निजी
privilege	इस्त्काक
prize	इनाम
probably	शायद
problem	मसलह
procedure	तरीकहकार
proceed	पकिव ब्रोंठ
process	अमल
produce	पैदवार
product	चीज़
production	पैदावार
profession	पेयशह
professional	पेशावारा
profile	प्रोफाइल
profit	नफा
profound	गहरह
progress	तरकी
project	प्रोजेक्ट
prominent	मशहूर
promise	वादह
promote	तरकी
promotion	फ़रूग
prompt	तैयार
prone	लत
pronouns	ज़मीर
pronunciation	वर्ताव
proof	सबूत
proper	असल पंठ
properly	ठीक सान
properties	जायदाद
property	जाइदाद
proposal	पेशगी
prospect	इमकान
prosperity	खुशहाली
prosperous	तरकीयाफ्त
protect	हिफाज़त करअन
proud	फखर
prove	साबित
provide	फरह्म करून
provided	मुहय्या थावुन
province	सूबाह
provision	लाहीअमल
puberty	ब्लूगत
public	अवाम
pull	लम्मुन
pumpkin	लाअर
punctual	हाज़िर रोजुन
pupil	चाठ
purchase	मअल हियोन
pure	खालिस
purple	वांगन रंग
purpose	मकसद
purse	अमल दरामद करून
pursue	ताकुब
pursuit	काम
push	दक
put	त्रावुन
put	थावुन
qualification	एहलियत
quality	मैयाद
quantity	म्याद
quarantine	क्वारंटाइन
quarrel	झगड़ह
quarter	सह माही
Quechua	कुएचुआ
queen	रानी
queer	अजीब
query	सवाल
question	सवाल
queue	कतार मंज़
quick	जल्दी
quickly	जल्दी सान
quiet	छोप
quiet	खामोश
quilt	नेरून
quilt	मोकलावुन
quit	ख़ारिज
quite	छऔप
quiz	क्विज
quotation	कोटेशन
quote	कोट
quotes	हवालह जात
rabbit	खरगोश
race	दऔव
rage	शरारत
rain	रूद
raise	तुलुन
raised	तुलुन
ran	दावुन
random	बेतरतीब
range	हदूद
rapid	तेज़
rapidly	तेज़ी सान
rare	नायाब
rare	ख़ास
rarely	खास पान्ठ
rash	खिश
rat	गगुर
rate	शरह
rather	बल्कि
ratio	अनुपात
rational	अक़ली
raw	खाम
raw	खाम माल
re	दुबारह
reach	वातुन
reached	वोतमुत
reaction	रदीअम्ल
read	परून
reading	परून
ready	तैयार
real	असली
reality	हकीकी
reality	असली
realize	समझुन
realized	अहसास गसुन
really	पज़ज़ी
rear	पथकुन
reason	वजह
reasonable	माकूल
recall	याद करून
receipt	रसीद
receive	हासिल करून
receive	रटून
received	राटून
recent	हालह
recently	ताजः
reception	खुशामद
recipe	हिदायत
reckless	लापरवाह
recognition	पहचान
recognize	परजनावुन
recommend	सिफारिश करयिन
recommended	सिफारिश
record	रिकॉर्ड
recover	वापस अनुन
recovery	वसूली
rectangle	तिकून
red	वोजुल
redeem	त्रावुन
redemption	रिहाई
reduce	कम करून
redundant	गैरज़रूरी
refer	सोजुन
reference	हवालह
reflect	अकासी
reflection	अक्स
refrain	रोकावुन
refrigerator	फ्रिज
refund	रिफंड
refuse	मना करून
refused	इनकार करून
regard	मुतल्लिक
regarding	मुतल्लीक
regardless	एमि बगआर
regards	हवालह
region	अलाकः
register	रजिस्टर
regret	अफ़सोस
regular	लगातार
regularly	रोज़ रोज़
reject	ख़ारिज
relate	तालुक
related	मुताल्कः
relationship	रिश्तह
relative	रिश्तेदार
relatives	रिश्तहदार
relax	आराम सान
release	येल त्रावुन
release	रिहाई
released	जारी गोव
relevant	मताबिक
reliable	लग्हार
relief	मदद
relieve	सकून दियुन
relieved	सोजुन
relieved	सकून
religion	मज़हब
religious	मज़हबी
reluctant	हडधर्म
rely	बरोसह
remain	रोजुन
remaining	बाकी
remarkable	ज़बरदस्त
remedy	इलाज
remember	याद थावुन
remind	याद करून
reminder	याददहनी
remote	दूरदराज़
remove	दूर करून
render	रेंडर
rent	किराय
repair	मरमत
repeat	दोहरावुन
replace	बद्लावुन
reply	जवाब
report	रिपोर्ट
represent	नुमाइन्दगी
reputation	शोहरत
request	दरखास्त
require	ज़रूरत
required	ज़रूरत
rescue	बचाव
research	ताज्ज़ियाह
resemble	हिवुय
resentment	नाराज़गी
reservation	रिजर्वेशन
reserve	मह्फोज़ थावुन
resident	रोज़नवोल
resign	इस्ताफा
resilience	खामोश बेय
resilient	लचीला
resist	मज़मत
resistance	मज़हमत
resolution	इरादः
resolve	हल करून
resort	सहारह
resources	आगुअर
respect	अह्तिराम
respond	जवाब
response	जवाब
responsibility	ज़िम्मदारी
responsible	ज़िम्मेदार
rest	आराम
rest in peace	जंतस मंज़
restaurant	रेस्टोरेंट
restore	जमा करून
restrict	काबू करून
result	नतीजह
results	नतीज
resume	दुबारह शुरू करून
retail	परचून
retain	बरकरार थावुन
retention	बरकरार थावुन
retired	रिटायर्ड
retreat	पथ हटून
retrieve	येछान
return	वापस करून
reveal	बयान करून
reveal	वनुन
revealed	हावुन
revenge	इंतिकाम
revenue	आमदनी
reverse	वापिस नियुन
review	बेय विछुन
revise	वापसी
revision	बेय वुछुन
revolution	इन्किलाब
revolution	तहरीक
reward	इनाम
rhythm	ताल
rib	लरकअयन
rice	तमुल
rich	अमीर
rid	छुटकार
ride	सवआर
ridiculous	लानत
right	सही
right	दोछुन
right now	विन्केन
rigid	सख्त
ring	वआज
rinse	कल्ला
riot	फसाद
rip	अफ़सोस
ripe	पोप
rise	वाथुन
risk	खतरह
rival	हरीफ
river	दरया
road	सड़क
roast	बुजून
robust	मज़बूत
rock	कअएन
rod	रोड
role	किरदार
roll	रोल
roof	तालव
room	कमरह
root	मूल
rope	रज़
rotten	खराब
rough	रफ़
roughly	तकरीबन
round	गोल
route	वथ
routine	रोज़मर्रा
row	कतार
rub	राग्डावुन
rubber	रबड़
rubbish	कचरह
rude	बदतमीज
rug	कालीन
ruin	बर्बादी
rule	कानून
ruler	हुकुमरान
rules	कानून
run	दवुन
running	दावुन
rural	दिहाती
rush	जल्दी
sack	बुहुअर
sacred	पाख
sacrifice	क़ुरबानी
safe	महफूज़
safe flight	महफूज़ परवाज़
safety	हिफाज़त
sage	समझदार
said	वन्मुत
said	वानून
sail	आब वथ
sailing	पकुन
sake	खात्र
salary	तनखाह
sale	कनून
salmon	सामन
salt	नून
same	हिवुय
Same here	बराबर येतेन
sample	नमूनह
sand	सेख
Sanskrit	संस्कृत
sarcastic	तन्ज़ियः
sassy	ससिई
sat	सेट
satisfaction	मुतमइन
satisfied	मुतमाईन
satisfy	मुतमइन
satisfying	तसली बख्श
Saturday	बटवार
sausage	सॉसेज
savage	वैशी
save	महफूज़ करून
saw	विछुन
say	वन
scale	पैमानह
scam	जालई
scar	दाग़
scarce	नायाब
scared	खूचुमुत
scarf	स्कार्फ
scary	खोछवुन
scattered	बिखरीथ
scene	नाज़ार
scenery	कुदरती नज़ार
scent	महक
schedule	सकेडूल
school	स्कूल
school	चआटहाल
science	साइंस
scientist	साइंसदान
scientists	साइंसदानी
scissors	कांची
scold	रोब करून
scope	स्कोप
score	स्कोर
scrap	छोठ
scratch	खअश
scream	क्रेख
screen	स्क्रीन
screw	पेंच
script	लेखित
sea	समंदर
seal	महर
search	तलाश करून
season	मौसम
seat	सीट
second	दोयिम
secret	ख़ुफ़िया
section	सेक्शन
secure	महफूज़
security	सिक्यूरिटी
see	वअछुन
see you	मेलोव
see you later	पत मेलोव
see you soon	जल्दी मिलेंगे
see you tomorrow	पगह सम्खोव
seed	बियोल
seek	चाडून
seem	बासान
seems	बसान
seen	हावुन
seize	क़ब्जः
seizure	दोरा
seldom	कभी कभी
seldom	मुकमल तोर पान्ठ
select	चुनिव
self	पनुन
self healing	पानेय बलुन
selfish	खुद गरज
sell	कुनुन
send	सोजुन
send me your picture	सोज़ मअ तस्वीर
senior	ज़ियोठ
sense	एहसास
sensible	समझदार
sensitive	हसास
sent	सोजुन
sentence	जुमला
sentences	जुम्लह
separate	अलग करुन
Sepedi	सेपेडी
september	सितम्बर
sequence	तरतीब
series	सीरीज
serious	संजीदः
seriously	संजीदगी
serve	खिदमत
service	खद्मात
session	सेशन
set	सेट
set up	काइम कर्यिव
setting	सेटिंग
settle	आबाद
seven	सथ
seventeen	सददः
seventy	सत्तथ
several	केंह
severe	शदीद
sew	टेब दियिन
sh	शह
shade	सायह
shadow	छाय
shake	हिलावुन
shall	कररी
shallow	हल्काः
shallow	सतही
shame	शर्म
shape	शक्ल
share	बांटून
sharp	तेज़
she	सअ
she has	सोउ छे थावान
she is	सोह छे
shed	छपर
sheep	तीर
sheet	शीत
shelf	शेल्फ
shell	शैल
shelter	पनाह
shield	ढाल
shift	शिफ्ट
shine	चमक
ship	जहाज़
shipping	शिपिंग
shirt	कमीज
shoes	खोरबान
shoot	गुऊल्य मारियिन
shop	दुकान
shopping	खरीदअरी
shore	बोठ
shore	किनारा
short	च्होत
shortage	किलत
shot	शॉट
should	चाहे
shoulder	फ़ियोक
shout	क्रेक दियेन
show	हावुन
show me	हाव मअ
shower	शावर
shrimp	झींगा
shrink	खरीगसून
shut	बंद
shut up	छोप कर
shy	मंदछुन
sibling	बेनि बोय
siblings	बेनि-बोय
sick	बेमार
side	तरफ
sigh	अह
sight	नजर
sightseeing	विच्छन वाजेन जायेन हियुन्द सफ़र
sign	दस्तखत
signature	दस्तखत
significant	अहम
silence	ख़ामोशी
silent	खामोश
silk	रेशम
silly	पागल
silver	चाअदय
similar	ह्यूवअय
simp	सादह
simple	सदः
simultaneously	अकिस्य वक्ट्स मंज़
since	तनपेठ
sincere	मुखलिस
sincerely	मुखलिस
sing	गियेव
singer	गेवन वोल
single	कुन
sink	खअरि गसून
Sir	सर
Sir	उस्ताद
sister	बेनिह
sister in law	साल
sit	बियेठ
site	साइट
situation	हालात
six	छह
sixteen	शुरह
sixty	शेठ
size	बजर
skill	महारत
skills	महारत
skin	मुसलह
skinny	पतलह
skip	त्रावुन येल
skirt	स्कर्ट
sky	आस्मन
slave	गुलाम
sleep	शौंगुन
sleeping	निन्द्र
sleepy	निन्दर
sleeve	आस्तीन
slice	टुकड़ह
slide	स्लाइड
slightly	थोड़ा
slim	तोन
slip	खअर
slope	ढलान
slot	स्लॉट
slow	सुस्त
slowly	वार वार
small	लोकुत
smart	होशियार
smell	मुश्क
smile	मुस्कान
smoke	दुह
smooth	हमवार
snack	नाश्तह
snail	कियोम
snake	सरुफ़
snap	छीनुन
snow	शीन
so	तेली
so cute	वार्या असल
so far	वनियुक ताम
soak	डुबावुन
soap	साबुन
sober	पुर सकून
soccer	फुटबॉल
social	समाजी
society	मुआशरह
socks	मोज़ह
soft	नर्म
software	सॉफ्टवेर
soil	मिच्छ
sold	कअनुन
sold out	कुन मुत
soldier	सिपाही
sole	कुनुय
solid	ठोस
solution	हल
solve	हल करुन
some	केंह
somebody	कांह
somehow	कुंती पान्ठ
someone	कान्ह
something	केंह ति
sometimes	कुनिसात
song	बआथ
soon	जल्दी
sophisticated	नफीस
Sorani	सोरानी
sore	ज़ख्म
sore throat	चोक होट
sorrow	गम
Sorry	माफ़ी
sort	तरतीब मंज़
sought	तलाश करून
soul	रूह
soulmate	साथी
sound	आवाज़
soup	साबन
sour	चोक
source	अगुर
south	जनूब
space	जगह
spam	फजूलइक
span	वख
Spanish	स्पेनिश
spare	स्पेयर
speak	बोलुन
speak	वनुन
special	ख़ास
species	मसालह
specific	ख़ास पांठ
spectacular	शानदार
speech	तक़रीर
speechless	बे लफ्ज़
speed	रफ़्तार
spell	जादू
spend	खर्च
spent	खर्च
spicy	मसाल वोल
spike	फअलुन
spin	गुमाव
spinach	पालक
spirit	रूह
spit	थोख
splendid	शानदार
split	तकसीम
spoil	खराब
spoiled	खराब
spontaneous	अचानक
spoon	चमचह
spot	जगह
spouse	खंदारीन
spread	फआलावुन
spring	सौन्त
square	मरबह
squeeze	निचोड़
squid	स्क्विड
squirrel	क्रेंकलअट
st	एसटी
stab	हमलह
stable	मुस्तःक्म
stack	स्टैक
staff	अम्लह
stage	मरहल
stain	दाग़
stairs	हेयर
stake	दावा
stalk	डंठल
stall	स्टाल
stamp	सील
stamp	टिकेट
stand	खड़ा
standard	मअयारी
star	तारुक
start	शुरू
started	शुरू करून
starving	बोछहोत
state	रियासत
state	हालत
statement	बयान
statement	गरज़
station	स्टेशन
statue	बुत
status	हालत
stay	रोजुन
stay safe	महफूज़ रूजिव
steady	मुस्तकम
steak	माजुक कबाब
steal	चोरी
steam	आरख
steel	स्टील
steep	खड़ा
stem	तन
stem	गोड
step	कदम
stick	लूर
stiff	अकड़न
still	तेलीति
sting	ढंग
stingy	कंजूस
stir	हलचल
stock	स्टॉक
stolen	चूरि नियुन
stomach	मआदह
stone	पत्थर
stood	खड़ा गसुन
stool	स्टूल
stop	रुकावुन
storage	ज़खीरह
store	स्टोर
storm	तूफान
story	दलील
stove	स्टोव
straight	सियोद
straightforward	सियोद
strain	छानुन
strange	अजीब
strange	वअपर
stranger	अजनबी
strategy	रणनीति
straw	पराज
strawberry	स्ट्रॉबेरी
streak	लकीर
stream	स्ट्रीम
stream	कोअल
street	गली
strength	ताक़त
stress	तनाव
stretch	लामुन
strict	सख्त
strike	हड़ताल
string	तार
strip	पटी
strive	कोशिश
stroke	स्ट्रोक
strong	मज़बूत
struck	मारा
structure	ढ़ांचह
struggle	कशमश
struggling	कशमश मंज़
stubborn	हडधर्म
stubborn	जिद्दी
stuck	बंद
student	तल्बीइल्म
study	परून
studying	परुन
stuff	सामान
stunning	शानदार
stupid	बेवकूफ
style	अंदाज़
subject	मज़मून
submission	जमा करून
submit	दाखिल
substance	मादः
substitute	मुत्बादिल
subtle	ठीक ठाक
succeed	कामयाब गसुन
success	कामयाबी
successful	कामयाब
such	यूथ
such as	यिथ पान्ठ
suck	चुशुन
sudden	अचानक
suddenly	अचानक
suffer	शिकार
suffering	कष्ट
sufficient	काफी
sugar	खनड
suggest	मश्वर दियुन
suggest	तजवीज़ दियेन
suggestion	सलाह
suit	सूट
suitable	मुनासिब
suitable	अहल
suitcase	सूटकेस
sum	रक़म
summary	खुलासह
summer	गर्मी
summit	इजलास
sun	आफताब
sunday	आथवार
sunny	प्रेज़वुन
sunset	अफताब लोसून
sunshine	ताफ
super	सुपर
superior	आला
supervisor	निगरानी
supper	रातुक खेन
supply	फराह्मी
support	हिमायत
support	मदद
suppose	एदाद करून
supposed	फ़र्ज़ करोव
sure	यकानी
sure	पज़िया
surface	सतह
surge	इज़ाफे
surgery	सर्जरी
surname	ज़ात
surprise	हैरत
surprised	हैरानी
surrender	हथियार त्राव्य्न
surrounding	इर्दगिर्द
surveillance	निगरानी
survey	सर्वे
survive	जिनदह रोजुन
suspect	मुशतबह
suspended	मंसूख गसून
suspicious	शकावर
sustain	लगातार थावुन
sustainability	पादारी
sustainable	टिकाव
swag	लूट
swallow	नियेंगलावुन
swap	ताबदलह
swear	कश्म
sweat	आरख
sweater	बनियान
sweep	स्वीप
sweet	मियूठ
sweet dreams	टाठि ख्वाब
sweet tooth	मदुर दंद
sweetheart	जानू
swell	हुनुन
swelling	हुनुन
swim	छांट
swimming	तैरुन
swing	झूलुन
switch	बदलावुन
swollen	सोचून
sword	तलवार
symbol	अलामत
sympathy	हमदर्दी
symptoms	अलामत
system	सिस्टम
table	टेबल
tackle	उलझून
tag	टैग
tail	दूम
tail	लोट
take	रटीव
take away	नियिव
take care	ख्याल थाव
take off	उतार
taken	रटून
talk	कथ
talkative	बातूनी
tall	थोद
tap	नलकह
tape	टेप
target	हदफ़
task	कअम
taste	जायकाह
tasty	मज़्दार
taught	हेछमुत
tea	चाय
teach	हेछनावुन
teacher	वस्ताद
team	टीम
tear	ओश
tears	ओश
tease	जेर तुलुन
technology	तकनीक
teeth	दंद
tell	वान
tell me	वन मेअ
temper	शरारत
temperature	गर्मी
temple	मंदिर
temporary	आरजी
ten	दह
ten thousand	दह सास
tenant	किराएदार
tend	रिझान
tendency	रुझान
tender	टेंडर
tense	तनाव
tension	तनाव
tent	टेंट
tentative	अंदाज़न
term	अवकात
terms	शर्त
terrible	खोफनक
terrific	खोफनक
territory	इलअकः
test	टेस्ट
text	लफ्ज़
than	पतत
than	मुकाबलह
thank	शुक्रिया
thank you	शुक्रिया
Thank you for your patience while we investigate shipment	शुक्रिया तुहुन्ज़ी बर्दाशत बापत यीतिस काल्स असय शिपमेंटुक तहकीक करोव
thank you so much	तुहुंद वार्याह शुक्रिया
thank you very much	तुहुंद वार्याह शुक्रिया
thanks	शुक्रिया
Thanks for using our app	शुक्रिया सअन्य एप्प इस्तेमाल करन्ह खात्र
that	ताकि
that is	सु छु
that's good	यि गोव असल
the	सु
theft	चूर
their	तिहुन्द
them	तिमन
theme	थीम
themselves	पानह
then	पतः
theory	नज़र्याह
there	तति
there are	कति छि
there is	तति छि
therefore	लिहाज़ा
these	तिम
they	सु
they are	तिम छि
thick	मोट
thief	चूओर
thigh	जंग
thin	तोन
thing	चीज़
things	चीज़
think	सोंच
third	त्रेयिम
thirsty	ट्रेशहोत
thirteen	त्रह
thirty	त्रअह
this	यि
this is	यि छु
thorough	असल पान्ठ
thoroughly	असल पान्ठ
those	तिम
those	तिमन
though	अगरचि
thought	ख्याल
thoughtful	खयालन मंज़
thoughts	खयालात
thousand	सास
thread	पन
threat	दमकी
threaten	धमकी
three	ट्रे
threshold	थ्रेशहोल्ड
thrilled	पुरजोश
thrive	मुकाम्स वातुन
throat	होट
through	मंअजी
throughout	तमान
throughout	सरासर
throw	चालवुन
thumb	नेठ
thunder	गग्राय
Thursday	ब्रेस्वार
thus	यिथपांठ
tick	टिच
tide	लहर
tidy	साफ़
tie	बराबर
tiger	सअह
tight	टाइट
tight	तंग
Tigrinya	तिग्रिन्या
time	वक़्त
timid	डरपोक
tiny	लोकुत
tip	बख्शीश
tips	तजवीज़
tire	टायर
tired	थोकमुत
tissue	टिश्यू
title	उनवान
to	कुन
to be	बनुन
toast	टोस्ट
today	आज़
toddler	वार्या लोकुट बच्चह
toes	खूर
toes	गोर
together	यिकवट
toilet	बेतुलखुलाह
told	वनिव
tolerance	बर्दाश्त
tolerate	सहन करुन
tolerate	बर्दाश्त
tomato	रुवांगन
tomorrow	पगह
tongue	ज़ियेव
tonight	आज़ राथ
too	ति
took	रटून
tool	औजार
tools	अवजार
tooth	दंद
top	पेठ
topic	मौज़ूह
torn	फटून
torture	सख्ती करयिन
torture	अज़ाब करून
total	कुल
touch	टच
tough	मुश्किल
tour	सफ़र
toward	कुन
towards	कुन
towel	तोलिया
town	शहर
toxic	ज़हरी
trace	ट्रेस
track	वथ
track	ट्रैक
trade	तिजारत
tradition	रवायत
traditional	रिवाजी
traffic	ट्रैफिक
trail	कोशिश
train	ट्रेन
training	तरबियत
trait	खासियत
traits	असरात
transfer	मुन्तकिल
transition	मुन्तकली
translate	तरजमह
transparent	शफाफ
transport	ट्रांसपोर्ट
transportation	नकलो हमल
trap	जाल
trash	रदी
trauma	सदमह
travel	सफ़र
tray	ट्रे
treasure	खज़ानह
treat	एलाज़
treatment	इलाज
tree	कुल
tremendous	ज़बरदस्त
trend	रुझान
trial	पीशी
trick	चाल
tried	कोशिश करयिन
trigger	मुतहरिक
trim	चटून
trip	ट्रिप
trouble	मुसीबत
trousers	ट्रौजरस
truck	ट्रक
true	पोज़
trunk	ट्रंक
trust	बरोसह
truth	पोज़
try	कोशिश
Tsonga	त्सोंगा
tube	टयूब
Tuesday	ब्रेसवार
tuition	ट्यूशन
turkey	टर्की
turmeric	लेदर
turn	फिरून
turtle	दुबअह
tutor	कांह परनावन वोल
twelve	बाह
twenty	वुह
twenty-one	अकवुह
Twi	तवी
twice	दुबारह
twist	मोड़
two	ज़ह
type	किस्म
typical	लचक
ugly	बदसूरत
ultimate	हतमी
umbrella	छातर
unable	नकाबिल
uncle	पत्रर
unconscious	बेहोश
under	तहत
underneath	मनअज़
underrated	कम दरजह वोल
understand	समझ
understood	समझदार
unfortunately	बदकस्मती
uniform	वर्दी
uniform	हिवुय
unique	मुनफ़रिद
unique	अलग
unit	यूनिट
university	यूनिवर्सिटी
unknown	अनजान
unless	अगरचि
until	ताम
unusual	गैरमामूली
up	हियोर
up to you	तुहुय तामथ
update	अपडेट
upgrade	अपग्रेड
upon	अमि पेठ
upset	परेशान
urban	शेहरी
urge	ज़ोर दियुन
urgent	फोरी
us	असय
use	इस्तेमाल
used	इस्तेमाल गोमूत
useful	फैदहमंद
useless	बेकार
usual	मअमूल
usually	आम पान्ठ
utility	कामि
vacation	छुट्टी
vaccination	वैक्सीनेशन
vaccine	वैक्सीन
vacuum	वैक्यूम
vague	मुबहम
valid	दरुस्त
valley	घाटी
valuable	कीमती
value	क़द्र
value	कअमत
variety	किस्म्दार
various	वार्याह
vary	मुख्तलिफ
vase	गदान
vast	वसी
vegetable	सब्जी
vegetables	सब्जी
vegetables	सब्ज़ियाँ
vehicle	गाडीय
vendor	खर्चावन वोल
venom	ज़हर
venture	जाय
venue	मकाम
verify	ताज्दीक करून
versatile	बअहामी
version	वर्शन
vertical	खड़ा
very	वार्या
very good	वार्या असल
vessel	बानह
via	सीत
via	ज़र्याह
vibe	इल्हाम
vibes	इल्हाम
vibes	वाइब्स
vicious	शएतानी
victim	मजलूम
video	वीडियो
view	विछुन
village	गाम
villain	डाकू
vinegar	सिरकह
vintage	विंटेज
violence	तशदुद
violent	पुरतशदुद
viral	वायरल
virgin	अन्हुर
virtual	मजाज़ी
virtue	सिफ्फत
vision	मकसद
visit	विच्छनि गासुन
visual	बसीर
vital	ज़रूरी
vivid	वशद
vocabulary	अलफ़ाज़
voice	आवाज़
void	बातिल
volume	हजम
volunteer	रजाकार
vomit	दोख
vulnerable	ख़तरनाक
vulnerable	कमज़ोर
wage	वेतन
wages	मजूउर
waist	कमर
wait	इन्तिज़ार कर
waiter	वेटर
waiting	इन्तिज़ार
wake	वाथुन
wake up	हुशियार गस
walk	पकुन
walking	पकुन
wall	दीवार
wall	देवार
wallet	पर्स
wander	नअचुउन
wanna	चाहुन
want	खाहिश
want	चाह
wanted	चाह वोल
war	जंग
wardrobe	अलमारी
warehouse	गोदाम
warm	गर्मी
warn	खबरदार
warning	खबरदार
warrior	लड़ाकू
was	आसि
wash	छलोव
waste	जायः
watch	गअर
water	आब
watermelon	खरबुज
wave	लहर
way	वथ
we	असय
we are	असय छि
we can	असय करोव
weak	कमज़ोर
weakness	कमजोरी
wealth	दौलत
wealthy	अमीर
wealthy	दौलत मंज़
wear	लागुन
wearing	लागिथ
weather	मौसम
wedding	खान्दर
Wednesday	बोधवार
weed	गासह
week	हफ्तह
weekend	हफ्तुक आखर
weight	वज़न
weird	अजीब
welcome	खुशआमद
welfare	फलाह
Well	बेहतर
Well	असल
well done	शाबाश
went	गासुन
were	आस्य
west	मगरिब
wet	अदुर
whale	वेल
what	क्या
what about you	तुहुय मुतल्ल्क क्या
what are you doing	क्या छिव करान
what are you doing now	तुहुय क्या छिव विन्केन करान
what are you doing right now	तुहुय क्या छिव विन्केन करान
what do you do	तुहुय क्या छिव करान
what do you do for a living	ज़िन्द रोज़नह खात्र क्या छिव करान
what do you mean	चे क्या मतलब छुय
what do you want	तुहुय क्या छिव येछान
what happened	क्या गोव
what is	क्या छु
what is this	यि क्या छु
what is your job	तुहुय क्या कअम छे
what is your name	तुहुय क्या छु नाव
what's up	चालान
what's your name	च्हे क्या छुय नाव
whatever	कएँ ति
wheat	कानअक
wheel	टआर
when	कअर
whenever	कुन्तीसात
where	कति
where are you	तुहुय कति छिव
where are you from	तुहुय कती पेठ छिव
where are you now	वनियेन कति छिव तुहुय
where do you live	तुहुय कति छिव रोज़ान
where is	कति छु
whereas	येलकेन
whether	चाहे
which	कुम
which	कुस
which	कोम
while	मंजी
whisper	फुसफुस
whistle	शुरियिन
white	सफ़ेद
who	कुस
who are you	तुहुय कुम छिव
who is	कुस छु
who is this	यि कुस छु
whole	पूरह
whom	केमिस
whose	कअमी सुन्द
why	क्याज़ी
why not	क्याज़ी नह
wicked	शर वोल
wide	खोल
widow	मोंड
width	खजर
wife	ज़नान
wild	जंगली
will	करह
will	चाह
willing	तयार
win	ज़ेनुन
wind	हवा
window	दअर
windy	तूफ़ानी
wine	शराब
winter	वंदह
wipe	साफ़ करून
wire	तार
wisdom	हिकमत
wise	चालक
wish	खवाइश
wish you all the best	तुहुंदी खात्र नेक तमाह
witch	चुड़ैल
with	सीत
withdraw	वापिस नियुन
withdrawal	वापसी
within	अथ मंज़
without	अमिबगैर
witness	गवाह
witty	विट्टी
wolf	शाल
woman	ज़नान
women	ज़नान
won	ज़ेनुन
won't	गसी नह
wonder	ताजुब
wonder	ख़ास
wonderful	शानदार
wood	जियुन
wood	लकड़
wool	पोट
word	लफ्ज़
words	लफ्ज़
work	कअम
work out	कसरत
work out	मशकत
working	कअमि मंज़
world	दुनिया
worm	कियोम
worn	लागिथ
worried	फिक्र मंद
worry	फिक्र
worse	बदतर
worship	इबादत
worst	बदतरीन
worth	क़ाबिल
worth it	येमी काबिल
worthy	लग्हार
would	कररह
wound	ज़ख्म
Wow	ज़बरदस्त
Wow	वोव
wrap	वलून
wrath	शरारत
wrist	होचह
write	लेखिव
Write here	येतन लेखियिव
writing	लेखान
written	लेखित
wrong	गलत
wrote	लेखुन
yard	सहन
yawn	ज़ामन
Yeah	आ
year	वरी
years	वरी
yeast	यीस्ट
yell	क्रेक दियिन
yellow	लियोदूर
Yes	आ
yes baby	आ बेबी
yes dear	ओवा अज़ीज़
yes honey	आ जानू
yes my love	ओवा मियोन टोठ
yes of course	आ बिल्कुल
yesterday	पगह
yet	वनियुख ताम
yield	पैदवार
you	तुह्य
you are	तुहुय छिव
you are beautiful	तुहुय छिव खूबसूरत
you are so beautiful	तुहुय छिव वार्याह खूबसूरत
you are welcome	तुहुन्द खुशआमद
you can	तुहुय हेकिव
You know	तुहुय छेव पता
you too	तुहुय ति
you're welcome	खुश आमद
young	जवान
your	तुहुंद
your welcome	तुहुंद खुशआमद
yourself	पन्निस पानस
youth	नोजवान
you’re welcome	तुहुंद खुशामद
yummy	मज़ दार
zero	सिफर
zero	जीरो
