abandoned	lɛf
abandon	lɛf
abide	fala
ability	ebul fɔ yuz
able	ebul
about	bɔt
above	ɔp
abroad	patrol
absence	nɔ de
absent	nɔ de
absolutely	rili
absorb	pe atɛnshɔn
abstract	at fɔ ɔndastand
absurd	nɔ mek sɛns
abundance	bɔku
abundant	bɔku
abuse	trit bad
accent	aw pɔsin de tɔk
accept	gri
access	fɛn
accident	aksidɛnt
accommodation	say fɔ slip
accomplish	du
accomplished	dɔn du
according	frɔm wetin
account	akawnt
accuracy	kɔrɛkt
accurate	kɔrɛkt
accused	bin blem
ache	pen
achievement	wetin wi gɛt
achieve	mitɔp
acknowledge	no
acquaintance	kɔmpin
acquired	dɔn gɛt
acquire	gɛt
acquisition	gɛt
across	krɔs
act	akt
action	du
active	wok
activities	tin dɛn
activity	tin
actor	aktɔ
actually	rili
actual	rial
acute	siriɔs
adapt	chenj
add	ad
addicted	gɛt bad abit
addition	ad
additional	ad
address	adrɛs
adequate	i du
adjacent	nia
adjective	gol
adjust	ajɔst
admire	kɔle
admit	gri se
adopt	tek pikin fɔ mɛn
adorable	fayn
advanced	go bifo
advance	go bifo
advantage	bɛnifit
adventure	travul
adverb	advab
advertisement	advatayz
advertising	de advatayz
advice	advays
advise	advays
advocate	sɔpɔt
aesthetic	fayn
affair	biznɛs
affect	afɛkt
affection	lɛk
affordable	ebul fɔ du
afford	ebul fɔ bay
afraid	fred
after	afta
afternoon	aftanun
afterwards	afta
again	igen
against	agens
age	ej
agency	ɔfis
agent	maneja
aggressive	vɛks
agile	muv izi wan
ago	trade
agree	gri
agreement	agrimɛnt
agriculture	fam wok
ahead	bifo
aid	ɛp
aim	plan
air	briz
airport	iapɔt
aisle	layn
alarm	wɔnin
alcohol	rum
alert	pe atɛnshɔn
a little	smɔl
alive	gɛt layf
allowed	dɔn alaw
allow	gri
all	ɔl
all right	nɔ bad
all the best	ɔl di bɛst
almost	lɛk
alone	wangren
along	wit
a lot	bɔku
a lot of	bɔku
already	dɔn
Alright	gud
also	bak
alternative	ɔda
although	pan ɔl
always	ɔltɛm
amazing	sɔprayz
ambiguous	nɔ klia
ambition	zil pasmak
ambitious	mekɔp yu maynd
amend	kɔrɛkt
amid	insay
among	pan
among us	pan wi
amount	ɔmɔs
amusing	fɔni
analysis	chɛk
ancestors	fɔstɛm pipul dɛn
anchor	ankɔ
ancient	ol
and	ɛn
and you	ɛn yu
angel	enjɛl
anger	vɛks
angle	say
angry	vɛks
animal	animal
ankle	fut
anniversary	anivasri
announcement	anawns
annoyed	mɔna
annoying	mɔna
annoy	mɔna
annual	ɛvri ia
anonymous	nɔ no di nem
another	ɔda
answer	ansa
anticipate	wet fɔ
an	wan
anxiety	wɔri
anxious	wɔri
any	ɛni
anymore	igen
anyone	ɛnibɔdi
anything	ɛnitin
anyways	stil
anyway	stil
apartment	ajɔynin
apart	pat
apologize	tɛl sɔri
apparent	klia
apparently	i go mɔs bi
appeal	bɛg
appearance	aw a luk
appeared	dɔn sho
appear	sho
appetite	fil fɔ it
apple	apul
application	aplay fɔm
apply	aplay
appointment	sho tɛm
appreciate	gladi fɔ
appreciation	gladi fɔ
approach	mit
appropriate	fayn
approval	gri fɔ
approved	dɔn gri
approve	gri
approximately	lɛkɛ
april	Epril
arbitrary	nɔ rizin
architect	pɔsin we de bil
architecture	drɔ plan
archive	kip fayl
area	eria
are	de
are you busy	yu bizi
are you married or single	yu mared ɔ yu nɔ mared
are you married	yu mared
Are you still there?	yu de de
are you there	yu de
are you	we yu
argue	agyu
argument	agyu
arise	kam
arm	an
army	sojaman dɛn
around	arawnd
arrange	arenj
arrangement	arenj
arrival	rich
arrived	dɔn rich
arrive	rich
arrogant	prawd
arrow	aro
art	drɔin
article	atikul
artificial	gini gini
artist	pɔsin we de drɔ
as	as
ashamed	shem
ash	ashis
ask	aks
asked	dɔn aks
asleep	slip
as long as	wans
aspect	tin
Assamese	Assamese
assault	trɛtin
assembly	asɛmbli
assertive	fɔ klem
assess	chɛk
assessment	chɛk
assets	valyu tin dɛn
asset	valyu tin
assign	gi wok
assignment	wok
assistant	pɔsin we de ɛp
assist	ɛp
associated	dɔn kip kɔmpin
associate	kip kɔmpin
association	kip kɔmpin
assume	fɔ tink
assumption	fɔ tink
as well as	bak
as well	ɛn
ate	dɔn it
athlete	spɔtman
at least	lɛk
attached	jɔyn
attach	kam nia
attachment	lɛk
attack	atak
attempt	tray
attendance	go
attend	kam
attention	atɛnshɔn
attitude	aw wi tink
attraction	lɛk
attractive	fayn
attract	lɛk
attribute	kwaliti
audience	ɔdiɛns
august	Ɔgɔst
aunt	anti
aunty	anti
authentic	rial
authority	pawa
author	pɔsin we de rayt buk
autumn	reni sizin
available	de
average	lɛk
avoid	avɔyd
awake	wek
a	wan
award	prayz
awareness	fɔ no
aware	no
away	go
awesome	wɔndaful
awful	bad
awkward	nɔ fil fayn
Aymara	Aymara
baby	bebi
bachelor	man we nɔ mared
back	bak
background	stori
bad	bad
bag	bag
bait	bet
bake	bek
bakery	ples fɔ bek
baking soda	bekin soda
balance	tink di rayt we
ball	bɔl
Bambara	Bambara
banana	banana
band	band
bang	nak
bank	bank
bar	ba
barely	nɔ izi
bargain	bunya
bark	bak
barley	bali
barrier	sɔntin we stɔp yu
base	bɔt
based	bay
basement	ɔnda di grɔn
basically	men
basic	men
basil	pasmegi
bastard	basta-dɔg
batch	grup
bathroom	batrum
bath	was
battery	batri
battle	fɛt
bay	waf
beach	bich
beam	shayn
beans	binch dɛn
bear	bia
beard	bia-bia
bearing	de bia
beast	animal
beat	bit
beautiful	rili fayn
beauty	fayn
be	bi
became	dɔn bi
be careful	tek tɛm
because	bikɔs
become	fɔ bi
bed	bed
bedroom	bedrum
beef	bif
been	bin
bee	ɔni bi
beer	bia
before	bifo
began	dɔn stat
begin	bigin
beginning	bigin
behalf	fɔ
behave	biev
behavior	biev
behaviour	biev
behind	biɛn
being	fɔ bi
belief	biliv
believe	biliv
belly	bɛlɛ
belong	gɛt
beloved	wan we a lɛk
below	dɔŋ
belt	bɛlt
bench	bɛnch
bend	bɛn
beneath	ɔnda
benefit	bɛnifit
benefits	bɛnifit dɛn
beside	nia
besides	apat frɔm dat
best	bɛst
best of luck	ɔl di bɛst
best regards	ɔl di bɛst
better	bɛtɛ
between	bitwin
beverage	drink
beyond	sote
Bhojpuri	Bhojpuri
biased	nɔ trit ɔlman di sem
bias	nɔ lɛk ɔda pipul dɛn
bicycle	baysikul
bid	ɔmɔs yu go pe
big	big
bike	bayk
bill	pe mɔni
bind	tay
bird	bɔd
birthday	batde
bit	dɔn bɛt
bite	bɛt
bitter	bita
black	blak
blade	nɛf
blame	blem
blanket	kɔba
blank	ɛmti
blast	sawnd
bleach	blich
blend	miks
bless	blɛs
blessed	dɔn blɛs
blind	blayn
bliss	ɛnjɔy
block	blɔk
blood	blɔd
bloom	gro
blow	blo
blue	blu
blunt	tɔk tret
board	bod
boat	bot
body	bɔdi
boil	bwɛl
bold	gɛt maynd
bond	nia
bone	bon
book	buk
booster	maklɛt
boost	ɛp
boots	sus
boot	sus
border	bɔda
bored	nɔ bisin bɔt
bore	dɔl
boring	gens
born	bɔn
borrow	lɛnt
boss	bɔs
bother	ambɔg
both	ɔltu
bottle	bɔtul
bottom	bɔtɔm
bought	dɔn bay
bounce	bawns
boundaries	bɔda dɛn
bound	tay
bow	butu
bowl	bol
box	bɔks
boy	bɔy
boyfriend	bɔyfrɛn
bracelet	breslɛt
brain	bren
branch	branch
brand	mak
brave	gɛt maynd
breach	prɔblɛm
bread	bred
breakfast	mɔnintɛm it
break	pwɛl
breast	brɛst
breath	briz we yu de blo
breathe	blo
breed	kip
brick	blɔk
bride	yawo
bridge	brij
brief	shɔt
bright	brayt
brilliant	brayt
bring	briŋ
broad	big
broadcast	TV
bro	bro
broke	brok
broken	dɔn brok
broom	brum
brother	brɔda
brother in law	brɔdaɛnlɔ
brought	kam wit
brown	brawn
brush	brɔsh
bucket	bɔkɛt
buddy	padi
budget	plan mɔni biznɛs
bug	bɔg
build	bil
building	de bil
built	dɔn bil
bulk	mɔ
bull	kaw
bully	buli
bump	bɔmp
bunch	grup
bundle	pakɛj
burden	lod
buried	bin bɛr
burn	bɔn
burst	bɔs
bury	bɛri
bus	bɔs
bush	bush
business	biznɛs
bust	arɛst
busy	bizi
but	bɔt
butter	bɔta
butterfly	bɔtaflay
button	bɔtin
buy	bay
by	bay we
bye	baybay
by the way	ɛniwe
cabbage	kabɛj
cabinet	say fɔ kip tin dɛn
cage	fɛns
cake	kek
calf	kaw pikin
called	bin kɔl
call	kɔl
call me	kɔl mi
calm	kolat
came	dɔn kam
campaign	spɛshal program
Cancel	nɔ
cancer	kansa
can	kin
can't	nɔ kin
capable	ebul
capacity	ebul fɔ du
capital	kapital
caption	pikchɔ
capture	kech
career	wok
carefully	saful saful
careful	tek tɛm
careless	nɔ tek tɛm
caring	de kia
car	motoka
carpenter	kapɛnta
carpet	kapɛt
carrot	karɔt
carry	kɛr
carry on	kɔntinyu
carry out	du
case	kes
cash	kɔpɔ
castle	kastɛl
cast	plasta
casual	rilaks
catch	kech
category	kayn
cat	pus
cattle	kaw dɛn
caught	bin kech
cause	mek
caution	kɛlɛkɛlɛ
cautious	kɛlɛkɛlɛ
cave	kev
cease	stɔp
ceiling	silin
celebrate	sɛlibret
cell	sɛl
center	sɛnta
century	wan ɔndrɛd ia
cereal	pap
ceremony	sɛrimɔni
certainly	na dat
certain	shɔ
certificate	pepa
chain	chen
chair	chia
challenge	wetin mit yu
chance	chans
change	chenj
chaos	plabah
characteristics	karakta
character	karakta
charge	chaj
charity	ɛp
charming	biev fayn
chart	bɔks
chase	rɔnata
chat	chat
cheap	nɔ dia
cheating	de rog
cheat	rog
check	chɛk
cheek	jɔ
cheerful	gladi
cheer	gladi
cheers	bɔk ɔp
cheese	chiz
chemistry	kɛmistri
cherish	valyu
chess	chɛs
chest	chɛst
chew	cham
chicken	fɔl
chief	chif
childhood	we a bin pikin
child	pikin
children	pikin dɛn
chill	kol
chimneys	chimni dɛn
chin	chin
chocolate	chɔklɛt
choice	disayd
choose	pik
chop	kɔt
chores	wok dɛn
chubby	bɔmp
church	chɔch
cinnamon	sinamum
circle	sakul
circumstances	tin dɛn
citizen	sitizin
city	siti
claim	se
clarify	mek klia
class	klas
clay	kle
clean	klin
clear	klia
clerk	wokman
clever	sɛns
client	kɔstɔma
cliff	mawnten
climate	wɛda
climb	klem
clingy	eng pan yu nɛk
clock	klok
close	tayt
closet	klɔsɛt
clothes	klos
cloth	klos
cloud	klawd
cloudy	klawd
clown	klawn
clue	ɛp
clumsy	bɔk yu fut
cluster	grup
coach	koch
coal	chakol
coast	kost
coat	kot
coffee	kɔfi
cognitive	tink
coincidence	chans
cold	kol
collapse	fɔdɔm
collar	kɔla
colleague	kɔmpin
colleagues	kɔmpin dɛn
collect	gɛda
collection	wetin yu gɛda
college	kɔlɛj
color	kɔlɔ
colorless green ideas slept furiously	Grin aydia dɛn we nɔ gɛt kɔlɔ dɔn rili slip
colour	kɔlɔ
column	pila
combination	togɛda
combine	miks togɛda
comb	kom
come here	kam na ya
come	kam
come on	kam ya
comfortable	fil fayn
comfort	ɛnkɔrej
coming	de kam
coming soon	kam jisnɔ
command	tɛl
comment	kɔmɛnt
commercial	biznɛs
commission	wok
commit	du
commitment	nɔ kɔmɔt biɛn
committed	dɔn du
commodity	tin
common	kɔmɔn
communicate	tɔk
communication	tɔk
community	pipul na di eria
commute	travul
companion	kɔmpin
company	kɔmni
compare	kɔmpia
comparison	kɔmpia
compassionate	sɔri-at
compassion	sɔri-at
compatible	gri
compete	kɔmpitishɔn
competent	ebul du
competition	kɔmpitishɔn
competitive	kɔmpitishɔn
complain	kɔmplen
complaint	kɔmplen
complement	ɛp
complete	dɔn
completely	kpatakpata
complex	at
compliance	obe
complicated	at
compliment	tɛl tɛnki
comply	obe
composition	aw fɔ arenj sɔntin
compound	kɔmpawnd
comprehension	ɔndastand
comprehensive	kpatakpata
compromise	sɛtul
compulsory	pawpa
computer	kɔmpyuta
concentrate	put atɛnshɔn pan
concept	pɔynt
concern	bisin
concerned	bisin bɔt
concert	myuzik sho
conclusion	dɔn
concrete	simɛnt
condition	kɔndishɔn
conditions	kɔndishɔn dɛn
conduct	biev
conference	mitin
confess	kɔnfɛs
confidence	kɔnfidɛns
confident	kɔnfidɛns
confirm	mek wi biliv
conflict	fɛt-fɛt
confused	bin kɔnfyuz
confusion	kɔnfyus
congrats	kɔngrats
congratulation	kɔngrats
congratulations	kɔngrats
conjunction	togɛda
connect	kɔnɛkt
conquer	win am
consciousness	no
conscious	no
consent	gri
consequences	rizɔlt dɛn
conservation	kip
conservative	soba
considered	bin tink bɔt
consider	tink bɔt
consistency	ɔltɛm
consistent	ɔltɛm
consist	min
constantly	ɔltɛm
constant	ɔltɛm
constipation	banbɛlɛ
construction	bil
consume	yuz
consumption	ɔmɔs yu yuz
contact	kɔl
contagious	sɔntin we de prɛd
contain	gɛt
contains	gɛt
contemporary	da tɛm de
contempt	fil bad bɔt
content	satisfay
contest	kɔmpitishɔn
context	sem say
continent	pat na di wɔl
continue	kɔntinyu
contract	agrimɛnt
contrast	difrɛn
contribute	gi
contribution	gi
control	kɔntrol
controversial	agyumɛnt
convenience	izi
convenient	izi
conversation	tɔk
convert	chenj
convey	ɛksplen
convinced	dɔn mek biliv
convince	mek am biliv
cooking	de kuk
cook	kuk
cool	kol
cooperation	jɔyn an togɛda
cope	bia
copper	kɔpa
core	men
corner	kɔna
corn	kɔn
correct	kɔrɛkt
cost	pe
costume	klos
cottage	smɔl os
cotton	kɔtin
couch	sɛti chia
cough	kɔf
could	ebul
council	kɔmiti
counter	nɔ gri
count	kɔnt
country	kɔntri
countryside	ɔplayn
couple	tu
courage	kɔrɛj
course	kɔz
courtesy	bisin bɔt
court	kɔt
cousin	kɔzin
cover	kɔba
coward	fred man
cow	kaw
cozy	ɛnjɔy
crab	crabs
crack	koken
craft	mek
crap	gini gini
crash	kapsay
craving	de want ɔltɛm
crawl	krip
crazy	ful
create	mek
creative	du nyu tin
credit	krɛdit
creep	fulman
creepy	strenj
crew	wan dɛn we wok na bot
crime	kraym
cringe	shem
crisis	prɔblɛm
criteria	lɔ dɛn
critical	tranga
criticism	fɛn fɔlt
crops	tin dɛn we yu plant
crop	tin we yu plant
cross	krɔs
crow	blak bod
crowd	bɔku bɔku pipul
crowded	bɔku bɔku pipul
crown	krawn
crucial	impɔtant
cruel	wikɛd
cruise	travul insay bot
crush	mas
cry	kray
cucumber	kɔkumba
cuddle	ɔg
culture	kɔlchɔ
cunning	kɔni kɔni
cupboard	kɔpbɔd
cup	kɔp
curb	gɔta
cure	mɛn
curfew	kɔfyu
curiosity	bisin
curious	want fɔ no
curly	kɔli
currency	mɔni
currently	tide
current	naw
curse	kɔs
curtain	kɔtin
cushion	pilo
customer	kɔstɔma
customs	kɔstɔm dɛn
custom	wetin kɔmɔn
cute	fayn
cut	kɔt
cycle	abit
cycling	de baysikul
daddy	papa
dad	papa
daily	ɛnide
dairy	tin we dɛn yuz milk mek
damage	pwɛl
dam	dam
damn	dam
damp	sok
dance	dans
danger	denja
dangerous	denja
dark	dak
darling	dalin
dash	layn
data	data
date	det
daughter	gal pikin
day	de
dead	dɔn day
deadline	ustɛm i fɔ dɔn
deaf	dɛf
deal	du
Dear All	kushɛ ɔlman
Dear Customer	To di kɔstɔma
Dear Parents	Mi mama ɛn papa dɛn
Dear Sir	Kushɛ Sa
Dear students	kushɛ mi studɛnt dɛn
Dear Team	kushɛ-o tim
dear	valyu
death	day
debate	agyu
debit	dɛbit
debris	dɔti
debt	dɛt
decade	tɛn ia
decay	rɔtin
deceased	dɔn day
deceive	ful pipul
december	Disɛmba
decent	gud
decided	dɔn disayd
decide	disayd
decision	disayd
deck	dɛk
decline	go dɔŋ
decrease	go dɔŋ
dedicated	bin gi
dedication	de biɛn sɔntin
deed	tin we yu du
deep	dip
deer	dia
default	balans
defeat	win
defend	protɛkt
define	wetin i min
definitely	shɔ
definition	minin
degree	kayn we
delayed	westɛm
delay	westɛm
delete	dilit
deliberate	bay wilful
delicate	wik
delicious	swit
delighted	gladi
delight	gladi
deliver	briŋ
delivered	dɔn lɛf
delivery	go lɛf
demanding	de aks
demand	tɛl
democracy	gɔvmɛnt fɔ di pipul
demon	dɛbul
demonstrate	sho
denied	dɔn dinay
density	tik
dentist	tit dɔktɔ
deny	dinay
department	dipatmɛnt
departure	lɛf
depend	abop
deploy	sɛn
deposit	put
depressed	at bin rili pwɛl
depression	pwɛl at
depth	dip
describe	tɔk bɔt
description	tɔk bɔt
desert	dɛzat
deserve	fɔ gɛt
designation	taytul
design	dizayn
desire	want
desk	dɛks
despair	at pwɛl
desperate	fil se ɔltin dɔn
despite	pan ɔl
dessert	swit
destination	usay yu de go
destiny	mak
destroy	pwɛl
destruction	pwɛl
detail	patikyula tin
details	tin dɛn
detect	notis
determination	mekɔp yu maynd
determined	mekɔp yu maynd
determine	mekɔp yu maynd
devastated	at pwɛl
developed	bin mek
develop	go bifo
development	aw i go bifo
device	ilɛktronik tul
devil	dɛbul
devoted	dɔn gi
Dhivehi	Dhivehi
diabetes	shuga
diarrhea	rɔnbɛlɛ
diary	jɔnal
dictionary	dikshɔnari
did	dɔn du
die	day
died	dɔn day
diet	lɛ yu bɔdi kam dɔŋ
difference	difrɛn
different	difrɛn
difficult	nɔ kin izi
dig	dig
dignity	rɛspɛkt
diligent	wok tranga wan
dinner	ivintɛm it
dip	put
direct	dayrɛkt
direction	we
director	dayrɛktɔ
dirt	dɔti
dirty	dɔti
disabled	disebul
disable	disebul
disappear	lɔs
disappointed	fil bad
disaster	bad bad tin
discard	trowe
discharge	dischaj
discipline	kɔrɛkt
discount	ridyus
discover	kam no
discrimination	tek wan pɔsin impɔtant pas ɔda pɔsin
discussion	tɔk bɔt
discuss	tɔk bɔt
disease	sik
diseases	sik dɛn
disguise	ayd
disgusting	dɔti dɔti
dishes	pan dɛn
dish	pan
dismiss	pul
dispatch	sɛn
display	sho
disposal	trowe
dispute	cham-mɔt
distance	fa
distinct	spɛshal
distinguish	mek wi difrɛn
distress	trɔbul
distribution	sheb
district	distrikt
disturb	ambɔg
ditch	gɔta
dive	dayv
diverse	difrɛn
diversity	difrɛn
divide	sheb
divine	lɛk ɛvin
divorce	dayvɔs
dizzy	ed de tɔn
doctor	dɔktɔ
document	pepa
do	du
does	du
doesn't	nɔ
dog	dɔg
Dogri	Dogri
doing	de du
doll	dɔlbebi
domain	domen
domestic	na os
dominant	men
donate	gi
done	dɔn
donkey	dɔnki
don't	nɔ
Don't worry	nɔ wɔri
dope	drɔg
double	tu
doubt	dawt
dough	mɔni
down	dɔŋ
download	dɔŋlod
do you love me	yu lɛk mi
do you	yu de
draft	briz
drag	drɛg
drain	dren
drama	stori
draw	drɔ
drawer	drɔwɔ
drawing	drɔin
dread	fred
dream	drim
dress	drɛs
drill	mek ol
drink	drink
drive	drayv
drop	drɔp
dropped	dɔn drɔp
drought	ren nɔ kam
drunk	chak
dry	dray
duck	dɔks
dude	bɔbɔ
due	fɔ gɛt
due to	bikɔs
dull	dɔl
dumb	bigful
dump	dɔti bɔks
duration	ɔmɔs tɛm
during	we
dust	dɔst
duty	wok
dwell	ste
dying	de day
each	ɛni
each other	dɛnsɛf
eager	rili want
eagle	igul
earlier	bin
early	ali
earn	gɛt
ears	yes
earth	dunya
earthquake	atkwek
ear	yes
ease	izi
easily	izi
east	ist
easy	izi
eating	de it
eat	it
economic	mɔni biznɛs
economy	mɔni biznɛs
edge	nia
edit	kɔrɛkt
education	skul biznɛs
effect	apin
effective	gud gud
efficiency	ɔganayz
efficient	ɔganayz fayn
effort	tray tranga wan
egg	eg
eggplant	gadineg
ego	prawd
eighteen	etin
eight	et
eighty	eti
either	ɔ
elaborate	ɛksplen
elbow	ɛlbo
elderly	ol pɔsin
elder	ol pa
elegant	fayn stayl
element	tin
elephant	ɛlifant
eleven	ilɛvin
eligible	fit fɔ
eliminate	dɔnawe wit
else	bak
embarrassed	shem
embarrassing	shem
embrace	ɔg
emerge	kɔmɔt
emergency	sɔntin yu nɔ plan
emotional	aw yu de fil
empathy	sɔri-at
emphasis	atɛnshɔn pan
emphasize	put atɛnshɔn pan
employees	wokman dɛn
employee	wokman
employer	bɔsman
employment	wok
empty	ɛmti
enable	ɛp
encounter	mit
encourage	ɛnkɔrej
endangered	ambɔg
end	dɔn
endeavor	tray
endurance	bia
endure	bia
enemy	ɛnimi
energy	pawa
engage	aks fɔ mared
engaged	bin put an pan
engagement	ɛngej
engineer	injinia
engine	injin
English	Inglish
enhance	mek bɛtɛ
enjoy	ɛnjɔy
enormous	big big
enough	du
ensure	mek shɔ
enter	ɛnta
entertainment	ɛnjɔymɛnt
enthusiasm	zil
enthusiastic	zil
entire	ɔl
entitled	gɛt rayt
entity	ɔganayzeshɔn
entrance	domɔt
entrepreneur	biznɛsman
envelope	ɛnvilop
environment	ples
envy	milɛ
epic	spɛshal
epidemic	sik prɔblɛm
equal	ikwal
equipment	tul
equity	valyu tin
equivalent	sem
eraser	pul
error	mistek
escape	kɔmɔt
especially	mɔ
essay	ripɔt
essence	minin
essential	impɔtant
established	bin stat
establish	stat
estate	prɔpati
estimated	lɛk
estimate	lɛk
etc	ɛn ɔda tin dɛn
eternal	sote go
ethics	biliv dɛn
evaluate	chɛk
evaluation	chɛk
evening	ivin
even	ivin
even though	pan ɔl
event	program
eventually	as tɛm de go
ever	ɛva
everybody	ɔlman
every	ɛvri
everyone	ɔlman
everything	ɔl wetin
evidence	pruf
evil	wikɛd
evolution	ɔltin kam bay chans
evolve	chenj
Ewe	Ewe
exactly	jɔs lɛk
exact	sem
exam	ɛgzam
examine	chɛk
example	ɛgzampul
exceed	pas
excellent	wɛl dɔn
exception	pas
except	pas
excessive	pasmak
excess	pasmak
exchange	gi
excited	gladi
excitement	zil
exciting	gladi
exclusive	spɛshal
excuse	ɛkskyuz
excuse me	sɔri ya
execute	kil
execution	kil
executive	bigman
exercise	ɛksasayz
ex	ɛks
exhausted	dɔn taya
exhaust	taya
exhibition	sho
exhibit	sho
exist	de de
existence	de de
existing	de de
exit	kɔmɔt
expand	gro
expected	bin wet
expect	wet fɔ
expenses	spɛn mɔni
expensive	dia
experience	ɛkspiriɛns
experiment	tɛst
expert	masta sabi bukman
expired	dɔn dɔn
explain	ɛksplen
explanation	fɔ ɛksplen
exploit	yuz fɔ bad
explore	lan mɔ
export	sɛn
exposed	mek ɔlman no
expose	tɛl ɔlman
exposure	ɛkspiriɛns
expression	tɔk
express	tɔk
extended	bin prɛd
extend	gro
extension	lɔng
extent	lɛvul
external	ɔda tin
extinct	nɔ de igen
extract	pul kɔmɔt
extra	mɔ
extraordinary	rili spɛshal
extremely	rili
extreme	rili
eyes	yay
eye	yay
fabric	klos
fabulous	wɔndaful
face	fes
facilitate	ɛp
facilities	ɔfis
facility	ples
factor	tin
factory	faktri
facts	trut dɛn
fact	trut
fade	fed
failed	dɔn fel
fail	fel
failure	fel
faint	fent
fair	du tin tret
fairly	fia wan
fairy	fɛri
faith	fet
faithful	fetful
fake	gini gini
fall	fɔdɔm
false	lay
fame	ɔlman no bɔt am
familiar	sabi
family	famili
famine	bad angri
famous	wetin ɔlman sabi
fancy	pɔsh
fan	fan
fantastic	wɔndaful
farewell	baybay
far	fa
farmer	fama
farm	fam
fascinating	spɛshal
fashion	stayl
fast	kwik
fatal	kin kil
fat	bɔmp
fate	wetin go apin
father	papa
fatigue	taya
fault	fɔlt
favorite	bɛst
favour	aks
favourite	bɛst
fear	fred
feast	bɔku it
feather	fɛda
features	tin dɛn
feature	tin
february	Fɛbwari
fed up	dɔn taya
feedback	ansa
feed	it
fee	fi
feel	fil
feeling	filin
feet	fut
fell	fɔdɔm
fellow	kɔmpin
felt	dɔn fil
female	uman
fence	fɛns
fertile	fatayl
festival	fɛstival
fetch	briŋ
fever	fiva
fewer	nɔ bɔku
few	sɔm
fiance	man we yu go mared
fiction	stori stori
field	fil
fierce	wayl
fifteen	fiftin
fifty	fifti
fight	fɛt
fighting	de fɛt
figure	nɔmba
figure out	tray fɔ no
file	fayl
filled	dɔn fil
fill	fil
film	fim
filthy	dɔti
finally	dɔn
finance	mɔni biznɛs
financial	mɔni biznɛs
find	fɛn
find out	fɛnot
fine	fayn
finger	finga
finish	dɔn
finished	dɔn dɔn
fire	faya
firm	kɔmni
first	fɔs
first name	fɔs nem
fish	fish
fit	fit
five	fayv
fixed	bin mek
fix	mek bak
flag	flag
flash	flash
flat	flat
flawless	pafɛkt
flaw	mak
flee	rɔnawe
flesh	bɔdi
flew	dɔn flay
flex	bɛn
flexible	ajɔst
flight	flay
flip	tɔn oba
flirt	flɔt
flirting	de mek lɛk se yu lɛk am
float	pantap
flood	ebi ebi ren
floor	grɔn
flour	flawa
flower	flawa
flow	flo
fluently	gud gud wan
fluent	tɔk gud gud wan
fluffy	saf
flu	flu
fluid	wata-wata
fly	flay
focus	tink bɔt
fog	fɔg
foggy	fɔg
fold	fol fol
folks	pipul dɛn
follow	fala
following	fala
follow up	go bak
food	it
fool	ful
foolish	nɔ gɛt sɛns
football	futbɔl
foot	fut
forbidden	nɔ fɔ du
force	fos
forecast	wetin dɛn tink se go apin
forehead	fɔed
foreign	ɔda
forest	bush
forever	sote go
For example	fɔ ɛgzampul
for	fɔ
forget	fɔgɛt
forgive	fɔgiv
forgot	dɔn fɔgɛt
for instance	fɔ ɛgzampul
fork	fɔk
formal	ɔfishal
former	trade
form	fɔm
fortunately	i gud
fortune	bɔku mɔni
forty	fɔti
forty-two	fɔti-tu
forward	wet fɔ
for you	fɔ yu
foster	mek
fought	bin fɛt
foundation	fawndeshɔn
found	bin fɛn
four	fɔ
fourteen	fɔtin
fox	fɔks
fragile	wik
frame	frem
framework	ɛksplen
fraud	kruk
freak	aksidɛnt
freedom	fridɔm
free	fri
freeze	friz
frequency	ɔmɔs tɛm
frequent	bɔku
frequently	bɔku tɛm
fresh	frɛsh
friday	Frayde
fridge	friza
friendly	bi padi
friend	padi
friendship	padi biznɛs
friends	padi dɛn
frightened	fred
frightening	fred
frog	frɔg
from	frɔm
front	bifo
frozen	dɔn friz
fruit	frut
frustrated	gens
fuel	fyuɛl
Fulfulde	Fulfulde
full	ful-ɔp
function	wok
fundamental	impɔtant
funeral	bɛrin
fun	ɛnjɔy
funny	fɔni
furious	vɛks bad wan
fur	kanda
furniture	tin dɛn
furthermore	bɔt nɔto dat nɔmɔ
further	mɔ
future	tumara bambay
gain	gɛt
game	gem
gap	spes
garage	garaj
garbage	dɔti
garden	gadin
garlic	galik
gate	get
gather	gɛda
gathering	mitin
gauge	mɛzhɔ
gave	dɔn gi
gear	gia
gender	bɔy ɔ gal
general	kɔmɔn
generally	bɔku tɛm
generate	mek
generation	pipul dɛn
generous	fri-an
genius	bɔku sɛns
genre	kayn
gentle	saful
genuine	rili
gesture	aw yu mek yu an
get dressed	drɛs
get	gɛt
getting	de gɛt
get up	grap
get well soon	gɛt wɛlbɔdi kwik kwik wan
ghost	gost
ghosting	dɔn dɔn di padi biznɛs wantɛm wantɛm
giant	big big
gift	gift
ginger	jinja
girlfriend	galfrɛn
girl	gal
give	gi
given	dɔn gi
give up	giv ɔp
glad	gladi
glance	luk kwik wan
glasses	glasis
glass	glas
glimpse	si smɔl
global	ɔlsay na di wɔl
gloomy	dɔŋ
gloves	glɔv dɛn
glow	shayn
glow up	shayn ɔn
glue	glu
go ahead	go bifo
goal	gol
goals	gol dɛn
goat	got
go away	kɔmɔt
god bless you	Gɔd blɛs yu
god	Gɔd
goes	go
go	go
going	de go
going to	go go
gold	gold
gone	dɔn
gonna	go
good afternoon	gud aftanun
good bye	baybay
goodbye	baybay
good day	adu-o
good evening	gud ivnin
good	gud
good job	gud wok
good looking	fayn
good luck	gud lɔk
good morning	gud mɔnin
good morning my love	gud mɔnin mi lɔv
good night	gud nɛt
goodnight	gudnɛt
goods	tin dɛn
Google	Google
Google Translate	Google Translet
goose	dɔks
goo	tin
gorgeous	rili fayn
gossip	kongosa
got	bin gɛt
got it	dɔn gɛt am
go to bed	go ledɔm
government	gɔvmɛnt
grab	grip
grade	mak
gradually	smɔl smɔl
graduate	gradyuet
grain	sid
grant	alaw
granted	gi
grapes	greps
grasp	grip
grass	gras
grateful	gladi
gratitude	fil fɔ tɛl tɛnki
grave	grev
gray	gre
great	rili
greed	big yay
greedy	big yay
green	grin
greet	grit
greeting	grit
greetings	de grit
grey	gre
grid	nɛtwɔk
grief	pwɛl at
grind	gren
grip	ol
grocery	makit
groom	ɔkɔ
gross	dɔti dɔti
ground	grɔn
group	grup
grow	gro
growth	gro
grumpy	vɛks
Guarani	Guarani
guarantee	prɔmis
guard	gayd
guess	no
guest	strenja
guidance	gayd
guide	gayd
guilty	gilti
guy	man
guys	man dɛn
gym	jim
habit	abit
habitat	say we animal de
had	bin
hail	ays blɔk
hair	ia
half	af-af
hall	ɔl
hand	an
handle	sɔlv
handsome	fayn
hang	ɛng
hang out	kip kɔmpin
happen	apin
happened	dɔn apin
happiness	gladi
happy birthday	api batde
happy birthday to you	api batde to yu
happy	gladi
happy new year	api nyu ia
hard	at
hardly ever	nɔ kin
hardly	nɔ
harm	damɛj
harmful	denja
harmony	wanwɔd
harsh	strikt
harvest	avɛst
has	dɔn
hate	et
have a good day	ɛnjɔy di de
have a nice day	a op yu de go fayn
have breakfast	it mɔnintɛm it
have fun	ɛnjɔy
have	gɛt
have you eaten	yu dɔn it
having	de gɛt
hazard	denja
haze	nɔ klia
headache	ed de at
head	ed
healing	de mɛn
heal	mɛn
health	wɛlbɔdi
healthy	gɛt wɛlbɔdi
heard	dɔn yɛri
heart	at
hear	yɛri
heat	ɔt
heaven	ɛvin
heavy	ebi
hectic	bizi
he has	i gɛt
he	i
height	ayt
heir	pikin
he is	i na
heist	tif
held	dɔn ol
hell	ɛl
Hello	Adu
hello dear	kushɛ dalin
hello how are you	adu-o, aw yu de du
hello how are you doing	adu-o, aw yu de du
helmet	ɛlmɛt
help	ɛp
helpful	fɔ ɛp
hence	so
herd	mɛn
here	naya
her	i
heritage	wetin yu gɛt
hesitate	westɛm
Hey	Eh
hidden	ayd
hide	ayd
hierarchy	ɔda
high	ay
highlight	sho
hi how are you	kushɛ, aw di bɔdi
hike	waka
hiking	waka
Hi	kushɛ
hilarious	fɔni
hill	il
him	in
hint	ɛp
hips	wesbon dɛn
hip	wesbon
hire	tek pɔsin
hiring	de tek pɔsin fɔ wok
his	in
history	istri
hit	bɔks
Hi there	kushɛ-o
Hmm	Ehh
hobby	tin we yu lɛk
hold	ol
hold on	ol
hole	ol
holiday	ɔlide
hollow	ɛmti
home	os
homework	skulwok
honestly	ɔnɛs wan
honest	ɔnɛs
Honey	Ɔni
honor	ɔnɔ
hood	bɔnɛt
hook	uk
hopefully	op se
hopeless	nɔ gɛt wan op
hope	op
hop	jɔmp
horizontal	bifo ɛn biɛn
horn	ɔn
horrible	bad bad
horror	fiaful
horse	ɔs
hospitality	fri-an
hospital	ɔspitul
hostile	vɛks
host	pɔsin we de trit strenja fayn
hotel	ɔtɛl
hot	ɔt
hour	awa
hours	awa dɛn
household	os
house	os
how about you	we yu
how are you	aw di bɔdi
how are you doing	aw yu de du
how are you doing today	aw yu de du tide
how are you today	aw yu de tide
how	aw
how do you do	aw yu de du
however	bɔt
how is	aw
how many	ɔmɔs
how much	ɔmɔs
how often	ɔmɔs tɛm
how old are you	ɔmɔs ia yu ol
how was your day	aw yu spɛn di de
how was your night	aw yu pas di nɛt
hubby	man
hub	sɛnta
huge	big
hug	ɔg
human	mɔtalman
humble	ɔmbul
humidity	sok
humid	sok
hundred	ɔndrɛd
hungry	angri
hunt	ɔntin
hurricane	ebi ebi briz
hurry	ɔri
hurry up	kam kwik
hurt	wund
husband	maredman
hustle	rɔsh
hut	bafa
hygiene	klin
I	a
I am fine	a de fayn
I am	mi na
I can	a kin
I can't	a nɔ ebul
ice	ays
ice cream	ays krim
ideal	bɛst
idea	pɔynt
identical	sem
identify	no
identity	udat
idiot	fulman
idle	aydul
I do	a du
I do not know	a nɔ no
I do not understand	a nɔ ɔndastand
I don't	a nɔ
I don't know	a nɔ no
I don’t know	a nɔ no
I don’t understand	a nɔ ɔndastand
I don't understand	A nɔ ɔndastand
I don't understand what you mean	a nɔ ɔndastand wetin yu min
I don't understand you	a nɔ ɔndastand yu
if	if
ignore	nɔ put atɛnshɔn pan
i guess	a tink
I had	a dɔn
I have	a gɛt
I have been	a dɔn
I hope so	a op so
I know	a no
I like	a lɛk
I like you	a lɛk yu
illegal	di lɔ nɔ de alaw
illness	sik
ill	sik
Ilocano	Ilocano
I love	a lɛk
I love my big brother	a lɛk mi big brɔda
I love my big sister	a lɛk mi big sista
I love my father	a lɛk mi papa
I love my little brother	a lɛk mi smɔl brɔda
I love my little sister	a lɛk mi smɔl sista
I love my mother	a lɛk mi mama
I love you	A lɛk yu
I love you so much	a rili lɛk yu
I love you too	a lɛk yu bak
image	aydul
imagine	imajin
I mean	a min
I'm fine	a de fayn
I'm good	a de oke
I'm here	a de ya
I miss you	a mis yu
I miss you so much	a rili mis yu
immediately	wantɛm wantɛm
immediate	wantɛm wantɛm
immense	big
I'm	mi na
I’m	mi na
impact	afɛkt
impatient	nɔ ebul wet
implement	stat fɔ yuz
important	impɔtant
import	briŋ kam
impose	fos
impossible	nɔ pɔsibul
impression	shep
impressive	big big
impress	kɔle
improve	bɛtɛ
improvement	go bifo
I'm sorry	a sɔri
in addition	pantap dat
inappropriate	nɔ fayn
incentive	rizin
incident	sɔntin
include	min
including	de min
income	mɔni
inconvenience	nɔ izi
increased	dɔn go ɔp
increase	mɔ
incredible	wɔndaful
indeed	fɔ tru
independent	du tin fɔ yusɛf
India	India
indicate	sho
indigenous	kɔmɔt frɔm di eria
individual	pɔsin
industry	fil
inevitable	go mɔs apin
In fact	infakt
infant	bebi
infection	sik we de prɛd
infinity	sote go
inflammation	swɛl
inflation	mɔni biznɛs tranga
influence	afɛkt
information	tin dɛn
inform	tɛl
in front of	bifo
ingredients	tin dɛn we de insay
inheritance	wetin yu fambul gɛt
initial	fɔs
initiative	ɛp fɔ stat
injured	wund
injury	wund
innocent	gud
innovation	nyu tin
in order to	fɔ
inquiry	aks
insane	kres
insect	bɔg bɔg
insecure	fil bad
insert	ad
inside	insay
insight	tink gud wan
insist	pin
insomnia	nɔ ebul slip
inspiration	kɔrɛj
inspire	push
install	dawnlod
instance	sɔntɛnde
instant	naw naw
instead	bifo dat
instead of	bifo
instructions	advays dɛn
instrument	yuz ple myuzik
insult	provok
insurance	inshɔrans
intact	de pan am
integrity	du wetin rayt
intellectual	pɔsin wit sɛns
intelligence	sɛns
intelligent	gɛt sɛns
intended	dɔn plan
intend	plan
intense	rili
intention	plan
interact	biev to
interaction	biev
interest	bisin
interested	bisin bɔt
interesting	fayn
interfere	ambɔg
intermediate	af-af
internal	insay
international	intanashɔnal
internship	wok we dɛn nɔ pe yu
interpreter	intaprita
interpret	intaprit
interrupt	kɔt wɔd
interview	intavyu
intimate	tayt
into	to
introduce	sho
introduction	sho
introvert	shem
intuition	ɔndastand
invalid	nɔ ol wata
invent	mek fɔs
inventory	rɛkɔd
invest	du biznɛs
investigate	tray fɔ no
invitation	fɔ invayt
invite	invayt
invoice	bil
involved	put an pan
involve	sɔntin fɔ du wit
iron	ayɛn
I see	a si
island	ayland
isolated	fa say
issues	tin dɛn
issue	tin
items	tin dɛn
item	tin
I think	a tink
it	i
it is	i na
its	in
it's	i na
It's okay	i oke
it's ok	i ok
it was	i bin
I understand	a ɔndastand
I want	a want
I want to see you	a want fɔ si yu
I want you	a want yu
I was	a bin
I will	a go
I would be	a go bi
jacket	jakɛt
jail	jel
January	Janwari
jar	glas
jaw	jɔ
jealous	milɛ
jerk	drɔ
jewelry	valyu tin
job	wok
jogging	de jɔg
join	jɔyn
joint	togɛda
joke	jok
journalist	pɔsin we de rayt fɔ nyuspepa
journey	patrol
joy	gladi
judge	jɔj
juice	jus
july	Julay
jump	jɔmp
june	Jun
junk	dɔti
just do it	jɔs du am
justice	du wetin rayt
justify	gi rizin
just	jɔs
Kalaallisut	Kalaallisut
keen	rili
keep it up	nɔ lɛf
keep	kip
kept	dɔn kip
kettle	kɛtul
key	ki
kick	kik
kidding	jok
kid	jok
kidney	kidni
kids	pikin dɛn
kill	kil
kinda	lɛk
kind	kayn
kindly	saful
kindness	saful
king	kiŋ
kiss	kis
kitchen	kichin
kite	kayt
kitten	smɔl pus
knee	ni
knew	dɔn no
knife	nɛf
knight	nayt
knowledge	no
known	no
know	no
Konkani	Konkani
Krio	Krio
label	kɔl
labor	wok
labour	wok
lack	nɔ
ladder	lada
lady	uman
laid	bin le
lake	watasay
lamb	ship pikin
lame	kripul
lamp	layt
land	land
landscape	land
language	langwej
lap	fut
large	big
last but not least	las bɔt stil
last	las
last name	las nem
late	let
lately	dis biɛn tɛm
later	leta
latest	tin we jɔs kɔmɔt
latter	las
laughing	de laf
laugh	laf
laughter	laf
launch	sɛn
laundry	bruk
law	lɔ
lawn	gras
lawyer	lɔya
layer	pat
lay	le
layout	dizayn
lazy	aydul
leader	lida
lead	lid
leaf	lif
leak	wata kam insay
lean	lin
leap	jɔmp
learning	de lan
learn	lan
lease	rɛnt
least	lili
leather	lɛda
leave	lɛf
leaves	lif dɛn
led	dɔn lid
left	dɔn go
legacy	wetin yu lɛf fɔ yu pikin
legal	gɛt di rayt
legend	soso stori
leg	fut
legit	gɛt rayt
leisure	blo
lend	trɔs
length	lɔng
less	nɔ
lesson	lɛsin
let	lɛ
letter	lɛta
lettuce	salad
level	lɛvul
leverage	pawa
liability	lod
library	laybri
lick	lik
lie	lay
lies	lay lay dɛn
life	layf
lift	es
light	layt
lightning	laytin flash
like	lɛk
likely	go mɔs bi
likewise	semweso
line	layn
Lingala	Lingala
link	link
lion	layɔn
liquid	wata-wata
listening	de lisin
listen	lisin
list	list
literally	tru tru
literature	buk
litter	trowe dɔti
little	smɔl
liver	liva
lives	tap
live	tap
living	fɔ liv
living room	palɔ
lizard	kondo
load	lod
loaf	bred
loan	lon
local	eria
location	ples
lockdown	lɔk
lock	lɔk
log	bod
lol	lol
lonely	wangren
long	lɔng
long time no see	i dɔn te we wi si
look	luk
loop	tay
loose	slak
lord	lɔd
lose	dɔn lɔs
loss	lɔs
lost	lɔs
lot	pat
loud	lawd
lounge	palɔ
love	lɔv
lovely	fayn
love you	lɔv yu
lower	ridyus
low	lo
loyal	de biɛn
loyalty	de biɛn
luck	lɔk
lucky	gɛt lɔk
Luganda	Luganda
luggage	bag dɛn
lump	pat pan
lunch	lɔnch
lungs	lɔng
luxury	jɛntri
lying	de lay
machine	mashin
madam	uman
made	bin mek
mad	vɛks
magazine	magazin
magnificent	wɔndaful
maid	savant
main	men
maintain	kɔntinyu
maintenance	mek say we dɔn pwɛl
Maithili	Maithili
majority	mɔ
major	men
make	mek
make up	pawda
male	man
mall	mɔl
manage	manej
management	fɔ manɛj
manager	maneja
mandatory	pawpa
manifest	sho
manipulate	kɔntrol
man	man
manner	we
manual	buk
many	bɔku
many many happy returns of the day	bɔku bɔku fayn tin dɛn fɔ yu
march	mach
margin	kɔna say
market	makit
marriage	mared
married	mared
mask	maks
mass	bɔku
massive	big
master	masta
match	mach
mate	met
material	tin dɛn
math	mats
matter	tin
maturity	machɔ
maybe	sɔntɛm
may	sɔntɛm
meal	it
meaning	minin
mean	min
means	min
meant	bin min
meanwhile	We dis de bi
measure	mɛzhɔ
measures	tin dɛn
meat	bif
medical	wɛlbɔdi biznɛs
medicine	mɛrɛsin
meditation	tink dip
medium	lukin-grɔn uman
meeting	mitin
meet	mit
Meiteilon	Meiteilon
melt	mɛlt
me	mi
memories	tin dɛn we yu mɛmba
memory	mɛmba
mental	maynd
mentioned	dɔn tɔk
mention	tɔk
mentor	pɔsin we advays
merchant	biznɛsman
mercy	sɔri-at
merely	jɔs
merry christmas	api Krismas
message	mesɛj
mess	bad-ɔf
messy	skata
metal	ayɛn
method	we
me too	mi bak
mice	arata dɛn
middle	midul
midnight	midulnɛt
might	sɔntɛm
mild	nɔ vɛks kwik
milestone	gol
military	soja
milk	milk
million	milyɔn
mind	maynd
mindset	wetin yu de tink
mine	mi yon
mingle	miks
minor	smɔl
minute	minit
minutes	minit dɛn
miracle	mirɛkul
mirror	lukin-glas
miscellaneous	ɔda
mischievous	kɔni kɔni
miserable	at pwɛl
misery	sɔfa
missing	de mis
mission	wok
miss	mis
miss you	mis yu
mistake	mistek
mist	smɔl ren
Mizo	Mizo
mobile	mobayl
mock	provok
model	ɛgzampul
moderate	soba
modern	naw
modest	ɔmbul
moist	sok
moisture	wata
mold	shep
mole	mol
moment	tɛm
mom	mama
monday	Mɔnde
money	mɔni
monitor	wach
monkey	mɔnki
month	mɔnt
mood	aw yu fil
moody	at fɔ dil wit
moon	mun
moral	aw wi liv
more	mɔ
moreover	dɔn
morning	mɔnin
mortgage	trɔs
mostly	bɔku
most	pas ɔl
mother	mama
motion	muv
motivation	gɛt zil
mountain	mawntɛn
mouse	arata
mouth	mɔt
movement	fɔ muv
move	muv
movie	fim
mrs	wɛf
much	bɔku
mud	pɔtɔpɔtɔ
mug	kɔp
muscle	mɔsul
museum	myuziɔm
mushroom	mɔshrum
music	myuzik
must	mɔs
mute	nɔ ebul tɔk
mutual	togɛda
My dear	mi dalin
my friend	mi padi
My hovercraft is full of eels	my bot dɔn ful-ɔp wit fish dɛn
my love	mi lɔv
my	mi
my name is	mi nem na
my pleasure	a gladi
myself	misɛf
mysterious	sikrit
mystery	sikrit
myth	lay lay stori
nail	nel
naive	nɔ gɛt sɛns
name	nem
narrative	stori
narrow	tayt
nasty	bad bad
nationality	us kɔntri yu kɔmɔt
national	nashɔnal
native	yon
natural	kɔmɔn
nature	nechɔ
nausea	vɔmit
nearby	nia
nearly	lɛk
near	nia
neat	nit
necessary	nid
necklace	chen
neck	nɛk
need	nid
negative	bad
neglect	fɔgɛt bɔt
negotiate	tɔk prays
neighborhood	eria
neighbor	neba
neither	ɔ
nephew	brɔda pikin
nerd	mumu
nervous	fred
nest	nɛst
net	nɛt
network	nɛtwɔk
neutral	nɔ put an pan
never give up	nɔ giv ɔp
never mind	i nɔ impɔtant
nevermind	nɔ mata
never	nɔ ɛva
nevertheless	Bɔt stil
new	nyu
news	nyuz
next	nɛks
next to	nia
nice	fayn
nice to meet you	gladi fɔ mit yu
niece	sista pikin
nightmare	bad drim
night	nɛt
nine	nayn
nineteen	nayntin
ninety	naynti
nobody	nɔbɔdi
noise	nɔys
noisy	nɔys
none	nɔn
No	Nɔ
noon	12 oklɔk
nope	nɔ-o
no problem	nɔ prɔblɛm
normal	nɔmal
nor	nɔ
north	nɔt
nose	nos
nostalgic	mɛmba
not at all	atɔl
not bad	nɔ bad
noted	fɔ mɛmba
note	not
nothing	natin
noticed	dɔn notis
notice	notis
Not now	nɔto naw
not	nɔto
not yet	nɔ yɛt
noun	nawn
nouns	nawn dɛn
novel	nyu
november	Novɛmba
nowadays	tide
no way	nɔ we nɔ de
now	naw
nuisance	mɔna
null	nɔ gɛt wan valyu
number	nɔmba
numb	nɔ fil natin
nurse	nɔs
nutmeg	natmeg
nut	nat
nutrition	it we gi wɛlbɔdi
oath	prɔmis
obesity	fat
obey	obe
objective	gol
object	tin
obligation	pawpa
obscure	ayd
observation	fɔ wach
observe	wach
obsessed	tink pasmak
obsession	tumɔs
obsolete	nɔ de na stayl igen
obstacle	prɔblɛm
obtained	dɔn gɛt
obtain	gɛt
obvious	klia
obviously	klia wan
occasionally	wan wan tɛm
occupation	wok
occupied	bin bizi
occur	apin
occurred	dɔn apin
occurs	apin
ocean	si
october	Ɔktoba
odds	chans dɛn
odd	strenj
of course	na tru
offensive	bad bad tin
offer	gi
office	ɔfis
official	bigman
off	ɔf
of	ɔf
often	bɔku tɛm
Oh	O
oh really	o rili
oil	ɔyl
okay baby	oke bebi
okay dear	oke dalin
okay honey	oke dalin
okay my love	oke mi lɔv
okay	ok
ok dear	ok dalin
ok honey	ok dalin
ok my love	oke mi lɔv
ok	ok
old	ol
once	wan tɛm
one language is never enough	wan langwej nɔ go du
one	wan
onion	yabas
online	Intanɛt
only	nɔmɔ
on	pantap
open	opin
operation	ɔpreshɔn
opinion	wetin yu tink
opportunities	chans dɛn
opportunity	chans
opposite	difrɛn
optimistic	gɛt op
optional	pɔsibul
option	ɔda tin
orange	ɔrinch
order	ɔda
ordinary	nɔmal
organization	ɔganayzeshɔn
orientation	usay
original	fɔstɛm
origin	usay i kɔmɔt
Oromo	Oromo
or	ɔ
orphan	pikin we nɔ gɛt mama ɛn papa
other	ɔda
otherwise	if nɔto dat
ought	fɔ
Our mission: to enable everyone, everywhere to understand the world and express themselves across languages.	Wi wok: fɔ mek ɔlman ɔlsay na di wɔl ebul fɔ ɔndastand dɛnsɛf ɛn tɔk to dɛnsɛf.
Our mission: to organize the world's information and make it universally accessible and useful.	Wi wok: fɔ ɔganayz ɔltin na di wɔl ɛn mek ɔlman ebul fɛn am ɛn yuz am
our	wi
outcome	rizɔlt
outfit	klos
outgoing	jovial
out	kɔmɔt
outlet	ol
outline	awtlayn
outside	na do
outstanding	spɛshal
oven	ovun
overall	ɔl
overcome	sɔlv
over	oba
over there	oba yanda
overthinking	tink pasmak
overwhelmed	tumɔs
overwhelming	pasmak
owe	fɔ pe
owl	awul
owner	pɔsin we gɛt am
own	yon
ox	kaw
pace	spid
package	bɔks
pack	pak
paid	dɔn pe
pain	pen
painting	pentin
paint	pent
pair	bay tu
pale	layt
palm	bɛlɛ an
pandemic	sik
panic	fred
pan	pan
pants	trɔsis
paper	pepa
paradise	paradays
parallel	gri
parcel	bɔks
pardon	fɔgiv
parents	mama ɛn papa dɛn
park	pak
parrot	parɔt
parsley	pasli
participate	put an pan
particularly	mɔ
particular	patikyula
partner	patna
part	pat
party	pati
passage	da say de
passed	bin pas
passionate	kɔmɔt na yu at
passion	fala wi at
passive	du natin
pass	pas
password	paswɔd
past	trade
patch	af pat
pathetic	sɔri fɔ si
path	rod
patience	peshɛnt
patient	peshɛnt
pattern	ɛgzampul
pause	wet smɔl
pavement	rod
payment	pe
pay	pe
peaceful	pis
peace	pis
peach	pich
peak	ay pas
pear	Inglish pia
peas	piz
peculiar	strenj
peel	pil
pee	pis
peer	kɔmpin
peers	kɔmpin dɛn
pencil	pɛnsil
pending	de wet
pen	pɛn
people	pipul dɛn
pepper	pɛpɛ
perceive	si
perception	aw wi ɔndastand
perfect	pafɛkt
performance	pafɔm
perform	pafɔm
perhaps	sɔntɛm
period	tɛm
permanent	sote go
permission	alaw
permit	alaw
perseverance	kɔntinyu
persistent	nɔ taya
personality	karakta
personal	pasɔnal
person	pɔsin
perspective	aw yu si sɔntin
persuade	mek dɛn du sɔntin
pervert	pɔsin we nɔ du tin tret
pet	animal we yu gi nem
phase	tɛm
phenomenon	mirekul
philosophy	mɔtalman sɛns
phone	fon
photo	snap
phrase	wɔd dɛn
physical	bɔdi
pick	pik
pick up	tot
picture	pikchɔ
piece	pat
pieces	tin dɛn
pigeon	pijin
pig	ɔg
pile	bɔku
pillow	pilo
pilot	paylɔt
pineapple	paynapul
pin	fasin
pink	pink
pitch	ta
pit	ol
pity	sɔri
place	ples
places	ples dɛn
plague	bad tin
plain	klia
plane	iaplen
plan	plan
plant	plant
plants	plant dɛn
plate	plet
platform	stej
playing	de ple
play	ple
pleasant	fayn
pleased	gladi
please	duya
pleasure	ɛnjɔy
pledge	prɔmis
plenty	plɛnti
plot	plan
plug	plɔg
plumber	plɔmba
plum	plɔm
plural	pas wan tin
podcast	pɔdkast
poem	pɔym
poetry	pɔym
point	pɔynt
poison	pɔyzin
police	polis
policy	wɔd
polite	biev fayn
pollution	dɔti ia
pond	watasay
pool	wata
poop	kaka
poor	pɔ
pop	pɔp
popular	kɔmɔn
population	pipul dɛn
pork	ɔg
porridge	pap
port	waf
position	say
positive	gud
possess	gɛt
possession	prɔpati
possessive	milɛ
possible	pɔsibul
postpone	put na kɔna
post	post
potato	pɛtetɛ
potential	kin du
pound	pawn
poverty	po
powerful	pawaful
power	pawa
practical	gud
practice	du
praise	prez
prank	jok
pray	pre
precious	valyu
precise	kɔrɛkt
precisely	na so
predict	tɔk se sɔntin go bi
preference	wetin wi lɛk
prefer	want
pregnant	gɛt bɛlɛ
prejudice	tek wan pɔsin bɛtɛ pas ɔda pɔsin
premises	say
premium	bɛst
preparation	fɔ pripia
prepared	dɔn pripia
prepare	pripia
preposition	prɛposishɔn
presence	de de
presentation	ɛgzampul
present	gi
preserve	kip
president	prɛsidɛnt
press	prɛs
pressure	prɛshɔ
pretend	mek lɛk
pretty	fayn
prevent	stɔp
previous	bifo
prey	tin fɔ kech
price	prays
pride	prawd
priest	prist
primary	fɔs
prime	impɔtant
princess	kiŋ in gal pikin
principal	men
prior	bifo
priority	fɔs
prison	jel
privacy	nɔ lɛt ɛnibɔdi ambɔg
private	sikrit
privilege	ɔnɔ
prize	prayz
probably	sɔntɛm
problem	prɔblɛm
procedure	aw fɔ du sɔntin
proceed	kɔntinyu
process	we
produce	mek
production	mek sɔntin
product	sɔntin
professional	sabi gud gud wan
profession	wok
profile	profayl
profit	prɔfit
profound	rili
progress	go bifo
project	prɔjɛkt
prominent	impɔtant
promise	prɔmis
promote	sɔpɔt
promotion	go bifo
prompt	kwik
prone	kin
pronouns	pronawn dɛn
pronunciation	kɔl di wɔd
proof	pruf
properly	kɔrɛkt
proper	rayt
properties	prɔpati dɛn
property	land
proposal	aks
prospect	chans
prosperity	prɔpati
prosperous	jɛntri
protect	protɛkt
proud	prawd
prove	pruf
provided	bin gi
provide	gi
province	distrikt
provision	tin
puberty	we pikin dɛn bɔdi chenj
public	pɔblik
pull	drɔ
pumpkin	pɔnki
punctual	kam pan tɛm
pupil	studɛnt
purchase	bay
pure	klin
purple	pɔrpul
purpose	plan
purse	an bag
pursue	rɔnata
pursuit	rɔnata
push	push
put	put
qualification	fit fɔ du sɔntin
quality	kwaliti
quantity	ɔmɔs
quarantine	kɔrɔnti
quarrel	agyu
quarter	fɔ ɛvri fɔ tin dɛn we yu kɔnt na wan lɛf
Quechua	Quechua
queen	kwin
queer	strenj
query	kwɛstyɔn
question	kwɛstyɔn
queue	kyu
quick	kwik
quickly	fas fas
quiet	kwayɛt
quilt	kɔba
quite	plɛnti
quit	lɛf
quiz	tɛst
quotation	tɔk
quotes	tɔk dɛn
quote	tɔk
rabbit	rabit
race	res
rage	rili vɛks
rain	ren
raised	dɔn es
raise	mɛn
random	jɔs apin
ran	dɔn rɔn
range	te
rapid	kwik kwik
rapidly	kwik kwik
rare	at fɔ si
rarely	at fɔ si
rash	kraw kraw
rat	arata
rate	ɔmɔs
rather	bifo dat
rational	kɔrɛkt
ratio	reshio
raw	nɔ kuk
reached	dɔn rich
reach	rich
reaction	we aw pɔsin biev
reading	ridin
read	rid
ready	rɛdi
reality	rial
realized	dɔn kam fɔ no
realize	kam fɔ no
really	rili
real	rial
rear	mɛn
reasonable	nɔ de pin pan sɔntin
reason	rizin
re	bak
recall	mɛmba
receipt	pepa
received	bin gɛt
receive	gɛt
recently	dis biɛn tɛm
recent	nɔ tu te
reception	risɛpshɔn
recipe	aw fɔ kuk
reckless	wayl
recognition	no
recognize	no
recommend	advays
recommended	dɔn advays
record	rɛkɔd
recover	wɛl
recovery	fɔ wɛl
rectangle	bɔks
redeem	sev
redemption	fɔ sev
red	rɛd
reduce	ridyus
redundant	nɔ impɔtant
reference	tɔk bɔt
refer	tɔk bɔt
reflection	tan lɛk
reflect	tink bak
refrain	stɔp
refrigerator	friza
refund	gi bak
refused	nɔ gri
refuse	nɔ gri
regard	bɔt
regarding	bɔt
regardless	ilɛk
regards	bɔt
region	eria
register	rɛjista
regret	rigrɛt
regularly	ɔltɛm
regular	ɔltɛm
reject	avɔyd
related	gɛt fɔ du wit
relate	tɔk
relationship	padi biznɛs
relative	fambul
relatives	famili dɛn
relax	rilaks
released	bin go fri
release	fri
relevant	fɔ du wit
reliable	tru
relief	fil fayn
relieved	bin ɛp
relieve	sɔlv
religion	rilijɔn
religious	rilijɔn
reluctant	nɔ kin want
rely	abop
remain	fɔ kɔntinyu
remaining	de lɛf
remarkable	wɔndaful
remedy	sɔlv
remember	mɛmba
reminder	mɛmba
remind	mɛmba
remote	fa
remove	pul kɔmɔt
render	gi
rent	rɛnt
repair	mek bak
repeat	tɔk bak
replace	pul
reply	ansa
report	ripɔt
represent	tinap fɔ
reputation	gudnem
request	aks
required	fɔ du
require	nid fɔ du
rescue	sev
research	stɔdi
resemble	fiba
resentment	tawa
reservation	sɛt tɛm
reserve	kip
resident	pɔsin na di eria
resign	lɛf
resilience	strɔng
resilient	strɔng
resistance	fɔ avɔyd
resist	avɔyd
resolution	sɔlv
resolve	sɔlv
resort	las tin
resources	prɔpati dɛn
respect	rɛspɛkt
respond	ansa
response	ansa
responsibility	gɛt fɔ du
responsible	ebul fɔ du
restaurant	rɛstɔrant
rest in peace	rɛst in pis
restore	briŋ bak
rest	rɛst
restrict	stɔp
result	rizɔlt
results	rizɔlt dɛn
resume	stat bak
retail	sɛl
retain	kip
retention	kip
retired	lɛf fɔ wok
retreat	go bak
retrieve	sev
return	go bak
revealed	dɔn sho
reveal	sho
revenge	tɔn-dɛt
revenue	mɔni
reverse	chenj
review	rivishɔn
revise	rivishɔn
revision	kɔrɛkt
revolution	chalenj
reward	prayz
rhythm	bit
rib	bon na yu sayd
rice	res
rich	jɛntri
ride	rayd
ridiculous	ful
rid	trowe
right now	naw naw
right	rayt
rigid	strikt
ring	riŋ
rinse	was
riot	tray fɔ tek kɔntrol
rip	chɛr
ripe	rɛdi
rise	go ɔp
risk	denja
rival	chalenj
river	riva
road	rod
roast	ros
robust	strɔng
rock	ston
rod	tik
role	pat
roll	rol
roof	ruf
room	rum
root	rut
rope	rop
rotten	rɔtin
rough	at
roughly	lɛkɛ
round	rawnd
route	rod
routine	plan
row	padul
rubber	rɔba
rubbish	dɔti
rub	rɔb
rude	rud
rug	kapɛt
ruin	pwɛl
ruler	pɔsin we de rul
rule	rul
rules	lɔ dɛn
running	de rɔn
run	rɔn
rural	ɔplayn
rush	rɔn wit spid
sack	bag
sacred	oli
sacrifice	sakrifays
safe flight	sef flay
safe	sef
safety	fɔ sef
sage	plant we sɛnt
said	bin se
sailing	de sel
sail	klos pan bot
sake	sek
salary	pe
sale	sɛl
salmon	fish
salt	sɔl
Same here	sem na ya
same	sem
sample	ɛgzampul
sand	sansan
Sanskrit	Sanskrit
sarcastic	provok
sassy	tɔk bak
sat	bin sidɔm
satisfaction	fɔ satisfay
satisfied	satisfay
satisfying	de satisfay
satisfy	satisfay
Saturday	Satide
sausage	bif
savage	trit bad
save	sev
saw	bin si
say	se
scale	skel
scam	kruk
scarce	at fɔ si
scared	fred
scarf	edtay
scar	mak
scary	fred
scattered	dɔn skata
scene	ples
scenery	fayn say
scent	sɛnt
schedule	mek tɛm
school	skul
science	sayɛns
scientist	sayɛnsman
scientists	sayɛnsman dɛn
scissors	sisɔs
scold	vɛks
scope	ɔmɔs
score	mak
scrap	smɔl
scratch	krach
scream	ala ala
screen	skrin
screw	nel
script	raytin
seal	stamp
search	luk fɔ
season	sizin
seat	sidɔm ples
sea	watasay
second	sɛkɔn
secret	sikrit
section	pat
secure	sef
security	natin nɔ de fɔ fred
seed	sid
seek	luk
seems	tan lɛk
seem	tan lɛk
seen	dɔn si
see	si
see you later	si bak
see you	si yu
see you soon	wi go si bak
see you tomorrow	wi go si tumara
seize	kech
seizure	gɛt fit
seldom	i kin te
select	pik
self healing	mɛn bay insɛf
selfish	tink bɔt yusɛf nɔmɔ
self	sɛf
sell	sɛl
send me your picture	sɛn mi yu pikchɔ
send	sɛn
senior	ol
sense	sɛns
sensible	gɛt sɛns
sensitive	ɔmbul
sent	bin sɛn
sentence	sɛntɛns
sentences	sɛntɛns dɛn
separate	pat
Sepedi	Sɛpɛdi
september	Sɛptɛmba
sequence	ɔda
series	stori dɛn
seriously	siriɔs
serious	siriɔs
serve	sav
service	savis
session	tɛm
set	sɛt
setting	de mek
settle	sɛtul
set up	put
seven	sɛvin
seventeen	sɛvintin
seventy	sɛvinti
several	bɔku
severe	siriɔs
sew	so
shade	kɔba
shadow	shed
shake	shek
shall	fɔ
shallow	lo
shame	shem
shape	shep
share	shɛb
sharp	shap
shed	bafa
sheep	ship
sheet	shit
she has	i gɛt
she	i
she is	i na
shelf	shɛf
shell	shɛl
shelter	ayd
shield	kɔba
shift	chenj
shine	shayn
ship	bot
shipping	de sɛn
shirt	shat
shoes	sus
shoot	shut
shopping	de bay bay
shop	shɔp
shore	land
shortage	bɛtɛ nɔ de
short	shɔt
shot	dɔn shut
shoulder	sholda
should	fɔ
shout	ala
shower	shawa
show me	sho mi
show	sho
shrimp	shrimps
shrink	tan smɔl
sh	sh
shut	lɔk
shut up	sɛt mɔt
shy	shem
sibling	brɔda
siblings	sista dɛn
sick	sik
side	say
sigh	tɔk
sightseeing	visit
sight	si
signature	sayn
significant	impɔtant
sign	sayn
silence	sɛt mɔt
silent	nɔ de tɔk
silk	silk
silly	fɔni
silver	silva
similar	fiba
simp	fulman
simple	simpul
simultaneously	sem tɛm
since	frɔm
sincere	kɔmɔt na di at
sincerely	wit yu at
singer	pɔsin we de siŋ
single	nɔ mared
sing	siŋ
sink	sink
Sir	sa
sister in law	sistaɛnlɔ
sister	sista
site	ples
sit	sidɔm
situation	we aw tin bi naw
six	siks
sixteen	sikstin
sixty	siksti
size	sayz
skill	skil
skills	skil dɛn
skin	kanda
skinny	dray
skip	jɔmp
skirt	skat
sky	skay
slave	slev
sleeping	de slip
sleep	slip
sleepy	fil fɔ slip
sleeve	sliv
slice	pat
slide	sink
slightly	smɔl
slim	dray
slip	slipul
slope	say
slot	spes
slowly	smɔl smɔl
slow	tek tɛm
small	smɔl
smart	gɛt sɛns
smell	smɛl
smile	smayl
smoke	smok
smooth	fayn
snack	chamcham
snail	snel
snake	snek
snap	snap
snow	sno
soak	sok
soap	sop
sober	soba
soccer	futbɔl
social	soshal
society	sosayti
socks	sɔks
so cute	rili fayn
so far	naw
soft	saf
software	kɔmpyuta program
soil	dɔti
sold	dɔn sɛl
soldier	sojaman
sold out	dɔn sɛl am dɔn
sole	nɔmɔ
solid	strɔng
solution	fɔ sɔlv
solve	sɔlv
somebody	sɔmbɔdi
somehow	sɔntɛm
someone	sɔmbɔdi
some	sɔm
something	sɔntin
sometimes	sɔntɛm
song	siŋ
soon	nɔ go te
sophisticated	wɔndaful
Sorani	Sorani
sore	bwɛl
sore throat	trot de at
sorrow	trɔbul
Sorry	Sɔri
sort	kayn
so	so
sought	bin aks
soulmate	bɛst padi
soul	sol
sound	sawnd
soup	sup
source	usay i kɔmɔt
sour	sawa
south	sawt
space	spes
spam	spam
Spanish	Spanish
span	tɛm
spare	sev
speak	tɔk
special	spɛshal
species	kayn
specific	patikyula
spectacular	spɛshal
speechless	wan we nɔ ebul tɔk
speech	tɔk
speed	fas fas
spell	spɛl
spend	spɛn
spent	dɔn spɛn
spicy	bɔku pɛpɛ
spike	go ɔp
spinach	grin
spin	tɔn rawnd
spirit	spirit
spit	pit
splendid	wɔndaful
split	sheb to tu
spoiled	dɔn pwɛl
spoil	pwɛl
spontaneous	nɔ plan am
spoon	spun
spot	ples
spouse	man ɔ wɛf
spread	prɛd
spring	kɔmɔt
square	skwaya
squeeze	kwis
squid	skwid
squirrel	skwirɛl
stab	chuk
stable	stɛdi
stack	pak
staff	wokman
stage	stej
stain	sten
stairs	stɛp dɛn
stake	bɛt
stalk	tres
stall	westɛm
stamp	stamp
standard	advays
stand	tinap
star	sta
started	bin stat
start	stat
starving	angri we kil
statement	wɔd
state	stet
station	steshɔn
statue	statyu
status	pozishɔn
stay safe	tek tɛm
stay	ste
steady	nɔ fɔdɔm
steak	bif
steal	tif
steam	stim
steel	ayɛn
steep	ay
stem	branch
step	fut mak
stick	stik
stiff	strikt
still	stil
sting	bɛt
stingy	krabit
stir	miks
stock	tin we wi invɛst pan
stolen	dɔn tif
stomach	bɛlɛ
stone	ston
stood	dɔn tinap
stool	sidɔm ples
stop	lɛf
storage	usay fɔ kip
store	kip
storm	bad bad briz
story	stori
stove	kuktɔp
straightforward	tɛl di tru
straight	tret
strain	shifta
stranger	strenja
strange	strenj
strategy	plan
strawberry	strabɛri
straw	gras
streak	layn
stream	strim
street	strit
strength	trɛnk
stress	strɛs
stretch	strɛch
strict	strikt
strike	protɛst
string	rop
strip	pul
strive	tray
stroke	strok
strong	strɔng
struck	bin apin
structure	bildin
struggle	nɔ izi
struggling	wok tranga wan
st	sɛnt
stubborn	trangayɛs
stuck	fasin
student	studɛnt
studying	de stɔdi
study	stɔdi
stuff	tin
stunning	sɔprayz
stupid	ful
style	stayl
subject	tɔpik
submission	gri fɔ obe
submit	rɛdi fɔ de ɔnda
substance	drɔg
substitute	pul
subtle	kɔni kɔni
succeed	go bifo
successful	fɔ go bifo
success	go bifo
such as	lɛk
such	kayn
suck	sɔk
suddenly	wantɛm wantɛm
sudden	wantɛm wantɛm
suffering	de sɔfa
suffer	sɔfa
sufficient	i du
sugar	suga
suggestion	advays
suggest	tɔk
suitable	fayn
suitcase	bɔks
suit	klos
summary	ɛksplen
summer	sɔma
summit	mitin
sum	nɔmba
sunday	Sɔnde
sunny	san
sun	san
sunset	we di san dɔn go dɔŋ
sunshine	san de shayn
superior	big pas
supervisor	maneja
super	wɔndaful
supper	ivintɛm it
supply	gi
support	sɔpɔt
supposed	fɔ
suppose	lɛ wi se
sure	shɔ
surface	sho
surge	go ɔp
surgery	ɔpreshɔn
surname	las nem
surprised	dɔn sɔprayz
surprise	sɔprayz
surrender	sɔrɛnda
surrounding	wetin de rawnd
surveillance	wach
survey	ripɔt
survive	sev
suspect	tink se
suspended	stɔp
suspicious	dawt
sustainability	kɔntinyu fɔ sɔpɔt
sustainable	kɔntinyu fɔ sɔpɔt
sustain	sɔpɔt
swag	stayl
swallow	swɛla
swap	chenj
swear	swɛ
sweater	swɛta
sweat	swɛt
sweep	swip
sweet dreams	swit drim dɛn
sweetheart	switat
sweet	swit
sweet tooth	swit mɔt
swelling	de swɛl
swell	swɛl
swimming	de swin
swim	swin
swing	chenj
switch	chenj
swollen	swɛl
sword	sɔd
symbol	sayn
sympathy	sɔri fɔ
symptoms	sayn dɛn
system	sistɛm
table	tebul
tackle	du
tag	pent
tail	tel
take away	kɛr go
take care	tek kia
taken	dɔn tek
take off	pul
take	tek
talkative	tɔk bɔku
talk	tɔk
tall	tɔl
tape	tep
tap	tap
target	tagɛt
task	wok
taste	tes
tasty	tes fayn
taught	bin tich
teacher	ticha
teach	tich
team	tim
tear	kray wata
tears	kray wata
tease	provok
tea	ti
technology	tɛknɔlogi
teeth	tit
tell me	tɛl mi
tell	tɛl
temperature	tɛmprɛchɔ
temper	karakta
temple	tɛmpul
temporary	nɔ go te
tenant	pɔsin we rɛnt
tend	abit
tendency	abit
tender	kia
tense	strɛs
tension	prɔblɛm
tentative	nɔ sɛtul
ten	tɛn
ten thousand	tɛn tawzin
tent	tɛnt
terms	wɔd dɛn
term	wɔd
terrible	bad
terrific	wɔndaful
territory	tɛritri
test	tɛst
text	tɛks
Thanks for using our app	tɛnki we yu yuz wi ap
thanks	tɛnki
thank	tɛnki
Thank you for your patience while we investigate shipment	Tɛnki we yu peshɛnt fɔ lɛ wi chɛk di ship in lod
thank you so much	plɛnti tɛnki
thank you	tɛnki
thank you very much	bɔku bɔku tɛnki
than	pas
that	dat
that is	dat na
that's good	dat na gud
the	di
theft	tif
their	dɛn
them	dɛn
theme	tim
themselves	dɛnsɛf
then	dɔn
theory	wetin pɔsin tink
there	de
therefore	dat mek
there is	de na
these	dɛn wan ya
they are	dɛn na
they	dɛn
thick	tik
thief	tifman
thigh	fut
things	tin dɛn
thing	tin
think	tink
thin	stret kɔt
third	tɔd
thirsty	tɔsti
thirteen	tɔtin
thirty	tati
this	dis
this is	dis na
thorough	kpatakpata
thoroughly	gud gud wan
those	dɛn wan dɛn
though	pan ɔl
thoughtful	du fayn tin
thoughts	tink
thought	tink
thousand	tawzin
thread	trɛd
threaten	trɛtin
threat	trɛtin
three	tri
threshold	domɔt
thrilled	gladi pasmak
thrive	go bifo
throat	trot
throughout	te
through	pas
throw	sɛn am
thumb	big finga
thunder	tɛnda krak
Thursday	Tɔsde
thus	so
tick	tik
tide	tayd
tidy	klin
tie	tay
tiger	tayga
tight	tayt
Tigrinya	Tigrinya
time	tɛm
timid	shem
tiny	smɔl smɔl
tip	ɛp
tips	advays dɛn
tired	taya
tire	taya
tissue	ɛnkicha
title	taytul
toast	tost
to be	bi
today	tide
toddler	bebi we jɔs bigin waka
toes	to dɛn
together	togɛda
toilet	tɔylɛt
told	dɔn tɛl
tolerance	fɔ alaw
tolerate	alaw
tomato	tamatis
tomorrow	tumara
tongue	tɔng
tonight	dis nɛt
took	bin tek
tools	tul dɛn
tool	tul
too	sɛf
tooth	tit
topic	tɔpik
top	ɔp
torn	chɛr
torture	sɔfa
total	ɔl
to	to
touch	tɔch
tough	tranga
tour	visit
towards	to
toward	to
towel	tawɛl
town	tɔŋ
toxic	pɔyzin
trace	stɔdi
track	rod
trade	bay ɛn sɛl
traditional	kɔstɔm
tradition	kɔstɔm
traffic	trafik
trail	rod
training	trenin
train	tren
trait	kwaliti
traits	abit dɛn
transfer	transfa
transition	chenj
translate	translet
transparent	klia
transportation	transpɔt
transport	transpɔt
trap	trap
trash	dɔti
trauma	shɔk
travel	travul
tray	tre
treasure	valyu tin dɛn
treatment	tritmɛnt
treat	trit
tree	tik
tremendous	wɔndaful
trend	abit
trial	prɔblɛm
trick	kɔni kɔni
tried	dɔn tray
trigger	stat
trim	kɔt
trip	travul
trouble	plaba
trousers	trɔsis
truck	trɔk
true	tru
trunk	trɔnk
trust	abop
truth	trut
try	tray
Tsonga	Tsonga
tube	tyub
Tuesday	Tyusde
tuition	skulfi
turkey	tɔki
turmeric	yala magi
turn	tɔn
turtle	trɔki
tutor	ticha
twelve	twɛlv
twenty-one	twɛnti-wan
twenty	twɛnti
twice	tu tɛm
twist	bɛn-bɛn
Twi	Twi
two	tu
type	kayn
typical	nɔmal
ugly	wowo
ultimate	kpatakpata
umbrella	ɔmbrɛla
unable	nɔ ebul
uncle	ɔnkul
unconscious	nɔ no natin
underneath	ɔnda
under	ɔnda
underrated	tɛkɛ
understand	ɔndastand
understood	dɔn ɔndastand
unfortunately	i sɔri fɔ no se
uniform	yunifɔm
unique	in tu nɔ de
unit	pat
university	yunivasiti
unknown	nɔ no
unless	nɔ gɛt wan valyu
until	te
unusual	strenj
update	chenj
upgrade	go bifo
up	ɔp
upset	vɛks
up to you	lɛf to yu
urban	siti
urgent	nɔ westɛm
urge	push
used	dɔn yuz
useful	de ɛp
useless	nɔ gɛt wan valyu
use	yuz
usually	kin
usual	nɔmal
us	wi
utility	sɔntin wi nid
vacation	ɔlide
vaccination	maklet
vaccine	maklet
vacuum	swip
vague	nɔ klia
valid	rayt
valley	vali
valuable	valyu
value	valyu
variety	difrɛn
various	difrɛn difrɛn
vary	difrɛn
vase	flawa pɔt
vast	big
vegetable	plant fɔ it
vegetables	plant dɛn
vehicle	motoka
vendor	pɔsin we de sɛl
venom	pɔyzin
venture	prɔjɛkt
venue	ples
verify	chɛk
versatile	rɛdi fɔ chenj
version	dis wan
vertical	ɔp ɛn dɔŋ
very good	rili gud
very	rili
vessel	bot
via	bay
vibe	filin
vibes	filin
vicious	wayl
victim	sɔfa
video	fim
view	wetin yu tink
village	vilɛj
villain	bad pɔsin
vinegar	sɔntin we sawa
vintage	ol
violence	kuskas
violent	fɛt-fɛt
viral	kɛr sik
virgin	vajin
virtual	frɔm kɔmpyuta
virtue	kwaliti
vision	si
visit	visit
visual	si
vital	impɔtant
vivid	klia
vocabulary	difrɛn wɔd dɛn
voice	vɔys
void	lɔs
volume	ɔmɔs
volunteer	kam fɔ ɛp
vomit	vɔmit
vulnerable	nɔ gɛt pɔsin fɔ ɛp am
wage	pe
wages	pe
waist	wes
waiter	weta
waiting	wet
wait	wet
wake up	wek
wake	wek
walking	de waka
walk	waka
wallet	wɔlɛt
wall	wɔl
wander	waka waka
wanna	want
wanted	bin want
want	want
wardrobe	wadrob
warehouse	sto rum
warm	wam
warning	wɔnin
warn	wɔn
warrior	fɛtman
war	wɔ
was	bin
wash	was
waste	west
watch	wach
watermelon	watamɛlon
water	wata
wave	wev
way	we
weakness	wik
weak	wik
wealth	jɛntri
wealthy	jɛntri
we are	wi na
wearing	de wɛr
wear	wɛr
weather	wɛda
we can	wi kin
wedding	mared
Wednesday	Wɛnsde
weed	gras
weekend	wikɛnd
week	wik
weight	we
weird	strenj
welcome	wɛlkɔm
welfare	tin dɛn we fɔ mek wi gladi
well done	wɛl dɔn
Well	wɛl
went	bin go
were	bin
west	wɛst
wet	sok
we	wi
whale	wel
what about you	we yu
what are you doing now	wetin yu de du naw
what are you doing right now	wetin yu de du jɔs jɔs naw
what are you doing	wetin yu de du
what do you do for a living	wetin yu de du fɔ wok
what do you do	wetin yu de du
what do you mean	wetin yu min
what do you want	wetin yu want
whatever	ilɛk
what happened	wetin apin
what is this	wetin dis
what is	wetin na
what is your job	uskayn wok yu de du
what is your name	wetin na yu nem
what's up	wetin na di nyus
what's your name	wetin na yu nem
what	wetin
wheat	wit
wheel	taya
whenever	ɛnitɛm
when	ustɛm
where are you from	usay yu kɔmɔt
where are you now	usay yu de naw
where are you	usay yu de
whereas	semweso
where do you live	usay yu de
where is	usay
where	usay
whether	ilɛksɛf
which	us
while	we
whisper	tɔk saful wan
whistle	wistul
white	wayt
who are you	udat na yu
who is this	na udat
who is	udat na
whole	wan ol
whom	udat
whose	udat
who	udat
why not	yu nɔ tink
why	wetin du
wicked	wikɛd
wide	big
widow	uman we in man dɔn day
width	wayd
wife	wɛf
wild	wayl
will	go
willing	rɛdi
wind	briz
window	winda
windy	briz de blo
wine	wayn
winter	kol wɛda
win	win
wipe	wep
wire	kebul
wisdom	sɛns
wise	sɛns
wish	want
wish you all the best	wish yu ɔl di bɛst
witch	wich
withdrawal	kɔmɔt
withdraw	pul an pan
within	insay
without	nɔ
with	wit
witness	witnɛs
witty	fɔni
wolf	wulf
woman	uman
women	uman dɛn
wonderful	wɔndaful
wonder	wanda
won	dɔn win
won't	nɔ go
wood	wud
wool	wul
words	wɔd dɛn
word	wɔd
working	wokin
work out	ɛksasayz
work	wok
world	wɔl
worm	tumbu
worn	pwɛl
worried	bin wɔri
worry	wɔri
worse	wɔs
worship	wɔship
worst	wɔs
worth it	nɔ fɔ natin
worth	valyu
worthy	fit
would	go
wound	wund
Wow	Eh
wrap	rap
wrath	vɛks
wrist	an
Write here	rayt na ya
write	rayt
writing	raytin
written	dɔn rayt
wrong	rɔng
wrote	dɔn rayt
yard	gadin
yawn	yawn
Yeah	Yɛs
year	ia
years	ia dɛn
yeast	yist
yell	ala
yellow	yala
yes baby	yɛs bebi
yes dear	yɛs dalin
yes honey	yɛs dalin
yes my love	yɛs, mi lɔv
yes of course	yɛs, na tru
yesterday	yɛstide
Yes	Yɛs
yet	stil
yield	gri
you are beautiful	yu fayn o
you are so beautiful	yu rili fayn
you are welcome	yu wɛlkɔm
you are	yu na
you can	yu kin
You know	yu no
young	yɔŋ
you're welcome	yu wɛlkɔm
you’re welcome	yu wɛlkɔm
yourself	yusɛf
your welcome	yu wɛlkɔm
your	yu
youth	yɔŋ
you too	yu bak
you	yu
yummy	swit
zero	ziro
