a	Jun
a little	chi'n
a lot	nintz'
a lot of	ch´uq
a lot of	k´loj
abandon	oqb´il
abandon	k´olil
abandon	kolil
abandoned	ko´lin
abide	ma b´nchet
ability	junpaqx
able	kab´ale
about	naqaku tkitz
above	jawl
abroad	mya toj q-tx´otx´
absence	nti'
absent	mixti
absolutely	iktzen
absorb	tz'ub'il
abstract	abstracto
absurd	xnak
abundance	nimxix
abundant	nimxix
abuse	ma tz'ok il
accent	yol
accept	k´amol
access	oktzil
access	okx
accident	k´ixb´len
accommodation	ja taye q-ja
accomplish	t´un tpon b´aj
accomplished	ma b'ent
according	tzenku ló
account	tjlala tuj k'upwaq
account	tajlal k'u'npwaq
accuracy	tzeʼnx
accurate	axexje
accused	ma kux b'ajsan
ache	ky´ixk´oj
ache	ky´ixk´aj
achieve	k'anb'et
achievement	ma b´ent
acknowledge	niky'tzil
acquaintance	tzqi´n
acquire	t-tzyet
acquired	etzil
acquisition	adquisicion
across	tuj
across	tu
act	n-b´ajte
action	n-b´ant
active	itz'
activities	aq'untl
activity	aju at toklen
actor	jun xjal in netz toj televisión
actual	jaala
actually	jane
acute	netz'
adapt	naq'et
add	tz'aqsil
addicted	naqʼete tiʼj
addition	tzuyet
addition	yoq'ol
addition	slapat
additional	junjutl
address	tja q´amal b´e
address	janejenel
adequate	b´ant tun txiye
adjacent	alojxa
adjective	ka´yinb´ib´aj
adjust	tz´aqol
adjust	tz´aqet
adjust	tz´aqtzil
admire	n-xi q-kayen wen
admit	tziyet
adorable	ponex t-kayb´ajtz
advance	ja ma qo kanen
advanced	ma nej
advantage	a b´a´n
adventure	niky´b´ajil
adverb	K´tzpyol
advertisement	qmal t-pakb´al
advertising	chik'b'al
advice	nab´l
advice	nab´il
advise	nab'il
advocate	k'olil
aesthetic	ponex kayen
affair	ajpaj
affect	q´on mal
affection	laq'il
afford	tzaqpaj
affordable	asequble
afraid	xob´el
after	Texlena
afternoon	q'ale
afterwards	yajxa
afterwards	yajxtil
again	ju majt
against	ti´j
age	jte tanq´ib´la
agency	ja qʼol tqanil
agent	jun xjal
aggressive	tx´uj
agile	ojqel
ago	tijxi
agree	kuyil
agree	k´uyil
agree	k´amol
agreement	ik tzeʼn otoq
agriculture	naqʼunan tiʼj txʼotxʼ
ahead	tnejil
ahead	nejil
ahead	nejne
aid	onil
aim	tz´ib´il
aim	xolte
air	kyq´iq´
aisle	twitz ja
alarm	k'asb'il
alcohol	q´en
alert	xqʼuqink tibʼa
alive	chwiqlal
all	tkyaqil
all right	b´a´n
all the best	ky'iwb'il
allow	kuyil
allowed	a xq´mante
almost	noq ch´intl
alone	tjunilx
along	tib´ajxe lu´n
already	matxi
Alright	b´an
also	ikx
alternative	juntl lu´n
although	q'unpitz'un
always	axju
am	ayine
amazing	ponex wen
ambiguous	nya axixtok
ambition	tajbʼil tuʼn tbʼant tuʼn
ambitious	xjal taj txqan puaq
amend	saman
amid	kyxol
among	kyxol
among us	kyxol
amount	jte tq´anil
amusing	tze'
an	jun
analysis	chikʼbʼabʼil
ancestors	qcham
anchor	tzyubʼil bar
ancient	ojtxax
and	ex
and you	yaj tzun ta
angel	talsanjil
angel	sanjil
anger	tx'ujil
angle	xky'ch jiqin
angry	jawna
angry	xk´oy
angry	xkyaq
animal	tx´kup
ankle	n-a
anniversary	q´ijlal
announcement	qm'al
annoy	tx´u´jil
annoy	q´oj
annoyed	tx'ujin
annoying	shch´il
annual	junjun ab´q´i
anonymous	ewitib´
another	juntl
answer	tzaq´wel
answer	tz´aq´wel
anticipate	qmaxpina
anxiety	lipen qanb´el
anxious	lipel
any	a´lchaqxtz
any	tichaqx
anymore	q'otz
anyone	el qex
anything	ti xku
anyway	tzenculaj
anyways	maske ikju
apart	junxitl
apartment	nimtnam
apologize	chin tnajsama
apparent	ikytaqjo
apparently	t-kayb´ajtz
appeal	n-tza t-b´isen
appear	kanetil
appearance	t-kayb´ajtz
appeared	ma knet
appetite	q'q'in
apple	tz´ib´q´ob´
application	q'anilte
apply	b´inchil
appointment	amb´el te kayel
appreciate	toklen
appreciation	la´qil
approach	txi lipey
appropriate	wen
approval	tzaq'wel
approve	tzaq´wel
approved	ma kutzb'il
approximately	ch´ime
april	tkyaxjaw
arbitrary	mya tzʼaqlxix
architect	ajtzqilximb´inch
architecture	tzqib´ximb´inch
archive	xk´u´b´il
are	Eye
are you	aya
are you busy	tla amb´il ti ja
are you married	mejeb'niya
are you married or single	mejeb´niya maqa nya
Are you still there?	a tixa atzu
are you there	atz´ taya
area	jun pedaz tx´otx´
argue	q-yol
argument	q-yol
arise	itz'jin
arm	q´ab´aj
army	k'loj xjal
around	tijxe
arrange	b'nchet
arrange	b'inchal
arrangement	tziyb'il
arrival	ma ul
arrive	e´li
arrive	e´lil
arrive	pol
arrived	chin pone
arrogant	jun xjal kuj yolen
arrow	smaj
art	ilb'ilal
article	jun lu´n
artificial	mya atumel
artist	ajkye´x
as	s´e´n
as long as	toj chʼin ambʼil
as well	ikx
as well as	s'en tzun
ash	tza´j
ashamed	tx'ixow'
ask	xjelil
asked	ma tzaj xjelin
asleep	wtan
aspect	t-kayb´ajtz
Assamese	Assamese
assault	b'uchil
assembly	ch'uqxjal
assess	niky´xjelil
assessment	xjelb´il
assessment	niky´xjel
asset	itz'
assets	at
assign	jask'ul
assignment	taq´in
assignment	aq´untl
assist	xel
assistant	ajtz'ib'
associated	junjun
association	k'loj
assume	tun txi q-b´isen
assumption	kubʼ kyximen
at	toj
at least	extzen
ate	ma wa'na
athlete	jun xja'l
attach	b'uyil
attached	tok ti´j
attachment	b'uyil
attack	yoqpet
attempt	b'inchaxtla
attend	kayinxa
attendance	at
attention	nak´b´il
attitude	t-kayb´ajtze
attract	juk'il
attraction	nga'ne
attractive	ponex
attribute	jun bʼaʼn
audience	jun audiencia
august	twaxjaw
aunt	kyan
aunty	ixman
author	a b´inchelte
authority	oklen
autumn	q'ulq'ijil
available	amb´il
average	kyxol
avoid	nanxitb´inchana
awake	i'tz'
award	chojb'al
aware	n-xi b´iset
awareness	tanb´ele
away	chaq
awesome	ponex
awful	qo tza xob´x
awkward	alkayela
Aymara	Aymara
baby	nex
bachelor	bachiller
back	tijxi
background	txe
bad	taq´wix
bag	ch'u'x
bag	ch'ux
bait	seb´
bake	tz'i'lsb'il
bake	womsb'il
bake	wonsb'il
bakery	k´ayb´il xb´ukwa
balance	jte´
ball	xpotz
ball	xpo´tz
ball	xtul
Bambara	Bambara
banana	lob'aj
band	b'yuj
bang	ky´ixb´aj
bank	k'ulb'il pwaq
bar	k'a'yb'il
barely	penex
bargain	suqb´in
bark	ch´iyin tx´wan
barley	sapalut
barrier	maqb´il
base	tyajil
based	ttzaj
basement	kub'ni
basic	basico
bastard	oik'o'l
batch	iky'
bath	tz´alb´il
bathroom	tz'alb'il
battery	bateriy
battle	nya bʼaʼn.
bay	kytzi aʼ
be	xilen
be	a
be careful	kayix tumila
beach	Tziya´
beam	b'inchal
beans	chenaq´
bear	nikx
beard	xmatz´ib´aj
beast	chej
beat	ma b´aj tq´ij
beautiful	ponix
beauty	achb´ajil
became	qjal b'ian
because	Q´un
because	tu´nj
become	ma ja byan
bed	koxb´il
bed	kuxb´il
bedroom	wuatb'l
bee	onin
beef	chib'j te wakx
been	s'e'n tz'un taya
beer	k´wab´aj tzeky´
before	ojxi´
before	na´mxtaq
began	ma txi' qe
begin	qetsal
beginning	qeb´il
beginning	qe´
beginning	laqet
behalf	tb'anel jaku
behave	qximbʼetz
behavior	tzen n-oke tu´n kywutz xjal
behaviour	tbʼanel qmod
behind	Ttza´ltij
behind	ti´jxa
behind	ti´jxi
being	xilen
being	a
belief	okslal
believe	okslal
belly	t-tz'on
belong	ja n-xi q-b´isen ja otoye
beloved	xb'oj
below	kub´l
belt	k'uj
bench	k´ulb´il pwaq
bend	pajtzul
beneath	tjaq´
benefit	n-tza on qe tzen n-xi q-b´inchen jun lu´n
benefits	onb'il
beside	tx-laj
besides	tok t-k´atz
best	b´antyil
best of luck	tb'anel junju
best regards	k´olb´el
better	b´antyil
between	xol
between	kyxol
beverage	k'wab'aj
beyond	mastz´u´n ch´ix
Bhojpuri	Bhojpuri
bias	tze´n n-xi txalene
biased	laqil
bicycle	chejqanb'il
big	nimin
big	nmaq
big	ma´
bike	chejqanb'il
bill	lu´n tun tokx q-chjon
bind	mojb'al
bird	pich
birthday	ab'qi
bit	ch'i'n
bite	xjak'al
bite	tx'a'l
bite	xjak'il
bitter	k´a´
black	q'aq
black	q'eq
blade	qesb'il
blame	tpaja
blame	pajb'al
blank	saq´
blanket	q-chamar
blast	poq'j
blend	simol
blend	smol
bless	k´i´wil
blessed	ky´iwlal
blessed	ky´i´wlal
blessed	k´i´wil
blind	mox
bliss	k'iwlab'il
block	jpul
blood	chiky´
blood	chik´el
bloom	b´echil
blow	n-el poq´le
blue	xq'ilin
blunt	jun lu´n desafilado
board	mujb´el
boat	mak´ox
body	xmilalb'aj
boil	loq'lol
bold	q´aq
bond	tkʼujlabʼil
bone	b'aq
book	uj
boost	matijset
booster	mojel
boot	chunxjab´
boots	chunxjab´
border	tx´an b´e
bore	uljil
bored	q-watl
boring	ky´aj
boring	altwinqal
born	itz´jil
borrow	qmajin
boss	nejenil
both	k´ab´íl
bother	iplaj
bottle	lmet
bottom	kub´il
bottom	tjaq´
bought	ma loq´in
bounce	lipel
bound	tzyu´n
boundaries	tiʼchaq mitiʼ
bow	tokixpo'tz
bowl	tk´wel
box	kax
boy	q´a
boyfriend	xmoxil
bracelet	ti q'ob'aj
brain	xoqxi´n
brain	jolin
brain	jolon
branch	jun t-q´ob´
brand	techel
brave	tx´u´jil
breach	mi xpon b'aj
bread	twamo´s
bread	xb´ukwa
bread	tx´i´l
break	laqil
breakfast	wa'l
breast	mix
breath	xew
breathe	xewaj
breathe	xewb'aj
breed	ch´iysal
breed	a´lal
brick	xkyaqloq´
bride	xmoxb'il
bridge	q´a´jan
bridge	q´anjin
bridge	q´a´j
brief	ch'inin
bright	qopb'l
brilliant	qoqb'il
bring	q´intza
bro	tx'ibin
broad	nim toj
broadcast	yek'il
broadcast	q'olte
broke	ma laq
broken	xlaq
broom	tz´isb´il
brother	itz´inb´aj
brother	atzikyb´aj
brother	xib´aj
brother in law	b´alak
brother in law	b´aluk
brought	aq´untl
brought	aq´un
brush	tx'ajil b'aq'
bucket	tb'el
buddy	tuk´il
buddy	xkomp´it
buddy	t-xb´oj
budget	jte t-wi´
bug	ma chi qe tzaqje
build	txakb´et
build	b´inchil
building	nimja
building	wa´linja
built	ma b'inchet
bulk	iqtz
bull	wakx
bully	b'iyol xjal
bump	iqtz
bunch	ktxij
bundle	b'laq'
burden	Iqal
burden	isq'ul
burden	iqil
buried	mq'un
burn	patil
burst	ma tzel poq´j
bury	maqul
bury	muqil
bus	k'uxb'il
bush	txu'l
business	k´ax
bust	t-jaq´ t-qule
busy	tla amb´il
but	me
butter	txamanil
butterfly	pak'il
button	natob'
buy	loq´al
buy	laq´ol
buy	loq´il
by	ch´ine
by	ch´ini
by	ch´inrtz´
by the way	naq' sik'wal
bye	wexa
cabbage	kolx
cabbage	kulix
cabinet	kax
cage	tja txkup
cake	pastel
calf	notz'
call	yolb´ilte
call me	ch´in tyolb´tza
called	k'alil
called	txokil
called	txakol
calm	chewsil
came	ul
came	ma tzul
can	jaku
can	ja
can	b´antel
can't	lay b´ent
Cancel	layt
Cancel	okxju
cancer	q'ayab'il
capable	b´an
capacity	b´an tu´n
caption	nim yol
capture	ma tz'yet
car	carro
career	oqe´lan
career	oqelb´aj
career	oqelbp´il
careful	cheb´e taj
carefully	chab'a
careless	xi k'ayin
caring	tk'ujlab'il
carpenter	ajtze´
carpet	b'etb'il
carrot	maman
carrot	q'anitzaj
carrot	q'anjil
carry	q´inxa
carry on	lejet
carry out	b'inchal
case	ja n-chi ku´xe lu´n
cash	pwaq
cast	aye elenco kye xjal
castle	ja
casual	junjen q´ij
cat	wix
catch	tzuyil
catch	tzyul
category	ch'uq
cattle	alimil
caught	ma tz´yet
cause	tu´n
caution	k´ayinxa
cautious	kayil tumil
cave	jul
cease	okx
ceiling	yek´b´itz
celebrate	iky´sab´itz
celebrate	iky´saj q´ij
cell	tnitx'il k'ul
center	tmij
center	niky´aj
century	jok'al ab'qe
cereal	wabʼj
ceremony	yuxhil
certain	junjen
certainly	ex iktzen wen
certificate	uʼj
chain	aq'il
chair	q'uqb'il
chair	q'a'jtz
chance	anb´il
change	tx´exb´il
chaos	i´l
character	t-kayb´ajtz
characteristics	kymod
charge	iqatz
charity	mojel
charming	tzalaje
chart	techel
chase	lajol
chat	lajil
cheap	miya´wi´yal
cheat	sb´ul
cheating	yolin t-xuʼjil tukʼil junt
check	xq´uqil
cheek	txaq'tzi'
cheer	tzalajb´il
cheerful	tzalajsb'il
cheerful	ntzalaj
cheers	b´a´n
cheers	chwiqlal
cheese	kyes
chemistry	b´inchel q´anb´el
cherish	laq´il
chest	qanb´el
chew	tx'a'l
chew	k'xul
chew	b'e'l
chicken	eky'
chicken	txuxu'l
chief	tejil
child	kw´al
childhood	k'walil
children	k'wal
chill	chew
chimneys	ob'aq
chin	xpetz
chocolate	tz´ub´aj kyikyiw
choice	sk´ob´il
choose	sk´ol
chop	ch´yon
chores	tun tku q-b´inchen
chubby	q'es
church	tja manb´aj
cinnamon	canel
circle	se´w
circumstances	aye lu´n n-chi b´ajte
citizen	ajchojil
city	tnam
claim	qanixa
claim	xjelinxa
clarify	spiky'eb'il
class	t-clase
clay	ch'ax tx'o'tx'
clean	saq
clean	sjanin
clean	xnul
clear	b´a´n
clerk	ajtz'ib'
clever	b´a´n b´isen wen
client	loq'il
cliff	xaq
climate	na´ltx´otx´
climb	q-jay
clingy	q'lak'
clingy	ch'aq'
clock	ajlab´il amb´il
close	miltz´ul
close	jpul
close	lamol
closet	k´ub´b´il
cloth	b´u´x
clothes	ijb´aj
cloud	muj
cloudy	at muj
clown	payas
clue	kol
clumsy	mib´e tu´n
cluster	chmoj xjal
coach	xjal yek´el
coal	txan q'a'l
coast	mlaj
coat	q-sueter
coffee	k´ape
cognitive	cognitivo
coincidence	kanet
cold	chew
collapse	ma ku yutx´j
collar	qul
colleague	tuk´il
colleague	xkomp´it
colleague	t-xb´oj
colleagues	t-xb'oj
collect	b´uyil
collection	b'uyil
college	xkomp´it
color	tk'wa'
colorless green ideas slept furiously	chin laqe tin txuye
colour	tk´wa´
column	tb'aqil ttzal i'jb'aj
comb	xweb'
combination	mojb'al
combine	junx
come	tzaja
come	we tzaja
come here	tzaja tzala
come on	q'oya
comfort	pon tkʼuʼj
comfortable	b´a´n
coming	juntl
coming soon	chixtil
command	chq'ol
comment	xim yol
commercial	k´ayb´il
commission	taqʼun
commit	comprometerse
commitment	jtoj tun tu´le
committed	comprometido
commodity	k´ax
common	axu
communicate	q´umol
communication	yolil
community	tnam
commute	kal
companion	txkompi't
compare	loq´al
compare	loq´il
comparison	mojb'et
compassion	qʼaqʼbʼil qkʼuʼj
compassionate	qʼaqʼin tkʼuʼj
compatible	ikq´ex
competent	kbʼantel tten
competition	b'a'nxnaq'tz
competitive	mas bʼaʼn
complain	b´ajsal
complaint	tyol tiʼj juntl
complement	tmoj
complete	Tz´aqali
complete	Tz´aqli
completely	akax
complex	cuest
compliance	tze'l twitz
complicated	ch´u´x
compliment	tz´el twitz
comply	el twitz
composition	tbʼinchbʼen
compound	at toj
comprehension	keleltnik'
comprehensive	mojb'ab'il
compromise	tun txi b´inchet
compulsory	sq´uin
computer	ajnab´il
concentrate	ximele
concept	t-kayb´ajtz
concern	ti tzulo
concerned	melj
concert	ch'uq xjaal
conclusion	iktzentzje
condition	axexje
conditions	junjun tiʼchaq
conduct	t-kayb´ajtz kywutz xjal
conference	atlu
confess	q'mal
confidence	q'uqb'il k'u'j
confident	ax
confirm	q'mal tq'anil
conflict	q´oj
confused	ma qe tzak'j
confusion	najil
congrats	tzalajsal
congratulation	tzalajsal
congratulations	tzalajsb´il
conjunction	ch'uq
connect	mojb'al
conquer	tkubʼ tiʼj
conscious	tenab'il
consciousness	qnab'il
consent	chuch´i´
consequences	ti kb´ajel
conservation	laj
consider	ku tz´ulo ku tx´imina
considered	klo'n
consist	techel
consistency	majx
consistent	jun lu´n n-xi b´inchet junjen q´ij
constant	q´achq´al
constantly	at ju
construction	b´inkab´il ja
consume	b'ajsal
consumption	b´ajsal
consumption	molj
consumption	b´ajsil
contact	tzyul
contagious	b'ajo'k
contain	at toj
contains	tten
contemporary	ja'lin
contempt	ik´al
contempt	ik´il
content	b´ixnaq´tz
contest	conrus
context	aju yol
continent	a iq´in tun
continue	lojonxa
contract	twi´ aq´untl
contrast	junxitl
contribute	chojil
contribute	chjol
contribution	onb'il
control	tkawbʼil
controversial	wul
convenient	tu´n b´a´n
conversation	tx'olb'al
conversation	lajiñ
convert	kjalb'iyan
convey	chik´il
convince	kub´ tuj twitz
convinced	mikb'el ti'j
cook	b'nchal wab'j
cooking	b´inchal wabj
cool	xbajin
cooperation	mojil
cope	weʼ kywitz
copper	kob'r
core	tq´anal
corn	xin
corner	b'utx'
correct	tb'anil
cost	twi'
costume	xnb´alamb´alil
cottage	ja
cotton	noq'
couch	q'uqb'il
cough	qulb´aj
cough	sjol
cough	tzjo´l
could	ku tz´ulo
council	chemb'il
count	ajlall
count	ojla´n
counter	yek´il k´ax
country	tnam
countryside	k´ul
couple	junjen
courage	tx'ujil
course	xnaq´ta
court	jol
court	amj
courtesy	tbʼanel xjal
cousin	chojb´al
cousin	kotzalalb´il
cover	maqsil
cow	wakx
coward	ma ja x'ob'
crab	chap
crab	chop
crack	laqin
crap	yaq
crash	punil
craving	tk'ok'jal
crawl	k´ol txakal
crawl	k´e´b´il
crawl	txakil
crazy	xo'j
crazy	Swat
create	nab'lilte
create	b'nchalte
creative	t-b´anex b´isen
credit	q-k´as
creep	ob'il
creepy	klelin
crew	nimxix
crime	il in bʼant
cringe	ch´ixil
cringe	ch´ixwel
crisis	mintiʼxix kypwaq
criteria	t-ximbʼetz
critical	ilx ti´j
criticism	yolintoq nya bʼaʼn kyiʼj txqantl
crop	awaj
crops	awal
cross	iky´ix
cross	ikyi´t
cross	ikk´xil
crow	joj
crowd	txqan xjal
crowded	jun xjal atestado
crown	coron
crucial	cruacial
cruel	xkyaqk'u'j
cruise	bark
crush	yuq´el
cry	oq'il
cuddle	tz'ul
culture	abrazos
cunning	tzeʼn jaku bʼant
cup	k'wab'il
cupboard	k´ub´b´il
curb	wa'b'il
cure	q´anil
curfew	tyeja tjaya
curiosity	tuʼn tel mas nnikʼe tiʼj.
curious	b´isel
curly	coloch
currency	se´pwaq
current	ak´a´j
currently	a jalin
curse	q'anil toj twi'
curtain	txab'alaninja
cushion	q´awej
custom	xkanob'il
custom	tzejxb'alin
customer	loq´el
customs	aduanas
cut	qesil
cute	tb´abil
cycle	amb'al
dad	tata
dad	tat
dad	mamb´aj
daddy	tat
daily	junjun q'ij
dairy	ta'l imaj
dam	tzyu'n
damage	yajil
damage	yajilte
damn	q'anil toj twi'
damp	xb'umb'uj
dance	b'ixil
danger	tzaj jun nya bʼaʼn
dangerous	taq'wix
dark	qlolj
dark	qtakin
dark	qlolaj
darling	n-xujele waje ti´j
dash	tzok'
data	nim toklen
date	tajlal
date	tajlalq´ij
daughter	alib´aj
day	q´ij
dead	kyimna
dead	kyimni
deadline	tmakb´il q´ij
deaf	chk´in
deal	xi q-b´inchen
dear	tal
Dear All	xb'oj
Dear Customer	Samel Xjal
Dear Parents	eyeq´iye manb´aj
Dear Sir	xb'oj
Dear students	eyeq´iye k´uxun
Dear Team	eyeq´iye wuk´il
death	kyimni
debate	yolin tiʼj
debit	tz'el q'in
debris	tz'is
debt	k´as
decade	laj ab'qi
decay	ma b'aj
deceased	ma kyim
deceive	sb'ul
december	tkalaxxjaw
decent	b´a´n
decide	n-xi t-b´isen
decided	txi b´iset
decision	b´isel
deck	maqsil
decline	ik'il
decrease	qelil
dedicated	xonk'u'j
dedication	aq'unal tij
deed	tz'b'b'en
deep	nim t-xe'
deer	jun-venado
default	estzen tu´n
defeat	ma k´ub´
defend	kolil
define	ikja
definitely	iktzen
definition	tzen kxele
degree	ab'q'i xnaq'tz kol
delay	ma q'et
delayed	yaj
delete	siky'il
deliberate	ma kut b'isen
delicate	k´uw
delicious	k´o´kj
delight	oquinil
delighted	k´ujlal
deliver	q´ot
deliver	q´ol
delivered	q'olte
delivery	ma chin tza je q'olte
demand	b´ajsal
demanding	amlil
democracy	tiptnam ex numb´il
democracy	nak´b´il
democracy	txub´txaj anq´ib´il
demon	ju'o
demonstrate	yek´b´il
denied	ma ju ewin
density	ch'uxh
dentist	q-anil eyb'aj
deny	lay
department	te tnam
departure	ma txi´
depend	k'okel
deploy	loch´il
deposit	n-okx
depressed	bisin
depression	bis
depth	txe´
describe	q´mantza s´en
description	t-kayb´ajtz
desert	n-ti´ at toj
deserve	leq´
design	b´inchel
designation	tqʼoʼn
desire	ajb´il
desk	mex
desk	tz'ib'b'il
desk	también
despair	toj kʼixkʼoj
desperate	tunx n-b´isenx
despite	t´un pitzun
dessert	n-ti´ at toj
destination	tun q-kanen
destiny	kpon
destroy	ch´uqal
destroy	q´uchil
destroy	yuch´il
destruction	tx'uyil
detail	junjun tiʼchaq
details	jun tiʼ
detect	tel naj qnikʼ
determination	jte´ qaj ti´j
determine	ma pon b´aj
determined	tajxex
devastated	chunil
develop	b´inchel
developed	bʼinchaʼn
development	ch'isb'il
device	kxb´il
devil	taj wil il
devoted	tililxix
Dhivehi	Dhivehi
diabetes	diabetes
diarrhea	k´uj
diary	chijtl
dictionary	pujb´ilyol
did	ma ku tbinchan
die	kimni
die	kim
died	kyimni
diet	kyyoʼn xjal weʼyaj
difference	junxitl
different	ju´nxil
different	junxil
difficult	kyuw
difficult	ch´ux
dig	lukal
dignity	t-dignidad
diligent	xhtij
dinner	w'al
dip	jk'om
direct	qʼanchaʼl
direction	janejenel
director	nejenel
dirt	tz´il
dirty	tz'i'l
dirty	q'ux
disable	anmi
disabled	anmi
disappear	najsil
disappointed	q-k´e tun q-kayen ti´j
disaster	i´l
discard	xol
discharge	iqal
discharge	q´lte
discipline	nak´b´il
discover	jolil
discover	jalol
discrimination	iq'il
discuss	yolil
discussion	wul
discussion	yasil
discussion	ch´otjil
disease	yab´
diseases	yab'il
disguise	ewil
disgusting	nya´txu´txjal
dish	le'wlaq
dishes	le'wlaq
dismiss	k'awil
dispatch	k'ayil
display	yek'al yek'il
disposal	tz'is
dispute	txi tiret
distance	jte´ q-xol
distinct	junxit
distinguish	q´inchil
distress	b'is
distribution	le´l
distribution	sipil
district	distrito
disturb	ky´elet
disturb	yekil
ditch	jul
dive	jilil
diverse	tixch'aq'
diversity	chukchaq anq´ib´il
divide	sipil
divide	palte
divine	ponix
divorce	ma ku p'an
dizzy	yupaj
dizzy	witzb´aj
do	jaku
do you	ay
do you love me	in laqa wije
doctor	q´anel
doctor	q´anil
document	u'jil
does	ma´y
does	may
doesn't	mi'n
dog	tz´yan
Dogri	Dogri
doing	b´inchal
doll	la's
domain	b'antil
domestic	q-jay
dominant	kyuw
don't	lay
don't	mixti
don't	tla
Don't worry	nan tzaj txima
donate	oyil
done	b´a´nmaj
donkey	bur
double	k´ab´e
doubt	xjel
doubt	xka´mil
doubt	q´uq´il
dough	q'otj
down	kub´l
download	kub'sil
draft	q´uchb´il
drag	jk'ul
drain	jutzx
drain	jutzl
drama	iltzeb'
draw	tilb´ilal
drawer	kyajb'utx'an
drawer	kax
drawing	ilb'ilal
dread	xtalb´il
dream	witziky´
dress	chuy
drill	laq'il
drink	k´wab´aj
drive	manejarel kxbil
drop	txat
drop	t´un t
dropped	ma ku tzaq'
drought	tzqij
drunk	tx´ojtenil
dry	tzqi
dry	txajan
duck	patz
dude	xjel
dude	xk'amil
dude	q'uq'il
due	toj
due to	t´un tpaj
dull	tzaj q-watl tu´n
dumb	men
dumb	sma'k
dumb	me
dump	axtok
dump	ax
duration	jteʼ amb'il
during	tze´n
dust	quq
dust	qupj
dust	puj
duty	k'as
dwell	najal
dying	kyimni
dying	kim
each	jun jun
each other	tz'oka
eager	n-lipen xjal
eagle	t´iw
ear	xkyimb´aj
earlier	q'ontz amb'il
early	qlax mo qlixje
earn	kanb'il
ears	xkyimb´aj
earth	tx´o´tx´
earthquake	kyaqnab´
ease	q-facilidad
easily	nya kuj
east	a la
easy	tu´nxtib´
eat	wa´l
eat	wal
eating	wa´l
economic	pwaq
economy	pwaq
edge	ja n-el b´aj
edit	b'nchu'j
education	xnaq´tzb´il
effect	n-b´aj ti´jxe
effective	tbʼanel
efficiency	bʼant tuʼn
efficient	b´an b´inchen
effort	ipal
egg	jos
eggplant	xpenitzaj
ego	nimsan tibʼ
eight	wajxaq
eighteen	wajxaqlaj
eighty	kyajk´al
either	maqo
elaborate	b´inchal
elbow	tch'eq' q'ob'aj
elder	ni min xjoq´
elderly	nimin
elegant	q´tik´
element	tz'aqsb'il
elephant	elefant
eleven	b´elaj
eligible	jun lu´n kab´ale token
eliminate	tkubʼ naj
else	nimx
else	q´otzl
embarrassed	tx'ixwil
embarrassed	ch'ixil
embarrassed	ch'ixwel
embarrassing	chʼixwi
embrace	Tz´ulil
embrace	chlel
emerge	ma ja b´ian
emergency	nya bʼaʼn
emotional	tuʼn ttzalaja
empathy	ximana
emphasis	enfasis
emphasize	yekʼinxa
employee	majin
employees	majin
employer	majin
employment	aq'untl
empty	mishti toj
empty	amil
empty	miti toj
enable	kuyil
encounter	jyo´n
encounter	ma tzel yal
encourage	txi q-mojen
end	ma b´aj
endangered	toj taq'wix
endeavor	kyuw
endurance	kuj
endure	tipa
enemy	ajq´oj
energy	tipumala
engage	kxel b´inchet
engaged	taj tun tok
engagement	jun compromis
engine	rum
engine	juk'ul
engineer	ajtzqilb´inch
English	me'x yol
enhance	b´antyil
enjoy	taje
enormous	nintzk'u
enough	okxu
ensure	axix
enter	okx
entertainment	q-kayb´etz
enthusiasm	tzalajb´il
enthusiastic	tzalajsb'il
enthusiastic	ntzalaj
entire	junka
entitled	tuk´il toklen
entity	ch'uq xjaal
entrance	oktzil
entrance	okx
entrepreneur	xjal n-b´inchen jun lu´n saq
envelope	tib'aj
envelope	tb'el
environment	twitz tx´o´x
envy	yaqil
envy	xkyaqtze'l
envy	xjiq'al
epic	mintiʼ tzaj xobʼ
epidemic	yab'il
equal	iikx
equipment	ky-lu´n
equity	junx
equivalent	junx
eraser	xqechb'il
error	nya bʼaʼn
escape	oqil
escape	oqel
especially	extzen axexje
essay	xnik'chal
essence	k'ok'jil
essential	ilx
establish	tun tok
established	kxel o´n
estate	q'ina
estimate	nxi q-b´isen
estimated	t-xb'oj
eternal	lay b'aj
ethics	tb'anel
evaluate	niky'xjelil
evaluation	xjelb'il
even	ex
even though	extzen
evening	aq´b´il
evening	qoniky´an
evening	qniky´in
event	jun lun n-b´aj
eventually	ex junjen maj
ever	ju majku
every	junjun
everybody	tkyaqil
everyone	tyaqilx
everything	tkyaqil
evidence	tech'il
evil	tajaw il
evil	tajwil il
evolution	tzajni qoʼ
evolve	tx´ixpul
Ewe	Ewe
ex	o tz´ik´
exact	ikja
exactly	iktzen
exam	ka'yib'il
examine	ka'yib'il
example	techel
exceed	tel qbʼis
excellent	ponex
except	me mi´ne
exception	okxa
excess	nimxix
excessive	nimxix
exchange	tx´exb´il
excited	n-lipen qanb´el
exciting	n-qo tzejen tu´n
exclusive	naq oʼkx
excuse	najsama
excuse me	najsama
execute	b´inchalte
execution	tkubʼ bʼiyoʼn
executive	jun ejecutivo
exercise	aq´net
exhaust	oqil
exhausted	siktel
exhibit	mujle
exhibition	yekb´il
exist	i'tz'
existence	at
existing	atixix
exit	tzexa tzala
expand	lemtz'il
expect	yol
expected	ayo´n
expected	ayo´nmaj
expected	ayon
expenses	kub' tb'ajsan
expensive	wi´yal
experience	ojtzq´b´il
expert	ojtz'q'il
expired	kub'
explain	tx'olb'al
explain	chik'b'l
explain	chik'b'al
explanation	chik'b'al
exploit	yajil
explore	qo kayen
export	exk´ay
expose	chik'il
exposed	tyek'in
exposure	chik´il
express	tx'olb'al
express	chik'b'al
express	chik'b'il
expression	yek´kye´xix sa´b´ix
extend	q´onxa
extended	yekin
extended	yoli'
extension	extension
extent	echil
external	jumajx
extinct	ma k'ubaj
extra	juntl
extract	toj chʼin yol
extraordinary	nim tbʼanel
extreme	kuj
extremely	junti´j
eye	witzj
eyes	witz´j
fabric	chem
fabulous	tbʼanelxix
face	twitz
facilitate	nya kwest
facilities	q-facilidad
fact	ma b´nchet
fact	b'a'nmaj
factor	nim toklen
factory	b'inchb'il
facts	b´inchaj
fade	ma Kim
fade	ma txi'
fail	ma tz´akj
failed	ma tzakj
failure	ma tzá qj
faint	xb unin nya kuj
faint	numj
fair	naqchaj
fairly	junx
faith	q´uqlalk´u´j
faithful	wen
fake	nya ax
fall	tz´aq
FALSE	chaj yol
FALSE	ploj
FALSE	taq´ux
fame	nimxix toklen
familiar	jaxjal
familiar	najayal
family	jaxjal
family	najayal
famine	q´aq´in
famous	jotx wutzqilte
fan	xjal taj qi´j
fancy	witz´ik´ixim
far	chaq
farewell	mankasab´il
farm	attoq nim awal
farmer	ajkojol
fascinating	n-qo ja ka´yen ti´j
fashion	tbʼanel
fast	ojqelx
fat	xb´ok
fat	xtob´
fat	chu´s
fatal	nach
fate	ja ma qoxe
father	xnuq
father	tata
father	tat
fatigue	siktel
fault	ma q´etzakj
favorite	a mas qaj ti´j
favour	xtalb´il
favourite	mas ngane
fear	xob´ajil
fear	chewil
fear	chi
feast	nim chib'j
feather	xiky'b'aj
feature	t-kayb´ajtz
features	kyok ti´j
february	tkab´jaw
fed up	xtx'ujin
fee	chjol
feed	k´achil
feed	k´a´chil
feedback	yol
feel	n'alte
feeling	na'l
feet	qamb'aj
feet	q'anab'aj
fell	ma k'u tz'aq'
fellow	wuk´il
felt	ma ku tnana
female	ttxu
fence	naq´aku
fertile	b´a´n tz´alen
festival	nintz q'ij
fetch	jyol
fever	kyeq´ kyaq
few	ch´in
few	noq ch´inxix
fewer	ch'in
fiance	kyajlaj
field	k´ul
fierce	juntij lamidx
fifteen	jwelaj
fifty	ka´k´al laj
fight	jya'tz
fight	la'jan k'axjel
fighting	la'jan
figure	t-kayb´ajtz
figure out	jyol
file	k'u'l
fill	nojsantzan
filled	ma tzq´et
film	txumakib´
filthy	q´ux
filthy	tz´il
finally	tuntzentzje
finance	pwaq
financial	pwaq
find	ma knet
find out	ma tze'el yal
fine	b´a´n
finger	tal qob´aj
finish	b´aj
finished	ma b'ent
fire	q'aq'
firm	tok
first	tnejil
first	tnejel
first name	tjil tb´i
fish	katz
fish	kyix
fit	naq´l
fit	naq´et
fit	naqle
five	jwe´
fix	b'inchalte
fixed	junx
flag	tsu't tnam
flash	tzaj
flat	chq´alaj
flat	chq´ajlaj
flaw	tzkaj
flaw	tx'u'jwi
flawless	saq
flee	oq´il
flesh	ch´ib´aj
flew	ma lipan
flex	paqtzul
flexible	koxpil
flight	kylipan twitz kyaʼj
flip	miltz´ul
flip	paq´tzull
flirting	chunil
flood	ma k´uj b´aj
flood	ma k´uj lob´j
floor	twi´tx´otx´
flour	ky´aj
flow	n-tza t-b´inchen tib´aj
flower	b´ech
flu	yolok toj twi
fluent	a'
fluently	nya kuj
fluffy	chab´a
fluid	ta'l
fly	lipal
focus	kxel kayet
fog	muj
foggy	muj q´witz
foggy	q´aqmujil
fold	paqtzul
folks	wukile
follow	lipeb'il
follow up	ljonxa
following	juntl
food	niky´b´eb´il
fool	xnak
fool	xkonk
fool	qejil
foolish	mib'in
foolish	tx'u'j
foot	qamab'aj
foot	q'anb'aj
football	xpo´tzil
for	tu´n
for	te
For example	techel
for instance	jun kyxol
for you	teya
forbidden	mya b´an
force	ipumal
forecast	tzen tzule
forehead	twitz
foreign	mya te tzaló
forest	tze´
forest	k´ul
forever	te jotx q´ij
forget	el naj
forget	najsimil
forgive	najsal
forgot	ma tz'ik' tnal
form	tza'n tiene
formal	b´a´n
former	formal
fortunately	b´a´namaj)
fortune	tq'inimal
forty	kab´k´al
forty-two	kab´k´al kab´
forward	twitz
foster	tbʼanel tten
fought	ma la'jan k'axjel
found	ma knet
foundation	kab'.tlok'
four	kyaje
four	kyaj
fourteen	kyajlaj
fox	chux
fragile	kab´ale taq´e
frame	tilbʼilal
framework	alkye tten
fraud	laq´e tib´il
freak	ttxu
free	tz´pin
freedom	tzaqpin
freeze	qwak´sal
freeze	wak´sil
freeze	che´wsil
frequency	atl
frequent	ch´qalx
frequent	kukx
frequently	ch´qalx
frequently	kukx
fresh	xba´jin
friday	joq'ij
fridge	chewsb´il
friend	quk´ila
friend	xb´oj
friendly	xjal b´an yolen
friends	quk´ila
friendship	tamiw
frightened	x´ob´ajil
frightening	lab'il
frog	xulma
frog	xal
from	maxtz'u
front	plaj
front	tplaj
frozen	wak´sin
frozen	che´wsin
frozen	qwak´
fruit	lob´j
frustrated	tzaj tbʼis
fuel	gasolin
Fulfulde	Fulfulde
full	nojsantza
fun	tzalb´ajil
fun	tachaxil
function	tajb'en sqit
function	ka'yb'il
function	kib'il
fundamental	iqin tnam
funeral	muquʼn
funny	tzalb´ajil
fur	txa ab´aj
fur	tz´umil
furious	tx'u'jin
furniture	toj tja'
further	q´ontz
furthermore	extzen
future	tzul
gain	kanb´il
game	saqchal
gap	netz´ b´e
garage	tja b'och
garbage	tz´is
garden	ja te b'ech
garlic	anx
garlic	anjs
gate	tjpel ja
gather	mojb'ab'il
gathering	chmob´il
gathering	ch´uqil
gauge	echil
gave	ma tzaj q'on
gear	jun tuerca
gender	xe´chil
gender	tqab´
general	jotx
generally	majx
generate	b'inchal
generation	toj ambʼil
generous	b´a´xjal
genius	twi´xim
genre	xe´chil
genre	tqab´
gentle	tb´anilxjal
genuine	twutx té
gesture	kotx'il
get	kanetsil
get dressed	xb´alamet
get dressed	q´on tija
get up	wektza
get well soon	qa tz'el b'a'na
getting	kanetsil
ghost	ju'õ
ghosting	Ma wile jun anmi´
giant	nintz'ku'
gift	o´yb´itz
ginger	xanxiw
girl	kuxin
girlfriend	tukʼil
give	q´olte
give up	oqb´il
give up	kolil
give up	ko´lil
given	dado
glad	tzalaj
glance	oquinil
glass	lemet
glasses	tjomel witzb´aj
glimpse	k'ayil
gloomy	nya we'n
glow	qoqb´il
glow up	xtilin
glow up	xtilan
glue	lak´ib´il
go	q´oxel
go ahead	nejli
go away	tx´iya´
go to bed	wtal
go to bed	q´oya tal
go to bed	ktal
goal	tikb´antel
goals	a wajb´ile
goat	Ttxu chib´
goat	chip
god	ajaw
god bless you	ky'iwb'il ajaw
goes	n-ipan
goes	nipan
going	ma chinxe
going to	q´oya atz
gold	q'anpwaq
gone	ma txi
gonna	ma q'ox atz'
goo	oeri
good	b´a´n
good afternoon	q´alte
good afternoon	chinq´olb´ene
good bye	wexa
good bye	chab´iya
good day	b´a´ntz q´ij
good evening	talte
good evening	qalte
good job	b´an aq´na´n
good job	aq´unb´en
good job	aq´namaj
good looking	ponix
good luck	b´ax kayen tib´e
good morning	B´a´tz q´ij
good morning	chinqolbéne
good morning my love	b´an q´ij
good night	ta´lt
good night	qalte
goodbye	wexa
goodnight	qalte
goods	at jun
Google	google
goose	gans
gorgeous	ponex wen
gossip	slak'
got	kenetsil
got	kanetsal
got it	chi k'aneye tij
government	wi´xin
grab	tzuyil
grab	tzyul
grade	ab´q´i xnaq´tz
grade	kol
gradually	cheb'a
graduate	xnaqʼtzbʼil
grain	twi'tz
grant	q'onxa
grapes	xjitz
grasp	kaneyil
grass	itzaj
grateful	q´oj chionte
gratitude	q´ol chjonte
grave	jul
gray	sib'
great	b´a´nxix
greed	achb'il
greedy	tuk´a avidez
green	txa'x
greet	q'olb'eb'l
greeting	q´olb´eb´il
greetings	q'olb'el
grey	sib'
grid	pa' xwub'
grief	n-cho´n
grind	ch´el
grip	tzyuma
gross	matij
ground	tajq' xjab'
group	chmoj
grow	ch´iy
grow	ch´iyil
growth	ch'iy
grumpy	lo'ch
Guarani	guaraní
guarantee	qkʼuʼj tiʼj
guard	xq'uqil
guess	ponil
guest	txokb´il
guidance	nejil
guide	yek´ul b´e
guilty	tpaj
guilty	pajb´al
guy	q'a
guys	q'a
guys	kuxin
habit	ax b´inchet junjun q´ij
habitat	jaa
had	ma ja tz'aq'
hail	saqb'aqaj
hail	saqb'aqin
hair	xyen
hair	tzmalwi
half	nik´jan
hall	q'uqb'il
hand	q´ob´aj
handle	yukal
handle	yukchil
handsome	q´tik´
hang	yob´ink´a
hang out	kyten jun rat
happen	qa ma b'aj
happened	ma b´aj
happiness	tzalajsb´il
happy	tzalaj
happy birthday	Tzalajsb´il q´ij teya
happy birthday to you	tzaljsb´il q´ij teya
happy new year	Tzajasb´il ak´aj abq´i
hard	ch´ux
hardly	kyuw
hardly ever	bajxa
harm	yajil
harmful	q'on taq'wix
harmony	ttxu´txajil chnab´
harsh	ch´ux
harvest	aw'al
has	a ti te
hate	xkymb'aj
have	a tita
have	Iq´in
have a good day	b'atz qij teya
have a nice day	b´a´nx q´ij teya
have breakfast	wa´l
have breakfast	wal
have fun	tachxil
have fun	tzalb'ajil
have you eaten	ma wana
having	a tita
having	aq´in
hazard	xob'ajil
haze	yaq'
he	a
he has	a ti te
he is	a
head	wib´aj
head	wi
headache	nchon wi'
heal	q´anil
health	b'a'n
healthy	b´an t-chwinqel
hear	b´il
heard	b'ilte
heart	anma
heart	anmi
heat	q´exa
heat	q´aq´il
heaven	kya´j
heavy	al
hectic	yekil
height	twe'
heir	etzb´il
heist	elq'in
heist	eleq
held	txtokal
held	xtokal
hell	xib'alb'a
hell	najan
hell	tenb'ilq'aq'
Hello	Je´ky
hello dear	tze´n tayey
hello how are you	je´ky s´e´n taya
hello how are you doing	je'ky s'en taya
helmet	t-xk'omil wib'aj
help	onil
helpful	ajb´ebíl
helpful	ajb´alan
helpful	chi
hence	tuntzen
her	teya
herd	k'loj rit
here	tzalu´
heritage	n-ki o´n qe
hesitate	xtz´mil
Hey	Tze´n
Hi	Je´ky
hi how are you	je´ky s´e´n ta´ya
Hi there	je´ky
hidden	ewin
hide	ewil
hierarchy	ajb'ech
high	nimin twe
highlight	xtilil
hike	b´etil
hiking	bʼetil
hilarious	q-tzeb´el
hill	witz
him	a
hint	tb'anel b'e
hip	twi'kuxb'aj
hip	xixb'aj
hips	xixb'aj
hire	tzyul
his	teya
history	t-xilen
hit	b´ujil
hit	ky´ixb´il
hobby	jun rat
hold	tzuyil
hold	tzuyb´il
hold	tzyul
hold on	nyon
hold on	yol
hole	xlaq´
holiday	ojlal
hollow	jul
home	ja
homework	aq'unab'il toj ja
honest	axix
honestly	axix
Honey	T- al kab
Honey	ta´l kab´
honor	nimxix chjonte
hood	tz'itk'uj
hook	xok
hook	yo'b'il
hop	t'ik´pul
hope	toj q´ij
hopefully	ch'in tb'anel tu'nju
hopeless	b'is
horizontal	tq´e´lil
horn	q'ajtzb'il
horrible	taq'wix
horror	xob'il
horse	kej
hospital	tja q'anb'il
hospitality	b'antulena
host	xjal yolel toj chnab´
hostile	nya bʼaʼn
hot	kyeq´
hotel	ponix ja
hour	kolq'ij
hours	kolq'ij
house	ja
household	ja
how	se´n tzun
how	Tza´n
how about you	yajtzun ta
how are you	s´ent a´ya
how are you doing	se´n ta´ya
how are you doing today	s´e´n ta´ya jalin
how are you today	s´e´n taya jalin
how do you do	s´e´n ta´ya
how is	s'e'n
how many	jte'qe
how much	jte
how much	jt´en
how much	niy pun
how often	kukxjo
how old are you	jte tanq´ib´la´
how was your day	sen sexa tq´ija
how was your night	s´e´n sok´iya´ te q´onik´in
however	Noq tze´n taye
hub	niky'aj
hubby	qe ka´yil
hug	tz´ulil
huge	nimin
human	xjal
humble	b´unlatten
humble	b´uninxjal
humid	xb´u´l
humidity	xb´umb´uj
hungry	wayij
hungry	wa´yij
hungry	q´aq´in
hunt	kanb´at
hurricane	nim jb'al
hurry	qelxa
hurry up	q´elxa
hurry up	q´lana
hurt	ky´ixb´e
husband	chmilb'aj
hustle	n-chi rinen jotx
hut	ja
hygiene	xnul
I	Ayine
I am	ayine
I am fine	b´an chjonte
I can	ja'ku
I can	ja'na
I can	ja'ka
I can't	lay b´entwune
I do	oky
I do not know	s´e´n lo
I do not understand	mixti k´ane
I don't	lay´
I don't know	s´e´n lo
I don't understand	mixti
I don't understand	minti
I don't understand	jon
I don't understand what you mean	mixti in chin kaneye tiju toka qmalte
I don't understand you	xi kane
I don’t know	s´en lo
I don’t understand	xti K'ane
i guess	axlo
I had	tenwe
I have	a tiwe´
I have been	ntene
I hope so	a tz´n yonjiye
I know	b´in
I know	kanli
I like	in chin laqe tija
I like you	chi laqe tija
I love	tk'ujlab'il
I love my big brother	chin laqe tij tziqe ni min
I love my big sister	chin laqe tij tziqe ni min
I love my father	chin laqe tij nmane
I love my little brother	chin laqe tij witzine
I love my little sister	chin laqe tij witzine
I love my mother	tx´uye
I love my mother	in chin laqe tij naniye
I love you	In chin laqe tija
I love you so much	in chin laqe tija
I love you too	ikxwe in chin laqe tija
I mean	a kxel nmane
I miss you	inchin bisine tija
I miss you so much	chin bisine nim tija
I see	txi k´ayine
I think	ximil
I think	chin ximine
I understand	ma chin qaneye
I want	ajb´il
I want to see you	waje t´un tw´ila´
I want you	ky'iwb'il
I was	ma chin tene
I will	k-txel b´inchane
I would be	axna
I'm	ayine
I'm fine	b´an tiniye
I'm good	b´an ti niye
I'm here	a tine tzala
I'm sorry	najsama
ice	txa'chew'
ice cream	leq'che'w
idea	xim
ideal	tbʼanel onbʼil
identical	ikxixju
identify	tun txi t-jyone
identity	techel
idiot	mib´e b´isen
idle	xi yuk´ch
if	oky
ignore	mi txi t-kayen
ill	yab´
ill	yab´il
illegal	nya we'n
illness	yab'
Ilocano	Ilocano
image	tilb´ilal
imagine	ximb´aj
immediate	jalinxix
immediately	jalinxix
immense	nintzk´u
impact	kuj te qe
impatient	loch'il
implement	tun tok
import	iltij
important	iltij
impose	chq'ol
impossible	la'yx b'ent
impress	tuʼn kyjaw labʼin
impression	t-xaq uʼj toj kʼuxbʼil
impressive	qo ja ka´yen ti´j
improve	b´antyil
improvement	wen
in	tuj
in	Tu
in addition	axna
In fact	axpe ikx
in front of	twi'tz
in order to	el qe
inappropriate	nach
incentive	qmojbʼabʼil
incident	nya bʼaʼn
include	tun tokx
including	tukʼex
inconvenience	nya bʼaʼn
increase	nimsal
increased	ma jaw
incredible	mi n-xi q-ni´men
indeed	tuntzen
independent	t-junalx
India	India
indicate	q´maxa
indigenous	wqnaqil
individual	jun
individual	tjunix
industry	poq´sal ti´chaq
inevitable	la b´ant t´el
infant	kwal qa
infection	tilal yab´il
infinity	nimxix
inflammation	tq'anil
inflation	xhupin
influence	yolelqe
inform	q'malte
information	tqanil
ingredients	t-k'ujil
inheritance	etzb'iñ
initial	el q´un xi qeya
initial	tnejil
initiative	tun txi xke
injured	ma q'ixb'i
injury	ky'ilxb'en
innocent	mya at t-paj
innovation	ak'aj
inquiry	jyoʼnktza
insane	tx´u´j
insect	q´kup
insecure	mlay bʼant jun tiʼ
insert	q´onxa
inside	toj
insight	umel tuʼn
insist	wexa
insomnia	txunwi´
inspiration	tz'ilte
inspire	ambʼil te
install	q'ol
instance	tqanin onbʼil
instant	jalinxix
instead	tuj - tx´ixpub´il
instead of	te txel
instructions	qmal txolil
instrument	wakb'il
insult	yasil
insurance	b´a´ntten
integrity	jun wen xjal
intellectual	mas bʼaʼn
intelligence	mas bʼaʼn
intelligent	b´an b´isen
intend	qanil
intended	jatumel
intense	n-lipen
intention	taj
interact	yolil
interaction	yolil
interest	tal pwaq
interest	ta´l pwaq
interested	tal pwaq
interesting	qaj ti´j
interfere	xyol
intermediate	niky'jen
internal	tojxi
internal	tukxa
international	ti´jxix tnam
internship	iky'il
interpret	nelpuna
interrupt	yaqpul
interview	xjelb´il
intimate	tamiw.
into	toj
introduce	xuqan
introduce	xuq
introduction	tuk tel q-nik´
introvert	xjal mib´e yolen
intuition	n´al
intuition	jachmob´il
invalid	attoq jun tyabʼ toj
invent	xkansil
invent	nab´il
invest	tel qpaʼn
investigate	jyol
invitation	x´okb´il
invite	txok´il
invoice	u´j tun txi chjet
involve	tun tokj
involved	tun tokxe toj
iron	k'uxb'il
is	a ju
island	plowti'j
island	a'ti'j
isolated	tjunalx
issue	b´i´yol
issues	q´oj
it	a
it is	a
it was	ma b'aj
it's	aju
it's ok	b´an
It's okay	b'a'n
item	xnaqʼtzbʼil
items	tz´aqsb´il
its	teya
I’m	ayine
jacket	t´ij kamixj
jail	chojb´il il
January	tnexjaw
jar	xar
jaw	qtzi
jealous	xk´aqlin
jealous	ajxky´aqil
jerk	nya bʼaʼn xjal
jewelry	pwaqab´aj
job	a´qan
jogging	rinel
join	mojb'alte
joint	txol b'a'q
joke	yaq
journalist	chik´qanil
journalist	xob´lyol
journey	b´etil
journey	b éyat
joy	tzalaj
judge	xjal q´malte
juice	ta'l
july	twuxjaw
jump	lipul
june	tqaxjaw
junk	tz'is
just	noq
just do it	b´inchanxa
justice	xtis
justice	xtulb'il-il
justice	teylixil
justify	ikyjo
Kalaallisut	Kalaallisut
keen	laqil
keep	kanq´ila
keep it up	nejk'uya
kept	jaku ten
kettle	txikyb'il
key	tal ja´
kick	xajol
kid	k´awl
kidding	yaq´il
kidney	chjab'
kids	k´wal
kill	bíyil
kind	tichaq'x
kinda	ch'in netz'
kindly	b'a'nxix
kindness	b'a'nxix
king	nim tipumal
kiss	tz´ub´
kiss	ma´tz
kitchen	b´inchb´il wab´j
kite	q'manxa'
kitten	wix
knee	ch´ekyb´aj
knee	ch´eky
knew	b'intaq
knife	q'esil
knight	ponix ichan
know	ojtzqil
knowledge	nab´il
knowledge	ojtzqib´il
known	tzqi'n
Konkani	Konkani
Krio	Krio
label	tu´jal pa
labor	aq´untl
labor	aq´qntz
labour	aq'anal
lack	chi´ixpatzan
lack	ch´inx
lack	ch´ix b´aj
ladder	yotx
lady	q'apoj
laid	kubʼ bʼinchaʼn
lake	najab´
lake	talnajab´
lake	alwun
lamb	rit
lame	q´ewjne
lamp	kandil
land	tx´otx´
landscape	tbʼanel keʼyin
language	yol
lap	twi tqan
large	xqin
large	xji´l
large	qini´ch
last	b´ajsb´il
last	mankb´il
last but not least	nya iltij
last but not least	tmakb´il jela
last name	k´olil
late	yaj
lately	kʼitzqeku
later	nejxi
latest	a ju tmakb'il
latter	tmakb'il
laugh	tzet
laugh	tze´l
laughing	tz´el
laughter	tzet
laughter	tze´l
launch	txi q-xo´n
laundry	tx´ajb´l
law	q-ley
lawn	xpatzb´an
lay	q'olte
layer	txow
layout	qajbʼil
lazy	q´il
lead	yek´il
lead	q´ol tumel
leader	nejinil
leaf	a'witz
leak	ma tz'ex
leak	nel
lean	k´ekuya
lean	xmejek´uya
lean	mok´ekaya
leap	t'ikpajil
learn	kanol
learn	xnaq´tzil
learning	xnaqtzb'il
lease	majil
least	naq ch'in
leather	tz´u´m
leather	tz´u´n
leave	le´b´il kolil
leaves	t-xaqtze´
leaves	txaq tze
led	qʼiʼn tuʼn
left	nayaj
left	xnayj
leg	kuxb'sj
legacy	n-ki o´n qe
legal	kywitz aj kawil
legend	tzqib'k'lojyol
legit	kyiʼj xuʼj
leisure	amb'il
lend	txol
lend	ch'exyol
length	tnuq
length	tnuqil
less	naq´ch´in
less	chi´n
lesson	xnaqʼtzbʼil
let	chi nexe tk´tza
letter	samu'j
lettuce	q-lechuga
level	chik'ob'ilja
leverage	txi q-aprovecharen
liability	matoklen
library	maju´jb´il
lick	leq´il
lick	leq´al
lie	chal yol
lies	chajyol
life	chwiqlal
lift	q'inktza
light	xtilin
lightning	xtilin
like	nwane
likely	jakulo bʼan
likewise	ax ikx
line	sqit
Lingala	Lingala
link	enlace
lion	q'eq ti'witzb'aj
liquid	t´al
listen	b´in
listening	b´il
literally	ikjxexje
literature	u´j
litter	tz'is
little	b´otz´
live	chwinqlal
liver	saseb´
lives	chwiqlal
living	chwiqlala
living room	jaa
lizard	ayin
lizard	a'yin
load	Iqatz
loaf	twamo´s
loaf	xb´ukwa
loaf	tx´i´l
loan	tx´ex
loan	ch´exb´aj
loan	ch´ex
local	tembʼil
location	jatumel
lock	jpul
lock	jpun
lockdown	oʼkx tiʼj jun
log	qtzʼibʼinkux tqanil
lol	tzeb´el
lonely	tjunix
long	xji'l
long	xqin
long	qini'ch
long time no see	tzma xq´iltla
look	kayil
loop	bucle
loose	jaw
loose	tza'qil
loose	tza'q
lord	iichin
lose	tz´aqil
loss	ma qe tz'aq'
lost	ma tzaj
lost	xol
lot	nintz´
loud	nim twe'
loud	matij twe'
loud	nimtwe'
lounge	nim ja
love	laq´jil
love you	in chin laqe tija
lovely	qaj ti´j
low	ch'in
lower	chi'n ta'l
loyal	jun xjal leal
loyalty	qʼuqbʼil kykʼuʼj.
luck	tb'anel tunju
lucky	b´a´namaj
Luganda	Luganda
luggage	tiq´ina
lump	tanaj
lump	iqtz
lunch	w'al
luxury	tbʼanel
lying	mib´e yolen tuk´e twutx
machine	kxb'il
mad	tzkaj
mad	tx´u´jwi´
madam	qtxu
made	b'a'nmaj
magazine	chik´xim
magnificent	b'anxex
maid	xjal misol tz´is
main	winaq
maintain	k'ayilte
maintenance	kayb´etz
Maithili	Maithili
major	winaq
majority	chʼixmi tkyaqil
make	b´inchal
make up	tok te
male	tman
mall	nimin k´ax
Mam	toj qyol
man	ichin
man	chan
manage	akja´yil xnaq´tzb´il
management	b´inchel
manager	xjal yekel jotx
mandatory	aq´un
manifest	q'amanxe
manipulate	chq'ol
manner	tumel
manual	uʼj
many	nim
march	toxjaw
margin	margen
market	k'ayb'il
marriage	mjeb'in
married	mejeb´li
mask	potzb'il wutz
mass	q´otj
massive	txqan
master	xnaq´atzon
master	nejenel aq´untl
master	xnaq´tzal
match	saqchal
mate	tuk´il
material	aq´unb´il
math	ajlab´ilxix
matter	Iltij
maturity	ma q´qnix
may	kb´entil tuna
maybe	qapa
maybe	qaj
me	weye
me too	ikyx we
meal	wab´aj
mean	tzelpuna
meaning	ti tz´elpuna
means	ti tz'elpuna
meant	a taq´ xi tman
meanwhile	extzen
measure	mlol
measure	malil
measure	échat
measures	malb´il
meat	chib´j
medical	q´anil
medicine	q'anb'il
meditation	b'isil
medium	xol
meet	chmolte
meet	ch´uqil
meeting	mujb´el xjal
Meiteilon	Meiteilon
melt	yulj
melt	niwjsal
memories	n´al
memory	nab´b´il
mental	txubʼtxaj
mention	q´malte
mention	q´manxa
mentioned	ma tzaj q'man
mentor	xnaqʼtzbʼil
merchant	k´ayil
mercy	uʼn tjapun
merely	tuʼntzunju
mess	mya b´a´n taye
message	q-yol
messy	nya txolb´i´n
messy	xitli
messy	sputin
metal	kxb'il
method	txilnen
mice	ich'
middle	niky´aj
middle	niky´jin
midnight	tkuj aq´b´il
might	ku tz´u lo
mild	cheb´e
milestone	amb'il
military	txa'x xjal
milk	ta'l imaj
million	millon
mind	nab´l
mindset	b'is
mine	weye´
mingle	smol
minor	b´otz
minute	minut
minutes	minut
miracle	bʼaʼn kyuʼn
mirror	ka´witz
mirror	xpejs
mirror	kayb´iwitzb´aj
miscellaneous	k'loj
mischievous	tiptaj
miserable	mya b´an t-chwinqel
misery	mebʼayil
miss	b´isil
miss you	chin bisine tija
missing	ma qe tzaq´
mission	tiʼ in bʼant kyuʼn
mist	q'aqmujil
mistake	q-paj
Mizo	Mizo
mobile	celular
mock	xniky´b´il
mock	knol
model	yekʼbʼil tiʼj
moderate	kawil
modern	ja'lin
modest	me's
moist	Ak´l
moist	ob´ob´j
moisture	xb´umb´uj
mold	poj
mole	q´eq´al
mom	nan
moment	amb'il
monday	xjaw
money	pwaq
monkey	max
month	xjaw
mood	ipumalj teya
moody	lo'chil
moon	txu xjaw
moral	b'is
more	q´otzl
moreover	ikx tz´unj
morning	ch´ubil
morning	nchi´j
morning	najchi´j
mortgage	k'as
most	nintz'
mostly	te tnejil
mother	txub'l
mother	txub'aj
motion	yukchil
motivation	sak'sil
mountain	pink'ul
mountain	chik'ul
mountain	k'ul
mouse	ich´
mouth	tzib'aj
move	yukchuil
move	yekil
movement	yekil
movie	txumakb'
mrs	xu'j
much	nim
mud	xoq'l
mug	jar
muscle	ch´ib´aj
mushroom	xul
mushroom	tx´yol
mushroom	xwich´
music	chnab´
music	twi´chnab´
must	b'inchanxa
mute	q'ol nakb'il
mutual	ikxje te junjen
my	weye
my friend	a ju quk'ila xb'oj
my love	a waje
my name is	awe nb´i
myself	ayiin
mysterious	chal yol
mysterious	nik´al yol
mystery	ewan
myth	noqxyol
nail	xky´aqb´aj te´sb´il
naive	xnak
name	b´ib´aj
narrative	tx´olb´il
narrow	jutz´
narrow	twitz
narrow	much´
nasty	juntij tzu´j
national	tnam
nationality	tanmiyil
native	te jaxex
natural	ttenkuxjo
nature	qtxu' tx'otx'
nature	twitz tx'otx'
nausea	xab'
near	naqa
near	naqayin
near	naqa´yin
nearby	naq'ak'u
nearly	junilni
neat	tb´anel
necessary	iltij
neck	qul
neck	q´ub´aj
necklace	uyj
need	qaj
negative	ch'u'xil
negative	ewin
neglect	xi xik'ayin
negotiate	k'ayil
neighbor	xjal ajlaj
neighborhood	kojb'il
neither	mi´ne
nephew	witzine
nerd	mas bʼaʼn
nervous	xob´ajil
nervous	tchwil
nest	paqb'il
nest	q'u'
net	saq
network	xyub´
network	pa
neutral	junx
never	layx
never give up	mixi qe tzaqpina
never mind	xlek'uj
nevermind	nya´ iltij
nevertheless	extzen
new	ak´aj
news	ab'ax
next	juntl
next to	junx tuk´il
nice	Tb´anil
nice to meet you	tzen tayey
niece	witz´ine
night	qoniky'an
night	aq'b'il
nightmare	xob'sil qwatl
nine	b'elaj
nineteen	b´elajlaj
ninety	kyjk´al laj
No	Lay
no problem	mi´ b´isen
no way	xix jun tumil
nobody	mixti
noise	chkyimb´il
noisy	chkyimb´il
none	ni junjun
noon	wanq'ij
noon	chilka qij
noon	chilqij
nope	mixti
nope	minti tla
normal	ikja
north	jawnix
nose	txa´nb´aj
nostalgic	b'is
not	lay
not	minti
not	tla
not at all	xite'
not bad	b´ante
Not now	lay jalin
not yet	namx
note	twi chnab´
noted	ma kux tz'ib'it
nothing	xtix
notice	kayil
noticed	ma tzok tayina
noun	kyaqil b´ib´aj
noun	jiq´chal
nouns	kyaqil b´ib´aj
nouns	jiq´chal
novel	saq
november	tjunlaxkaw
now	jalin
nowadays	ja lin te q´ij jalin
nuisance	snak
null	mya wen
numb	sk´an
number	tajlal
nurse	onil ajq'anil
nut	jumil
nut	sutjitz´
nutmeg	ch'ilil
nutrition	k'ach'il
oath	jun yol toj tbʼi dios
obesity	xtob´
obesity	xb´o´w
obey	nimb´il
obey	nimal
object	sipb´al
objective	tkb´antel
obligation	txi b´inchet
obscure	q´lolj
observation	k'ayil
observe	k´ayilte
obsessed	taj ti´j wen
obsession	obsesion
obsolete	asb'en
obtain	tun t-jyet
obtained	kykʼamoʼn
obvious	iktzen
obviously	iktzen
occasionally	mya jotx q´ij
occupation	mi´ amli
occupied	nya ambli
occur	na b'aj
occurred	ma b'aj
occurs	in b´aj
ocean	kub'ni plow
ocean	jawni plow
october	tlaxjaw
odd	alkayela
odds	nya mikxe
of	te
of course	iktzen
off	yupil
off	yupan
off	yupin
offensive	nach
offer	q-loq´ barat
office	ja jatumel
official	aju axix
often	junjen maj
Oh	tib´aj
oh really	ax
oil	aseyt
ok	b´anatz´un
ok dear	b´a´antz´un
ok honey	kutzin k'ujlab'il
ok my love	kutzen
okay	b´anatz´un
okay baby	b´ana tzun nex
okay dear	kutzen
okay honey	kutzen
okay my love	kutzen
old	ojtxi
old	xjoq´
on	toj
once	ju maj
one	jun
one language is never enough	qa nim yol b´an
onion	sb'oy
onion	xnakite
online	kub'ku
only	t-junilx
only	jiq´ijil
open	jaql
open	jqle
open	jqo´n k´ab´li
operation	operacion
opinion	t-b´isel tib´aje lo
opportunities	anb'il
opportunity	anb´il
opposite	tmaqb´il
optimistic	tbʼanel
option	toj tumel
optional	onbʼil lu
or	moqa
orange	lanch
order	txolb´il
ordinary	chi ma ik'x
organization	chemb'l
orientation	qmal nab'il
origin	tlok´
original	axixju
Oromo	Oromo
orphan	meb´a
orphan	yaj
orphan	b´eyb´il
other	juntl
otherwise	me mya lo
ought	jaku tzʼoknin
our	qe
our	qeya
our	qe´y
Our mission: to enable everyone, everywhere to understand the world and express themselves across languages.	aju q'xime: te q´kaq´il tun tok ojtzq´et twitz tx´otx´ex tun txi qmet toj alux yol
Our mission: to organize the world's information and make it universally accessible and useful.	aju q'xime: tun txi q'mete toj nuk'un te tnam ex t'un ko'k te ajb'en
out	ex
out	exil
outcome	tuʼntzunju
outfit	ijb'aj
outgoing	ma tz'el
outlet	tzexa tzala
outline	q´amalte
outside	pen
outstanding	jawil
outstanding	tx'aql
outstanding	tx'aqle
oven	jorn
oven	wosb´il
oven	tz´i´lsb´i´l
over	tibaj
over there	chixa
over there	tzachi´n
over there	chix
overall	k´aq´il
overcome	tikʼx
overthinking	b'isil
overwhelmed	n-qo ja ka´yen ti´j
overwhelming	tq'optz'an
owe	k'as
owl	tukru
own	weye
owner	tajwil
ox	tman wakx
pace	tiky'xil xjal
pack	n-a
package	b'otz'
paid	choj
paid	chojb´il
pain	k´ixk´o´j
paint	uk´sil
painting	tk'wa'
pair	kab'
pale	smuq´in
palm	xa'j
pan	pan
pandemic	pandemia
panic	xob'jil
pants	wexj
paper	uj
paradise	tbʼanel najbʼil
parallel	mujtten
parcel	nim awal
pardon	ko'pil
parents	mamb'aj
parents	manb'aj
park	park
parrot	tnuq
parrot	tnuqil
parsley	rejil
part	q´esin
participate	yek´il
particular	ikxje
particularly	particularmente
partner	quk´e
party	nimq´ij
party	ninq´ij
pass	iky´tz
pass	iky´
passage	iky'
passed	ma tz´ik
passion	qa tun t-b´ant
passionate	txqan
passive	tuq'li
password	tal ja
past	ma k´ej
patch	xb´uqb´il
path	b'e
pathetic	mya wen ka´yen
patience	noqx samel
patient	yab´
pattern	nejinil
pause	yoma
pavement	ttxa´nklab´
pay	choj
pay	chojb´il
payment	chjol
peace	nak´i´l
peace	numb´il
peace	txub´txaj
peaceful	mintiʼ in che qʼojin
peach	trasni
peach	trasin
peach	taxan
peak	tuk´b´il
peak	twi´ittzi
peak	tz´i
pear	jaxab lob'aj
peas	chenaq'
peculiar	aju in bʼant kyuʼn
pee	tz´a´lil
peel	txk´omil
peer	tuk´il
peers	t-xb'oj
pen	tz´ib´ab´il
pencil	sb'qtz'ib'b'il
pending	na´m
people	xjal
pepper	pimient
perceive	ximil
perception	tzen n-xi q-kayen
perfect	b´a´n
perform	b´inchalte
performance	yek´el
perhaps	qapa
perhaps	qaj
period	amb´el
permanent	n-kij
permission	permis
permit	amb´il
perseverance	tbʼanel techel
persistent	te jumajx
person	xjal
personal	aq´anal
personality	xjalil
perspective	kayet
persuade	b´inchel tun ky-ni´men
pervert	nach
pet	alu'maj
phase	amb'al
philosophy	txunab'il
phone	yolb´il
photo	tilb'ilal
phrase	yoxchi'
physical	xmilal
pick	sik´olte
pick	tzakj
pick up	tun t-yet
picture	tilb´ilal
piece	taqiky´
pieces	tmojchaq´
pig	b´och
pigeon	xkawaste´
pigeon	xu´ch
pile	k´loj
pile	job´an
pillow	q´axweyj
pilot	yekil
pilot	choqol
pin	b'aq
pineapple	matzjti'j
pink	b'ech
pit	jul
pitch	matz'k'
pity	q´obaj
place	tenb´il
places	k'ayb'il
plague	kʼixbʼisabʼil
plain	twutz tx´otx´
plan	nuk´il
plane	k´xlip
plant	k´ul
plants	k´ul
plate	techil totx´
play	saqchal
playing	saqchal
pleasant	k´ok´j
please	bichanxa Xtalbil
pleased	k´uw
pleasure	k´okj
pledge	tuʼn tbʼant jlu kyu
plenty	nimxix
plot	anq'ib'il
plug	xikyb´txaqb´il
plum	chky'anan
plumber	b'inchil tub'
plural	nimsal
podcast	nchi yolin
poem	pakab´
poetry	pakab´
point	t´ak
poison	venen
police	xq'uqil
policy	kawil
polite	ponex xjal
pollution	yajel tx´otx´
pond	matij pil
pool	piscina
poop	txa'
poor	meb´a
poor	yaj
pop	laq'in
popular	jotx wutzqilte
population	tnam
pork	b´och
porridge	sqal
port	tziplow
position	tzen tayey
positive	qo b´isen b´a´n
possess	etzil
possession	etzal
possessive	lak'in
possible	iktzen
post	chik´b´a´n
postpone	toj jumajtil
potato	sq´al
potential	tipumal
pound	ka'yla'j
poverty	yaj
poverty	b´eyb´il
power	tipumal
powerful	kumil
practical	nya kwest
practice	b´inchal
praise	jun yol b´an ti´je
prank	yaq
pray	naʼn dios
precious	b´anil
precise	ikja
precisely	ikyjo
predict	q'mal
prefer	qa tajb'ila
pregnant	nya b´an
pregnant	ch´onwi´
prejudice	xmayil
premises	ja jatumel
premium	tb'anel
preparation	b'inchet
prepare	b'inchalte
prepared	b´inchan
presence	ktel
present	jalin
presentation	yekbʼil
preserve	k´ulte
president	nejenel
press	yiq´ob´il
press	b´etz´b´il
pressure	tipomal
pretend	taj tun tok
pretty	tb´anil
prevent	ka´ayil ti´j
previous	nejtil
prey	tzyu'n
price	twi
pride	nimaltib'
priest	ajb'ech
primary	txexnaq´tz
prime	winaq
principal	winaq
prior	nam taq
priority	iltij
prison	jpub´il
privacy	okx qe tajwil
private	te tajwi
privilege	tbʼanel ambʼil
prize	chojb´al
prize	kotzalalb´il
probably	kab´ale
problem	q´oj
procedure	ja ma tzaje
proceed	kxel b´inchet
process	qe tqiky´
produce	b´nchalte
product	k´ax
production	b'ichal yekil
profession	in che aqʼunan
professional	ajb´inch
professional	aju´j
profile	plaj
profit	kanb´ab´il
profound	txe'
progress	ch'iysb'il
project	aqʼuntl
prominent	q´anchal
promise	kxel q-b´inchen
promote	n-jax
promotion	k'loj
prompt	junratx
prone	nya kwest tu'n
pronouns	xelb´ib´aj
pronouns	txelb´ib´aj
pronunciation	qʼamanxa qe yol klarxix
proof	niky'b'eb'il
proper	b´a´n
properly	qe
properties	tajwil
property	iltij
proposal	txi yek´et
prosperity	tzalaj
prosperous	qʼinin
protect	k´ayil
proud	tjonk´u´
prove	yek´b´il
provide	q'olte
provided	ma tzajtq'on
province	kojb'il
provision	amli´
puberty	kuʼxin
public	qexjal
public	te kyaqilx
pull	xo´l
pumpkin	mukin
punctual	toj amb'il
pupil	xnaq´tzanjtz
purchase	loq´aj
pure	sjanen
purpose	Tikb´antel
purse	tb´el pwaq
pursue	joyil
pursue	jyol
pursuit	joyil
pursuit	jyol
push	lamo´n
push	jpu´n
put	qolte
qualification	tajlal xnaq'tz
quality	t-kayb´ajtz
quantity	tqan
quarantine	qokx jpet
quarrel	b'uj
quarter	te kyaje
Quechua	quechua
queer	ti tzun la
query	jyonkuxa
question	xjel
queue	tje
quick	q´ela
quick	q´exa
quick	ojq´ela
quickly	ojqel ch´intl
quickly	ojqel
quiet	chu´chil
quilt	watb'il
quit	leb´il
quite	nim
quiz	yek´il
quotation	b'il twi'
quote	b´il twi´
quotes	b´il twi´ kax
rabbit	xiky
race	rinel
rage	ttx'u'jil
rain	xb'al
raise	matijset
raised	ma jaw twi'
ran	ma rinin
random	noq ja
range	jaxex
rapid	jalinxix
rapidly	oxqelx
rare	alkelaya
rare	bisil
rarely	mya jotx maj
rash	aq'unal
rat	ich´
rate	t-wi´
rather	te txel
ratio	tiʼ toklen
rational	mas b'an
raw	cha'x
re	re
reach	kanol
reach	xikan
reach	se´l
reached	ma k´ub´tij
reaction	tmod
read	aj-u´j
reading	ujil
ready	ma qo b´ant
real	twutx
reality	ikja
realize	kayinxa
realized	ma ti la
really	iktzen
rear	xo´pj
rear	xo´pb´aj
reason	txolil
reasonable	ximil
recall	nalte
receipt	ma tz´okx
receive	k´amol
received	ma tzok k´amona
recent	etzqeku
recently	tzma x-b´aj
reception	ttziʼ
recipe	tu´jal
recipe	q´anb´il
reckless	nti txob´el
recognition	toklen
recognize	niky'tzil
recommend	o´qxenil
recommended	oq´xenil
record	ni juntl o japen ti´j
recover	tten juntl maj
recovery	ma tz'ajtz
rectangle	xqin
rectangle	xqinswej
red	k'eq
redeem	tx'exb'il
redemption	kyanmi
reduce	much´jsal
reduce	nuchsal
redundant	axjo
refer	tun txi q-sma´n
reference	b´ilte ti´j
reflect	yekʼbʼil
reflection	ximil
refrain	yoma
refrigerator	cheysb´il
refund	q'ol tx'el
refuse	ik'il
refused	ma tzel ik´in
regard	ti´j
regarding	el q´ib´aj
regardless	extzen ikje
regards	q´olb´el
register	in tzaj kyqʼamaʼn uʼj
regret	tzul toj tk´uja
regular	b'a'nx b'a'n ch'in
regularly	kukxjo
reject	ik´il
relate	kyqʼamaʼn
related	tok ti´j
relationship	tuk´e
relative	relativo
relatives	witzel
relax	qo lajen
release	tzaqpil
release	tz´loja´
released	me tzel k'opin
relevant	iltij
reliable	q´uqb´il k´u´j
relief	b'a'nnixix
relieve	q´amalte
relieved	q'anin
religion	okslab´l
religious	okslal
reluctant	jun lu´n reacio
rely	q´uqk´u´jil
remain	axtz'u tenkuya
remaining	ch'intl
remarkable	q'anchal
remedy	ti'chaq
remember	k´u´jlal
remind	n´al
reminder	nalte
remote	n-qo manejaren ti´j naqche
remove	yekil
remove	yukchil
render	majil
render	majnal
rent	majil
repair	saqsan
repeat	kyq´amantza
repeat	kyxnik´b´entza
replace	txel
reply	tz'aq' wel
report	n-tza t-q´man
represent	xel
reputation	q-b´ijte
request	q'anilte
require	wajb´le
required	q'anilte
required	iltij
rescue	klet
research	qe ajxpich'il
resemble	chi ma ikx
resentment	q'oj
reserve	ab'tzil
resident	te tzalu'n
resign	il tiʼj tuʼn tkyaj ttzaqpiʼn
resilience	tjaw weʼ t-xima
resilient	tipumala
resist	nik'x
resistance	ntipa
resolution	tzen kxel b´inchet
resolve	t-xi kybʼinchaʼn
resort	tb'anel ja
resources	nim at te
respect	nimb´il
respond	tzaq´wel
response	tz'aq'wel
response	tzaq'wel
responsibility	matoklen
responsible	xjal b´an b´isen tun t-b´an tu´n
rest	ojlal
rest in peace	chab´a tz´ojlan
restaurant	nimwab´il
restore	k'awil wab'j
restrict	mi tun toktz
result	t-pak´b´al
results	tuʼntzunju
resume	taltqanil
retail	jun netz´ k´ayel
retain	tzyuma
retention	wab´il
retention	wa´lb´il
retreat	retiro
retrieve	tten juntl maj
return	meltz'il
reveal	q'malte
revealed	ma txi tnam
revenge	t-xel
revenue	k'anb'abil
reverse	tijxi
review	k´ayilte
revise	k'ayilte
revision	k'ayilte
revolution	chʼixpubʼil
reward	chojb´al
reward	kotzalalb´il
rhythm	ajqelil mo cheb'a
rib	xuk´b´aj
rib	tchil
rib	xu´k´b´aj
rice	saqji'l
rice	saqtriy
rich	q´inon
rid	tzaqpil
ride	wa'b'il
ridiculous	q-tzeb´el
right	b´an
right now	jalin
rigid	kuj
ring	xmilq´ab´aj
ring	xmilq´ob´j
rinse	numsil
riot	wulil
rip	laqin
ripe	q´an
rise	jax toj kya´j
risk	nya bʼaʼn
rival	ajq´oj
river	a´
road	b´e
roast	tx'ilin
robust	ma'
rock	ab'aj
rod	tze
role	role
roll	tolu'j
roof	yek´b´itz
room	toj ja
root	tloq'
root	txe'
rope	ech
rotten	q´anaq
rotten	q´aynay
rough	xnak´
roughly	ma'xpa
round	t´ol
route	b'e
routine	axju b'inchet
row	txol.
rub	tok´tz tib´aj
rubber	xqechb´il
rubbish	tz´is
rude	kuj
rug	b´etb´il
rule	jikyb'il
ruler	jikyb´il
rules	tal kawb'il
run	qelaj
run	rinil
run	qelan
running	qelaj
running	rinil
running	qelan
rural	toj aldea
rush	ch'akajlab'il
sack	ch'u'x
sack	ch'x
sacred	xjan
sacrifice	tun txi oyet
safe	axix
safe flight	q'uqil tk'uj
safety	xq'u'q'il
sage	qawaj
said	ma tma
sail	aja'yil
sailing	aja´yil
sake	b´an
salary	twi´ k´u´j
sale	k'axjil
sale	k'a'x
salmon	kix
salt	atz´in. atz´an
same	ajxu
Same here	ikx tzalan
sample	yekb'il
sand	tz´awin q´uq´
Sanskrit	Sanskrit
sarcastic	yolb'il
sassy	atrevido
sat	ma kuqe
satisfaction	ttzalaja
satisfied	ma noj
satisfy	k'ok'j
satisfying	qeb´ni tk´u´j
Saturday	qaq´ij
savage	te ch´um
save	k'u'lte
save	k'u'l
saw	ma til
say	chitzan
say	q´amal
say	chi
scale	t-we´
scam	ma k´u alq´an
scar	tiky'len
scarce	ch´in
scared	xob'il
scared	sik´pul
scarf	potzb'il q'qul
scary	xob´el
scattered	chitil
scene	txokbʼil
scenery	chʼixpubʼil
scent	k´okj
schedule	amb´el
school	tja xnaq'tzb'l
science	xnaq´tzb´il kyten xjal
scientist	ajnab'xix
scientists	sjnab´xix
scissors	ch'ers
scold	ilil
scold	wulil
scope	tpon kanin
score	taq'b'il
scrap	tz'is
scratch	skyet xkatil
scream	sch'il
screen	tilb'ilalb'il
screw	klawo
script	wa´b´il
sea	plow
seal	tipun
seal	otx´
search	joyb´aj
season	xkotzb'il
seat	q'ajtz
second	tkab'
secret	jask'ul
section	k'loj
secure	axix
security	xq´uq´il
see	kayil
see you	qa q'ib'
see you later	qa wila nej
see you soon	qa wila nej
see you tomorrow	qa wila nejchij
seed	ijaj
seek	jyol
seem	chi ma ikx
seems	chi ma ikx
seen	ma ku k'ayin
seize	k'wal
seize	k'al
seldom	junjin maj
select	jk'ol
self	xilen
self	a
self healing	kykʼujlabʼil
selfish	xk'a
sell	k'ayilte
sell	k'ayil
send	q´olte
send me your picture	q´ontza jun tilb´ilala
senior	qman
senior	tat
sense	bab'il
sense	tzeb'il
sensible	kub' tna'n
sensitive	nxi q-sentiren
sent	ma xtx´i
sentence	txolyol
sentences	n'ajl dios
separate	pa'n
separate	pa'in maj
Sepedi	Sepedi
september	tb´exjaw
series	q-kayb´el
serious	axix
seriously	twitzxix
serve	ajb´el
service	ajb´el
session	amb'il
set	tkub´
setting	tx´uk´
settle	qeyb´etz
seven	wuq
seventeen	wuqlaj
seventy	oxk´al laj
several	txqan
severe	kuj
sew	tzol
sew	slepil
shade	lek´in
shadow	tewin
shake	qusb'il
shake	chtol
shall	ma txi ya atz
shallow	b'otz txe
shame	ch´ixb´il
shame	tx´ixwa
shame	tx´ixaw
shape	tten. txolb´al
shape	nak´ul
shape	tz'an tten
share	oyil
share	etzat ti´yax
sharp	kchil
she	a
she has	a ti te
she is	a
shed	kyja chej
sheep	rit
sheet	tx´an uj
shelf	yek´b´il k´axjel
shell	i'jb'aj
shelter	pa´til
shelter	ewil
shelter	kolb´aj
shield	txo'w
shift	tokex
shine	qopil
ship	nim tib´aja´
shipping	q´ol
shirt	kamixay
shoes	xjab´
shoot	xol q'aq'
shop	k´ayil
shopping	loq'il
shore	mlaj
short	xtok´
short	xkut
shortage	chin
shot	sqach tzaq´
should	tu´ntle
shoulder	semu´l
shoulder	semiil
shout	xch'il
show	yek´il
show	yek´al
show me	yekintza
shower	txi su´l ti´b´
shrimp	txo´m
shrink	k'oli
shut	jpulte
shut	jpul
shut up	numek´uya
shy	tx´ixb´el
sibling	itzikyb´aj
sibling	Atzikyb´aj
siblings	xib´an
siblings	wanab´e
siblings	anb´aj
sick	yab´
side	txlaj
sigh	b'sil
sigh	jiq'chil
sight	kayb'il
sightseeing	pasialil
sightseeing	b'til
sign	sqitil
signature	sqitil
significant	tilel
silence	nakb´il
silent	nakb'l
silent	xur
silk	chub'
silly	xnak´
silver	t'ab'
similar	ch'i ma ik'x
simp	xnak
simple	noq
simultaneously	ax ikx
since	axix toj
sincere	axix
sincerely	axix
sing	b'itzil
singer	b´itzil
single	n-junale
sink	tkub´il a´
Sir	qman
Sir	tat
sister	anab´
sister in law	b´alak
sister in law	b´aluk
sit	q´ek´uya
sit	q´uqli
site	k'a'yb'il
situation	tzen tayey
six	qaq
sixteen	qaqlaj
sixty	oxk´al
size	jni twe'
skill	junpaqx
skills	junpaqx
skin	chib'jil
skinny	slak´
skinny	slenk
skip	t´ikypajil
skip	t´ikypaj
skirt	mutz´amaj
sky	kya´j
slave	yajin xjal
sleep	tal
sleep	wtal
sleep	ktal
sleeping	tal
sleeping	wtal
sleeping	ktal
sleepy	yolok´ watle
sleeve	tq'ob
slice	nik'jen
slide	q´itil
slightly	cheb´e taj
slim	slik'
slim	slak'
slip	ma ja q'itj
slope	tzaqʼwet
slot	jul
slow	chab´a
slowly	chab´a
small	mux. nuch
small	b´o´s
smart	q´tik´
smell	siqil
smile	tz´e´l
smoke	sich´il
smooth	chab´a
snack	tchi'
snail	xjul
snail	xleky
snake	kan
snap	pa'l
snow	ch'ew
so	Yajtzutz
so cute	tb´anil
so far	chaq´
soak	aktzan
soap	q´eq
sober	mya k'walq'e'n
soccer	xpo'tzil
social	ch'uqxjal
society	ja otoye
socks	ma'l
soft	chab'a
soft	tu'nxtib'
soil	tajq´xjab´
sold	k´ayin
sold out	siktenil
sold out	mixitl
soldier	pint
sole	o´kx
solid	xpint
solid	ajq´oj
solution	n-xi q-b´inchen tun t-b´ant jun lu´n
solve	jyol tumel
some	junjun
somebody	jun qe la
somehow	ikyjo
someone	a tix juntl
something	jun lu´n
sometimes	atmaj
sometimes	wechaq
song	b´itz
soon	chinxtil
sophisticated	b´an yeken tib´
Sorani	Sorani
sore	n-cho´n
sore throat	chun
sore throat	ky´ixk´aj q´ulle
sore throat	chunaq. chumb´aj
sorrow	b'isb'il
Sorry	najsama
sort	nik'ul
sought	joyb´aj
sought	injyojtz´
soul	anmi
soulmate	xjal ikxje tzenku awe
sound	siqmal
sour	tx'am
source	kuj
source	kyiw
source	kaw
south	tajatz ta´w
space	temb´il
spam	jun correo mya wen
span	tipaj
Spanish	kyol mos
spare	ma qe ch´in
speak	yolil
special	Tb´anil
species	tk'ujil
species	wiq
specific	axexje
spectacular	ka´yb´itz
spectacular	kib´itz
spectacular	yek´b´il
speech	yolina
speechless	mixti nyolin
speechless	ti nyolin
speed	tzʼok tilil
spell	q´mal
spend	nojsal
spend	najsal
spent	ma ku b'aj
spicy	yab´
spike	le'ch
spin	sutil
spin	sutlal
spirit	xewb'aj xjan
spit	tzub´il
splendid	tb'anel
split	palte
spoil	chajilte
spoiled	nq´ayj
spoon	talpak´
spot	t'ak
spouse	xu'jilb'aj
spouse	xu'jlal
spread	loqj
spring	b´echq´ijil
square	swe'j
square	kyajb'utx'
squeeze	sikte
squid	cheb´e
squirrel	ku'k
st	klab´
stab	pejk'il
stable	tbʼanel
stack	tkub´il a´
staff	xjal aq'anal
stage	yek'b'il
stain	b'etel
stairs	yotx
stake	yek´il
stalk	lol
stall	tu´n
stall	te
stand	wa´l
standard	junil
star	che´w
start	qe'l
start	ajet
start	qetsal
started	ma txi q´e
starving	ma k'im tun q'aq''in
state	nimtam
statement	q´mal
station	xkotzb'il
statue	ib´ilal
status	tzen taye
stay	junx tenkuya
stay safe	q'uqil tk'uj
steady	toj tbʼanel
steak	chi'b'j k'asin
steal	alq´amaj
steal	alq´al
steal	elq´an
steam	xb´akix
steel	k'uxb'il
steep	toj tzaj
stem	itz'jil
step	iky´tz
stick	mijajech
stiff	kyaqluk'k'aj
still	loqey
sting	ch'i'o'n
stingy	xk´a
stir	smol
stock	i´tz´
stock	chwiqlal
stolen	alq'amaj
stolen	elq'an
stolen	alq'a'n
stomach	tz'on
stomach	k'u'b'aj
stone	abj
stood	tenb'il
stool	txa´
stop	wab´il
stop	tzuy
storage	k'ulte
store	kulte
storm	nimxix jb'al
story	aju tqʼama
stove	k'achb'il q'aq'
straight	txuk
straight	txulin
straightforward	tz´inintij
strain	jun cepa
strange	alkayela
stranger	chin bisine
strategy	tumel
straw	ch´um
straw	ch´in
strawberry	xwis
streak	sq'it
stream	taq'il xqoptzaj
street	klab´
strength	ajmaq
stress	sik´ten
stretch	q´inil
strict	jun xjal b´an kayen tij amb´el wen
strike	qo ku we´
string	xpotx´in
strip	xonxa
strive	jya'tz
stroke	n-tza lipen
strong	kuj
strong	kyiw
strong	kaw
struck	k'ixb'
structure	tzen kxel b´inchen
struggle	q´onka tilil
struggling	jya'tz
stubborn	mib´in
stuck	maqe q´et
student	xnaq´tzanjtz
study	u´jil
studying	u'jilil
stuff	lu´n
stunning	qo ja ka´yenx ti´j
stupid	xnak
stupid	xkonk
stupid	qejil
style	tq'anb'ech
subject	qman
subject	xjal
subject	txu
submission	q´ol
submit	chq´ol
substance	aju
substitute	xelb'aj
subtle	cheb´e
succeed	t-xi tqʼoʼna tbʼanel
success	tel b´aj
successful	ma b´ant
such	ikje
such as	s'en xju
suck	tz´ub´il
sudden	inan
suddenly	qaxku
suddenly	mixininj
suffer	ma k´uch´aj
suffering	yajiltib'il
sufficient	okxju
sugar	ch´iysb´il
suggest	jun q-yol
suggestion	jun nab´il yol
suit	xb´alamb´alil
suitable	t-b´an t-b´inchet
suitcase	iq´ijtz
summary	talqan
summer	q´ijal
summit	witz
sun	q´j
sunday	Domindo
sunny	q'ij
sunset	q'ale
sunshine	q'ij
super	nim
superior	tibʼaj
supervisor	nejenel
supper	w´al
supply	tun tok
support	mojel
suppose	nchiye
supposed	kubʼ kyximen
sure	ax
surface	tib´aj
surge	chʼiy
surgery	jqol xjal
surname	k'olil
surprised	kyimen
surrender	xi tqʼoʼn tibʼ
surrounding	wa'b'il
surveillance	xq´uqal
survey	kayel qi´j
survive	xa´wan
suspect	okslal
suspended	kawil
suspicious	k´uj a
sustain	tz'yul
sustainability	tzi´yal
sustainable	txokal
swag	chunxjab'
swallow	b´ilq´ul
swap	qo tx'ixpun
swear	jurar
sweat	mujk´aj
sweater	ta'yil xmilalb'aj
sweep	tz´isol
sweep	tz´isil
sweep	misol
sweet	chi´
sweet dreams	chi´twatla
sweet dreams	chi´ q´ajt
sweet tooth	liq´
sweet tooth	tzeq
sweetheart	k'ujlab'il
swell	nmal
swelling	mal
swelling	malil
swim	chi'l
swimming	chil
swing	tik´
switch	tx'exb'il
swollen	m´al
sword	laqte
symbol	tech
sympathy	cho'n k'uj
symptoms	ti nch'iyon
system	nuk'ul ttxolil
table	Mex
table	tenb'il
tackle	laq'eb'il
tag	tu'jal pa
tail	tje
take	k ´wal l
take	K´al
take away	q´inxa
take care	ka´yinx tib´a
take off	loch´al lochi´l
taken	ma tx'iq'in
taken	ma b'aj
talk	yolil
talkative	un xjal aju noq tgan tuʼn tyolin
tall	nimin twe'
tap	makol
tape	si'pj
target	tkb'antel
task	taq´in
taste	yak'ol
taste	k'ok'jal
tasty	k'ok'j
taught	yek´ilte
tea	te'
teach	yek´il
teacher	nejenel aq´untl
team	b'yuj
tear	ta´lwitzb´aj
tears	ta'lwutzb'aj
tease	yajil
technology	saq
teeth	b´aj
tell	chitzan
tell	q´amal
tell	chi
tell me	qamantza weya
temper	tzen kyaq
temperature	ab´il
temple	tja kjawil
temporary	junjen amb´el
ten	lajuj
ten	laj
ten thousand	junch´uy jwe´q´o´
tenant	majil
tend	yob'il
tendency	saq
tender	jun ilicitación
tense	jip
tension	nya bʼaʼn
tent	ja
tentative	q'eqab'
term	b´ajsil
terms	jun yol
terrible	taq'wix
terrific	ponix
territory	n tx'otx'
test	ka´yel
text	yol tz'ib'in
than	ti ju
thank	qol chjonte
thank you	chjonte
Thank you for your patience while we investigate shipment	tzaj tqona tun qo jyone tij toqxena
Thank you for your patience while we investigate shipment	chjonte te amb´il
thank you so much	chjonte
thank you very much	chjonte
thanks	chjonte
Thanks for using our app	chjonte sajon aplicaciones qeye
that	qeju
that is	a natzun
that's good	b'a'natzun
the	a
theft	alqan
their	qeye
them	aqe
theme	tema
themselves	eyex
then	nej
theory	chinaj
there	machi´w
there	txix
there is	a ti
therefore	extzen
these	ajlu´
they	aye
they	aqe
they are	eye
thick	pin
thief	aleq'
thigh	twi´tz k´uxe
thin	slak
thin	slik
thing	lu´n
things	tx´aqan
think	ximil
third	toxin
thirsty	wje á
thirteen	oxlaj
thirty	junk´al laj
this	a ju lu
this is	ajlu´
thorough	siktenil
thoroughly	cheb'a
those	aj
though	ixqa
though	exlaqa
though	b´awtl
thought	xim
thoughtful	k'u'jlan
thoughts	xim
thousand	kab´q´o´ lajk´al
thread	noq´
threat	x'olb'tz'al
threaten	xob´ajil
three	oxe
three	ox
threshold	ja tun t-kanen
thrilled	tb'anel
thrive	tun q-q´inex
throat	qulb´aj
through	kyoj
throughout	kyxol
throw	chitil
throw	xo'l
throw	chita
thumb	tal q'ob'aj
thunder	k´inkaq
thunder	q´ankyoq
Thursday	kyaq'ij
thus	iku k´alani´
tick	q´ol techil
tide	yupaj witzb'aj
tidy	txole'
tidy	txolb'i'n
tie	xmol
tie	jitz'il
tiger	b´alan
tiger	b´alun
tight	noqxex
Tigrinya	Tigrinya
time	amb´il
tiny	chin b´otz
tip	nab'il
tips	nab'il
tire	llanta
tired	sikten
tissue	chemaj
title	tx'ilu'j
title	tb'i
to	Te
to be	tza lo
toast	tx'il wab'j
today	jalin
toddler	botz k'wal
toes	tal tq´an
together	junx
toilet	tz´alb´il
told	ma tzaj tman
tolerance	nimb'il
tolerate	nimb´il
tomato	xko´ya
tomato	xkoya
tomorrow	nejchij
tongue	aq'
tongue	aq'b'aj
tonight	ja lin te q'onik'an
too	sub´an
too	ikx
took	k'ab'aj
took	k'wa'n
took	k'walte
tool	makb'il
tools	makb'il
tooth	b'aq
tooth	steb'aj
tooth	eyb'aj
top	jawni
top	jawna
topic	b'i'yol
torn	lich'il
torture	yajil
total	jte
touch	tzyuma
tough	kuj
tour	ma b´et
toward	jayil
towards	jayil
towel	txo'wa
town	tnam
toxic	mya wen
trace	tik'len
track	pista
trade	k'yil
trade	xk'ayil
tradition	anq´ib´il
traditional	n-qb´inchen toj q-tx´otx´
traffic	txqan kar
trail	b´e
train	no´xk´ux
train	kotkotan k´uxb´il
train	tiqantib´
training	xnaqtzb´il
trait	ikja
transfer	transferir
transition	tx´xpub´l
translate	tel qnikʼ
transparent	qanchal
transport	b'etb'il
transportation	b'etb'il
trap	k'ob'il
trash	txatz´is
trash	tz´is
trauma	job'aj
travel	b´etel
tray	laq
treasure	q-tesoro
treat	txi q-b´inchen
treatment	jun lu´n n-xi b´inchet
tree	tze´
tremendous	nintz´k´u´
trend	ik tzeʼnx in kubʼ
trial	xnik'chalte
trial	xnik'chal
tried	ma chi tb´inchan
trigger	b´inchalte
trim	jol
trip	b´etel
trouble	q´oj
trousers	wex
truck	iqatzb´il
TRUE	ax
trunk	ajtz´in
trust	q´uqb´il tk´u´j
truth	ax
try	B´inchal
Tsonga	Tsonga
tube	tub
Tuesday	kaq´ij
tuition	tok letra kyiʼj
turkey	chmeq´
turn	ptz´ul
turn	paqtzul
turn	paqet
turtle	petz
tutor	ab'tzil
twelve	kab´lajuj
twelve	kab´laj
twenty	junk'al
twenty-one	junk´al jun
Twi	Twi
twice	kab´e maj
twist	sutil
twist	sutlal
two	kab´
two	kab´e
type	wiq
typical	ik tzeʼnx in kubʼ
ugly	taq´wix
ultimate	b'ajsb'il
umbrella	pa´t
unable	mnya b'an
uncle	kyan
unconscious	najnab´il
under	chin
under	chaba
underneath	tjaq´
underrated	xnak
understand	nakeyil
understand	toj twi´
understand	niky´
understood	ma chi kane
unfortunately	i´l
uniform	junelni
unique	junx
unit	tnej
university	jaxnaq'tzb'il
unknown	jun xjal ojtzqilte
unless	me qa n-ti´
until	to´jtx'io´jtx'I
unusual	myaxex normal
up	jawl
up to you	aya q´malte
update	q-resultado
upgrade	kuchil
upon	talsyap
upon	twi´
upon	yut´anmi
upset	q´oj
urban	toj t-nam
urge	ilx ti´j
urgent	noj q'elin
us	aqoye
use	oksil
used	ajb´en
useful	ajb´elil
useless	ti tajb´en
usual	naqʼli qe
usually	junjen maj
utility	ajb'eb'il
utility	ajb'alan
vacation	ojlab´il
vaccination	toch´il
vaccine	tx'ik
vaccine	tuch'
vacuum	xi toj
vague	myaxex twutx
valid	twutx
valley	semil tx'otx'
valuable	car wen
value	jte twi'
variety	chukchaq
variety	b´a´mpun
various	chukchaq
various	b´a´mpun
vary	junxichaq
vase	teb´l b´ech
vast	vasto
vegetable	k´ayil itzaj
vegetables	itzaj
vehicle	kxb´il te yekelqu
vendor	xi tq'o'n
venom	q'anb'il
venture	emrpes
venue	tzalajsb'il
verify	k'ayilte
versatile	nim nokn
version	nim
vertical	nukʼun tten
very	juntijxex
very good	b'an
vessel	bark
via	toj
vibe	q-vibra
vibes	t-lipel
vicious	aju otoq chin naqʼete tiʼj
victim	ok bʼinchan nya bʼaʼn tiʼj
view	k´ayb´il
village	q-aldea
villain	nach
vinegar	tx'am
vintage	ojtxax
violence	q´oj
violent	bʼaʼn qʼojin
virgin	txin
virtue	qʼaqʼbʼil tkʼuʼj
vision	ka'yb'i
visit	u'la
visual	k'ayb'il
vital	vital te qe
vivid	chwiqlal
vocabulary	q-yol
voice	twi´
void	amil
void	miti´toj
volume	tal
volunteer	aq'anal toj oyaj
vomit	xab´il
vulnerable	cheb´e
wage	twi' k'u'j
wages	tw´tk´uj
waist	k´itzb´aj
wait	yolte
wait	yol
waiter	majin
waiter	majan
waiting	yol
wake	ma ja k'ij
wake up	k´asil
wake up	k´isil
wake up	k´asul
walk	b étil
walking	b´etil
wall	twitx ja
wall	tapa
wall	loq'n
wallet	tkjub´il pwaq
wallet	b´o´t
wander	q´il
wanna	wajb´ile
want	ajb´il
wanted	jyojtz´
war	q´oj
wardrobe	k'ub'il b'ush
warehouse	deposito
warm	kyaq
warn	q'mal
warning	qman t-pakb'al
warrior	ajq'oj
was	ma tz´ok´
wash	tx´ajil
wash	tx´ajol
wash	txjol
waste	ik´il
watch	kayil
water	a´
watermelon	kyaq´oq´
wave	tma´lal a´
way	tza´an
way	tten
we	Aqoye
we	aqo
we are	aq´oye
we can	b'antil
weak	nya kuj
weak	xb´unin
weak	numj
weakness	nti' tipan
wealth	q'inamab'il
wealth	q'inimil
wealthy	b´an
wear	oksil
wear	ajb´en
wearing	ma ajb'enxi
weather	na´ltx´otx´
wedding	mujeb´ilin
Wednesday	ixq'ij
weed	itzaj
week	q'ij
week	wuqb'il
week	taqajan
weekend	te fin de semana
weight	al
weird	alkayela
welcome	bánkulene´
welfare	b'a'nxix
Well	b´antzun
well done	b´a´n xb´incheta
went	ma tzok´
were	ma ten
were	ten
west	toj oeste
wet	xb´u´l
whale	wo´kyix
what	tiju
what about you	ti xb'aj teya
what are you doing	Ti bajteya
what are you doing now	ti b´ajteya jalin
what are you doing right now	ti báj teya jalin
what do you do	ti baj teya
what do you do for a living	s'en nanq'iniya'
what do you mean	ti tmana
what do you want	ti tajb´ila
what happened	ti xb´aj
what is	ti tzun la
what is this	ti ju lu
what is this	ti la
what is your job	te qe naq'unaniya
what is your name	ti tb´iya
what is your name	tqal tb´iya
what's up	ti xb'aj
what's your name	ti tb´iya
whatever	tixku
wheat	a-trigo
wheel	syutb'il
when	jtojtzin
when	jtoj
whenever	jtoxk´u
where	ja´
where	ja
where	jatumuil
where are you	ja taya
where are you from	Te jayila´
where are you now	ja taya jalin
where do you live	ja taya tjaya
where is	ja
where is	jatumel tzun
whereas	tzenku
whether	oky
which	el qe
while	tze´n
whisper	yolil chab´a
whistle	xub´il
white	saq´
who	el qeju
who are you	alkeya
who is	el qe
who is this	el ke
whole	junka
whole	chwinqxix
whom	alqe
whose	tuntzen
why	taquntzun
why not	ta q´un lay
wicked	nya bʼaʼn xjal
wide	nim twitz
wide	matij twitz
widow	meb´a xinaq
width	ja n-qo okx b´aje
wife	xu'jilb'aj
wife	xu'jlal
wild	nti´ t-nab´
will	tqeq´il tkuja
willing	taj
win	kanb´al
win	kanb´il
wind	kyq'iq'
window	spiky'b'il
window	toky'
wine	su'lq'e'n
winter	jb'alil
wipe	qopsil
wire	taq'il
wisdom	b´isel
wise	b´isel
wish	ajb´il
wish you all the best	b´an teya
witch	ajitz
with	tukil
withdraw	q'imila
within	toj
without	xtix
witness	kayel
witty	xhtij
wolf	xoj
woman	qya
women	qya
won	kamb'il
won't	lay txi'
wonder	xjelil
wonderful	ponex
wood	tze´
wool	tsmal rit
word	yol
words	yol
work	aq´anal
work out	b'inchal
working	aquí
world	twitztx´otx´
world	twitz q´ijlal
world	q´ijlalil
worm	no'x
worm	xton
worn	ma ajb'en
worried	melj
worry	melj
worse	a mya b´a´n
worship	nimbʼel
worst	mya wen
worth	t-chojb´etz
worth it	q'uqil tk'uj
worthy	nim toklen
would	okle
wound	k´ixb´in
wound	ky´ixbí
Wow	Ooo
wrap	pajtz´ulte
wrath	txu'j
wrist	ti q´ob´aj
write	tzib´il
Write here	tzib´inkuya tzala
writing	tz'ib'b'en
written	tz´ib´in
wrong	ma chin qe tzaqje
wrote	ma ku tz´ib´in
yard	pen
yawn	k´ab´il
Yeah	oky
Yeah	o´na
Yeah	qa
year	ab´q´i
years	ab´q´i
yeast	yek'tz'ib'b'il
yell	sch´in
yell	sch´il
yell	woyil
yellow	xq´an
yellow	up
yellow	q´an
Yes	oki
yes baby	oky nex
yes dear	ikja txin
yes honey	iktzen
yes my love	iktzen
yes of course	b'a'n
yesterday	ewi
yet	namx
yield	tmal twitz
you	Aya
you are	aya
you are beautiful	ponix te
you are so beautiful	tb'anej te
you are welcome	mixti´x
you are welcome	nti´x
you can	k-b´entil
You know	b'il
you too	ex teya
you're welcome	mix tix
young	kuxin
your	teya
your welcome	mixti
your welcome	xite
yourself	axa
youth	k´uxin
you’re welcome	xite
yummy	k'ok'j
zero	kow
