a	settong
a little	sakunnik
a lot	benyak
a lot of	bennyak
abandon	edhina
abandoned	etorot
abide	neng-neng
ability	bakat
able	bisa
about	tentang
above	attas
abroad	luar negri
absence	tadhe'
absent	tak hadir
absolutely	se paste
absorb	nyerrep
abstract	abstrak
absurd	camplang
absurd	hèran
abundance	benyak
abundant	ce' benynya'en
abuse	eangguy tak samestena
abuse	esake'e
accent	logat
accept	narema
access	akses
accident	kacalaka'an
accommodation	akomodasi
accomplish	mamarè
accomplished	mamareh
according	menurut
account	akun
accuracy	tètèn
accurate	rapa'
accused	è sangka
ache	sake'
achieve	ngaolle
achievement	prestasi
acknowledge	ngakoni
acquaintance	pangataoan
acquaintance	èlmo
acquaintance	pangalaman
acquire	ngaolle
acquired	e olle
acquisition	ambil alih
across	alebhati
act	alako
action	kalakoan
active	aktif
activities	kagiadhân
activity	kalakoan
actor	pemain lakon lake'
actual	saongguna
actually	saongguna
acute	konco'
adapt	abiyasaaghi
add	nambeagi
addicted	kecanduan
addition	tambâân
additional	tambaan
address	alamat
adequate	cokop
adjacent	eseddi'en
adjective	kata sifat
adjust	ngator
admire	kagum
admit	narema
adopt	adopsi
adorable	lebur
advance	tingkat tenggi
advanced	canggih
advantage	kaontongan
adventure	petualangan
adverb	oca' katerangan
advertisement	iklan
advertising	iklan
advice	mainga'
advise	nasehat
advocate	se abherri' saran
aesthetic	lebhur
affair	selingkuh
affect	aberik pengaruh
affection	sifat paratèn
afford	mampu
affordable	bisa ebelli
afraid	tako'
after	samarena
afternoon	sore
afterwards	saampona
again	pole
against	moso
against	lalabenan
age	omor
agency	agen
agent	agen
aggressive	kodhu
agile	ghesset
ago	lambhâ'
agree	setuju
agreement	kasapakatan
agriculture	parcaton
ahead	eadhe'
aid	bhântoan
aim	tojjuwen
air	aèng
airport	Bandara
aisle	long longan
alarm	beker
alcohol	khamr
alcohol	minuman se bisa ma mabu'
alert	paenga'an
alive	odi'
all	kakappi
all right	sae
all the best	sakabbina kabhâgusen
allow	nga'olleaghi
allowed	ngolleaghi
almost	para'
alone	kadibhi'
along	asareng
already	mareh
Alright	enggi ampon
also	jhugan
alternative	alternatif
although	sanajjen
always	pancet
am	abdhina
amazing	loar biasah
ambiguous	agheduen makna duwe'
ambition	ambisi
ambitious	pangatero
amend	ngoba
amid	etenga
among	eantara
among us	antarana abe' dhibi'
amount	jumla
amusing	lebur
an	settong
analysis	karènaan
ancestors	bhuju'
anchor	Jangkar
ancient	konah
and	sareng
and you	tor panjenengan
angel	malaèkat
anger	ngoso'
angle	dupaddu
angry	morka
animal	keban
ankle	bungkella soko
anniversary	salametan taonan
announcement	pengumuman
announcement	aberrik oning
annoy	a ganggu
annoyed	pegghel
annoying	agenggu
annual	taonan
anonymous	tadek nyamana
another	se laenna
answer	jeweben
anticipate	agejegeh
anxiety	kakbhateran
anxious	enga'
anxious	apangrasah
any	apah phei
anymore	pole
anyone	sapa'a phei
anything	apa bei
anyway	selain gheruwa
anyways	lamon ca'-oca'an
apart	bagien
apartment	panginepan
apologize	asapora
apparent	cora'en
apparently	masena
appeal	lebur
appear	nampak
appearance	ropana
appeared	nyolbi'
appeared	dateng
appetite	èber
appetite	nafso ngakan
apple	apel
application	daftaran
application	aplikasi
apply	adaftar
appointment	jhenjhi
appreciate	ngarghai
appreciation	ngalokaghi
approach	masemma'
appropriate	pantes
approval	persetujuan
approval	edhi
approve	satuju
approved	eolleaghi
approximately	korang lebih
april	april
arbitrary	kawenangan
architect	arsitek
architecture	bangunan
archive	arsip
are	ka'into
are you	apa ba'na
are you busy	ba'na sibuk apa enjhâ'
are you married	sampeyan la akabin?
are you married or single	ba'na la akabin apa ghik parabân
Are you still there?	Apa be'na ghik edissa'?
are you there	ngèding bân?
area	wilayah
argue	abenta
argument	argumen
arise	ngombâr
arm	lengngen
army	tentara
around	sekitar
arrange	marapi
arrange	nata
arrangement	rancangan
arrival	datang
arrive	sampek
arrived	depa'
arrogant	sombong
arrow	pana
art	seni
article	artikel
artificial	palsu
artist	pemain lakon bini'
as	akadiye
as long as	saabiddhâ
as well	kean
as well as	kean
ash	abuh
ashamed	epatodus
ask	tanya
asked	e penta
asleep	tatedung
aspect	aspek
Assamese	sala settong bhâsa e India
Assamese	bhâsa Assamese
Assamese	Besa Assamese
Assamese	Assamese
assault	nyerrang
assembly	kompolan
assertive	nolongi
assess	abherri' nilai
assessment	penilaian
asset	dhunynya
assets	di'andi'en
assign	motos-aghi
assign	nettepaghi
assignment	lalakon
assist	abhanto
assist	nolongin
assistant	Panglakoh
associate	kanca
associated	se bâdâ hubunganna
association	hubungan
assume	asumsi
assumption	panganggheb
at	ning e
at least	paleng enjhâ'
ate	ngakan
ate	adhe'er
athlete	atlet
attach	cekka'
attached	etoro'aghi
attachment	pasangan
attack	nyerrang
attempt	upaya
attend	ngahadiri
attendance	kahadiren
attention	perhatian
attitude	tengka
attract	ngajhek
attraction	panajha'an
attractive	lebur
attribute	parlangkabhan
audience	oreng se nengghu
august	agustos
aunt	bhibbhi'
aunty	lek
authentic	asli
author	pengarang
author	oreng se ngarang
authority	kobâsa
autumn	mosem semi
available	badah
average	kabenya'an
avoid	ajhauin
awake	jâghâ
award	hadia
aware	enga'
aware	apangrasah
awareness	romasana
away	jheu
awesome	lowar biasah
awful	matodus
awkward	ani
Aymara	bhâsa Aymara
Aymara	Aymara
Aymara	Besa Aymara
baby	bhaji'
bachelor	sarjana
back	abelih
back	e budih
background	latar belakang
bad	jhube'
bag	tas
bait	bheni
bake	tonoh
bakery	toko rotè
baking soda	sodana jhejhen
balance	seimbang
balance	saldo tabungan
ball	ebbal
Bambara	bhâsa Bambara
Bambara	Bambara
Bambara	sala settong bhâsa e Afrika
Bambara	Besa Bambara
banana	geddhâng
band	ben
bang	monyi ranying leddu'en
bank	bank
bar	batang
barely	sakuni'
barely	jarang
bargain	nabâr
bark	monyèna patè'
barley	berres barli
barrier	se ngalangi
base	dâsar
based	dasar
basement	roang ebebe tana
basic	dasar
basically	dhessarra
basil	kamangi
bastard	bhâjing
batch	gilirân
bath	mandi
bathroom	jedding
battery	batre
battle	tokar
bay	teluk
be	deddi
be careful	tèngatè
beach	pantai
beam	balok
beans	oto'
bear	bhaung
bear	Mikol
beard	jenggu'
bearing	bhantalan
beast	keben raje
beat	mokol
beautiful	Raddin
beauty	lebhur
beauty	se raddhin
became	dâddhi
because	karnah
become	deddhi
bed	kasor
bedroom	lèncak
bee	nyaroan
beef	dhaging sapeh
been	ampon
beer	bir
beer	tuwa'
before	sabelluna
began	amolae
begin	molae
beginning	dâ adâ'na
behalf	kaangghuy
behave	atèngka bâghus
behavior	andep asor
behaviour	babatek
behind	ebudih
being	deddi
belief	kapartaje'en
believe	partajhe
belly	tabu'
belong	kaandi'
beloved	kasayangan
below	e babana
belt	sabbhu'
bench	bangku
bend	mabilu'
beneath	bâbâ
benefit	kaontongan
benefits	kaontongan
beside	e samping
besides	selain gheruwa
best	paleng begus
best of luck	samoge'e deddi pojure
best regards	salam aghung
better	lebbi bhagus
between	antarana
beverage	minuman
beyond	e attasa
Bhojpuri	Bhojpuri
Bhojpuri	bhâsa Bhojpuri
Bhojpuri	Besa Bhojpuri
bias	prasangka
biased	melean
bicycle	sepeda
bid	se e patabâr
big	rajhe
bike	sapeda pancal
bill	tagiyen
bind	nale'e
bird	mano'
birthday	ulang tahun
bit	sakonik
bite	ngengke'
bitter	pae'
black	celleng
blade	todi'
blame	nyala'agi
blank	kosong
blank	tade'
blanket	sapo'
blast	leddhu'en
bleach	e pa pote
blend	nyamporaghi
bless	a bherkat-aghi
blessed	eparèngè rahmat
blind	butah
bliss	ka bhunga-an
block	ngadhdhângi
block	bâta
blood	dhere
bloom	kembhâng
blow	leddhuk
blue	biru
blunt	tak meddhi'
board	papan
board	dewan
boat	sampan
body	badan
boil	ngella
bold	bengal
bold	tebel
bond	nyambhung
bone	tolang
book	nyewa
book	buku
boost	meceppet
booster	pendorong
boot	parao
boots	sapatu bot
border	betesan
bore	bhusen
bored	busen
boring	mabusen
born	èlahiraghi
borrow	nginjem
boss	bos
both	kakappi daduwe'
bother	sodara lakek
bottle	butol
bottom	e bhebhe
bought	melleh
bounce	tal-mental
bound	nalè'e
bound	alonca'
boundaries	bates
bow	nondhu'
bowl	mangko'
box	dus
boy	ana' lake'
boyfriend	ser-essèrann lalake'
bracelet	ghelleng
brain	otek
branch	cabang
brand	merek
brave	bengal
breach	alanggar
bread	roti
break	peccah
breakfast	sarapan
breast	soso
breath	anyabâ
breathe	anyabe
breed	anak poto
brick	bhata
bride	mantan binè'
bridge	jhembhâdhân
brief	singkat
bright	terang
brilliant	pèntèr
bring	ngibah
bro	Kakeh
broad	loas
broadcast	siaran
broke	ancor
broke	belle
broken	ancor
broom	posapo
brother	taretan lake'
brother in law	tarètan epar
brought	ngibe
brown	coklat
brush	sikat
bucket	karanjheng
buddy	kanca
budget	dana
bug	ko'roko'
build	abangun
building	abangun
built	èghèbèy
bulk	rajhâ
bulk	tebbel
bull	bhântèng
bully	congoco
bump	nabra'
bunch	benyak
bundle	tompo'an
burden	beban
buried	epândâm
burn	ngobbhâr
burst	leddhu'
bury	e kobur
bus	bis
bush	ombhut
business	kalakoan
business	usaha
bust	soso
bust	leddhuk
busy	repot
but	namong
butter	mentega
butterfly	kepper
button	tombol
buy	melleh
by	moso
by the way	selain gheruwa
bye	te-ngate
cabbage	gubes
cabinet	lomarè kotak
cage	korong
cake	roti
calf	empè'
call	ngolok
call me	telpon engko'
called	ejulughi
calm	tenang
calm	sabbher
came	datâng
campaign	kampanye
can	bhutol
can	bisah
can't	tak bisah
Cancel	Batal
cancer	kanker
capable	bisah
capacity	esseh
capital	modal
capital	ibu kota
caption	keterangan
capture	nangkep
car	mobil
career	lako
careful	tè-ngatè
carefully	tengate
careless	ben-saromben
caring	niser
carpenter	tokang kajhu
carpet	lamak
carrot	wortel
carry	ngibe
carry on	alanjut-aghi
carry out	ngibe
case	tas koper
case	masalah
cash	pesse
cast	ngontallagi
cast	pemeran film
castle	karaton
casual	biasa
cat	koceng
catch	nangkep
category	macemma
cattle	bu obuan
caught	nangkep
caught	mige'
cause	panyebab
caution	parengadân
cautious	ngastètè
cave	ghueh
cease	ambu
ceiling	ghâbâk
celebrate	arayaaghi
cell	sel
center	inti
center	tenga
century	abad
cereal	sereal
ceremony	upacara
certain	husus
certainly	se paste
certificate	sertifikat
chain	rantai
chair	korse
challenge	tantangan
chance	kasempadhân
change	aoba
chaos	kaco
character	karakter
characteristics	bâbâthek
charge	ngesse daya
charge	biaya
charity	sombhângan
charming	raddhin
charming	gânteng
chart	bagan
chase	nabeng
chat	torator
chat	acaca
cheap	mode
cheat	nyonto
cheating	a rocè
check	mareksah
cheek	pèpè
cheer	arak-sorak
cheerful	senneng
cheers	seneng
cheese	keju
chemistry	kimia
cherish	seneng
chess	catur
chest	dhadhah
chew	ngael
chicken	ajem
chief	katoa
child	na'-kana'
childhood	masa keni'
children	nak-kanak
chill	cellep
chimneys	lobenga kokos
chin	cangkèm
chocolate	sokklat
choice	pèlèan
choose	mele
chop	nyacca
chores	lalakon bengkoan
chubby	tembem
church	gereja
cinnamon	kajuh manes
circle	bunter
circumstances	lingkungan
circumstances	keadaan
citizen	masyarakat
city	kotta
claim	ngakoni
clarify	majelas-aghi
class	kelas
clay	cellot
clean	berseh
clear	berseh
clear	jelas
clerk	staf
clever	penter
client	lagânan
cliff	jhurang
climate	mosem
climb	ongghâ
clingy	lolo'
clingy	kantèl
clock	jam
close	semmak
closet	lemari
cloth	kalambi
clothes	kalambi
clothes	guy-engguy
cloud	ondhem
cloud	dung odung
cloudy	ondem
clown	badut
clue	tandhâ
clumsy	tak nyaman
cluster	kelompok
coach	pelatih
coal	batoh
coast	pasèsèr
coat	jaket
coffee	kopi
cognitive	kapenteran
coincidence	katepa'an
cold	cellep
collapse	bangkrut
collar	kerah le'er
colleague	kanca lakoh
colleagues	kanca kantor
collect	ngompolaghi
collection	pajhangan
college	kampus
college	kuliah
color	barnah
colorless green ideas slept furiously	has no discernible meaning
colour	bherna
column	kolom
comb	soroy
combination	camporan
combine	agabung-aghi
come	datang
come here	kadinna'
come on	mara ra
comfort	nyaman
comfortable	nyaman
coming	dateng
coming soon	bhakal datang
command	makon
comment	komentar
commercial	komersial
commission	komisi
commit	agâbây sala
commitment	komitmen
committed	agâbây sala
commodity	bharang
common	lomra
communicate	abânta
communication	komunikasi
community	masyarakat
commute	parjhelenan
companion	adampengi
company	perusahaan
company	kantor
compare	abândhingaghi
comparison	parbandingan
compassion	èsto
compassionate	trèsna
compatible	bisa asaeng
compete	asaeng
competent	bisa e andel-aghi
competition	lomba
competitive	asaeng
complain	mamanglo
complaint	hal se tak cocok
complement	alengkap-aghi
complete	lengkap
completely	possa'
completely	penuh
completely	kappi
complex	ruwat
compliance	penyesuaian
complicated	rumit
compliment	pojhiân
comply	mato aghi
comply	torro' aturen
composition	sosonan
composition	èssè
compound	magabung
comprehension	pangartean
comprehensive	nyaloroh
compromise	naber
compulsory	kawejiban
computer	komputer
concentrate	konsentrasi
concept	konsep
concern	kabater
concerned	kobeter
concert	konser
conclusion	kesimpulan
concrete	beton
condition	situasi
conditions	ka bede'en
conduct	alakoni
conference	tempat pertemuan se jhembar
confess	ngakoe
confidence	tatak ate
confident	bengal
confirm	konfirmasi
conflict	masalah
confused	posang
confusion	bingung
congrats	selamet ghi
congratulation	salamet
congratulations	salamet
conjunction	ngubung-aghi
connect	ngubung-aghi
conquer	ajhejhe
conscious	sadar
consciousness	enga'
consent	ijin
consequences	akibat
conservation	alindungi - a lestari-aghi
conservative	konserfatif
consider	rangirah
considered	eanggep
consist	bedha
consistency	tak a be obe
consistent	konsisten
constant	pagghun
constantly	pagghun
constantly	malolo
constipation	sossa makaluar kotoran
construction	bengunan
consume	konsumsi
consumption	konsumsi
contact	kontak
contagious	ngalle
contain	aesse
contains	a esse
contemporary	sa leting
contempt	nyallean
contempt	calean
content	esseh
contest	lomba
context	kabâdâân
continent	tase'
continue	alanjuttagi
contract	kontrak
contract	parjhânjian
contrast	tak padâ
contrast	laenan
contribute	kontribusi
contribution	abentuk bunter
control	marèksa
controversial	amasalah
convenience	ghâmpang
convenient	nyaman
conversation	catoran
convert	ngobe
convey	medapa'
convince	mayakinaghi
convinced	mayakin aghi
cook	amassak
cooking	amassak
cool	cellep
cool	gaya
cooperation	alako
cope	mamarè parkara
copper	timbhaga
core	dhasar
corn	jâghung
corner	paddhu
correct	mateppak
correct	teppak
cost	biaya
costume	klambih
cottage	ponduk
cotton	kapas
couch	sofa
cough	betok
could	bisah
council	ponghebe
count	jumlah
counter	alabân
country	naghere
countryside	dhisa
couple	pasangan
courage	bengal
course	kursus
course	pangajheren
court	pangadilen
courtesy	andep asor
cousin	sapopo
cover	totopan
cover	notope
cow	sapè
coward	oreng tako'an
cozy	nyaman
crab	kapètèng
crack	tennar
craft	okeran
crap	caca colo'
crash	nabrak
craving	ghângghu'
crawl	arangka'
crazy	ghile
create	agebey
create	gebey
creative	bannyak akal
creative	kreatif
credit	kredit
creep	nako'èn
creepy	nako'èn
creepy	marèngès
crew	anggota
crime	kajube'en
cringe	ta' lumrah
crisis	krisis
criteria	kriteria
critical	kritis
critical	penting
criticism	pesan
criticism	kritik
crop	motong
crops	men-taneman
cross	alebedhi
crow	mano' gagak
crowd	rammè
crowded	rammi
crown	mahkota
crucial	penteng
cruel	jahat
cruise	kapal
crush	nekket
cry	nangès
cucumber	tèmon
cuddle	luk-ghellukân
cuddle	pel-ampellan
culture	budaya
cunning	lecek
cup	cangkèr
cupboard	lomarè
curb	ngandhel-aghi
cure	bhares
curfew	bâkto malem
curiosity	rassa terro taoh
curious	terro taowa
curly	kreteng
currency	pèssè
current	se sateya
currently	bekto samangken
curse	nyalè
curse	nyompaè
curtain	kalambuh
cushion	bhântal
custom	adat
customer	oreng se eladin
customs	mesen
cut	ngettok
cute	locoh
cycle	alor
cycling	sapedaan
dad	eppa'
daddy	eppa'
daily	rèn-arèn
dairy	produk susu
dam	bendungan
damage	dampak
damn	apes
damp	dhemmel
dance	ajugit
danger	bahaya
dangerous	bahaya
dark	petteng
darling	sayang
dash	alari
data	data
date	tanggel
daughter	ana' bini'
day	areh
dead	mate
deadline	bâtes bâkto
deaf	kopok
deal	sapakat
dear	se molje
Dear All	Kepada sadhajana
Dear Customer	Sé muljhâ oréng sé aladhin
Dear Parents	Kepada oreng seppo
Dear Sir	Kepada Bapak
Dear students	Kepada mored
Dear Team	Kepala kalompok
death	kapatian
debate	debat
debit	debet
debris	rekare
debt	otang
decade	10 taon
decay	bucco'
deceased	almarhum
deceive	co-ngoco
deceive	nepo
december	desember
decent	begus
decide	nantoagi
decided	motos
decision	potosan
deck	kartu
decline	nolak
decrease	ngorangè
dedicated	khusus
dedication	pangatero
deed	akte
deep	delem
deer	manjhângan
default	se biasa
defeat	makala
defend	abela
define	ajelasaghi
definitely	ongguen
definitely	pastena
definition	artena
degree	derejet
delay	tunda
delayed	etunda
delete	èkosot
deliberate	e sangaja
delicate	alos
delicate	nyaman
delicious	nyaman
delight	seneng
delighted	ce' sennengnga
deliver	ngateraghi
delivered	takerem
delivery	anter
demand	papentah
demanding	nontot
democracy	pèlèan dhâri rakyat ban kaangghuy rakyat
demon	setan
demonstrate	muktèaghi
denied	ètolak
density	padhet
dentist	dokter bâjha
deny	nolak
department	departemen
departure	kaberangkadhan
depend	aghentong
deploy	nyebbar aghi
deposit	deposit
depressed	seddhi parana
depression	seddi
depth	dhâlem
describe	jelasagi
description	deskripsi
desert	gurun
deserve	pantes
design	desain
designation	se è pèlè
desire	pangatero
desk	meja
despair	sossa
desperate	putus asa
despite	maskena
dessert	kakanan manis
destination	tojjuen
destiny	pastè
destroy	maancor
destroy	marosak
destruction	ka-ancoran
detail	rinci
details	rinci
detect	ra ngera
determination	tekad
determine	netepaghi
determined	etantoagi
devastated	kalessoan
devastated	lesso
develop	tombu
developed	abangun
development	perkembangan
device	alat
devil	setan
devoted	setia
Dhivehi	sala settong bhâsa e India
Dhivehi	Dhivehi
Dhivehi	Besa Dhivehi
Dhivehi	bhâsa Dhivehi
diabetes	diabetes
diarrhea	acere'
diarrhea	mencret
diary	buku rèn-aren
dictionary	buku parbhâsa
did	ngalakonih
did	aghebey
die	matèh
died	mateh
died	sedhâh
diet	diet
difference	parbidâ'ân
different	bidha
difficult	malarat
dig	ngalè
dignity	kahormadhan
diligent	bhâjheng
dinner	makan malem
dip	è cangrep
direct	langsong
direction	bârâ' tèmor
direction	arah
director	katoa
dirt	kot-lokoden
dirt	tor-kotor
dirty	kedhhe'
dirty	kotor
disable	cacat
disabled	oreng cacat
disappear	èlang
disappointed	kecewa
disaster	bencana
discard	muang
discard	ngapos
discharge	mamoleh
discipline	disiplin
discount	diskon
discover	nemmo
discrimination	diskriminasi
discuss	diskusi
discussion	phag-remphag
disease	panyakek
diseases	panyaket
disguise	nyamar
disgusting	bâjhi'
dish	tor-ator
dishes	ra'kora'an
dismiss	maambhu
dispatch	abherri' tugas
display	pajengan
disposal	tempat weng-buengan
dispute	aparkara
distance	angghân
distinct	bidhe
distinguish	abidha'aghi
distress	kasangsara'an
distribution	bâgiyân
district	kabupaten
disturb	aghenggu
ditch	sok-sok
dive	nyellem
diverse	cem macem
diversity	acem-macem
divide	abâgi
divine	socce
divorce	atalak
dizzy	palengngen
do	ngalakoni
do you	apa ba'na
do you love me	apa be'na tresna ka sengkok
doctor	dokter
document	sorat atoles
does	alako
does	agebey
doesn't	bhunten
dog	patek
Dogri	Dogri
Dogri	bhâsa Dogri
Dogri	Besa Dogri
Dogri	sala settong bhâsa e India ban Pakistan
doing	alako
doll	ni'enni'an
domain	identitas web
domain	nyama server
domestic	urusan roma
dominant	kabenya'an
don't	jhâ'
Don't worry	Jhâ' kobhâtèr
donate	nyombang
done	elakonin
done	mareh
donkey	manjhângan
dope	ce' bhagus
double	rangkep due'
doubt	kabhater
dough	adhun
down	ebebe
download	nyempen
draft	rancangan
drag	narek
drain	makerrèng
drama	drama
draw	agember
drawer	rok-soroghân
drawing	agâmbâr
dread	rassa takok
dream	mempe
dress	kalambi lanjeng
drill	Bur
drink	nginum
drive	nyupir
drop	maghegger
drop	geggher
dropped	maghe'gger
drought	nemor
drunk	mabu'
dry	kerreng
duck	ètèk
dude	kang
due	polana
due to	polana
due to	sebâb
dull	mabusen
dumb	budhuh
dumb	bunggen
dump	kennengan sarkah
dump	muang
duration	bâkto
during	salaggi'na
dust	abu
duty	lalakon
duty	lakona
dwell	kareh
dying	matèa
each	sakabbi'na
each other	bâng sèbâng
eager	ghelem
eagle	manuk Rajawali
ear	kopeng
earlier	lebbhi ngadâ'
early	awwal
earn	olle
ears	kopeng
earth	bhumè
earthquake	lendhu
ease	gâmpang
easily	kalaben ghempang
east	tèmor
easy	gempang
eat	ngakan
eating	ngakan
eating	adha'ar
economic	arghena mude
economy	ekonomi
edge	penggir
edit	ngobe
education	pangajheren
effect	pengaruh
effective	teppak carana
efficiency	teppak bân manfaat
efficient	efisien
effort	usaha
egg	tellor
eggplant	terrong
ego	karepa tibi'
eight	bâllu'
eighteen	bâllu bellas
eighty	bâllung polo
either	sala' settong
elaborate	ejellesaghi
elbow	cèngkol
elder	lebbi tuah
elderly	reng toah
elegant	Lèmbâyyâ meltas penjhalin
element	bhagiyen
elephant	ghâjâ
eleven	sabellas
eligible	pantes
eliminate	ngobâ
eliminate	maèlang
else	laenna
embarrassed	todus
embarrassing	matodhus
embrace	merangkul
embrace	agelluk
emerge	hader
emergency	kabâdhâan gawat
emotional	seddien
empathy	rasa paratèn bân peduli
emphasis	mastèaghi
emphasize	mategghes
employee	panglako
employees	panglakon
employees	karyawan
employer	panglakon
employment	panglakon
empty	kosong
enable	bisa
enable	epaodik
encounter	ngadebhi
encourage	nyokong
end	dhibudhi
endangered	eancam
endeavor	usaha
endurance	katahanan
endure	malarat
enemy	moso
energy	kakoatan
engage	aphekalan
engage	noro'
engaged	atunangan
engaged	tergabung
engagement	tunangan
engagement	jhenjhi
engine	messin
engineer	tokang
English	Besa Inggris
enhance	ningkatagi
enjoy	nyaman
enormous	rajhe
enough	cokop
ensure	masteagi
enter	masok
entertainment	bur-leburen
enthusiasm	samangat
enthusiastic	ce' samangata
entire	sakabbhienna
entitled	ajudul
entity	tandha
entrance	pamaso'an
entrepreneur	pengusaha
envelope	amplop
environment	lingkungan
envy	iri
epic	lebur
epidemic	panyaket se nolar e sittong daerah luas
equal	padâ
equipment	pakakas
equity	tak berrâ' salajâ
equivalent	padâ
eraser	setip
error	rosak
escape	kabor
especially	khusussa
essay	esai
essence	essena
essence	intina
essential	parloh
establish	makaloar
established	ngaloaraghi
estate	kebbun
estimate	astimasi
estimated	parkeraan
etc	tor salaena
eternal	salanjhenga
eternal	abadi
ethics	adhâb
evaluate	marèksa
evaluation	evaluasi
even	sanajjen
even though	maskena
evening	malem
event	acara
eventually	akhirra
ever	taoh
every	sabbhân
every	bhân
everybody	sakabbi'na oreng
everyone	sakabbi oreng
everything	sakabbhienna
evidence	bhukte
evil	jahat
evolution	pangobe'en
evolve	aobe ka lebbi bhagus
Ewe	Besa Ewe
Ewe	bhâsa Ewe
Ewe	sala settong bhâsa e Afrika
Ewe	Ewe
ex	pacar lajhu
exact	teppa'
exactly	khosusa
exam	ujiân
examine	nyoba'
example	conto
exceed	lebbhi dâri batâs
excellent	begus
except	anging
exception	salaen rowa
excess	talebet
excessive	bilebbi
exchange	morop
excited	senneng
excitement	kabunga'an
exciting	lebur
exclusive	khusus
excuse	alesan
excuse me	ngapora
execute	alaksana-aghi
execution	elakoni
execution	epadeddi
executive	eksekutif
exercise	latian
exhaust	knalpot
exhausted	lessoh
exhibit	pameran
exhibition	pameran
exist	bedhe
existence	bedena
existing	bedhâ
exit	kaluar
expand	majhembâr
expand	maloas
expect	ngarep
expected	earep
expenses	pangaluaran
expensive	mewa
expensive	larang
experience	pangalaman
experiment	nyoba'
expert	oreng se ahli
expired	lajuh
explain	jelasagi
explanation	katerangan
exploit	mangabi'
explore	jelajah
export	ngirèm-aghi bharang
expose	mukka'
exposed	tabukka'
exposure	paparan
express	cepet
expression	ekspresi
extend	maleber
extended	epalanjeng
extension	se malanjhâng
extent	se tamasok kennengngan tertentu
external	luar
extinct	pona
extra	lebbi
extract	ngala'
extraordinary	tak biasa
extreme	bahaya
extremely	sarah
extremely	cè'
eye	mata
eyes	mata
fabric	kaen
fabulous	ce' lebhurra
face	ngadebhi
face	robhe
facilitate	fasilitas
facilities	fasilitas
facility	sarana
fact	fakta
factor	sabab
factory	pabrik
facts	kabenderan
fade	pudar
fail	gagal
failed	tak deddi
failure	gagal
faint	semaput
fair	adil
fairly	cokop
fairy	malaikat
faith	kasetiaan
faithful	setia
fake	palsu
fall	gaggar
false	SALA
fame	kondang
familiar	roco
family	keloarga
famine	kalaparan
famous	kasohor
fan	kipas angen
fancy	mewah
fantastic	lebhur sarah
far	jheu
farewell	perpisahan
farm	tanih
farmer	reng tani
fascinating	loar biasah
fashion	panampilan
fast	lekas
fast	cepet
fat	lemak
fat	lempo
fatal	fatal
fate	naseb
father	bapak
fatigue	kasoh
fault	kakaleroan
favorite	kasenengan
favour	kabhagusen
favourite	se paleng e kasennengnge
fear	tako'
feast	min-rammin
feather	buluh
feature	fitur
features	fitur
february	februari
fed up	pegghel
fee	opa
fee	gâji
fee	bajârân
feed	epakani
feed	pakan
feedback	masukan
feel	parasaan
feeling	perasaan
feet	soko
fell	labu
fell	geggher
fellow	kanca
felt	arassa'aghi
female	reng binik
fence	paghâr
fertile	jhenno
fertile	jhurbhu
festival	min rammin
fetch	nyarè
fever	panas
fever	demam
few	sakonik
fewer	lebbhi sakonè'
fiance	bhâkalan
fiction	ta' nyatah
field	talon
field	kennengan
fierce	gendhâk
fifteen	lèma bellas
fifty	seket
fight	carok
fighting	atokar
figure	sosok
figure out	nemoh
file	berkas
fill	ngisse'e
filled	epossa'e
filled	parèkas
film	felm
filthy	cacemmer
finally	akhirra
finance	Bagien pessean
financial	keuangan
find	nemmo
find out	nemoh
fine	bhagus
finger	ghârighi'
finish	mamarè
finished	marèh
finished	ampon
fire	apoy
firm	kuat
first	lu-ghallu
first name	nyama awal
fish	jhuko'
fit	sehat
five	lèma'
fix	mateppa'
fixed	pagghun
flag	bendera
flash	bhinar
flat	ratah
flaw	kakorangan
flawless	tadek cellana
flee	buruh
flesh	dhâging
flew	ngabber
flex	lemes
flexible	tak kako
flight	penerbangan
flip	bhelik
flip	melik
flirt	aghudhâ
flirting	agudhâ
float	ngambâng
flood	benjir
floor	lantai
flour	teppong
flow	arus
flower	kembhâng
flu	flu
fluent	lancar
fluently	hafal
fluffy	lembu'
fluid	lelle
fly	ngabbher
fly	lala'
focus	fokus
fog	kokos
foggy	kabut
foggy	kokos
fold	aleppèt
folks	ra'yat
follow	norok
follow up	mirengi
following	noro'è
food	kakanan
fool	congoco
fool	reng budhu
foolish	korang ajher
foolish	tak sopan
foot	soko
football	bal-balan
for	ka-angguy
For example	akadiye
for instance	contona
for you	kaangghuy be'na
forbidden	tak ollè
force	paksa
forecast	ramalan cuaca
forehead	deih
foreign	aseng
forest	alas
forever	sampek mate
forget	loppa
forgive	sapora
forgot	loppaeh
fork	garpu
form	bentuk
form	formulir
formal	resmi
former	luwang
fortunately	ontonga
fortune	kapojhurân
forty	pa' polo
forty-two	pa' polo duwe'
forward	ka adhe'
foster	nganjhu
fought	ajuang
found	nemmo
foundation	dasar
four	empa'
fourteen	pa' bellas
fox	moseng
fragile	lemah
frame	bingkai
framework	ka-rangka
fraud	tepo
freak	oreng tak bârâs
free	gratis
free	bebas
freedom	kabebasan
freeze	beku
frequency	kasegudân
frequent	segghut
frequently	segghut
fresh	segger
friday	jumat
fridge	kulkas
friend	kancah
friendly	ramah
friends	kanca
friendship	ca-kanca-an
frightened	takok
frightening	nako'e
frog	katak
from	dari
front	adâ'
frozen	ghâli
fruit	wâ' buwâân
frustrated	setres
fuel	bensin
Fulfulde	Besa Fulfulde
Fulfulde	sala settong bhâsa e Afrika
Fulfulde	Fulfulde
Fulfulde	bhâsa Fulfulde
full	possak
fun	lebur
function	fungsi
fundamental	penting
funeral	pamakaman
funny	loco
funny	lebur
fur	bulu
furious	ngoso'
furniture	perabotan
further	labbi jhau
furthermore	salanjut epon
future	masa se detenga
gain	olle
game	en-maenan
gap	jarak
garage	garasi
garbage	sarka
garden	taman
garlic	bhâbâng potè
gate	labâng
gather	makompol
gathering	kompolan
gauge	prasangka
gave	abherri'
gear	ger
gender	parobhe
gender	robhe
general	umum
generally	omomma
generate	ngasel-aghi
generation	katoronan
generous	lambhe'
genius	penter
genre	tema
gentle	alos
genuine	asli
gesture	gulina badan
get	ngaolle
get dressed	a kalabiyen
get up	jâghâ
get well soon	mandhâr lekas bhârâs
getting	ollè
ghost	bhâung
ghosting	ma elang
giant	rajhâ
gift	hadiya
ginger	jhâi
girl	anak binik
girlfriend	ser-esseran bini'
give	abharri'
give up	ambu
given	eparengi
given	eberrik
glad	seneng
glance	sakejit
glass	ghelles
glasses	kacamata
glimpse	ta enga' sakjjhe'
global	sa dunnya
gloomy	seddi
gloves	sarong tanang
glow	bhinar
glow up	aobe bhâgus
glue	lem
glue	jilit
go	mangkat
go ahead	ngatore
go away	ngallè
go to bed	tedunga
goal	tojjuen
goals	tojjuen
goat	embik
god	pangeran
god bless you	samughâ eparengna berkat se kobesah
goes	mangkat
going	èntar
going to	mangkat dhâ'
gold	emmas
gone	èlang
gonna	èntara
goo	lentat
good	Bhâgus
good afternoon	salamet sore
good bye	selamet dhinggal
good day	selamet siang
good evening	salamet malem
good job	hebat
good looking	gânteng
good luck	mandher sukses
good morning	salamet pagi
good morning my love	salamet pagi
good night	salamet malem
goodbye	selamat tinggal
goodnight	selamet malem
goods	parlangkabhan
Google	Google
Google Translate	Google Panarjemah
goose	benyak
gorgeous	raddin
gossip	gosip
got	olle
got it	iyâ ngartè
government	pamarentah
grab	ngala'
grade	kelas
gradually	on laon
graduate	lulus
grain	bâi'
grant	abherri' papareng
granted	ebâghi
grapes	anggor
grasp	nyangkarem
grass	rebbhâ
grateful	asokkor
gratitude	sokkor
grave	kophurân
gray	bu-abu
great	Bagus
greed	tama'
greedy	tamak
green	ijo
greet	nyapah
greeting	salam aghung
greetings	salam
grey	bu-abu
grid	kisi-kisi
grief	sossa
grind	aghiling
grip	gu' teggu'en
grocery	bâlânjhâ
groom	mantan lakè'
gross	mabejhik
gross	kotor
ground	tana
ground	dhasar
group	kalompok
grow	tombu
growth	tombhu
grumpy	ta' sabbâr
Guarani	bhâsa Guarani
Guarani	Guarani
Guarani	sala settong bhâsa e Amerika
Guarani	Besa Guarani
guarantee	mastèaghi
guarantee	ajâmin
guard	pangawal
guess	nebbak
guest	tamoy
guidance	panduen
guide	ngator
guilty	bersalah
guy	oreng lakè'
guys	kanak
gym	tempat latean
habit	kabiasaan
habitat	kennengngan odi'
had	andi'
hail	ngolok
hair	rambhut
half	saparo
hall	aula
hand	asta
hand	tanang
handle	nanganin
handsome	ghanteng
hang	ngântong
hang out	lân jhâlânan
happen	kadeddiyen
happened	ampon kadeddien
happiness	kajhemberen
happy	senneng
happy birthday	molang areh
happy birthday to you	selamet molang arè
happy new year	salamet taon anyar
hard	ghali
hard	malarat
hardly	para' tak bisa'a
hardly ever	rang-rang
harm	bahaya
harmful	bâbâjhâ
harmony	nyi-nyanyiyânn se kompak
harsh	kasar
harvest	panen
has	andi'
hate	tak seneng
have	andi'
have a good day	samughe'e lancar arena
have a nice day	moge-moge are mangken molje
have breakfast	neddha
have fun	neng senneng
have you eaten	sampiyan ampon adhe'er
have you eaten	be'na mare ngakan
having	ngaandi'
hazard	ka bhurughen
hazard	bhaleih
haze	kokos
he	oréng laké' roa
he has	andi'nan ruwa
he is	oreng gheruwa
head	cetak
headache	sake' cetak
heal	maberes
healing	liburân
healing	lân jhâlânan
health	kasehatan
healthy	sehat
hear	ngedingagi
heard	ngeding
heart	ateh
heat	panas
heaven	sowarghe
heavy	berre'
hectic	rowet
height	tenggina
heir	ahli waris
heist	ngico'
held	ebedeaghi
held	etegguk
hell	naraka
Hello	halo
hello dear	halo sayang
hello how are you	he, bârâmma kabhâra bâ'na
hello how are you doing	hei de'remmah kabereh
helmet	heklem
help	tolong
helpful	aghuna
hence	oleh sebeb gheruwa
her	reng bini' roa
herd	kompolan
here	edinna'
heritage	warisan
hesitate	ragu
Hey	hei
Hi	hei
hi how are you	hei, de'remmah kabereh
Hi there	hei
hidden	ngitek
hide	ngetek
hierarchy	tingkatan kalakoan
hierarchy	tingkat jabatan
high	tenggi
highlight	nyorot
hike	ongge
hiking	naik ghunong
hilarious	locoh
hill	ghunong
him	oreng jheriya
hint	tandhâ
hip	tongkeng
hips	bingkeng
hire	nyoro
hiring	abererik kalakoan
hiring	malako
his	andi'na oreng lake' roa
history	sejarah
hit	mokol
Hmm	hmm
hobby	kasennengan
hold	neggu'
hold on	nantos lun
hole	lobâng
holiday	liburan
hollow	alobâng
home	bengko
home	compok
homework	tugas
honest	jhujhur
honestly	saongguna
Honey	Madduh
honor	ngormadhi
hood	kodung
hook	pancengan
hop	alonca'
hope	ngarep
hopefully	samughâ
hopeless	tak ngarep
horizontal	gharis loros ka ereng
horn	klaskson
horn	titit
horrible	marèngès
horror	nako'e
horse	jhárân
hospital	roma sakek
hospitality	ramah-tamah
host	tuan ruma
hostile	tak akor
hostile	amoso
hot	panas
hotel	hotel
hour	pokol
hours	jem
house	roma
household	odi'na lakè' binè' samarena akabin
how	bârâmma
how about you	ba'na berema
how are you	bârâmma kabhârâ bâ'na
how are you doing	bârâmma kabhârâ bâ'na
how are you doing today	bârâmma kabhârâ bâ'na sateya
how are you today	beremma kaberre are mangken
how are you today	de'remmana kaberre are mangken
how do you do	de'remma kaberre
how is	bârâmma
how many	berempa
how much	sanapa arghena
how often	sanapa segghut
how old are you	berempa omora ba'na
how was your day	bârâmma kabârra ba'na saarè rèya
how was your night	bârâmma kabârra malemma
however	namong
hub	pusat
hubby	lakè
hug	ghelluk
huge	rajha
human	manossa
humble	sederhana
humid	memmel
humidity	memmel
hundred	atosen
hungry	lapar
hunt	madang
hunt	bhabatek
hurricane	badai
hurry	dhuliân
hurry up	majuh dhulien
hurt	sake'
husband	lake
hustle	nyotok
hut	pondhuk
hygiene	ka bhersean
I	Kaulâ
I am	engko'
I am fine	engko' tak rapah
I can	kule bisa
I can't	engko' ta' bisah
I do	engko' ngalakoni
I do not know	sengko' tak tao
I do not understand	sengko' tak ngarte
I don't	engko' tak
I don't know	engko' ta' tao
I don't understand	engko' ta' paham
I don't understand what you mean	sengko' tak ngartè maksode be'na
I don't understand you	engko' ta' ngarte ka ba'na
I don’t know	sengko' tak mireng
I don’t know	sengko' tak tao
I don’t understand	engko' ta' ngarte
i guess	tak sangghu
I had	din sengko'
I have	kule andi'
I have been	sengko' lastare
I hope so	sèngko' ngarep beriye kiya
I know	engko' tao
I like	sengko' lebur
I like you	Sengko' senneng ka ba'na
I love	engko' tresna
I love my big brother	sengko' sayang dha' ka kakak lake'na sengko'
I love my big sister	sengko' sayang dha' ka kakak bini'na sengko'
I love my father	sengko' sayang dha' ka eppa'na sengko'
I love my little brother	sengko' sayang dha' ka adek bini'na sengko'
I love my little sister	sengko' sayang dha' ka adek bini'na sengko'
I love my mother	sengko' sayang ka ebhu
I love you	Engko' seneng ka bhâ'na
I love you so much	kule tresna sampeyan
I love you too	Engko' tresna kèya ka ba'na
I mean	maksud kule
I miss you	engko' kerrong ka ba'na
I miss you so much	engko' ce' kerrongnga ka ba'na
I see	engko' ngartè
I see	engkok ngabâs
I think	Mon can engko'
I understand	kule ngarte
I want	Engko' terro
I want to see you	engko' terro tatemmoa moso ba'na
I want you	sengko' terro be'na
I was	sabelunna kule
I will	kule bakal
I would be	sengko' bhâkal
I'm	sengkok
I'm fine	engko' sehat
I'm good	Engko' baik
I'm good	Engko' tak rapah
I'm here	sèngko' edinna'
I'm sorry	kule nyo'on sapora
ice	es
ice cream	es grim
idea	pèkkèr
ideal	cocok
ideal	bhagus
identical	para' pade'e
identify	tentukan
identity	nyama
idiot	buduh
idle	dhalmos
if	mun
ignore	tak eabes
ill	songkan
illegal	rembun
illness	panyakek
Ilocano	Ilocano
Ilocano	Besa Ilocano
Ilocano	sala settong bhâsa e Filipina
Ilocano	bhâsa Ilocano
image	ghâmbhâr
imagine	ngayal
immediate	ager
immediately	dhulih
immense	jhembar
impact	pangaro
impatient	tak sabbhâren
implement	neraphaghi
import	ma masok bharang
important	parloh
impose	maksa-aghi
impossible	tak mungkin
impress	kasambu'
impression	panyangka se pertama
impressive	lebur
improve	mateppa'
improvement	ka majhuen
in	e
in	nâng e
in addition	Salaenna
In fact	nyatana
in front of	èadek
in order to	kaangghuy
in order to	kaghebey
in order to	ka ator
inappropriate	tak cocok
incentive	insentif
incident	kadhâddhiân
include	termasok
including	tamasok
income	bâjhârân
inconvenience	se ma tak nyaman
increase	sanajjen benyak
increased	ma majhu
incredible	gegek
indeed	Onggu-onggu
independent	mandiri
India	India
indicate	artena
indigenous	asli
individual	settong oreng
industry	industri
inevitable	tak bisa ehindare
infant	bhaji'
infection	infeksi
infinity	tadek betessa
inflammation	radang
inflation	onggena arge
influence	pangaro
inform	apareng oning
information	informasi
ingredients	bahan
inheritance	sangkolan
initial	awal
initiative	inisiatif
injured	loka
injury	sake'
injury	lokah
innocent	tak salah
innovation	inovasi
inquiry	suâl
insane	gile
insect	serangga
insecure	tak aman
insert	nyisib aghi
inside	e delem
insight	pangataoan
insist	maksa
insomnia	tak bisa tedung sampe malem
inspiration	inspirasi
inspire	aberri' pamekeran
install	masang
instance	conto
instant	langsung
instead	namong
instead of	e tembhang-
instructions	parenta
instrument	alat butabbuwen
insult	nyake'e parasaan
insurance	jaminan
intact	genna'
intact	lengkap
integrity	integritas
intellectual	penter
intelligence	oreng penter
intelligent	penter
intend	aniat
intended	aniat
intended	sangaja
intense	kellar
intention	maksod
interact	saleng aberrik pangaro
interaction	interaksi
interest	pangatero
interested	lebur
interesting	lebur
interfere	ko'nyalko'
intermediate	nga'tengnga'an
internal	reng dhalem
international	internasional
internship	praktek magang
interpret	nebhak
interpreter	tokang nerjemah
interrupt	ko'nyalko'
interview	wawancara
intimate	semmak
into	ka delem
introduce	makenalaghi
introduction	perkenalan
introvert	introver
intuition	pangrasa
invalid	lopot
invent	nyepta aghi
inventory	inventaris
invest	nyempen
investigate	nyareh
invitation	onjângan
invite	ngonjâng
invoice	tagiyen
involve	tamaso'
involved	termasuk
iron	besse
is	ka'into
island	poloh
isolated	ghunong na’nong bâto kletak
isolated	tempat se jheu
issue	masalah
issues	masalah
it	arowa
it is	areah
it is	aroah
it was	arowa la
it's	dhibi'na
it's ok	tak rapa
It's okay	tak rapah
item	bârâng
items	bharang
its	arèya
I’m	sengko'
jacket	jaket
jail	korongan
January	Januari
jar	toples
jaw	rahang
jealous	iri
jerk	oreng jahat
jewelry	mas emmasen
job	kalakoan
jogging	alari
join	norok
joint	parsendien
joke	con-locon
journalist	tokang toles berita
journey	parjhalanan
joy	bhunga
joy	kabhungaan
judge	anilai
judge	hakim
juice	jus
july	juli
jump	a loncak
june	juni
junk	bu-rombu
just	comah
just	phuruh
just do it	kalako bhai
justice	ka-adhilan
justify	mabhender
Kalaallisut	sala settong bhâsa e Greenland
Kalaallisut	Besa Kalaallisut
Kalaallisut	Kalaallisut
Kalaallisut	bhâsa Kalaallisut
keen	seneng
keen	lebur
keep	ajhege
keep it up	lanjut-aghi lako bhagusna
kept	esempen
kettle	ceret
key	konci
kick	nandhu'
kid	anak
kidding	aghejhek
kidney	ginjal
kids	na'-kana'
kill	mate'e
kind	macem
kind	Bhâgus
kinda	bek-abek
kindly	pelak
kindness	sifat bâghus
king	raja
kiss	nyiom
kitchen	dâpor
kite	lajhângan
kitten	buḍu’na kocèng
kitten	cemmèng
kitten	cacemmeng
knee	to'ot
knew	oning
knife	laddhing
knight	pahlawan
know	tao
knowledge	elmu
known	e kataoe
Konkani	Besa Konkani
Konkani	Konkani
Konkani	bhâsa Konkani
Konkani	sala settong bhâsa e India
Krio	bhâsa Krio
Krio	Besa Krio
Krio	Krio
Krio	sala settong bhâsa e Sierra Lione
label	cap
labor	panglakon
labour	tokang
lack	korang
ladder	andhâ
lady	be bini'
laid	dung-tedungan
lake	talaghâ
lamb	embi' kebhes
lame	dhipplak
lamp	lampu
land	tanah
landscape	pemandangan
language	besa
lap	rèbâ
large	rajhe
last	dibudih
last but not least	dibudina namong tak kala penting
last name	nyama aher
late	lambat
lately	akher-akher samangken
later	deggi'
latest	se paleng anyar
latter	sorat
laugh	ghelle'
laughing	aghelle'
laughter	ghella'
launch	luncurkan
laundry	londri
law	hokom
lawn	tanian rebbe
lawyer	pangacara
lay	abhering
layer	lapesan
layout	tampilan
lazy	malas
lead	mimpin
leader	katoa
leaf	dâun
leak	bucor
lean	nyender
leap	alonca'
learn	ajher
learning	ajhâr
lease	sewaan
lease	panyewaan
least	paleng sakonek
leather	kolè'
leave	adina'agi
leave	mangkat
leaves	dâun
led	e pimpin
left	kacer
leg	bettes
legacy	warisan
legal	hokom
legend	konah
legit	sah
leisure	santai
lend	nginjemagi
length	tenggi
less	korang deri
lesson	pangajhârân
let	ebiaragi
letter	sorat
lettuce	deun selada
level	tingkatan
leverage	faèdâ
liability	tangghungan
library	perpustakaan
lick	nyilât
lick	jhilât
lie	lecek
lies	lècèk
lies	congoco
life	odi'
lift	ngangka'
light	sonar
light	demmang
light	enteng
lightning	kelap
like	akadiye
like	seneng
likely	palèng
likewise	kèya
line	gâris
Lingala	Kongo
Lingala	Besa Lingala
Lingala	Lingala
Lingala	bhâsa Lingala
Lingala	sala settong bhâsa e Afrika
Lingala	ban Angola
link	hubungan
lion	macan
liquid	lelle
list	catetan
listen	ngedingagi
listening	ngeding-aghi
literally	saongguna
literature	beca'an
litter	mowâng sarka bân sarombân
little	sakoni'
little	keni'
live	odi'
live	langsung
liver	liver
lives	odi'
living	odi'
living room	amper
living room	kenengna tamuy
lizard	kaddhal
load	ngèssèè
loaf	roteh
loan	enjeman
local	lokal
location	kennengngan
lock	ekonci
lock	ngonci
lock	konci
lockdown	karantina
log	nyatet
lol	haha
lonely	kadibi'en
long	lanjeng
long time no see	abit ta' katemmo
look	ngabes
loop	sombângan
loose	longgar
lord	ghusteh
lose	elang
lose	kalah
loss	kala
lost	elang
lost	kalah
lot	bânnyak
loud	ranying
lounge	tempat santai
love	senneng
love you	lebur ka ba'na
lovely	lebur
low	rendah
lower	lebbi mabâ
loyal	setia
loyalty	sacca
luck	kè-rèjhekkèan
lucky	pojhur
Luganda	sala settong bhâsa e Afrika (Uganda)
Luganda	bhâsa Luganda
Luganda	Luganda
Luganda	Besa Luganda
luggage	tas
lump	bungkolan
lunch	makan siang
lungs	bbhere
luxury	mewa
lying	dhung-tedhungan
lying	congoco
machine	mesin
mad	ngoso'
madam	ebu
made	egebey
Madurese	Madurâ
magazine	sorat kabhar
magnificent	moljhâ
maid	pangladhin
main	otama
maintain	ajege
maintain	aromat
maintenance	perawatan
Maithili	Maithili
Maithili	sala settong bhâsa e India ban Nepal
Maithili	bhâsa Maithili
Maithili	Besa Maithili
major	parloh
major	rajhe
majority	kabenya'an
make	agabey
make up	adenden
male	lalake'
mall	toko rajeh
man	oreng lake
manage	ngelola
management	cara kaangguy ngator
manager	se ngator
mandatory	wejib
manifest	jelas
manipulate	nepo
manner	tatakrama
manual	elakoni kalaban tanang
many	benya'
many many happy returns of the day	bennya' kabhunga'an abheli are mangken
march	maret
margin	betes
market	pasar
marriage	kabinan
married	akabin
mask	masker
mass	bânynyak
massive	rajhe
massive	benyak
master	se ahli
match	padhe
match	cocok
mate	jhudhu
material	materi
math	matematika
matter	bharang
matter	masalah
maturity	dhibâsa
may	kamungkinan
maybe	kamungkinan
me	engko'
me too	engko' kea
meal	kakanan
mean	alat
mean	maksode
meaning	arteh
means	alat
means	artena
meant	aniat
meanwhile	samentara
measure	okoran
measures	ngokor
meat	deging
medical	mantre
medicine	bat-obatan
meditation	alate mental tor ngontrol parasa'an
medium	tak rajhâ tak kèning
meet	atemmo
meeting	pertemuan
Meiteilon	bhâsa Meiteilon
Meiteilon	Meiteilon
Meiteilon	Besa Meiteilon
Meiteilon	sala settong bhâsa e India
melt	anca
memories	kenangan
memory	tempat nyempen
mental	pekker
mention	nyebut
mentioned	sè kasebbhut
mentor	palatih
merchant	wel-juwel
mercy	sapora
merely	ghun
merry christmas	selamet are natal
mess	kacau
message	pessen
messy	salbut
metal	besseh
method	cara
mice	tekos
middle	tengnga
midnight	tenga malem
might	bisa phei
mild	angak
mild	lembut
milestone	tonggha' pancapaian
military	militer
milk	susu
million	juta
mind	pekkeran
mindset	pekkeran
mine	andi'na engko'
mingle	akrab
mingle	acampo
minor	kènè'
minute	menit
minutes	menit
miracle	papareng
miracle	ka-ajeiban
mirror	kaca
miscellaneous	cem-macem
mischievous	meller
mischievous	melleng
miserable	jhube'
misery	kasangsara'an
miss	kerong
miss	kalebet
miss you	kerrong ka ba'na
missing	kerrong
missing	èlang
mission	rancana
mist	u beu-en
mistake	kalopotan
Mizo	Mizo
Mizo	bhâsa Mizo
Mizo	sala settong bhâsa e India
Mizo	Besa Mizo
mobile	hape
mock	nyi-ngeyi
model	conto
moderate	sedhdhengan
modern	moderen
modest	sederhana
moist	lembu'
moisture	dhemmel
moisture	mel-mel
mold	cetakan
mole	taè lala'
mom	Embu'
moment	bâkto
monday	sennèn
money	pesse
monitor	layar
monkey	motak
month	bulen
mood	kabada'na ateh
moody	ghempang ghighir
moon	bulân
moral	moral
moral	adhab
more	lebbi benyak
moreover	salebbinah
morning	lagghuk
mortgage	sorat gâdhin
most	parak kakabbhi
mostly	kabennya'an
mother	ebhu
motion	gulih lalakon
motivation	motivasi
mountain	ghunong
mouse	tèkos
mouth	colo'
move	pindah
movement	ghulih
movie	felm
mrs	ebhu
much	benya'
mud	cellot
mug	mok
muscle	ora'
museum	musium
mushroom	kolat
music	musik
must	kodhu
mute	èsep
mutual	abhâreng
my	andi'ân engkok
My dear	Sayang
my friend	tang kancah
My hovercraft is full of eels	Kapala sengko' bennya' bellu'na
my love	kasayanganna engko'
my name is	tang nyama
my pleasure	dâpadâ
myself	engko'
mysterious	ghaib
mystery	misteri
myth	careta
nail	koko
naive	naif
name	asma
narrative	careta
narrow	cope'
nasty	nakal
nasty	kotor
national	nasional
nationality	kabhángsaan
native	oreng asli
natural	alami
nature	alam
nausea	ngota'a
near	semma'
nearby	semma'
nearly	para'
neat	rapih
necessary	parloh
neck	ghulu
necklace	kalong
need	bhuto
negative	negatif
neglect	tak areksaghi
negotiate	nabâr
neighbor	tatangge
neighborhood	tatanggâ
neither	jugen
nephew	ponakan
nerd	ani
nervous	takok
nest	sarang
nest	lebun
net	bersè
network	jhâ-jhâring
neutral	tak mele apa
neutral	biasa-biasa
never	ta' pernah
never give up	jhâ' pasra
never mind	ta' arapah
nevermind	ampon wes
nevertheless	namong
new	anyar
news	kabhar
next	selanjotta
next to	semmak ka
nice	nyaman
nice	Bhâgus
nice to meet you	seneng atemmo ban ba'na
niece	sapopo lakek
night	malem
nightmare	mempe ta' nyaman
nine	sanga'
nineteen	sanga bellas
ninety	sangang polo
No	Phunten
no problem	sobung masalah
no way	enjhâ'
nobody	adhe' oreng
noise	enger
noise	minrammin
noisy	ènger
none	tadâ'
noon	ang-siang
nope	sobung
nor	benni jughân
normal	normal
north	dâjhâ
nose	èlong
nostalgic	kerrong
not	njek
not at all	sakaleh
not at all	ta
not bad	tak pate jhubek
Not now	Benni satiya
not yet	gitak
note	catetan
noted	nyatet
nothing	adhe'
notice	nyadar
noticed	ngoladhi
noticed	ngabes
noun	kata benda
nouns	panyebbhut bhârâng
novel	novel
november	november
now	sateya
nowadays	satèya
nuisance	gengguen
null	bhâttal
numb	mate rassah
number	nomer
nurse	perawat
nurse	arabat
nut	kacang
nutmeg	pa'ala
nutrition	kandungan gizi
oath	sompa
obesity	adhâghing
obesity	lempo
obey	norot
object	tojjuen
object	bhereng
objective	adil
obligation	kawejiban
obscure	samar
observation	ngabesaghi
observation	ngawaseh
observation	nitenih
observe	ngabâsaghi
obsessed	seneng onggu
obsession	terro nga andik
obsolete	lajuh
obstacle	ujien
obtain	olle
obtained	e kaolle
obvious	terang
obvious	jelas
obviously	se paste
occasionally	sakadheng
occupation	kalakoan
occupied	ekenningin
occur	kadheddien
occurred	nyolbi'
occurred	dateng
occurs	deddi
occurs	kadeddien
ocean	tasè'
october	oktober
odd	ani
odds	ajaib
odds	tak teppak
of	dari
of course	ongguen
off	mate
off	sobung
offensive	nyinggung
offer	mataber
office	kantor
official	resmi
often	pancet
Oh	oh
oh really	oh, iye rah?
oil	minnyak
ok	Iyâ
ok dear	iye, sayang
ok honey	iye, sayang
ok my love	iyâ sayang
okay	iyâ
okay baby	oke sayang
okay dear	engghi sayang
okay honey	iye sayang
okay my love	engghi sayang
old	toah
on	é attas
once	sakalian
once	lambek
one	settong
one language is never enough	settong bhâsa ta' perna cokop
onion	bhâbâng mèra
online	onlen
only	coma
open	mukka'
operation	kalakoan
operation	oprasi
opinion	pendapat
opportunities	kasempadhân
opportunity	kasempatan
opposite	lalabenan
optimistic	partajhâ
option	pelean
optional	pelean
or	otabe
orange	jherruk
order	giliran
order	messen
ordinary	biasa
organization	organisasi
orientation	orientasi
origin	asal
original	asli
Oromo	Besa Oromo
Oromo	Oromo
Oromo	bhâsa Oromo
Oromo	sala settong bhâsa e Afrika
orphan	jatèm bân ko'ong
other	se laen
otherwise	kalamon bidhe
otherwise	sebaliknya
ought	kodhuna
our	andi'na kaule sadeje
Our mission: to enable everyone, everywhere to understand the world and express themselves across languages.	misina abe' dhibi': ngusaha-aghi sakabbina oreng, e dimma bei kaanghuy mangarte ban ngekpresi-agi abe' dhibikna edalam cem-macemma bhasa.
Our mission: to organize the world's information and make it universally accessible and useful.	misina abe' dhibi': ngator informasi dunya ban aghebey informasi ghempang e kala' manfaat-deh kaannghuy oreng bennyak
out	kaluar
out	tadhek
outcome	hasel
outfit	angguyen
outgoing	kalowar
outlet	toko
outline	intina
outside	eluar
outstanding	luar biyasa
oven	open
over	attas
over	talebet
over there	edissa'
overall	sakabbi'na
overcome	mamarè parkara
overthinking	alebbiyen pekker
overwhelmed	kewalahan
overwhelming	maposang
owe	aotang
owl	dhâris
own	andi'
owner	se andi'
ox	sapè
ox	kerbuy
pace	laju
pack	bungkos
package	paket
paid	ebâjhâr
pain	sake'
paint	cèt
painting	lukisan
pair	sapasang
pale	potè olay
palm	tapak
pan	bâjhân
pandemic	pandemi
panic	ngejit
pants	lebbhâr
paper	dhalubâng
paradise	soarghâh
parallel	nyambhung
parcel	bân-gibân
pardon	sapora? Arapa?
parents	reng tua duwa'
park	taman
parrot	wortel
parsley	daun peterseli
part	bâgiyân
participate	noro'
particular	khosus
particularly	khusus
partner	pasangan
party	tatarob
pass	lulus
passage	pesan
passed	lulos
passion	pangatero
passion	kasenengan
passionate	ce' kencengngah
passive	tak giat
password	sandi
past	lambe'
patch	tambelan
path	jelen
path	lorong
pathetic	malarat
patience	kasabbheren
patient	sabbar
patient	pasien
pattern	pola
pause	ambu sakejje'
pavement	jelen epenggir lorong
pavement	trotoral
pay	majer
payment	bârâghât
peace	damai
peaceful	tenang
peach	kesemek
peak	konco'
pear	pir
peas	kacang polong
peculiar	ani
pee	a senni
peel	ngombi'
peer	pasangan
peers	pasangan
pen	bolpen
pencil	po'lot
pending	terjeda
people	oreng benya
pepper	sa'ang
perceive	ngarte
perception	penaremaan
perfect	samporna
perform	tampik
performance	panampilan
perhaps	kamungkinan
period	bhekto
permanent	permanen
permission	ijin
permit	sorat izin
perseverance	pangatero
persistent	sabbhil
person	oreng
personal	kasorang
personality	bâbâthek
perspective	sudut pandang
persuade	ngajek
pervert	leter
pet	bu-obuan
phase	bhagiyen
phenomenon	kadeddiyen
philosophy	elmo hakekat
phone	telpon
photo	foto
phrase	kalemah
physical	wujud fisik
pick	mèlè
pick up	angka'
picture	ghamber
piece	bhagien
pieces	bagien kinik
pig	babi
pigeon	manu' dhâra
pile	tompo'an
pillow	bântal
pilot	pilot
pin	jârum
pineapple	lanas
pink	mera ngode
pit	lobâng
pitch	ngumpan
pitch	ngentor
pity	neser
place	tempat
place	kennengan
places	balai
plague	panyaket nolar
plain	rata
plain	biasa
plan	rencana
plane	kapal
plant	pabrik
plant	taneman
plants	men-temenan
plate	pereng
platform	kennengan
play	amain
playing	amain
pleasant	seneng
please	nyo'ona
pleased	ghumbirâ
pleasure	kanyamanan
pledge	sompa
plenty	benyak
plot	alur careta
plug	steker
plum	kobista
plumber	tokang sellang
plural	amakna duek
podcast	siaran
poem	pusis
poetry	puisi
point	poin
poison	racon
police	polisi
policy	atoran
polite	sopan
pollution	kokossa tompa'an
pond	talaghâ
pool	jubâng
poop	taè
poor	misken
pop	pop
popular	kasohor
population	penduduk
pork	dâginga bâbih
porridge	tajhin
port	palabbhuen
position	posisi
positive	positif
possess	andi'
possession	andhi'na
possessive	cerre'
possible	bisa
post	pos
postpone	nunda
potato	kentang
potential	potensial
pound	pound
poverty	kameskenan
power	kakoadhan
powerful	kuat
practical	praktis
practice	nyoba'
praise	nyanjung
prank	con-locon
pray	abâjhâng
precious	parloh
precious	penting
precise	teppak
precisely	teppa'
predict	ra-ngèra
prefer	lebih seneng
preference	pelean pekkeran beng-sebeng
pregnant	ngandhung
prejudice	panyangka
premises	dhasar pemekeran
premium	kwalitas bhaguse bharang
preparation	parsiapan
prepare	asiap
prepared	yap- siyap
preposition	penempatan
presence	bâdâ
present	hadia
present	hadir
present	sateya
presentation	presentasi
preserve	ngopeni
president	presiden
press	nekket
pressure	tekanan
pretend	congoco
pretty	bhagus
pretty	raddin
prevent	nyeggeh
previous	sabelunna
prey	kebhân se ekakan kebhân laèn
price	arghe
pride	kabangga'an
priest	pendeta
priest	mandita
primary	otamah
prime	sehat
prime	otama
princess	potrè
principal	atoran
prior	sabellunah
priority	se utama
prison	penjara
privacy	kaluasan abhe' dhibik
private	privat
privilege	kamolje'en
prize	hadiyah
probably	kamungkinan
problem	masalah
procedure	prosedur
proceed	alanjutaghi
process	cara
process	proses
produce	ngasèllaghi
product	bhârâng
production	produksi
profession	kalakoan
professional	profesional
profile	ghamberen
profit	kaontongan
profound	se-ekenal
progress	progres
project	proyek
prominent	penting
promise	jhenjhi
promote	mataber
promotion	promosi
prompt	maenga'
prone	gâmpang
pronouns	bhasa ghente
pronunciation	pangoca'an
proof	bhukte
proper	teppak
properly	teppak
properties	parlangkabhân
property	properti
proposal	lamaran
prospect	pangarebhân
prospect	pangarep
prosperity	makmor
prosperous	makmor
prosperous	jhembar
protect	ajhege
proud	bangga
prove	bhuktè
provide	nyadia'aghi
provided	esadiyâ'aghi
province	provinsi
provision	stok
puberty	dhibhâsa
public	umum
pull	narek
pull	najhek
pumpkin	labuh
punctual	teppa' bektoh
pupil	mored
purchase	melleh
pure	socce
purple	ungu
purpose	tojjuwen
purse	tas
pursue	nabeng
pursuit	usaha
push	nyothok
put	nyaba'
qualification	abadhi ka ahlian
quality	kualitas
quantity	jumlah
quarantine	karantina
quarrel	atokar
quarter	saparapat
Quechua	Besa Quechua
Quechua	Quechua
Quechua	bhâsa Quechua
queen	ratoh
queer	ani
query	petanya
question	petanya
queue	antrean
quick	lekkas
quickly	dhuli
quiet	esep
quilt	sapo'
quit	kalowar
quit	ambu
quite	Onggu-onggu
quiz	ulangan
quotation	permintaan
quote	kutipan
quotes	e kotep
rabbit	terbilong
race	ras
race	lomba
rage	bâllis
rain	ojen
raise	kaloar
raise	ngangka'
raised	maongghâ
ran	aberka'
random	acak
range	rentang
rapid	santa'
rapidly	kalaban bhajeng
rapidly	cepet
rare	jarang
rare	langka
rarely	jarang
rash	tombuen
rat	tèkos
rate	tingkat
rather	etembeng
ratio	okoran
rational	pekkeran asli
raw	mattah
reach	depa'
reached	ejhângngo
reaction	tangghebben
read	macah
reading	maca
ready	siap
real	ongghu
reality	sa benderreh
realize	apangrasah
realized	sadar
really	Onggu-onggu
rear	budhi
reason	alasan
reasonable	masok akal
recall	enga'
receipt	nota
receive	narema
received	narema
recent	paleng anyar
recent	ghi' buru
recently	samangken
reception	panglima
recipe	resep
reckless	carobhu
recognition	ngako
recognize	nyadar
recommend	nyarannagi
recommended	e rekomendasi aghi
record	nyimpen
recover	bharas
recovery	baras
rectangle	marsegi lanjhang
rectangle	persegi lanjhang
red	mera
redeem	nebbhus
redemption	tebusân
reduce	ngorangih
redundant	benyak
refer	maksod
reference	referensi
reflect	peka
reflection	bhajangan
refrain	makuat abe'
refrigerator	kulkas
refund	mabelih pesse
refuse	tak gelem
refused	e tolak
regard	pendapat
regarding	terkait
regardless	tak nganggep
regards	salam
region	wilayah
register	adaftar
regret	kastah
regular	sebiasah
regularly	tarator
reject	nola'
relate	bâdâ hubunganna
related	terkait
relationship	hubungan
relative	bhâlâ
relatives	taretan
relax	santai
release	makaloar
released	eocol
relevant	masok akal
reliable	jujur
relief	legghe
relieve	legga
relieved	tenang
religion	aghâma
religious	alem
reluctant	ta' kenceng
rely	ngandhellaghi
remain	paggun
remaining	karèna
remarkable	lebur
remedy	mèccèk
remember	engak
remind	maènga'
reminder	se maènga'
remote	ghunong na'nong
remove	maelangaghi
remove	ngapos
render	a berrik
rent	nyewa
repair	mecce'
repeat	ngulangè
replace	egântèaghi
replace	eporop
reply	belessan
report	laporagi
represent	abhâkkèlè
reputation	kahormadhan
request	minta
require	perlo
required	ebutoagi
rescue	nolong
research	neliti
research	penelitian
resemble	padeh
resentment	ka bâjhi'en
reservation	pessenan
reserve	nyèmpen
resident	oreng kampong
resign	ambu
resilience	koko
resilient	pangatero
resist	alabân
resistance	alabân
resolution	resolusi
resolve	mamarè parkara
resort	kenengan wisata
resources	asalla bârâng
respect	ngarghei
respond	abherri' tanggapan
response	respon
responsibility	tanggungan
responsible	andik tanggung jawab
rest	kareh
rest	buambu
rest in peace	samoge'e eparengna tera' kobur
restaurant	depot
restaurant	berung adhe'er
restore	mabelih
restrict	abâtesè
result	hasel
results	hasel
resume	lanjuttagi
retail	eceran
retain	nahan
retention	kennengngan kaangguy nyèmpen
retired	ambu alako
retired	pansion
retreat	nyorot
retrieve	ekala' polè
return	abeli
reveal	mukka'
revealed	etemmo
revealed	ka ongkap
revenge	abâles dendam
revenue	pendapatan
reverse	morop
review	mareksah
revise	mateppa'
revision	mabecce'
revision	mecce'
revolution	maobe
reward	hadiya
rhythm	laghu
rib	lang-tolang
rice	nase'
rich	soghi
rid	abersèè
ride	nompak
ridiculous	loco
right	teppa'
right	kangan
right now	sateya
rigid	kakoh
rigid	gherrâ
ring	cencen
rinse	noro
riot	gisru
rip	nyebbhit
rip	nyorè
ripe	massa'
rise	ongghe
risk	bâbâjhâ
rival	saengan
river	songai
road	jhâlân
roast	mangghâng
robust	koko
rock	bâto
rod	tonggha'
role	pangèlèn
roll	ghulungan
roof	ata'
room	kamar
root	ramo'
rope	tampar
rotten	buccok
rough	kasar
roughly	kalaben kasar
round	bunter
route	rute
routine	kabiasaan
row	bherisen
rub	agharu
rubber	sot-kosot
rubbish	sarka
rude	kasar
rug	karpet
ruin	aganggu
ruin	marosak
rule	jhalan
ruler	ghârisân
rules	atoran
run	buru
running	bhuruh
rural	dhisa
rush	kaburu
sack	ma ambu
sacred	soccèh
sacrifice	pangorbanan
safe	aman
safe flight	samughâ eparengna lancar penerbangan dhika
safe flight	selamet parjelenan
safety	kaamanan
sage	jhamoh
said	ekocak
sail	majheng
sailing	alajer
sake	demi
salary	opa
sale	obral
salmon	jhuko' salmon
salt	bujâ
same	padhe
Same here	depade
sample	contoh
sand	pasèr
sand	bedhdhi
Sanskrit	Besa Sansekerta
Sanskrit	bhâsa Sansekerta
Sanskrit	Sansekerta
Sanskrit	sala settong bhâsa e India
sarcastic	nyolak
sassy	langka
sat	tojhu'
satisfaction	kapoasan
satisfied	puas
satisfy	puas
satisfying	puas
Saturday	Satto
sausage	sosis
savage	marengis
save	nyempen
saw	nangaleh
saw	ngabes
say	ngocak
scale	okoran
scam	penipuan
scar	bekase loka
scarce	ane
scared	takok
scarf	kodung
scary	nako'èn
scattered	salbut
scene	kennengngan
scenery	bâs-abâsân
scent	beu
schedule	jadwal
school	sakola
science	elmo
scientist	rèng pènter
scientists	oreng se benya' elmo
scissors	ghuntèng
scold	aghighir
scold	eghighiri
scope	se tamasok e dhâlemma
score	nilai
scrap	a bettal aghi
scratch	coretan
scream	atowat
screen	layar
screw	tokol
script	beca'an
sea	tase'
seal	ajilid
seal	anjing laut
search	nyarè
season	mosèm
seat	katojhu'en
second	nomer duwe'
secret	rahasia
section	bâgiyân
secure	aman
security	satpam
see	ngabes
see you	dâgghi' polè yâ
see you later	nyo'on pamit
see you soon	nyo'on pamit
see you tomorrow	dhâgâ jumpa agghi
seed	binih
seed	bhibhit
seek	nyare
seem	akaton
seems	cora'na
seen	eabes
seize	nangkep
seizure	nyita
seldom	jarang
select	mele
self	aba'
self healing	masenneng abe'
selfish	egois
sell	juwel
send	ngirem
send me your picture	kerem aghi fotona be'na
senior	lebbhi towa
sense	rassa
sensible	masok akal
sensitive	sensitif
sent	ekèrèm
sentence	kalimat
sentences	okara
separate	pesah
Sepedi	Besa Sepedi
Sepedi	bhâsa Sepedi
Sepedi	Sepedi
Sepedi	sala settong bhâsa otama e Afrika
september	september
sequence	ghilirân
series	seri
serious	serius
seriously	kalabhân ongghu ongghu
serve	aladhini
service	jasa kaangguy aladhinè orèng
session	sesi
set	netepaghi
set up	majâghâ
setting	tempat
settle	jumenneng
seven	pètto'
seventeen	petto bellas
seventy	pettong polo
several	pan-berempan
severe	parah
sew	ajheik
shade	naung
shadow	jâng-bâjângan
shake	aguncang
shall	bakal
shallow	nengkek
shame	todhus
shape	bentuk
share	abeghi
sharp	tajhem
she	babini' roa
she has	jiye andik
she is	bâbinè' rowa
shed	gudâng
sheep	embi'
sheet	lembâr
shelf	rak
shell	kerrang
shelter	pangaopan
shield	tameng
shield	pelindung dhadha
shift	ghiliren
shine	terak
ship	kapal
ship	ngerem
shipping	ngirèm-aghi
shirt	kaos
shoes	sapatu
shoot	nemba'
shop	toko
shopping	abelenje
shore	tenggângan
short	pendhe'
shortage	kakorangan
shot	temba'an
should	kodunah
shoulder	bâu
shout	aorak
show	noddhuagi
show me	patao ka sengko'
shower	mandi
shrimp	odâng
shrink	kerso'
shut	esep
shut	mate'e
shut up	esep
shy	todus
sibling	tarètan
siblings	sodara kandung
sick	sake'
side	penggir
sigh	aserro
sight	ngoladhi
sightseeing	bâs-ngabâs
sign	tandhe
signature	tèken
significant	penting
silence	seppeh
silence	tade' monyina
silent	neng-neng
silk	sutra
silly	ta' ngastete
silver	pera'
similar	mirip
simp	oreng bhudhu
simple	sederhana
simultaneously	areng bhâreng
since	sajjageh
sincere	jhujhur
sincerely	saongghuna
sing	anyanyi
singer	oreng se anyanyi
single	kadibik
sink	kennengan ra'kora'an
sink	nyellem
Sir	Pak
sister	taretan binik
sister in law	epar bini'
sit	tojhu'
site	kennengngan bersejarah
situation	situasi
six	ennem
sixteen	nem bellas
sixty	sabidhak
sixty	nem polo
size	okoran
skill	kemampuan
skills	kemampuan
skin	kolè'
skinny	koros
skip	elebâdhi
skirt	rok
sky	langngè'
slave	budak
sleep	tedung
sleeping	teppa'na tedung
sleepy	katondu
sleeve	budhâ'
slice	nyèksèk
slide	lanyo
slightly	sakoni'
slim	koros
slip	tabhâlaccar
slope	lereng
slot	tempat kosong
slow	laon
slowly	on-laonan
small	keni'
smart	penter
smell	bheuh
smile	misem
smoke	a roko'
smooth	alos
snack	ghu'-ghengguk
snail	cangcang
snake	olar
snap	potong
snow	salju
so	Makah
so cute	loco
so far	sampek satèya
soak	bècca
soap	sabun
sober	tak mendhem
soccer	bal
social	sosial
society	masyarakat
socks	kaos soko
soft	alos
software	parlangkabhen komputer
soil	tana
sold	paju
sold out	pajuh
soldier	tentara
sole	settong
solid	tapet
solution	solusi
solve	ngataseh
solve	mamareh
some	pan-berempan
somebody	oreng
somehow	de'remmana
somehow	beremmana
someone	oreng
something	bhereng
sometimes	dheng-kadheng
song	nyanyian
soon	para'
sophisticated	mewah
Sorani	Sorani
Sorani	Besa Sorani
Sorani	bhâsa Sorani
sore	sake'
sore throat	sakek gherrungan
sorrow	kasossaan
Sorry	Saporana
sort	mèlè ban malaèn
sought	esarè
soul	roh
soulmate	jhudhu
sound	sowara
soup	sop
sour	celo'
source	sombher
south	lao'
space	ruang
space	jarak
spam	maksa
span	ajhângo
Spanish	Oreng Spanyol
spare	cadangan
speak	abenta
special	spesial
species	spesies
specific	paste
spectacular	lebhur sarah
speech	pidato
speechless	tak bisa
speed	cepet
spell	ngèjhâ
spend	matadhe'
spent	è patadhek
spicy	pedâs
spike	pakoh
spin	apotèr
spinach	tarnyak
spirit	roh
spit	acopa
splendid	bhagus sarah
split	pesah
spoil	manja
spoiled	e manja
spontaneous	cepat
spoon	sèndo'
spot	titik
spot	kennengan
spouse	pasangan
spread	nyebbar
spring	musem tombu
square	kotak
squeeze	mece'
squid	ennos
squirrel	âppu'
st	jhâlân
stab	e cocco
stable	jegjeg
stack	tompo'an
staff	panglako
stage	panggung
stain	tor-kotor
stairs	tingkat
stake	ataroan
stalk	ngawasi
stall	sellak
stall	macet
stamp	setempel
stand	manjeng
standard	okoran
star	bintang
start	molae
started	emolae
starving	kalaparan
state	nagara
state	ngoca'
statement	parnyataan
station	stasion
statue	patong
status	status
stay	ngenengi
stay safe	jagha kasalamedhan
steady	pagghun
steak	daging panggeng
steal	ngèco'
steam	kokos
steel	basse
steep	corem
stem	bhungka
step	cara
step	tengka'
stick	nempel
stick	tongket
stiff	kakoh
still	paggun
sting	beu sengnga'
stingy	motèk
stir	aghâluy
stock	stok
stolen	elang e keco'
stolen	ngico'
stomach	tabu'
stone	batoh
stood	manjheng
stool	bangku
stop	ambu
storage	kennengngan kaangguy nyèmpen
store	toko
store	nyempen
storm	angèn santak
story	careta
stove	tomang
straight	loros
straightforward	ghâmpang
strain	tekanan
strange	aneh
stranger	oreng aneh
strategy	cara
straw	dot sedot
strawberry	stroberi
streak	ghâris
stream	hulu
street	jhelen
strength	kakoatan
stress	stres
stretch	narèk
stretch	akalia'
strict	ketat
strike	nyerang
strike	mokol
string	talè
strip	ngombi'
strive	ikhtiyar
stroke	panyakek strok
stroke	mokol
strong	kuwat
struck	mârre
structure	sosonan
struggle	usaha
struggling	usaha
stubborn	tambeng
stuck	tak lancar
student	morèd
study	ajher
studying	parappa'na ajhèr
stuff	bharang
stunning	lebur
stupid	budhuh
stupid	bunggen
style	gaya
subject	oreng
subject	bhareng
submission	pangompolan
submit	ngompolagi
substance	bahan
substitute	se aghântèè
subtle	tak katon
succeed	sukses
success	sukses
successful	sukses
such	ce'
such	kadiyeh
such as	contona
suck	nyop-cop
sudden	ru-kaburuh
suddenly	tiba-tiba
suffer	menderita
suffering	malarat
sufficient	cokop
sugar	ghulâ
suggest	aberik saran
suggestion	saran
suit	cocok
suit	kalambi jas
suit	kamar hotel
suitable	cocok
suitcase	koper
suitcase	tas raje
sum	jumla
summary	ringkasan
summer	musem panas
summit	konco'
sun	mata'areh
sunday	ahad
sunny	terang
sunset	rop-sorop areh
sunshine	sonar arè
super	hebat
superior	bat mahebat
supervisor	pangawas
supper	adhe'er lem-malem
supper	ngakan malem
supply	aberik
support	sokongan
suppose	pantesah
supposed	esangghu
sure	yakin
surface	permukaan
surge	ngoprasi
surgery	oprasi
surname	nyamah
surprise	tak esangka
surprised	takerjet
surrender	pasra
surrounding	sakalelenga
surveillance	nyellingngaghi
survey	surve
survive	bertahan kaangguy odi'
suspect	ngèra
suspended	e tunda
suspicious	curiga
sustain	serra'
sustainability	alanjut ros terrosen
sustainable	serra'
swag	bharang ceco'an
swallow	ngalodu'
swap	morop
swear	asompa
sweat	pello
sweater	sweater
sweep	sapoan
sweet	manis
sweet dreams	mèmpè bhâgus
sweet tooth	senneng manes
sweetheart	sayang
swell	bere
swelling	bere
swim	alangngoy
swimming	alangngoy
swing	ngayun
switch	agente
swollen	bere
sword	pedang
symbol	tandah
sympathy	ate norok neser
symptoms	gejala
system	cara
table	meja
tackle	ngalakoni
tag	tandha
tail	bunto'
take	ngala'
take away	ghibe buruh
take care	ngopeni
take off	mukkal
taken	ekala'
talk	nyator
talkative	apokpak
talkative	amèlmèl
tall	tenggi
tap	pet
tap	noktok
tape	tapai
target	target
task	lalakon
taste	rassa
tasty	nyaman
taught	ngajer
tea	teh
teach	ngajâr
teacher	ghuruh
team	tim
tear	aèng mata
tears	aeng matah
tease	congoco
technology	teknologi
teeth	ghighi
tell	ngaberi
tell me	belei kule
temper	ma lembu' aghi
temperature	suhu
temple	klanteng
temporary	sementara
ten	sapolo
ten thousand	sapolo ebu
tenant	tempat
tend	tatarob
tendency	pamelean
tender	lembu'
tense	tegang
tension	kabâdhâan tak santai
tent	tenda
tentative	abeobe
term	istilah
terms	katantoan
terrible	jhubek
terrific	hebat
territory	wilayah
test	ujiân
text	becaan
than	etembheng
thank	sakalangkong
thank you	kalangkong
Thank you for your patience while we investigate shipment	kalangkong kasabbarna bhektona engkok ngurus keremna
thank you so much	mator sakalangkong
thank you very much	mator sakalangkong
thanks	kalangkong
Thanks for using our app	Mator kaso'on ampon agghunaghi aplikasi abhe' dhibik
that	arowa
that is	aroa
that's good	bâghus jarèya
the	arowa
theft	tokang ngala’an
their	andi'na oreng-oreng roa
them	oreng-oreng rowa
theme	tema
themselves	oreng-oreng roa
then	marena roa
theory	teori
there	edissa'
there are	bedha
there is	bedhe
therefore	mola dhari genika
these	areah
they	oreng-oreng rowa
they are	abe'na kabbhi
they are	be'na dhibi'
thick	kandel
thief	malèng
thigh	pokang
thin	koros
thing	bhârâng
things	reng-bereng
think	mikker
third	se nomor tello'
thirsty	pelka'
thirteen	tello bellas
thirty	tello polo
this	area
this is	area
thorough	tengate
thoroughly	sakabbhina
those	arowa
though	sanajjen
thought	mékkér
thought	pékkéran
thoughtful	ngastete
thoughts	pekkeran
thousand	ebu
thread	bula
threat	ancaman
threaten	ngancem
three	tellok
threshold	ambang betes
thrilled	bhunga sarah
thrive	lebbhâ'
throat	gherrungan
through	lébât
throughout	sakabbhi
throw	ngontallagi
thumb	empol
thunder	gludhuk
Thursday	Kemis
thus	aroa
tick	kotoh
tide	pasang
tidy	rapi
tie	dasi
tie	ikatan
tiger	macan
tight	ketat
Tigrinya	sala settong bhâsa e Afrika
Tigrinya	bhâsa Tigrinya
Tigrinya	Tigrinya
Tigrinya	Besa Tigrinya
time	bekto
timid	todusem
tiny	kinik
tip	bhajeren
tips	embu
tire	ban
tired	lessoh
tissue	tisu
title	judul
to	ka
to	dhâ'ka
to be	deddhi
toast	roti pangghâng
today	areh sateyah
toddler	nak-kanak
toes	gharighi'
together	asareng
toilet	kakus
told	ebâlâè
tolerance	mangarte
tolerate	ma jhârna
tolerate	mangarte
tomato	ranti
tomorrow	lagguna
tongue	elat
tonight	malem sateya
too	jugen
took	ngalak
tool	pakakas
tools	alat
tooth	ghighi
top	paling atas
top	paling begus
topic	se ekacaca
torn	bhedda
torn	acore
torture	nyèksa
total	jumlah
touch	nyèddhing
tough	Ghali
tough	malarat
tour	len-jhelenan
toward	ka
towards	nojju
towel	andok
town	kota
toxic	beracun
trace	lampat
track	lacak
track	jelen
trade	juwel
tradition	adhât
traditional	konah
traffic	lalu lintas
trail	lampat
train	alatih
train	kereta
training	alate
trait	bâbâthek
traits	bhâbhâtek
transfer	transfer
transition	pangobe'en
translate	terjemah
transparent	paddhâng
transport	angkot
transportation	angkotan
trap	alècang
trash	sarka
trauma	takok
trauma	rassa kobeter
trauma	was-was
travel	parjelenan
tray	baki
treasure	artah
treat	ngaladini
treatment	perawatan
tree	bhungka
tremendous	cè'rajhâna
trend	se satèya mashur
trial	percobaan
trick	akkal
tried	nyoba'
trigger	pemicu
trim	nyokor
trip	parjelenan
trouble	masalah
trousers	lebbhâr
truck	trek
true	TEPPA'
trunk	elongah ghâjhâ
trust	parcaje
truth	kebenderen
try	nyoba'
Tsonga	bhâsa Tsonga
Tsonga	Tsonga
Tsonga	sala settong bhâsa e Afrika
Tsonga	Besa Tsonga
tube	tabung
Tuesday	salasah
tuition	biaya
turkey	kalkun
turmeric	konye'
turn	abiluk
turn	atole
turtle	ra-korah
tutor	ngajhari
twelve	dubeles
twenty	dupolo
twenty-one	salekor
Twi	bhâsa Twi
Twi	Twi
Twi	sala settong bhâsa e Afrika
Twi	Besa Twi
twice	du kalè
twist	moter
two	duwe'
type	jenis
typical	tak padâ
typical	khas
ugly	jhube'
ultimate	dhi budhina
umbrella	pajung
unable	tak bisa
uncle	anom
unconscious	klenger
under	ebaba
underneath	e baba
underrated	e remeaghi
understand	ngarte
understood	ngarte
unfortunately	palangnga
uniform	saragam
unique	laen ban se laen
unit	bagien
university	universitas
unknown	tak kenal
unless	kecuali kalamon
until	sampe'
unusual	ta' biasa
up	attas
up to you	karebbe dhika
update	paleng anyar
upgrade	ningkat-aghi
upon	eatassa
upset	seddi
urban	kottha
urge	pangatero
urgent	penteng
us	kaule sadheje
use	ngangguy
used	eangguy
useful	agunah
useless	tadha' gunana
useless	tak manfaat
usual	sa-biasah
usual	biasah
usually	biasana
utility	kagunaan
vacation	liburan
vacation	aplesir
vaccination	e vaksin
vaccine	vaksin
vacuum	tanpa udara
vague	tak jellas
valid	teppak
valley	lemba
valuable	arghâ
value	nilai
value	arghe
variety	cem-macemma
various	cem-macemma
vary	amacem
vase	pot kembhang
vast	jembhâr
vegetable	lalap
vegetables	sayur
vehicle	kendaraan
vendor	pangada'
venom	jhaluna olar
venture	usaha
venue	kennengngan
verify	muktèaghi
versatile	serbaguna
version	versi
version	model
vertical	gharis loros ka atas
very	sangat
very good	ce' bhagussa
vessel	kapal
via	lebhâd
vibe	situasi
vibes	situasi
vicious	jahat
victim	korban
video	film
view	pemandangan
view	abes
village	disah
villain	penjahat
vinegar	cokka
vintage	kona
violence	kekerasan
violent	keras
viral	viros
virgin	parabân
virtual	virtual
virtue	tarakramah
vision	panengal
visit	ambu
visual	robeh
vital	penting
vivid	terang
vocabulary	kosa kata
voice	kasa'
voice	soara
void	kennengngan kosong
volume	volume
volunteer	relawan
vomit	ota
vulnerable	lemah
wage	bajaran
wage	opa
wages	opa
waist	monteng
wait	antos
waiter	pangladhin
waiting	nantos
wake	jeghe
wake up	jhegeh
walk	ajhalen
walking	ajelen
wall	geddung
wallet	dompet
wander	lenjelenan
wanna	terro
want	terro
wanted	se ekaterroè
war	perrang
wardrobe	kalambhi
warehouse	gudâng
warm	anga'
warn	ma-ènga'
warning	paenga'an
warrior	orèng sè ajuang
warrior	pajjhuang
was	ampon
wash	nyassa
waste	wang-muwang
waste	sarka
waste	rombuh
watch	ninggu
water	aeng
watermelon	somangka
wave	ombâ'
way	jhalen
way	cara
we	kulâ sadâjâh
we are	abe' dhibik
we can	abe' dhibik bisah
weak	kedur
weakness	kakorangan
wealth	kasehatan
wealthy	soghi
wear	ngangguy
wearing	ngangguy
weather	mosem
wedding	kabinan
Wednesday	rebbuh
weed	rebbhâ
week	minggu
weekend	aher minggu
weight	berre'na
weird	aneh
welcome	salamet deteng
welfare	kapojhurân
Well	Bhâgus
Well	Somor
well done	bagos
well done	mare
went	entar
were	ampon
west	bârâ'
wet	becca
whale	paus
what	napah
what about you	kalamon sampeyan beremma
what are you doing	apah sé élakoni bhâ'na
what are you doing now	apah sé élakoni bhâ'na sateya
what are you doing right now	be'na parrapa'na alako apa
what do you do	ba'na alako apa
what do you do for a living	apa ba'na ekalako
what do you mean	apah maksodha ba'na
what do you want	ponapa se ekasokan?
what happened	bede napa
what is	apah
what is this	apa riya?
what is your job	be'na alako apa
what is your name	sapah nyamana ba'na
what's up	apah
what's your name	sapa asmana be'na?
whatever	apa phei
wheat	gandum
wheel	roda
when	nalékana
whenever	bilâ bâi
where	edima
where are you	edima ba'na
where are you from	dâri dimma bâ'na
where are you now	edima ba'na sateya
where do you live	ba'na oreng dimma
where is	edimma
whereas	selain gheruwa
whether	ponapah
which	sekemma
while	salaggi'na
whisper	koto'an
whistle	pe-tope
whistle	pluit
white	pote
who	pasera
who are you	sampeyan sapa
who is	sapah
who is this	pasera panika
who is this	sapa riya
whole	kakappi
whom	sapa
whom	se
whose	andikna
why	arapah
why not	arapa mun njek
wicked	jahat
wide	lebhar
widow	randha
width	leberre
wife	bini
wild	liar
will	bhakal
willing	ghellem
win	mennang
wind	angin
window	jendèla
windy	angin
wine	arak
winter	mosem salju
wipe	ngosot
wipe	serbèt
wire	kabha'
wisdom	bijak
wise	bijak
wish	pangatero
wish you all the best	sadhaja kabhagusan kaator dha' dhika
witch	tokang seher
with	asareng
withdraw	narek
withdraw	macair
withdrawal	ngala'
within	e'dalam
without	tanpa
witness	sakseh
witty	penter
witty	cerdas
wolf	serigala
woman	bâbinè'
women	bebini' benya'
won	menang
won't	tak kèrah
wonder	keajaiban
wonderful	bhegus
wood	kajhu
wool	buluna embi'
word	kata
words	kata
work	alakoh
work out	olahraga
working	alako
world	dunnya
worm	cacèng
worn	ngangguy
worried	kobeter
worry	kobatèr
worse	lebih parah
worship	aibâdhâ
worship	abâjhâng
worst	paleng jubek
worth	pantes
worth it	pantes
worthy	pantes
would	bhakal
wound	loka
Wow	wow
wrap	mondhu'
wrath	napso
wrath	amarah
wrist	tanang
write	noles
Write here	Tolès e dinnak
writing	nolès
written	katoles
wrong	sala
wrote	noles
yard	tanèyan
yawn	auway
Yeah	Iya
year	taon
years	a on-taon
yeast	ragih
yell	atoat
yellow	konèng
Yes	Iyâ
yes baby	iye, sayang
yes dear	iyâ sayang
yes honey	ya sayang
yes my love	engghi sayang
yes of course	iye, pastena
yesterday	bheri'
yet	namong
yield	olle
you	bâ'na
you are	sampeyan
you are beautiful	be'na raddhin
you are so beautiful	be'na raddin sarah
you are welcome	sabhelik epon
you can	sampeyan bisa
You know	ba'na tao
you too	ba'na kèya
you're welcome	engghi pade-pade
young	ngode
your	andi'na ba'na
your welcome	dâpadâ
yourself	aba' dhibi'
youth	oreng ngodâ
you’re welcome	mator sakalangkong sabeligghâ
yummy	nyaman
zero	nol
