a	un
a little	un tiki
a lot	hopi
a lot of	hopi
abandon	bandoná
abandoned	bandoná
abide	kumpli
ability	abilidat
able	kapas
about	tokante
above	riba
abroad	ekstranhero
absence	ousensia
absent	ousente
absolutely	apsoluto
absorb	apsorbé
abstract	apstrakto
absurd	apsurdo
abundance	abundansia
abundant	abundante
abuse	abuso
accent	aksènt
accept	aseptá
access	akseso
accident	aksidente
accommodation	akomodashon
accomplish	alkansá
accomplished	a logra
according	sigun
account	kuenta
accuracy	eksaktitut
accurate	eksakto
accused	akusá
ache	doló
achieve	logra
achievement	logro
acknowledge	rekonosé
acquaintance	konosí
acquire	adkirí
acquired	optené
acquisition	kompra
across	dilanti di
act	aktua
action	akshon
active	aktivo
activities	aktividatnan
activity	aktividat
actor	aktor
actual	aktual
actually	en realidat
acute	agudo
adapt	adaptá
add	agregá
addicted	adikto
addition	komplemento
additional	adishonal
address	adrès
adequate	adekuá
adjacent	pegá ku
adjective	athetivo
adjust	ahustá
admire	atmirá
admit	admití
adopt	adoptá
adorable	tutu
advance	avansá
advanced	avansá
advantage	bentaha
adventure	aventura
adverb	atverbio
advertisement	anunsio
advertising	publisidat
advice	konseho
advise	konseho
advocate	defensor
aesthetic	estétiko
affair	asuntu
affect	afektá
affection	afekto
afford	pèrmití
affordable	pagabel
afraid	miedu
after	despues
afternoon	atardi
afterwards	despues
again	atrobe
against	kontra
age	edat
agency	agensia
agent	agente
aggressive	agresivo
agile	manehabel
ago	pasá
agree	di akuerdo
agreement	akuerdo
agriculture	agrikultura
ahead	delantá
aid	yudansa
aim	meta
air	airu
airport	aeropuerto
aisle	pasio
alarm	alarma
alcohol	alkohòl
alert	alerta
alive	bibu
all	tur
all right	ta bon
all the best	tur kos bon
allow	permití
allowed	pèrmití
almost	kasi
alone	so
along	kantu di
already	ya kaba
Alright	Ta bon
also	tambe
alternative	alternativa
although	a pesar ku
always	sèmper
am	ta
amazing	asombroso
ambiguous	ambiguo
ambition	ambishon
ambitious	ambisioso
amend	modifiká
amid	meimei
among	entre
among us	entre nos
amount	kantidat
amusing	prèt
an	un
analysis	análisis
ancestors	antepasadonan
anchor	ankla
ancient	antiguo
and	i
and you	i abo
angel	angel
anger	rabia
angle	ángulo
angry	rabiá
animal	bestia
ankle	ènkel
anniversary	aniversario
announcement	anunsio
annoy	fèrfelá
annoyed	fadá
annoying	fèrfelu
annual	anual
anonymous	anónimo
another	otro
answer	kontesta
anticipate	antisipá
anxiety	ansiedat
anxious	anshá
any	kualke
anymore	no mas
anyone	kualkier hende
anything	kualke kos
anyway	kon ku bini
anyways	en todo kaso
apart	apart
apartment	apartamento
apologize	despensá
apparent	aparente
apparently	aparentemente
appeal	apelashon
appear	parse
appearance	apariensia
appeared	aparesé
appetite	apetito
apple	apel
application	petishon
apply	apliká
appointment	sita
appreciate	apresiá
appreciation	apresio
approach	aserká
appropriate	apropiá
approval	aprobashon
approve	aprobá
approved	a aprobá
approximately	aproksimadamente
april	aprel
arbitrary	arbitrario
architect	arkitekto
architecture	arkitektura
archive	archivo
are	ta
are you	bo ta
are you busy	bo ta bezeg
are you married	bo ta kasá
are you married or single	bo ta kasá òf soltero
Are you still there?	Bo tei ahinda?
are you there	bo tei
area	área
argue	diskutí
argument	argumento
arise	surgi
arm	brasa
army	ehérsito
around	rònt di
arrange	regla
arrangement	akuerdo
arrival	yegada
arrive	yega
arrived	a yega
arrogant	arogante
arrow	flecha
art	arte
article	artíkulo
artificial	artifisial
artist	artista
as	manera
as long as	tanten ku
as well	tambe
as well as	manera
ash	as
ashamed	tin bèrgwensa
ask	puntra
asked	a puntra
asleep	drumí
aspect	aspekto
Assamese	Assamese
assault	atake
assembly	montahe
assertive	asertivo
assess	evaluá
assessment	evaluashon
asset	aktivo
assets	akshonnan
assign	asigná
assignment	ehresisio
assist	asistí
assistant	asistente
associate	sosio
associated	asosiá
association	asosiashon
assume	asumí
assumption	suposishon
at	na
at least	sikiera
ate	a kome
athlete	atleta
attach	athuntá
attached	athuntá
attachment	athunto
attack	atake
attempt	purba
attend	asistí
attendance	asistensia
attention	atenshon
attitude	aktitut
attract	atraé
attraction	atrakshon
attractive	atraktivo
attribute	atributo
audience	públiko
august	ougùstùs
aunt	tanta
aunty	tanchi
authentic	outéntiko
author	autor
authority	outoridat
autumn	hèrfst
available	disponibel
average	promedio
avoid	evitá
awake	spièrtá
award	premio
aware	konsiente
awareness	konsenshi
away	ousente
awesome	tremendo
awful	horibel
awkward	inkómodo
Aymara	Aymara
baby	beibi
bachelor	soltero
back	patras
background	desendensia
bad	malu
bag	saku
bait	garnachi
bake	hòrna
bakery	panaderia
baking soda	bikarbonato di soda
balance	balans
ball	bala
Bambara	Bambara
banana	bakoba
band	banda
bang	klap
bank	banko
bar	bar
barely	apénas
bargain	ganga
bark	blaf
barley	puspas
barrier	barera
base	base
based	basá na
basement	kèlder
basic	básiko
basically	basikamente
basil	yerba di hole
bastard	bastardo
batch	lote
bath	baño
bathroom	kamber di baño
battery	bateria
battle	bataya
bay	baia
be	ta
be careful	tene kuidou
beach	laman
beam	stral
beans	bonchinan
bear	ber
beard	barba
bearing	beri
beast	bestia
beat	derotá
beautiful	bunita
beauty	bunitesa
became	a bira
because	pasobra
become	a bira
bed	kama
bedroom	kamber
bee	abeha
beef	karni
been	tabata
beer	serbes
before	antes
began	a kuminsá
begin	kuminsá
beginning	kuminsamentu
behalf	na nòmber di
behave	komportá
behavior	komportamentu
behaviour	komportamentu
behind	patras
being	ta
being	ser humano
belief	kreensia
believe	kere
belly	barika
belong	pèrtenesé
beloved	stimá
below	abou
belt	faha
bench	banki
bend	dobla
beneath	bou di
benefit	benefisio
benefits	benefisionan
beside	banda di
besides	ademas di
best	mihó
best of luck	hopi éksito
best regards	un kordial saludo
better	mihó
between	meimei
beverage	bebida
beyond	mas leu
Bhojpuri	Bhojpuri
bias	prehuisio
biased	prehudisial
bicycle	baiskel
bid	ofresé
big	grandi
bike	baiskel
bill	kuenta
bind	mara
bird	para
birthday	dia di nasementu
bit	un tiki
bite	morde
bitter	marga
black	pretu
blade	blat
blame	kulpa
blank	bashí
blanket	deken
blast	eksploshon
bleach	kloròks
blend	meskla
bless	bendishon
blessed	bendishoná
blind	siegu
bliss	bienaventuransa
block	blòki
blood	sanger
bloom	floresementu
blow	supla
blue	blou
blunt	bòt
board	bòrchi
boat	boto
body	kurpa
boil	herebé
bold	lèter diki
bold	riská
bond	vínkulo
bone	wesu
book	buki
boost	impulso
booster	èmplifayer
boot	bota
boots	botanan
border	rant
bore	bora
bored	fèrfelá
boring	laf
born	nase
borrow	fia
boss	hefe
both	tur dos
bother	molèster
bottle	bòter
bottom	fondo
bought	a kumpra
bounce	bòns
bound	mará
boundaries	límitenan
bow	arko
bow	strek
bow	hasi reverensha
bowl	kòmchi
box	kaha
boy	mucha hòmber
boyfriend	frèi
bracelet	armbant
brain	serebro
branch	establesimentu
brand	marka
brave	baliente
breach	infrakshon
bread	pan
break	kibra
break	pousa
breakfast	desayuno
breast	pechu
breath	rosea
breathe	hala rosea
breed	rasa
brick	klenku
bride	brùit
bridge	brùg
brief	kòrtiku
bright	kla
brilliant	espléndido
bring	trese
bro	brò
broad	hanchu
broadcast	transmishon
broke	bashí
broke	a kibra
broken	kibrá
broom	basora
brother	ruman hòmber
brother in law	suá
brought	a trese
brown	brùin
brush	skeiru
bucket	hèmber
buddy	kompinchi
budget	presupuesto
bug	insekto
build	konstruí
building	edifisio
built	a konstruí
bulk	granèl
bull	toro
bully	tentadó
bump	desnivel
bunch	bòshi
bundle	pakete
burden	karga
buried	derá
burn	kima
burst	sker
bury	dera
bus	bùs
bush	mata
business	negoshi
bust	pechu
busy	drùk
but	pero
butter	manteka
butterfly	barbulètè
button	boton
buy	kumpra
by	dor di
by the way	a pesar
bye	ayo
cabbage	kolo
cabinet	kashi
cage	kouchi
cake	bolo
calf	bisé
calf	batata di pia
call	bèl
call	yama
call me	bèl mi
called	yamá
calm	kalma
came	a bini
campaign	kampaña
can	por
can't	no por
Cancel	Kanselá
cancer	kanser
capable	kapas
capacity	kapasidat
capital	kapital
caption	teksto abou
capture	kapturá
car	outo
career	karera
careful	kuidou
carefully	kuidadosamente
careless	deskuidá
caring	atento
carpenter	karpinté
carpet	tapeit
carrot	wòrtel
carry	karga
carry on	kontinuá
carry out	ehekutá
case	asuntu
cash	kèsh
cast	benta
castle	kastio
casual	kasual
cat	pushi
catch	fangu
category	kategoria
cattle	bakanan
caught	a kue
cause	kousa
caution	prekoushon
cautious	kouteloso
cave	kueba
cease	stòp
ceiling	plafòn
celebrate	selebrá
cell	sélula
center	sentro
century	siglo
cereal	sereal pa desayuno
ceremony	seremonia
certain	sigur
certainly	naturalmente
certificate	sertifikado
chain	kadena
chair	stul
challenge	desafio
chance	chèns
change	kambia
chaos	káos
character	karakter
characteristics	karakterísikanan
charge	kobra
charity	karidat
charming	simpátiko
chart	grafik
chase	pèrsiguí
chat	chèt
cheap	barata
cheat	hunga shushi
cheating	kòrta orea
cheating	hunga shushi
check	kuenta
check	chèk
cheek	banda di kara
cheer	animá
cheerful	kontentu
cheers	salú
cheese	keshi
chemistry	kímika
cherish	tesorá
chess	skak
chest	pechu
chest	kaha
chew	kou
chicken	galiña
chief	hefe
child	mucha
childhood	hubentut
children	muchanan
chill	fria
chill	rilèks
chimneys	chimenea
chin	kachete
chocolate	chukulati
choice	opshon
choose	skohe
chop	kòrta
chores	trabou di kas
chubby	gorditu
church	iglesia
cinnamon	kané
circle	serkel
circumstances	sirkunstansha
citizen	siudadano
city	siudat
claim	kleim
claim	demanda
clarify	klarifiká
class	klas
clay	klèi
clean	limpi
clear	transparente
clear	klaro
clerk	empleado
clever	sabí
client	kliente
cliff	baranka
climate	klima
climb	subi
clingy	pega pega
clock	oloshi
close	serka
close	sera
closet	kashi
cloth	duki
clothes	pañanan
cloud	nubia
cloudy	nublá
clown	payaso
clue	pista
clumsy	sokete
cluster	klùster
coach	entrenadó
coal	karbon
coast	kosta
coat	yas
coffee	kòfi
cognitive	kognitivo
coincidence	koinsidensia
cold	friu
collapse	kolapsá
collar	krag
colleague	kolega
colleagues	koleganan
collect	kolekshoná
collection	kolekshon
college	universidat
color	koló
colorless green ideas slept furiously	ideanan di koló bèrdè sin koló tabata drumi furiosamente
colour	koló
column	kolumna
comb	peña
combination	kombinashon
combine	kombiná
come	bini
come here	bin akinan
come on	ban
comfort	komfortabel
comfortable	komfortabel
coming	biniendo
coming soon	próksimamente
command	komandá
comment	komentá
commercial	komersial
commission	komishon
commit	kometé
commitment	kompromiso
committed	dediká
commodity	komodidat
common	komun
communicate	komuniká
communication	komunikashon
community	komunidat
commute	desplasamentu laboral
companion	kompañero
company	kompania
compare	kompará
comparison	komparashon
compassion	kompashon
compassionate	kompadesé
compatible	kompatibel
compete	kompetí
competent	kompetente
competition	kompetishon
competitive	kompetitivo
complain	keha
complaint	keho
complement	komplemento
complete	kompletu
complete	kaba
completely	kompletamente
complex	kompleho
compliance	kumplimentu
complicated	kompliká
compliment	kòmplimènt
comply	kumpli
composition	komposishon
compound	kompuesto
comprehension	komprenshon
comprehensive	komprensivo
compromise	kompromiso
compulsory	obligatorio
computer	kòmpiuter
concentrate	konsentrá
concept	konsepto
concern	preokupashon
concerned	preokupá
concert	konsierto
conclusion	konklushon
concrete	betòn
condition	kondishon
conditions	kondishonnan
conduct	komportashon
conduct	ehekutá
conference	konferesia
confess	konfesá
confidence	konfiansa
confident	sigur di su mes
confirm	konfirmá
conflict	konflikto
confused	bruhá
confusion	konfushon
congrats	pabien
congratulation	pa bien
congratulations	pabien
conjunction	konhunshon
connect	konektá
conquer	konkista
conscious	konsiente
consciousness	konsiensia
consent	pèrmití
consequences	konsekuensha
conservation	konservashon
conservative	konservativo
consider	konsiderá
considered	a konsiderá
consist	konsistí
consistency	konsistensia
consistent	konsistente
constant	konstante
constantly	konstantemente
constipation	será di kurpa
construction	konstrukshon
consume	konsumí
consumption	konsumo
contact	kontakto
contagious	kontagioso
contain	kontené
contains	e ta kontené
contemporary	kontemporáneo
contempt	despresio
content	kontenido
contest	kòntèst
context	konteksto
continent	kontinente
continue	kontinuá
contract	kontrato
contrast	kontraste
contribute	kontribuí
contribution	kontribushon
control	kòntròl
controversial	kontroversial
convenience	komodidat
convenient	adekuá
conversation	kòmbersashon
convert	kombertí
convey	transmití
convince	konvensé
convinced	kombensí
cook	kòki
cooking	kushinando
cool	cool
cooperation	koperashon
cope	akapará
copper	koper
core	núkleo
corn	maishi
corner	huki
correct	korekto
cost	kosto
costume	pak
cottage	kabana
cotton	katuna
couch	sofa
cough	tosa
could	lo por
council	konseho
count	konta
counter	kontadó
country	pais
countryside	kunuku
couple	par
couple	pareha
courage	kurashi
course	kurso
court	korte
courtesy	kortesia
cousin	primu
cover	tapa
cow	baka
coward	kobarde
cozy	komfortabel
crab	kangreu
crack	krak
craft	trabou di man
crap	kaka
crash	choke
craving	antoho
crawl	gatia
crazy	loko
create	krea
creative	kreativo
credit	krédito
creep	lastra
creepy	spantoso
crew	tripulashon
crime	krimen
cringe	krem den otro
crisis	krisis
criteria	kriterio
critical	krítiko
criticism	krítika
crop	kòrta
crop	kosecha
crops	kosechanan
cross	krus
cross	krusa
crow	krai
crowd	multitut di hende
crowded	yen yen
crown	korona
crucial	krusial
cruel	kruel
cruise	krusero
crush	machiká
crush	namorá
cry	yora
cucumber	kòmkòmer
cuddle	karisiá
culture	kultura
cunning	astuto
cup	kòpi
cupboard	kashi
curb	bògt
cure	kura
curfew	toke di keda
curiosity	kuriosidat
curious	kurioso
curly	krùl
currency	moneda
current	aktual
currently	aktualmente
curse	maldishon
curtain	kortina
cushion	kusinchi
custom	kustumber
custom	na midí
customer	kliente
customs	duana
cut	kòrta
cute	kiut
cycle	siklo
cycling	kore baiskel
dad	tata
daddy	papi
daily	tur dia
dairy	produkto di lechi
dam	dam
damage	daño
damn	malditu
damp	húmedo
dance	baila
danger	peliger
dangerous	peligroso
dark	sukú
darling	kerido
dash	strepi
data	dato
date	sita
date	fecha
daughter	yu muhé
day	dia
dead	morto
deadline	fecha límite
deaf	surdu
deal	dil
dear	estimado
Dear All	Estimado tur
Dear Customer	Estimado kliente
Dear Parents	Estimado mayornan
Dear Sir	Estimado señor
Dear students	Estimado estudiantenan
Dear Team	Estimado ekipo
death	morto
debate	debate
debit	debito
debris	restunan di demolishon
debt	debe
decade	dékada
decay	dekadensia
deceased	morto
deceive	gaña
december	dezèmber
decent	na drechi
decide	desidí
decided	a disidí
decision	desishon
deck	dèk
decline	rechasá
decline	bahada
decrease	bahamentu
dedicated	dediká
dedication	dedikashon
deed	akto
deep	hundu
deer	biná
default	standart
defeat	derotá
defend	defendé
define	definí
definitely	sigur
definition	definishon
degree	diploma
degree	grado
delay	retraso
delayed	retrasá
delete	eliminá
deliberate	deliberá
delicate	delikado
delicious	dushi
delight	delisia
delighted	kontentu
deliver	entregá
delivered	a entregá
delivery	entrega
demand	demanda
demanding	eksigente
democracy	demokrasia
demon	demonio
demonstrate	demostrá
denied	nengá
density	densidat
dentist	dentista
deny	nenga
department	departamento
departure	salida
depend	dependé
deploy	desplegá
deposit	bòrg
depressed	deprimí
depression	depreshon
depth	profundidat
describe	deskribí
description	deskripshon
desert	desierto
deserve	meresé
design	diseño
designation	designashon
desire	deseá
desk	büró
despair	desesperashon
desperate	desesperá
despite	a pesar di
dessert	pasaboka
destination	destino
destiny	destino
destroy	destruí
destruction	destrukshon
detail	detaye
details	detayenan
detect	detektá
determination	determinashon
determine	stipulá
determined	determiná
devastated	destruí
develop	desaroyá
developed	a desaroyá
development	desaroyo
device	aparato
devil	diabel
devoted	dediká
Dhivehi	Dhivehi
diabetes	diabétis
diarrhea	diarea
diary	diario
dictionary	dikshonario
did	a hasi
die	muri
died	a muri
diet	dieta
difference	diferensia
different	otro
different	diferente
difficult	difísil
dig	koba
dignity	dignidat
diligent	diligente
dinner	kuminda djanochi
dip	sambuyá
direct	direkto
direction	direkshon
director	direktor
dirt	porkeria
dirt	lodo
dirty	shushi
disable	desabilitá
disabled	desabilitá
disappear	disparsé
disappointed	desepshoná
disaster	desaster
discard	deskartá
discharge	deskarga
discipline	disiplina
discount	deskuento
discover	deskubrí
discrimination	diskriminashon
discuss	diskutí
discussion	diskushon
disease	malesa
diseases	malesanan
disguise	disfras
disgusting	repugnante
dish	kuminda
dishes	tayónan
dismiss	kita for di trabou
dispatch	despachá
display	reprodusí
disposal	eliminashon
dispute	disputa
distance	distansha
distinct	diferente
distinguish	diferenshá
distress	emergensia
distribution	distribushon
district	distrito
disturb	stroba
ditch	bandoná
ditch	roi
dive	sambuyá
diverse	diverso
diversity	diversidat
divide	parti
divine	divino
divorce	divorsio
dizzy	biramentu di kabes
do	hasi
do you	abo ta
do you love me	bo stima mi
doctor	dòkter
document	dokumento
does	hasi
doesn't	no ta
dog	kachó
Dogri	Dogri
doing	hasiendo
doll	pòpchi
domain	dominio
domestic	domestiko
dominant	dominante
don't	no
Don't worry	no wòri
donate	hasi donashon
done	klá
donkey	buriku
dope	tremendo
double	dòbel
doubt	duda
dough	mansa
down	abou
download	deskargá
draft	klat
draft	kònsèpt
drag	lastra
drain	drenahe
drama	drama
draw	pinta
drawer	lachi
drawing	dibuho
dread	tin miedu
dream	soño
dress	shimis
drill	bor
drink	bebe
drive	kore
drop	drùpel
drop	laga kai
dropped	a laga kai
drought	sekia
drunk	fuma
dry	seku
duck	patu
dude	sua
due	pa motibu di
due to	pa motibu di
dull	laf
dumb	dòm
dump	lèntfel
dump	kibra
duration	durashon
during	mientras
dust	stòf
duty	deber
dwell	permanesé
dying	muriendo
each	kada
each other	ku otro
eager	ansioso
eagle	águila
ear	orea
earlier	anteriormente
early	trempan
earn	gana
ears	oreanan
earth	mundu
earthquake	teremoto
ease	fasilidat
easily	fásilmente
east	ost
easy	fásil
eat	kome
eating	komiendo
economic	ekonómiko
economy	ekonomia
edge	rant
edit	editá
education	edukashon
effect	efekto
effective	efektivo
efficiency	efisiensia
efficient	efisiente
effort	esfuerso
egg	webu
eggplant	berehèin
ego	ego
eight	ocho
eighteen	diesocho
eighty	ochenta
either	sea
elaborate	elaborá
elbow	kokoti di man
elder	ansiano
elderly	hende grandi
elegant	elegante
element	elemento
elephant	olefante
eleven	diesun
eligible	na konsiderashon
eliminate	eliminá
else	otro
embarrassed	bèrgwensa
embarrassing	bergonsoso
embrace	brasa
emerge	surgi
emergency	emerhensia
emotional	emoshonal
empathy	empatía
emphasis	énfasis
emphasize	enfatisá
employee	empleado
employees	empleadonan
employer	dunadó di trabou
employment	empleo
empty	bashí
enable	aktivá
encounter	enkuentro
encourage	animá
end	final
endangered	menasá
endeavor	esfuerso
endurance	resistensia
endure	soportá
enemy	enemigo
energy	energía
engage	komprometé
engage	partisipá
engaged	komprometí
engagement	kompromiso
engine	motor
engineer	ingeniero
English	Ingles
enhance	mehorá
enjoy	disfrutá
enormous	enorme
enough	sufisiente
ensure	garantisá
enter	drenta
entertainment	farándula
enthusiasm	entusiasmo
enthusiastic	entusiasmá
entire	henter
entitled	titulá
entity	entidat
entrance	entrada
entrepreneur	empresario
envelope	ènvelòp
environment	medio ambiente
envy	envidiá
epic	épiko
epidemic	epidemia
equal	igual
equipment	ekipo
equity	akshon
equivalent	ekivalente
eraser	gùm
error	eror
escape	skapa
especially	spesialmente
essay	ensayo
essence	esensia
essential	esensial
establish	establesé
established	establesé
estate	propiedat
estimate	estimado
estimated	estimado
etc	etc
eternal	eterno
ethics	étika
evaluate	evaluá
evaluation	evaluashon
even	pareu
even though	maske
evening	anochi
event	evento
eventually	finalmente
ever	yega di
every	kada
everybody	tur hende
everyone	tur hende
everything	tur kos
evidence	prueba
evil	malisioso
evolution	evolushon
evolve	evolushoná
Ewe	Ewe
ex	èks
exact	eksakto
exactly	presis
exam	èksamen
examine	eksaminá
example	ehèmpel
exceed	sobrepasá
excellent	ekselente
except	eksepto
exception	eksepshon
excess	ekseso
excessive	eksesivo
exchange	interkambio
excited	speshá
excited	eksitá
excitement	eksitashon
exciting	eksitante
exclusive	eksklusivo
excuse	èksküs
excuse me	despensa
execute	ehekutá
execution	ehekushon
executive	ehekutivo
exercise	hasi deporte
exercise	ehersisio
exhaust	telpaip
exhausted	morto kansá
exhibit	eksibí
exhibition	eksibishon
exist	eksistí
existence	eksistensia
existing	eksistiendo
exit	salida
expand	ekspandé
expect	ferwagt
expected	sperá
expenses	gastonan
expensive	karu
experience	eksperiensia
experiment	eksperimento
expert	eksperto
expired	kaduká
explain	splika
explanation	eksplikashon
exploit	eksplotá
explore	eksplorá
export	eksportá
expose	eksponé
exposed	a eksponé
exposure	eksposishon
express	ekspresá
express	èksprès
expression	ekspreshon
extend	ekspandé
extended	ekstendé
extension	ekspanshon
extent	dimenshon
external	eksterno
extinct	ekstinshon
extra	èkstra
extract	ekstrakto
extraordinary	èkstraordinario
extreme	ekstremo
extremely	ekstremadamente
eye	wowo
eyes	wowonan
fabric	tela
fabulous	fabuloso
face	kara
face	konfrontá
facilitate	fasilitá
facilities	institushonnan
facility	institushon
fact	echo
factor	faktor
factory	fábrika
facts	echonan
fade	bira vago
fail	frakasá
failed	a faya
failure	frakaso
faint	desmayá
fair	honesto
fair	feria
fairly	basta
fairy	ada
faith	fe
faithful	leal
fake	falsu
fall	kai
FALSE	falsu
fame	fama
familiar	di konfiansa
familiar	konosí
family	famia
famine	hamber
famous	famoso
fan	fanátiko
fan	fèn
fancy	luhoso
fancy	gusta
fantastic	fantastiko
far	leu
farewell	despedida
farm	kunuku
farmer	kunukero
fascinating	fasinante
fashion	moda
fast	lihé
fat	gordo
fatal	letal
fate	destino
father	tata
fatigue	kansansio
fault	falta
favorite	preferí
favorite	faborito
favour	fabor
favourite	faborito
fear	miedu
feast	fiesta
feather	pluma
feature	karakterístika
features	karakterístikanan
february	febrüari
fed up	fadá
fee	tarifa
feed	duna kuminda
feedback	fitbèk
feel	sinti
feeling	sentimentu
feet	pia
fell	a kai
fellow	kompañero
felt	a sinti
female	femenino
fence	hèkchi
fertile	fértil
festival	festival
fetch	buska
fever	keintura
few	tiki
fewer	menos
fiance	prometido
fiction	fikshon
field	kunuku
fierce	brabu
fifteen	diesinku
fifty	sinkuenta
fight	bringa
fighting	bringando
figure	figura
figure out	averiguá
file	dokumento
fill	yena
filled	yená
film	pelíkula
filthy	shushi
finally	finalmente
finance	finansa
financial	finansiero
find	haña
find out	haña sá
fine	bon
finger	dede
finish	kaba
finished	kabá
finished	kla
fire	kandela
firm	fuerte
firm	kompania
first	prome
first name	promé nòmber
fish	piská
fit	pas
fit	fet
five	sinku
fix	drecha
fixed	a drecha
flag	bandera
flash	flèsh
flat	plat
flaw	fout
flawless	impekabel
flee	kore bai
flesh	karni
flew	a bula
flex	span
flexible	flèksibel
flight	vuelo
flip	bòltu
flirt	flert
flirting	bezeg ta flert
float	drif
flood	inundashon
floor	flur
flour	hariña
flow	fluho
flower	flor
flu	grip
fluent	papia bon
fluently	ku fluides
fluffy	plushi
fluid	líkido
fly	bula
focus	enfoká
fog	neblina
foggy	yen di neblina
fold	dobla
folks	hendenan
follow	sigui
follow up	sigimentu
following	siguiente
food	kuminda
fool	idiot
foolish	idiot
foot	pia
football	futbòl
for	pa
For example	Por ehèmpel
for instance	por ehèmpel
for you	pa bo
forbidden	prohibí
force	forsa
forecast	pronóstiko
forehead	frenta
foreign	ekstranhero
forest	mondi
forever	pa sèmper
forget	lubidá
forgive	pordoná
forgot	a lubidá
fork	fòrki
form	forma
formal	formal
former	antes
fortunately	afortunadamente
fortune	fortuna
forty	kuarenta
forty-two	kuarentidos
forward	dilanti
foster	fomentá
fought	a bringa
found	a haña
foundation	fundashon
four	kuater
fourteen	dieskuater
fox	soro
fragile	frágil
frame	leshi
framework	marko
fraud	froude
freak	straño
free	liber
freedom	libertat
freeze	fris
frequency	frekuensia
frequent	frekuente
frequently	frekuentemente
fresh	fresku
friday	djabièrnè
fridge	frishidèr
friend	amigu
friendly	amikabel
friends	amigunan
friendship	amistat
frightened	spantá
frightening	spantoso
frog	sapu
from	di
front	dilanti
frozen	di fris
fruit	fruta
frustrated	frustrá
fuel	kombustibel
Fulfulde	Fulfulde
full	yen
fun	dibertido
function	funshon
fundamental	fundamental
funeral	entiero
funny	prèt
fur	bònt
furious	furioso
furniture	muebel
further	mas detayá
furthermore	ademas
future	futuro
gain	ganashi
game	wega
gap	abismo
garage	garashi
garbage	shushi
garden	kurá
garlic	konofló
gate	porta grandi
gather	kolektá
gathering	reunion
gauge	meter
gave	a duna
gear	ekipamentu
gender	género
general	general
generally	generalmente
generate	generando
generation	generashon
generous	generoso
genius	genio
genre	género
gentle	suave
genuine	outéntiko
gesture	gesto
get	haña
get	buska
get dressed	bisti paña
get up	lanta para
get well soon	mehorá pronto
getting	hañando
ghost	spiritu
ghosting	ignorá
giant	gigante
gift	regalo
ginger	ehèmber
girl	mucha muhé
girlfriend	frei
give	duna
give up	bandoná
given	a duna
glad	kontentu
glance	bista
glass	glas
glasses	brelnan
glimpse	vislumbrá
global	global
gloomy	skur
gloves	hanskun
glow	lumbra
glow up	lumbra
glue	leim
go	bai
go ahead	bai numa
go away	bai
go to bed	bai kama
goal	ophetivo
goals	metanan
goat	kabritu
god	dios
god bless you	bendishon pa bo
goes	ta bai
going	bayendo
going to	mi ta bai
gold	oro
gone	a bai
gonna	m'a bai
goo	sleim
good	bon
good afternoon	bon tardi
good bye	ayo
good day	bon dia
good evening	bon nochi
good job	bon trabou
good looking	bunita
good luck	suerte
good morning	bon dia
good morning my love	bon dia mi amor
good night	bon nochi
goodbye	ayó
goodnight	bon nochi
goods	produktonan
Google	Google
Google Translate	Google Translate
goose	ganso
gorgeous	maravioso
gossip	redu
got	tabatin
got it	mi tin e
got it	mi a komprondé
government	gobièrnu
grab	kue
grade	grado
grade	sèifer
gradually	gradualmente
graduate	graduá
grain	grano
grant	supsidio
granted	konsedé
grapes	drùifnan
grasp	kue tene
grass	yerba
grateful	gradesido
gratitude	gradesimentu
grave	tumba
gray	shinishi
great	fantástiko
greed	kudishi
greedy	kodisioso
green	bèrdè
greet	kumindá
greeting	kumindamentu
greetings	kumindamentu
grey	shinishi
grid	raster
grief	luto
grind	mula
grip	gara
grocery	kompra
groom	kasadó
gross	fis
gross	bruto
ground	suela
group	grupo
grow	krese
growth	kresimentu
grumpy	fadá
Guarani	Guarani
guarantee	garantia
guard	vigilante
guess	rèi
guest	huéspet
guidance	guia
guide	guia
guilty	kulpabel
guy	gai
guys	matinan
gym	gym
habit	kustumber
habitat	habitat
had	tabatin
hail	hagel
hair	kabei
half	mitar
hall	hal
hand	man
handle	hèndel
handle	manehá
handsome	bunita
hang	kologá
hang out	ban basilá
happen	sosodé
happened	a pasa
happiness	felisidat
happy	felis
happy birthday	pabien
happy birthday to you	masha pabien pa bo
happy new year	felis aña nobo
hard	duru
hardly	apénas
hardly ever	kasi nunka
harm	daño
harmful	dañino
harmony	armonia
harsh	duru
harvest	koshecha
has	tin
hate	odia
have	tin
have a good day	pasa un bon dia
have a nice day	pasa un bon dia
have breakfast	desayuná
have fun	gosa di
have you eaten	bo a kome
having	teniendo
hazard	peliger
haze	neblina
he	e
he has	e tin
he is	e ta
head	kabes
headache	doló di kabes
heal	kura
healing	sanashon
health	salut
healthy	saludabel
hear	skucha
heard	a tende
heart	kurason
heat	kalor
heaven	shelu
heavy	pisá
hectic	agitá
height	altura
heir	heredero
heist	atrako
held	a tene
hell	fièrnu
Hello	Halo
hello dear	halo dushi
hello how are you	halo kon ta ku bo
hello how are you doing	halo konta bai ku bo
helmet	hèlm
help	yuda
helpful	servisial
hence	ta p'esei
her	e
herd	trupa
here	akinan
heritage	patrimonio
hesitate	duda
Hey	Hei
Hi	Hei
hi how are you	hei kon ta ku bo
Hi there	Hei konta
hidden	skondí
hide	skonde
hierarchy	herarkia
high	haltu
highlight	destaká
hike	keiru
hiking	keiru
hilarious	hopi prèt
hill	seru
him	e
hint	tep
hip	hep
hips	hepnan
hire	empleá
hiring	kontratá
his	di dje
history	historia
hit	dal
Hmm	Hmm
hobby	hòbi
hold	tene
hold on	warda un ratu
hole	buraku
holiday	fakansi
hollow	bashí
home	kas
homework	hùiswèrk
honest	honesto
honestly	sinseramente
Honey	Stropi di abeha
honor	honor
hood	kapushon
hook	ganchu
hop	ò
hope	spera
hopefully	ohalá
hopeless	sin speransa
horizontal	horizontal
horn	kachu
horrible	horibel
horror	horor
horse	kabai
hospital	hòspital
hospitality	horeka
host	anfitrion
hostile	hostil
hot	kayente
hotel	hotèl
hour	ora
hours	oranan
house	kas
household	doméstiko
how	kon
how about you	anto abo awor
how are you	kon ta ku bo
how are you doing	kon ta bai ku bo
how are you doing today	kon ta bai ku bo awe
how are you today	kon ta bai ku bo awe
how do you do	konta bai
how is	kon ta
how many	kuantu
how much	kuantu
how often	kuantu biá
how old are you	kuantu aña bo tin
how was your day	kon bo dia tabata
how was your night	kon tabata bo anochi
however	pero
hub	sentro
hubby	kasá
hug	brasa
huge	enorme
human	humano
humble	humilde
humid	úmedo
humidity	umedat
hundred	shen
hungry	hamber
hunt	yag
hurricane	orkan
hurry	hasi lihé
hurry up	hasi lihé
hurt	lastimá
husband	kasá
hustle	hasi lihé
hut	hùt
hygiene	higiene
I	ami
I am	Ami ta
I am fine	mi ta bon
I can	mi por
I can't	mi no por
I do	si mi ta
I do not know	mi no sa
I do not understand	mi no ta komprondé
I don't	mi no
I don't know	ami no sá
I don't understand	mi no ta kompronde
I don't understand what you mean	mi no ta kompronde kiko bo ke men
I don't understand you	mi no ta komprondé bo
I don’t know	mi no sa
I don’t understand	mi no ta komprondé
i guess	mi ta kere
I had	mi tabata tin
I have	mi tin
I have been	mi tababta
I hope so	mi ta spera
I know	mi sá
I like	mi gusta
I like you	mi gusta bo
I love	Mi stima
I love my big brother	mi stima mi ruman h
I love my big sister	mi stima mi ruman muhé grandi
I love my father	mi stima mi tata
I love my little brother	mi stima mi ruman hòmber chikí
I love my little sister	mi stima mi ruman muhé chikí
I love my mother	mi stima mi mama
I love you	Mi stima bo
I love you so much	Mi stima bo masha hopi
I love you too	mi tambe stima bo
I mean	mi ke men
I miss you	Mi ta sinti bo falta
I miss you so much	mi ta sinti bo falta hopi
I see	Mi ta mira
I think	mi ta pensa
I understand	Mi ta komprondé
I want	mi ke
I want to see you	mi kier wak bo
I want you	mi ke abo
I was	mi tabata
I will	mi lo
I would be	mi lo ta
I'm	Ami ta
I'm fine	mi ta bon
I'm good	mi ta bon
I'm here	Mi tei akinan
I'm sorry	despensá mi
ice	èis
ice cream	eiskrim
idea	idea
ideal	ideal
identical	identiko
identify	identifiká
identity	identidat
idiot	idiot
idle	inaktivo
idle	floho
if	si
ignore	ignorá
ill	malu
illegal	ilegal
illness	malesa
Ilocano	Ilocano
image	imágen
imagine	imaginá
immediate	imediatamente
immediately	mésora
immense	inmenso
impact	impakto
impatient	sin pashensi
implement	implementá
import	importashon
important	importante
impose	imponé
impossible	imposibel
impress	impreshoná
impression	impreshon
impressive	impreshonante
improve	mehorá
improvement	mehoria
in	den
in addition	ademas
In fact	En realidat
in front of	dilanti di
in order to	pa
inappropriate	inapropiá
incentive	estímulo
incident	insidente
include	inkluí
including	inklusive
income	entrada
inconvenience	inkumbiniensia
increase	oumentá
increased	oumentá
incredible	inkreibel
indeed	enberdat
independent	independiente
India	India
indicate	indiká
indigenous	indígena
individual	individual
industry	industria
inevitable	inevitabel
infant	yu na pechu
infection	infekshon
infinity	infinidat
inflammation	inflamashon
inflation	inflashon
influence	influensha
inform	informá
information	informashon
ingredients	ingredientenan
inheritance	herensha
initial	inisial
initiative	inisiativa
injured	herdiá
injury	leshon
innocent	inosente
innovation	inovashon
inquiry	investigashon
insane	loko
insect	insekto
insecure	inseguro
insert	insertá
inside	paden
insight	vishon
insist	insistí
insomnia	insomnio
inspiration	inspirashon
inspire	inspirá
install	instalá
instance	instansha
instant	instantáneo
instead	na lugá di
instead of	na lugá di
instructions	instrukshonnan
instrument	instrumento
insult	ofendé
insurance	seguro
intact	intakto
integrity	integridat
intellectual	intelektual
intelligence	inteligensia
intelligent	sabí
intend	pretendé
intended	destiná
intense	intenso
intention	intenshon
interact	interakshon
interaction	interakshon
interest	interes
interested	interesá
interesting	interesante
interfere	interferí
intermediate	intermedio
internal	interno
international	internashonal
internship	stazje
interpret	interpretá
interpreter	intérprete
interrupt	stroba
interview	entrevista
intimate	íntimo
into	den
introduce	introdusí
introduction	introdukshon
introvert	introvertí
intuition	intuishon
invalid	imbálido
invent	inventá
inventory	inventario
invest	invertí
investigate	investigá
invitation	invitashon
invite	invitá
invoice	faktura
involve	embolbí
involved	impliká
iron	heru
is	ta
island	isla
isolated	isolá
issue	problema
issues	problemanan
it	e
it is	e ta
it was	e tabata
it's	e ta
it's ok	e ta bon
It's okay	ta bon
item	artíkulo
items	artíkulonan
its	su
I’m	mi ta
jacket	yas
jail	prizòn
January	yanüari
jar	pòchi
jaw	kakumbein
jealous	yalurs
jerk	kabes di webu
jewelry	hoyanan
job	trabou
jogging	djòg
join	djòin
joint	konhunto
joke	wega
journalist	periodista
journey	biahe
joy	legría
judge	hues
judge	husga
juice	djus
july	juli
jump	bula
june	juni
junk	porkeria
just	djis
just do it	djis hasi' é
justice	hustisia
justify	hustifiká
Kalaallisut	Kalaallisut
keen	spièrtu
keep	mantené
keep	keda ku
keep it up	sigui asina
kept	a keda ku
kettle	ketel
key	yabi
kick	skòp
kid	mucha
kidding	wega
kidney	nir
kids	muchanan
kill	mata
kind	sorto
kind	amabel
kinda	mane
kindly	amikablemente
kindness	amabilidat
king	rei
kiss	sunchi
kitchen	kushina
kite	fli
kitten	pushi
knee	rudia
knew	tabata sá
knew	tabata konosé
knife	kuchú
knight	kabayero
know	sá
knowledge	konosementu
known	konosí
Konkani	Konkani
Krio	Krio
label	etikèt
labor	trabou
labour	laborá
labour	trabou
lack	falta
ladder	trapi
lady	dame
laid	poné
lake	mer
lamb	lamchi
lame	mankaron
lame	laf
lamp	lampi
land	pais
landscape	paisahe
language	idioma
lap	skochi
large	grandi
last	delaster
last but not least	pa finalisá
last name	fam
late	lat
lately	ultimamente
later	aweró
latest	último
latter	último menshoná
laugh	hari
laughing	hariendo
laughter	harimentu
launch	lansa
laundry	laba paña
law	lei
lawn	vèlt ku yerba
lawyer	abogado
lay	pone
layer	kapa
layout	diseño
lazy	floho
lead	guia
leader	lider
leaf	blachi
leak	lèk
lean	flaku
lean	lèn
leap	bulá
learn	siña
learning	siñando
lease	lis
least	mas mínimo
leather	kueru
leave	bai
leaves	blachinan
leaves	e ta bai
led	chumbu
left	robes
left	a bai
leg	pia
legacy	herensha
legal	legal
legend	leyenda
legit	legítimo
leisure	tempu liber
lend	fía
length	largura
less	menos
lesson	lès
let	hür
let	laga
letter	lèter
letter	karta
lettuce	kròpslá
level	nivel
leverage	influensha
liability	responsabilidat
library	biblioteka
lick	lembe
lie	gaña
lies	gañamentu
life	bida
lift	left
lift	hisa
light	lus
light	lihé
lightning	welek
like	gusta
likely	probablemente
likewise	igualmente
line	liña
Lingala	Lingala
link	lenk
lion	leon
liquid	líkido
list	lista
listen	tende
listening	skuchando
literally	literal
literature	literatura
litter	shushi
little	chikí
little	chikítu
live	biba
liver	higra
lives	bidanan
living	bibando
living room	sala
lizard	lagadishi
load	karga
loaf	bara di pan
loan	fiansa
local	lokal
location	lugá
lock	kandal
lock	sera na yabi
lockdown	siere
log	registrá
log	blòki di palu
lol	lol
lonely	solitario
long	largu
long time no see	hopi tempu sin mira bo
look	apariensia
look	wak
loop	las
loose	lòs
lord	Dios
lose	pèrdè
loss	pèrdida
lost	a pèrdè
lot	parsela
loud	duru
lounge	lòbi
love	amor
love you	stima bo
lovely	nèchi
low	abou
lower	mas abou
loyal	leal
loyalty	lealtat
luck	suerte
lucky	tin suerte
Luganda	Luganda
luggage	ekipahe
lump	bòlòbònchi
lunch	lùnch
lungs	pulmonnan
luxury	luho
lying	gañando
machine	mashin
mad	rabiá
madam	señora
made	a hasi
magazine	revista
magnificent	magnífiko
maid	kriá
main	prinsipal
maintain	mantené
maintenance	mantenementu
Maithili	Maithili
major	grandi
majority	mayoria
make	hasi
make up	makiyahe
male	maskulino
mall	sentro komersial
man	hòmber
manage	atministrá
management	gerensia
manager	gerente
mandatory	obligatorio
manifest	manifestá
manifest	lista di pasahero
manipulate	manipulá
manner	maner
manual	manual
many	hopi
many many happy returns of the day	masha pa bien i hopi aña mas di bida
march	mart
margin	márgen
market	merkado
marriage	matrimonio
married	kasá
mask	masker
mass	gran kantidat
massive	masivo
master	dominá
master	doño
match	korespondé
match	torneo
mate	amigu
mate	stürman
material	material
math	matemátika
matter	importansha
maturity	madures
may	por
may	mei
maybe	por ta
me	ami
me too	ami tambe
meal	kuminda
mean	nifiká
mean	malu
meaning	nifikashon
means	nifiká
meant	tabata ke men
meanwhile	mientras
measure	midi
measures	medidanan
meat	karni
medical	médiko
medicine	medisina
meditation	meditashon
medium	mediano
meet	reuní
meet	konosé
meeting	reunion
Meiteilon	Meiteilon
melt	smèlt
memories	memorianan
memory	memoria
mental	mental
mention	menshoná
mentioned	a menshoná
mentor	mèntòr
merchant	komersiante
mercy	piedat
merely	únikamente
merry christmas	bon pasku
mess	potoshi
message	mensahe
messy	bruá
metal	metal
method	método
mice	ratonnan
middle	mèi mèi
midnight	mèi anochi
might	portá
mild	suave
milestone	evento importante
military	militar
milk	lechi
million	mion
mind	mente
mindset	mentalidat
mine	dimi
mingle	meskla
minor	menor
minute	minüt
minutes	minütnan
miracle	milager
mirror	spil
miscellaneous	diverso
mischievous	malamucha
miserable	miserabel
misery	miseria
miss	señora
miss you	sinti bo falta
missing	disparsé
mission	mishon
mist	neblina
mistake	fout
Mizo	Mizo
mobile	selular
mock	tenta
model	modelo
moderate	moderá
modern	moderno
modest	modesto
moist	umedat
moisture	humedat
mold	beskein
mole	skupi di Dios
mole	talpa
mom	mama
moment	momento
monday	djaluna
money	sèn
monitor	pantaya
monkey	makaku
month	luna
mood	ambiente
mood	bèis
moody	mal beis
moon	luna
moral	moral
more	mas
moreover	ademas
morning	meinta
mortgage	hipotek
most	mayoria
mostly	prinsipalmente
mother	mama
motion	moshon
motivation	motivashon
mountain	seru
mouse	raton
mouth	boka
move	move
movement	moveshon
movie	pelíkula
mrs	sra
much	hopi
mud	lodo
mug	kòpi
muscle	múskulo
museum	museo
mushroom	champiñon
music	músika
must	mester
mute	baha zonido
mutual	mutuamente
my	di mi
My dear	Mi kerido
my friend	mi amigu
My hovercraft is full of eels	Mi hovercraft ta yen di kolebranan
my love	mi amor
my name is	mi nòmber ta
my pleasure	un plaser
myself	mi mes
mysterious	misterioso
mystery	misterio
myth	mito
nail	uña
naive	inosente
name	nòmber
narrative	narativo
narrow	smal
nasty	fis
national	nashonal
nationality	nashonalidat
native	indígena
natural	natural
nature	naturalesa
nausea	walmentu di stoma
near	serka
nearby	serka di
nearly	kasi
neat	desente
necessary	nesesario
neck	nèk
necklace	kadena
need	mester
negative	negativo
neglect	abandono
negotiate	negoshá
neighbor	bisiña
neighborhood	bario
neither	niun di dos
nephew	subrino
nerd	nerd
nervous	nèrvioso
nest	nèshi
net	nèt
network	ret
neutral	neutral
never	nunka
never give up	nunka pèrdè bo kurashi
never mind	legumai
nevermind	legumai
nevertheless	sin embargo
new	nobo
news	notisio
next	siguiente
next to	banda di
nice	agradabel
nice to meet you	un plaser di konose bo
niece	subrina
night	anochi
nightmare	pesadia
nine	nuebe
nineteen	diesnuebe
ninety	nobenta
No	No
no problem	sin problema
no way	no yu
nobody	niun hende
noise	zonido
noisy	hasi bochincha
none	niun
noon	mèrdia
nope	nò
nor	ni
normal	normal
north	nort
nose	nanishi
nostalgic	nostálgiko
not	no
not at all	di nada
not bad	no ta dje malu
Not now	Aworaki no
not yet	ahinda no
note	nota
noted	anotá
nothing	nada
notice	notifikashon
notice	ripará
noticed	a ripará
noun	sustantivo
nouns	sustantivonan
novel	novela
november	novèmber
now	aworaki
nowadays	awendia
nuisance	molèster
null	sero
numb	ferdof
number	number
nurse	zùster
nut	nechi
nutmeg	nétumuskat
nutrition	nutrishon
oath	huramentu
obesity	sobrepeso
obey	obedesé
object	opheto
objective	ophetivo
obligation	obligashon
obscure	skur
observation	opservashon
observe	opservá
obsessed	opseshoná
obsession	opseshon
obsolete	antikuá
obstacle	opstákulo
obtain	optené
obtained	optené
obvious	opvio
obviously	opviamente
occasionally	okashonal
occupation	okupashon
occupied	okupá
occur	sosodé
occurred	a sosodé
occurs	ta sosodé
ocean	osean
october	òktober
odd	straño
odds	chèns
of	òf
of course	kómpolaga
off	pagá
off	liber
offensive	ofensivo
offer	ofresé
office	kantor
official	ofisial
often	frekeunte
Oh	An
oh really	an berdat
oil	zeta
ok	ok
ok dear	ok dushi
ok honey	ok dushi
ok my love	ok mi amor
okay	ok
okay baby	ok beibi
okay dear	ok dushi
okay honey	ok dushi
okay my love	ok mi amor
old	bieu
on	riba
once	un biá
one	unu
one language is never enough	un idioma nunka ta sufisiente
onion	siboyo
online	online
only	so
open	habrí
operation	operashon
opinion	opinion
opportunities	oportunidatnan
opportunity	oportunidat
opposite	kontrali
optimistic	optimístiko
option	opshon
optional	opshonal
or	òf
orange	oraño
order	manda
order	pidi
ordinary	nòrmal
organization	organisashon
orientation	orientashon
origin	orígen
original	original
Oromo	Oromo
orphan	wérfano
other	otro
otherwise	sino
ought	lo
our	nos
Our mission: to enable everyone, everywhere to understand the world and express themselves across languages.	Nos mishon: ta pa aktivá tur hende, tur kaminda na mundu pa nan komprondé e mundu i pa nan ekspresá nan mes den tur idiomanan.
Our mission: to organize the world's information and make it universally accessible and useful.	Nos mishon: pa organisá e informashon na mundu i hasi'é universalmente aksesibel i útil.
out	pafó
outcome	resultado
outfit	bistuario
outgoing	èkstrovèrt
outlet	stòpkontakt
outline	skema
outside	pafó
outstanding	sobresalí
oven	fòrnu
over	pasá
over there	einan
overall	general
overcome	derotá
overthinking	pensa di mas
overwhelmed	abrumá
overwhelming	abrumador
owe	debe
owl	palabrua
own	propio
owner	doño
ox	bue
pace	tèmpo
pack	empaketá
package	pakete
paid	pagá
pain	doló
paint	pintura
painting	pintura
pair	par
pale	pálido
palm	palma
pan	panchi
pandemic	pandemia
panic	pániko
pants	karsonnan
paper	papel
Papiamento	Papiamentu
paradise	paraiso
parallel	paralelo
parcel	pakete
pardon	pordoná
parents	mayornan
park	parke
parrot	lora
parsley	pitiseli
part	parte
participate	partisipá
particular	spesífiko
particularly	partikularmente
partner	pareha
party	fiesta
pass	pas
pass	laga pasa
passage	tránsito
passed	a pasa
passion	pashon
passionate	pashoná
passive	pasivo
password	password
past	pasado
patch	lapi
path	kaminda
pathetic	pobersitu
patience	pasenshi
patient	pashente
patient	pasenshi
pattern	patronchi
pause	pousa
pavement	stupi
pay	paga
payment	pago
peace	pas
peaceful	trankil
peach	pich
peak	piko
pear	pera
peas	èrtu
peculiar	pekuliar
pee	pishi
peel	pela
peer	kolega
peers	koleganan
pen	pèn
pencil	pòtlot
pending	na espera di
people	hende
pepper	peper
perceive	persibí
perception	persepshon
perfect	perfekto
perform	aktua
performance	produktividat
performance	aktuashon
perhaps	porta
period	temporada
period	punto
period	regla
permanent	permanente
permission	pèrmit
permit	pèrmit
perseverance	perseveransha
persistent	persistente
person	persona
personal	personal
personality	personalidat
perspective	perspektiva
persuade	kombensé
pervert	pèrbertido
pet	bestia di kas
phase	fase
phenomenon	fenómeno
philosophy	filosofia
phone	telefòn
photo	potrèt
phrase	frase
physical	físiko
pick	skohe
pick up	piki
pick up	buska
picture	potrèt
piece	pida
pieces	pidanan
pig	porko
pigeon	paloma
pile	stapel
pillow	kusinchi
pilot	piloto
pin	pènchi
pineapple	anasa
pink	ros
pit	pos
pitch	tono
pity	kompashon
place	lugá
places	lugánan
plague	plaga
plain	simpel
plan	plania
plane	avion
plant	mata
plants	matanan
plate	tayó
platform	plataforma
play	hunga
playing	hungando
pleasant	agradabel
please	por fabor
pleased	satisfecho
pleasure	plaser
pledge	promesa
plenty	basta
plot	trama
plug	stèker
plum	preimu
plumber	paipfeter
plural	plural
podcast	podcast
poem	poema
poetry	poesia
point	punto
point	señalá
poison	venenu
police	polis
policy	polítika
polite	eduká
pollution	kontaminashon
pond	tanki di awa
pool	pul
poop	pupu
poor	pober
pop	eksploshon
popular	popular
population	poblashon
pork	porko
porridge	papa
port	haf
position	posishon
positive	positivo
possess	poseé
possession	poseshon
possessive	posesivo
possible	posibilidat
post	pòst
postpone	aplasá
potato	batata
potential	potensial
pound	liber
poverty	pobresa
power	poder
powerful	poderoso
practical	práktiko
practice	praktiká
praise	alabansa
prank	ko'i prèt
pray	resa
precious	balioso
precise	eksakto
precisely	presisamente
predict	pronostiká
prefer	preferá
preference	preferensha
pregnant	na estado
prejudice	prehuisio
premises	edifisionan
premium	premium
preparation	preparashon
prepare	prepará
prepared	a prepará
preposition	preposishon
presence	presensia
present	presentá
present	presente
presentation	presentashon
preserve	preservá
president	presidente
press	prensa
press	primi
pressure	preshon
pretend	hasi manera
pretty	nèchi
prevent	prevení
previous	pasá
prey	resa
price	preis
pride	orguyo
priest	saserdote
primary	primario
prime	primario
princess	prinsesa
principal	prinsipal
prior	prome
priority	prioridat
prison	prizòn
privacy	privasidat
private	privá
privilege	privilegio
prize	premio
probably	probablemente
problem	problema
procedure	prosedimentu
proceed	sigui
process	proseso
produce	produsí
product	produkto
production	produkshon
profession	profeshon
professional	profeshonal
profile	profil
profit	ganashi
profound	profundo
progress	progreso
project	proyekto
prominent	destaká
promise	promesa
promote	promové
promotion	promoshon
prompt	rápido
prone	suseptibel
pronouns	pronòmber
pronunciation	pronunsiashon
proof	prueba
proper	apropiá
properly	apropiá
properties	kualidatnan
property	propiedat
proposal	proposishon
prospect	perspektiva
prosperity	prosperidat
prosperous	próspero
protect	protehá
proud	orguyoso
prove	proba
provide	ofresé
provided	brinda
province	provinsia
provision	provishon
puberty	pubertat
public	públiko
pull	hala
pumpkin	pampuna
punctual	puntual
pupil	alumno
purchase	kumpra
pure	puro
purple	püs
purpose	ophetivo
purse	tas
pursue	buska
pursuit	persekushon
push	pusha
put	pone
qualification	kalifikashon
quality	kalidat
quantity	kantidat
quarantine	kuarentena
quarrel	pleitamentu
quarter	kuartal
Quechua	Quechua
queen	reina
queer	gei
query	konsulta
question	pregunta
queue	rèi
quick	lihé
quickly	lihé lihé
quiet	ketu
quilt	deken
quit	stòp
quite	basta
quiz	kues
quotation	presupuesto
quote	sita
quotes	sitanan
rabbit	konènchi
race	kareda
rage	rabia
rain	awaseru
raise	oumentá
raised	subí
ran	el a kore
random	arbitratio
range	alkanse
rapid	lihé
rapidly	rápidamente
rare	poko komun
rarely	rara bes
rash	erupshon
rat	djaka
rate	tarifa
rather	preferá
ratio	proporshon
rational	rashonal
raw	kurú
re	atrobe
reach	logra
reached	a alkansá
reaction	reakshon
read	lesa
reading	lesando
ready	klá
real	berdadero
reality	realidat
realize	realisá
realized	a realisá
really	realmente
rear	patras
reason	rason
reasonable	rasonabel
recall	debolbé
receipt	resibu
receive	risibí
received	a risibí
recent	resiente
recently	resientemente
reception	resepshon
recipe	reseta
reckless	deskabeyá
recognition	rekonosementu
recognize	rekonosé
recommend	rekomendá
recommended	a rekomendá
record	registro
record	graba
recover	rekuperá
recovery	rekuperashon
rectangle	rektángulo
red	kòrá
redeem	kambia
redemption	amortisá
reduce	redusí
redundant	reduntante
refer	referí
reference	referensia
reflect	reflehá
reflection	reflekshon
refrain	refrein
refrigerator	frishidèr
refund	paga bèk
refuse	rechasá
refused	nengá
regard	konsiderá
regard	relashoná ku
regarding	en relashon ku
regardless	a pesar di
regards	saludo
region	region
register	registrá
regret	repentimentu
regular	regular
regularly	regularmente
reject	rechasá
relate	relatá
related	parentá
relationship	relashon
relative	relativo
relative	miembro di famia
relatives	miembronan di famia
relax	rilèks
release	publiká
release	liberá
released	publiká
relevant	relevante
reliable	konfiabel
relief	alivio
relieve	aliviá
relieved	aliviá
religion	religion
religious	religioso
reluctant	no dispuesto
rely	dependé
remain	keda
remaining	restu
remarkable	remarkabel
remedy	remedio
remember	kòrda
remind	kòrda
reminder	rekordatorio
remote	kontrol di man
remote	apartá
remove	eliminá
render	reprodusí
rent	hür
repair	drecha
repeat	hasi di nobo
replace	kambia
reply	respondé
report	reportá
represent	representá
reputation	reputashon
request	petishon
require	mester di
required	rekerí
rescue	reskatá
research	inverstigashon
resemble	parse
resentment	renkor
reservation	reservashon
reserve	reservá
resident	residente
resign	renunsiá
resilience	resistensha
resilient	resistente
resist	resistí
resistance	resistensia
resolution	resolushon
resolve	resolvé
resort	resort
resources	rekursonan
respect	rèspèt
respond	kontestá
response	kontesta
responsibility	responsabilidat
responsible	responsabel
rest	sobrá
rest	sosegá
rest in peace	sesegá na pas
restaurant	restaurant
restore	rekuperá
restrict	restringí
result	resultado
results	resultadonan
resume	resumí
retail	komèrsio minorista
retain	konservá
retention	retenshon
retired	penshoná
retreat	retirada
retrieve	kolektá
return	bolbe
reveal	revelá
revealed	revelá
revenge	bengansa
revenue	entrada
reverse	kontrali
review	evaluashon
revise	kontrolá
revision	revishon
revolution	revolushon
reward	rekompensa
rhythm	ritmo
rib	repchi
rice	aros
rich	riku
rid	deshasí
ride	kore
ridiculous	ridíkulo
right	korekto
right	man drechi
right now	aworaki
rigid	duru
ring	renchi
rinse	hawa
riot	rebelion
rip	skùr
ripe	madurá
rise	subida
risk	riesgo
rival	rival
river	riu
road	kaminda
roast	hòrna
robust	robusto
rock	piedra
rod	bara
role	papel
roll	lora
roof	daki
room	kamber
root	rais
rope	kabuya
rotten	putrí
rough	ròf
roughly	mas o menos
round	rondó
route	ruta
routine	rutina
row	rèi
rub	frega
rubber	rùber
rubbish	shushi
rubbish	ko'i kèns
rude	ònbeskòp
rug	lomba
ruin	ruina
rule	regla
ruler	linial
rules	reglanan
run	kore
running	koriendo
rural	rural
rush	ansha
sack	saku
sacred	sagrado
sacrifice	sakrifisio
safe	seif
safe flight	bon biahe
safety	seguridat
sage	sali
said	a bisa
sail	bela di boto
sail	nabegá
sailing	nabegando
sake	interes
salary	salario
sale	baratio
salmon	salmou
salt	salu
same	mésun
Same here	mesun kos akinan
sample	muestra
sand	santu
Sanskrit	Sanskrit
sarcastic	sarkástiko
sassy	fresku
sat	a sinta
satisfaction	satisfakshon
satisfied	satisfecho
satisfy	satisfasé
satisfying	satisfaktorio
Saturday	Djasabra
sausage	sosèshi
savage	salbahe
save	reskatá
saw	a wak
say	bisa
scale	balansa
scam	froude
scar	sikatris
scarce	skars
scared	tin miedu
scarf	shal
scary	ta spanta
scattered	plamá
scene	esena
scenery	paisahe
scent	aroma
schedule	orario
school	skol
science	siensia
scientist	sientífiko
scientists	sientífikonan
scissors	skèrnan
scold	zundra
scope	grandura
score	puntuashon
scrap	heru bieu
scratch	raska
scream	grita
screen	pantaya
screw	skruf
script	guion
sea	laman
seal	kachó di awa
seal	seya
search	buska
season	temporada
seat	asiento
second	di dos
second	segundo
secret	sekreto
section	sekshon
secure	seguro
security	seguridat
see	mira
see you	wak bo
see you later	te aweró
see you soon	te aweró
see you tomorrow	te mañan
seed	simia
seek	buska
seem	parse
seems	parse
seen	a wak
seize	probechá
seizure	atake
seldom	rara bes
select	selekshoná
self	mes
self healing	auto sanashon
selfish	egoista
sell	bende
send	manda
send me your picture	manda mi bo potrèt
senior	hende grandi
sense	sensashon
sensible	sensato
sensitive	sensitivo
sent	a manda
sentence	frase
sentences	orashonnan
separate	apart
Sepedi	Sepedi
september	sèptèmber
sequence	sekuensia
series	serienan
serious	serio
seriously	den serio
serve	sirbi
service	servisio
session	seshon
set	establesé
set up	establesé
setting	konfigurashon
settle	regla
seven	shete
seventeen	diesshete
seventy	setenta
several	vários
severe	grave
sew	kose
sh	sh
shade	sombra
shadow	sombra
shake	bati
shall	lo
shallow	poko hundu
shame	bèrgwensa
shape	forma
share	parti
sharp	skèrpi
she	e
she has	e tin
she is	e ta
shed	depósito
shed	drama
sheep	karné
sheet	blachi
sheet	klechi
shelf	planki
shell	kokolishi
shelter	refugio
shield	eskudo
shift	warda
shift	desplasamentu
shine	bria
ship	barku
shipping	ekspedishon
shirt	kamisa
shoes	sapatunan
shoot	tira
shop	pakus
shopping	hasi kompra
shore	kantu di awa
short	kòrtiku
shortage	eskases
shot	a tira
should	lo
shoulder	skouder
shout	grita
show	mustra
show	show
show me	mustra mi
shower	ducha
shrimp	kabaron
shrink	redusí
shut	será
shut up	sera bo boka
shy	tímido
sibling	ruman
siblings	rumannan
sick	malu
side	banda
sigh	suspiro
sight	visibilidat
sightseeing	keiru
sign	señal
sign	firma
signature	firma
significant	importante
silence	silensio
silent	silensioso
silk	seda
silly	kèns
silver	plata
similar	komparabel
simp	bobo
simple	simpel
simultaneously	pareu
since	for di
sincere	sinsero
sincerely	sinseramente
sing	kanta
singer	kantante
single	soltero
single	so
sink	wasbak
sink	hundi
Sir	Señor
sister	ruman muhé
sister in law	kuñá
sit	sinta
site	lugá
situation	situashon
six	seis
sixteen	diesseis
sixty	sesenta
size	sais
size	tamaño
skill	abilidat
skills	abilidatnan
skin	kueru
skinny	flaku
skip	salta
skirt	saya
sky	shelu
slave	katibu
sleep	drumi
sleeping	drumiendo
sleepy	sinti soño
sleeve	manga
slice	snechi
slide	skùif
slide	slait
slightly	un tiki
slim	delegá
slip	slep
slope	inklinashon
slot	buraku largu smal
slow	pokopoko
slowly	pokopoko
small	chikí
smart	inteligente
smell	hole
smile	sonrisa
smoke	huma
smooth	suave
snack	snèk
snail	koklishi
snake	kolebra
snap	kibra
snow	sneu
so	e ora ei
so cute	hopi tutu
so far	te awor
soak	remohá
soap	habon
sober	sobrio
soccer	futbòl
social	sosial
society	sosiedat
socks	meya
soft	moli
software	software
soil	tera
sold	bendé
sold out	agotá
soldier	soldá
sole	zol
solid	duru
solution	solution
solve	solushoná
some	algun
somebody	algun hende
somehow	di algun manera
someone	algun hende
something	algu
sometimes	tin biaha
song	kantika
soon	próksimamente
sophisticated	refiná
Sorani	Sorani
sore	doló
sore throat	doló di garganta
sorrow	fèrdrit
Sorry	Despensa
sort	tipo
sought	a buska
soul	alma
soulmate	kompañero di alma
sound	zonido
soup	sòpi
sour	zür
source	rekurso
south	sùit
space	espasio
spam	spam
span	embergadura
Spanish	spañó
spare	reserva
speak	papia
special	spesial
species	espesie
specific	spesífiko
spectacular	spektakular
speech	diskurso
speechless	sin palabra
speed	velosidat
spell	enkanto
spell	spèl
spend	gasta
spend	dediká
spent	a pasa
spent	a gasta
spicy	pika
spike	oumento
spin	lora
spinach	spinazi
spirit	spiritu
spit	skupi
splendid	espléndido
split	parti
spoil	putri
spoil	malkriá
spoiled	a putri
spontaneous	spontáneo
spoon	kuchara
spot	mancha
spouse	kasá
spread	plama
spring	primavera
square	firkant
squeeze	pèrta
squid	sékat buladó
squirrel	ekhorn
st	san
stab	hinka
stable	stabil
stack	stapel
staff	empleado
stage	podio
stain	mancha
stairs	trapinan
stake	staka
stalk	stèngèl
stalk	pèrsigí
stall	puesto
stamp	stampia
stand	para
standard	standart
star	strea
start	kuminsá
started	a kuminsá
starving	hambrá
state	estado
statement	deklarashon
station	stashon
statue	estatua
status	estado
stay	keda
stay safe	kuida kurpa
steady	stabil
steak	bifstùk
steal	hòrta
steam	bapor
steel	stal
steep	pará
stem	stam
step	paso
stick	pida palu
stiff	tiesu
still	ketu
still	ahinda
sting	pika
stingy	pichiri
stir	bati
stock	akshon
stock	stòk
stolen	hortá
stomach	stoma
stone	piedra
stood	a para
stool	shushi
stool	krùk
stop	stòp
storage	almasenahe
store	pakus
storm	tormenta
story	historia
stove	stof
straight	stret
straightforward	simpel
strain	stam
strange	straño
stranger	hende straño
strategy	strategia
straw	pipa
strawberry	stròbèri
streak	strepi
stream	fluho
street	kaya
strength	forsa
stress	strès
stretch	rèk
strict	strèn
strike	dal
strike	wèlga
string	kuèrdè
strip	strep
strive	aspirá
stroke	atake
strong	fuerte
struck	a dal
structure	struktura
struggle	lucha
struggling	luchando
stubborn	tèrko
stuck	pegá
student	studiante
study	siña
studying	studiando
stuff	kosnan
stunning	magnífiko
stupid	kèns
style	estilo
subject	tópiko
subject	suheto
subject	vak
submission	entrega
submit	hasi un petishon
substance	supstansia
substitute	supstituto
subtle	sutil
succeed	triunfa
success	éksito
successful	eksitoso
such	tal
such as	manera
suck	chupa
sudden	diripiente
suddenly	direpiente
suffer	sufri
suffering	sufriendo
suffering	sufrimentu
sufficient	sufisiente
sugar	suku
suggest	proponé
suggestion	sugerensha
suit	kumbiní
suit	paki
suitable	adekuá
suitcase	maleta
sum	sòm
summary	resúmen
summer	berano
summit	piko
sun	solo
sunday	djadumingu
sunny	tin solo
sunset	bahada di solo
sunshine	resplandor di solo
super	super
superior	superior
supervisor	supervisor
supper	sena
supply	suministrá
support	apoyo
suppose	suponé
supposed	presuntu
sure	sigur
surface	superfisie
surge	oumento
surgery	siruhia
surname	fam
surprise	sorpresa
surprised	sorprendí
surrender	entrega
surrounding	rònt di
surveillance	vigilansia
survey	enkuesta
survive	sobrebibí
suspect	sospechá
suspended	suspendé
suspicious	sospechoso
sustain	mantené
sustainability	durabilidat
sustainable	durabel
swag	zuai
swag	ku estilo
swallow	guli
swap	kambio
swear	papia palabra malu
swear	hura
sweat	soda
sweater	suèter
sweep	bari
sweet	dushi
sweet dreams	drumi dushi
sweet tooth	bokadushi
sweetheart	kariño
swell	bamboleo
swelling	hinchamentu
swim	landa
swimming	landando
swing	skòmel
switch	kambia
swollen	hinchá
sword	spada
symbol	símbolo
sympathy	simpatia
symptoms	síntomanan
system	sistema
table	mesa
tackle	dil ku
tag	etikèt
tail	rabu
take	tuma
take away	kita
take care	kuida kurpa
take off	kita
take off	bai
taken	a tuma
talk	papia
talkative	papiadó
tall	largu
tap	kranchi
tap	tek
tape	teip
target	ophetivo
task	tarea
taste	purba
taste	smak
tasty	dushi
taught	a siña
tea	te
teach	siña
teacher	dosente
team	ekipo
tear	lagrima
tear	skùr
tears	lagrimanan
tease	tenta
technology	teknología
teeth	djentenan
tell	bisa
tell me	bisa mi
temper	temperamentu
temperature	temperatura
temple	tèmpel
temporary	temporal
ten	dies
ten thousand	dies mil
tenant	hürdó
tend	inkliná
tendency	tendensia
tender	moli
tense	tenso
tension	tenshon
tent	tènt
tentative	tentativo
term	término
terms	términonan
terrible	teribel
terrific	fantástiko
territory	teritorio
test	tèst
text	teksto
than	ku
thank	gradisí
thank you	danki
Thank you for your patience while we investigate shipment	Danki pa bo pashenshi mientras nos ta investigá e envio
thank you so much	masha danki
thank you very much	masha danki
thanks	danki
Thanks for using our app	Danki pa usa nos app
that	esei
that is	e ta
that's good	e ta bon
the	e
theft	hòrtamentu
their	nan
them	nan
theme	tema
themselves	nan mes
then	despues
then	awèl
theory	teoria
there	einan
there are	tin
there is	tin
therefore	p'esei
these	esakinan
they	nan
they are	nan ta
thick	diki
thief	ladron
thigh	bèl di pia
thin	fini
thing	kos
things	kosnan
think	pensa
third	di tres
thirsty	yen di set
thirteen	diestres
thirty	trinta
this	esaki
this is	esaki ta
thorough	riguroso
thoroughly	riguroso
those	esnan
though	ounke
thought	pensamentu
thoughtful	atento
thoughts	pensamentunan
thousand	mil
thread	hilu
threat	amenasa
threaten	menasá
three	tres
threshold	drèmpel
thrilled	emoshoná
thrive	florsé
throat	garganta
through	dor di
throughout	dor di
throw	tira
thumb	dùim
thunder	dònder
Thursday	Djaweps
thus	pues
tick	karpata
tide	marea
tidy	drechá
tie	dashi
tie	mara
tiger	tiger
tight	pèrtá
Tigrinya	Tigrinya
time	ora
timid	tímido
tiny	chikítu
tip	konseho
tip	punta
tip	tep
tips	teps
tire	tayer
tired	kansá
tissue	klinèks
title	titulo
to	pa
to be	ta
toast	brinda
toast	tòsti
today	awe
toddler	mucha chikí
toes	dedenan di pia
together	huntu
toilet	tualèt
told	a bisa
tolerance	toleransia
tolerate	tolerá
tomato	tomati
tomorrow	mañan
tongue	lenga
tonight	awe nochi
too	tambe
took	a kué
tool	hèrmènt
tools	hèrmèntnan
tooth	djente
top	tòp
topic	tópiko
torn	a skùr
torture	torturá
total	total
touch	mishi
tough	tòf
tour	paseo
toward	den direkshon di
towards	den direkshon di
towel	sèrbètè
town	siudat
toxic	tóksiko
trace	lokalisá
track	spor
track	rastro
trade	kambia
trade	komersio
tradition	tradishon
traditional	tradishonal
traffic	tráfiko
trail	ruta
train	trein
training	treinmentu
trait	kualidat
traits	rasgonan
transfer	transferensha
transition	transishon
translate	tradusí
transparent	transparente
transport	transpòrt
transportation	transpòrt
trap	trampa
trash	shushi
trauma	trouma
travel	biaha
tray	teblachi
treasure	tesoro
treat	trit
treat	trata
treatment	tratamentu
tree	palu
tremendous	tremendo
trend	tendensia
trial	prueba
trick	triki
tried	a purba
trigger	aktivá
trigger	gai
trim	kòrta
trip	trep
trouble	problema
trousers	karson
truck	trùk
TRUE	berdat
trunk	baul di outo
trust	konfia
truth	bèrdat
try	purba
Tsonga	Tsonga
tube	pipa
Tuesday	Djamars
tuition	plaka di skol
turkey	kalakuna
turmeric	kurkuma
turn	bira
turtle	turtuga
tutor	tutor
twelve	diesdos
twenty	binti
twenty-one	bintiun
Twi	Twi
twice	dos biá
twist	trose
two	dos
type	tipo
typical	típiko
ugly	mahos
ultimate	delaster
umbrella	paraplü
unable	inkapas
uncle	tio
unconscious	inkonsiente
under	abou
underneath	bou di
underrated	supestimá
understand	kompronde
understood	a komprondé
unfortunately	lamentablemente
uniform	unifòrm
unique	úniko
unit	unidat
university	universidat
unknown	deskonosí
unless	a ménos ku
until	te ku
unusual	apnormal
up	ariba
up to you	bo kuenta
update	aktualisá
upgrade	aktualisashon
upon	riba
upset	rabiá
urban	urbano
urge	urgensha
urgent	urgente
us	nos
use	usa
used	usá
useful	probechoso
useless	pòrnada
usual	usual
usually	normalmente
utility	utilidat
vacation	fakansi
vaccination	bakunashon
vaccine	bakuna
vacuum	pasa stòfzùiger
vague	vago
valid	bálido
valley	baye
valuable	balioso
value	balor
variety	variedat
various	varios
vary	variá
vase	florero
vast	enorme
vegetable	bèrdura
vegetables	bèrduranan
vehicle	vehíkulo
vendor	bendedó
venom	veneno
venture	empresa
venue	lugá
verify	verifiká
versatile	multifasétiko
version	vershon
vertical	vertikal
very	hopi
very good	hopi bon
vessel	barku
via	via
vibe	ambiente
vibes	ambientenan
vicious	visioso
victim	víktima
video	video
view	bista
village	pueblo
villain	bandidu
vinegar	binager
vintage	antiguo
violence	violensia
violent	violento
viral	viral
virgin	bírgen
virtual	virtual
virtue	virtut
vision	vishon
visit	bishitá
visual	visual
vital	vital
vivid	bibu
vocabulary	vokabulario
voice	bos
void	imbálido
volume	volúmen
volunteer	boluntario
vomit	saka
vulnerable	vulnerabel
wage	salario
wages	sueldonan
waist	sintura
wait	warda
waiter	weiter
waiting	sperando
wake	spièrta
wake up	lanta for di soño
walk	kana
walking	kanando
wall	muraya
wallet	pòtmòni
wander	bagamundiá
wanna	ke
want	kier
wanted	buská
war	guera
wardrobe	kashi di paña
warehouse	depósito
warm	kayente
warn	atvertí
warning	atvertensia
warrior	luchadó
was	tabata
wash	laba
waste	shushi
waste	malgastá
watch	wak
water	awa
watermelon	patia
wave	ola
way	kaminda
we	nos
we are	nos ta
we can	nos por
weak	suak
weakness	debilidat
wealth	rikesa
wealthy	riku
wear	bisti
wearing	tin bistí
weather	wer
wedding	boda
Wednesday	Djárason
weed	cheiba
week	siman
weekend	wikènt
weight	peso
weird	straño
welcome	bon bini
welfare	bienestar
Well	Bon
well done	bon trabou
went	a bai
were	tabata
west	wèst
wet	lei
whale	bayena
what	kiko
what about you	i abo
what are you doing	kiko bo ta hasiendo
what are you doing now	kiko bo ta hasiendo aworaki
what are you doing right now	kiko bo ta hasiendo aworaki
what do you do	kiko bo ta hasi
what do you do for a living	den kiko bo ta traha
what do you mean	kiko bo ke men
what do you want	kiko bo ke
what happened	kiko a pasa
what is	kiko ta
what is this	kiko esaki ta
what is your job	kua ta bo trabou
what is your name	kua ta bo nòmber
what's up	ki tin
what's your name	kua ta bo nòmber
whatever	ki ku ta
wheat	trigo
wheel	wil
when	ki ora
whenever	ki ora ku ta
where	na unda
where are you	unda bo ta
where are you from	di unda bo ta bini
where are you now	na unda bo ta aworaki
where do you live	na unda bo ta biba
where is	unda ta
whereas	maske
whether	sea.òf
which	kua
while	tanten
whisper	kuchikuchi
whistle	flùit
white	blanku
who	ken
who are you	ken bo ta
who is	ken ta
who is this	ken esaki ta
whole	kompletu
whom	esun ku
whose	di dje
why	dikon
why not	dikon no
wicked	malbado
wide	hanchu
widow	biuda
width	anchura
wife	kasá
wild	salbahe
will	boluntat
willing	dispuesto
win	gana
wind	bientu
window	bentana
windy	hopi bientu
wine	biña
winter	wenter
wipe	limpia
wire	waya
wisdom	sabiduria
wise	sabí
wish	deseá
wish you all the best	mi ta deseá bo tur kos bon
witch	hèks
with	ku
withdraw	retirá
withdrawal	lanta plaka
withdrawal	retirá
within	denter di
without	sin
witness	testigo
witty	ingenioso
wolf	wòlf
woman	muhé
women	muhénan
won	a gana
won't	no lo
wonder	puntra su mes
wonder	milager
wonderful	maravioso
wood	palu
wool	lana
word	palabra
words	palabranan
work	traha
work out	entrená
working	trahando
world	mundu
worm	bichi
worn	a bisti
worried	preokupá
worry	preokupashon
worse	pió
worship	alabá
worst	pió
worth	balor
worth it	balapena
worthy	digno
would	lo por
wound	herida
Wow	Wow
wrap	empaketá
wrath	bengansa
wrist	pòls
write	skirbi
Write here	Skirbi akinan
writing	eskritura
written	a skirbi
wrong	robes
wrote	a skirbi
yard	kurá
yawn	hap
Yeah	Sè
year	aña
years	añanan
yeast	yist
yell	grita
yellow	hel
Yes	Si
yes baby	si beibi
yes dear	si dushi
yes honey	si dushi
yes my love	si mi amor
yes of course	si sigur
yesterday	ayera
yet	ahinda
yield	prestashon
you	abo
you are	abo ta
you are beautiful	bo ta bunita
you are so beautiful	bo ta hopi bunita
you are welcome	na òrdu
you can	abo por
You know	Bo sa
you too	abo tambe
you're welcome	di nada
young	hoben
your	bo
your welcome	bo bon bini
yourself	bo mes
youth	hubentut
you’re welcome	di nada
yummy	dushi
zero	sero
