a	اک
a little	تھوڑا جیہا
a lot	بہوں زیادہ
a lot of	بہوں سارا
abandon	چھوڑنڑاں
abandoned	ویران
abide	سہڑاں
ability	صلاحیت
able	قابل
about	بارے وچ
above	اوتے
abroad	باہر
absence	غیر حاضری
absent	غیر حاضر
absolutely	بالکل
absorb	ملا ڈیونڑاں
abstract	خلاصہ کرنڑاں
absurd	بے تُکا
abundance	بہوں زیادہ ہوونڑاں
abundant	بہوں سارا
abuse	برا بھلا آکھڑاں
abuse	ناجائز
accent	لہجہ
accept	قبول کرو
access	ایکسس
access	راہ
accident	حادثہ
accommodation	موزوں ہونڑاں
accomplish	پورا کرنڑاں
accomplished	پورا کیتا
according	دے مطابق
account	اکاؤنٹ
accuracy	درستی
accurate	درست
accused	ملزم ٹہرانڑاں
ache	درد
ache	درد کرنڑاں
achieve	حاصل کرنڑاں
achievement	کامیابی
acknowledge	علم
acquaintance	واقف کار
acquire	حاصل کرنڑاں
acquired	کمایا ہویا
acquisition	حاصل کرنڑاں
across	پار
act	عمل
action	عمل
active	چست
activities	سرگرمیاں
activity	عمل
actor	اداکار
actual	اصل
actually	اصل وچ
acute	شدید
adapt	اختیار کرنڑاں
add	شامل کرو
addicted	عادی
addition	جمع
additional	اضافی
address	مخاطب کرنڑاں
address	ایڈریس
adequate	بہوں
adjacent	ملیا ہویا
adjective	صفت
adjust	درست کرنڑاں
admire	تعریف کرنڑاں
admit	داخل ہونڑاں
adopt	جھولی گھنڑاں
adorable	سسوہنڑاں
advance	پیشگی ڈیونڑاں
advance	بیعانہ
advanced	بہوں اعلٰی
advantage	فیدہ
adventure	مُہم
adverb	متعلق فعل
advertisement	اشتہار
advertising	اشتہار بازی
advice	صلاح
advise	صلاح
advocate	وکیل
advocate	وکالت کرنڑاں
aesthetic	چنگے ذوق آلا
affair	واقعہ
affect	اثر انداز تھیونڑاں
affection	محبت
afford	مالی حیثیت
affordable	گنجائش دے قابل
afraid	ڈر
after	بعد
afternoon	ڈوپہر
afterwards	ایندے بعد
again	ولا
against	خلاف
age	عمر
agency	ایجنسی
agent	ایجنٹ
aggressive	جھگڑا کرنڑ والا
agile	چُست
ago	گزریا ہویا
agree	متفق
agreement	معاہدہ
agriculture	زمین دی کاشت
ahead	اگو
aid	امداد
aim	مقصد
air	ہوا
airport	ایئر پورٹ
aisle	بغلی راہ
alarm	الارم
alcohol	الکحل
alert	الرٹ
alive	جیندا
all	سارا
all right	بالکل ٹھیک
all the best	اللہ خیر کرے
allow	اجازر ڈیوو
allowed	اجازت ڈتی گئی
almost	تقریباً
alone	کلہا
along	دے نال
already	پہلاں توں
Alright	درست
also	وی
alternative	متبادل
although	فرض کیتا
always	یکے
am	سویرے
amazing	حیرت وچ سٹنڑنڑ آلا
ambiguous	گول مول
ambition	آرزو
ambitious	وڈے حوصلے آلا
amend	تبدیلی کرنڑاں
amid	درمیان وچ
among	درمیان
among us	ساڈے بیچ
amount	قیمت
amusing	دلچسپ
an	ہک
analysis	تجزیہ
ancestors	وڈے بزرگ
anchor	اینکر
ancient	حادثہ
and	تے
and you	تے تساں
angel	فرشتہ
anger	غصہ
angle	فرشتہ
angry	رسیا ہویا
animal	جانور
ankle	گٹا
anniversary	سالانہ تقریب
announcement	اعلان
annoy	ناراض کرنڑاں
annoyed	ناراض کیتا
annoying	ڈکھ ڈیوڑاں
annual	سالانہ
anonymous	نامعلوم
another	ہک ڈوجھا
answer	جواب
answer	جواب ڈیونڑاں
anticipate	پہلے کنے سمجھ وینجڑاں
anxiety	بے چینی
anxious	بے چین
any	کوئی وی
anymore	ایں ویلے
anyone	کوئی وی
anything	کوئی وی شے
anyway	ہر حال وچ
anyways	کسے وی طرحاں
apart	انج انج
apartment	اپارٹمنٹ
apologize	معافی منگڑاں
apparent	نمایاں
apparently	ظاہر
appeal	دعویٰ کرنڑاں
appear	حاضر تھیوو
appearance	موجودگی
appeared	ظاہر تھیا
appetite	بوکھ
apple	سیب
application	درخواست
apply	درخواسر ڈیوو
appointment	اپائنٹمنٹ
appreciate	حوصلہ افزائی کرو
appreciation	قدر قیمت وچ اضافہ
approach	درخواست کرنڑاں
approach	شامل کرنڑاں
appropriate	مناسب
approval	منظوری ڈیونڑاں
approve	منظور کرنڑاں
approved	منظور شدہ
approximately	تقریباً
april	اپریل
arbitrary	ظالمانہ
architect	بناونڑ آلا
architecture	تعمیر دی طرز
archive	آرکائیو
are	ہیں
are you	کیا تساں
are you busy	کیا تساں مصروف ہو
are you married	تساں شادی شدہ ہو
are you married or single	تساں شادی شدہ ہو یا غیر شادہ شدہ
Are you still there?	کیا تساں ہونڑ تئیں اُتھئیں ہو؟
are you there	کیا تساں موجود ہو
area	علاقہ
argue	بحث کرنڑاں
argument	دلیل
arise	اُٹھڑاں
arm	بانہہ
army	آرمی
around	چاریں پاسے
arrange	ترتیب ڈیوو
arrangement	بندوبست کرنڑاں
arrival	آمد
arrive	آونڑاں
arrived	آ پُجے ہاں
arrogant	گستاخی کرنڑ والا
arrow	تیر
art	آرٹ
article	مضمون
artificial	مصنوعی
artist	فنکار
as	ایویں
as long as	جڈھنڑ تک کہ
as well	ایندے نال نال
as well as	جیویں کہ
ash	راکھ
ashamed	شرمسار
ask	آکھو
asked	آکھیا
asleep	سمیا ہویا
aspect	پہلو
Assamese	آسامی
assault	حملہ کرنڑاں
assembly	اجتماع
assertive	فخر نال آکھڑاں
assess	اندازہ کرنڑاں
assessment	اندازہ لاؤ
asset	اثاثہ
assets	اثاثے
assign	ذمے لاونڑاں
assignment	اسائنمنٹ
assist	مدد ڈیونراں
assistant	معاون
associate	حصہ دار ہونڑاں
associated	شریک
association	ایسوسی ایشن
assume	فرض کرو
assumption	فرض کرنڑاں
at	اتے
at least	گھٹ توں گھٹ
ate	کھادا
athlete	پہلوان
attach	مل وینجڑاں
attached	جڑیا ہویا
attachment	الحاق
attack	حملہ
attempt	کوشش کرنڑاں
attempt	کوشش
attend	حاصر ہونڑاں
attendance	حاضری
attention	توجہ ڈیوو
attitude	ورتاؤ
attract	آپنڑے پاسے چھکڑاں
attraction	کشش
attractive	کشش آلا
attribute	سبب بنڑاونڑاں
audience	ڈیکھنڑ آلے
august	اگست
aunt	چاچی
aunty	ماسی
authentic	بھروسے آلا
author	لکھاری
authority	اختیار
autumn	خزاں
available	موجود
average	اوسط
avoid	پرہیز کرو
awake	جگاونڑاں
award	ایوارڈ
aware	پتہ ہونڑاں
awareness	واقفیت
away	پریں
awesome	حیران کر ڈیونڑ والا
awful	خوفناک
awkward	برا
Aymara	آئیمارا
baby	بال
bachelor	کنوارہ
back	پچھے
background	پس منظر
bad	ماڑا
bag	بیگ
bait	چارہ لاونڑاں
bake	بھنڑاں
bakery	بیکری
baking soda	مِٹھا سوڈا
balance	موازنہ کرنڑاں
balance	توازن
ball	گیند
Bambara	بمبارا
banana	کیلا
band	بینڈ
bang	وجاونڑاں
bank	بینک
bar	بار
barely	جو
bargain	سودا
bark	چھلکا
bark	بھونکڑاں
barley	جَو
barrier	رکاوٹ
base	بنیاد
based	بنیاد رکھی
basement	تہہ خانہ
basic	بنیادی
basically	بنیادی طور تے
basil	نیازبُو
bastard	کم ذات
batch	بیچ
bath	دھاونڑاں
bathroom	لیٹرین
battery	بیٹری
battle	جنگ
bay	بھونکڑاں
be	رہو
be careful	دھیان رکھو
beach	سمندر
beam	چمکنڑاں
beans	لوبیا
bear	گھن وینجڑاں
bear	برداشت کرنڑاں
beard	ڈاڑھی
bearing	ڈھنگ
beast	درندہ
beat	دھڑکن
beat	دل دا دھڑکڑاں
beautiful	سوہنڑاں
beauty	خوبصورتی
became	تھی گیا
because	ایں وجہ توں
become	ہونڑاں
bed	بسترا
bedroom	سمنڑ دا کمرہ
bee	شہد دی مکھی
beef	گائے دا گوشت
been	تھے
beer	بھالو
before	پہلاں
began	شروع کیتا
begin	شروع کرو
beginning	شروع کرنڑاں
behalf	واسطے
behave	پیش آونڑاں
behavior	ورتاؤ
behaviour	رویہ
behind	پچھو
being	تھیندے ہوئے
belief	ایمان
believe	یقین
belly	پیٹ
belong	ملکیت ہونڑاں
beloved	محبوب
below	ہیٹھ
belt	بیلٹ
bench	پَھٹا
bend	موڑنڑاں
beneath	تلے
benefit	فائدہ
benefit	فائدہ ڈیونڑاں
benefits	فیدے
beside	نال
besides	کسے دے نال نال
best	بہترین
best of luck	اللہ بہتر کرے
best regards	نیک تمناواں
better	بھلا
between	وچکار
beverage	شربت
beyond	ڈوجی پاسے
Bhojpuri	بھوج پوری
bias	طرفداری کرنڑاں
biased	مخالف
bicycle	سائیکل
bid	بولی ڈیونڑاں
big	وڈا
bike	موٹر سائیکل
bill	بل
bind	بدھڑاں
bird	پرندہ
birthday	سالگرہ
bit	ٹکڑا
bite	تروڑاں
bite	زخم
bitter	کوڑا
black	کالا
blade	بلیڈ
blame	الزام
blame	الزام ڈیونڑاں
blank	خالی
blanket	کمبل
blast	دھماکا
bleach	بلیچ
blend	ملاونڑاں
bless	دُعا کرنڑاں
blessed	مبارک
blind	کانڑاں
bliss	برکت
block	بلاک کرنڑاں
blood	رت
bloom	کَلی
blow	تھلے
blue	نیلا
blunt	بے حس بناونڑاں
board	بورڈ
boat	کشتی
body	جسم
boil	ابالڑاں
bold	بہادر
bond	لگاؤ
bone	ہڈی
book	کتاب وچ لکھڑاں
book	کتاب
boost	قوت اچ اضافہ کرنڑاں
boost	زیادتی
booster	بوسٹر
boot	بُوٹ
boots	ہوٹل دا عملہ
border	حد
bore	برداشت کیتا
bored	تھکیا ہویا
boring	آوزار
born	پیدا تھیونڑاں
borrow	منگیا ہویا
boss	باس
both	ڈوہویں
bother	بھرا
bottle	بوتل
bottom	تھلے
bought	گھنیا گیا
bounce	شور شرابے نال
bound	بندش
boundaries	حداں
bow	بو
bowl	پیالہ
box	ڈبا
boy	چھوہر
boyfriend	محبوب
bracelet	بازو بند
brain	دماغ
branch	برانچ
brand	برانڈ
brave	بہادر
breach	خلاف ورزی
bread	روٹی
break	توڑ پھوڑ
break	تروڑنڑاں
breakfast	ناشتہ
breast	چھاتی
breath	ساہ لینڑاں
breathe	ساہ
breed	پالنڑاں
brick	بُلاک
bride	کنوار
bridge	برج
brief	خلاصہ
bright	تیز
brilliant	شوخ
bring	چا آوو
bro	بِھرا
broad	بورڈ
broadcast	نشر کرنڑاں
broke	تروڑیا
broken	ترٹا ہویا
broom	بوہاری
brother	بھرا
brother in law	ڈیر
brought	گھنڑاں
brown	خاکی
brush	برش
bucket	بالٹی
buddy	یار
budget	بجٹ
bug	کھٹمل
build	تیار کیتا
building	عمارت
built	بنڑایا
bulk	بہوں سارا
bull	بیل
bully	ڈراونڑاں
bump	دھکا
bunch	گُچھا
bundle	گنڈھوکڑی
burden	بوجھ
burden	بوجھ سٹڑاں
buried	دفن کیتا
burn	سڑنڑاں
burst	پھٹڑاں
bury	دفن کرنڑاں
bus	بس
bush	جھاڑی
business	کاروبار
bust	تباہ کرنڑاں
busy	مصروف
but	لیکن
butter	مکھنڑ
butterfly	تتلی
button	بٹنڑ
buy	مُل گھنو
by	ولوں
by the way	اوویں ہی
bye	خدا حافظ
cabbage	بند گوبھی
cabinet	الماری
cage	پنجرہ
cake	کیک
calf	بچھڑا
call	کال
call	پُکارڑاں
call me	میکوں کال کرو
called	سڈنڑاں
calm	امن
came	آ گیا
campaign	مہم
can	قابل ہونڑاں
can	ٹین
can't	نہیں کر سکدے
Cancel	منسوخ کرو
cancer	کینسر
capable	لائق
capacity	گنجائش
capital	دارالحکومت
caption	سرخی
capture	قید کرنڑاں
car	گاڈی
career	کریئر
careful	فکر مند
carefully	احتیاط نال
careless	لاپرواہ
caring	خیال رکھن آلا
carpenter	ترکھانڑ
carpet	قالین
carrot	گاجر
carry	چا کے ٹرو
carry on	چِھکی رکھو
carry out	باہرو گھن ونجو
case	کیس
cash	نقد
cast	قوم
castle	قلعہ
casual	عام
cat	بلی
catch	پکڑیا
category	قسم
cattle	مال مویشی
caught	پکڑیا
cause	سبب
cause	سبب دی وجہ
caution	احتیاط
cautious	محتاط
cave	غار
cease	ختم ہونڑاں
ceiling	آخری حد
celebrate	خوشی مناونڑاں
cell	خلیہ
center	مرکز
century	صدی
cereal	اناج
ceremony	رسم
certain	خاص
certainly	یقینی طور تے
certificate	سند
chain	چین
chair	کرسی
challenge	ٹوکڑاں
challenge	اعتراض
chance	موقع
change	وٹاؤ
chaos	افراتفری
character	کردار
characteristics	خصوصیتاں
charge	قیمت
charity	خریت
charming	خوبصورتی
chart	چارٹ
chase	پچھے ٹرنڑاں
chat	بات چیت
chat	بات چیت کرنڑاں
cheap	سستا
cheat	دھوکہ ڈیونڑاں
cheating	فریبی
check	جائزہ گھنڑاں
check	قابو وچ کرنڑاں
cheek	گَل
cheer	نعرہ لاونڑاں
cheerful	خوش کرنڑاں
cheers	خوش رہوو
cheese	چیز
chemistry	کیمیا
cherish	عزیز رکھنڑاں
chess	شطرنج
chest	سینہ
chew	چَباونڑاں
chicken	مرغی
chief	اہم
child	بال
childhood	نیاناں
children	بال
chill	بہوں ٹَھڈا
chill	ٹَھڈا کرنڑاں
chill	ٹَھڈ
chimneys	چمنیاں
chin	بوتھی
chocolate	چاکلیٹ
choice	پسند
choose	چنڑو
chop	ٹکڑے کرنڑاں
chores	کم کاج
chubby	گول مٹول
church	چرچ
cinnamon	دار چینی
circle	دائرہ
circumstances	حالات
citizen	شہری
city	شہر
claim	حق
claim	دعویٰ کرنڑاں
clarify	صاف کرنڑاں
class	جماعت
clay	مٹی
clean	صاف
clear	صاف کرنڑاں
clear	صاف
clerk	کلرک
clever	چلاک
client	موکل
cliff	ٹیلا
climate	آب و ہوا
climb	چڑھڑاں
clingy	چمبڑنڑ آلا
clock	گھڑی
close	بند کرو
closet	غیر عملی
cloth	کپڑا
clothes	کپڑے
cloud	بادل
cloudy	بادل آلا
clown	مسخرہ
clue	اشارہ
clumsy	بے ڈھنگا
cluster	گُچھا
coach	کھیڈ سکھاونڑ آلا
coal	کوئلہ
coast	کنارہ
coat	کوٹ
coffee	کافی
cognitive	علم رکھنڑ آلا
coincidence	اتفاق
cold	ٹھڈا
collapse	غائب کرنڑاں
collar	کالر
colleague	رفیق
colleagues	ساتھیاں
collect	جمع کرنڑاں
collection	جمع کرنڑاں
college	کالج
color	رنگ
colorless green ideas slept furiously	بغیر رنگ آلے خیالات غصے وچ سَم تھئین
colour	رنگ
column	کالم
comb	کنگھی
combination	میل
combine	کَٹھا کرنڑاں
come	آؤ
come here	اِتھاں آؤ
come on	پھلڑاں پھولڑاں
comfort	آرام
comfortable	آرام دہ
coming	آندا پیا ہے
coming soon	جلدی آندا پیا ہے
command	حکم
comment	تبصرہ
commercial	کمرشل
commission	کمیشن
commit	ذمے لاونڑاں
commitment	معاہدہ
committed	مخلص
commodity	مال
common	عام
communicate	اطلاع ڈیونڑاں
communication	گالھہ بول
community	کمیونٹی
commute	ادلہ بدلی کرنڑاں
companion	ہم نشین
company	کمپنی
compare	موازنہ کرنڑاں
comparison	مقابلہ
compassion	ترس کھاونڑاں
compassionate	ہمدرد
compatible	موافق
compete	مقابلہ کرنڑاں
competent	اہل
competition	مقابلہ
competitive	مقابلے دا
complain	شکایت
complaint	شکایت
complement	پوری مقدار
complement	مکمل کرنڑاں
complete	مکمل
completely	مکمل طور تے
complex	پیچیدہ
compliance	مرضی
complicated	پیچیدہ
compliment	تعریف کرنڑاں
comply	حکم پورا کرنڑاں
composition	ترکیب
compound	مرکب
comprehension	عقل سمجھ
comprehensive	جامع
compromise	سمجھوتہ کرنڑاں
compromise	سمجھوتہ
compulsory	لازمی
computer	کمپیوٹر
concentrate	توجہ نال کم کرنڑاں
concept	خیال
concern	تعلق رکھڑاں
concern	تعلق
concerned	فکر مند
concert	ہم آہنگ بنڑاونڑاں
conclusion	نتیجہ
concrete	ٹھوس
concrete	سیمنٹ
concrete	سیمنٹ لاونڑاں
condition	حالت
conditions	شرطاں
conduct	طور طریقہ
conference	جلسہ
confess	اعتراف کرنڑاں
confidence	اعتماد
confident	اعتماد آلا
confirm	تصدیق کرو
conflict	تنازعہ
confused	پریشان ہونڑاں
confusion	پریشانی
congrats	مبارکاں
congratulation	مبارکباد
congratulations	مبارکاں
conjunction	جوڑا
connect	جوڑو
conquer	فتح کرنڑاں
conscious	ہوش وچ
consciousness	شعور
consent	منظوری
consent	منظوری ڈیونڑاں
consequences	نتیجے
conservation	حفاظت
conservative	محتاط
consider	غور کرنڑاں
considered	سوچا سمجھیا
consist	شامل ہونڑاں
consistency	ہمواری
consistent	مستقل
constant	مستقل
constantly	ہمیشہ
constipation	قبض
construction	تعمیر
consume	خرچ کرنڑاں
consumption	خرچ
contact	تعلق پیدا کرنڑاں
contact	تعلق
contagious	چھوت
contain	شامل ہے
contains	مشتمل ہونڑاں
contemporary	اک زمانہ
contempt	توہین
content	مواد
contest	مقابلہ
context	سیاق وسباق
continent	براعظم
continue	جاری رکھو
contract	معاہدہ
contract	گھٹ کرنڑاں
contrast	فرق کرنڑاں
contrast	فرق
contribute	حصہ گھنو
contribution	حصہ
control	قابو کرنڑاں
controversial	جھگڑے آلا
convenience	سہولت
convenient	آسان
conversation	گالھہ کرنڑاں
convert	مذہب تبدیل کرنڑ آلا
convert	مذہب تبدیل کرنڑاں
convey	پُجاونڑاں
convince	منوانڑاں
convinced	قائل ٹھیا
cook	باورچی
cook	پکاونڑاں
cooking	پکاونڑاں
cool	ٹھڈا
cool	بہوں چنگا
cooperation	تعاون
cope	قابو پاونڑاں
copper	تانبا چڑھونوڑاں
core	کورٹ
corn	چھلی
corner	کونا
correct	درست
cost	خرچ کرنڑاں
cost	قیمت
costume	جوڑا ڈیونڑاں
cottage	جُھوپڑی
cotton	کپاہ
couch	صوفہ
cough	کھنگ
could	کر سکن
council	کونسل
count	تعداد
counter	کاؤنٹر
country	ملک
countryside	دیہاتی علاقہ
couple	جوڑا
courage	ہمت
course	کورس
court	کورٹ
courtesy	خوش اخلاقی
cousin	کزن
cover	کورٹ
cow	گاں
coward	ڈرپوک
cozy	سکھی
crab	کیکڑا
crack	کڑک
crack	تروڑنڑاں
craft	چالاکی کرنڑاں
crap	پھانسی ڈیونڑاں
crash	گرجڑاں
crash	گرج
craving	خواہش
crawl	رُڑھنڑاں
crazy	دیوانہ
create	بنڑاؤ
creative	تخلیقی
credit	کریڈٹ
creep	رینگڑاں
creepy	گھبراہٹ
crew	جہاز دا عملہ
crime	جرم
cringe	خوشامد کرنڑاں
cringe	جُھکڑاں
crisis	بحران
criteria	معیار
critical	تشویشناک
criticism	تنقید
crop	فصل
crops	فصلاں
cross	صلیب
cross	منسوخ کرنڑاں
crow	کاں
crowd	رش
crowded	رش
crown	تاج
crucial	نازک
cruel	ظالم
cruise	جہاز پھرانڑاں
crush	دباونڑاں
crush	بِھیڑ
cry	رونڑاں
cucumber	کھیرا
cuddle	گلے لاونڑاں
culture	ثقافت
cunning	مکار
cup	پیالی
cupboard	الماری
curb	قید
cure	علاج
cure	علاج کراونڑاں
curfew	کرفیو
curiosity	سکھنڑں دا شوق
curious	جسوسی کرنڑاں
curly	گھنگریالا
currency	کرنسی
current	ہونڑیں
currently	حال وچ
curse	آفت
curtain	پردہ
cushion	گَدّی
custom	مخصوص
customer	گاہک
customs	رسم رواج
cut	کَٹیا
cut	زخم
cute	سوہنڑاں
cycle	سائیکل
cycling	سائیکل چلاونڑاں
dad	پیو
daddy	پِیو
daily	روزانہ
dairy	کھیر دی دکان
dam	ڈیم
damage	تروڑنڑاں
damage	نقصان
damn	مندے کڈھنڑاں
damp	سِنا کرنڑاں
dance	ڈانس
danger	خطرہ
dangerous	خطرناک
dark	گھیرا
darling	محبوب
dash	شان نال
data	ڈیٹا
date	چاہنڑے آلے نال مللاقات کرنڑاں
date	تاریخ
daughter	دھی
day	ڈینہہ
dead	مریا ہویا
deadline	مقرر کیتی حد
deaf	ڈورا
deal	ونڈڑاں
deal	معاملہ
dear	عزیز
Dear All	تمام عزیز
Dear Customer	عریز گاہک
Dear Parents	عزیز والدین
Dear Sir	عزیز سر
Dear students	عزیز شاگرداں
Dear Team	عزید ٹیم
death	فوتگی
debate	بحث کرنڑاں
debit	خرچ
debris	کباڑ
debt	قرضہ
decade	صدی
decay	سڑنڑاں
deceased	مرحوم
deceive	دھوکہ ڈیونڑاں
december	دسمبر
decent	چنگا
decide	فیصلہ کرو
decided	فیصلہ کیتا
decision	فیصلہ کرنڑاں
deck	جہاز دا تختہ
decline	رد کرو
decrease	گھٹاونڑاں
dedicated	منسوب کیتا
dedication	چڑھاوا
deed	عمل
deep	ڈونگا
deer	ہرنڑ
default	پہلاں توں
defeat	شکست
defeat	شکست ڈیونڑاں
defend	دفاع کرنڑاں
define	واضح کرنڑاں
definitely	صحیح طور تے
definition	تعریف
degree	ڈگری
delay	دیر
delay	دیر کرنڑاں
delayed	دیر نال
delete	نکال ڈیونڑاں
deliberate	صلاح کرنڑاں
delicate	ملائم
delicious	مزیدار
delight	خوشی
delighted	خوش تھئے ہاں
deliver	حوالے کرنڑاں
delivered	حوالے کیتا
delivery	ڈیلیوری
demand	مطالبہ کرنڑاں
demand	مطالبہ
demanding	محنت طلب
democracy	جمہوریت
demon	بھوت
demonstrate	سمجھاونڑاں
denied	انکار کیتا
density	ٹھوس پن
dentist	ڈنداں دا ڈاکٹر
deny	انکار کرو
department	شعبہ
departure	روانگی
depend	بھروسہ کرنڑاں
deploy	ترتیب کرنڑاں
deposit	امانت
deposit	امانت رکھنڑاں
depressed	افسردہ
depression	دباؤ
depth	گہرائی
describe	وضاحت کرو
description	تفصیل
desert	صحرا
deserve	حقدار
design	نقشہ
design	نقشہ بناونڑاں
designation	عہدہ
desire	خواہش
desire	خواہش کرنڑاں
desk	ڈیسک
despair	مایوسی
desperate	بے پرواہ
despite	ایندے باوجود
dessert	مٹھا
destination	منزل
destiny	مقدر
destroy	تباہ کرنڑاں
destruction	تباہی
detail	تفصیل
details	تفصیلاں
detect	سراغ لاونڑاں
determination	ارادہ
determine	مقرر کرنڑاں
determined	پکا ارادہ
devastated	مکمل تباہ
develop	ترقی
developed	ترقی کیتی
development	ترقی
device	آلہ
devil	شیطان
devoted	وفادار
Dhivehi	دویہی
diabetes	شوگر
diarrhea	دست آونڑاں
diary	ڈائری
dictionary	ڈکشنری
did	کیتا
die	فوت تھیونڑاں
died	مر گیا
diet	خوراک
difference	فرق
different	مختلف
difficult	مشکل
dig	کھودو
dignity	عزت
diligent	محنتی
dinner	رات دا کھاونڑاں
dip	ڈُباونڑاں
direct	سدھا
direction	سمت
director	ناظم
dirt	خاک
dirty	پلیت
disable	نااہل
disabled	ناکارہ کیتا
disappear	غائب ہونڑاں
disappointed	مایوس کیتا
disaster	تباہی
discard	رد کرنڑاں
discharge	خارج کرنڑاں
discipline	پابندی
discount	رعایت
discover	تلاش کرنڑاں
discrimination	تفریق
discuss	بحث کرو
discussion	بات چیت
disease	بیماری
diseases	بیماریاں
disguise	روپ بدلنڑاں
disgusting	نفرت دے قابل
dish	تھالی
dishes	ڈشاں
dismiss	منسوخ کرنڑاں
dispatch	بھیجڑاں
display	ڈسپلے
disposal	بندوبست
dispute	جھگڑا
distance	فاصلہ
distinct	مختلف
distinguish	فرق کرنڑاں
distress	تکلیف دا باعث
distribution	تقسیم کرنڑاں
district	ضلع
disturb	تنگ کرنڑاں
ditch	دھوکہ ڈیونڑاں
dive	ڈُبکی لاونڑاں
diverse	مختلف
diversity	اختلاف
divide	تقسیم کرنڑاں
divine	جادو
divorce	طلاق ڈیونڑاں
divorce	طلاق
dizzy	چکر آونراں
do	کرو
do you	کیا تساں
do you love me	کیا تساں میڈے نال پیار کردے ہو
doctor	ڈاکٹر
document	تحریر
does	غائب واحد
doesn't	نہیں کریندا
dog	کتا
Dogri	ڈوگری
doing	کرنڑاں
doll	گڑیا
domain	ڈومین
domestic	گھریلو
dominant	نمایاں
don't	نہ کرو
Don't worry	پریشان نہ تھیوو
donate	عطیہ کرنڑاں
done	تھی گئے
donkey	گڈھا
dope	نشہ
double	ڈُو کرنڑاں
double	ڈُو
doubt	شک شبہ
doubt	شک ہونڑاں
dough	اَٹے دا پیڑا
down	تھلے
download	ڈاؤن لوڈ کیتا
draft	مسودہ
draft	مسودہ تیار کرنڑاں
drag	چھکڑاں
drain	نالی بنڑاونڑاں
drama	ڈرامہ
draw	کھچو
drawer	دراز
drawing	ڈرائنگ
dread	ڈرنڑا
dream	خواب
dream	خواب ڈیکھنڑاں
dress	لباس
drill	سوراخ کرنڑاں
drink	پیونڑاں
drink	شربت
drive	گاڈی چلاؤ
drop	قطرہ
drop	ٹپکڑاں
dropped	ٹپکیا
drought	قحط
drunk	نشہ کیتا ہویا
dry	خشک
duck	بدک
dude	نفاست پسند
due	واجب
due to	ایندی وجہ توں
dull	مندا
dumb	گونگا
dump	ذخیرہ کرنڑاں
duration	معیاد
during	دوران
dust	دھول
duty	فرض
dwell	سوچنڑاں
dying	مرنڑاں
each	ہر ہک
each other	اک ڈوجھا
eager	خواہشمند
eagle	باز
ear	کَن
earlier	ابتدائی
early	چھیتی
earn	کمانڑاں
ears	کَن
earth	زمین
earthquake	زلزلہ
ease	آسانی
easily	آسانی نال
east	مشرق
easy	آسان
eat	کھاؤ
eating	کھاونڑاں
economic	معاشی
economy	معیشت
edge	پاسا
edit	ترتیب ڈیونڑاں
education	تعلیم
effect	اثر
effective	اثر کرنڑ آلا
efficiency	قابلیت
efficient	لائق
effort	کوشش
egg	انڈہ
eggplant	بینگنڑ
ego	انا
eight	اَٹھ
eighteen	اٹھاراں
eighty	اسی
either	ڈو وچوں ہک
elaborate	وضاحت کرنڑاں
elbow	بانہہ
elder	بزرگ
elderly	وڈی عمر دا
elegant	پاکیزہ
element	عنصر
elephant	ہاتھی
eleven	گیارہاں
eligible	اہل
eliminate	ختم کرنڑاں
else	کوئی وی
embarrassed	پریشان کیتا
embarrassing	پریشان کرنڑ آلا
embrace	قبول کرنڑاں
emerge	برآمد کرنڑاں
emergency	ہنگامی صورت
emotional	جذباتی
empathy	ہمدردی
emphasis	زور ڈیونڑاں
emphasize	زور ڈیوڑاں
employee	ملازم
employees	ملازم
employer	مالک
employment	ملازمت
empty	خالی
enable	اہل بنڑاؤ
encounter	مقابلہ کرنڑاں
encourage	حوصلہ ڈیوو
end	ختم
endangered	خطرے وچ سٹیا
endeavor	محنت
endurance	برداشت
endure	برداشت کرنڑاں
enemy	دشمن
energy	توانائی
engage	مصروف
engaged	مشغول ہونڑاں
engagement	مصروفیت
engine	انجن
engineer	انجینیئر
English	انگریزی
enhance	بہتر بنڑاؤ
enjoy	مزہ کرو
enormous	بہوں سارا
enough	بہوں
ensure	یقینی بنڑاؤ
enter	داخل کرنڑاں
entertainment	تفریح
enthusiasm	جوش
enthusiastic	جوش والا
entire	سارا
entitled	عنوان دے نال
entity	ذات
entrance	اندرو وینجڑ دا راہ
entrepreneur	منتظم
envelope	لفافہ
environment	ماحول
envy	بغض
epic	عظیم الشان
epidemic	وبا
equal	برابر
equipment	سامان
equity	انصاف
equivalent	برابر
eraser	ربڑ
error	خرابی
escape	فرار ہونڑاں
especially	خاص طور تے
essay	مضمون
essence	روح
essential	ضروری
establish	قائم کرنڑاں
established	مقرر کیتا
estate	ملکیت
estimate	اندازہ لاونڑاں
estimated	اندازہ لایا گیا
etc	وغیرہ
eternal	اندرونی
ethics	اخلاقیات
evaluate	قیمت لاونڑاں
evaluation	اندازہ لاونڑاں
even	اتھاں تائیں کہ
even though	حالانکہ
evening	شام
event	ایونٹ
eventually	آخر کار
ever	کڈئیں وی
every	ہر
everybody	ہر کوئی
everyone	ہر ہک
everything	ہر شے
evidence	ثبوت
evil	مصیبت
evolution	ترقی
evolve	ترقی ڈیونڑاں
Ewe	ایو
ex	ایکس
exact	بالکل درست
exactly	بالکل
exam	امتحان
examine	معائنہ کرنڑاں
example	مثال
exceed	حد کنے ودھنا
excellent	بہوں چنگا
except	علاوہ
exception	احتجاج
excess	زیادہ
excessive	بے حساب
exchange	تبدیلی
excited	جذباتی
excitement	جوش
exciting	دلچسپ
exclusive	خصوصی
excuse	معذرت
excuse me	گستاخی معاف
execute	نافذ کرنڑاں
execution	نفاذ کرنڑاں
executive	انتظامیہ
exercise	مشق
exercise	مشق کرنڑاں
exhaust	باہر کڈھ ڈیونڑاں
exhausted	تھکیا ہویا
exhibit	پیش کرنڑاں
exhibition	نمائش
exist	موجودہ
existence	وجود دی صورت
existing	موجودہ
exit	باہر نکلو
expand	ودھاؤ
expect	امید کرنڑاں
expected	توقع رکھی اے
expenses	خرچے
expensive	ماہنگا
experience	تجربہ کرنڑاں
experience	تجربہ
experiment	تجربہ
expert	ماہر
expired	معیاد مُک گئی
explain	وضاحت کرو
explanation	وضاحت
exploit	ناجائز فائدہ چاونڑاں
explore	تحقیق کرنڑاں
export	برآمد
expose	ظاہر کرنڑاں
exposed	بے نقاب کرنڑاں
exposure	ظاہر کرنڑاں
express	اظہار کرو
expression	اظہار
extend	ودھاونڑاں
extended	پھیلیا ہویا
extension	وادھا
extent	حد
external	بیرونی
extinct	ناپید
extra	اضافی
extract	کڈھنڑاں
extraordinary	غیر معمولی
extreme	آخیر
extremely	بہوں زیادہ
eye	اکھ
eyes	اکھیں
fabric	کپڑا
fabulous	نقلی
face	سامنڑاں کرنڑاں
face	منہ
facilitate	آسان کرنڑاں
facilities	سہولتاں
facility	سہولت
fact	حقیقت
factor	وجہ
factory	فیکٹری
facts	حقائق
fade	مُرجھاونڑاں
fail	ناکام
fail	ناکام ہونڑاں
failed	ناکامیاب
failure	ناکامی
faint	بے ہوش ہونڑاں
fair	مناسب
fair	صاف
fairly	جائز طور تے
fairy	پری
faith	ایمان
faithful	ایماندار
fake	نقلی
fall	جال
fall	ڈھڑاں
false	غلط
fame	مشہوری
familiar	ملدا جلدا
family	خاندان
famine	قحط
famous	مشہور
fan	چاہنڑ آلا
fan	پَکھا
fancy	فینسی
fantastic	نویکلا
far	پریں
farewell	الوداع
farm	کھیت
farmer	زمیندار
fascinating	دل کوں بھاونڑ والا
fashion	فیشن
fast	تیز
fat	موٹا
fatal	مہلک
fate	قسمت
father	پیو
fatigue	تھکیڑا
fault	خرابی
favorite	پسندیدہ
favour	حمایت
favourite	پسندیدہ
fear	ڈرڑاں
fear	خوف
feast	دعوت
feather	پَر
feature	تصویر بناونڑاں
feature	رنگ روپ
features	فیچرز
february	فروری
fed up	بیزار
fee	فیس
feed	کھاونڑاں ڈیوڑاں
feedback	فیڈ بیک
feel	محسوس کرنڑاں
feeling	محسوس کرنڑاں
feet	پیر
fell	گراونڑاں
fellow	سانجھی
felt	محسوس کیتا
female	عورت
fence	جالی
fertile	زرخیز
festival	تہوار
fetch	آنڑاں
fever	بخار
few	کجھ
fewer	گھٹ توں گھٹ تر
fiance	منگیتر
fiction	افسانہ
field	فیلڈ
fierce	ظالم
fifteen	پندراں
fifty	پنجھا
fight	لڑائی کرنڑاں
fight	لڑائی
fighting	بھڑنڑاں
figure	بناونڑاں
figure	شکل
figure out	جواب نکالنڑاں
file	فائل
fill	بھرنڑاں
filled	بھریا ہویا
film	فلم
filthy	گندہ
finally	آخرکار
finance	مالی
financial	مالی
find	گولھو
find out	گولھو
fine	خالص
fine	جرمانہ
finger	انگلی
finish	ختم کرنڑاں
finished	ختم کیتا
fire	بھا
firm	پِکا کرنڑاں
firm	فرم
first	اول
first name	پہلا ناں
fish	مچھی
fit	چست
five	پنج
fix	ٹھیک کرنڑاں
fixed	ٹھیک کر ڈتا
flag	جھنڈا
flash	بجلی دا چمکڑاں
flat	چَپٹی شے
flat	مَندا
flaw	قَصور
flawless	نقص دے بغیر
flee	فرار تھیونڑاں
flesh	فلیش
flew	اُڈر گیا
flex	مڑنڑاں
flexible	لوچ دار
flight	پرواز
flip	اچانک اُچھالڑاں
flirt	جوٹھا پیار
flirting	تڑپاندے ہوئے
float	تیرڑاں
flood	سیلاب
floor	منزل
flour	اٹا
flow	روانی
flow	وہنڑاں
flower	پُھل
flu	نزلہ
fluent	رواں
fluently	روانی نال
fluffy	پُھلیا ہویا
fluid	پتلا
fly	اُڈارڑاں
focus	نگاہ دا مرکز
focus	نگاہ دے موکز وچ آنڑاں
fog	دُھند
foggy	کُہیڑ
fold	موڑنڑنا
folks	لوک گیت
follow	نقل کرنڑاں
follow up	پچھے لگے رہونڑاں
following	اگلا
food	کھاونڑاں
fool	بھولا
fool	بے وقوف بناونڑاں
foolish	پاگل
foot	پیر
football	فُٹ بال
for	واسطے
For example	مثال دے طور تے
for instance	مثال دے طور تے
for you	تساں واسطے
forbidden	ممنوعہ
force	قوت
forecast	پیشنگوئی
forehead	مَتھا
foreign	غیر ملکی
forest	جنگل
forever	ہمیشہ واسطے
forget	بُھل وینجڑاں
forgive	معاف کرنڑاں
forgot	بُھل گئے
fork	کانٹا
form	خاکہ بناونڑاں
form	شکل
formal	رسمی
former	قدیم
fortunately	خوش قسمتی نال
fortune	قسمت
forty	چالیھہ
forty-two	بتالیھہ
forward	اگے بھیجو
foster	پالنڑاں
fought	لڑائی کیتی
found	مل گیا
foundation	قیام
four	چار
fourteen	چوڈھاں
fox	لومڑی
fragile	نازک
frame	فریم
framework	ڈھانچا
fraud	فراڈ
freak	غیر معمولی شے
free	مفت
freedom	آزادی
freeze	جمڑاں
frequency	فریکوئنسی
frequent	اکثر
frequently	جلدی نال
fresh	تازہ
friday	جمعہ
fridge	فرج
friend	دوست
friendly	مہربان
friends	دوست
friendship	دوستی
frightened	ڈرنڑاں
frightening	ڈراونڑاں
frog	مینڈک
from	توں
front	اگو
frozen	جمیا ہویا
fruit	پھل
frustrated	مایوس
fuel	فیول
Fulfulde	فلفوڈا
full	مکمل
fun	تفریح
function	فنکشن
fundamental	بنیادی
funeral	جنازہ
funny	مزاحیہ
fur	فر
furious	زوردار
furniture	فرنیچر
further	بیا
furthermore	ایندے علاوہ
future	مستقبل
gain	نفع
gain	نفع کمانوڑاں
game	کھیڈ
gap	خالی جاہ
garage	گیراج
garbage	کوڑا
garden	باغ
garlic	تھوم
gate	بوہا
gather	جمع ہونڑاں
gathering	اجتماع
gauge	ناپڑاں
gave	ڈتا
gear	گیئر
gender	جنس
general	عام
generally	عام طور تے
generate	پیدا کرنڑاں
generation	نسل
generous	سوہڑاں
genius	ذہین
genre	قسم
gentle	شریف
genuine	اصلی
gesture	اشارہ
get	حاصل کرو
get dressed	تیار تھی وینجو
get up	تیار ہوونڑاں
get well soon	جلدی چنگے تھی ویسو
getting	نفع
ghost	بلا
ghosting	تصویر دے نال ڈوجھا فالتو عکس نظر آونڑاں
giant	دیو
gift	تحفہ
ginger	ادرک
girl	چھوہیر
girlfriend	محبوبہ
give	ڈیوو
give up	معاف کرنڑاں
given	ڈِتا
glad	خوش
glance	جھلک
glass	شیشہ
glasses	چشمہ
glimpse	عکس
global	عالمی
gloomy	سنسان
gloves	دستانے
glow	چمک
glow	چمکڑاں
glow up	چمکنڑاں
glue	گوند
go	ونجو
go ahead	شروع کرو
go away	روانہ ہوونڑاں
go to bed	بستر تے وینجو
goal	مقصد
goals	مقاصد
goat	بکری
god	خدا
god bless you	تساں دے اتے اللہ دی رحمت ہووے
goes	سفر کرنڑاں
going	وینجڑاں
going to	وینجڑاں
gold	سونا
gone	ٹر گیا
gonna	جاندا پیا
goo	چپکنڑ آلی شے
good	چنگا
good afternoon	ڈوپہر دا سلام
good bye	خدا حافظ
good day	چنگا ڈینھہ
good evening	شام دا سلام
good job	چنگا کم
good looking	خوبصورت
good luck	خوش قسمتی
good morning	سویر دا سلام
good morning my love	میڈے پیارے سویرے دا سلام
good night	رات دا سلام
goodbye	رب راکھا
goodnight	رات بخیر
goods	مال
Google	گوگل
Google Translate	گوگل ترجمہ
goose	ہنس
gorgeous	چمکڑاں
gossip	گالھیں کرنڑاں
got	مل گیا
got it	سمجھ گیاں
government	سرکاری
grab	کَھس گھنڑاں
grade	درجہ
gradually	ہولے ہولے
graduate	سند ڈیونڑاں
grain	دانڑاں
grant	منظور کرنڑاں
granted	منظور کیتا
grapes	انگور
grasp	سمجھڑاں
grass	گھاہ
grateful	مشکور
gratitude	شکر کرنڑاں
grave	قبر
gray	سرمئی
great	چنگا
greed	لالچ
greedy	لالچی
green	سبز
greet	مبارکباد ڈیونڑاں
greeting	سلام
greetings	مبارکباداں
grey	سرمئی
grid	جنگلا
grief	افسوس
grind	پیسڑاں
grip	پکڑ
grocery	کریانہ
groom	دولہا
gross	پورا
ground	میدان
group	گروپ
grow	نشونما
growth	پیداوار
grumpy	بدمزاج
Guarani	گورانی
guarantee	ضمانت
guard	محافظ
guess	اندازہ لاؤ
guest	مہمان
guidance	رہنمائی
guide	رہنمائی کرنڑاں
guide	رہنما
guilty	مجرم
guy	بندہ
guys	لوک
gym	جم خانہ
habit	عادت
habitat	وطن
had	رکھیا
hail	سلام کرنڑاں
hair	وال
half	ادھا
hall	ہال
hand	ہتھ
handle	قابو کرنڑاں
handsome	سوہنڑاں
hang	لٹکاؤ
hang out	نمائش کرنڑاں
happen	واقعہ ہوونڑاں
happened	واقع تھیا
happiness	خوشی
happy	خوشی
happy birthday	سالگرہ مبارک
happy birthday to you	تواکوں سالگرہ مبارک ہووے
happy new year	نویں سال دی مبارک
hard	بھاری
hardly	مشکل نال
hardly ever	شاید ہی کڈھئیں
harm	نقصان پُجاونڑاں
harm	نقصان
harmful	خطرناک
harmony	ہم آہنگی
harsh	کڑک
harvest	کٹائی
has	ہے
hate	نفرت
have	ہے
have a good day	تہاڈا ڈینھہ چنگا گزرے
have a nice day	تساں دا ڈینھہ چنگا ہووے
have breakfast	ناشتہ کرو
have fun	مزہ کرو
have you eaten	کیا تساں کھا گھدا ہے
having	گھر دا سامان
hazard	خطرہ
haze	کُہیڑ
he	چھوہر
he has	اوندے کولہو ہے
he is	او ہے
head	سر
headache	سر درد
heal	ایڑھی
healing	چنگا تھونڑاں
health	صحت
healthy	صحت مند
hear	سنڑو
heard	سنڑیا
heart	دل
heat	حرارت
heat	گرم کرنڑاں
heaven	جنت
heavy	بھاری
hectic	پُر جوش
height	اوچائی
heir	وارث
heist	چوری کرنڑاں
held	قرار ڈتا گیا
hell	جہنم
Hello	ہیلو
hello dear	ہیلو دوست
hello how are you	ہیلو تساں کیویں ہو
hello how are you doing	ہیلو تساں کیا کریندے پیوے
helmet	ہیلمٹ
help	مدد کرو
helpful	مددگار
hence	بعد وچ
her	زنانی
herd	ریوڑ
here	ایتھاں
heritage	ترکہ
hesitate	شرمانونڑاں
Hey	ھے
Hi	ہائے
hi how are you	ہائے تساں دا کیا حال ہے
Hi there	ہیلو
hidden	لکیا ہویا
hide	لکاؤ
hierarchy	پِیر
high	اوچا
highlight	خاص گالھہ
hike	لمبا پیدل سفر
hiking	ہائیکنگ
hilarious	زندہ دل
hill	پہاڑی
him	مرد
hint	اشارہ
hip	ران
hips	کولہے
hire	کرائے تے ڈیونڑاں
hiring	بھرتی کرنڑاں
his	مذکر
history	تاریخ
hit	مارنڑاں
Hmm	ہمم
hobby	شوق
hold	سانبھو
hold on	قابو وچ رکھو
hole	سوراخ
holiday	چھٹی
hollow	کھوکھلا
home	گھر
homework	گھر دا کم
honest	ایماندار
honestly	ایمانداری نال
Honey	ماکھی
honor	عزت
hood	قنات
hook	کنڈا
hop	کودنڑاں
hope	اُمید رکھڑاں
hope	اُمید
hopefully	پُر امید طور تے
hopeless	ناامید
horizontal	افقی
horn	سینگ
horrible	خوفناک
horror	عزت
horse	گھوڑا
hospital	ہسپتال
hospitality	تواضع
host	میزبان
host	میزبان بنڑاں
hostile	مخالف
hot	گرم
hotel	ہوٹل
hour	گھنٹہ
hours	گھنٹے
house	گھر
household	خاندان
how	کیویں
how about you	تساں کینجھے ہو
how are you	تساں کیویں ہو
how are you doing	تساں کیویں ہو
how are you doing today	تساں اج کیویں ہو
how are you today	اج تساں دا کیا حال ہے
how do you do	تساں کینجھے ہو
how is	کینجھا ہے
how many	کنے
how much	کتنا
how often	کتنی واری
how old are you	تساں دی عمر کیا ہے
how was your day	تساں دا ڈینھہ کینجھا ہا
how was your night	تساں دی رات کیویں گزری
however	تاں
hub	مرکز
hubby	پایا
hug	گلے لاونڑاں
hug	پیار کرنڑاں
huge	بہوں وڈا
human	انسان
humble	مسکین
humid	سِنا
humidity	ہوا اچ نمی
hundred	سو
hungry	بُکھا
hunt	شکار کھیڈنڑاں
hurricane	آندھی
hurry	جلدی کرنڑاں
hurry up	جلدی کرنڑاں
hurt	ڈکھ ڈیوڑاں
husband	پایا
hustle	دھکا کھاونڑاں
hustle	دھکا
hut	جھونپڑی
hygiene	صحت صفائی
I	میں
I am	میں
I am fine	میں ٹھیک ہاں
I can	میں کر سکدا آں
I can't	میں نمی کر سکدا
I do	میں کرینداں
I do not know	میکوں کائینی پتہ
I do not understand	میکوں سمجھ کائینی آئی
I don't	میں نمی کریندا
I don't know	میکوں کائینی پتہ
I don't understand	میکوں سمجھ کائینی آیا
I don't understand what you mean	میں تہاڈا مطلب نہیں سمجھیا
I don't understand you	میں تہاڈی گالھہ نمی سمجھیا
I don’t know	میکوں کائینی پتہ
I don’t understand	میں کائینی سمجیا
i guess	میڈا خیال ہے
I had	میڈے کولہو ہا
I have	میڈے کولہو ہے
I have been	میں کردا رہیاں
I hope so	میکوں امید ہے
I know	میکوں پتہ ہے
I like	میکوں پسند ہے
I like you	میکوں تساں پسند او
I love	میکوں محبت ہے
I love my big brother	میکوں آپنڑیں وڈے بھرا نال پیار ہے
I love my big sister	میکوں آپنڑیں وڈی بھینڑ نال پیار ہے
I love my father	میکوں آپنڑیں پیو نال پیار ہے
I love my little brother	میکوں آپنڑیں نکے بھرا نال پیار ہے
I love my little sister	میکوں آپنڑیں نکی بھینڑ نال پیار ہے
I love my mother	میکوں آپنڑیں ماں نال پیار ہے
I love you	میکوں تساں دے نال پیار اے
I love you so much	میکوں تساں نال بہوں پیار ہے
I love you too	میکوں وی تساں نال پیار اے
I mean	میڈا مطلب اے
I miss you	میں تہاکوں یار کریندا ہاں
I miss you so much	میں تواکوں بہوں زیادہ یاد کرینداں
I see	میں سمجھ گیاں
I think	میڈا خیال ہے
I understand	میں سمجھدا آں
I want	میں چاہنداں
I want to see you	میں تواکوں ڈیکھڑاں چاہنداں
I want you	میں تیکوں چاہندا ہاں
I was	میں ہامیں
I will	کریساں
I would be	میں ہوواں گا
I'm	میں
I'm fine	میں ٹھیک ہاں
I'm good	میں چنگا ہاں
I'm here	میں اتھاں ہاں
I'm sorry	میکوں معاف کرو
ice	برف
ice cream	آئس کریم
idea	خیال
ideal	مثالی
identical	ملدا چُلدا
identify	سنیانڑو
identity	شناخت
idiot	بیوقوف
idle	بیکار
if	جے
ignore	نظرانداز کرو
ill	بیمار
illegal	غیر قانونی
illness	بیماری
Ilocano	اِلوکانو
image	فوٹو
imagine	تصور کرنڑاں
immediate	فوری
immediately	فوری طور تے
immense	لامحدود
impact	اثر
impact	اثر کرنڑاں
impatient	بے صبر
implement	عمل وچ آنڑاں
import	درآمد کرنڑاں
import	درآمد
important	اہم
impose	نافذ کرنڑاں
impossible	ناممکن
impress	ٹھپا لاونڑاں
impression	خیال
impressive	متاثر کرنڑ والا
improve	بہتر کرو
improvement	بہتری
in	وچ
in addition	ایندے علاوہ
In fact	حقیقت وچ
in front of	دے سامنڑیں
in order to	کرنڑ واسطے
inappropriate	نامناسب
incentive	مقصد
incident	حادثہ
include	شامل کرو
including	شامل ہونڑاں
income	آمدن
inconvenience	تکلیف ڈیونڑاں
increase	ودھانا
increase	ودھاؤ
increased	ودھایا گیا
incredible	یقین نہ کرنڑ دے قابل
indeed	حقیقت وچ
independent	خودمختار
India	بھارت
indicate	نشاندہی کرنڑاں
indigenous	مقامی
individual	کلہا
industry	صنعت
inevitable	لاعلاج
infant	کھیر پیونڑ آلا بال
infection	انفیکشن
infinity	لامحدود
inflammation	ورم
inflation	ودھاوا
influence	اثر
influence	اثر کرنڑاں
inform	اطلاع ڈیوو
information	معلومات
ingredients	شیواں
inheritance	جائیداد
initial	ابتدائی
initiative	پہلا قدم
injured	نقصان پُجیا
injury	چوٹ
innocent	معصوم
innovation	تبدیلی
inquiry	چھان بین
insane	دیوانہ
insect	کیڑا مکوڑا
insecure	غیر محفوظ
insert	داخل کرنڑاں
inside	اندرلے پاسے
insight	گھیری نظر
insist	تقاضا کرنڑاں
insomnia	نیندر نہ آونڑاں
inspiration	ساہ گھنڑاں
inspire	جوش پیدا کرنڑاں
install	انسٹال کرنڑاں
instance	واقعہ
instant	فوری
instead	بجائے
instead of	دے بجائے
instructions	ہدایتاں
instrument	اوزار
insult	بے عزتی
insurance	بیمہ
intact	محفوظ
integrity	ایمانداری
intellectual	ذہنی
intelligence	ذہانت
intelligent	ذہانت
intend	ارادہ کرنڑاں
intended	منظور شدہ
intense	تیز
intention	ارادہ
interact	اک ڈوجھے تے عمل کرنڑاں
interaction	اشتراک عمل
interest	دلچسپی
interested	دلچسپی رکھدے آں
interesting	دلچسپ
interfere	مداخلت
intermediate	ثانوی
internal	اندرونی
international	بین الاقوامی
internship	نگرانی وچ تربیت
interpret	مداخلت
interpreter	ترجمان
interrupt	دخل ڈیونڑاں
interview	انٹرویو
intimate	قریبی
into	دے وچ
introduce	تعارف کراؤ
introduction	تعارف
introvert	اندرلے پاسے موڑنڑاں
intuition	مشاہدہ
invalid	غیر قانونی
invent	ایجاد کرنڑاں
inventory	فہرست
invest	سرمایہ لگاونڑاں
investigate	تفتیش کرنڑاں
invitation	کانڈھا ڈیونڑاں
invite	کانڈھا ڈیوو
invoice	بِل بناونڑاں
invoice	بِل
involve	شامل ہونڑاں
involved	شامل ہونڑاں
iron	استری کرنڑاں
iron	استری
is	ہے
island	جزیرہ
isolated	سُنسان
issue	نکلڑاں
issue	انجام
issues	مسئلے
it	جے
it is	ایہہ ہے
it was	ایہہ ہا
it's	ایندا
it's ok	ٹھیک ہے
It's okay	ٹھیک ہے
item	شے
items	شیواں
its	ایہہ ہے
I’m	میں ہاں
jacket	جیکٹ
jail	جیل
January	جنوری
jar	مٹکا
jaw	جبڑا
jealous	سِننا
jerk	جھٹکا
jewelry	زیور
job	نوکری
jogging	ہولے درکڑاں
join	شامل ہوو
joint	جوڑ
joke	لطیفہ
journalist	صحافی
journey	سفر
joy	خوشی
judge	جج
judge	فیصلہ کرنڑاں
juice	جوس
july	جولائی
jump	اچھلڑاں
june	جون
junk	نجات پاونڑاں
just	انصاف پسند
just	بالکل
just do it	بس کر سٹو
justice	انصاف
justify	صحیح ثابت کرنڑاں
Kalaallisut	کالالیست
keen	بہوں گھٹ
keep	رکھو
keep it up	ایکوں جاری رکھو
kept	رکھیا ہویا
kettle	کیٹلی
key	چابی
kick	ٹھوکر مارنڑاں
kid	بال
kidding	مذاق کرنڑاں
kidney	گردہ
kids	بچے
kill	مارنڑاں
kind	رحم دل
kind	قسم
kinda	قسم
kindly	مہربان
kindness	رحمدلی
king	بادشاہ
kiss	چُمڑاں
kitchen	باورچی خانہ
kite	پتنگ
kitten	بلی دا بچہ
knee	گوڈا
knew	جانڑاں
knife	چاقو
knight	گھوڑا
know	جانڑاں
knowledge	علم
known	جانڑاں گیا
Konkani	کونکنی
Krio	کریو
label	لیبل لگاونڑاں
label	لیبل
labor	مزدوری
labour	بال پیدا ہونڑاں
lack	کمی
ladder	پوڑھی
lady	زال
laid	دبیا ہویا
lake	تالاب
lamb	بھیڈ
lame	لنگڑا
lamp	شمع
land	زمین
land	کنارے
landscape	قدرتی منظر
language	زبان
lap	جھولی
large	کُھلا
last	آخری
last but not least	آخری لیکن گھٹ توں گھٹ نہ
last name	آخری ناں
late	مرحوم
lately	تھوڑا عرصہ پہلاں
later	بعد اچ
latest	تازہ ترین
latter	آخری
laugh	کھلڑاں
laughing	کھلڑاں
laughter	کھل
launch	لانچ کرنڑاں
laundry	لانڈری
law	قانون
lawn	لان
lawyer	وکیل
lay	لیٹڑاں
layer	تہہ
layout	ترتیب
lazy	سست
lead	راہنمائی کرنڑاں
leader	قائد
leaf	پتہ
leak	ٹپکڑاں
lean	ٹیکا لاونڑاں
leap	چھال مارنڑاں
learn	سکھڑاں
learning	سکھڑاں
lease	ٹھیکہ ڈیونڑاں
least	آخیری
leather	چمڑا
leave	چھٹی
leave	روانہ ہونڑاں
leaves	چھٹیاں
led	زیر انتظام
left	باقی
leg	لت
legacy	ورثہ
legal	قانونی
legend	روایت
legit	عوامی
leisure	فارغ
lend	قرض ڈیونڑاں
length	لمائی
less	گھٹ
lesson	سبق
let	اجازت ڈیونڑاں
letter	خط
lettuce	سلاد پتہ
level	درجہ
leverage	بیرمی نظام
liability	ذمہ واری
library	لائبریری
lick	چَٹڑاں
lie	جوٹھ بولڑاں
lie	جوٹھ
lies	جوٹھ
life	حیاتی
lift	چاونڑاں
lift	اُتے چاونڑاں
light	ہلکا
light	روشنی
lightning	آسمانی بجلی
like	پسند
likely	بہوں ممکن
likewise	ایویں ای
line	لکیر
Lingala	لنگالا
link	کڑی
lion	شیر
liquid	مائع
list	فہرست
listen	سنڑو
listening	سنڑاں
literally	سچ مچ
literature	ادب
litter	پھیلڑاں
little	نکا
live	زند رہنڑاں
live	زندہ
liver	جگر
lives	حیاتیاں
living	جیندا جاگدا
living room	بیٹھک
lizard	چھپکلی
load	لوڈ کرنڑاں
loaf	ٹہلڑاں
loan	قرض
local	مقامی
location	جاہ
lock	تالا
lockdown	لاک ڈاؤن
log	لاگ
lol	زول نال ہسنا
lonely	کلہا
long	لما
long time no see	تساں کوں ڈیکھے بہوں ڈینھہ تھی گئین
look	ڈیکھڑاں
look	شکل
loop	لوپ
loose	ڈھیلا
loose	ڈھیلا کرنڑاں
lord	حاکم
lose	گنوانڑاں
loss	نقصان
lost	گار تھینڑاں
lot	زیادہ
loud	اوچا
lounge	بھالا گھنڑ دا کمرہ
love	محبت کرنڑاں
love	پیار
love you	تساں کوں پسند کریندے آں
lovely	سوہنڑاں
low	گھٹ
lower	گھٹ
loyal	وفادار
loyalty	وفاداری
luck	قسمت
lucky	خوش قسمت
Luganda	یوگنڈا
luggage	زبان
lump	گُٹھلی
lunch	ڈوپہر دا کھاونڑاں
lungs	پھیپھڑے
luxury	عیش پرست
lying	لمے پانڑاں
machine	مشین
mad	دیوانہ
madam	میڈم
made	بنڑیا ہویا
magazine	رسالہ
magnificent	عالیشان
maid	ملازمہ
main	اہم
maintain	برقرار رکھو
maintenance	مرمت
Maithili	میتھلی
major	اہم
major	میجر
majority	اکثریت
make	بنڑاؤ
make up	سنگھار کرنڑاں
male	مرد
mall	مال
man	مرد
manage	انتظام کرو
management	انتطامیہ
manager	منتظم
mandatory	ضروری
manifest	ظاہر
manipulate	گٹھ جوڑ کرنڑاں
manner	طور طریقہ
manual	ہتھ نال
many	بہوں کجھ
many many happy returns of the day	خوشی دا ایہہ ڈینھہ ولا ولا آوے
march	مارچ
margin	حاشیہ
market	مارکیٹ
marriage	شادی
married	شادی شدہ
mask	ماسک
mass	ڈھیر
massive	ٹھوس
master	ماسٹر
match	جوڑ
match	کھیڈنڑاں
mate	شادی کرنڑاں
material	سامان
math	حساب
matter	واقعہ
matter	اہم ہونڑاں
maturity	واجب
may	ممکن ہونڑاں
may	کنواری
maybe	تھی سکدا اے
me	میں
me too	میڈا وی
meal	کھاونڑاں
mean	مطلب
mean	عام
meaning	مطلب
means	مطلب
meant	مطلب تھیا
meanwhile	دوران وچ
measure	ناپو
measures	تدبیراں
meat	گوشت
medical	میڈیکل
medicine	دوا
meditation	مسلسل سوچ
medium	ذریعہ
meet	ملو
meeting	ملاقات
Meiteilon	مٹیلین
melt	گھلڑاں
memories	یاداں
memory	یادداشت
mental	ذہنی
mention	ذکر کرنڑاں
mentioned	منصوبہ بناونڑاں
mentor	استاد
merchant	سوداگر
mercy	رحمت
merely	صرف
merry christmas	میری کرسمس
mess	گند
message	پیغام
messy	بے ترتیب
metal	دھات
method	طریقہ
mice	چوہے
middle	درمیانی
midnight	ادھی رات
might	تھی سکدا اے
mild	درمیانی
milestone	ترقی دا نشان
military	فوج
milk	کھیر
million	ڈاہ لکھ
mind	ضمیر
mind	بُرا مناونڑاں
mindset	سوچنڑ دا انداز
mine	کان
mine	میڈا
mingle	ملاونڑاں
minor	نکا
minute	منٹ
minutes	منٹاں
miracle	کرشمہ
mirror	شیشہ
miscellaneous	مختلف شیواں
mischievous	شرارتی
miserable	ڈکھی
misery	آفت
miss	ناکام رہنڑاں
miss you	تساں کوں یاد کریندے آں
missing	غائب
mission	فرض
mist	دُھند
mistake	غلطی
Mizo	میزو
mobile	موبائل
mock	مذاق اُڈارنڑاں
model	نمونہ
moderate	معتدل
moderate	اعتدال اتے آنڑاں
modern	جدید
modest	معمول جھا
moist	تر
moisture	نمی
mold	پھپھوندی لگڑاں
mold	پھپھوندی
mole	تِل
mom	ماں
moment	ویلا
monday	سوموار
money	پیسہ
monitor	مانیٹر
monkey	بندر
month	منہ
mood	موڈ
moody	بیزار
moon	چندر
moral	اخلاقی
more	ودھ
moreover	اس دے سوا
morning	سویرے
mortgage	رہن
most	سب کنے ودھ
mostly	زیادہ تر
mother	ماں
motion	حرکت
motivation	تحریک
mountain	پہاڑ
mouse	چوہا
mouth	منہ
move	منتقل کرنڑاں
movement	تحریک
movie	فلم
mrs	شادی شدہ زال
much	بہوں ودھ
mud	دلدل
mug	کٹورا
muscle	پٹھا
museum	عجائب گھر
mushroom	کھمبی
music	موسیقی
must	فرض
must	کچی شراب
mute	چپ کروانڑاں
mutual	مشترکہ
my	میڈا
My dear	میڈے پیارے
my friend	میڈا دوست
My hovercraft is full of eels	میڈا ہوور کرفٹ ایلاں نال بھریا ہویا ہے
my love	میڈا پیار
my name is	میڈا ناں ہے
my pleasure	میڈی خوش قسمتی ہے
myself	آپنڑیں آپ کوں
mysterious	پراسرار
mystery	راز
myth	فرضی گالھیں
nail	نحوں
naive	سدھا سادا
name	ناں
narrative	بیانیہ
narrow	سوڑا
nasty	ناپاک
national	قومی
nationality	قومیت
native	مقامی
natural	قدرتی
nature	قدرت
nausea	متلی
near	کولہو
nearby	کولہو
nearly	کولہو کولہو
neat	صاف
necessary	ضروری
neck	گِچی
necklace	ہار
need	ضرورت ہونڑاں
need	فوری ضرورت
negative	منفی
neglect	نظر انداز کرنڑاں
negotiate	سودا کرنڑاں
neighbor	ہمسائے
neighborhood	ہمسائے
neither	ڈوہویں وچوں کوئی ہک وی کائینا
nephew	بھتریجا
nerd	کمزور
nervous	پریشان
nest	گھونسلا
net	جالی
network	نیٹ ورک
neutral	قدرتی
never	کڈئیں وی نہ
never give up	کڈھئیں ہمت نہ ہارو
never mind	برا نہیں میندا
nevermind	کوئی گالھہ نہیں
nevertheless	ایس دے باوجود
new	نواں
news	خبراں
next	اگلا
next to	دے نال
nice	اچھا
nice to meet you	تساں نال مل کے خوشی تھئی اے
niece	بھڑینجی
night	رات
nightmare	ڈرونڑاں خواب
nine	نئوں
nineteen	انویھہ
ninety	نوّے
No	نہ
no problem	کوئی مسئلہ کائینی
no way	بالکل وی نہ
nobody	کوئی وی نہ
noise	شور
noisy	شور آلا
none	کوئی وی نہ
noon	ڈوپہر
nope	نہ
nor	نہ تے
normal	عام
north	شمال
nose	نک
nostalgic	ماضی دی یاد
not	کائینا
not at all	بالکل وی کائیناں
not bad	برا کائینی
Not now	ہونڑیں نہ
not yet	ہنڑ تائیں نہ
note	نوٹ
noted	اہم
nothing	کجھ وی نہ
notice	غور کرنڑاں
noticed	نوٹس کیتا
noun	اسم
nouns	اسم
novel	ناول
november	نومبر
now	ہونڑ
nowadays	اج کل
nuisance	تکلیف
null	خالی
numb	سن کرنڑاں
number	نمبر
nurse	نرس
nut	اخروٹ
nutmeg	جائفل
nutrition	خوراک
oath	حلف
obesity	موٹاپا
obey	فرمانبرداری کرنڑاں
object	شے
objective	حقیقی
obligation	پابندی
obscure	اندھارا
observation	مشاہدہ کرنڑاں
observe	غور کرنڑاں
obsessed	وہم دل وچ بیہہ گئے
obsession	وہم کرنڑاں
obsolete	پرانڑاں
obstacle	آڑ
obtain	حاصل کرنڑاں
obtained	جاری ہویا
obvious	صاف
obviously	واضح طور تے
occasionally	کڈھئیں کڈھئیں
occupation	پیشہ
occupied	قبضہ کیتا
occur	واقع ہونڑاں
occurred	واقع تھیا
occurs	ہوونڑاں
ocean	سمندر
october	اکتوبر
odd	بے جوڑ
odds	فرق
of	دا
of course	بے شک
off	بند
offensive	خراب
offer	تجویز
offer	تجویز کرنڑاں
office	آفس
official	سرکاری
often	کڈھئیں
Oh	اوہ
oh really	اوہ واقعی
oil	تیل
ok	ٹھیک ہے
ok dear	ٹھیک ہے دوست
ok honey	ٹھیک ہے مٹھی
ok my love	ٹھیک ہے میڈے سوہنڑے
okay	ٹھیک ہے
okay baby	ٹھیک ہے میڈی جان
okay dear	ٹھیک ہے دوست
okay honey	ٹھیک ہے مٹھی
okay my love	میڈے پیار ٹھیک ہے
old	پرانڑاں
on	اتے
once	ہک واری
one	ہک
one language is never enough	ہک زبان کافی نہیں ہوندی
onion	وصل
online	آن لائن
only	صرف
open	کھولو
operation	آپریشن
opinion	رائے
opportunities	موقعے
opportunity	موقع
opposite	ضد
optimistic	امید نال رہونڑاں
option	اختیار
optional	اختیاری
or	یا
orange	اورنج
orange	کینو
order	حُکم
order	حُکم ڈیونڑاں
ordinary	معمولی
organization	تنظیم
orientation	تبدیلی لاونڑاں
origin	بنیاد
original	اصل
Oromo	اورومو
orphan	یتیم
other	بیا
otherwise	ایس دے علاوہ
ought	ضروری ہونڑاں
our	سہاڈا
Our mission: to enable everyone, everywhere to understand the world and express themselves across languages.	ساڈا مشن: ہر اک نوں، ہر جاہ تے دنیا نوں سمجھنڑ تے وکھری بولیاں وچ آپنڑاں اظہار کرنڑ دے قابل بناونڑاں۔
Our mission: to organize the world's information and make it universally accessible and useful.	ساڈا مشن: دنیا دی معلومات کوں منظم کرنڑاں تے پوری دنیا وچ اینکوں رسائی دے قابل تے فائدہ مند بناونڑاں۔
out	باہر
outcome	نتیجہ
outfit	کپڑے
outgoing	کیتی جاونڑ آلی
outlet	نکلنڑ دی راہ
outline	خاکہ
outside	باہر
outstanding	غیر معمولی
oven	اوون
over	اوتے
over there	اُتھاں
overall	مجموعی
overcome	ہراونڑاں
overthinking	زیادہ سوچڑاں
overwhelmed	جذباتی
overwhelming	بہوں زیادہ
owe	قرض دار ہونڑاں
owl	الو
own	زاتی
own	مالک ہونڑاں
owner	مالک
ox	سانڈ
pace	رفتار
pack	بدھڑاں
package	بدھنڑاں
paid	ادا شدہ
pain	درد
paint	رنگ
painting	مصوری
pair	جوڑا
pale	پیلا
palm	ہتھیلی
pan	پرات
pandemic	وبا
panic	دہشت
pants	پینٹ
paper	پرچہ
paradise	جنت
parallel	اکو جیہا
parcel	پارسل
pardon	معافی ڈیونڑاں
parents	ماں پیو
park	پارک
parrot	طوطا
parsley	پارسلے
part	حصہ
participate	شامل ہونڑاں
particular	مخصوص
particularly	خاص طور تے
partner	ساتھی
party	دعوت
pass	پاس
passage	راہ
passed	ٹُر گیا
passion	جذبہ
passionate	جذباتی
passive	سست
password	پاس ورڈ
past	ماضی
patch	تھگڑی
path	راہ
pathetic	درد آلا
patience	صبر
patient	مریض
patient	صابر
pattern	نمونہ
pause	تھوڑی دیر رُکڑاں
pavement	پَکّی روڈ
pay	ادائیگی کرو
payment	ادا کرنڑاں
peace	امن
peaceful	پرامن
peach	آڑو
peak	چوٹی
pear	ناشپاتی
peas	مٹر
peculiar	خاص
pee	مٹر
pee	چھوٹا پیشاب کرنڑاں
peel	چِھلڑاں
peer	برابر
peers	ہم جھولی
pen	قلم
pencil	پنسل
pending	زیر غور
people	لوک
pepper	کالی مرچ
perceive	ڈیکھڑاں
perception	مینھ
perfect	مکمل کرنڑاں
perform	انجام ڈیوو
performance	کارکردگی
perhaps	شید
period	ویلا
permanent	مستقل
permission	اجازت
permit	اجازت ڈیونڑاں
perseverance	استقامت
persistent	ثابت قدم
person	بندہ
personal	ذاتی
personality	شخصیت
perspective	منظر
persuade	منوانڑاں
pervert	بچاؤ
pet	پالتو
phase	دور
phenomenon	انوکھی شے
philosophy	فلسفہ
phone	فون
photo	تصویر
phrase	جملہ
physical	جسمانی
pick	چنڑاں
pick up	چاؤ
picture	تصویر
piece	ٹکڑا
pieces	ٹکڑے
pig	سور
pigeon	کبوتر
pile	ڈھیر
pillow	سرانڑاں
pilot	پائلٹ
pin	پِن
pineapple	انناس
pink	گلابی
pit	کَھڈ
pitch	کم شروع کرنڑاں
pity	ہمدردی
place	مقرر کرنڑاں
place	جاہ
places	جاہواں
plague	طاعون
plain	سادہ
plan	منصوبہ
plane	جہاز
plant	پودا
plants	پودے
plate	پلیٹ
platform	پلیٹ فارم
play	کھیڈڑاں
play	کھیڈ
playing	کھیڈڑاں
pleasant	خوشگوار
please	مہربانی
pleased	خوش
pleasure	خوشی
pledge	ضمانت
plenty	بہوں زیادہ
plot	پلاٹ
plug	پلگ
plum	آلو بخارا
plumber	پلمبر
plural	جمع
podcast	پوڈکاسٹ
poem	نظم
poetry	شاعری
point	نقطہ
poison	زہر
police	پولیس
policy	پالیسی
polite	خوش اخلاق
pollution	آلودگی
pond	تالاب
pool	پول
poop	تھک وینجڑاں
poor	غریب
pop	پھٹراں
popular	مشہور
population	آبادی
pork	سور دا گوشت
porridge	دلیہ
port	بندرگاہ
position	عہدہ
positive	مثبت
possess	ماک ہوونڑاں
possession	قبضہ
possessive	قبضے دے متعلق
possible	ممکن
post	اشتہار ڈیونڑاں
post	عہدہ
postpone	ملتوی کرنڑاں
potato	آلو
potential	اختیار
pound	پاؤنڈ
poverty	غریبی
power	طاقت
powerful	طاقتور
practical	تجربہ
practice	عمل کرنڑاں
practice	عمل
praise	تعریف کرنڑاں
prank	شرارت
pray	دعا
precious	قیمتی
precise	صاف
precisely	بالکل ٹھیک
predict	پیشنگوئی کرنڑاں
prefer	ترجیح ڈیوو
preference	ترجیح
pregnant	حاملہ
prejudice	بے انصافی کرنڑاں
premises	عمارت
premium	پریمیم
preparation	تیاری
prepare	تیاری کرو
prepared	تیار کیتا
preposition	حرف ربط
presence	موجودگی
present	تحفہ
present	موجودہ وقت
presentation	پریزنٹیشن
preserve	محفوظ کرنڑاں
president	صدر
press	دباونڑاں
press	بِھیڑ
pressure	دباؤ
pretend	بہانہ کرنڑاں
pretty	خوبصورت
pretty	چنگے طریقے نال
prevent	روکڑاں
previous	پچھلا
prey	شکار
price	قیمت
pride	فخر کرنڑاں
priest	پادری
primary	پرائمری
prime	اہم ترین
princess	شہزادی
principal	پرنسپل
prior	افضل
priority	ترجیح
prison	قید خانہ
privacy	رازداری
private	پرائیویٹ
privilege	بری کرنڑاں
prize	انعام
probably	امکان ہونڑاں
problem	مسئلہ
procedure	طریقہ
proceed	اگے ونجو
process	عمل کرنڑاں
process	طریقہ
produce	پیدا کرنڑاں
product	پراڈکٹ
production	پیداوار
profession	پیشہ
professional	پیشہ ور
profile	پروفائل
profit	منافع
profound	چاونڑاں
progress	ترقی کرنڑاں
progress	ترقی
project	منصوبہ
prominent	نمایاں
promise	وعدہ کرنڑاں
promise	وعدہ
promote	ترقی ڈیونڑاں
promotion	ترقی
prompt	فوری
prone	جھکیا ہویا
pronouns	تلفظ
pronunciation	تلفظ
proof	ثبوت
proper	مناسب
properly	چنگی طرحاں
properties	خصوصیتاں
property	جائیداد
proposal	تجویز
prospect	امکان
prosperity	کامیابی
prosperous	خوشحال
protect	تحفظ
proud	مغرور
prove	ثبوت
provide	ڈیوو
provided	ڈے ڈتا گیا
province	صوبہ
provision	فراہم کرنڑاں
puberty	جوانی
public	عوام
pull	چھکو
pumpkin	کدو
punctual	وقت دا پابند
pupil	شاگرد
purchase	گھنو
pure	خالص
purple	جامنی
purpose	مقصد
purse	پرس
pursue	پچھو لگے رہنڑاں
pursuit	جستجو
push	دھکا ڈیوو
put	رکھو
qualification	تعلیم
quality	معیار
quantity	معیار
quarantine	قرنطینہ
quarrel	جھگڑا
quarrel	جھگڑنڑاں
quarter	چوتھائی
Quechua	کیچوا
queen	شہزادی
queer	نرالا
query	سوال
question	سوال
queue	قطار
queue	قطار بناونڑاں
quick	فوری
quickly	فوری طور تے
quiet	چپ
quilt	سووڑ
quit	چھوڑو
quite	بہوں کجھ
quite	بالکل
quiz	پہیلی
quotation	حوالہ
quote	حوالہ ڈیونڑاں
quote	حوالہ
quotes	حوالے
rabbit	خرگوش
race	ریس
rage	غصہ
rain	مینھ
raise	چاونڑاں
raise	اُتے چاونڑاں
raised	چایا ہویا
ran	ستلی
random	بے ترتیب
range	حد
rapid	بہوں تیز
rapidly	تیزی نال
rare	غیر معمولی
rarely	کڈئیں کڈھئیں
rash	پھرتی نال
rat	چوہا
rate	ریٹ
rather	بہوں حد تائیں
ratio	شرح
rational	سمجھدار
raw	لین
re	ری
reach	پُجو
reached	پُج گیا
reaction	رد عمل
read	پڑھو
reading	پڑھنڑاں
ready	تیار
real	اصلی
reality	حقیقت
realize	احساس کرنڑاں
realized	حاصل کیتا ہویا
really	واقعی
rear	گھٹ
reason	وجہ
reasonable	مناسب
recall	ولا کال کرو
receipt	رسید
receive	وصول کرو
received	وصول کیتا
recent	نواں تازہ
recently	ہونڑیں ہونڑیں
reception	استقبالیہ
recipe	ترکیب
reckless	لاپرواہ
recognition	شناخت کرنڑاں
recognize	سنیانڑو
recommend	تجویز کرنڑاں
recommended	سفارش کیتی
record	ریکارڈ
record	ریکارڈ کرنڑاں
recover	واپس گھنڑاں
recovery	وصولی
rectangle	مستطیل
red	سرخ
redeem	بچا گھنڑاں
redemption	چھڑوانوڑاں
reduce	گھٹ کرو
redundant	فالتو
refer	حوالہ
reference	حوالہ
reflect	عکس
reflection	ریفلیکشن
refrain	رکڑاں
refrigerator	سردخانہ
refund	واپس کرنڑاں
refuse	انکار کرنڑاں
refused	انکار کیتا
regard	خیال کرنڑاں
regarding	دے متعلق
regardless	بے لحاظ
regards	مخلص
region	علاقہ
register	رجسٹر
regret	افسوس
regular	باقاعدہ
regularly	باقاعدگی نال
reject	رد کرنڑاں
relate	بیان کرنڑاں
related	متعلقہ
relationship	رشتہ
relative	موصول
relative	رشتے دار
relatives	رشتہ دار
relax	آرام کرنڑاں
release	آزادی
release	آزاد کرنڑاں
released	جاری کیتا گیا
relevant	متعلقہ
reliable	بھروسے آلا
relief	امداد
relieve	حمایت کرنڑاں
relieved	حمایت کیتی
religion	مذہب
religious	مذہبی
reluctant	ضدی
rely	بھروسہ کرنڑاں
remain	باقی ہونڑاں
remaining	باقی
remarkable	نمایاں
remedy	علاج
remember	یاد رکھو
remind	یاد ڈیواونڑاں
reminder	یاد کروانڑاں
remote	ریموٹ
remove	ہٹاؤ
render	ڈیونڑاں
rent	کرایہ
repair	مرمت کرنڑاں
repeat	دہراؤ
replace	ادل بدل کرنڑاں
reply	جواب
reply	جواب ڈیونڑاں
report	اطلاع ڈیونڑاں
report	اطلاع
represent	نمائندگی کرنڑاں
reputation	عزت
request	درخواست
request	عرض کرنڑاں
require	ضروری
required	ضرورت اے
rescue	بچاونڑاں
research	تحقیق
resemble	رلدا ملدا
resentment	بُرا مناونڑاں
reservation	قید
reserve	محفوظ کرنڑاں
resident	رہائشی
resign	استعفٰی ڈیونڑاں
resilience	لچک
resilient	لوچ آلا
resist	مقابلہ کرنڑاں
resistance	مدافعت دی طاقت
resolution	نارمل ہونڑاں
resolve	حل کرنڑاں
resort	گزرنڑاں
resources	وسائل
respect	عزت
respect	عزت کرنڑاں
respond	جواب ڈیونڑاں
response	جواب
responsibility	ذمہ واری
responsible	ذمہ وار
rest	آرام
rest in peace	رحمت وچ جاہ ملے
restaurant	ریسٹورینٹ
restore	واپس آنڑاں
restrict	پابند
result	نتیجہ
results	نتیجے
resume	ولا شروع کرو
retail	پرچون ویچڑاں
retain	رکھو
retention	یاد رکھنڑاں
retired	ریٹائر ہویا
retreat	پِچھے ہٹڑاں
retrieve	ولا حاصل کرنڑاں
return	واپس کرنڑاں
reveal	ظاہر کرو
revealed	ظاہر کیتا
revenge	بدلہ
revenue	آمدن
reverse	پُٹھا چلاونڑاں
review	تبصرہ
review	تبصرہ کرنڑاں
revise	دہراؤ
revision	دہرانڑاں
revolution	انقلاب
reward	انعام
rhythm	روانی
rib	پسلی
rice	اول
rich	امیر
rid	پیچھا چھڑاونڑاں
ride	سواری کرنڑاں
ride	سواری
ridiculous	مذاق اڈارنڑاں
right	سجے
right	درست
right now	بالکل ہونڑیں
rigid	بے لوجھ
ring	مندری
rinse	دھونڑاں
riot	فساد
rip	پھاڑنڑاں
rip	چیرڑاں پھاڑنڑاں
ripe	پکا
rise	اضافہ
rise	مَہنگا ہونڑاں
risk	خطرہ
risk	خطرے وچ سَٹڑاں
rival	رقیب
river	دریا
road	روڈ
roast	بُھنڑاں
robust	بہوں طاقتور
rock	پہاڑ
rod	چھڑی
role	کردار
roll	رڑھکانڑاں
roof	چھت
room	کمرہ
root	چھت
rope	رسی
rotten	گندا
rough	خراب
roughly	خراب
round	دائرہ
route	روٹ
routine	معمول
row	لائن
rub	رَگڑو
rubber	ربڑ
rubbish	گندگی
rude	بدتمیز
rug	قالین
ruin	بربادی
rule	قاعدہ
ruler	حاکم
rules	قوانین
run	نسو
running	دُرکڑاں
rural	دیہاتی
rush	اصل
rush	تیز رفتاری
sack	بوری
sacred	مقدس
sacrifice	قربانی کرنڑاں
safe	محفوظ
safe flight	محفوظ پرواز
safety	حفاطت
sage	سیج
said	آکھیا
sail	سمندری سفر
sailing	دریا دا سفر
sake	دے واسطے
salary	تنخواہ
sale	سیل
salmon	سامن
salt	لونڑ
same	ہک جینجہا
Same here	اتھاں وی اوہی ہے
sample	سادہ
sand	ریت
Sanskrit	سنسکرت
Saraiki	سرائیکی
sarcastic	تعریفی
sassy	بے ادب
sat	ہفتہ
satisfaction	اطمینان
satisfied	مطمئن
satisfy	راضی کرنڑاں
satisfying	اظمینان ڈیونڑ آلا
Saturday	ہفتہ
sausage	ساسیج
savage	جنگلی
save	محفوظ کرو
saw	ڈیکھیا
say	آکھو
scale	فُٹا
scam	دھوکہ ڈیونڑاں
scar	نشان
scarce	کمی دے نال
scared	ڈرنڑاں
scarf	اسکارف
scary	ڈرپوک
scattered	وکھریا ہویا
scene	منظر
scenery	نظارہ
scent	عطر
schedule	نقشہ بناونڑاں
schedule	طریقہ
school	سکول
science	سائنس
scientist	سائنسدان
scientists	سائنسدان
scissors	مقراض
scold	نقص کڈھڑاں
scope	گنجائش
score	اسکور
scrap	ردی
scratch	خراش
scream	چیخڑاں
screen	سکرین
screw	اسکرو
script	تحریر کرنڑاں
sea	سمندر
seal	مہر
search	گولھو
season	موسم
seat	سیٹ
second	ڈوجھا
secret	راز
section	حصہ
secure	محفوظ کرنڑاں
security	ضمانت
see	ڈیکھو
see you	ولا ملسوں
see you later	بعد اچ ملدے ہوں
see you soon	ولا ملسوں
see you tomorrow	کل ملسوں
seed	بیج
seek	گولھڑاں
seem	نظر آونڑاں
seems	لگدا ہے
seen	ڈیکھیا گیا
seize	پابند کرنڑاں
seizure	قبصہ
seldom	کڈھئیں کڈھئیں
select	منتخب کرنڑاں
self	خود
self healing	خود ٹھیک ہونڑاں
selfish	خودغرض
sell	ویچڑاں
send	بھیجو
send me your picture	میکوں آپنڑیں تصویر بھیجو
senior	سینیئر
sense	شعور
sensible	عقلمند
sensitive	حساس
sent	بھیج ڈتا گیا
sentence	جملہ
sentences	جملے
separate	انج
Sepedi	سپیڈی
september	ستمب
sequence	ترتیب
series	سیریز
serious	سنجیدہ
seriously	سنجیدگی نال
serve	پیش کرنڑاں
service	خدمت
session	اجلاس
set	سیٹ
set	لگاونڑاں
set up	ترتیب ڈیونڑاں
setting	سیٹنگ
settle	طے کرنڑاں
seven	سَت
seventeen	سترہاں
seventy	ستر
several	ہک توں ودھ
severe	شدید
sew	سیونڑاں
sh	ایس ایچھ
shade	چھاں
shadow	چھاں
shake	ہلاونڑاں
shall	کرنا
shallow	گھٹ ڈونگا
shame	شرم
shape	شکل
share	ونڈو
sharp	تیز
she	چھوہیر
she has	اوندے کول ہے
she is	یے ہے
shed	سر لکاونڑ دی جاہ
sheep	بھیڈ
sheet	شیٹ
shelf	شیلف
shell	سیپی
shelter	ٹھکانڑاں
shield	ڈھال
shift	شفٹ
shine	چمک
ship	سمندری جہاز
shipping	جہاز اچ مال لوڈ کرنڑاں
shirt	چولا
shoes	جوتے
shoot	گولی مارنڑاں
shop	دکان
shopping	خرید فروخت کنڑاں
shore	سہارا ڈیونڑاں
short	چھوٹا
shortage	کمی
shot	گولی مارنڑاں
shot	گولی
should	لازمی
shoulder	مونڈھا
shout	چیخڑاں
show	نمائش
show	پیش کرنڑاں
show me	میکوں ڈکھاؤ
shower	چھینٹے آونڑاں
shrimp	جھینگا
shrink	سکڑنڑاں
shut	بند کرنڑاں
shut up	بند کرنڑاں
shy	شرمیلا ہونڑاں
sibling	بھینڑ بھرا
siblings	بھینڑ بھرا
sick	بیمار
side	پاسا
sigh	ٹھڈا ساہ گھنڑاں
sight	نظر
sightseeing	سیر تفریح
sign	علامت
signature	دستخط
significant	اہم
silence	خاموشی
silent	خاموش
silk	ریشم
silly	بیوقوف
silver	چاندی
similar	ہکو جینجھا
simp	سادہ
simple	سادہ
simultaneously	اکو وقت اچ
since	اوں ویلے توں
sincere	صادق
sincerely	مخلص
sing	گاونراں
singer	گُلوکار
single	کلہا
sink	گندگی دا کھڈا
sink	ڈوبڑاں
Sir	سر
sister	بھینڑ
sister in law	نینہانڑ
sit	بیہڑاں
site	جگہ
situation	صورتحال
six	چھی
sixteen	سولہاں
sixty	سٹھ
size	ناپ
skill	ہنرمندی
skills	مہارتاں
skin	کھل
skinny	بہوں دُبلا
skip	چھوڑ ڈیو
skirt	اسکرٹ
sky	آسمان
slave	غلامی
sleep	بیندر
sleeping	سُمڑاں
sleepy	سُتا ہویا
sleeve	آستین
slice	ٹکڑا
slice	ٹکڑا کرنڑاں
slide	سلائیڈ
slightly	ہولے نال
slim	سوکھا
slip	تلکڑاں
slope	ترچھی جاہ
slot	سوراخ
slow	ہولا
slowly	ہولے نال
small	نکا
smart	سمارٹ
smell	بو
smile	مُسکراہٹ
smile	مُسکرانڑاں
smoke	دھواں
smooth	صاف
snack	ہلکا ناشتہ
snail	گھونگا
snake	سانپ
snap	حرکت کرنڑاں
snow	برف
so	تاں
so cute	بہوں سوہنڑاں
so far	ہونڑ تائیں
soak	بھگوونڑاں
soap	صابنڑ
sober	سنجیدہ
soccer	ساکر
social	سماجی
society	سوسائٹی
socks	جراباں
soft	پولا
software	سافٹ ویئر
soil	مٹی
sold	وک گیا
sold out	وِک گیا
soldier	سپاہی
sole	جوتے دا تلے آلا حصہ
solid	ٹھوس
solution	حل
solve	حل کرو
some	کجھ
somebody	کوئی بندہ
somehow	کئیں طریقے نال
someone	کوئی ہک
something	کوئی شے
sometimes	کئیں ویلے
song	گانا
soon	جلدی
sophisticated	بناوٹی
Sorani	سورانی
sore	ڈُکھتی جاہ
sore	ڈُکھنڑ آلا
sore throat	گلے اچ ورم
sorrow	غم
Sorry	معذرت
sort	ترتیب ڈیوو
sought	گولھیا
soul	روح
soulmate	سچا جوڑی دار
sound	آواز
soup	سوپ
sour	کھٹا
source	ذریعہ
south	جنوب
space	گنجائش
spam	اسپیم
span	وقفہ
Spanish	اسپینش
spare	فالتو
spare	بچاونڑاں
speak	الاونڑاں
special	خاص
species	مِصالحے
specific	مخصوص
spectacular	ڈیکھنڑ دے قابل
speech	بولنڑاں
speechless	خاموش
speed	رفتار
spell	ہجے
spend	خرچیا
spent	خرچ کیتا
spicy	مصالحے دار
spike	کیل
spin	گھماونڑاں
spinach	پالک
spirit	جذبہ
spit	تُھک
splendid	چنگا
split	تقسیم کرنڑاں
split	تفریق
spoil	وگاڑنڑاں
spoiled	خراب تھی گیا
spontaneous	بغیر ارادہ
spoon	چمچہ
spot	جاہ
spouse	پایا
spread	پھیلا ڈیوو
spring	بہار
square	چورس
squeeze	نچوڑنڑاں
squid	سکویڈ
squirrel	گلہری
st	ایس ٹی
stab	گھسیڑنڑاں
stable	مضبوط
stack	ڈھیر لاونڑاں
staff	عملہ
stage	مرحلہ
stain	دھبہ
stairs	پوڑھیاں
stake	بازی لاونڑاں
stalk	اکڑ کنے ٹرڑاں
stall	اصطبل
stamp	مہر
stand	کھڑا
stand	کھڑا ہونڑاں
standard	معیاری
star	تارہ
start	شروع کرو
started	شروع کیتا
starving	بُکھا مرنڑاں
state	حالت
state	عرض کرنڑاں
statement	بیان
station	اسٹیشن
statue	بُت
status	اسٹیٹس
stay	قیام کرنڑاں
stay	ٹِکڑاں
stay safe	محفوظ رہو
steady	قائم رکھنڑاں
steak	گوشت دا ٹکڑا
steal	چوری کرنڑاں
steam	بھاپ
steel	اسٹیل
steep	ڈھلان
stem	رکاوٹ
step	قدم
stick	کاٹھی
stiff	ضدی
still	خاموشی
still	ہونڑ تائیں
sting	ڈنگ مارنڑاں
stingy	کنجوس
stir	ہلاونڑاں
stock	ذخیرہ
stolen	چوری کیتا ہویا
stomach	ڈھیڈ
stone	پتھر
stood	کھڑا تھیا
stool	اسٹول
stop	روکو
storage	ذخیرہ
store	اسٹور
storm	طوفان
story	کہانی
stove	چولھا
straight	سدھا
straightforward	دیانت دار
strain	چھانڑاں
strange	غیر
stranger	اجنبی
strategy	حکمت عملی
straw	پینپ
strawberry	رس بھری
streak	بہوں تیز اثر
stream	اسٹریم
street	روڈ
strength	طاقت
stress	دباؤ
stretch	چِھکڑاں
strict	سخت گیر
strike	ہڑتال
string	اسٹرنگ
strip	پٹی
strive	کوشش کرنڑاں
stroke	فالچ
strong	مضبوط
struck	ہڑتال کیتی
structure	ڈھانچہ
struggle	کوشش کرنڑاں
struggle	کوشش
struggling	جدوجہد
stubborn	ضدی
stuck	پھسیا ہویا
student	شاگرد
study	مطالعہ کرنڑاں
study	مطالعہ
studying	پڑھنڑاں
stuff	عملہ
stunning	حیرت انگیز
stupid	بیوقوف
style	انداز
subject	مضمون
submission	گزارش
submit	جمع کراؤ
substance	مادہ
substitute	متبادل
subtle	چالاک
succeed	کامیابی حاصل کرنڑاں
success	کامیابی
successful	کامیاب
such	اینجھا
such as	جیویں کہ
suck	چوسڑاں
sudden	اچانک
suddenly	اچانک
suffer	تکلیف چانڑاں
suffering	مصیبت
sufficient	بہوں
sugar	کھنڈ
suggest	تجویز کرو
suggestion	تجویز
suit	جوڑا
suit	سوہنڑاں نظر آونڑاں
suitable	موافق
suitcase	اٹیچی
sum	جمع کرنڑاں
summary	خلاصہ
summer	گرمی
summit	چوٹی
sun	سِج
sunday	اتوار
sunny	روشن
sunset	سِج لہڑاں
sunshine	سِج دی روشنی
super	کمال
superior	اوچے درجے دا
supervisor	منتظم
supper	شام دا کھاونڑاں
supply	سامان
supply	مہیا کرنڑاں
support	مدد کرنڑاں
support	حمایت کرنڑاں
suppose	فرض کرنڑاں
supposed	فرض کیتا
sure	بالکل
surface	سطح
surge	چڑھنڑاں
surgery	سرجری
surname	خاندانی ناں
surprise	حیران کرنڑاں
surprised	حیران تھیا
surrender	دستبردار ہونڑاں
surrounding	ماحول
surveillance	کڑی نگرانی
survey	سروے کرنڑاں
survey	سروے
survive	بچ وینجڑاں
suspect	شک
suspect	شک کرنڑاں
suspended	معطل کیتا گیا
suspicious	مشکوک
sustain	برداشت کرنڑاں
sustainability	مضبوطی
sustainable	برداشت دے قابل
swag	زور نال ڈھاونڑاں
swallow	کھاونڑاں
swap	اک وار وچ
swear	قسم چاونڑاں
sweat	پسینہ
sweater	سویٹر
sweep	بوہاری ڈیونڑاں
sweet	مٹھا
sweet dreams	پیارے خواب
sweet tooth	مٹھائی دا شوق
sweetheart	معشوق
swell	پُھولنڑاں
swelling	سوج ہونڑاں
swim	تیرنڑاں
swimming	تیرنڑاں
swing	پینگھا
swing	پینگھا ڈیونڑاں
switch	سوئچ
switch	سوئچ لگاونڑاں
swollen	اوپھل ہویا
sword	تلوار
symbol	علامت
sympathy	ہمدردی
symptoms	علامتاں
system	نظام
table	میز
tackle	وزنی شیواں چاونڑاں
tag	ٹیگ
tail	دم
take	پکڑو
take away	گھن کے وینجو
take care	دھیان رکھنڑاں
take off	ذمہ واری چاونڑاں
taken	گھنڑاں
talk	تقریر کرنڑاں
talk	الاونڑاں
talkative	زیادہ گالھیں کرنڑ آلا
tall	لمبا
tap	کھٹکاونڑاں
tap	ٹیپ
tape	ٹیپ
target	نشانہ بناونڑاں
target	نشانہ
task	ٹاسک
taste	ذائقہ
taste	چکھڑاں
tasty	مزیدار
taught	پڑھایا
tea	جا
teach	پڑھاونڑاں
teacher	استاذ
team	ٹیم
tear	ہنجو
tears	ہنجو
tease	چھیڑنڑاں
technology	ٹیکنالوجی
teeth	ڈند
tell	آکھو
tell me	میکوں ڈسو
temper	غصہ آونڑاں
temperature	پارہ
temple	کنپٹی
temporary	عارضی
ten	ڈاہ
ten thousand	ڈاہ ہزار
tenant	قنات
tend	ڈیکھ بھال کرنڑاں
tendency	رجحان
tender	ڈیکھ بھال کرنڑ آلا
tense	کھچاؤ
tension	ٹینشن
tent	قنات
tentative	عارضی
term	مقررہ وقت
terms	ماہواری
terrible	ڈراونڑاں
terrific	ٹریفک
territory	علاقہ
test	آزمائش
test	آزمائش دے لائق قرار ڈیونڑاں
text	ٹیکسٹ
than	مقابلے وچ
thank	شکریہ
thank you	تہاڈا شکریہ
Thank you for your patience while we investigate shipment	ساڈے شپنگ دی چھان بین دے دوران تساں دے صبر واسطے شکریہ
thank you so much	تہاڈا بہوں زیادہ شکریہ
thank you very much	تہاڈا بہوں زیادہ شکریہ
thanks	شکریہ
Thanks for using our app	ساڈی ایپ استعمال کرن دا شکریہ
that	اوہ
that is	او ہے
that's good	ایہہ چنگی گالھہ اے
the	دی
theft	چوری
their	اونہاں دا
them	اوہناں
theme	تھیم
themselves	او خود
then	ولا
theory	نظریہ
there	اتھاں
there are	اوتھاں ہے
there is	اوتھاں ہے
therefore	ایں واسطے
these	ایہہ
they	وہ
they are	اوہ ہن
thick	موٹا
thief	چور
thigh	ران
thin	باریک
thing	شے
things	شیواں
think	سوچڑاں
third	تریجھا
thirsty	ترسیا
thirteen	تیرہاں
thirty	تِریہہ
this	ایہہ
this is	ایہہ ہے
thorough	پورا
thoroughly	پوری طرحاں
those	اوہ
though	تاں وی
thought	سوچ
thoughtful	سوچ سمجھ کنے
thoughts	خیالات
thousand	ہزار
thread	دھاگہ
threat	دھمکی ڈیونڑاں
threaten	دھمکی ڈیونڑاں
three	ترے
threshold	تھریشولڈ
thrilled	شوق پیدا کیتا
thrive	خوشحال ہونڑاں
throat	گلا
through	دے ذریعے
throughout	شروع توں اخیر تائیں
throw	سٹ گھتو
thumb	انوٹھا
thunder	گرج چمک
Thursday	خمیس
thus	ایس واسطے
tick	نشان
tide	لہراں اُٹھڑاں
tidy	صاف ستھرا
tie	کم کاج
tie	بدھڑاں
tiger	چیتا
tight	سوڑا
Tigrinya	ٹگرینیا
time	ویلا
timid	ڈرپوک
tiny	نکا
tip	ٹوٹکہ
tips	تجویزاں
tire	تھکڑاں
tired	تھکیا ہویا
tissue	ٹشو
title	عنوان
to	تائیں
to be	ہونڑ آلا
toast	ڈبل روٹی
today	اج
toddler	بانبڑو کریندا بال
toes	پنجے
together	نال رل کے
toilet	لیٹرین
told	آکھیا
tolerance	نرم مزاجی
tolerate	برداشت کرنڑاں
tomato	ٹماٹر
tomorrow	آونڑ والا کل
tongue	زبان
tonight	اج رات
too	بہوں
took	گھنیا
tool	اوزار
tools	اوزار
tooth	ڈند
top	اوتلا
topic	عنوان
torn	پھٹیا ہویا
torture	تکلیف ڈیونڑاں
total	کُل
touch	ہتھ لاونڑاں
tough	مشکل
tour	سفر
toward	اگو
towards	دے پاسے
towel	تولیہ
town	شہر
toxic	زہریلا
trace	پتہ لاونڑاں
track	ٹریک
trade	کاروبار
trade	کاروبار کرنڑاں
tradition	روایت
traditional	روایتی
traffic	ٹریفک
trail	پیچھا کرنڑاں
train	ریل گاڈی
training	تربیت
trait	خصوصیت
traits	خصوصیت
transfer	منتقل کرنراں
transition	بدلنڑاں
translate	ترجمہ کرنڑاں
transparent	شفاف
transport	سواری
transportation	اک جاہ توں ڈوجھی جاہ تے پُجاونڑاں
trap	پھندا
trash	کوڑا
trauma	چوٹ
travel	سفر
tray	ٹرے
treasure	خزانہ
treat	ورتاؤ کرنڑاں
treatment	علاج
tree	درخت
tremendous	بہوں ہی وڈا
trend	رجحان
trial	آزمائش
trick	چال
tried	کوشش کیتی
trigger	ٹریگر دباونڑاں
trigger	ٹریگر
trim	کاٹڑاں
trip	سفر
trouble	تکلیف
trousers	پاجامے
truck	ٹرک
true	سچ
trunk	بکسا
trust	اعتبار کرنڑاں
trust	اعتبار
truth	سچ
try	کوشش کرو
Tsonga	سونگا
tube	نالی
Tuesday	منگل
tuition	ٹیوشن
turkey	ترکی
turmeric	ہَلِدر
turn	موڑو
turtle	کچھوا
tutor	استاد
twelve	بارہاں
twenty	ویہہ
twenty-one	اکویھہ
Twi	دو گنا
twice	ڈو وار
twist	مروڑنڑاں
two	ڈو
type	قسم
typical	مثالی
ugly	بدصورت
ultimate	آخری
umbrella	چھتری
unable	بے بس
uncle	چاچا
unconscious	بے ہوش
under	تھلے
underneath	تلّے
underrated	کم شرح دی
understand	سمجھڑاں
understood	سمجھیا
unfortunately	بدقسمتی نال
uniform	یونیفارم
unique	وکھرا
unit	اکائی
university	یونیورسٹی
unknown	نامعلوم
unless	جیرے ویلے تائیں
until	اوں ویلے تائیں
unusual	غیر معمولی
up	اوتے
up to you	تساں دے اتے ہے
update	نواں کرنڑاں
update	اپ ڈیٹ
upgrade	اعلٰی درجہ
upgrade	اعلٰی درجے اتے آنڑاں
upon	تھلے
upset	پرشان
urban	شہر دا
urge	زور
urge	زور ڈیونڑاں
urgent	ضروری
us	اساں
use	استعمال
use	استعمال کرنڑاں
used	استعمال کیتا ہوا
useful	مفید
useless	بے فائدہ
usual	معمول دے مطابق
usually	عام طور تے
utility	سہولت
vacation	چھٹی
vaccination	ویکسین دا ٹیکا
vaccine	ویکسین
vacuum	خالی جاہ
vague	غیر واضح
valid	معیاد
valley	وادی
valuable	قدر دے قابل
value	قدر
value	قدر کرنڑاں
variety	قسم
various	وکھرے
vary	مختلف ہونڑاں
vase	گلدان
vast	بے شمار
vegetable	سبزی
vegetables	سبزیاں
vehicle	گاڈی
vendor	ویچنڑ آلا
venom	زہر
venture	خطرناک کم
venue	جگہ
verify	تصدیق کرنڑاں
versatile	ہمہ گیر
version	نُسخہ
vertical	سدھا کھڑا
very	بہوں
very good	بہوں چنگا
vessel	رگ
via	ذریعے نال
vibe	وائب
vibes	وائبز
vicious	بد کردار
victim	نشانہ
video	ویڈیو
view	ڈیکھو
village	گراں
villain	بدمعاش
vinegar	سرکہ
vintage	انگور دی فصل
violence	تشدد
violent	شدید
viral	وائرس دا
virgin	کنواری
virtual	اصلی
virtue	نیکی
vision	ڈیکھنڑاں
visit	ملاقاتی
visit	ملاقات واسطے آونڑاں
visual	نظر آونڑ آلا
vital	حیاتی
vivid	شوخ
vocabulary	الفاظ دا ذخیرہ
voice	آواز
void	نکالنا
volume	والیوم
volunteer	رضاکار
vomit	اُلٹی
vomit	اُلٹی کرنڑاں
vulnerable	غیر محفوظ
wage	مزدوری
wages	اجرت
waist	کمر
wait	بھالا گھنو
waiter	بیرا
waiting	بھالا گھدی بیٹھے اوں
wake	جاگدے رہو
wake up	جاگو
walk	پیدل سیر
walk	پیدل سیر کرنڑاں
walking	پیدل سیر کرنڑاں
wall	دیوار
wallet	بٹوہ
wander	آوارہ گردی گرنڑاں
wanna	چاہت
want	چاہندے او
wanted	مطلوب
war	جنگل
wardrobe	الماری
warehouse	گودام
warm	تَتا
warm	تَتا کرنڑاں
warn	ہوشیار کرنڑاں
warning	پاونڑاں
warrior	سپاہی
was	ہا
wash	دھونونڑاں
waste	خرچ کرنڑاں
waste	بربادی
watch	گھڑی
water	پانڑیں
watermelon	تربوز
wave	لہر
way	راہ
we	اساں
we are	اساں ہوں
we can	اساں کر سکدے ہاں
weak	کمزور
weakness	کمزوری
wealth	دولت
wealthy	امیر
wear	پاوو
wearing	پاونڑاں
weather	موسم
wedding	شادی
Wednesday	بدھ
weed	گھاہ
week	کمزور
weekend	ہفتے دا آخر
weight	وزن
weight	وزن کرنڑاں
weird	جادو
welcome	ست بسم اللہ
welfare	خوشحالی
Well	ول
well done	بہوں چنگا
went	وینجو
were	تھے
west	مغرب
wet	س
whale	وہیل
what	کیا
what about you	آپنڑیں بارے وچ ڈسو
what are you doing	تساں کیا کریندے پئے او
what are you doing now	تساں ہونڑے کیا کریندے پئے او
what are you doing right now	تساں ایں ویلے کیا کریندے پیوے
what do you do	تساں کیا کریندے ہو
what do you do for a living	تساں گزارا کرنڑ واسطے کیا کریندے او
what do you mean	تہاڈا کیا مطلب ہے
what do you want	تساں کیا چاہندے ہو
what happened	کیا تھیا اے
what is	کیا ہے
what is this	ایہہ کیا ہے
what is your job	تساں کیا کم کریندے ہو
what is your name	تہاڈا ناں کیا ہے
what's up	کیا تھیندا پیا ہے
what's your name	تہاڈے ناں کیا ہے
whatever	کجھ وی
wheat	کنڑک
wheel	چرخی
when	کڈنڑ
whenever	جڈھنڑ کڈھئیں
where	کتھاں
where are you	تساں کتھاں او
where are you from	تساں کتھو دے او
where are you now	ہن تسی کتھے او
where do you live	تساں کتھاں رہندے ہو
where is	کتھاں ہے
whereas	ایندے باوجود
whether	موسم
which	کیہڑا
while	دوران
whisper	کَن وچ الاونڑاں
whistle	سیٹی
white	چِٹا
who	کون
who are you	تساں کوں ہو
who is	کون ہے
who is this	اتھاں کوں ہے
whole	ثابت
whom	کئیں کوں
whose	کیس دا
why	کیوں
why not	کیوں کائینا
wicked	ماڑا
wide	چوڑائی
widow	باری
width	چوڑا
wife	زال
wild	جنگلی
will	چاہنڑاں
will	مرضی
willing	رضامند
win	جیت
wind	ہوا
window	باری
windy	جتھاں تیز ہوا چلدی پئی ہووے
wine	شراب
winter	سردی
wipe	پوچڑاں
wire	تار
wisdom	عقل
wise	عقلمند
wish	خواہش
wish	خواہش کرنڑاں
wish you all the best	تہاڈے واسطے نیک تمناواں
witch	چڑیل
with	نال
withdraw	واپس گھنڑاں
withdrawal	واپس گھنڑاں
within	دے وچ
without	دے بغیر
witness	شہادت
witness	شہادت ڈیونڑاں
witty	لائق
wolf	لومبڑی
woman	زال
women	عورت
won	جیتیا
won't	نہیں
wonder	معجزہ
wonderful	حیران کرنڑ آلا
wood	لکڑ
wool	اون
word	لفظ
words	الفاظ
work	کم
work	کم کرنڑاں
work out	ورزش
working	کم کرنڑاں
world	دنیا
worm	تتا
worn	پُرانڑاں
worried	پریشان
worry	پریشان
worse	زیادہ خراب
worship	عبادت
worst	برا
worth	مستحق
worth it	ایندے قابل
worthy	حقدار
would	آرزو کرنڑاں
wound	زخم
Wow	واہ
wrap	ولھیٹا
wrath	غصہ
wrist	کلائی
write	لکھو
Write here	اِتھاں لکھو
writing	لکھائی
written	لکھیا ہویا
wrong	غلط
wrote	لکھیا
yard	گز
yawn	اونگھ
yawn	اونگھڑاں
Yeah	ہا
year	سال
years	سال
yeast	خمیر
yell	چیخڑاں
yellow	پیلا
Yes	ہا
yes baby	ہا میری جان
yes dear	ہا پیارے
yes honey	ہا مٹھی
yes my love	میڈے پیار ہاں
yes of course	ہاں بالکل
yesterday	گزریا ہویا کل
yet	ہونڑ تائیں
yield	اجازت ڈیونڑاں
you	تساں
you are	تساں ہو
you are beautiful	تساں خوبصورت ہو
you are so beautiful	تساں بہوں سوہنڑے ہو
you are welcome	تہاکوں ست بسم اللہ
you can	تساں کر سکدے او
You know	تواکوں پتہ ہے
you too	تساں کوں وی
you're welcome	تہانوں سو بسم اللہ
young	جوان
your	تساں دا
your welcome	تساں کوں ست بسم اللہ
yourself	تساں خود
youth	نوجوان
you’re welcome	تہانوں ست بسمہ اللہ
yummy	مزیدار
zero	صفر
