a	ၼိူင်ႈဢၼ်
a little	ဢိတ်ႉဢိတ်ႉ
a lot	ၼမ်တေႉတေႉ
a lot of	ၼမ်လၢႆ
abandon	ၸႂ်ပိဝ်
abandon	ပွၺ်ႈၾႃႈ
abandoned	ပၢႆႊယၢၼ်
abide	ယိူၼ်ႉၵၼ်ႈ
ability	တၢင်းၵတ်ႉ
able	မေႃပဵၼ်
about	လွင်ႈတၢင်း
above	တင်းၼိူဝ်
abroad	မိူင်းၼွၵ်ႈ
absence	ႁၢမ်း
absent	လုတ်ႈႁၢမ်း
absolutely	တိုၼ်းဝႃႈတေႉတေႉ
absorb	ၸုတ်ႉဢဝ်
abstract	ဝူၼ်ႉပဵၼ်ဢဝ်ၵွၺ်း
absurd	ဢမ်ႇၸၢင်ႊပဵၼ်လႆႈ
abundance	မီးလူၼ်ႉ
abundant	ၼမ်လူၼ်ႉပူၼ်ႉ
abuse	ႁဵတ်းလွင်ႈမိူၵ်ႈမႂ်ႈ
abuse	မိူၵ်ႈ
accent	သဵင်လၢတ်ႈ
accept	ႁပ်ႉလႆႈ
access	လွင်ႈသုၼ်ႇလၢတ်ႈ၊ ၵပ်းသိုပ်ႇ
access	ႁွတ်ႈလႆႈ
accident	ဢမ်ႇသၢၵ်ႇထုၵ်ႇ
accommodation	ႁွင်ႈလိုဝ်ႈသဝ်း
accommodation	ၺီႉၵၼ်
accommodation	ပၼ်တီႈယူႇတီႈၼင်ႈ
accomplish	ပႃးၸွမ်းၼႂ်းလိူင်ႈ
accomplished	ယဝ်ႉတူဝ်ႈလီ
according	လူၺ်ႈ
account	ႁဵင်းမၢႆသုၼ်ႇတူဝ်
accuracy	မၢၼ်ႇမႅၼ်ႈလီ
accurate	မၢၼ်ႇမႅၼ်ႈ
accused	တၢင်ႇတၢင်းၽိတ်း
ache	ၵူၼ်ႈၶိုၼ်ႈ
ache	ၸဵပ်း
achieve	ဢွင်ႇမၢၼ်
achievement	လွင်ႈဢွင်ႇမၢင်ႇ
acknowledge	ပိုၼ်ႉႁူႉၼမ်
acquaintance	ႁူႉမိုတ်ႈဝႆႉ
acquire	လႆႈမႃး
acquired	ၵႅင်ႉ
acquisition	ႁႃႁွမ်တွမ်ႊ
across	ၶၢမ်ႈ
act	လဵၼ်ႈၸိူင်း
action	ၼႃႈၵၢၼ်
active	ၵႆႉ
activities	ၵၢၼ်တူင်ႉၼိုင်
activity	လွင်ႈတူင်ႉၼိုင်
actor	ၸၢႆးၸိူင်း
actual	ဢၼ်တေႉတေႉ
actually	တီႈတႄႉတႄႉမၼ်း
acute	ယႂ်ႇလူင်
adapt	ၵဵပ်းလဵင်ႉ
add	လေႃး
addicted	ၸပ်းယႃႈ
addition	သႂ်ႇထႅင်ႈ
additional	ထႅင်ႈ
address	မွၵ်ႇလၢတ်ႈၵႂၢမ်း
address	ႁဵင်းတီႈယူႇ
adequate	ၵုမ်ႇထူၼ်ႈ
adjacent	ၸပ်း
adjective	ၵမ်ႉႁိၵ်ႈ
adjust	မႄးႁႂ်ႈသၢင်ႇတေႃႇ
admire	ၼပ်ႉယမ်
admit	ႁပ်ႉၶၢမ်ႇ
adopt	ၵဵပ်းလဵင်ႉ
adorable	ႁၵ်ႉ
advance	လွင်ႈၶိုၼ်ႈယႂ်ႇ
advance	ၶိုၼ်ႈတၢင်းၼႃႈ
advanced	ၸၼ်ႉသုင်
advantage	ၽွၼ်းလီ
adventure	ႁဵတ်းၸုၼ်ႉ
adverb	ၵမ်ႉသၢၵ်ႈ
advertisement	ပိုၼ်ႊၽၢဝ်ႇ
advertising	ပိုၼ်ႊၽၢဝ်ႇ
advice	ပၼ်တၢင်းႁၼ််ထိုင်
advise	ပၼ်တၢင်းႁၼ်
advocate	တၢင်ႊလၢတ်ႈ
advocate	ၵမ်ႉထႅမ်
aesthetic	ႁၢင်ႊငၢမ်း
affair	လွင်ႈၵၢၼ်
affect	ႁဵတ်းႁႂ်ႈ တုမ်ႉတိူဝ်ႉ
affection	ထိုင်တီႈ
afford	ၸွၺ်ႈထႅမ်
affordable	မီးမိူဝ်ႈႁဵတ်းလႆႈလီ
afraid	ဢၼ်ၵူဝ်
after	ဝၢႆးသေ
afternoon	ဝၢႆးဝၼ်း
afterwards	ပေႃးယဝ်ႉၼႆႉ
again	ထႅင်ႈပွၵ်ႈၼိုင်ႈ
against	သၢၼ်ၶတ်း
age	ဢသၢၵ်ႈ
agency	ၽူႈတၢင်တူဝ်ၶၢႆ
agent	ၽူႈတၢင်တူဝ်
aggressive	ပၢၼ်းၽိတ်း
aggressive	ပူၼ်ႉပႅၼ်
agile	လွင်ႈတူင်ႉၼိုင်ဝႆး
ago	ပူၼ်ႉမႃး
agree	ၽွမ်ႉၸွမ်း
agreement	လိၵ်ႈႁူမ်ႈမၢႆ
agriculture	ၽၢႆႇၽုၵ်ႈသွမ်ႈ
ahead	ဢွၼ်တေး
aid	ၶူဝ်းၵမ်ႉ
aim	ယိူင်းမၢႆ
air	လူမ်း
airport	ၵႂၢင်းႁိူင်းဝိၼ်
aisle	တၢင်းၶုၼ်
alarm	ၾႆးပၼ်ၾၢင်ႉ
alcohol	လဝ်ႈ
alert	တိုၼ်ႇ
alive	ၶီးၸႂ်
all	တင်းမူတ်း
all right	လီတေႉယဝ်ႉ
all the best	ၶႅမ်ႉတင်းမူတ်း
allow	ၽွမ်ႉၸွမ်း
allowed	ၶႂၢင်းပၼ်ႁႂ်ႈႁဵတ်း
almost	ၸမ်တေ
alone	ၵေႃႉလဵဝ်
along	ႁိမ်းႁွမ်း
already	ပေႃးယဝ်ႉယဝ်ႈ
Alright	လႆႈယူႇ
also	ၸိူင်ႉၼၼ်ၵွၺ်း
alternative	ထႅင်ႈတၢင်ႇလၢႆး
although	ပႅၵ်ႉသမ်ႉဝႃႈ
although	သေတႃႉၵေႃႈ
always	ၵႆႉၵႆႉ
am	ပဵၼ်
amazing	လၢၵ်ႇလၢႆးတႄႉယဝ်ႉ
ambiguous	ပဵၼ်ၸႂ်တုၺ်း
ambition	တၢင်းယိူင်းဢၢၼ်း
ambitious	တၢင်းယိူင်းဢၢၼ်း
amend	ပိုၼ်ႊၽၢဝ်ႇၶေႃႈမႄး
amid	ၽေဢွၵ်ႇမႃး
among	ၼႂ်းၵႃႊ
among us	ၼႂ်းႁဝ်းၼႆႉ
amount	တၢင်းၼမ်
amusing	လႆႈၸႂ်
an	ဢၼ်ၼိုင်ႈ
analysis	ၸႅၵ်ႇဝႆႉ
ancestors	ပူႇမွၼ်ႇၼၢႆးယႃႊ
anchor	လဵၵ်းလၢမ်ႊႁိူဝ်း
ancient	ၶူဝ်းၵဝ်ႇၶူဝ်းမွၼ်
and	လႄႈ
and you	သူလူး
angel	ၼၢင်းၽီ
anger	ၸႂ်လမ်
angle	ၸဵင်ႇ
angry	ၸႂ်လမ်
animal	တူဝ်သတ်း
ankle	တႃတိၼ်
anniversary	ၶွပ်ႈၶူပ်ႇ
announcement	ၶေႃႈပိုၼ်ႊၽၢဝ်ႇ
annoy	ၽိတ်းၵၼ်
annoyed	ထဵင်ၵၼ်
annoying	ထဵင်ၵၼ်
annual	ၼႂ်းၵႃႊၼိူင်ႈပီႊ
anonymous	မေႃလိၵ်ႈ ဢၼ်ဢမ်ႇႁူႉၸိုဝ်ႈ
another	တၢင်ႇၸိူဝ်း
answer	ၶေႃႈတွပ်ႇ
answer	တွပ်ႇပၼ်
anticipate	လၢမ်းၶၢတ်ႈ
anxiety	လွင်ႈၶီၸႂ်၊ လွင်ႈမႆႈၸႂ်
anxious	မႆႈၸႂ်
any	သေဢၼ်ဢၼ်
anymore	မီးထႅင်ႈ
anyone	ၽႂ်ၵေႃႈလႆႈ
anything	ၵူႊလွင်ႈ
anyway	ပဵၼ်ႁိုဝ်ၵေႃႈလၢႆး
anyways	ႁဵတ်းႁိုဝ်ၵေႃႈလီ
apart	ၵႃႇၵၼ်
apartment	ႁွင်ႈလိုဝ်ႈ
apologize	ပွၺ်ႇဝၢင်းၶႂၢင်း
apparent	ႁူႉလႆႈလီ
apparently	ႁၼ်ၸႅင်ႈလီ
appeal	တၢင်ႇလိၵ်ႈ
appear	ပေႃႇဢွၵ်ႇမႃး
appearance	ပေႃႇဢွၵ်ႇမႃး
appeared	ပေႃႇဢွၵ်ႇမႃး
appetite	ၸႂ်ၶႂ်ႈၵိၼ်
apple	မၢၵ်ႇၶႃႊၶုင်ႉ
application	တၢင်ႇလဝ်ႈၼႃႈၵၢၼ်
apply	ႁဵတ်းလႆႈ
appointment	တၼ်းႁဵင်း
appointment	ၼႃႈၵၢၼ်
appointment	ၶဵၼ်းၵၼ်
appreciate	ႁူမ်ၸူမ်းၸွမ်း
appreciate	ၸႅင်ႈလီလီ
appreciation	ႁူႉႁၼ်ၸႅင်ႈလီ
approach	ၶဝ်ႈၸမ်
appropriate	ဢၼ်သၢင်ႇတေႃႇ
approval	ၵမ်ႉႁပ်ႉတေႃႇ
approve	ႁပ်ႉႁွင်း
approved	မၵ်ႉမၼ်ႈပၼ်
approximately	တိုၼ်းပဵၼ်ဝႆႉ
april	လိူၼ်သီႇ
arbitrary	ၵႃႉၶၢႆ
architect	လၢႆးမိုဝ်းၵေႃႇၵၢႆႇ
architecture	ႁၢင်ႊၽၢင်ႁူင်းၵေႃႇၵၢႆႇ
archive	တီႈၵႂၢၼ်းမၢႆမီႈ
are	ပဵၼ်
are you	သူႁႃႉ
are you busy	ၸွင်ႇသူမၢင်ႉႁိုဝ်
are you married	သူၵူပ်းၵူႈယဝ်ႉႁႃႉ
are you married or single	သူမီးၼႃႈႁိူၼ်းယဝ်ႉႁႃႉ ဢမ်ႇၼၼ် လွတ်ႈလႅဝ်း
Are you still there?	သူတိုၵ်ႉမီးတီႈၼႆႈယူႇႁႃႉ
are you there	သူမီးၼၼ်ႉႁႃႉ
area	လႅၼ်ႊတီႈ
argue	ထဵင်ၵၼ်
argument	ထဵင်ၵၼ်
arise	ယုၵ်ႉၶိုၼ်ႈ
arm	ၶႅၼ်
army	တပ်ႉသိုၵ်း
around	ႁိမ်းႁွမ်း
arrange	ၶပ်းၶိုင်
arrangement	ၵၢၼ်ၸတ်းပွင်
arrival	ႁွတ်ႈထိုင်
arrive	ထိုင်မႃး
arrived	ႁွတ်ႈထိုင်
arrogant	ၸႂ်ၵႂ်ႊ
arrogant	မၢၼ်ႇယႂ်ႇ
arrow	ပိုၼ်ၵၢင်ႇ
art	ပၢႆးတႅမ်ႈႁၢင်ႊ
article	လိၵ်ႈပိုတ်ႇ
artificial	ပၼ်ႇႁူဝ်
artist	မေႃပၢၼ်းသီ
as	ဢမ်ႇၸႂ်ႈသင်
as long as	ႁိုင်ၵႃႊႁိုင်
as well	ယဝ်ႉၵေႃႈ
as well as	လႄႈတင်း
ash	တဝ်
ashamed	လီဢၢႆ
ask	ထၢမ်
asked	ထၢမ်
asleep	ငဝ်ႈၼွၼ်း
aspect	ႁၢင်ႊၽၢင်
Assamese	ၶိူဝ်းဢႃႇသမ်ႇ
assault	ပႃးတိၼ်ပႃးမိုဝ်း
assembly	ႁူမ်ႈတုမ်
assertive	ဝႃႈတေႉတေႉ
assess	ၶၢတ်ႈလၢမ်း
assessment	ထတ်းတိၼ်
asset	လမ်ႉၵတ်ႉမီးၶၼ်
assets	ၶေႃႈလႆႈၸႂ်
assign	မႅင်ႇၵၢၼ်
assignment	ၵၢၼ်ႁဵၼ်း
assignment	ဢၢပ်ႇပၼ်ပုၼ်ႈၽွၼ်း
assist	ၵမ်ႉၵူ
assistant	ၵူၼ်းၸွၺ်ႈ
associate	ၼိူင်းတူၺ်း
associated	ႁူမ်ႈႁွမ်း
association	ဝူၼ်ႉၸၢပ်ႈ
assume	ႁပ်ႉႁၼ်
assumption	ႁပ်ႉႁၼ်
at	တီႈ
at least	တီႈဢေႇသုတ်း
ate	ၵိၼ်
athlete	လႅၼ်ႈၶႄႉ
attach	သႂ်ႇၸွမ်း
attached	မတ်ႉၸပ်းဝႆႉ
attachment	ၵွင်ႉၵဵဝ်ႇၵၼ်
attack	ၶဝ်ႈတိုၵ်း
attempt	တၢင်းၶတ်းၸႂ်
attempt	ၶတ်းၸႂ်
attend	ၶိုၼ်ႈႁွတ်ႈ
attendance	ၶိုၼ်ႈႁွတ်ႈ
attention	ၶဝ်ႈၸႂ်
attitude	တၢင်းႁပ်ႉႁၼ်
attract	ၸၼ်ၸႂ်
attraction	ၸၼ်ၸႂ်
attractive	ၸၼ်ၸႂ်
attribute	မၢႆတွင်းဢဝ်
audience	ၵူၼ်းပၼ်ႁႅင်း
august	လိူၼ်ပႅတ်ႇ
aunt	ပႃႈ
aunty	ပႃႈ
authentic	ဢၼ်တေႉ
author	ၸၢႆးၸိူင်း
authority	ႁႅင်းပွင်ႊ
autumn	ၶၢဝ်းႁုၼ်ႈ
available	ၸၢင်ႊလႆႈ
average	ပၢၼ်ၵၢင်ဢၼ်ၽတ်ႉၽဵင်ႇ
avoid	ငိူင်ႉဝႄႈ
awake	တူင်ႉတိုၼ်ႇ
award	သူးတွၼ်ႈ
aware	ဢၼ်ႁူႉ
awareness	ၽိုၼ်ႉႁူႉၶိုၼ်း
awareness	ႁူႉပွင်ႇလႆႈလီ
away	ၵႆၵႆ
awesome	ၶႅမ်ႉ
awful	ႁူၵ်းႁၢႆႉ
awkward	ဢၼ်ထုၵ်ႇမႅၼ်ႈၸႂ်
Aymara	ၶိူဝ်းဢႅမ်ႇမြႃႇ
baby	လုၵ်ႈဢွၼ်ႇ
bachelor	ၸုမ်ႈၶူး
back	တၢင်းလင်
back	ပွၵ်ႈၶိုၼ်း
background	ပိုၼ်ႉလင်
bad	ဢၼ်ဢမ်ႇလီ
bag	ထူင်
bait	ယိူဝ်ႇပႃ
bake	တူမ်ႈၾႆး
bakery	ၵူၼ်းႁဵတ်းၶဝ်ႈမုၼ်း
baking soda	ၽွင်သူဝ်ႇတႃႇ
balance	ၵွၼ်းၵိူင်ႇ
ball	မၢၵ်ႇၼင်လွမ်ႊ
Bambara	ၶိူဝ်းပႅမ်ႇပြႃႇ
banana	ၵူၺ်ႈ
band	လိဝ်
bang	တႅၼ်ႇတိုင်ႉတိုင်ႉ
bank	ယေးငိုၼ်း
bar	ႁၢၼ်ႉလဝ်ႈ
barely	ဢိတ်ႉဢီႈ
bargain	သဵတ်ႈငိုၼ်း
bark	သဵၼ်မႃႁွၼ်
bark	မႃႁွၼ်
barley	ဢိတ်းဢီႈ
barrier	လႅၼ်ႊတီႈပၼ်ႁူမ်ႇလူမ်ႈ
base	ပိုၼ်ႉတႂ်ႈ
based	ဢိင်ႈ
basement	ထၢပ်ႈတႂ်ႈလိၼ်
basic	ပိုၼ်ႉထၢၼ်ႈ
basically	ပိုၼ်ႉထၢၼ်ႈလီ
basil	ၽၵ်းလိူၼ်းၵလႃး
bastard	လုၵ်ႈဢၼ်ၵိူတ်ႈမႃး ပႆႇၶဝ်ႈၶႂၢင်ႇတြႃး
batch	ၸုပ်ႈ
bath	ဢၢပ်ႇၼမ်ႉ
bathroom	ႁွင်ႈၼွၼ်း
battery	မၢၵ်ႇထၢတ်ႈ
battle	ပၢင်တိုၵ်း
bay	မႃႁဝ်ႇ
be	ပဵၼ်
be careful	ၾၢင်ႉတူဝ်လီ
beach	ၾင်ႇပၢင်ႇလၢႆႇ
beam	သၢႆလႅင်း
beans	ထူဝ်ႇ
bear	မီ
beard	မွၺ်ၵၢင်း
bearing	လွင်ႈႁဵတ်းသၢင်ႈ
beast	တူဝ်သီႇတိၼ်
beat	ပေႉပၢင်လွင်း
beat	လွင်ႈလူႉသုမ်း
beautiful	ႁၢင်ႊလီ
beauty	ႁၢင်ႊလီ
became	ပဵၼ်မႃး
because	ၵွပ်ႈပိူဝ်ႈဝႃႈ
become	ပဵၼ်မႃး
bed	ၵူႇ
bedroom	ႁွင်ႇ
bee	ၽိုင်ႈ
beef	ၼိူဝ်ႉဝူဝ်း
been	ၽႅဝ်ၸူဝ်ႈ
beer	လဝ်ႈပူၵ်ႇ
before	ဢွၼ်တၢင်းၼႆႉ
began	တႄႇႁဵတ်း
begin	တႄႇ
beginning	ႁူဝ်တႄႇ
behalf	တၢင်တူဝ်
behave	တၢင်းယၢမ်ႈ
behavior	တၢင်းယၢမ်ႈ
behaviour	ၽိင်ႈယၢမ်ႈလီ
behind	တၢင်းလင်
being	ပဵၼ်ယူႇ
belief	ယုမ်ႇ
believe	ယုမ်ႇ
belly	ဢႅင်ႈ
belong	ၶွင်ၶဝ်
beloved	ႁၵ်ႉႁႅင်းၼႃႇ
below	တင်းတႂ်ႈ
belt	သၢႆၵႅတ်
bench	တင်ႇယၢဝ်း
bend	ၵူင်ႇ
beneath	ဢမ်ႇထိူၵ်ႈ
benefit	သၢင်ႈလီ
benefit	ၽွၼ်းလီ
benefits	ၽွၼ်းလီ
beside	ႁိမ်းၶၢင်ႈ
besides	ၵူၺ်းၵႃႊ
best	လီထီႈသုတ်း
best of luck	သုၼ်ႇလီႁႅင်း
best regards	ယွၼ်းသူးပၼ်ယူႇ
better	လီလိူဝ်သေ
between	ၼႂ်းၵႄႈၵၢင်
beverage	လဝ်ႈၶူၼ်း
beyond	ၽၢႆႇပုၼ်ႉ
Bhojpuri	ၶိူဝ်းပူဝ်ႉၽူႇဝႃႇရီႇ
bias	ၸွမ်းပႃႈၸွမ်းၽၢႆႇ
biased	ၸပ်းၽၢၵ်ႇ
bicycle	လႅင်
bid	ၵၢတ်ႇႁိမ်သိုဝ်ႉ
big	ယႂ်ႇ
bike	လူတ်ႉထိပ်ႇ
bill	ငိုၼ်းၸၢႆႇ
bind	မတ်ႉ
bird	ၼူၵ်ႉ
birthday	ဝၼ်းၵိူတ်ႇ
bit	ဢိတ်းၸႅတ်ႉ
bite	ၵၢပ်ႈ
bitter	ၶူမ်
black	သီလမ်
blade	ၶူမ်းၾႃႉ
blame	ႁႃတၢင်းၽိတ်း
blame	လွင်ႈႁႃတၢင်းၽိတ်း
blank	လွၵ်းပဝ်ႇ
blanket	ၽႃႈတၢၼ်း
blast	တႅၵ်ႇ
bleach	ႁဵတ်းႁႂ်ႈၽိူၵ်ႇ
blend	ၶဝ်ႈၶိုင်
bless	ယွၼ်းသူးပၼ်
blessed	ယွၼ်းသူးပၼ်
blind	တႃမွတ်ႇ
bliss	ၸူမ်းသိူဝ်း
block	ဢိုတ်းပႅတ်ႈ
blood	လိူတ်ႈ
bloom	မွၵ်ႇၵီႊ
blow	ပဝ်ႇလူမ်း
blue	သီသွမ်ႇ
blunt	ငိူဝ်ႈ
board	ပႅၼ်ႈ
boat	ႁိူဝ်း
body	တူဝ်ၶိင်း
boil	ၽူတ်း
bold	ၼႃဝႆႉ
bond	လိၵ်ႈၵိၼ်ၵႅၼ်ႇ
bone	လုပ်ႇ
book	မၢႆဝႆႉ
book	ပပ်ႉလိၵ်ႈ
boost	သၢင်ႈႁႂ်ႈမႂ်ႇသုင်
boost	သွၵ်းတိၼ်ယၢဝ်း
booster	ဢၼ်ႁဵတ်းသၢင်ႈ ၶိုၼ်ႈယႂ်ႇ
boot	ၵဵပ်းမူၵ်ႇ
boots	ၵႅပ်းမူၵ်ႇ
border	ၵေႃႉသေႈ
bore	ၶၢၼ်ႉ
bored	ဢၼ်လီၶၢၼ်ႉ
boring	လွင်ႈၶၢၼ်ႉ
born	ၵိူတ်ႇ
borrow	ၸေႇ
boss	ထႅၼ်ႊ
boss	ပေႃႈလဵင်ႉ
both	တင်းသွင်ဢၼ်
bother	ပၼ်ၸႂ်သုၵ်းသၢၵ်ႉ
bottle	တဝ်ႈ
bottom	တီႈတႂ်ႈ
bought	သိုဝ်ႉ
bounce	ၵျွၵ်းဝႅၼ်
bound	ဢွင်
boundaries	လႅၼ်ႊလိၼ်
bow	ၵၢင်ႇ
bowl	ဢၢင်ႇ
box	တိူၵ်ႈ
boy	ဢွၼ်ႇၸၢႆး
boyfriend	ၵေႃႉႁၵ်ႉ
bracelet	ဝႅၼ်
brain	ဢွၵ်းဢေႃ
branch	ၵိင်ႇၶႃႊ
brand	မိၵ်ႈမၢႆ
brave	ႁတ်းႁၢၼ်
breach	ယႃႉၵႂၢမ်းမၼ်ႈ
bread	ၶဝ်ႈမုၼ်း
break	လူႉလႅဝ်
break	လွင်ႈတႅၵ်ႇယၢႆႈ
breakfast	ၶဝ်ႈပၼ်ႈ
breast	ဢူၵ်း
breath	ထူၺ်ႈၸႂ်
breathe	ထူၺ်ႈၸႂ်
breed	လဵင်ႉလူ
brick	မၢၵ်ႇဢုတ်ႇ
bride	ၸဝ်ႈသၢဝ်
bridge	ၶူဝ်
brief	တီႈပွတ်း
bright	ႁိူင်ႈလႅင်း
brilliant	လႅတ်းၽၢႆ
bring	ဢဝ်မႃး
bro	သြႃႇၵေႃႉ
broad	တဵမ်ထူၼ်ႈ
broadcast	ႁူင်းပွၺ်ႇသဵင်
broke	လူႉလႅဝ်
broken	လူႉလႅဝ်
broom	ၸဝ်ႈမၢဝ်ႇ
brother	ၸၢႆး
brother in law	ၼွင်ႉၶူၺ်
brought	တေႃႉမႃး
brown	သီၶွၼ်ႇ
brush	ယူႈ
bucket	ပုင်းၼမ်ႉ
buddy	ၵေႃႉသေႈ
budget	ငိုၼ်းၸႂ်ႉ
bug	မူင်ႈမႅင်း
build	ၵေႃႇသၢင်ႈ
building	ႁူင်းၵေႃႇသၢင်ႈ
built	ၵေႃႇသၢင်ႈ
bulk	ႁူဝ်ၼပ်ႉ
bull	ၵႂၢၺ်း
bully	ပေႉၵိၼ်
bump	တွင်ႈၸူဝ်ႈ
bunch	ပဵၼ်ၶေႃႈ
bundle	ႁဵတ်းပဵၼ်ၸွၵ်းပဵၼ်ၸွၵ်း
burden	ႁၢပ်ႇ
burden	ၶူဝ်းၼၵ်း
buried	ၽင်
burn	ၸုတ်ႇၾႆး
burst	ယူႈ
bury	ၽင်
bus	လူတ်ႉၸၢင်ႈ
bush	တဝ်ႉ
business	ပၢႆးမၢၵ်ႈမီး
bust	ယႃႉလူႉ
busy	မၢင်ႉ
but	ၵူၺ်းၵႃႊ
butter	ၶႆၼိူၺ်း
butterfly	ၵၢပ်ႇဝိူဝ်ႈ
button	ပွတ်းတႂ်ႈ
buy	သိုဝ်ႉ
by	ႁိမ်းၶၢင်ႈ
by the way	ႁေၵေႃႈ
bye	မွၼ်းမွၼ်း
cabbage	ၽၵ်းၵၢတ်ႇပီ
cabinet	ၶွင်ႈထွတ်ႇ
cage	ၶွၵ်ႈၼူၵ်ႉ
cake	ၶဝ်ႈမုၼ်း
calf	ဢေဝူဝ်း
call	သိုပ်ႇၾူၼ်း
call	လွင်ႈႁွင်ႉလၢတ်ႈ
call me	သိုပ်ႇၾူၼ်းၸူးႁဝ်းလႄႈ
called	ႁွင်ႉ
calm	ယဵၼ်ယဵၼ်
came	မႃး
campaign	ပၢင်တိုၵ်း
can	မေႃႁဵတ်း
can't	ဢမ်ႇမေႃ
Cancel	ႁူၼ်ၶိုၼ်း
cancer	တၢင်းပဵၼ်ယင်ႇႁၢၵ်ႈ
capable	လမ်ႉၵတ်ႉလူင်းမိုဝ်း
capable	လူင်ႉလႅၼ်ႇ
capacity	လမ်ႉၵတ်ႉ
capital	ယႂ်ႇ
caption	လိၵ်ႈၼေ
capture	တီႉ
car	လူတ်ႉ
career	ၵူၼ်းႁဵတ်းၵၢၼ် ႁူမ်ႈၵၼ်
careful	တူၺ်းထိုင်
carefully	ၽၢင်ႉလီလီ
careless	ဢမ်ႇမီးတၢင်းၾၢင်ႉ
caring	တူၺ်းထိုင်ဝႆႉ
carpenter	မေႃမိုဝ်း
carpet	ၽႃႈသိူဝ်ႈ
carrot	ႁူဝ်ၽၵ်းပၵ်း
carry	တေႃႉ
carry on	ဢဝ်မႃးလႄႈ
carry out	တေႃႉဢွၵ်ႇ
case	လွင်ႈတၢင်း
cash	ၸၢႆႇၵႃႊ
cast	ထၢင်ႇ
castle	ႁေႃတမ်ႇတိူင်း
casual	ဢမ်ႇထၢင်ႇသေ ပဵၼ်
cat	မႅဝ်
catch	တီႉ
category	ဢမ်ႇဝႆႉလၢမ်
cattle	ဝူဝ်းၵႂၢၺ်း
caught	ၺွပ်း
cause	တွၼ်း
cause	ပေႃႇပဵၼ်မႃး
caution	ၽၢင်ႉ
cautious	မီးၸႂ်ၾၢင်ႉ
cave	ႁူႈထမ်ႈ
cease	ၵိုတ်း
ceiling	ၽႃမုင်း
celebrate	ႁဵတ်းပွၺ်း
cell	တွမ်ႇတွမ်ႊ
center	သုၼ်ၵၢင်
century	ႁူဝ်ပၢၵ်ႇပီႊ
cereal	ၶဝ်ႈမုၼ်းၶွပ်ႈ
ceremony	ပၢင်ပွၺ်း
certain	ဢၼ်တႄႉ
certainly	လပ်းလွင်း
certificate	ၽိုၼ်ယွင်ႈယေႃး
chain	ၸႅင်ႊလဵၵ်း
chair	တင်ႇ
challenge	လွင်ႈၶဵင်ႇတႃႉ
challenge	ၶဵင်ႉတႃႉ
chance	သုၼ်ႇ
change	လႅၵ်ႈလၢႆႈ
chaos	ငဝ်းလၢႆးပႅတ်ႈလၢႆႊ
character	တၢင်းယၢမ်ႈ
characteristics	ၽိင်ႈယၢမ်ႈ
charge	သႂၢင်း
charity	ၸုမ်းၸွၺ်ႈတူင်ႇၵူၼ်း
charming	ၸၼ်ၸႂ်
chart	ၽိုၼ်လွၵ်းႁၢင်ႊ
chase	ၶႅၵ်ႉႁၢင်ႊ
chat	ဢုပ်ႇၶႆႊ
chat	ၶေႃႈဢုပ်ႇၼိူဝ်ၼႅင်ႊ
cheap	ပေႃး
cheat	ပႅတ်းလႅၼ်
cheat	ႁၵ်းလင်
cheating	ႁၵ်းလင်
check	လွင်ႈၵူတ်ႇထတ်း
check	ထတ်းသၢင်ႈတူၺ်း
cheek	ၵႅမ်ႈ
cheer	သူၺ်ႉသူၺ်ႉ
cheerful	ၸူမ်းၸွမ်း
cheers	သူၺ်ႉ
cheese	မၼ်းၼူမ်းၵၢမ်ႈ
chemistry	ပၢႆးပိုတ်ႇထၢတ်ႈ
cherish	ႁၵ်ႉထိုင်ဢူၵ်း
chess	လွၵ်းၵႆႇ
chest	ဢူၵ်း
chew	ယႅမ်ႉ
chicken	ၼိူဝ်ႉၵႆႇ
chief	ၵူၼ်းလူင်
child	လုၵ်ႈဢွၼ်ႇ
childhood	ပၢၼ်လုၵ်ႈဢွၼ်ႇ
children	လုၵ်ႈဢွၼ်ႇ
chill	ၶူပ်ႉလၢင်ႈ
chill	လွင်ႈၸပ်းၵတ်း
chill	လွၵ်ႇပိူၼ်ႈ
chimneys	မူၵ်ႇၵွၼ်းၾႆး
chin	ၵွင်ႈၵၢင်း
chocolate	သေႃႉၵလႅၵ်ႉ
choice	လိူၵ်ႈ
choose	လိူၵ်ႈ
chop	တႅပ်း
chores	ၵၢၼ်ႁိူၼ်းၵၢၼ်ယေး
chubby	ပီးပုၵ်ႉ
church	ၵျွင်းၾႃႉၸဝ်ႈ
cinnamon	မွတ်ႈ
circle	တူင်ႇမူၼ်း
circumstances	သၢႆငၢႆ
citizen	ၵူၼ်းမိူင်း
city	ဝဵင်းလူင်
claim	ႁပ်ႉႁွင်း
claim	သုၼ်ႇဢၼ်ထိူၵ်ႈလႆႈ
clarify	မီးၸႂ်လီ
class	ႁွင်ႈႁဵၼ်း
clay	လိၼ်
clean	ၵဵင်ႈသႂ်
clear	လၢင်ႉ
clerk	တႅမ်ႈလိၵ်ႈ
clever	လႅတ်းသႅဝ်း
client	ၶၢဝ်ႊၾႃႉ
cliff	ႁႃႉႁိုၵ်း
climate	ၶၢဝ်ႊၾႃႉ
climb	ၶိုၼ်ႈ
clingy	ၸပ်း
clock	ဢွမ်မူင်း
close	ဢိုတ်း
closet	တူႈၶူဝ်း
cloth	သိူဝ်ႈၶူဝ်း
clothes	ၶူဝ်းၼုင်ႈ
cloud	မွၵ်ႇၵုမ်ႈ
cloudy	မွၵ်ႇၼႃ
clown	ၵူၼ်းယူဝ်ႉႁုၼ်ႉၼူဝ်
clue	ငိူၼ်ႈငဝ်ႈ
clumsy	ဢမ်ႇႁဵတ်းလီလီ
cluster	တုမ်ၵၼ်
coach	ၶူးသွၼ်လဵၼ်ႈႁႅင်း
coach	ၸီႉၼေလၢႆး
coal	ထၢၼ်ႇႁိၼ်ငိူၵ်ႈ
coast	ၽၢင်ႇပၢင်ႇလၢႆႇ
coat	ပႄႉ
coffee	ၵႃႇၽီႇ
cognitive	ႁူႉလီလီ
coincidence	ၼႄႉသၢင်ႉ
cold	ဢၼ်ၵတ်း
collapse	ၵူၼ်ႇပင်း
collar	ၶေႃးသိူဝ်ႈ
colleague	ၵူၼ်းႁူမ်ႈႁဵတ်းၵၢၼ်
colleagues	ၵူၼ်းႁဵတ်းၵၢၼ်ၸွမ်းၵၼ်
collect	ၸူႉႁွမ်
collection	ၸူႉႁွမ်တွမ်ႊဝႆႉ
college	ႁူင်းမူၺ်း
color	သီ
colorless green ideas slept furiously	ႁၢမ်းသီ၊ သီၶဵဝ်၊ တၢင်းဝူၼ်ႉ၊ ႁၢဝ်ႈႁႅင်း
colour	သီ
column	ၶွၵ်းတၢင်းတင်ႈ
comb	ဝီႁူဝ်
combination	လေႃးၸၢပ်ႈ
combine	ၶဝ်ႈပႃးၸွမ်း
come	မႃး
come here	မႃးတီႈၼႆႈ
come on	မႃးလႄႈ
comfort	ၸႂ်သိူဝ်းသႃႇ
comfortable	ယူႇငၢႆႈလူမ်ၸႂ်
coming	မႃးယဝ်ႉ
coming soon	ၸမ်တေမႃးယဝ်ႉ
command	ပၼ်ၶေႃႈပူင်
comment	တၢင်းႁၼ်
commercial	ၵႃႉၶၢႆ
commission	ငိုၼ်းသူး
commit	ႁဵတ်းတၢင်းၽိတ်း
commitment	ဢဝ်ပုၼ်ႈၽွၼ်း ၶေႃႈႁပ်ႉႁွင်း
committed	ပူၼ်ႉပႅၼ်မၢႆမီႈ
commodity	ၵုၼ်ႇတၢင်းတိုဝ်း
common	ဢၼ်လူဝ်ႇ
communicate	ၵပ်းသိုပ်ႇ
communication	ၵပ်းသိုပ်ႇတိတ်းတေႃႇ
community	မုၵ်ႉၸုမ်း
commute	ၵႂႃႇၵႂႃႇမႃးမႃး တႃႇၵၢၼ်
companion	တႆးၵေႃႉ
company	ႁူင်းၵၢၼ်
compare	တႅၵ်ႈၼိူင်း
comparison	တိူၵ်ႈၼိူင်း
compassion	ဢေးလူ
compassionate	ႁဵတ်းႁႂ်ႈဢီးလူ
compatible	ၵိုင်ႇလႅပ်ႈ
compete	ထႅမ်ႈသႂ်ႇႁႂ်ႈတဵမ်
competent	တၢင်းၵတ်ႉ
competition	ပၢင်ၶႄႇၶဵင်ႇ
competitive	လႆႈၶႄႉတင်းၼမ်
complain	ႁႃလွင်ႈသုၵ်း
complaint	ႁႃလွင်ႈဢူၼ်
complement	ၵုမ်ႇထူၼ်ႈ
complement	သႂ်ႇပၼ်ႁႂ်ႈၵုမ်ႇ
complete	ႁဵတ်းတဵမ်
completely	တဵမ်တဵမ်ထူၼ်ႈထူၼ်ႈ
complex	သုၵ်ႉသၢၵ်ႉ
compliance	ႁဵတ်းၸွမ်းမၢႆမီႈ
complicated	သုၵ်ႉသၢၵ်ႉယၢပ်ႇၸႂ်
compliment	ယွင်ႈယေႃး
comply	ႁဵတ်းၸွမ်း
composition	လိၵ်ႈပိုတ်ႇ
compound	ႁူမ်ႈလေႃး
comprehension	ပွင်ႇၸႂ်
comprehensive	ၵုမ်ႇထူၼ်ႈ
compromise	ႁဵတ်းၶေႃႈလႆႈၸႂ်
compromise	ၶေႃႈလႆႈၸႂ်
compulsory	ဢမ်ႇႁဵတ်းဢမ်ႇလႆႈ
computer	ၶွမ်း
concentrate	ပၵ်ႉၸႂ်
concept	တၢင်းႁပ်ႉႁၼ်
concern	မႆႈၸႂ်
concern	လွင်ႈၵွင်ႉၵၢႆႇ
concerned	ၵပ်းၵၢႆႇ
concert	ပၢင်မူၼ်ႊသိူဝ်း
conclusion	ၵမ်းလိုၼ်း
concrete	သၢႆးပၢၼ်ႇ
concrete	မီးႁၢင်ႊမီးတူဝ်
concrete	လွင်းသၢႆး
condition	လႆႈပိုင်ႈဢိင်
condition	ငဝ်းလၢႆး
conditions	ငဝ်းလၢႆး
conduct	ၸီႉၼေသဵၼ်ႈတၢင်း
conference	ပၢင်ၵုမ်ႊလူင်
confess	ယွၼ်းႁပ်ႉ
confidence	ယုမ်ႇတူဝ်ၵဝ်ႇ
confident	တၢင်းယုမ်ႇယမ်
confirm	ႁပ်ႉႁွင်းတေႉယဝ်ႉ
conflict	တၢင်းႁၼ်ထိုင်ပိူင်ၵၼ်
confused	ၸႂ်သုၵ်း
confusion	ဢမ်ႇလပ်းလွင်း
congrats	ၸူမ်းၸွမ်း
congratulation	ႁူမ်ၸူမ်းၸွမ်း
congratulations	ၸူမ်းၸွမ်းယဝ်ႉ
conjunction	ၵပ်း
connect	ၵပ်းၸူး
conquer	ႁုပ်ႈသိမ်းဢွင်ႇပေႉ
conscious	ၸႂ်ႊႁူႉ
consciousness	မီးၸႂ်ၽၢင်ႉ
consent	ၶေႃႈယွၼ်းၶႂၢင်ႉ
consent	ယွၼ်းၶႂၢင်ႉ
consequences	ၽွၼ်းႁၢႆႉ
conservation	ၶေႃႈဢုပ်ႇၵၼ်
conservative	တူၺ်းထိုင်လုမ်းလႃး
consider	ဝူၼ်ႉလီလီ
considered	ဝူၼ်ႉသွၼ်ႇ
consist	ၶဝ်ႈပႃးဝႆႉ
consistency	ၵိုင်ႇတၢၼ်ႇ
consistent	ဢမ်ႇမီးတၢင်းလႅၵ်ႈလၢႆႊ
constant	ပိူင်တၢႆ
constantly	သိုပ်ႇပဵၼ်ဝႆႉ
constipation	တွင်ႉပိၵ်ႉ
construction	ၽၢႆႇၵေႃႇသၢင်ႈ
consume	ႁၼ်ထိုင်ဝႃႈ
consumption	ႁႂ်ႈၵုမ်ႇထူၼ်ႈ
contact	ႁဵင်းၵပ်းသိုပ်ႇ
contagious	တၢင်းပဵၼ်ၸပ်း
contain	ပႃးဝႆႉ
contains	ပႃးၸွမ်းဝႆႉ
contemporary	ၵၢပ်ႈပၢၼ်လဵဝ်
contempt	သၢင်းၽႅပ်ႉႁႅင်းၼႃႇ
content	လမ်းၼႂ်း
contest	လၢတ်ႈထဵင်
context	ႁူဝ်ၼၢမ်း
continent	လိုမ်ႈလိၼ်
continue	သိုပ်ႇထႅင်ႈ
contract	လိၵ်ႈၵိၼ်ၵႅၼ်
contract	ႁဵတ်းလိၵ်ႈၵိၼ်ၵႅၼ်ႇ
contrast	လိၵ်ႈၵိၼ်ၵႅၼ်ႇ
contrast	ႁဵတ်းလိၵ်ႈၵိၼ်ၵႅၼ်ႇ
contribute	ငိုၼ်းတွင်း
contribution	မူႇပိူင်
control	ထိင်း
controversial	ၵေႃႉမေႃထဵင်
convenience	ၶႅမ်ႉလႅပ်ႈလီ
convenient	ၽိူမ်ႉထႅမ်
conversation	ၶေႃႈဢုပ်ႇဢေႃး
convert	လႅၵ်ႈပိၼ်ႇ
convey	တေႃႉသူင်ႇ
convey	ၵဵပ်းၶေႃႈမုၼ်း
convince	ယုမ်ႇယမ်ယွမ်းႁပ်ႉ
convinced	ယုမ်ႇယမ်ႁပ်ႉၸႂ်ႉ
cook	ႁုင်
cook	ၸဝ်ႈမိုဝ်ႉ
cooking	တူမ်ႈႁုင်
cool	လႅတ်းတေႉ
cooperation	ႁူမ်ႈမိုဝ်း
cope	ၵေႈၶႆႈ ပၼ်ႁႃ
copper	တွင်းလႅင်
core	ၵႅၼ်ႊၵၢင်ႊ
corn	ၶဝ်ႈၾႃႉ
corner	ၸဵင်ႇ
correct	မၢၼ်ႇမႅၼ်ႈ
cost	ၵႃႊၶၼ်
cost	တူၵ်းမႅၼ်
costume	သိူဝ်ႈၶူဝ်းၸၢဝ်ႈ
cottage	ႁိူၼ်းထၢပ်ႈလဵဝ်
cotton	ၵုၺ်
couch	ၶူးသွၼ်လဵၼ်ႈႁႅင်း
cough	မဵၼ်ဢၢႆႊလူတ်ႉ
could	ပဵၼ်လႆႈ
council	ၶွင်ႇသီႇ
count	ဢၢၼ်ႇ
counter	သၢၼ်ၶတ်း
country	ဝၢၼ်ႈမိူင်း
countryside	မၢၼ်ႈၼွၵ်ႈၼႃးပၢင်ႇ
couple	သွင်
couple	ၵူပ်ႉၵူႈ
courage	ႁတ်းႁၢၼ်
course	တင်ႈႁဵၼ်း
court	လုမ်းတြႃး
courtesy	ၽိင်ႈငႄႈ
cousin	ပီႈၼွင်ႉၶႅၼ်ႈတွင်ႉ
cover	ႁူမ်ႇ
cow	ဝူဝ်းမႄႈ
coward	ၶီႈၵူဝ်
cozy	မီးလွင်ႈဢုၼ်ႇၸႂ်
crab	ပူ
crack	ႁွၺ်းတႅၵ်ႇ
crack	တႅၵ်ႇၵႃႇ
craft	ဢေဝူဝ်း
crap	ၶီႈႁူဝ်
crash	လူႉလႅဝ်
crash	တူၵ်းလႅဝ်
craving	တႂ်းမွင်း
crawl	ၵၢၼ်း
crazy	ယွင်ႇ
create	ၶူင်ႊသၢင်ႈ
creative	ၶူင်ႊသၢင်ႈ
credit	ယုမ်ႇယမ်
creep	ပူပ်ႇၵၢၼ်း
creepy	တုမ်ႇၶူၼ်ၼိူဝ်ႉၵီႈ
crew	ၵူၼ်းထၢမ်းၵၢၼ်
crime	လိူင်ႈ
cringe	ဢၼ်ဢၢႆသေလွင်ႈလွင်ႈ
cringe	ႁူၼ်လင်
crisis	ၶၢဝ်းၵိၼ်းႁႅင်း
criteria	ပိူင်တႅၵ်ႈတႃႇ တႅပ်းတတ်း
critical	လမ်ႇလွင်ႈ
criticism	လိၵ်ႈထတ်းသၢင်
crop	မၢၵ်ႇဝၢၵ်ႈ
crop	ပၢတ်ႇၶဝ်ႈ
crops	မၢၵ်ႇဝၢၵ်ႈၶဝ်ႈၼမ်ႉ
cross	ၶတ်း
cross	သၢၼ်ၶတ်း
crow	ၵႃလမ်
crowd	ၵူၼ်းၵိုၼ်း
crowded	ၵူၼ်းၵိုၼ်း
crown	ႁူင်းသႅင်
crucial	လမ်ႇလွင်ႈတႃႇယႃႉပႅတ်ႈ
cruel	မိူၵ်ႈလိူင်း
cruise	ၶၢဝ်းတၢင်းပၢင်ႇလၢႆႇ
crush	ၵေႃႉထုၵ်ႇၸႂ်
crush	ငိုတ်ႈလႅဝ်၊ ယႃႉတႅၵ်ႇ
cry	ႁႆႈ
cucumber	တႅင်ၶႃႇ
cuddle	ၼွၼ်းဢီး
culture	ၽိင်ႈငႄႈ
cunning	လွၵ်းလိင်ႉၼမ်
cup	ၵွၵ်း
cupboard	တူႈသႂ်ႇဝၢၼ်ႇ
curb	လွင်ႈၵၢၼ်ထိင်းသိမ်း
cure	ယႃႈယႃ
cure	ယူတ်းယႃ
curfew	ႁၢမ်ႈဢွၵ်ႇႁိူၼ်း
curiosity	ၸႂ်ၶႂ်ႈႁူႉႁႅင်း
curious	ၸွပ်ႇႁူႉ
curly	ငေႃး
currency	ယူင်ႉငိုၼ်းတွင်း
current	မိူဝ်ႈလဵဝ်
currently	ယၢမ်းမိူဝ်ႈလဵဝ်
curse	ၵိၼ်ႇ
curtain	ၽႃႈၵင်ႈ
cushion	ၵွပ်ႈမွၼ်း
custom	ၽိင်ႈထုင်း
customer	ပီႈၼွင်ႉသိုဝ်ႉၶၢႆ
customs	ၽိင်ထုင်း
cut	ၵိမ်း
cut	ၵႅတ်း
cute	လီႁၵ်ႉ
cycle	ပၼ်ႇၶွပ်ႈ
cycling	ၶီႇလႅင်
dad	ပေႃႈ
daddy	ပေႃႈ
daily	ၵူႊဝၼ်း
dairy	ၵူႊဝၼ်း
dam	ၾၢႆ
damage	ယႃႉလူႉ
damage	လွင်ႈလူႉသုမ်း
damn	သႄႉၼႄး
damp	ယိုၵ်ႉယမ်း
dance	ၵႃႈ
danger	မီးၽေး
dangerous	ၽေးၶဵၼ်
dark	လပ်းသိင်ႇ
darling	ႁၵ်ႉဢိူၺ်း
dash	ၶၢႆႉၵႃႇ
data	ၶေႃႈမုၼ်း
date	ဝၼ်းထီႈ
date	ၶဵၼ်းၵၼ်
daughter	လုၵ်ႈယိင်း
day	ဝၼ်း
dead	တၢႆ
deadline	ၶၢဝ်းမၵ်းၶၢၼ်း
deaf	ႁူလိတ်ႇ
deal	ဢၼ်ၵႃႊယႂ်ႇ
deal	ၸႅၵ်ႇၽၢႆႉ
dear	ႁၵ်ႉဢိူၺ်း
Dear All	မႂ်ႇသုင်တင်းသဵင်ႈ
Dear Customer	ပီႈၼွင်ႉသိုဝ်ႉပၼ်ႁႅင်းၶႃႈ
Dear Parents	မႂ်ႇသုင်ၶႃႈ ပေႃႈမေႈ
Dear Sir	မႂ်ႇသုင်ၶႃႈ သြႃႇ
Dear students	မႂ်ႇသုင် လုၵ်ႈႁဵၼ်းၶဝ်
Dear Team	မႂ်ႇသုင် ၵေႃႉၸုမ်းႁဝ်း
death	တၢင်းတၢႆ
debate	ပၢင်ထဵင်ၵၼ်
debit	ၼီႈ
debris	လွင်ႈလူႉလႅဝ်
debt	ၼီႈ
decade	ႁူဝ်သိပ်းပီႊ
decay	ၸဝ်ႊ
deceased	ယွမ်းလူင်း
deceive	ပႅတ်ႉ
december	လိူၼ်သိပ်းသွင်
decent	ၶႅမ်ႉ
decide	တႅပ်းတတ်း
decided	တႅပ်းတတ်း
decision	တႅပ်းတတ်း
deck	ၽိူၼ်တႅမ်ႈလိၵ်ႈ
decline	လူတ်ႈယွမ်းၵႃႇ
decrease	လူတ်ႈယွမ်း
dedicated	ၽင်သႂ်ႇ
dedication	ၸုၼ်ႉလူႇ
deed	တၢင်းႁဵတ်းသၢင်ႈ
deep	လိုၵ်ႉ
deer	ၵႂၢင်
default	လွတ်ႈႁၢမ်း
defeat	ဢဝ်ပေႉ
defeat	ၸႅတ်ႈထၢမ်
defend	ၵႅတ်ႇၶႄ
define	ပိုတ်ႇတီႈပွင်ႇ
definitely	ပိုတ်ႇတီႈပွင်ႇ
definitely	ၸႅင်ႈလႅင်းလီၼႃႇ
definition	ပိုတ်ႇတီႈပွင်ႇ
degree	ဢမ်ႇၽွမ်ႉၸွမ်း
delay	ၸိူင်ႉထိူင်း
delay	တၢင်းမႂ်ႉ
delayed	ထိူင်းထိူဝ်ႉ
delete	မွတ်ႇပႅတ်ႈ
deliberate	တင်ႈၸႂ်ႁဵတ်း
delicate	ဢူၼ်ႈဢွၼ်ႇ
delicious	ဝၢၼ်ႈမိူင်း
delight	ပဵဝ်ႇသိူဝ်းမူၼ်ႊ
delighted	သိူဝ်းသႃႇ
deliver	ၵူၼ်းသူင်ႇၶူဝ်း
delivered	သူင်ႇၸူး
delivery	တေႃႉသူင်ႇ
demand	ၶေႃႈတုၵ်းယွၼ်း
demand	တုၵ်းယွၼ်း
demanding	တၢင်းလူဝ်ႇ
democracy	တီႇမွၵ်ႉၵရေႇသီႇ
demon	ၽီႁၢႆႉ
demonstrate	ႁဵတ်းၼေၽၢင်ႁၢင်ႊ
denied	ထဵင်
density	တၢင်းလႅၼ်ႈ
dentist	မေႃယႃၶဵဝ်ႈ
deny	ထဵင်
department	ႁွင်ႈလိုဝ်ႈ
departure	ဢွၵ်ႇၵႂႃႇ
depend	ဢိင်ၼိူဝ်
deploy	ၽေႈတပ်ႉဝႆႉ
deposit	တိုၼ်းလၢင်း
deposit	လူင်းတိုၼ်း
depressed	ထိူင်းၵိူင်ႉ
depression	ၸႂ်တူၵ်း
depth	တၢင်းၼိုၵ်း
describe	တႅမ်ႈၼေ
description	ၸႅင်ႈၼႄ
desert	ၵႂႃႇပႅတ်ႈ
deserve	ၵိုင်ႇထိူၵ်ႈ
design	ၸၼ်ဝဵပ်ႇယၢင်ႇ
design	ဝဵပ်ႇယၢင်ႇ
designation	တႅမ်ႈႁၢင်ႊဝဵပ်ႈယၢင်ႇ
desire	ၵၢင်ၸႂ်
desire	မုင်ႈမွင်း
desk	ၽိူၼ်တႅမ်ႈလိၵ်ႈ
despair	ၸႂ်လဵၵ်ႉ
desperate	ႁူၵ်းႁၢႆႉ
despite	ပိၵ်ႉသမ်ႉဝႃႈ
dessert	တၢင်းၵိၼ်ဝၢၼ်
destination	တႃႈၵႂႃႇ
destiny	ၵၢမ်ႇ
destroy	ယႃႉလူႉ
destruction	ယႃႉလႅဝ်
detail	ႁူဝ်ယွၺ်ႊ
details	ႁူဝ်ယွၺ်ႊ
detect	သွၵ်ႈႁၼ်
determination	ၸႂ်ၵႅၼ်ႇၶႅင်
determine	တႅပ်းတတ်း
determined	တႅပ်းတတ်း
devastated	သၢဝ်းလူႉသၢဝ်းလႅဝ်
develop	ႁုၼ်ႈမုၼ်း
developed	မုၼ်းလႅင်း
development	ႁုၼ်ႈမုၼ်း
device	ၸၢၵ်ႈ
devil	ၽီႁၢႆႉ
devoted	မီးသႅတ်ႉၸႃႉ
Dhivehi	ၶိူဝ်းတႄႉႁီႉဝႃႇရီႇ
diabetes	ယဵဝ်ႈဝၢၼ်
diarrhea	ပဵၼ်တွင်ႉ
diary	မၢႆတွင်းၵူႊဝၼ်းဝၼ်း
dictionary	ပပ်ႉပိုတ်ႈတႅတ်ႈ
did	ႁဵတ်း
die	တၢႆ
died	တၢႆ
diet	တႃႇၶဝ်ႈၸွမ်းလၢႆး
difference	ပႅၵ်ႈပိူင်ႈ
different	ဢၼ်ပႅၵ်ႇပိူင်ႈ
difficult	တၢင်းယၢပ်ႇ
dig	ၶုတ်း
dignity	ၵုင်ႇ
diligent	ၸႂ်ဢိုၼ်ႇၶတ်းၸႂ်
dinner	ၶဝ်ႈၶမ်ႈ
dip	ၸမ်ႈ
direct	ၵမ်းသိုဝ်ႈ
direction	တၢင်းတေၵႂႃႇ
director	ၽူႈၼၢမ်းၸိူင်း
dirt	ႁင်ႈ
dirty	ႁင်ႈဝူၺ်ႇ
disable	ဢမ်ႇၶႅင်ႁႅင်း
disabled	တုၵ်ႉၶီႉတႃႉ
disappear	ႁၢႆၵႂႃႇ
disappointed	ၸႂ်လမ်မႃး
disaster	တီႈပဵၼ်လွင်ႈႁၢႆႉ
discard	ပိုၼ်ႉပႅတ်ႈ
discharge	ယွၼ်းဢွၵ်ႇ
discipline	ပၵ်းပိူင်မၢႆမီႈ
discount	ယွမ်းပၼ်
discover	ၶူၼ်ႉႁႃ
discrimination	ၸႅၵ်ႇၽေႁူႉႁၼ်လႆႈ
discuss	ဢုပ်ႇဢေႃး
discussion	ဢုပ်ႇၵုမ်
disease	တၢင်းပဵၼ်
diseases	တၢင်းပဵၼ်
disguise	ဢုပ်ႇ
disgusting	လီၸင်း
dish	ၽၵ်း
dishes	ဢၢင်ႇၽေ
dismiss	ဢမ်ႇလမ်ႇလွင်ႈ
dispatch	သူင်ႇၵူၼ်း
display	ၼေဝႆႉ
disposal	ပၢၵ်ႇပၢႆႊပႅတ်ႈ
dispute	ႁိမ်ၼမ်ႉၵႂၢမ်း
distance	တၢင်းၵႆ
distinct	ပႅၵ်ႇပိူင်
distinguish	ႁူႉႁၼ်လႆႈ
distress	ႁိူဝ်ႉၸႂ်
distribution	ၽေႈၶၢႆ
district	ပိုၼ်ႉၼႃႈတီႈ
disturb	လွင်ႈသုၵ်ႉသၢၵ်ႉ
ditch	ႁွင်ႊၼမ်ႉ
dive	လမ်ႊၼမ်ႉ
diverse	ပႅၵ်ႈပိူင်ၵၼ်
diversity	မဵဝ်းယၢင်ႇ
divide	ၸႅၵ်ႇၽေ
divine	ၾႃႉၸဝ်ႈ
divorce	ပႅတ်ႈ
divorce	မႄႈႁၢင်ႉ
dizzy	မဝ်း
do	ႁဵတ်း
do you	သူႁႃႉ
do you love me	ၸွင်ႇသူႁၵ်ႉႁဝ်း
doctor	မေႃယႃ
document	ၽိုၼ်လိၵ်ႈၽိုၼ်မၢႆ
does	ႁဵတ်းသၢင်ႈ
doesn't	ဢမ်ႇလႆႈႁဵတ်း
dog	မႃ
Dogri	ၶိူဝ်းတွၵ်ႉၵရီႇ
doing	ႁဵတ်းယူႇ
doll	ႁုၼ်ႇႁၢင်ႊ ဢေၵူၼ်း
domain	လႅၼ်ႊပိူင်ႇငမ်း
domestic	ၶူဝ်းၸႂ်ႉၼႂ်းမိူင်း
dominant	ဢဵၼ်ႁႅင်းယႂ်ႇ
don't	ယႃႇႁဵတ်း
Don't worry	ယႃႇမႆႈၸႂ်
donate	လူႇတၢၼ်း
done	ယဝ်ႉတူဝ်ႈလီငၢမ်း
donkey	မႃႉပွၵ်း
dope	ယႃႈတႃးသွင်ႇ
double	သွင်ပုၼ်ႈ
double	ၵူမ်ႈၵွမ်း
doubt	ထၢင်ႇထိူမ်
doubt	လွင်ႈထၢင်ႇထိူမ်
dough	ၶဝ်ႈမုၼ်ႈတူင်ႇ
down	တီႈတႂ်ႈ
download	ၸၼ်လူင်း
draft	ပိူင်လိူင်း
draft	တႅမ်ႈၸၼ်ဝႆႉ ပိူင်လိူင်း
drag	ၶၢႆႉလွၺ်းလွၺ်း
drain	ႁွင်ႊလၢႆႇၼမ်ႉ
drama	ၸိူင်းတၢင်းႁၵ်ႉ
draw	တႅမ်ႈႁၢင်ႊ
drawer	ၶွင်ႈထွတ်ႇ
drawing	တႅမ်ႈႁႃဝႆႉ
dread	ၵူဝ်ႁေ
dream	တၢင်းၾၼ်
dream	ၼွၼ်းၾၼ်
dress	ၶူဝ်းတုၺ်ႇၼၢင်းယိင်း
drill	ႁွၺ်းထႆ
drink	သူတ်း
drink	ၼမ်ႉသူတ်း
drive	ႁေႃႈ
drop	ယွတ်ႇၼမ်ႉ
drop	ယွတ်ႇတူၵ်း
dropped	တူၵ်းၵမ်းယွတ်ႇယွတ်ႇ
drought	ၾႃႉလႅင်ႉ
drunk	သူတ်ႉ
dry	ႁႅင်ႈ
duck	ပဵတ်း
dude	ၵူၼ်း
due	ပၢင်ၽိတ်းၵၼ်
due to	ယွၼ်ႉဝႃႈ
dull	ၶၢၼ်ႉၼႃႇ
dumb	ဢႃႉ
dump	ၵွင်ယုၵ်းယၢပ်း
duration	ဢသၢၵ်ႈ
during	ၽွင်းၶၢဝ်းမိူဝ်ႈ
dust	ၽုၼ်ႇမုၵ်ႉ
duty	ပုၼ်ႈၽွၼ်း
dwell	ယူႇသဝ်း
dying	တၢႆ
each	ဢၼ်လႂ်ဢၼ်ၼၼ်ႉ
each other	ၵူႊၵေႃႉၵေႃႉ
eager	ၸႂ်လမ်မႃး
eagle	ၼူၵ်ႉႁုင်ႉ
ear	ႁူ
earlier	ၸဝ်ႉတိူဝ်း
early	ၸဝ်ႉ
earn	လႆႈငိုၼ်း
ears	ႁူ
earth	လုမ်ႈၾႃႉ
earthquake	ဢိင်ႇသၼ်ႇ
ease	ငၢႆႈငႅမ်ႈ
easily	ငၢႆႈငႅမ်ႈ
east	ၽၢႆႇဝၼ်းဢွၵ်ႇ
easy	ငၢႆႈ
eat	ၵိၼ်
eating	ၵိၼ်
economic	ပၢႆးမၢၵ်ႈမုၼ်း
economy	ပၢႆးမၢၵ်ႈမုၼ်း
edge	ၶၢႆႉလွၺ်းလွၺ်း
edit	မႄးၶပ်း
education	ပၢႆးပၺ်ႇၺႃႇ
effect	တွမ်ႉယွၼ်ႈ
effective	ထိုင်တီႈ
efficiency	ၽွၼ်းလီ ၸူဝ်ႊပွတ်းပွတ်း
efficient	လူင်ႉလႅၼ်ႇ
effort	တၢင်းၶတ်းၸႂ်
egg	ၶႆႇ
eggplant	မၢၵ်ႇၶိူဝ်
ego	မၢၼ်ႇယႂ်ႇ
eight	ပႅတ်ႈ
eighteen	သိပ်းပႅတ်ႇ
eighty	ပႅတ်ႇသိပ်း
either	သေဢၼ်ဢၼ်
elaborate	ၶပ်းၶိုင်ပၼ် သပ်းသေး
elbow	ငွၵ်းသွၵ်ႇ
elder	ၵေႃႉယႂ်ႇ
elderly	ၵူၼ်းထဝ်ႈ
elegant	လဝ်း
element	ၶူဝ်းၶွင်
elephant	ၸၢင်ႉ
eleven	သိပ်းဢဵတ်း
eligible	ၵိုင်ႇထိူၵ်ႈ
eliminate	ပၢႆႇဢွၵ်ႇပႅတ်ႈ
else	ထႅင်ႈ
embarrassed	ႁဵတ်းႁႂ်ႈဢၢႆ
embarrassing	ၽွင်းၶဵဝ်
embrace	ၵွတ်ႇ
emerge	ပေႃႇပဵၼ်မႃး
emergency	ၶၼ်ႊၼႃႉ
emotional	ၸႂ်ၶုၺ်ႉ
empathy	ႁၼ်ထိုင်ၸွမ်းၵၢင်ၸႂ်
emphasis	ပၼ်ပူၺ်
emphasize	ပၼ်ပူၺ်
employee	ၵူၼ်းႁဵတ်းၵၢၼ်
employees	လုၵ်ႈၸၢၵ်ႈ
employer	လုၵ်ႈၸၢင်ႈႁဵတ်းၵၢၼ်
employment	လုၵ်ႈၸၢင်ႈၵူၼ်းႁဵတ်းၵၢၼ်
empty	ပဝ်ႇ
enable	ႁဵတ်းလႆႈ
encounter	ႁူပ်းၺႃး
encourage	ပၼ်ႁႅင်းၵမ်ႉထႅမ်
end	သုတ်းယဝ်ႉ
endangered	ၸမ်တေမူၺ်ႉ
endeavor	ၶတ်းၸႂ်
endurance	ယိူၼ်ႉၵၼ်ႈ
endure	ယိူၼ်ႉၵၼ်ႈ
enemy	ၽူႈၶဵၼ်
energy	ဢဵၼ်ႁႅင်း
engage	မၼ်ႈ
engaged	ၶဝ်ႈထိုင်
engagement	မၼ်ႈၵၼ်
engagement	ပၢင်တိုၵ်း
engagement	ၶဵၼ်းၵၼ်
engine	ၸၢၵ်ႈ
engineer	မေႃပၢႆးၸၢင်ႊ
English	ဢိင်းၵလဵတ်ႈ
enhance	ၶိုၼ်ႈယႂ်ႇ
enjoy	ၸူမ်းၸွမ်း
enormous	ယႂ်ႇၼႃႇ
enough	ၵုမ်ႇထူၼ်ႈ
ensure	ႁႂ်ႈပဵၼ်မႃး
enter	ၶဝ်ႈမႃး
entertainment	လဝ်ႇမူၼ်ႊ
enthusiasm	ၸႂ်ၸိုၼ်ႇ
enthusiastic	ၸႂ်ဢိုၼ်ႇ
entire	တင်းမူတ်း
entitled	သႂ်ႇပၼ်ႁူဝ်ၶေႃႈ
entity	ႁူင်းၵေႃႇၵၢႆႇ
entrance	ၶဝ်ႈၵႂႃႇ
entrepreneur	ၽူႈၶူင်ႊပိုတ်ႇတၢင်း ၼႃႈၵၢၼ်
envelope	ထူင်လိၵ်ႈ
environment	သိုင်ႇဝႅတ်ႉလွမ်ႉ
envy	သီႈၵေႉ
epic	ထုၵ်ႇယုၵ်ႉယွင်ႈ
epidemic	တၢင်းပဵၼ်ၸပ်း
equal	မိူၼ်ၵၼ်
equipment	ၶိူင်ႈၸႂ်ႉ
equity	ၵႃႊၶၼ် ငိုၼ်းတိုၼ်း
equivalent	မိူၼ်ၵၼ်
eraser	ၵွၼ်ႈထူ
error	ပဵၼ်လူႉ
escape	လွတ်ႈ
especially	ပေႃးတေဝႃႈတေႉမႃး
essay	လိၵ်ႈပွင်
essence	လွၼ်ႉမွၼ်း
essential	ဢၼ်လူဝ်ႇ
establish	ယူႇသၢင်ႈသဝ်း
established	ၵေႃႇသၢင်ႈ
estate	ဝၢင်းႁိူၼ်း
estimate	လၢမ်းၶၢတ်ႈ
estimated	ၼပ်ႉယမ်
etc	ၸႃႉၵႂႃႇ
eternal	ဢမ်ႇႁူဝ်ဢမ်ႇႁၢင်
ethics	ၶိူဝ်းၵူၼ်း
evaluate	တႅပ်းတတ်းၵႃႊၶၼ်
evaluation	တႅပ်းတတ်းၵႃႊၶၼ်
even	သေတႃႉ
even though	ႁဵတ်းႁိုဝ်ဝႃႈၵေႃႈ
evening	တၢမ်းၶမ်ႈ
event	လွင်ႈပေႃႇပဵၼ်မႃး
eventually	ၵမ်းလိုၼ်းမႃး
ever	တႃႇသေႇ
every	ၵူႊ
everybody	ၵူႊၵေႃႉ
everyone	ၵူႊၵေႃႉ
everything	ၵူႊလွင်ႈ
evidence	ၶူဝ်းလၵ်းထၢၼ်
evil	မိူၵ်ႈလိူင်း
evolution	ၾိင်ႈပဵၼ်လႅၵ်ႈ
evolve	လႅၵ်ႈလၢႆႊ
Ewe	ၶိူဝ်းဢိဝ်း
ex	ၵေႃႉၵဝ်ႇ
exact	တႅတ်ႈတေႃး
exactly	တီႈတေႉမၼ်း
exam	ပၢင်ထတ်ႈထိၼ်
examine	ၸႅတ်ႈႁႂ်ႈႁူႉ
example	တူဝ်ယၢင်ႇ
exceed	လူၼ်ႉလိူဝ်
excellent	ၶႅမ်ႉတေႉတေႉ
except	ႁပ်ႉၶၢမ်ႇ
exception	လိူဝ်ၼႆႉ
excess	တိူဝ်းတေႉ
excessive	ၼမ်ႉလူၼ်ႉ
exchange	လႅၵ်ႈ
excited	တိုၼ်ႇတဵၼ်ႈ
excitement	ၸႂ်တိုၼ်ႇတဵၼ်ႈ
exciting	ၸႂ်တိုၼ်ႇတဵၼ်ႈ
exclusive	ၸႂ်ႉတႃႇႁင်းၶေႃ
excuse	ၶႅၼ်းတေႃႈ
excuse me	ၵမ်းၵွၼ်ႇၶႃႈ
execute	ပၼ်တၢမ်ႇတၢႆ
execution	ပၼ်တၢမ်ႇတၢႆ
executive	ၵေႃပွင်ၸတ်းၵၢၼ်
exercise	လဵၼ်ႈႁႅင်း
exercise	ၵၼ်ႊၽိုၵ်းလႅၼ်ႇ
exhaust	တိုဝ်းၸႂ်ႉမူတ်းမူတ်း
exhausted	ၸႂ်ႉသဵင်ႈသဵင်ႈ
exhibit	ၶူဝ်းၶွင်ၼေႁၢင်ႊ
exhibition	ႁွင်ႈၼေၶူဝ်း
exist	တိုၵ်ႉလိပ်း
existence	မီးပဵၼ်ဝႆႉ
existing	မီးဝႆႉ
exit	ဢွၵ်ႇ
expand	ၶႂၢၵ်ႈၵႂၢင်ႈ
expect	မုင်ႈမွင်း
expected	မုင်ႈမွင်း
expenses	ၵႃႊၸႂ်ႉၸၢႆႇ
expensive	ၵႃႊယႂ်ႇ
experience	တူဝ်ထူပ်း
experiment	တူဝ်ထူပ်း
expert	ၽူႈလူင်ႉလႅၼ်ႇ
expired	ဢသၢၵ်ႈမူတ်းယဝ်ႉ
explain	သပ်းလႅင်း
explanation	ၶေႃႈသပ်းလႅင်း
exploit	ၸုၼ်ႉ
explore	ၶူၼ်ႉႁႃ
export	တေႃႉသူင်ႇ
expose	ၼေႁႂ်ႈႁၼ်လီ
exposed	ၼေႁႂ်ႈႁၼ်လီ
exposure	ၶူၼ်ႉႁႃၼေ
express	ၸႅင်ႈၼႄ
expression	ၶေႃႈၸႅင်ႈၼေ
extend	ၶႂၢၵ်ႈ
extended	ၶႂၢၵ်ႉ
extension	ၶႂၢၵ်ႈ
extent	တၢင်းၼမ်
external	တႅၵ်ႈ
extinct	မူၺ်ႉယဝ်ႉ
extra	ဢၼ်ပူဝ်ႇ
extract	ႁႅမ်ဢွၵ်ႇ
extraordinary	တိူဝ်းဢၼ်ၽဵၼ်ႈၽဵၼ်ႈၼၼ်ႉ
extreme	ၸပ်းၽၢၵ်ႇႁႅင်း
extremely	ၶိုၵ်ႉၶႅမ်ႉ
eye	မၢၵ်ႇတႃ
eyes	တႃ
fabric	ပွတ်းတွၼ်ႊ ႁူင်းၵေႃႇသၢင်ႈ
fabulous	ဢၢမ်းဢေႃး
face	တေႃႇၼႃႈ
face	ၼႃႈတႃ
facilitate	ႁႂ်ႈယဝ်ႉတူဝ်ႈငၢႆႈ
facilities	ႁဵတ်းႁႂ်ႈယဝ်ႉငၢႆႈ
facility	လႆႈမႃးငၢႆႈ
fact	လိူင်ႈပဵၼ်
factor	လွင်ႈတၢင်း
factory	ႁူင်းၸၢၵ်ႈ
facts	ၶေႃႈမုၼ်း
fade	သီမွင်ၵႃႇ
fail	လူႉသုမ်း
failed	တူၵ်းသုမ်း
failure	ၵၢၼ်ႉသုမ်း
faint	ႁႅင်းလဵၵ်ႉ
fair	ၽဵင်ႇပဵင်း
fairly	ၽဵင်ႇပဵင်း
fairy	ၼၢင်းၽီၼႂ်းဢႃႊပုမ်ႇ
faith	သႅတ်ႈၸႃႇ
faithful	မီးသႅတ်ႉၸႃႇ
fake	ဢၼ်ပွမ်
fall	ၼႃႈၶၢဝ်းၵတ်း
fall	လူမ်ႉ
false	ၽိတ်း
fame	လိုဝ်းလင်ႊ
familiar	မိုတ်ႈၵိုဝ်းဝႆႉ
family	မုင်ႉႁေႃႁိူၼ်း
famine	ဢိုပ်းႁႅင်ႈဢိုပ်းႁဵဝ်ႇ
famous	ၸိုဝ်းလိုဝ်းလင်ႊ
fan	ၵူၼ်းပၼ်ႁႅင်း
fan	ဝႂ်ႊၽတ်းလူမ်း
fancy	တၢင်းဝူၼ်ႉ
fantastic	ၶိုၵ်ႉၶႅမ်ႉ
far	ၵႆ
farewell	သူင်ႇသင်ႇ
farm	ၼႃး
farmer	ၸဝ်ႈၼႃး
fascinating	ၸၼ်ၸႂ်
fashion	ၶူဝ်းၶိုတ်းၵၢပ်ႈ
fast	ၽႂ်း
fat	ပီး
fatal	ထိုင်တၢႆ
fate	ၵၢမ်ႇႁၢႆႉ
father	ပေႃႈ
fatigue	ႁိူဝ်ႉဢူၼ်ႈ
fault	တၢင်းၽိတ်း
favorite	လႆႈၸႂ်ႈသုတ်း
favour	ၸွၺ်ႈထႅမ်
favourite	လႆႈၸႂ်တီႈသုတ်း
fear	ၵူဝ်ႁႄ
feast	ပၢင်ၵိၼ်မူႇ
feather	ၶူၼ်ၵႆႇ
feature	ႁႂ်ႈပႃး ဢၼ်လမ်ႇလွင်ႈ
feature	ႁၢင်ႊၽၢင်
features	လၢၵ်ႇလၢႆး
features	ႁၢင်ႊၽၢင်
february	လိူၼ်သွင်
fed up	လဵင်ႉဝႆႉ
fee	ၵႃႊၸွင်းၸေး
feed	လဵင်ႉ
feedback	ပၼ်တၢင်းႁၼ်ထိုင်
feel	ငိၼ်းထိုင်ၸႂ်
feeling	ၸႂ်ႉၶုၺ်ႉႁူႉ
feet	တိၼ်
fell	လူမ်ႉ
fellow	ၽူႈၶဝ်ႈၸုမ်း
felt	ၶုၺ်ႉ
female	မေႊ
fence	တႃႇႁူဝ်ႉ
fertile	ၽုၼ်ႇမၼ်းလိၼ်လီ
festival	ပၢင်ပွၺ်း
fetch	ၵႂႃႇႁွင်ႉမႃး
fever	ၼၢဝ်ၼူၵ်ႉ
few	ဢိတ်းဢီႈ
fewer	ၵမ်ႉဢေႇ
fiance	ၵေႃႉမၼ်ႈ
fiction	ဝူၼ်ႉပဵၼ်ဢဝ်
field	ၵၢင်ပၢင်ႇ
fierce	မိူၵ်ႈမႂ်ႈ
fifteen	သိပ်းႁႃႈ
fifty	ႁႃႈသိပ်း
fight	မင်ႈ
fight	ၶႄႉသဵင်ႇ
fighting	ၶႄႉၶဵင်ႇ
figure	မိူၼ်ႁၢင်ႊ
figure	ၶႅပ်းႁၢင်ႊ
figure out	သၢင်းလၢင်း
file	ၽိုၼ်ၶေႃႈမုၼ်း
fill	သႂ်ႇ
filled	ထႅမ်သႂ်ႇ
film	ၸိူင်း
filthy	ႁႃႈသိပ်း
finally	ၵမ်းလိုၼ်း
finance	ၵၢၼ်ငိုၼ်း တွင်း
financial	ၵၢၼ်ငိုၼ်းတွင်း
find	ႁႃႁၼ်
find out	သူၵ်ႈႁႃ
fine	ယူႇလီ
finger	ၼိဝ်ႉမိုဝ်း
finish	ယဝ်ႉတူဝ်ႈ
finished	ယဝ်ႉယဝ်ႉ
fire	ၾႆး
firm	ၵႅၼ်ႇၶႅင်
firm	လွင်ႈၵႅၼ်ႇၶႅင်
first	ဢွၼ်တၢင်ႇသုတ်း
first name	ၸိုဝ်ႈႁူဝ်ၼႃႈ
fish	မဵတ်းပႃ
fish	ပႃ
fit	တေႃႉတႄႉ
five	ႁႃႈ
fix	ၺႃးလီလီ
fixed	မႄးႁဵတ်း
flag	ၸွမ်ပိဝ်
flash	ၾႆႈမႅပ်ႈ
flat	လူမ်းၶိုၼ်ႈ
flat	ဢၼ်ၽႅပ်ႉ
flaw	တၢင်းၽိတ်း
flawless	ဢမ်ႇမီးတီႈ ၸုတ်ႈယွမ်း
flee	လႅၼ်ႈ
flesh	သႅၼ်ႈသႂ်
flew	မိၼ်
flex	သၢႆၾႆး
flexible	ၵွတ်းလႆႈ
flight	တၢင်းမိၼ်
flip	ဢဝ်မိုဝ်းတွၵ်ႈ
flirt	လဵၼ်ႈပိူၼ်ႈ
flirting	ၸႂ်တူင်ႉတိုၼ်ႇ
float	ၽူး
flood	ၼမ်ႉထူမ်ႈ
floor	ၸႂ်ႉတႂ်ႈ
flour	ၽွင်ၶဝ်ႈမုၼ်း
flow	ၼမ်ႉလႆ
flow	လႆလူင်း
flower	မွၵ်ႇယႃႈ
flu	ပဵၼ်ဢၢၼ်
fluent	လႅၼ်ႇ
fluently	ႁူမ်ႇငမ်း
fluffy	ၶူၼ်ပူင်းပူင်း
fluid	ပဵၼ်ၼမ်ႉ
fly	မိၼ်
focus	ပၵ်းၸႂ်
focus	သုၼ်ၵၢင်
fog	မွၵ်ႇဢိူမ်ႈ
foggy	မွၵ်ႇဢိူမ်ႈ
fold	တူပ်း
folks	ၸေႃႉလႅမ်
follow	ၸွမ်းလင်
follow up	ၸွမ်းလင်မႃး
following	ၸွမ်းလင်
food	တၢင်းၵိၼ်
fool	ငိူဝ်ႈ
fool	ၵူၼ်းယွင်ႇ
foolish	ယွင်ႇၼႃႇ
foot	တိၼ်
football	မၢၵ်ႇၼင်လွမ်ႊ
for	တွၼ်ႈတႃႇ
For example	တူဝ််ယၢင်ႇ
for instance	ဢၼ်ပဵၼ်မႃး
for you	တႃႇမႂ်း
forbidden	ၶေႃႈႁၢမ်ႈ
force	ဢဵၼ်ႁႅင်း
forecast	လၢမ်းၶၢတ်ႈၶၢဝ်ႊၾႃႉ
forehead	ၼႃႈၽၢၵ်ႇ
foreign	မိူင်းၼွၵ်ႈ
forest	ထိူၼ်ႇ
forever	တေႃႇၸူဝ်ႊ
forget	လိုမ်း
forgive	ယွၼ်းတၢင်းၽိတ်း
forgot	လိုမ်းယဝ်ႉ
fork	ၸေႃႉငႅမ်ႈ
form	ပိူင်ၽၢင်
form	ၽိုၼ်တၢင်ႇလဝ်ႈ
formal	ပိူင်ၽၢင်
former	ယၢမ်ႈပဵၼ်
fortunately	သုၼ်ႇလီ
fortune	သုၼ်ႇ
forty	သီႇသိပ်း
forty-two	သီႇသိပ်းသွင်
forward	သိုပ်ႇတင်းၼႃႈ
foster	လူလွမ်တူၺ်းထိုင်
fought	မင်ႈ
found	သွၵ်ႈႁၼ်
foundation	ငဝ်ႈပိုၼ်ႉ
four	သီႇ
fourteen	သိပ်းသီႇ
fox	မႃလိၼ်
fragile	ၽုၺ်ႈ
frame	ၶွပ်ႇ
framework	လွၵ်းၶွတ်ႇၽွတ်ႈ
fraud	ယွၵ်ႇလႅၼ်
freak	ၵူၼ်းၶလႅၵ်ႉ
free	လၢႆလၢႆ
freedom	လွတ်ႈလႅဝ်း
freeze	လၢင်ႈ
frequency	လၢႆလၢႆၵမ်း
frequent	ပဵၼ်လၢႆလၢႆၵမ်း
frequently	ၵမ်းၵမ်း
fresh	သႅၼ်ႈသႂ်
friday	ဝၼ်းၽတ်း
fridge	တူႈယဵၼ်
friend	ဢူၺ်းၵေႃႉ
friendly	မေႃမိုတ်ႈၵိုဝ်း
friends	ဢူၺ်းၵေေႃႉ
friendship	တႆးၵေႃႉၵၼ်
frightened	တိုၼ်ႇ
frightening	တိုၼ်ႇ
frog	ၶဵတ်ႇ
from	မႃးတီႈ
front	တၢင်းၼႃႈ
frozen	လၢင်ႈၵတ်း
fruit	မၢၵ်ႇမႆႉ
frustrated	ႁဵတ်းႁႂ်ႈလႅဝ်
fuel	ၼမ်ႉမၼ်းယိူဝ်ႇ
Fulfulde	ၶိူဝ်းၽူႇၽူႇတႄႇ
full	တဵမ်
fun	ႁုၼ်ႉၼူဝ်
function	ပုၼ်ႈၽွၼ်း
fundamental	ပိုၼ်ႉထၢၼ်ႈ
funeral	မႃႇသႃႇ
funny	ႁုၼ်ႉၼူဝ်
fur	ၶူၼ်
furious	ႁႅင်းႁႅင်း
furniture	ၶူဝ်းႁိူၼ်းယေး
further	ၵႆတိူဝ်း
furthermore	ထႅင်ႈတၢင်းၼိူင်ႈ
future	ၶၢဝ်းၼႃႈ
gain	ၼမ်ႉတွၼ်း
gain	မႅတ်ႈ
game	တၢင်းလဵၼ်ႈ
gap	ၵႃႇၵၼ်
garage	သိုင်ႇလူတ်ႉ
garbage	ယုၵ်ႉယၢၵ်ႉ
garden	သူၼ်မွၵ်ႇႁိူၼ်း
garlic	ၽၵ်းလူဝ်
gate	ၽၵ်းတူဝၢင်း
gather	ႁူမ်ႈၵၼ်
gathering	ၸူႉတုမ်ၵၼ်
gauge	တီႈတၢင်းတႅၵ်ႈ
gave	ပၼ်
gear	ၵီႇယႃႇ
gender	ၽွၵ်ႇ
general	ၽဵၼ်ႈၽဵၼ်ႈ
generally	ပေႃးဢဝ်ၽဵၼ်ႈဝႃႈ
generate	ပေႃႇပဵၼ်မႃး
generation	သႅၼ်းႁုၼ်ႈမႂ်ႇ
generous	ၸႂ်လီ
genius	ၺၢၼ်ႇလီ
genre	မဵဝ်းသႅၼ်းပၢႆးမွၼ်း
gentle	ၽွၵ်ႇ
genuine	ၸၼ်ႉသုင်
gesture	ၼေတိၼ်ၼေမိုဝ်း
get	လႆႈ
get dressed	လၢႆႊၶူဝ်း
get up	ၼွၼ်းလုၵ်ႉ
get well soon	တေလီမႃးယူႇ
getting	လႆႈမႃး
ghost	ၽီၽဵတ်ႇ
ghosting	ၽီမိၵ်ႉသႃႇ
giant	လူင်
gift	ၶူဝ်းတွၼ်ႈ
ginger	ၶိင်
girl	ယိင်းဢွၼ်ႇ
girlfriend	ၸူႉ
give	ပၼ်
give up	ယွမ်းသုမ်း
given	ပၼ်ဝႆႉ
glad	ႁူမ်ၸူမ်း
glance	ၵိုင်ႉၵၢင်ႉတူၺ်း
glass	ၵွၵ်းၵႅဝ်ႈ
glasses	ၵႅဝ်ႈတႃ
glimpse	ႁၼ်ၸငူႉၵဝၢႆႉ
global	တင်းလူၵ်ႈ
gloomy	လပ်းသိင်ႇ
gloves	ဝႃႇမိုဝ်း
glow	ၶဝ်ႈၸႂ်
glow	ႁိူဝ်ႈဢွၵ်ႇမႃး
glow up	ၵေႃႉယႂ်ႇ
glue	မုၵ်ၸပ်း
go	ၵႂႃႇ
go ahead	ၵႂႃႇႁူဝ်တေး
go away	ၵႂႃႇၵႆၵႆ
go to bed	ၵႂႃႇၼွၼ်း
goal	တႃႈယိူင်း
goals	ပဝ်ႉမၢႆ
goat	ပႄႉ
god	ၾႃႉၸဝ်ႈ
god bless you	ၾႃႉၸဝ်ႈယွၼ်းသူးပၼ်သူ
goes	ၵႂႃႇ
going	ၵႂႃႇယူႇ
going to	တေၵႂႃႇႁဵတ်း
gold	ၶမ်း
gone	ၵႂႃႇယဝ်ႉ
gonna	တေႁဵတ်း
goo	ႁဵတ်းၼႃႈဢီးလူ
good	လီဢိူဝ်ႈ
good afternoon	မႂ်ႇသုင် ဝၢႆးဝၼ်း
good bye	မွၼ်းမွၼ်း
good day	ဝၼ်းလီ
good evening	မႂ်ႇသုင်တၢမ်းၶမ်ႈ
good job	ႁဵတ်းလႆႈလီတေႉ
good looking	ႁၢင်ႊလဝ်း
good luck	သုၼ်ႇလီ
good morning	မႂ်ႇသုင်ၵၢင်ၼႂ်
good morning my love	မႂ်ႇသုင်ၵၢင်ၼႂ် ၵေႃႉႁၵ်ႉ
good night	မွၼ်းမွၼ်း ၼွၼ်းလပ်းဝၢၼ်ဝၢၼ်ၶႃႈ
goodbye	မွၼ်းမွၼ်း
goodnight	ၾၼ်လီ
goods	ၵုၼ်ႇ
Google	ၵူးၵႄး
Google Translate	ၵူးၵႄး ပိၼ်ႇၾၢၼ်ၵႂၢမ်းလၢတ်ႈ
goose	ႁၢၼ်ႇ
gorgeous	လဝ်း
gossip	ၵႂၢမ်းမဝ်ၽၢင်း
got	လႆႈ
got it	လႆႈယဝ်ႉ
government	လူင်ပွင်ႊၸိုင်ႈ
grab	ၸၵ်ႉဢဝ်
grade	ၸၼ်ႉႁဵၼ်း
gradually	လွၺ်းလွၺ်းမႃး
graduate	လႆႈၶူး
grain	မဵတ်ႉသၢၼ်
grant	ပၼ်ၶႂၢင်ႉ
granted	ပၼ်ၶႂၢင်ႉ
grapes	မၢၵ်ႇဢိတ်ႇ
grasp	ဝၵ်ႉဝႆႉ
grass	ယိူဝ်ႈယႃႈ
grateful	ၸူမ်းထိုင်
gratitude	ၶွပ်ႈၸႂ်
grave	လိုၵ်ႉလမ်ႇ
gray	သီမူၼ်ႇ
great	ၶိုၵ်ႉၶႅမ်ႉ
greed	လမ်ႇမၢၵ်ႈ
greedy	ၸႂ်လမ်ႇမၢၵ်ႈ
green	သီၶဵဝ်
greet	သိုပ်ႇမိုတ်ႈ
greeting	သိုပ်ႇမိုတ်ႈ
greetings	သိုပ်ႇမိုတ်ႈ
grey	သီမူၼ်ႇ
grid	ၶႅင်းၸီႇ
grief	တၢင်းမႆႈၸႂ်
grind	ၵၢပ်ႈ
grip	ဝၵ်းဝႆႉဝိုၼ်းဝိုၼ်း
grocery	ၽၵ်းၶဵဝ်
groom	ၸဝ်ႈမၢဝ်ႇ
gross	ႁၢဝ်ႈ
ground	လိၼ်
group	ၸုမ်း
grow	ႁုၼ်ႈယႂ်ႇမႃး
growth	ႁုၼ်ႈယႂ်ႇ
grumpy	ဝႆႉၼႃႈဢမ်ႇလီ
Guarani	ၶိူဝ်းၵႂႃႇရႅၼ်ႇၼီႇ
guarantee	ၶေႃႈႁပ်ႉပဝ်ႊ
guard	ၽူႈၵႅမ်တူဝ်
guess	လၢမ်းဢဝ်
guest	ၶႅၵ်ႇ
guidance	ၼေတၢင်း
guide	ၵူၼ်းၼေတၢင်း
guide	ၼေပၼ်တၢင်း
guilty	ဢမ်ႇလုင်ႇတူဝ်
guy	ၼေသူ
guys	ၵူၼ်းႁဝ်း
gym	လဵၼ်ႈႁႅင်း
habit	တၢင်းယၢမ်ႈ
habitat	ၽိင်ႈယၢမ်ႈ
had	မီး
hail	မၢၵ်ႇႁဵပ်း
hair	ၶူၼ်ႁူဝ်
half	ၼိူင်ႈၶိုင်ႈ
hall	ႁေႃ
hand	မိုဝ်း
handle	မိုဝ်းယိပ်း
handsome	ႁၢင်ႈလဝ်း
hang	ၽႅၼ်ဝႆႉ
hang out	ဢဝ်ဢွၵ်ႇပႅတ်ႈ
happen	ပဵၼ်မႃး
happened	ပဵၼ်မႃး
happiness	တၢင်းသိူဝ်းၸႂ်
happy	ဢၼ်မူၼ်ႈသိူဝ်း
happy birthday	သူင်သိူဝ်းဝၼ်းၵိူတ်ႇၶႃႈ
happy birthday to you	မႂ်ႇသုင်ဝၼ်းၵိူတ်ႇ
happy new year	သူင်သိူဝ်းပီႊမႂ်ႇ
hard	ဢၼ်ယၢပ်ႇ
hardly	ယၢပ်ႇယၢပ်ႇ
hardly ever	ယၢပ်ႇတႃႇသေႇ
harm	သၢင်ႊၸူဝ်ႈ
harm	တၢင်းသၢင်ႊ
harmful	တိူဝ်ႉၸဵပ်း
harmony	လၢတ်ႈၸွမ်းသဵင်
harsh	ၵျၢမ်း
harvest	သိမ်းမၢၵ်ႇၶဝ်ႈတဝ်ႈၼမ်ႉ
has	မီး
hate	ၸင်း
have	မီး
have a good day	ၵၢမ်ႇလီၼႃ
have a nice day	ႁႂ်ႈပဵၼ်ဝၼ်းလိ
have breakfast	ၵိၼ်ၶဝ်ႈပၼ်ႈ
have fun	သိူဝ်းၸႂ်
have you eaten	သူၵိၼ်ယဝ်ႉႁႃႉ
having	မီးဝႆႉ
hazard	ႁတ်းၸုၼ်ႉ
haze	မဵတ်ႉၼၢႆး
he	မၼ်းၸၢႆး
he has	မၼ်းမီး
he is	မၼ်းပဵၼ်
head	ႁူဝ်
headache	ႁူဝ်ၶႆႈ
heal	ယႃ
healing	ယူတ်းယႃ
health	ယူႇလီ
healthy	ယူႇလီ
hear	ငိၼ်း
heard	လႆႈငိၼ်း
heart	ႁူဝ်ၸႂ်
heat	ပၼ်ၾႆး
heat	မႆႈ
heaven	မိူင်းၽီ
heavy	ၼၵ်း
hectic	ၸပ်းၼၢဝ်
height	တၢင်းသုင်
heir	ၵေႃႉပုတ်ႈၶူဝ်းပုတ်ႈ
heist	ၸူၼ်
held	ယိပ်းဝႆႉ
hell	ငရၢႆး
Hello	မႂ်ႇသုင်ၶႃႈ
hello dear	မႂ်ႇသုင် ၵေႃႉႁၵ်ႉ
hello how are you	မႂ်ႇသုင်။ ယူႇလီယူႇႁႃႉ။
hello how are you doing	မႂ်ႇသုင် ၸွင်ႇသူယူႇလီ
helmet	မၢၵ်ႇႁူဝ်ၵႅၼ်ႇ
help	ၸွၺ်ႈထႅမ်
helpful	ၶဝ်ႈတၢင်းၸွၺ်ႈထႅမ်
hence	တႄႇၼႆႉၵႂႃႇ
her	ၶူဝ်းမၼ်းၼၢင်း
herd	ၽုင်ဝူဝ်းၵႂၢၺ်း
here	တီႈၼႆႈ
heritage	ၶူဝ်းပုတ်ႈ
hesitate	တူၼ်ႉႁူၼ်
Hey	ႁိူၺ်ႉ
Hi	မႂ်ႇသုင်
hi how are you	မႂ်ႇသုင် ယူႇလီယူႇႁႃႉ
Hi there	မႂ်ႇသုင်
hidden	သိူင်ႇ
hide	သိူင်ႇသိမ်း
hierarchy	ၶပ်ႉလဵၵ်ႉတေႃႇယႂ်ႇ
high	ဢၼ်သုင်
highlight	ပၼ်ႁွၺ်း
hike	ၶိုၼ်ႈလွၺ်
hiking	ၶိုၼ်ႈလွၺ်
hilarious	လီၶႂ်ႈၶူဝ်
hill	ၵုင်းလွၺ်
him	မၼ်း
hint	ၼေငိူၼ်ႈ
hip	ၵူၼ်ႈ
hips	ၵူၼ်ႈ
hire	ၸၢင်ႈ
hiring	ႁပ်ႉႁဵတ်းၵၢၼ်
his	ၶွင်မၼ်း
history	ပိုၼ်း
history	ပၢႆးလႅင်ႊပိုၼ်း
hit	တွၺ်ႇ
Hmm	ဢိုမ်း
hobby	တၢင်းသူင်
hold	ယိပ်းဝႆႉ
hold on	ၵမ်ဝႆႉ
hole	ႁူး
holiday	ဝၼ်းလိုဝ်ႈ
hollow	ႁူႉလူမ်ႇ
home	ႁိူၼ်း
homework	လိၵ်ႈၵၢၼ်ႁိူၼ်း
honest	သိုဝ်ႈယူဝ်း
honestly	ဝႃႈသိုဝ်ႈသိုဝ်ႈ
Honey	ႁၵ်ႉဢိူၺ်း
honor	ၽုင်း
hood	မုင်း
hook	မဵတ်း
hop	ယွပ်ႇ
hope	မုင်ႈမွင်း
hopefully	မီးတၢင်းမုင်ႈမွင်း
hopeless	ႁၢမ်းတၢင်းမုင်ႈမွင်း
horizontal	သိုဝ်ႈသိုဝ်ႈ
horn	ၶဝ်
horrible	ႁၢၵ်းႁၢႆႉၼႃႇ
horror	ၼႃႈလီၵူဝ်
horse	မႃႉ
hospital	ႁူင်းယႃ
hospitality	ႁပ်ႉၶႅၵ်ႇလႆႈလီ
host	ၽူႈၵႂၼ်းထိင်း
host	ၵႂၢၼ်းထိင်း
hostile	ပၢၼ်းၽိတ်း
hot	ဢၼ်မႆႈ
hotel	ႁူင်းႁႅမ်း
hour	ၸူဝ်ႊမူင်း
hours	ၸူဝ်ႊမူင်း
house	ႁိူၼ်း
household	ၵၢၼ်ႁိူၼ်း
how	ၸိူင်ႉႁိုဝ်
how about you	သူလူး
how are you	ယူႇလီယူႇႁႃႉ
how are you doing	ၸွင်ႇယူႇလီ
how are you doing today	မိူဝ်ႈၼႆႉမိူၼ်ၸိူင်ႉႁိုဝ်ဝႆႉ ယူႇလီယူႁႃႉ
how are you today	မိူဝ်ႈၼႆႉ ပဵၼ်ႁိုဝ်
how do you do	သူယူႇလီယူႇႁႃႉ
how is	ပဵၼ်ႁိုဝ်
how many	မီးၵႃႊႁိုဝ်
how much	ၵႃႊႁိုဝ်
how often	ၵႆႉၵႆႉပဵၼ်ႁိုဝ်
how old are you	ဢသၢၵ်ႈသူလႆႈၵႃႈႁိုဝ်
how was your day	သူပဵၼ်ႁိုဝ်ဝႆႉ
how was your night	ၶမ်ႈၼႆႉ ပဵၼ်ႁိုဝ်ၽွင်ႈ
however	ၸိူင်ႉႁိုဝ်ၵေႃႈယဝ်ႉ
hub	ငဝ်းလၢႆးလီ
hubby	ၽူဝ်
hug	လွင်ႈၵွတ်ႇ
hug	ၵွတ်ႇ
huge	ယႂ်ႇၵႂၢင်ႈ
human	ၵူၼ်း
humble	ယွမ်းတူဝ်
humid	ယမ်း
humidity	ယိုၵ်းယမ်း
hundred	ၼိူင်ႈပၢၵ်ႇ
hungry	တွင်ႉမႆႈ
hunt	သုမ်ႉ
hurricane	လူမ်းလႅင်ႉ ႁႃႇရီႇၵဵင်း
hurry	ဝႆး
hurry up	ဝႆးဝႆးလႄႈ
hurt	ၸဵပ်းၸႂ်
husband	ၽူဝ်
hustle	မႄႈမွၵ်ႇယႃႈ
hustle	လိုပ်ႈဢွၵ်ႇ
hut	သုမ်ႉ
hygiene	ၵဵင်ႈသႂ်တူဝ်ၶိင်း
I	ၵဝ်
I am	ႁဝ်းပဵၼ်
I am fine	ႁဝ်းယူႇလီယူႇ
I can	ႁဝ်းမေႃ
I can't	ၵဝ်ဢမ်ႇမေႃ
I do	ၵဝ်ဢိူဝ်ႈ
I do not know	ၵဝ်ဢမ်ႇႁူႉ
I do not understand	ၵဝ်ဢမ်ႇပွင်ႇၸႂ်
I don't	ႁဝ်းဢမ်ႇလႆႈႁဵတ်း
I don't know	ႁဝ်းဢမ်ႇႁူႉ
I don't understand	ႁဝ်းဢမ်ႇပွင်ႇၸႂ်
I don't understand what you mean	ႁဝ်းဢမ်ႇပွင်ႇၸႂ် သူၶႂ်ႈမၢႆထိုင်သင်
I don't understand you	ႁဝ်းဢမ်ႇပွင်ႇၸႂ်သူ
I don’t know	ၵဝ်ဢမ်ႇႁူႉ
I don’t understand	ႁဝ်းဢမ်ႇပွင်ႇၸႂ်
i guess	ၵဝ်လၢမ်းတူၺ်း
I had	ၵဝ်မီး
I have	ႁဝ်းမီး
I have been	ႁဝ်းလႆႈပဵၼ်
I hope so	ႁဝ်းၵေႃႈဝႃႈၼၼ်
I know	ႁဝ်းႁူႉဢိူဝ်ႈ
I like	ႁဝ်းလႆႈၸႂ်
I like you	ႁဝ်းလႆႈၸႂ်သူ
I love	ႁဝ်းႁၵ်ႉ
I love my big brother	ႁဝ်းႁၵ်ႉ ၸၢႆးႁဝ်း
I love my big sister	ႁဝ်းႁၵ်ႉပီႈသၢဝ်ႁဝ်း
I love my father	ႁဝ်းႁၵ်ႉပေႃႈႁဝ်း
I love my little brother	ႁဝ်းႁၵ်ႉၼွင်ႉၸၢႆးႁဝ်း
I love my little sister	ႁဝ်းႁၵ်ႉၼွင်ႉယိင်းႁဝ်း
I love my mother	ႁဝ်းႁၵ်ႉမႄႈႁဝ်း
I love you	ႁဝ်းႁၵ်ႉသူ
I love you so much	ႁဝ်းႁၵ်ႉသူ တေႉတေႉ
I love you too	ႁဝ်းၵေႃႈ ႁၵ်ႉသူ
I mean	ၵဝ်ၶႂ်ႈဝႃႈၼႆႉ
I miss you	ႁဝ်းၸႂ်ထိုင်သူ
I miss you so much	ႁဝ်းၸႂ်ထိုင်သူတေႉယဝ်ႉ
I see	ႁဝ်းပွင်ႇၸႂ်ယဝ်ႉ
I think	ၵဝ်ဝူၼ်ႉဝႃႈ
I understand	ႁဝ်းႁူႉပွင်ႇ
I want	ၵဝ်ၶႂ်ႈလႆႈ
I want to see you	ႁဝ်းၶႂ်ႈထူပ်းသူ
I want you	ႁဝ်းၶႂ်ႈလႆႈ
I was	ႁဝ်းပဵၼ်မႃး
I will	ႁဝ်းတေ
I would be	ႁဝ်းၶႂ်ႈပဵၼ်
I'm	ႁဝ်းပဵၼ်
I'm fine	ႁဝ်းယူႇလီယူႇ
I'm good	ႁဝ်းယူႇလီယူႇ
I'm here	ႁဝ်းမီးၼႆႈ
I'm sorry	ၶႂၢင်းပၼ်ႁဝ်းသေၵမ်း
ice	ၼမ်ႉၶႅင်
ice cream	ၼမ်ႉမူၺ်
idea	တၢင်းဝူၼ်ႉ
ideal	တၢင်းဝူၼ်ႉ
identical	ဢမ်ႇၸႂ်ႈတၢင်ႇဢၼ်
identify	မၵ်းမၼ်ႈ
identity	ၼေလၵ်းထၢၼ်
idiot	ၵူၼ်းၵႅၵ်း
idle	ဢမ်ႇလႆႈလွင်ႈ
if	သင်ဝႃႈ
ignore	ပိုၼ်ႉပႅတ်ႈ
ill	ၼၢဝ်
illegal	သၢၼ်ၶတ်းလၵ်းမိူင်း
illness	ၼၢဝ်
Ilocano	ၶိူဝ်းဢီႇလူဝ်ႇၶႃႇလူဝ်ႇ
image	ပုင်ႇႁၢင်ႊ
imagine	ဝူၼ်ႉႁၼ်
immediate	ၵမ်းသိုဝ်ႈ
immediately	ၵမ်းလဵဝ်
immense	ယႂ်ႇလူင်
impact	တဵၵ်းသႂ်ႇ
impact	တိူဝ်ႉသႂ်ႇႁႅင်း
impatient	ၸႂ်ပွတ်း
implement	ႁဵတ်းႁႂ်ႈယဝ်ႉ
import	ၵုၼ်ႇသႂၢင်း
import	လၢၵ်ႇလၢႆး
important	လမ်ႇလွင်ႈ
impose	မၵ်ႉမၼ်ႈတၢင်းၽိတ်း
impossible	ဢမ်ႇပဵၼ်လႆႈ
impress	လႆႈၸႂ်
impression	တၢင်းႁၼ်ထိုင်
impressive	လီထၢင်ႇယႂ်ႇ
improve	တိူဝ်းတွၼ်းၶိုၼ်ႈယႂ်ႇမႃး
improvement	ႁုၼ်ႈမုၼ်း
in	တၢင်းၼႂ်း
in addition	သႂ်ႇထႅင်ႈ
In fact	ဝႃႈမႃးတေႉၵေႃႈ
in front of	တၢင်းၼႃႈ
in order to	ၶပ်ႉထၢမ်း
inappropriate	ဢမ်ႇလႅၵ်ႈသၢၵ်ႈ
incentive	ပၼ်ႁႅင်း
incident	လၢႆးပဵၼ်
include	ၶဝ်ႈပႃးဝႆႉ
including	ၶဝ်ႈပႃးဝႆႉ
income	ငိုၼ်းၶဝ်ႈ
inconvenience	သၢႆငၢႆဢမ်ႇၶႅမ်ႉ
increase	တိူဝ်းၼမ်မႃး
increased	ၼမ်ၶိုၼ်ႈမႃး
incredible	ၶိုၵ်ႉၶႅမ်ႉ
indeed	တီႈတႄႉမၼ်း
independent	လွင်ႈလွတ်ႈလႅဝ်း
India	မိူင်းဢိၼ်းယႂ်း
indicate	ယိူင်းၸူး
indigenous	ပဵၼ်ၸၢဝ်းၶိူဝ်း
individual	လၢႆးၵေႃႉ
industry	ႁူင်းၸၢၵ်ႈ
inevitable	ဢၼ်ယၢမ်ႈပဵၼ်
infant	ဢေလႅင်
infection	ၸပ်းတၢင်းပဵၼ်
infinity	မိုၼ်ႇမုင်ႊ
inflammation	ၵႂ်ႊ
inflation	ငိုၼ်းၵႂ်ႊ
influence	ႁႅင်းပွင်ႊ
influence	ႁူမ်ႇမုင်း
inform	ပွင်ႇလႅင်း
information	ၶေႃႈမုၼ်း
ingredients	ၶဝ်ႈၶိုင်
inheritance	ပုတ်ႈၶူဝ်းပုတ်ႈ
initial	ဢၼ်တႄႇ
initiative	ဢွၼ်ၼႃႈ
injured	မၢတ်ႇၸဵပ်း
injury	သမ်းၶဵမ်
innocent	ဢမ်ႇမီးတၢင်းၽိတ်း
innovation	လႅၵ်ႈလၢႆႊလၢႆးမႂ်ႇ
inquiry	ၸွပ်ႇထၢမ်
insane	ၸႂ်ဢမ်ႇလီ
insect	မူင်ႈမႅင်း
insecure	ႁၢမ်းလွင်ႈၵႅတ်ႈၵင်ႈ
insert	မူင်ႈမႅင်း
inside	တၢင်းၼႂ်း
insight	ၺၢၼ်ႇႁၼ်ထိုင်လွၼ်ႉ
insist	တိုၵ်းသူၼ်းတေႉဝႃႈ
insomnia	တၢင်းပဵၼ် ၼွၼ်းဢမ်ႇလႆႈ
inspiration	ၶူင်ႉထူၺ်ႈၸႂ်
inspire	ယူင်းသေႃႇ
install	သႂၢင်းသႂ်ႇ
instance	ပိူင်ပဵၼ်
instant	တႃႉဢဝ် ၼႆႉတႅၼ်း
instead	ၽိူဝ်ႇတႃႉ
instead of	တႃႉတိုဝ်း
instructions	ၶေႃႈပၼ်ဝႆႉ
instrument	ၶိူင်ႈႁႆႇတိုင်ႈ
insult	လႃႇ
insurance	ႁပ်ႉပဝ်ႊ
intact	တိုၵ်ႉလီယူႇ
integrity	သိုဝ်ႈယူဝ်း
intellectual	ၺၢၼ်ႇပၺ်ႇၺႃႇ
intelligence	လႅတ်းၾၢႆ
intelligent	လႅတ်းၽၢႆ
intend	ယိူင်းဢၢၼ်း
intended	ယိူင်းၸူး
intense	ယႂ်ႇႁႅင်းၼႃႇ
intention	ပၵ်းၸႂ်
interact	သူၼ်ၸႂ်
interaction	တုမ်ႉတွပ်ႇ
interest	ၶဝ်ႈၸႂ်
interested	ၶဝ်ႈၸႂ်
interesting	လွင်ႈလီသူၼ်ၸႂ်
interfere	ၶဝ်ႈၵၢင်
intermediate	ၸၼ်ႉၵၢင်
internal	ၽၢႆႇတၢင်းၼႂ်း
international	ၵဵဝ်ႇတင်းၵူႊမိူင်းမိူင်း
internship	ၶၢဝ်းတၢင်းထိင်းသိမ်း
interpret	ၵဵပ်းတီႈပွင်ႇ
interpreter	ၵူၼ်းပိၼ်ႇၾၢၼ်ႊ
interrupt	ၶၢတ်ႇၵႃႇ
interview	သွပ်ႇၸၢမ်း
intimate	ၸမ်ၸႂ်
into	ၶဝ်ႈၵႂႃႇ
introduce	သိုပ်ႇမိုတ်ႈ
introduction	ၶေႃႈၼၢမ်း
introvert	ယူႇပိၼ်ႉယူႇပႅတ်ႈ
intuition	ႁူႉဝႆႉႁင်းၵွၺ်း
invalid	ဢမ်ႇၶဝ်ႈၶႂၢင်ႇတြႃး
invent	ၶူင်ႊသၢင်ႈ
inventory	ၸလၢင်းၵုၼ်ႇ
invest	ၽင်တိုၼ်းလၢင်း
investigate	ၸွပ်ႇထၢမ်
invitation	ၽိတ်ႈႁပ်ႉဢဝ်
invite	ၽိတ်ႈမွၵ်ႇ
invoice	သဵၼ်ႈၶူဝ်းၵုၼ်ႇ
invoice	ႁဵတ်းသဵၼ်ႈ
involve	ၶဝ်ႈပႃးၸွမ်း
involved	ၶဝ်ႈပႃးၸွမ်း
iron	တဵင်ႇသိူဝ်ႈၶူဝ်း
iron	လဵၵ်းၶၢင်
is	ပဵၼ်
island	ၵုၼ်
isolated	ၸႅၵ်ႇဝႆႉ
issue	ပိုၼ်ႊၽၢဝ်ႇ
issue	ပၼ်ႁႃ
issues	လွင်ႈတၢင်း
it	ဢၼ်ၼၼ်ႉ
it is	ၼၼ်ႉပဵၼ်
it was	ၼၼ်ႉပဵၼ်မႃး
it's	ၼၼ်ႉပဵၼ်
it's ok	ၶႅမ်ႉတေႉ
It's okay	ၶႅမ်ႉလႅပ်ႈလီ
item	ၶူဝ်းၸႂ်ႉ
items	ၶူဝ်းၶွင်
its	ၶွင်မၼ်း
I’m	ၵဝ်ပဵၼ်
jacket	သိူဝ်ႈသွၼ်ႉ
jail	ၶွၵ်ႈ
January	လိူၼ်ၼိူင်ႈ
jar	ၵွၵ်းၵႅဝ်ႈလူင်
jaw	ၵွင်ႉၵၢင်း
jealous	သူၺ်ႈ
jerk	ၸၵ်ႉယုပ်း
jewelry	ၶိူင်ႈႁွၺ်ႈၶိူင်ႈတိုဝ်း
job	ၼႃႈၵၢၼ်
jogging	ဢွင်ၸွၵ်း
join	ၶဝ်ႈၸွမ်း
joint	ၼိူဝ်ႉလုပ်ႇ
joke	ၵိူဝ်ႉလဵၼ်ႈ
journalist	ၽူႈတႅမ်ႈလိၵ်ႈ ၸျႃႇၼႄႇ
journey	ၶၢဝ်းတၢင်းယၢဝ်း
joy	ႁုၼ်ႉၼူဝ်
judge	ၽူႈထတ်းသိၼ်
judge	ထတ်းသိၼ်
juice	ၼမ်ႉဝၢၼ်
july	လိူၼ်ၸဵတ်း
jump	ဝႅၼ်
june	လိူၼ်ႁူၵ်း
junk	ၸေႈသႃ
just	ၵူၺ်း
just do it	ႁဵတ်းၼႆႉၵွၺ်ႈလႃႈ
justice	လွင်ႈၽဵင်ႇပဵင်း
justify	မၢၼ်ႇမႅၼ်ႈ
Kalaallisut	ၶိူဝ်းၵူႃႇလႃႇလီႉသုတ်ႉ
keen	ပႃးၸႂ်ပႃးၶေႃး
keep	ၵဵပ်းသိမ်း
keep it up	သိမ်းမၼ်းဝႆႉ
kept	ထိင်းဝႆႉ
kettle	ငွၺ်း
key	ၵၢၵ်ႇသေႃး
kick	ပိတ်ႉ
kid	လုၵ်ႈဢွၼ်ႇ
kidding	ယဝ်ႉလဵၼ်ႈ
kidney	တပ်း
kids	လုၵ်ႈဢွၼ်ႇ
kill	ႁႅမ်
kind	ၸႂ်လီ
kind	ၸိူဝ်ႉၶိူဝ်း
kinda	တၢၼ်ႇတၢၼ်ႇ
kindly	ၸႂ်လီ
kindness	ၸႂ်လီ
king	ၶုၼ်ႁေႃၶမ်း
kiss	ၸုပ်ႇ
kitchen	သိုင်ႇၾႆး
kite	လၢင်းယၢၼ်း
kitten	ဢေမႅဝ်
knee	ၶုပ်ႉၶဝ်ႇ
knee	ႁူဝ်ၶဝ်ႇ
knew	ႁူႉယဝ်ႉ
knife	မိတ်ႈ
knight	ၽူႈႁတ်းႁၢၼ်
know	ႁူႉ
knowledge	တၢင်းႁူႉ
known	ႁူႉယဝ်ႉ
Konkani	ၶူဝ်းၶွၼ်ႇၶႃႇၼီႇ
Krio	ၶိူဝ်းၶရီႇဢူဝ်
label	မိၵ်ႈယႃႈယႃ
label	ၼေၸိုဝ်ႈတွၼ်ႊ
labor	ႁွင်ႈပၢႆးသၢႆႊ
labour	ၵၢၼ်ၵႅမ်း
lack	ႁၢမ်း
ladder	ၶူဝ်လႆ
lady	သၢဝ်
laid	သိူဝ်ႇ
lake	ၼွင်
lamb	ဢေၸဵၼ်ႊ
lame	ၶႃႁၵ်း
lamp	ဢေတူဝ်း
land	ၼိူဝ်လိၼ်
land	လိၼ်
landscape	လႅၼ်ႊမုင်ႈတၢင်းၼွၼ်း
landscape	လႅၼ်ႊမုင်ႈ
language	လိၵ်ႈလၢႆးၵႂၢမ်းလၢတ်ႈ
lap	ၶႃလူင်
large	လူင်
last	လိုၼ်းသုတ်း
last but not least	ၵမ်းလိုၼ်း ၵူၺ်းၵႃႊ ဢမ်ႇၸႂ်ႈတီႈဢေႇသုတ်း
last name	ၸိုဝ်ႈတၢင်းလင်
late	တူၵ်းလိုၼ်း
lately	တူၵ်းလိုၼ်း
later	ဝၢႆးလိုၼ်း
latest	ၵမ်းလိုၼ်း
latter	ဝၢႆးလိုၼ်း
laugh	ၶူဝ်
laughing	ၶူဝ်
laughter	ၵူၼ်းၶူဝ်
launch	တႄႇႁဵတ်းၼႃႈၵၢၼ်
laundry	တီႈသၵ်းၶူဝ်း
law	ပၵ်းပိူင်
lawn	ပၢင်ႇယိူဝ်ႈ
lawyer	ၽူႈတၢင်လၢတ်ႈ
lay	လူမ်ႉ
layer	ထၢပ်ႈ
layout	ထၢပ်ႈ
lazy	ၶၢၼ်ႉ
lead	ဢွၼ်ႁူဝ်
leader	ၽူႈဢွၼ်ႁူဝ်
leaf	မႂ်ႊမႆႉ
leak	ၸိုမ်းဢွၵ်ႇ
lean	ၶွၼ်း
leap	ဢွင်
learn	ႁဵၼ်း
learning	ႁဵၼ်းသွၼ်
lease	လိၵ်ႈၶၢၼ်ႈၼင်လိၼ်
least	တီႈဢေႇသုတ်း
leather	ၼင်
leave	မႂ်ႊမႆႉ
leaves	ဢွၵ်ႇၵႂႃႇ
led	ဢွၼ်ႁူဝ်
left	ၽၢႆႇသၢႆႉ
leg	တိၼ်
legacy	ၶူဝ်းပုတ်ႈ
legal	ၶဝ်ႈၶႂၢင်ႇတြႃး
legend	ဢႃႊသိူၵ်ႈ
legit	ၶဝ်ႈတၢင်းၵၢၼ်
leisure	လိုဝ်ႈႁိူဝ်ႉ
lend	ၵူႈ
length	တၢင်းယၢဝ်း
less	ဢေႇ
lesson	ၶၢဝ်းသွၼ်လိၵ်ႈ
lesson	တွၼ်ႊသွၼ်
let	ဢွၼ်ၵၼ်
letter	လိၵ်ႈထွင်
letter	တူဝ်မႄႈလိၵ်ႈ
lettuce	ၽၵ်းသလၢပ်ႈ
level	ၸၼ်ႉ
leverage	ၺိပ်ၶၢႆႉ
liability	မီးဝႆႉပုၼ်ႈၽွၼ်း
library	ႁူင်းလၢႆး
lick	လေး
lie	ပႅတ်ႉလႅၼ်
lie	လွင်ႈလႅၼ်
lies	ပႅတ်ႉလႅၼ်
life	ၸၢတ်ႈပၢၼ်
lift	ၸၢၵ်ႈတိဝ်ႈၶိုၼ်ႈ
lift	ယွင်ႈ
light	သၢႆလႅင်း
light	မဝ်ႊ
light	ၸပ်းၾႆး
lightning	ၾႃႉမႅပ်ႈ
like	လႆႈၸႂ်
likely	မိူၼ်ႁၢင်ႊ
likewise	မိူၼ်ၼႆ
line	သၢႆ
Lingala	ၶိူဝ်းလိင်ႇၵႃႇလႃႇ
link	ၵဵဝ်ႇၵွင်ႉ
lion	သၢင်ႇသီႈ
liquid	ၼမ်ႉလႅဝ်ႊ
list	သႅၼ်ႈ
listen	ထွမ်ႇ
listening	ထွမ်ႇယူႇ
literally	သိုဝ်ႈသိုဝ်ႈ
literature	ပၢႆးလိၵ်ႈလူင်
litter	ဢိတ်းဢွတ်း
little	ဢၼ်ဢေႇ
live	ယူႇသဝ်း
live	သၢႆၸႂ်
liver	တပ်း
lives	ယူႇ
living	ယူႇသဝ်း
living room	ႁွင်ႈႁပ်ႉၶႅၵ်ႇ
lizard	ဢၢင်ႇၶၢင်
load	ၶွၼ်ႇ
loaf	ၶဝ်ႈမုၼ်းမူင်ႊ
loan	ငိုၼ်းၶီႈ
local	ပိုၼ်ႉတီႈ
location	တီႈယူႇ
lock	ၵၢၵ်ႇသေႃး
lockdown	ဢိုတ်းတၢင်းၶဝ်ႈဢွၵ်ႇ
log	တုမ်မႆႉ
lol	ႁႁႁ
lonely	ၵေႃႉလဵဝ်
long	ယၢဝ်း
long time no see	ဢမ်ႇလႆႈႁၼ်ၵၼ် ႁိုင်ယဝ်ႉ
look	တူၺ်း
loop	တူင်ႇ
loose	လူမ်
lord	ၾႃႉၸဝ်ႈ
lose	သုမ်း
loss	သုမ်း
lost	သုမ်း
lot	ၼမ်
loud	သဵင်ႁႅင်း
lounge	ၶၢၼ်ႉဢိူၼ်လိူၼ်
love	တၢင်းႁၵ်ႉ
love you	ႁၵ်ႉသူ
lovely	လီႁၵ်ႉ
low	တီႈတႂ်ႈ
lower	တႅမ်ႇတိူဝ်း
loyal	ၶုၼ်
loyalty	ဢၼ်မီးသတ်ႉၸႃႇ
luck	သုၼ်ႇ
lucky	သုၼ်ႇလီ
Luganda	ၶိူဝ်းလူႇၵၢတ်ႇတႃႇ
luggage	တိူၵ်ႈၶူဝ်း
lump	ပဵၼ်ၵွၼ်ႈ
lunch	ၶဝ်ႈၼႂ်
lungs	ပွတ်ႇ
luxury	ၸေးၸိမ်ႇ
lying	ပႅတ်ႉလႅၼ်
machine	ၸၢၵ်ႈ
mad	ယွင်ႇ
madam	မႄႈသၢဝ်
made	ႁဵတ်းဝႆႉ
magazine	ပပ်ႉမႅၵ်ႉၵၸိၼ်း
magnificent	ၶိုၵ်ႉၶႅမ်ႉ
maid	လုၵ်ႈၸၢင်ႈ
main	ပိူင်ယႂ်ႇ
maintain	ထိင်းသိမ်း
maintenance	လူလွမ်ပႂ်ႉပႃး
Maithili	ၶိူဝ်းမၢႆႇတီႇလီႇ
major	ဢၼ်လမ်ႇလွင်ႈ
major	ၵူၼ်းႁဵၼ်းပၢႆးပိူင်လူင်
majority	ဢၼ်ၶိုၵ်ႉတွၼ်း
make	ႁဵတ်းသၢင်ႈ
make up	ႁၢင်ႈၶိူင်ႈ
male	တူဝ်ၽူႈ
mall	ၵၢတ်ႇလူင်
man	ၽူႈၸၢႆး
manage	ၸတ်းပွင်
management	ၸတ်းပွင်
manager	ၽူႈပွင်ၵၢၼ်
mandatory	ၶေႃႈပူင်
manifest	ၸႅင်ႈလႅင်းလီ
manipulate	ၵမ်ၸိူၵ်ႈဝႆႉလႆႈလီ
manner	ၽိင်ႈယၢမ်ႈ
manual	လၢႆးမိုဝ်း
many	လၢႆလၢႆဢၼ်
many many happy returns of the day	ဝၼ်းသိူဝ်းၸႂ်တေႉတေႉဝႃႈဝႃႈ
march	ပၢင်ၶႄႉၶဵင်ႇ
margin	မႆႁွၺ်းၶွၵ်း
market	ၵၢတ်ႇ
marriage	ႁဵတ်းၶႅၵ်ႇ
married	သွၼ်ႉမိင်ႈ
mask	ၵၢပ်ႇၼႃႈ
mass	တၢင်းၼၵ်း
massive	ၼၵ်းႁႅင်း
master	သြႃႇလူင်
match	ပၢင်ၶႄႉသဵင်ႇ
match	ၵိုၵ်းသဵင်ႇ
mate	ၽူႈၸွၺ်ႈ
mate	ၵေႃႉၵူႈ
material	ၶူဝ်းၸႂ်ႉ
math	ပၢႆးၼပ်ႉ
matter	လွင်ႈတၢင်း
matter	လမ်ႇလွင်ႈလၢၵ်ႇလၢႆး
maturity	ၵေႃႉယႂ်ႇယဝ်ႉ
may	တႃႉႁဵတ်းၼႆ
may	ထုၵ်ႇလီ
maybe	ယူဝ်ၶေး
me	ႁဝ်း
me too	မိူၼ်ၵၼ်
meal	တႃႇၶဝ်ႈ
mean	ပွင်ႇဝႃႈ
meaning	တီႈပွင်ႇ
means	ပွင်ႇဝႃႈ
meant	ပွင်ႇဝႃႈ
meanwhile	ၼႂ်းဝူင်ႈဝၢင်ႈ
measure	တႅၵ်ႈ
measures	တႅၵ်ႈ
meat	ၼိူဝ်ႉ
medical	ယႃႈယႃ
medicine	ယႃႈယႃ
meditation	ၵႅင်ႉၵမ်ႊတြႃး
medium	ပၢၼ်ၵၢင်
meet	ႁူပ်ႉထူပ်း
meeting	ပၢင်ၵုမ်
Meiteilon	ၶိူဝ်းမေႇထေးလွၼ်ႇ
melt	ၶႃႇ
memories	တီႈမၢႆတွင်း
memory	မၢႆတွင်း
mental	ၵဵဝ်ႇတင်းၸႂ်
mention	ၸီႉၸူး
mentioned	ႁွင်ႉၸူး
mentor	ၽူႈထႅမ်တူၺ်း
merchant	ၵူၼ်းၵႃႉ
mercy	ဢဵတ်းလူ
merely	တေႃႉတႄႉ
merry christmas	ႁူမ်ၸူမ်း ပၢင်ပွၺ်း ၶရိတ်ႉ
mess	ႁၢႆႉၸႃႉ
message	လိၵ်ႈပွတ်း
messy	သုၵ်ႉသၢၵ်ႈ
metal	ၶူဝ်းႁႄႊ
method	လွၵ်းလၢႆး
mice	ၼူ
middle	ၼႂ်းၵၢင်
midnight	ၶိုၼ်းတဵင်ႈ
might	ထုၵ်ႇလီ
mild	ဢူၼ်ႈ
milestone	လၵ်းမၢႆ တဵမ်လၵ်း
military	တပ်ႉသိုၵ်း
milk	ၼမ်ႉၼူမ်း
million	ၼိူင်ႈလၢၼ်ႉ
mind	ၸႂ်
mindset	ပၢႆးၸႂ်ႊ
mine	ႁင်းၵဝ်
mine	မၢၵ်ႇ
mingle	ၶူၼ်းလေႃး
minor	လဵၵ်ႉ
minute	မဵတ်ႉ
minutes	မဵတ်ႉ
miracle	ပိူင်ပဵၼ်ဢၢမ်းဢေႃး
mirror	မၢၼ်ႇၸမ်ႈ
miscellaneous	ၵူႊလွင်ႈလွင်ႈ
mischievous	ယႃႉၽွၼ်း
miserable	ၸႂ်တုၵ်ႉ
misery	ၸႂ်တုၵ်ႉတေႉ
miss	ၸႂ်ထိုင်
miss	တူၵ်းႁၢႆ
miss	ၶုၼ်ယိင်း
miss you	ၸႂ်ထိုင်သူ
missing	ႁၢႆဝႆႉ
mission	တႃႈယိူင်း
mist	သႅင်ၶဝ်ႉ
mistake	တၢင်းၽိတ်း
Mizo	ၶိူဝ်းမီႇသူဝ်ႇ
mobile	မိုဝ်းထိုဝ်
mock	မုၼ်ႈၸဝ်ႈ
model	ပဵၼ်လၵ်းၸဵင်
moderate	ထိင်းပၼ်
modern	ၵၢပ်ႈမႂ်ႇ
modest	မီးတၢၼ်ႇတၢၼ်ႇ
moist	ယိုၵ်းယမ်း
moisture	ယိုၵ်း
mold	တႅမ်ႈပိူင်ႁၢင်ႊ
mold	ထၢင်ႇ
mole	ၾႆ
mom	မႄႈမွၵ်ႇယႃႈ
moment	ၸူဝ်ႊၵႅပ်ႉ
monday	ဝၼ်းၸၼ်
money	ငိုၼ်း
monitor	ႁူဝ်ၼႃႈလုၵ်ႈႁဵၼ်း
monkey	လိင်း
month	သူပ်း
mood	ၼမ်ႉၸႂ်
moody	ၸႂ်လႅၵ်ႈငၢႆႈ
moon	လိူၼ်
moral	တၢင်းၵႅင်ႉၵမ်ႊ
more	ၼမ်လိူဝ်သေ
moreover	ထႅင်ႈတၢင်းၼိူင်ႈ
morning	ႁူဝ်ၼႂ်
mortgage	လိၵ်ႈၵမ်ႉ
most	ၵမ်ႈၼမ်
mostly	ၵမ်ႉၼမ်
mother	မႄႈမႄႈ
motion	ၶၢႆႉတူင်ႉ
motivation	ႁႅင်းၸႂ်
mountain	ႁၢဝ်းလွၺ်
mouse	ၼူ
mouth	သူပ်း
move	ၶၢႆႉ
movement	ၶၢႆႉတူင်ႉ
movie	ၸိူင်း
mrs	မႄႈသၢဝ်
much	ၼမ်
mud	ဢုင်
mug	ၵွၵ်းလူင်
muscle	ၾူတ်ႇဢဵၼ်မႃႇ
museum	ႁွင်ႈၼေၶူဝ်းၶွင်ၵဝ်ႇ
mushroom	ႁဵပ်း
music	ၽဵင်း
must	လူဝ်ႇ
must	တိုၼ်း
mute	ဢိုတ်းသဵင်
mutual	တင်းသွင်ပႃႈသွင်ၽၢႆႇ
my	ၶွင်ၵဝ်
My dear	ႁၵ်ႉၵဝ်ဢိူၺ်း
my friend	တႆးၵေႃႉၵဝ်
My hovercraft is full of eels	ၼႂ်းႁိူဝ်းႁဝ်း တဵမ်ဝႆႉ ပႃႇယဵၼ်ႇဢိူဝ်ႈ
my love	တၢင်းႁၵ်ႉႁဝ်း
my name is	ၸိုဝ်ႈႁဝ်းႁွင်ႉ
my pleasure	ပဵၼ်ၼမ်ႉၸႂ်ၵဝ်ယဝ်ႉ
myself	တူဝ်ၵဝ်ၵွၺ်း
mysterious	မီးလွင်ႈသိူင်ႇလပ်ႉ
mystery	လပ်းသိူင်ႇဝႆႉ
myth	ဢသိူၵ်ႈ
nail	မၢတ်ႇလဵၵ်ႉၼႃး
naive	ႁၢမ်းတူဝ်ထူပ်း
name	ၸိုဝ်ႈ
narrative	ၸိူင်း
narrow	ၵႅပ်ႈ
nasty	လိူင်း
national	ၸၢဝ်းၶိူဝ်း
nationality	ၸၢဝ်းၶိူဝ်း
native	ၵူၼ်းၵိုၵ်းမိူင်း
natural	ၾိင်ႈတိုၼ်း
nature	ၾိင်ႈတိုၼ်း
nausea	ဢိုတ်ႇဢၢတ်ႇ
near	ၸမ်
nearby	ၸမ်ၸမ်
nearly	ၸမ်ၸမ်
neat	သႅၼ်ႈသႂ်
necessary	ဢၼ်လူဝ်ႇမီးလူဝ်ႇပဵၼ်
neck	ၶေႃး
necklace	သၢႆၶေႃး
need	တၢင်းလူဝ်ႇ
negative	လွင်ႈၸႃႉ
neglect	ဝႆႉမဝ်မၢင်
negotiate	ၺီႉလႆႈ
neighbor	ႁိမ်းႁိူၼ်း
neighborhood	ႁိမ်းႁိူၼ်း
neither	ဢမ်ႇၸႂ်ႈသေဢၼ်
nephew	လၢၼ်ယိင်း
nerd	ၸလိူဝ်ႈၸလႃႈ
nervous	ၸႂ်သၼ်ႇ
nest	ႁင်းၼူၵ်ႉ
net	ယႅင်ႉ
network	ၼႅင်ႊ
neutral	ၵူၼ်းၶဵဝ်
never	ဢမ်ႇမီးသေပွၵ်ႈ
never give up	ဢမ်ႇတွၼ်ႉယွၼ်းသုမ်း
never mind	ယႃႇဝႆႉၸႂ်
nevermind	ဢမ်ႇပဵၼ်သင်
nevertheless	ၵေႃႈလၢႆး
new	မႂ်ႇ
news	ၶၢဝ်ႇ
next	ထႅင်ႈဢၼ်ၼိူင်ႈ
next to	ႁိမ်းၼႆႉ
nice	ၶႅမ်ႉ
nice to meet you	ငိၼ်းၸူမ်းလႆႈႁူပ်ႉထူပ်းသူၶႃႈ
niece	လၢၼ်
night	ၵၢင်ၶမ်ႈ
nightmare	ၶိူဝ်ႈၵိၼ်
nine	ၵဝ်ႈ
nineteen	သိပ်းၵဝ်ႈ
ninety	ၵဝ်ႈသိပ်း
No	ဢမ်ႇ
no problem	ဢမ်ႇပဵၼ်သင်
no way	ဢမ်ႇမီးတၢင်း
nobody	ဢမ်ႇမီးၽႂ်
noise	မေႃး
noisy	မေႃးပၼ်း
none	ဢမ်ႇမီးသင်
noon	ဝၼ်းတဵင်ႈ
nope	ဢမ်ႇၸႂ်ႈ
nor	ၼႆႉၵေႃႈဢမ်ႇ
normal	တၢၼ်ႇတၢၼ်ႇ
north	ၽၢႆႇႁွင်ႇ
nose	ၶူႈလင်ႊ
nostalgic	ၸႂ်ထိုင်ဝၼ်းလင်
not	ဢမ်ႇ
not at all	ဢမ်ႇၸႂ်ႈတင်းမူတ်း
not bad	ဢမ်ႇႁၢင်ႊႁၢႆႉ
Not now	ဢမ်ႇၸႂ်ႈတေႃႈလဵဝ်
not yet	ဢမ်ႇပႆႇ
note	မၢႆတွင်း
noted	တီႈတွင်း
nothing	ဢမ်ႇမီးသင်
notice	ၽၢင်ႉမႅၼ်ႈ
noticed	မၢႆဝႆႉ
noun	ႁိၵ်ႈ
nouns	ႁိၵ်ႈ
novel	သၢင်း
november	လိူၼ်သိပ်းဢဵတ်း
now	မိူဝ်ႈလဵဝ်
nowadays	ၵၢပ်ႈပၢၼ်မိူဝ်ႈလဵဝ်
nuisance	ၸႂ်သုၵ်ႉသၢၵ်ႉ
null	ဢမ်ႇၶဝ်ႈၶႂၢင်ႈတြႃး
numb	ၼဵတ်း
number	တူဝ်ၼပ်ႉ
nurse	မေႃယႃဢွၼ်ႇ
nut	မဵတ်ႉထူဝ်ႇ
nutmeg	မၢၵ်ႇတွၺ်ႇ
nutrition	ထၢတ်ႈလဵင်ႉၸႂ်
oath	ၶၢမ်ႇၵိၼ်ႇ
obesity	ပီးလူၼ်ႉ
obey	ၸွမ်းၶေႃႈတီႈသင်ႇ
object	ၶူဝ်းၶွင်
objective	ထင်ႉ
obligation	ႁူႉပုၼ်ႈၽွၼ်း
obscure	ဝဝ်းမွင်
observation	ႁပ်ႉထွမ်ႇတုင်းဢဝ်
observe	လဵပ်ႈႁဵၼ်း
obsessed	မႆႈၸႂ်
obsession	ၸႂ်ၸပ်း
obsolete	ဢမ်ႇမီးၵၢပ်ႈမၼ်း
obstacle	လွင်ႈႁၢမ်ႈသီး
obtain	ၶဝ်ႈပႃး
obtained	လႆႈမႃး
obvious	ႁူႉလႆႈငၢႆႈ
obviously	ဢၼ်ႁူႉငၢႆႈ
occasionally	မၢင်ႊပွၵ်ႈမၢင်ႊလႂ်
occupation	ၼႃႈၵၢၼ်
occupation	ႁုပ်ႈသိမ်းဢဝ်
occupation	ၶဝ်ႈယူႇထင်သဝ်း
occupied	ၼႃႈၵၢၼ်
occur	ပဵၼ်မႃး
occurred	ပေႃႇပဵၼ်မႃး
occurs	ပေႃႇပဵၼ်မႃး
ocean	ၼမ်ႉသမ်ႇမုၵ်ႉ
october	လိူၼ်သိပ်း
odd	ဢၼ်လၢၵ်ႇလၢႆး
odds	ၸိၵ်ႉ
of	ၶွင်
of course	ၸိူင်ႉၼၼ်ယဝ်ႉ
off	ႁပ်း
offensive	လူလၢႆ ႁဵတ်းတီႈ
offer	ၶူဝ်းပၼ်
offer	ယိုၼ်ႈပၼ်
office	ႁွင်ႈလုမ်း
official	ၸွမ်းတြႃး
often	ၵႆႉၵႆႉ
Oh	ဢူဝ်ႉႁူဝ်
oh really	ဢူဝ်ႉ ၸႂ်ႈႁႃႉ
oil	ၼမ်ႉမၼ်း
ok	လႆႈယူႇ
ok dear	လီယဝ်ႉ ႁၵ်ႉဢိူၺ်း
ok honey	လီယဝ်ႉ ႁၵ်ႉဢိူၺ်း
ok my love	လီယဝ်ႉ ႁၵ်ႉဢိူၺ်း
okay	လႆႈယူႇ
okay baby	လီယဝ်ႉ ဢေႁဝ်း
okay dear	လီယဝ်ႉ ၵေႃႉႁၵ်ႉ
okay honey	လႆႈယူႇ ၵေႃႉႁၵ်ႉ
okay my love	ႁဝ်းလႆႈၸႂ်
old	ဢၼ်ထဝ်ႈ
on	တၢင်းၼိူဝ်
once	ပွၵ်ႈလဵဝ်
one	ဢၼ်ၼိူင်ႈ
one language is never enough	လိၵ်ႈလၢႆးၵႂၢမ်းလၢတ်ႈ ၼိူင်ႈဢၼ်ၼႆႉ ပႆႇၵုမ်ႇထူၼ်ႈ
onion	ၽၵ်းမူဝ်ႇ
online	ၼိူဝ်ၼႅင်ႊ
only	ၼႆႉၵွၺ်း
open	ၽုၺ်ႇ
operation	ၽႃႇတတ်း
opinion	တၢင်းႁၼ်ထိုင်
opportunities	တိုဝ်ႉတၢင်း
opportunity	တိုဝ်ႉတၢင်း
opposite	တေႃႇၼႃႈ
opposite	ပိၼ်ႈၾူၼ်
optimistic	ႁၼ်ၽၢႆႇလီ
option	သုၼ်ႇလိူၵ်ႈတိုဝ်ႉတၢင်း
optional	ဢမ်ႇလိူၵ်ႈသင်
or	ဢမ်ႇၼၼ်
orange	မၢၵ်ႇဝၢၼ်
orange	သီလိူင်မၢၵ်ႇၸွၵ်း
order	သင်ႇ
order	မၢႆၶပ်ႉ
ordinary	လၢႆးၽဵၼ်ႈ
organization	မူႇၸုမ်း
orientation	ၶူၼ်ႉၶႆႈ
origin	ငဝ်ႈတိုၼ်း
original	ငဝ်ႈတိုၼ်း
Oromo	ၶိူဝ်းဢူဝ်ႇရူဝ်ႇမူဝ်ႇ
orphan	လုၵ်ႈဢွၼ်ႇၽၢၼ်ပေႃႈမႄႈ
other	တၢင်ႇဢၼ်
otherwise	ထႅင်ႈတၢင်းၼိူင်ႈ
ought	ၶေးပဵၼ်
our	ၶူဝ်းၶွင်ၸိူဝ်းႁဝ်း
Our mission: to enable everyone, everywhere to understand the world and express themselves across languages.	ပဝ်ႉမၢႆႁဝ်း - တႃႇႁဵတ်းႁႂ်ႈ ၵူၼ်းၵူႊၵေႃႉ၊ ၵူႊတီႈ ႁူႉႁၼ်သေ မွၵ်ႇၼႆတေႃႇ ၽႃႇသႃႇၼႂ်းလူၵ်ႈ ႁႂ်ႈပွင်ႇၸႂ်။
Our mission: to organize the world's information and make it universally accessible and useful.	ပဝ်ႉမၢႆႁဝ်း - တေၸတ်းပွင်ႊ ႁႂ်ႈၶေႃႈမုၼ်းလုမ်ႈၾႃႉသေ ႁဵတ်းႁႂ်ႈမၼ်း ပၼ်ၽွၼ်းလီ ၶဝ်ႈတၢင်းတိုဝ်းၼၼ်ႉ။
out	ဢွၵ်ႇၵႂႃႇ
outcome	ငိုၼ်းဢွၵ်ႇ
outfit	ၶူဝ်းၶွင်ဢၼ်လူဝ်ႇ
outgoing	ပွင်ႇၸႂ်
outlet	ႁူးဢွၵ်ႇ
outline	ႁွၺ်းၶွပ်ႇ
outside	ၽၢႆႇၼွၵ်ႈ
outstanding	ပွင်ႇၸႂ်
oven	မေႃႈတင်ႈ
over	ပူၼ်ႉလိူဝ်
over there	မီးၼၼ်ႉၵွၺ်း
overall	ႁုပ်ႈတုမ်
overcome	ၶၢမ်ႈပူၼ်ႉ
overthinking	ဝူၼ်ႉပူၼ်ႉ
overwhelmed	ႁူမ်ႇငမ်း
overwhelming	ႁူမ်ႇငမ်း
owe	ထုၵ်ႇၼီႈ
owl	ၵဝ်ႉ
own	ပိူင်ႇဝႆႉ
owner	ၸဝ်ႈၶွင်
ox	ဝူဝ်းငၢၼ်
pace	ႁိဝ်ႈၸင်ႊ
pack	ႁေႃႇ
package	တိင်ၶွင်ႉ
paid	ၸၢႆႇ
pain	လွင်ႈၸဵပ်းသႅပ်ႇ
paint	ယွမ်ႉ
painting	ယွမ်ႉသီ
pair	ၵူပ်ႉ
pale	ၽိူၵ်ႇသလၢၵ်ႇ
palm	ထၢၼ်
pan	မေႃႈၶူဝ်ႈ
pandemic	တၢင်းပဵၼ်ႁႃ
panic	တိုၼ်ႇသၢၼ်ႈ
pants	ၵူၼ်ၵႁၢတ်ႈ
paper	ၸေႈ
paradise	မိူင်းၽီ
parallel	သိုဝ်ႈပဵင်းၵၼ်
parcel	ၸွၵ်း
pardon	ယွၼ်းသၢႆၸႂ်
parents	ပေႃႈမႄႈ
park	သူၼ်မွၵ်ႇ
parrot	ၼူၵ်ႉၶဵဝ်
parsley	ၽၵ်းၵီး
part	တွၼ်ႊ
participate	ၶဝ်ႈႁူမ်ႈၸွမ်း
particular	လၢႆးၵေႃႉ
particularly	ၵမ်ႉၼမ်
partner	ၵေႃႉသေႈ
party	ပၢင်ပွၺ်း
pass	ပူၼ်ႉ
passage	မူတ်း
passed	လတ်းပူၼ်ႉ
passion	ႁၵ်ႉႁႅင်း
passionate	ႁၵ်ႉႁႅင်း
passive	ဢမ်ႇတူင်ႉဢမ်ႇၼိုင်
password	မၢႆလပ်ႉ
past	ပူၼ်ႉယဝ်ႉ
patch	ဢၼ်ၽုင်
path	ၽူႈႁႃၼႃႈလိၼ်မႂ်ႇ
pathetic	လီဢီးလူ
patience	ၸႂ်ယၢမ်း
patient	ၵူၼ်းပဵၼ်
pattern	ႁၢင်ႊၽၢင်
pause	ၵိုတ်းဝႆႉ
pavement	တၢင်းၵူၼ်းပႆ
pay	ၸၢႆႇ
payment	လၢႆးၸၢႆႇငိုၼ်း
peace	ငမ်းယဵၼ်
peaceful	ၵတ်းယဵၼ်
peach	မၢၵ်ႇမူၼ်ႇ
peak	ႁွတ်ႈၸိၵ်းႁွတ်ႈယွတ်ႈ
pear	မၢၵ်ႇၵေႃႈ
peas	ထူဝ်ႇၶၢမ်း
peculiar	ဢမ်ႇလႆႈၸႂ်
pee	ယဵဝ်ႈ
peel	ပွၵ်ႇပိူၵ်ႇ
peer	ၵေႃႉသေႈ ပဵင်းၵၼ်
peers	ၵေႃႉသေႈ
pen	ၵမ်တႅမ်ႈ
pencil	ၵမ်ႈႁႅင်ႈ
pending	တိုၵ်ႉၵိုတ်းဝႆႉ
people	ၵူၼ်း
pepper	မၢၵ်ႇၽိတ်းပွမ်ႈ
perceive	လဵပ်ႈႁဵၼ်းမႅၼ်ႈ
perception	ႁူႉပွင်ႇႁၼ်လႅင်း
perfect	တဵမ်ထူၼ်ႈ
perform	ႁဵတ်းသၢင်ႈ
performance	လဝ်ႇမူၼ်ႊၸႂ်
perhaps	ယူဝ်ၶေး
period	ၶၢဝ်းၼႆႉ
permanent	ဢမ်ႇမၼ်ႈၵိုမ်း
permission	ၶေႃႈပၼ်ၶႂၢင်ႉ
permit	ယွၼ်းၶႂၢင်ႉ
perseverance	ၸႂ်ဢိုၼ်ႇ
persistent	တိုၼ်းမီးဝႆႉ
person	သုၼ်ႇၵူၼ်း
personal	သုၼ်ႇတူဝ််
personality	သုၼ်ႇတူဝ်
perspective	ၸဵင်ႇႁၼ်
persuade	ႁႂ်ႈပိူၼ်ႈယုမ်ႇ
pervert	ႁႂ်ႈထိုင်တၢင်းၽိတ်း
pet	သတ်းႁိူၼ်း
phase	ႁဵတ်းၵမ်းၶၵ်ႉၶၵ်ႉ
phenomenon	ပွင်ႇဝႃႈ
philosophy	ပၢႆးဝူၼ်ႉၶပ်ႉ
phone	မိုဝ်းထိုဝ်
photo	ၶႅပ်းႁၢင်ႊ
phrase	ၶေႃႈၵႂၢမ်း
physical	တွၼ်ႊတူဝ်ၶိင်း
pick	ၵဵပ်း
pick up	ၵဵပ်းၶိုၼ်ႈမႃး
picture	ၶႅပ်းႁၢင်ႊ
piece	ဢိတ်းဢွတ်း
pieces	ပိတ်းပွတ်း
pig	မူ
pigeon	ၵႃဢိုဝ်ႈ
pile	လွတ်ႇၼမ်ႉ
pillow	မွၼ်ႁူဝ်
pilot	ၵူၼ်းႁေႃႈႁိူဝ်းဝိၼ်
pin	သႂ်ႇၶဵမ်
pineapple	မၢၵ်ႇႁႃလၢတ်ႈ
pink	သီၶွင်
pit	လွတ်ႈဢဝ်ၵုၵ်ႉ
pitch	ႁဵတ်းသုမ်ႉ
pity	ဢီးလူ
place	ဢွင်ႈတီႈ
place	ဝၢင်း
places	ဢွင်ႈတီႈ
plague	တၢင်းပဵၼ်ႁႃႊ
plain	ၽဵၼ်ႈၽဵၼ်ႈ
plan	ၽႅၼ်ၵၢၼ်
plane	ႁိူဝ်းဝိၼ်
plant	တူၼ်ႈ
plants	တူၼ်ႈ
plate	ဢၢင်ႇၽေ
platform	တၢင်းၵူၼ်းပၼ်
play	လဵၼ်ႈ
play	ၼႄၸိူင်း
playing	လဵၼ်ႈ
pleasant	ၸဝ်ႈၼႃး
please	ၶႅၼ်းတေႃႈ
pleased	ၶႅၼ်းတေႃႈ
pleasure	မူၼ်ႊသိူဝ်း
pledge	ၵႂၢမ်းမၼ်ႈ
plenty	ၼမ်ၼမ်
plot	လွၵ်းၸိူင်း
plug	ၽၢင်သဵပ်ႇၾႆး
plum	မၢၵ်ႇမၼ်ႉ
plumber	ၵူၼ်းမႄးၼမ်ႉ
plural	မၢႆၼပ်ႉၼမ်
podcast	ပွၺ်ႇသဵင်
poem	ဝွၵ်း
poetry	လၢင်ႇၵႃႇ
point	ၸီႉ
poison	ငူၼ်ႉ
police	ႁၢၼ်
policy	ၵၢၼ်မိူင်း
polite	ယဵၼ်ႇငႄႈ
pollution	ႁင်ႈဝူၺ်ႇ
pond	ၼွင်ဢွၼ်ႇ
pool	ၼွင်
poop	ၶီႈ
poor	ၽၢၼ်
pop	ၵႂၢမ်းပွပ်ႉ
popular	ၸိုဝ်ႈလိုဝ်းလင်ႊ
population	ႁူဝ်ၼပ်ႉၵူၼ်းမိူင်း
pork	ၼိူဝ်ႉမူ
porridge	ၶဝ်ႈတူမ်ႈ
port	လဝ်ႈမၢၵ်ႇလႅင်
position	ဢွင်ႈတီႈ
positive	လီ
possess	ပိူင်ႇ
possession	ၶူဝ်းပိူင်ႇ
possessive	ပိူင်ႇဝႆႉ
possible	ပဵၼ်လႆႈ
post	သူင်ႇလိၵ်ႈ
post	ပုၼ်ႈၽွၼ်း
postpone	ၶၢႆႉလၢႆႊ
potato	မၢၼ်းၶိူဝ်
potential	ၼိမ်ၼိမ်
pound	လုမ်းထိင်းမၢႆမီႈ သဵၼ်ႈတၢင်း
poverty	ၽၢၼ်
poverty	ဢေႇ
power	ဢဵၼ်ႁႅင်း
powerful	မီးႁႅင်းပွင်ႊ
practical	ၸၢမ်းတူၺ်း
practice	ၽိုၵ်းလႅၼ်ႇ
practice	တၢင်းၽိုၵ်း
praise	လုၵ်ႉယွင်ႈ
prank	ယဝ်ႉၵိူဝ်ႉ
pray	ၼမ်ႉယႃသိတ်ႇ
precious	ၵိုင်ႇၵႃႊၶၼ်
precise	ၸႅင်ႈလႅင်းတႅတ်ႈတေႃးလီ
precisely	ၸႅင်ႈလႅင်းတႅတ်ႈတေႃးလီ
predict	ႁေႃးဝႆႉ
prefer	ၵဵၵ်ႉ
preference	ပၼ်ပူၺ်
pregnant	မၢၼ်း
prejudice	ၸွမ်းပႃႈၸွမ်းၽၢႆႇ
premises	ပၼ်လွင်ႈတၢင်း
premium	ပွတ်းၶိုၵ်ႉတွၼ်း
preparation	လႃႊႁႅၼ်း
prepare	ႁၢင်ႈႁႅင်း
prepared	လႃႊႁႅၼ်း
preposition	ႁဵင်း
presence	ၵၢပ်ႈယၢမ်းလဵဝ်
present	ၶွင်ၽၢၵ်ႇ
present	ယၢမ်းတေႃႈလဵဝ်
presentation	တၢင်ႇလၢတ်ႈ
preserve	ထိင်းသိမ်းၼင်ႇပိူင်ၵဝ်ႇ
president	လူင်ပွင်ႊၸိုဝ်ႈ
press	ၸၢၵ်ႈဢိတ်ႇလိၵ်ႈ
press	တဵၵ်း
pressure	ႁႅင်းတဵၵ်း
pretend	ၵျႃး
pretty	ႁၢင်ႊလီ
prevent	ၵႅတ်ႇၶႄဝႆႉ
previous	ႁူၼ်ၶိုၼ်း
prey	တူဝ်သတ်းထိူၼ်ႇ
price	ၵႃႊၶၼ်
pride	ဢဝ်ၵုင်ႇ
priest	ၵျွင်းၾႃႉၸဝ်ႈယေႇသူႉ
primary	ငဝ်ႈ
prime	လမ်ႇလွင်ႈ
princess	ၸဝ်ႈယိင်း
principal	ပိူင်ႈယႂ်ႇ
prior	လူဝ်ႇဝႆး
prior	မိူဝ်ႈၼၼ်ႉ
priority	ပၼ်ပူၺ်
prison	ၶွၵ်ႈ
privacy	သုၼ်ႇတူဝ်
private	သုၼ်ႇတူဝ်
privilege	သုၼ်ႇၶိုၵ်ႉတွၼ်း
prize	သူး
probably	ဢၼ်ၵိုင်ႇလီပဵၼ်၊ ဢၼ်ပဵၼ်လႆႈ
problem	ပၼ်ႁႃ
procedure	လၢႆးတၢင်း
proceed	ဢုပ်ႇၵုမ်
process	ၶပ်းၶိုင်ႁဵတ်းသၢင်ႈ
process	လွင်ႈတၢင်း
produce	ႁဵတ်းဢွၵ်ႇ
product	ၵုၼ်း
product	ၶူဝ်းၵုၼ်ႇ
product	ထုၵ်ႈဢွၵ်ႇ
production	ႁဵတ်းဢွၵ်ႇ
profession	လူင်ႉလႅၼ်ႇ
professional	လူင်ႉလႅၼ်ႇ
profile	ၾၢင်ႁၢင်ႊ
profit	ၼမ်ႉတွၼ်း
profound	ပဵၼ်ယႂ်ႇပဵၼ်လူင်
progress	ထိုင်တီႈ
project	ၼႃႈၵၢၼ်
prominent	လွင်ႈယႂ်ႇ
promise	ၵႂၢမ်းမၼ်ႈ
promise	ပၼ်ၵႂၢမ်းမၼ်ႈ
promote	ပၼ်ႁႅင်း
promotion	ပၼ်သူးတွၼ်ႈ
prompt	ယူင်းသေႃႇ
prone	ၵႆႇပဵၼ်
pronouns	ႁိၵ်ႈတၢင်
pronunciation	လၢႆးဢွၵ်ႇသဵင်
proof	ၼေလၵ်းထၢၼ်
proper	တေႉတေႉဝႃႈဝႃႈ
properly	တေႉတေႉမီးမီး
properties	တၢင်းၵတ်ႉ
property	လမ်ႉၵတ်ႉ
proposal	ၶေႃႈတၢင်ႇထိုင်
prospect	တၢင်းမုင်ႈမွင်း
prosperity	တၢင်းမုင်ႈမွင်း
prosperous	မၢၵ်ႈမီးႁႅင်းၼႃႇ
protect	ၵႅတ်ႈၶႄ
proud	ၸူမ်းၸွမ်း
prove	ၼေလၵ်းထၢၼ်
provide	ၵမ်ႉထႅမ်
provided	ဝၢင်းၽႅၼ်
province	ၸိုင်ႈမိူင်း
provision	ၵမ်ႉထႅမ်
puberty	ၵေႃႉယႂ်ႇမႃး
public	ၶွင်တင်းၼမ်
pull	ၸၼ်
pumpkin	ပၵ်ႉ
punctual	ၶၢဝ်းမၢၼ်ႇ
pupil	လုၵ်ႈၼွင်ႉ
purchase	သိုဝ်ႉ
pure	သႅၼ်ႈ
purple	သီၵမ်ႇ
purpose	ယိူင်းမၢႆ
purse	ၵဵင်ႈသႂ်
pursue	ၸွမ်းမႃး
pursuit	လမ်းႁႂ်ႈၶိုတ်း
push	တဝ်ႉ
put	သႂ်ႇ
qualification	လမ်ႉၵတ်ႉ
quality	ၼမ်ႉလီ
quantity	တၢင်းၼမ်
quarantine	ပၢင်လိုဝ်ႈႁေႉတၢင်းပဵၼ်
quarrel	ၽိတ်းၽႅၵ်ႇၵၼ်
quarter	သီႇပုၼ်ႈ ၼိူင်ႈပုၼ်ႈ
Quechua	ၶိူဝ်းၶႅတ်ႉသျူႇဝႃႇ
queen	ၼၢင်းႁေႃၶမ်း
queer	လၢၵ်ႇလၢႆး
query	ၸွပ်ႇႁႂ်ႈႁူႉ
question	ၶေႃႈထၢမ်
queue	ၶပ်ႉထႅဝ်
queue	ထႅဝ်ၵူၼ်း
quick	ၽႂ်း
quickly	ဝႆးဝႆး
quiet	ၼိမ်ယဵၼ်
quilt	ယဵတ်ႈသႂ်ႇၵႅၼ်
quit	ဢွၵ်ႇ
quite	တၢၼ်ႇတၢၼ်ႇ
quiz	ၶေႃႈတႃႉ
quotation	ၽိုၼ်ဢိင်ႈ
quote	ၶေႃႈဢၢင်ႈဢိင်ႈ
quote	ဢိင်ႈ
quotes	ယၢင်း
rabbit	ပၢင်တၢႆး
race	လႅၼ်ႈၶႄႉ
rage	ၸႂ်လမ်
rain	ၾူၼ်
raise	ယုၵ်ႉၶိုၼ်ႈ
raise	ၽူႈယုၵ်ႉပူၵ်းတၢင်ႇသုင်
raised	ယုၵ်ႉၶိုၼ်ႈ
ran	လႅၼ်ႈ
random	ၵမ်ႉၺႃး
range	ၶပ်ႉယႆဝႆႉ
rapid	ဝႆးၽႂ်း
rapidly	ဝႆးဝႆး
rare	ဢၼ်ႁႃယၢပ်ႇ
rarely	ဢေႇႁႅင်း
rash	ႁဵတ်းဢမ်ႇဝူၼ်ႉ
rat	ၼူ
rate	တၢင်းဝႆး
rather	လိူဝ်သေ
ratio	လၵ်းၸဵင်ႁိဝ်ႈၸင်ႈ
rational	ၸွမ်းလွင်ႈၸွမ်းတၢင်း
raw	ဢၼ်လိပ်း
re	ၵမ်ႉထႅမ်
reach	ႁွတ်ႈၽႅဝ်
reached	ႁွတ်ႈထိုင်
reaction	တုမ်ႉတွပ်ႇ
read	ဢၢၼ်ႇလိၵ်ႈ
reading	လူလိၵ်ႈ
ready	တူဝ်ႈတၼ်း
real	ဢၼ်တေႉ
reality	ဢွၼ်တေႉ
realize	ဢၼ်တေႉ
realized	ဢၼ်ၸိုဝ်ႈၸႂ်ႈ
really	တေႉတေႉ
rear	ၽၢႆႇတၢင်းတူၵ်း
reason	လွင်ႈတၢင်း
reasonable	မီးလွင်ႈတၢင်း
recall	ႁွင်ႉၶိုၼ်း
receipt	ႁပ်ႉငိုၼ်း
receive	လႆႈႁပ်ႉ
received	ႁပ်ႉလႆႈ
recent	ၵမ်းထိုင်
recently	မိူဝ်ႈဢမ်ႇပႆႇႁိုင်သင်ၼႆႉ
reception	ႁပ်ႉၶၢမ်ႇ
recipe	လၢႆးႁုင်မိုဝ်ႉ
reckless	ဝႆႉမဝ်ႊမၢင်ႊ
recognition	မၵ်းမၼ်ႈပၼ်
recognize	မၢႆတွင်းဝႆႉ
recommend	ပၼ်တၢင်းႁၼ်ထိုင်
recommended	ပၼ်တၢင်းၶႆႈၸႂ်
record	ၶေႃႈမၢႆတွင်း
record	မၢႆတွင်းဝႆႉ
recover	ၶူၼ်ႉၶိုၼ်း
recovery	ၶိုၼ်းဢဝ်ၶိုၼ်း
rectangle	သီႇလႅမ်ႊ
red	သီလႅင်
redeem	လႅၵ်ႈၶိုၼ်းၶူဝ်းၵမ်ႉ
redemption	ၶႄသၢႆၸႂ်
reduce	လူတ်ႈယွမ်း
redundant	လိူင်ႇမၢၵ်ႈ
refer	မၢႆထိုင်
reference	ၽိုၼ်ဢိင်ႈ
reflect	တွၼ်ႉ
reflection	တူၼ်ႉၶိုၼ်း
refrain	ဢဝ်ပၢႆႊမႃး ထိင်းဝႆႉ
refrigerator	တူယဵၼ်
refund	ထွၼ်ပၼ်ငိုၼ်း
refuse	တွပ်ႇထဵင်
refused	ထဵင်ၶိုၼ်း
regard	ၼပ်ႉယမ်
regarding	တူၺ်းလီလီ
regardless	ဢမ်ႇဝူၼ်ႉလီလီ
regards	ယွင်ႈယေႃး
region	လႅၼ်ႊတီႈ
register	သႂ်ႇၸိုဝ်ႈ
regret	ၼႅင်ၸႂ်
regular	ၵူႊပွၵ်ႈ
regularly	ပဵၼ်ၵူႊၽဝ်ႇ
reject	ဢဝ်ဢွၵ်ႇ
relate	ၵိုတ်းလိူဝ်
related	ၵိုတ်း
relationship	လွင်ႈမိုတ်ႈၵိုဝ်း
relative	ၵွင်ႉၵဵဝ်ႇ
relative	ပီႈၼွင်ႉ
relatives	ပီႈၼွင်ႉ
relax	လိုဝ်ႈႁိူဝ်ႉ
release	ပွၺ်ႇပၼ်
released	ၵိုတ်းဝႆႉ
relevant	သၢင်ႇတေႃႇ
reliable	ယုမ်ႇၸႂ်လႆႈ
relief	ၸိုၼ်ႈၶႅၼ်း
relieve	ၶႅၼ်းသႃႇမႃး
relieved	ယႃတၢင်းၸဵပ်း
religion	ၼပ်ႉထိုဝ်
religious	ၵၢၼ်ၼပ်ႉထိုဝ်
reluctant	ဢမ်ႇပႃးၸႂ်
rely	ဢိင်
remain	ၵိုတ်းဝႆႉ
remaining	ၵိုတ်းဝႆႉ
remarkable	ပဵၼ်တီႈတွင်းမၢႆ
remedy	ၶိုင်တၢင်းၽိတ်းႁဵတ်းႁႂ်ႈ မႅၼ်ႈ
remember	တွင်းဝႆႉ
remind	ပၼ်ၽၢင်ႉ
reminder	ၶေႃႈပၼ်ၽၢင်ႉ
remote	ၵႆ
remove	ထွၼ်ပႅတ်ႈ
render	ၸေႇယိမ်
rent	ၵႃႊၶၢတ်ႈ
repair	မႄး
repeat	သမ်ႉထႅင်ႈ
replace	တႅၼ်းၶိုၼ်း
reply	ၶၢၼ်ၶိုၼ်း
report	တၢင်ႇၽိုၼ်
report	လၢႆးငၢၼ်း
represent	တၢင်တူဝ်
reputation	ၶၢဝ်ႇလိုဝ်း
request	တုၵ်းယွၼ်း
require	ယွၼ်းထိုင်
required	ယွၼ်းတၢင်းၸွၺ်ႈထႅမ်
rescue	ၵဵဝ်ႇၶေ
research	ၶူၼ်ႉၶႂႃႉ
resemble	မိူၼ်
resentment	ႁၢမ်းသိၵ်ႈၶႃႇ
reservation	ဢွင်ႈၶေႃၶေႃ
reserve	ၶေႃၶေႃ
resident	ၵူၼ်းယူႇသဝ်း
resign	ထွၼ်တူဝ်
resilience	ၶၢမ်ႇတၢမ်ႇလႆႈ
resilient	ၶၢမ်ႇတၢမ်ႇ
resist	ၸင်ႈၶၢမ်ႇ
resistance	ၸင်ႈၶၢမ်ႇ
resolution	ၶေႃႈယၼ်ႇၸႂ်
resolve	ၵေႈလိတ်ႈ
resort	တီႈလိုဝ်ႈသဝ်း
resources	ၶူဝ်းတိုၼ်း
respect	ၼပ်ႉယမ်
respond	တုမ်ႉတွပ်ႇ
response	တုမ်ႉတွပ်ႇ
responsibility	ပုၼ်ႈၽွၼ်း
responsible	လီပိုင်ႈဢိင်
rest	လိုဝ်ႈႁိူဝ်ႉ
rest in peace	ႁႂ်ႈၵႂႃႇႁွတ်ႈတီႈၵတ်းယဵၼ်
restaurant	ႁၢၼ်ႉတၢင်းၵိၼ်
restore	ၶိုၼ်းဝႆႉၶိုၼ်း
restrict	မၵ်းၶၼ်ႈ
result	ၶေႃႈၵမ်းလိုၼ်း
results	ၼမ်ႉတွၼ်း
resume	မႄးတႄႇမႂ်ႇ
retail	ၶၢႆလုမ်း
retain	ထိင်းသိမ်း
retention	ယင်ႇမၼ်ႈဝႆႉ
retired	ဝၢင်းလိုဝ်ႈၵၢၼ်
retreat	ႁူၼ်လင်
retrieve	ၶၢမ်ႇၽွၼ်းႁၢႆႉ
return	ပွၵ်ႈၶိုၼ်း
reveal	ပၼ်ႁူႉ
revealed	ၽုၺ်ႇၶႆႊ
revenge	တွပ်ႇတႅၼ်း
revenue	ငိုၼ်းၶွၼ်ႇ
reverse	ပိၼ်ၾူၼ်
review	ႁုပ်ႈတူၺ်းၶိုၼ်း
review	ၽိုၼ်ႉတူၺ်း
revise	ၶိုၼ်းတူၺ်း
revision	လိုမ်ႉၶိုၼ်း
revolution	လုၵ်ႉၽိုၼ်ႉ
reward	သူး
rhythm	ၸၢပ်ႇလႅပ်ႈ
rib	လုပ်ႇသၼ်လင်
rice	ၶဝ်ႈ
rich	မၢၵ်ႈမီး
rid	ပၢႆႇဢွၵ်ႇ
ride	ၶီႇ
ridiculous	တၢင်းၶႂ်ႈၶူဝ်
right	မႅၼ်ႈ
right now	ယၢမ်းၼႆႉ
rigid	ၶိူင်ႇၶမ်ႉ
ring	ႁၢင်ႊၸွပ်ႇ
rinse	သုၵ်ႈၼမ်ႉ
riot	တွၼ်ႊလမ်ႇလွင်ႈ
rip	သိၵ်ႇ
rip	ႁူၼ်လင်
ripe	သုၵ်း
rise	တၢင်းၶိုၼ်ႈ
risk	ပဵၼ်ၽွၼ်းႁၢႆႉ
risk	ၽွၼ်းႁၢႆႉ
rival	ၽူႈၶႄႉၶဵင်ႇ
river	ၼမ်ႉၵေး
road	သဵၼ်ႈတၢင်း
roast	ယၢင်ႉ
robust	ၶိူင်ႇၶမ်ႉ
rock	ၽႃႁိၼ်
rod	လူၼ်ႈလဵၵ်း
role	ၽူႈလဵၼ်ႈၸိူင်း
roll	ဢိင်ႈ
roof	ႁၢၵ်ႈမႆႉ
room	ႁွင်ႈ
root	ႁၢၵ်ႈမႆႉ
rope	ၸိူၵ်ႈ
rotten	ၼဝ်ႈ
rough	ဢၼ်ဢမ်ႇၶျေုး
roughly	ၵႅမ်းဝႆႉ
round	ႁွပ်ႈ
route	သဵၼ်ႈတၢင်း
routine	ၵၢၼ်ၵူႊဝၼ်းဝၼ်း
row	ထႅဝ်ၼွၼ်း
rub	ထူ
rubber	ၵွတ်ႈမွတ်ႇ
rubbish	ယုၵ်ႉယၢၵ်ႉ
rude	ဢၼ်လိူင်း
rug	ၽႅၼ်ႇထူၶီႈတိၼ်
ruin	လူႉလႅဝ်
rule	ဢုပ်ႇပိူင်ႇ
ruler	မႆႉထတ်း
rules	ဢုပ်ႇပိူင်ႇ
run	လႅၼ်ႈ
running	လႅၼ်ႈ
rural	မၢၼ်ႈၼွၵ်ႈ
rush	မႆႉဢေႃႈ
rush	ၵႂႃႇဝႆးဝႆး
sack	ထူင်ၶဝ်ႈ
sacred	ဝႆႉၼၵ်း
sacrifice	ပွၺ်ႇၽႃႈ
safe	တိူၵ်ႈဝႆႉငိုၼ်း
safe	လွတ်ႈၽေး
safe flight	ဝိၼ်လွတ်ႈၽေး
safety	လွတ်ႈၽေး
sage	မီးတၢင်းဝူၼ်ႉလီ
said	လၢတ်ႈ
sail	ႁေႃႈႁိူဝ်းလူမ်း
sailing	ဝၢႆႈႁိူဝ်းလူမ်း
sake	လဝ်ႈၸပၢၼ်ႇ
salary	ငိုၼ်းလိူၼ်
sale	ၶၢႆ
salmon	ပႃသႄႇမုၼ်ႇ
salt	ၵိူဝ်
same	မိူၼ်ၵၼ်
Same here	တီႈၼႆႈၵေႃႈမိူၼ်ယဝ်ႉ
sample	တူဝ်ယၢင်ႇ
sand	သၢႆး
Sanskrit	ၶိူဝ်းသၢၼ်းသၶရိတ်ႉ
sarcastic	တၢၼ်ႈၵၵ်ႉ
sassy	ဢမ်ႇသၢင်းၽႂ်
sat	ၼင်ႈ
satisfaction	ပဵင်းပေႃး
satisfied	ပဵင်းပေႃး
satisfy	လႅၵ်ႈသၢၵ်ႈၸႂ်
satisfying	လႅၵ်ႈသၢၵ်ႈၸႂ်
Saturday	ဝၼ်းသဝ်
sausage	သႆႈယဵတ်ႈ
savage	လိူင်း
save	ၵဵဝ်ႇၶေ
saw	ႁၼ်
say	လၢတ်ႈ
scale	တၢင်းတႅၵ်ႈ
scam	လွၵ်းလိင်ႉ
scam	ၵူၼ်းလိူင်း
scar	ႁွၺ်းဢၢတ်ႉ
scarce	ယၢပ်ႇယၢပ်ႇယိၼ်းယိၼ်း
scared	လီၵူဝ်
scarf	ၽႃႈပၢႆႉၶေႃး
scary	လီၵူဝ်
scattered	ၸႅၵ်ႇၸုမ်း
scene	ဢွင်ႈတီႈပဵၼ်ၼၼ်ႉ
scenery	လႅၼ်ႊမုင်ႈၾိင်ႈငၢမ်း
scent	ဢၢႆႊႁွမ်
schedule	ၶပ်ႉမၢႆ
school	ႁူင်းႁဵၼ်း
science	ပၢႆးသၢႆႊ
scientist	ၸဝ်ႈပၢႆးသၢႆႊ
scientists	ၸဝ်ႈပၢႆးသၢႆႊ
scissors	ၵိမ်း
scold	မေႃး
scope	တၢင်းႁၼ်
score	မၢႆဝၢၵ်ႈ
scrap	ပိတ်းပွတ်း
scratch	တိူၼ်ႇ
scream	သႅၼ်ႇႁွင်ႉ
screen	ၼႃႈပဵင်း
screw	သႆႈမူ
script	ထႅဝ်လိၵ်ႈၵႂၢမ်းလၢတ်ႈ
sea	ပၢင်ႇလၢႆႇ
seal	မူၼ်ႈ
search	သွၵ်ႈႁႃ
season	ၾိင်ႈၾႃႉ
seat	တီႈၼင်ႈ
second	သိၵ်ႈ
secret	လွင်ႈသိူင်ႇသိမ်း
section	ပွတ်းတွၼ်ႊ
secure	လွတ်ႈၽေး
security	လွင်ႈႁူမ်ႇလူမ်ႈ
see	ႁၼ်
see you	ၵွၺ်ႈထူပ်းၵၼ်
see you later	ၵွၺ်ႈထူပ်းၵၼ်
see you soon	ၵွၺ်ႈထူပ်းၵၼ်
see you tomorrow	မိူဝ်ႈၽုၵ်ႈထူပ်းၵၼ်
seed	မဵတ်ႉၾၼ်း
seek	ႁၼ်ယဝ်ႉ
seem	ႁၼ်
seems	ႁၼ်
seen	ႁၼ်
seize	ၺွပ်း
seizure	ၺွပ်း
seldom	မၢင်ႊပွၵ်ႈ
select	လိူၵ်ႈ
self	ႁင်းၵွၺ်း
self healing	ယႃတူဝ်ၸဝ်ႈၵဝ်ႇ
selfish	ႁၼ်ပုၼ်ႈသုၼ်ႇတူဝ်
sell	ၶၢႆ
send	သူင်ႇ
send me your picture	သူင်ႇပၼ် ၶႅပ်းႁၢင်ႊသူလူး
senior	ၸၼ်ႉယႂ်ႇ
sense	ၶုၺ်ႉႁူႉ
sensible	ဝူၼ်ႉ
sensitive	တိူဝ်ႉဢမ်ႇလႆႈ
sent	သူင်ႇ
sentence	တူၼ်ႈထႅဝ်ႈ
sentences	တူၼ်ႈထႅဝ်
separate	ၶၼ်ႈဝႆႉ
separate	ၸႅၵ်ႇဝႆႉ
Sepedi	ၶိူဝ်းသႄႉပတီႇ
september	လိူၼ်ၵဝ်ႈ
sequence	လွၵ်းၸိူင်း
sequence	ၶပ်ႉမၢႆ
series	ပဵၼ်သွၺ်ႈ
serious	ဝူၼ်ႉလိုၵ်ႉ
seriously	တေႉတေႉ
serve	ႁဵတ်းလဵင်ႉ
service	ၸွင်းၸေး
session	ပၢင်ၵုမ်သၽႃး
set	ၶပ်းသၢင်ႈ
set	ပဵၼ်ၸုမ်ႇ
set up	ႁဵတ်းသၢင်ႈ
setting	တီႈမႄး
settle	ယဝ်ႉတူဝ်ႈ
seven	ၸဵတ်း
seventeen	သိပ်းၸဵတ်း
seventy	ၸဵတ်းသိပ်း
several	ၼမ်ၼမ်လၢႆလၢႆ
severe	ႁၢဝ်ႈ
sew	သွၺ်
sh	သျိူဝ်ႇ
shade	ႁူမ်ႈ
shadow	ႁူမ်ႈ
shake	ၶဝ်ႇ
shall	တေလႆႈ
shallow	ဢိုၼ်
shallow	တိုၼ်ႈ
shame	တၢင်းဢၢႆ
Shan	တႆး
shape	ႁၢင်ႊလႅမ်ႊ
share	ပိုၼ်ႊၽႄ
sharp	ၽၢႆ
she	မၼ်းၼၢင်း
she has	မၼ်းမီး
she is	မၼ်းပဵၼ်
shed	လၢႆႊၶၢပ်ႈ
sheep	တူဝ်း
sheet	မၢင်ႊၸေႈ
shelf	ၶဵင်ႇ
shell	ၵၢပ်ႇႁွၺ်
shelter	ႁေႉၵင်ႈ
shield	ၵၢပ်ႇႁေႉ
shift	ၶၢႆႉလၢႆႊ
shine	ပိူင်း
ship	ႁိူဝ်း
shipping	ဢွၵ်ႇႁိူဝ်း
shirt	သိူဝ်ႈသိူတ်ႉ
shoes	သွၵ်းတိၼ်
shoot	ယိုဝ်း
shop	ႁၢၼ်ႉၶၢႆၶွင်
shopping	ၸၢႆႇၵၢတ်ႇ
shore	ႁၢတ်ႇသၢႆးပၢင်ႇလၢႆႇ
short	ပွတ်း
shortage	လူဝ်ဝႆႉ
shot	ပိုတ်း
shot	ယိုဝ်းၵွင်ႈ
should	ထုၵ်ႇလီ
shoulder	ႁူဝ်မႃႇ
shout	ပၢဝ်ႇ
show	ၼေ
show	ပၢင်ပွၺ်းၼေ
show me	ၼေႁဝ်းလူး
shower	ဢၢပ်ႇၼမ်ႉ
shrimp	ၵုင်ႈ
shrink	ႁူတ်း
shut	ဢိုတ်း
shut up	ဢိုတ်းသူပ်း
shy	ဢၼ်ဢၢႆ
sibling	ပီႈၼွင်ႉ
siblings	ပီႈၼွင်ႉ
sick	ၼၢဝ်
side	ၸွမ်းပႃႈၸွမ်းၽၢႆႇ
side	ၶၢင်ႈ
sigh	မဵတ်ႇမၢႆ
sight	ဢႃႇႁူင်ႇႁၼ်
sightseeing	တႃႈမုင်ႈႁၼ်
sign	လူင်းလၢႆးမိုဝ်း
signature	လၢႆးမိုဝ်း
significant	ဢၼ်လၢၵ်ႇလၢႆး
silence	တဵတ်ႇယဵၼ်
silent	တဵတ်ႇယဵၼ်
silk	မၼ်ႈလၢႆႈ
silly	ၶလႅၵ်ႉ
silver	ငိုၼ်း
similar	မိူၼ်ၵၼ်
simp	ယူဝ်းယူဝ်း
simple	ၽဵၼ်ႈၽဵၼ်ႈ
simultaneously	ပဵၼ်ၶၢဝ်းလဵဝ်
since	တႄႇၼၼ်ႉမႃး
sincere	ဢမ်ႇၵျႃး
sincerely	ဢမ်ႇၵျႃး
sing	ႁွင်ႉၵႂၢမ်း
singer	ၽူႈႁွင်ႉၵႂၢမ်း
single	ၵေႃႉလဵဝ်
sink	ၶဵင်ႇၼမ်ႉ
sink	ၸူမ်
Sir	သြႃႇ
sister	ပီႈသၢဝ်
sister in law	ၼွင်ႉပႂ်ႉ
sit	ၼင်ႈ
site	ၼႃႈလိၼ် တီႈမၵ်းမၼ်ႈယဝ်ႉ
situation	လႅၼ်ႊတီႈ
situation	ငဝ်းလၢႆး
six	ႁူၵ်း
sixteen	သိပ်းႁူၵ်း
sixty	ႁူၵ်းသိပ်း
size	တၢင်းယႂ်ႇ
skill	လမ်ႉၵတ်ႉ
skills	လမ်ႉၵတ်ႉ
skin	ၽိဝ်ၼိူဝ်ႉ
skinny	ၼိူဝ်ႉႁေႃႇလုပ်ႇ
skip	ၶၢမ်ႈပႅတ်ႈ
skirt	သိၼ်ႈၵပူင်း
sky	တွင်ႉၾႃႉ
slave	ၶီႈၶႃႈ
sleep	ၼွၼ်း
sleeping	ၼွၼ်းဝႆႉ
sleepy	ၼွၼ်းဝၢၼ်
sleeve	ၶႅၼ်သိူဝ်ႈ
slice	ႁဵတ်းမၢင်ႊမၢင်ႊ
slice	ၶႅပ်း
slide	ထူၸၼ်း
slightly	ဢိတ်းဢွၼ်ႇ
slim	သေးသွၺ်ႇ
slip	ပလၢတ်ႈ
slope	ၸၼ်း
slot	ႁူးသႂ်ႇငိုၼ်း
slow	ထိူင်း
slowly	ထိူင်းထိူင်း
small	လဵၵ်ႉ
smart	လႅတ်း
smell	ၼူမ်
smell	ဢၢႆႊသႅဝ်
smile	ယုမ်ႉ
smoke	လုတ်ႇလႅၼ်းယႃႈ
smooth	လိူမ်ႈလႆ
snack	တၢင်းၵိၼ်လဵၼ်ႈ
snail	ႁွၺ်
snake	ငူး
snap	ၸၵ်ႉဢဝ်
snow	မူၺ်
so	ပေႃႉၼၼ်
so cute	လီႁၵ်ႉထူၼ်ႈ
so far	ၵႆၼႃႇ
soak	ၽေႃႉ
soap	ၵွၼ်ႈသီ
sober	ထိင်းတူဝ်ၵဝ်ႇ
soccer	မၢၵ်ႇၼင်ႈလွမ်ႊ
social	တူင်ႇၵူၼ်း
society	တူင်ႇၵူၼ်း
socks	ဝႃႇတိၼ်
soft	ဢူၼ်ႈဢွၼ်ႇ
software	သွပ်ႉဝႄး
soil	လိၼ်
sold	ၶၢႆ
sold out	ၶၢႆဢွၵ်ႇ
soldier	လုၵ်ႈသိုၵ်း
sole	ၽႃႇတိၼ်
solid	ၶူဝ်းၵွၼ်ႈ
solution	ၶေႃႈၵေႈၶႆႈ
solve	ၵေႈၶႆႈ
some	မၢင်ဢၼ်
somebody	သေၵေႃႉၵေႃႉ
somehow	လၢႆးလႂ်ၵေႃႈယဝ်ႉ
someone	သေၵေႃႉၵေႃႉ
something	သေလွင်ႈလွင်ႈ
sometimes	သေၶၢဝ်းၶၢဝ်း
song	ၵႂၢမ်း
soon	ဢမ်ႇႁိုင်သင်
sophisticated	တူဝ်ထူပ်း
sophisticated	ၶိုတ်းၵၢပ်ႈ
Sorani	ၶိူဝ်းသေႃႇရႅၼ်ႇၼီႇ
sore	တၢင်းၸဵပ်း
sore	ၸဵပ်း
sore throat	ၶေႃးၸဵပ်း
sorrow	တုၵ်ႉၸႂ်
Sorry	ၶႂၢင်းပၼ်ဢိတ်းၼိုင်ႈၶႃႈ
sort	မဵဝ်းမိူၼ်
sought	သွၵ်ႈႁႃ
soul	ၶႂၼ်ငဝ်း
soulmate	ဢူၺ်းၵေႃႉ ၸႂ်မိူၼ်
sound	သဵင်
soup	ထၢင်ႊ
sour	သူမ်ႈ
source	ငဝ်ႈတိုၼ်း
south	ၽၢႆႇၸၢၼ်း
space	ၵွင်းၵၢင်ႇ
spam	လိၵ်ႈဢမ်ႇပႆႇလႆႈၶႂၢင်ႉ
span	တႅၵ်ႈ
Spanish	ၵႂၢမ်းသပဵင်ႇ
spare	လိူဝ်ဝႆႉ
spare	ဢၼ်လိူဝ်
speak	လၢတ်ႈ
special	ဢၼ်ၶိုၵ်ႉ
species	မဵဝ်းသႅၼ်း
specific	မဵဝ်းသႅၼ်း
spectacular	ႁၢင်ႊလီ ၶိုၵ်ႉၶႅမ်ႉ
speech	တၢၼ်ႈၶႆႊ
speechless	ဢမ်ႇမီးၵႂၢမ်းလၢတ်ႈ
speed	တၢင်ႉဝႆး
spell	လေႃးတူဝ်လိၵ်ႈ
spend	ၸႂ်ႉၸၢႆႇ
spent	ၸၢႆႇပႅတ်ႈ
spicy	ၽဵတ်း
spike	တေႃလွၵ်ႇ
spin	လိမ်ႇ
spinach	ၽၵ်းႁူတွပ်း
spirit	ၸႂ်ႊႁူႉ
spit	ၼမ်ႉလၢႆး
splendid	ယႂ်ႇလူင်ယႂ်ႇလၢင်
split	ၽႃႇ
spoil	ယႃႉ
spoiled	ယႃႉ
spontaneous	တိုၼ်းပဵၼ်မႃး
spoon	ၸေႃႉ
spot	ႁွၺ်းမၢတ်ႇ
spouse	ၽူဝ်မေး
spread	ၽႄႈၸွတ်ႇၵႂႃႇ
spring	ၶၢဝ်းႁွင်
square	သီႇလႅမ်ႊပဵင်း
squeeze	မိပ်ႇ
squid	ပႃမိုၵ်ႉ
squirrel	ၸွၼ်ႈ
st	သထ
stab	တႅင်း
stable	မၼ်ႈဝႆႉ
stack	တၢင်ႇထႅင်ႈ
staff	ဢဵၼ်ႁႅင်းၵူၼ်းႁဵတ်းၵၢၼ်
stage	ၶဵင်ႇၸၢတ်ႈ
stain	ၵူဝ်ႈဢိူၵ်ႇ
stairs	ၶူဝ်လႆ
stake	ပုၵ်းသဝ်
stalk	ၼီႇ
stall	ႁၢၼ်ႉၶၢႆတၢင်းၵိၼ်ယွၺ်ႈ
stamp	ၸုမ်ႈၶွၼ်ႇ
stand	လုၵ်ႉၸုၵ်း
stand	မႆႉတင်ႈ
standard	လၵ်းၸဵင်
standard	ၸၼ်ႉ
star	လၢဝ်
start	တႄႇ
started	တႄႇ
starving	တွင်ႉမႆႈႁႅင်းၼႃႇ
state	မွၵ်ႇလၢတ်ႈၼႄ
state	မိူင်း
statement	လိၵ်ႈပိုၼ်ႊၽၢဝ်ႇ
station	တႃႈလူတ်ႉ
statue	ႁုၼ်ႇႁၢင်ႊ
status	ႁုၼ်ႇႁၢင်ႊ
stay	ဢွင်ႈယူႇ
stay	ယူႇသဝ်း
stay safe	ယူႇလွတ်ႈၽေး
steady	ဝိုၼ်းဝိုၼ်း
steak	ၼိူဝ်ႉဝူဝ်းၸီႇ
steal	လၵ်ႉ
steam	ၵႂၼ်းၼမ်ႉမႆႈ
steel	လဵၵ်ႉလေႃႇ
steep	ၸၼ်း
stem	ၶႃႊမႆႉ
step	ၸၼ်ႉ
stick	ၶမ်
stick	တိင်
stick	ၶွၼ်ႉ
stiff	ၸင်ႈဝႆႉ
still	တေႃႇထိုင်
sting	ၼၢမ်ပၵ်း
stingy	ၸဵပ်းၵႅၼ်း
stir	ၵဝ်း
stock	ၶူဝ်းဝၢင်းဝႆႉၼႂ်းမိုဝ်း
stolen	လၵ်ႉ
stomach	ႁူင်းၶဝ်ႈ
stone	ၵွၼ်ႈႁိၼ်
stood	လုၵ်ႉၸုၵ်ႉ
stool	တိၼ်မႃ
stop	ၵိုတ်း
storage	တီႈသိမ်းၶူဝ်း
store	သိမ်းဝႆႉ
storm	လူမ်းလႅင်ႉ
story	ဢႃႊပုမ်ႇ
stove	ပုင်းၾႆး
straight	သိုဝ်ႈသိုဝ်ႈ
straightforward	ၵႂႃႇသိုဝ်ႈသိုဝ်ႈ
strain	ၸိုၼ်ႇ
strange	ပႅၵ်ႈပႅၵ်ႈ
stranger	ၵူၼ်းပႅၵ်ႈၼႃႈ
strategy	လွၵ်းလၢႆးဝၢင်းၽႅၼ်
straw	လွတ်ႇၼမ်ႉ
strawberry	မၢၵ်ႇႁူႈလိၼ်
streak	ၶိူဝ်းယႂ်း
stream	ႁွင်ႊ
street	သဵၼ်ႈတၢင်း
strength	ႁႅင်း
stress	ဝႆႉၼၵ်း
stretch	ၸၼ်
strict	ပၵ်းပိူင်ယႂ်ႇ
strike	တႅၼ်ႇ
strike	ၼေၵၢင်ၸႂ်
string	သၢႆ
strip	ၼွၵ်ႈ
strive	ၶတ်းၸႂ်
stroke	ႁွၺ်းမင်ႈ
strong	ႁႅင်းယႂ်ႇ
struck	တႅၼ်ႇ
structure	ပိူင်ၽၢင်
struggle	တေႃႇသူႈ
struggling	လႆႈၸိုၼ်ႇၽိုၼ်ႉ
stubborn	ႁူဝ်ၶႅင်
stuck	ၶမ်ဝႆႉ
student	လုၵ်ႈႁဵၼ်း
study	လဵပ်ႈႁဵၼ်း
study	ၽိုၼ်လိၵ်ႈ
studying	ၽိုၵ်းႁဵၼ်း
stuff	ၶူဝ်းၶွင်
stunning	ႁၢင်ႊလီ
stunning	လိုမ်းႁၢင်ႊလိုမ်းတူဝ်
stupid	ငိူဝ်ႈငႃႉ
style	ႁၢင်ႊသွၺ်ႇ
subject	ပၢႆးၾၢႆႇ
submission	သႂၢင်းၶဝ်ႈ
submit	သူင်ႇၸူး
substance	ၶူဝ်းၶွင်
substitute	တႅၼ်းတၢင်
subtle	ဢူၼ်ႈဢွၼ်ႇ
succeed	ဢွင်ႇမၢၼ်
success	ဢွင်ႇမၢင်ႇ
successful	ဢွင်ႇမၢၼ်
such	မိူၼ်ၼင်ႇ
such as	ၸိူဝ်းၼႆႉ
suck	ၸုတ်း
sudden	ၵမ်းသိုဝ်ႈ
suddenly	ၵိုင်ႉၵၢင်ႉ
suffer	တၢင်းၸဵပ်း
suffering	လႆႈၶၢမ်ႇဝႆႉ
sufficient	တဵမ်ထူၼ်ႈ
sugar	ၵိူဝ်ဝၢၼ်
suggest	ပၼ်တၢင်းႁၼ်ထိုင်
suggestion	တၢင်းႁၼ်ထိုင်
suit	သိူဝ်ႈတုၺ်ႇ
suit	ၵိုင်ႇတၢၼ်ႇ
suitable	ၵိုင်ႇငမ်ႇ
suitcase	တူၵ်ႈၶူဝ်း
sum	လေႃး
summary	ၶေႃႈလူပ်း
summer	ၶၢဝ်းမႆႈ
summit	ႁပ်ႉၶၢမ်ႇ
sun	တႃဝၼ်း
sunday	ဝၼ်းတိတ်ႉ
sunny	လႅတ်ႇလီ
sunset	ဝၼ်းတူၵ်း
sunshine	လႅတ်ႇထွင်ႇ
super	ထႅၼ်ႊ
superior	တွၼ်းၶႅမ်ႉ
supervisor	မေႃယႃလူင်
supper	တႃႇၶဝ်ႈၶမ်ႈၶိုၼ်း
supply	လွင်ႈၸွၺ်ႈထႅမ်
supply	ၶဝ်ႈၸွၺ်ႈ
support	လွင်ႈၵမ်ႉထႅမ်
suppose	ၸွၺ်ႈထႅမ်
supposed	ၵမ်ႉၸွၺ်ႈ
sure	မၼ်ႈၸႂ်
surface	ၽိုၼ်ၼႃႈ
surge	ပိူမ်ႉၼမ်ႉလူင်
surgery	ၽႃတတ်း
surname	ၸိုဝ်ႈၶိူဝ်းႁိူၼ်း
surprise	လီဢၢမ်း
surprised	ႁဵတ်းႁႂ်ႈဢၢမ်း
surrender	ဝၢင်းၶိူင်ႈ
surrounding	ႁိမ်းႁွမ်း
surveillance	ပႂ်ႉတူၺ်း
survey	ၵဵပ်းဝႆႉၶေႃႈမုၼ်း
survey	ၵဵပ်းၶေႃႈမုၼ်း
survive	ၶီးၸိုၼ်ႈ
suspect	ဢမ်ႇလွတ်ႈထၢင်ႇထိူမ်
suspect	ထၢင်ႇထိူမ်
suspended	တိင်ႇတွၺ်
suspicious	ထၢင်ႇထိူမ်
sustain	ပၼ်ၽွၼ်း
sustainability	ထိင်းလႆႈယဝ်ႉ
sustainable	ထွၵ်ႈဝႆႉ
swag	ယွၺ်ႉတူၵ်း
swallow	ဢိုၼ်
swap	လႅၵ်ႈၶူဝ်းၵုၼ်ႇတေႃႇၵၼ်
swear	လၢတ်ႈၵႂၢမ်းလိူင်း
sweat	ႁိူဝ်ႇ
sweater	သိူဝ်ႈထူဝ်း
sweep	ပတ်းႁိူၼ်း
sweet	ဢၼ်ၸဵမ်းၸဵမ်း
sweet dreams	ၾၼ်လီ
sweet tooth	ႁိူၵ်ႇၵႂ်ႊ
sweetheart	ၵေႃႉႁၵ်ႉ
swell	ၵႂ်ႊမႃး
swelling	ၵႂ်ႊ
swim	လုၺ်းၼမ်ႉ
swimming	လုၺ်းၼမ်ႉ
swing	သူင်ႇဢူႇ
swing	ဢူင်ႈၸႃး
switch	သႅၼ်ႇ
switch	ၼဵၼ်ၾႆး
swollen	ဢိုၼ်
sword	လႅဝ်း
symbol	မဵတ်ႇမၢႆ
sympathy	ၸႂ်ဢီးလူ
symptoms	ပိူင်ၽၢင်တၢင်းပဵၼ်
system	ယူင်ႉ
table	ၽိူၼ်
tackle	ယိပ်းၵမ်
tag	ႁွၺ်ႈၽႅၼ်
tail	ႁၢင်
take	ဢဝ်
take away	ဢဝ်ပႅတ်ႈ
take care	လုမ်းလႃးတူၺ်းထိုင်
take off	ထွတ်ႇ
taken	ဢဝ်မႃး
talk	ဢုပ်ႇဢေႃး
talkative	သူပ်းၼမ်
tall	သုင်
tap	ၽွၵ်ႈ
tap	ၵွၵ်ႉၼမ်ႉ
tape	ၸေႈတိင်
target	ပဝ်ႉမၢႆ
task	ပုၼ်ႈၽွၼ်း
taste	ၼမ်ႉလႅမ်ႈ
taste	ၸိမ်း
tasty	ဝၢၼ်
taught	သွၼ်
tea	ၼဵင်ႈ
teach	သွၼ်
teacher	မေႃသွၼ်
team	ၸုမ်း
tear	သိၵ်ႇ
tear	ၼမ်ႉတႃ
tears	ၼမ်ႉတႃ
tease	ဝီၶူၼ်တူဝ်း
technology	ပၢႆးၸၢင်ႊ
teeth	ၶဵဝ်ႈ
tell	ၶႆႊ
tell me	ၶႆႊႁဝ်းလူး
temper	ၶူၼ်းၸွမ်းၸင်ႈၽဵင်ႇ
temperature	တၢင်ႉမႆႈ
temple	ၵျွင်းၽြႃး
temporary	ၸူဝ်ႊၵႅပ်ႉ
ten	ၼိူင်ႈသိပ်း
ten thousand	ၼိူင်ႈမိုၼ်ႇ
tenant	ႁိူၼ်းၶၢတ်ႈ
tend	လဵင်ႉလူလုမ်းလႃး
tendency	ၶွၼ်းဝႆ
tender	သႂၢင်းၵုၼ်ႇ
tense	ၸႂ်ႈမႆႈ
tension	ၶဵင်ႈၶႅင်
tent	သုမ်ႉ
tentative	ဢၼ်ၸၢမ်း
term	ၶၢဝ်းယၢမ်းမၵ်းမၼ်ႈ
terms	ထွၺ်ႈၵႂၢမ်း
terrible	ႁူၵ်ႉႁၢႆႉ
terrific	ၼႃႈလီၵူဝ်
territory	လႅၼ်ႊပိူင်ႇငမ်း
test	ထတ်းထိၼ်
text	လိၵ်ႈပွတ်း
than	လိူဝ်သေၼႆႉ
thank	ယိၼ်းၸူမ်း
thank you	ယိၼ်းၸူမ်းယဝ်ႉၶႃႈ
Thank you for your patience while we investigate shipment	ငိၼ်းၸူမ်းၶွပ်ႈၸႂ်ဢၼ်ဝႆႉၸႂ်ယၢဝ်းသေပႂ်ႉၽွင်းယၢမ်းမိူဝ်ႈတိုၵ်ႉဢုပ်ႇၵုမ်လွင်ႈသူင်ၶူဝ်းၶွင်ယူႇၼၼ်ႉ။
thank you so much	ယိၼ်းၸူမ်းၼမ်ၼမ်
thank you very much	ယိၼ်းၸူမ်းၼမ်ၼမ်ၶႃႈ
thanks	ယိၼ်းၸူမ်း
Thanks for using our app	ယိၼ်းၸူမ်းတီႈ ၸႂ်ႉဢႅပ်ႉၶႃႈၶဝ်
that	ဢၼ်ၼၼ်ႉ
that is	ၼၼ်ႉပဵၼ်
that's good	ၼႆႉလီယဝ်ႉ
the	ဢၼ်
theft	တၢင်းၽိတ်းလၵ်ႉၶူဝ်း
their	ၶွင်ၸိူဝ်းၶဝ်
them	ၸိူဝ်းၶဝ်
theme	ၶေႃႈမုၼ်းလိၵ်ႈႁွမ်တွမ်ႊ
themselves	ၸိူဝ်းၶဝ်ၵွၺ်း
then	ပေႃးၸိူင်ႉၼၼ်
theory	ၽိင်ႈတႅၵ်ႈ
there	တီႈၼၼ်ႈ
there are	မီးၸိူဝ်းၼႆႉ
there is	ၼႆႉမီး
therefore	ၵွပ်ႈၸိူင်ႉၼၼ်လႄႈ
these	ၸိူဝ်းၼႆႉ
they	ၶဝ်
they are	ၶဝ်ပဵၼ်
thick	ၼႃ
thief	ၽူႈလၵ်ႉ
thigh	ဝိုၼ်း
thin	ယွမ်
thing	ၶူဝ်းၶွင်
things	ၶူဝ်းၶွင်
think	ၶႆႈၸႂ်
third	ထီႈသၢမ်
thirsty	ႁႃႇႁႅင်ႈ
thirteen	သိပ်းသၢမ်
thirty	သၢမ်သိပ်း
this	ဢၼ်ၼႆႉ
this is	ဢၼ်ၼႆႉပဵၼ်
thorough	ၶၢမ်ႈပူၼ်ႉ
thoroughly	ဢၼ်တဵမ်ထူၼ်ႈ
those	ၸိူဝ်းၼၼ်ႉ
though	ပႅၵ်ႉသမ်ႉဝႃႈ
thought	ဝူၼ်ႉ
thoughtful	မီးပၢႆးဝူၼ်ႉလီ
thoughts	ဝူၼ်ႉ
thousand	ၼိူင်ႈႁဵင်
thread	မႆ
threat	ၶိူဝ်ႈ
threaten	ၶိူဝ်ႈ
three	သၢမ်
threshold	ၶွပ်ႇၽၵ်းတူ
thrilled	ငႅဝ်
thrive	မၢၵ်ႈမီး
throat	လွတ်ႇၶေႃး
through	ၶၢမ်ႈၵႂႃႇ
throughout	လတ်းၶၢမ်ႈ
throw	ဝိုတ်း
thumb	ႁူဝ်မႄႈမိုဝ်း
thunder	ၾႃႉလင်ႊ
Thursday	ဝၼ်းၽတ်း
thus	ယွၼ်ႉၼၼ်
tick	ၼႃ
tide	ပဵင်းၵၼ်
tidy	မႄးၶပ်း
tie	မတ်ႉ
tie	သၢႆႁတ်းၶေႃး
tiger	သိူဝ်
tight	ၵိုမ်းၵိုမ်း
Tigrinya	ၶိူဝ်းထီႇၵရိၼ်ႇၼီႇယႃႇ
time	ၶၢဝ်းယၢမ်း
timid	လီၵူဝ်
tiny	လဵၵ်ႉဢႅၼ်
tip	ပၢႆ
tips	ငိုၼ်းသူး
tire	မၢၵ်ႇလေႃႉလူတ်ႉ
tired	ႁိူဝ်ႉ
tissue	ၸေႈၸဵတ်ႉ
title	ႁူဝ်ၶေႃႈ
to	ထိုင်
to be	တႃႇတေပဵၼ်မႃး
toast	ၶဝ်ႈမုၼ်းၸီႇ
today	မိူဝ်ႈၼႆႉ
toddler	လုၵ်ႈဢွၼ်ႇလႅင်
toes	ႁူဝ်မႄႈတိၼ်
together	ၸွမ်းၵၼ်
toilet	ထၢင်
told	ၶႆႊ
tolerance	တၢင်းယိူၼ်ႉၵၼ်ႈ
tolerate	ဢမ်ႇႁၢမ်ႈတၢပ်ႈ
tomato	မၵ်ႇၶိူဝ်သူမ်ႈ
tomorrow	မိူဝ်ႈၽုၵ်ႈ
tongue	လိၼ်ႉ
tonight	ၶမ်ႈၼႆႉ
too	ၵေႃႈ
took	ဢဝ်ယဝ်ႉ
tool	ၶူဝ်းၶိူင်ႈ
tools	ၶိူင်ႈၸႂ်ႉ
tooth	ၶဵဝ်ႈ
top	ၸိၵ်းၸွမ်
topic	ႁူဝ်ၶေႃႈ
torn	သိၵ်း
torture	ႁဵတ်းမိူၵ်ႈ
total	ႁူမ်ႈလေႃး
touch	တိူဝ်ႉ
tough	ယၢပ်ႇၵိၼ်း
tour	ဢွၵ်ႇတၢင်း
toward	ယိူင်းတၢင်းၼႃႈ
towards	ၵႂႃႇၸူး
towel	ၽႃႈၸဵတ်း
town	ဝဵင်း
toxic	မိူဝ်ႇ
trace	လမ်းသွၵ်ႈႁႃ
track	တၢင်း
trade	လွင်ႈၵႃႉၶၢႆ
trade	ၵႃႉၶၢႆ
tradition	ၵၢႆႇတင်းၽိင်ႈထုင်း
traditional	ဢၼ်ၵပ်းၵၢႆႇတင်း ၽိင်ႈငႄႈ
traffic	ၾႆးတၢင်းၸူႉ
trail	ၸွမ်းႁွၺ်းတိၼ်
train	ၽိုၵ်းပၼ်
training	ၽိုၵ်ႉၽွၼ်ႉ
trait	တၢင်းယၢမ်ႈ
traits	တၢင်းယၢမ်ႈၸႅင်ႈ
transfer	လႅၵ်ႈၸူး
transition	လွင်ႈၶၢႆႉလၢႆႊ
translate	ပိၼ်ႇလိၵ်ႈ
transparent	ႁၼ်ထိုင်လွၼ်ႉလႆႈ
transport	တေႃႇသူင်ႇ
transportation	ၶူင်ႉၵၢၼ်တေႃႉသူင်ႇ
trap	ႁႅဝ်ႉ
trash	ဢမ်ႇၶဝ်ႈတၢင်းတိုဝ်း
trauma	ပဵၼ်ႁၢႆႉမႃး ဝၢႆးလိုၼ်း
travel	ဢွၵ်ႇတၢင်း
tray	လႅင်ႇပၢၼ်း
treasure	ၵႅဝ်ႈသႅင်ငိုၼ်းၶမ်း
treat	လဵင်ႉ
treat	ၵပ်းသိုပ်ႇ
treatment	ႁဵတ်းသၢင်ႈ
tree	တူၼ်ႈမႆႉ
tremendous	တိုၼ်ႇဢၢမ်း
trend	ၸူးတၢင်း
trial	ၸၢမ်းတူၺ်း
trick	ယွၵ်ႇလႅၼ်
tried	ၸၢမ်းတူၺ်း
trigger	တႄႇငိူၼ်ႈမၼ်း
trigger	ၼဵင်
trim	ယူဝ်းယူဝ်းၽဵၼ်ႈၽဵၼ်ႈ
trip	ၶၢဝ်းတၢင်းလႄႇ
trouble	တုၵ်ႉ
trousers	ၵူၼ်
truck	လူတ်ႉတၢင်ႇၵုၼ်ႇ
true	မႅၼ်ႈ
trunk	တူၼ်ႈလမ်း
trust	လွင်ႈမၢၼ်ႇမႅၼ်ႈ
trust	ယုမ်ႇ
truth	ယုမ်ႇ
try	ၸၢမ်းတူၺ်း
Tsonga	ၶိူဝ်းသွင်းၵႃႇ
tube	လွတ်ႇ
Tuesday	ဝၼ်းဢၢင်းၵၢင်း
tuition	ၽိုၵ်းသွၼ်ၶိုၼ်း
turkey	ၵႆႇၸၢင်ႉ
turmeric	မိၼ်ႉ
turn	ငွၵ်း
turtle	တဝ်ႇပၢင်ႇလၢႆႇ
tutor	မေႃသွၼ်ၸၼ်ႉၸွမ်
twelve	သိပ်းသွင်
twenty	ၼိူင်ႈသၢဝ်း
twenty-one	သၢဝ်းဢဵတ်း
Twi	ၶိူဝ်းထြီႇ
twice	သွင်ပုၼ်ႈ
twist	ဢေသွင်
two	သွင်
type	ၸႃႉမဵဝ်း
typical	ဢွၵ်ႇႁၢင်ႊဝႆႉ
ugly	ႁၢင်ႊၸႃႉ
ultimate	ၵမ်းလိုၼ်း
umbrella	ၸွင်ႈ
unable	ဢမ်ႇပဵၼ်လႆႈ
uncle	လုင်း
unconscious	လိုမ်းတူဝ်
under	တၢင်းတႂ်ႈ
underneath	တၢင်းတႂ်ႈ
underrated	သၢင်းၽႅပ်ႉႁႅင်းၼႃႇ
understand	ပွင်ႇၸႂ်
understood	ပွင်ႇၸႂ်လီ
unfortunately	ၵႅၼ်
uniform	သိူဝ်ႈတုၺ်ႇ
unique	ၶိုၵ်ႉၶၢႆး
unique	ဢမ်ႇမီးတီႈတႅၵ်ႈၼိူင်း
unit	ယူႇၼိတ်ႉ
university	ၸၼ်ႉၸွမ်
unknown	ဢမ်ႇႁူႉ
unless	ပေႃးဢမ်ႇပဵၼ်ၵေႃႈ
until	တေႃႇထိုင်
unusual	ဢမ်ႇသူႈပဵၼ်
up	တီႈၼိူဝ်
up to you	ၵမ်ႉၸႂ်သူ
update	လွင်ႈႁဵတ်းႁုၼ်ႈမႂ်ႇ
update	မႄးႁုၼ်ႈမႂ်ႇ
upgrade	ႁုၼ်ႈမႂ်ႇ
upgrade	မႄးသႂ်ႇ
upon	တၢင်းၼိူဝ်
upset	ၸႂ်လဵၵ်ႉ
urban	ၼႂ်းဝဵင်း
urge	တိုၵ်းသူၼ်းတေႉတေႉဝႃႈဝႃႈ
urgent	မၢင်ႉၵိၼ်း
us	ႁဝ်းၸိူဝ်းၼႆႉ
use	ၸႂ်ႉတိုဝ်း
use	တၢင်းၸႂ်ႉ
used	ၸႂ်ႉတိုဝ်း
useful	ၶဝ်ႈတၢင်းတိုဝ်း
useless	ဢမ်ႇၶဝ်ႈတၢင်းတိုဝ်း
usual	ၵႆႉပဵၼ်
usually	ၵႆႉၵႆႉ
utility	ၶဝ်ႈတၢင်းတိုဝ်း
vacation	လႄႇၶၢဝ်းတၢင်းပွတ်း
vaccination	ယႃႈႁေႈၵင်ႈ တၢင်းပဵၼ်
vaccine	ယႃႈႁေႉတၢင်းပဵၼ်
vacuum	ၵၢင်ႁၢဝ်
vague	ဢမ်ႇလပ်းလွင်း
valid	လွင်ႈတၢင်းၵိုမ်းၶိူင်ႇ
valley	ဝၢဝ်ႇလွၺ်
valuable	ၵႃႊယႂ်ႇ
value	ၵႃႊၼႃႇ
value	ၵႃႊၶၼ်
variety	ပႅၵ်ႈပိူင်
various	ၵူႊမဵဝ်းမဵဝ်း
vary	ပိူင်ႈပႅၵ်ႈ
vase	ၼမ်ႉတဝ်ႈ
vast	လၢတ်ႈၵႂၢင်ႈ
vegetable	ၽၵ်းယိူဝ်ႈလၢင်းၶဵဝ်
vegetables	ၽၵ်းယိူဝ်ႈလၢင်းၶဵဝ်
vehicle	လႅင်
vendor	ၵူၼ်းၶၢႆ
venom	မဵဝ်းၵွင်ႉႁၢႆႉ
venture	ၸုၼ်ႉႁဵတ်းပၢႆးမၢၵ်ႈမီး
venue	တီႈႁူပ်းထူပ်းၵၼ်
verify	ၸႅတ်ႈတူၺ်း
versatile	လွင်ႈတၢင်းၵူႊလွင်ႈ
version	လၢႆးႁွင်ႉ
vertical	ၶဝ်ႈသုၼ်ႇတင်ႈလီ
very	ႁႅင်းႁႅင်း
very good	ၶႅမ်ႉတေႉ
vessel	ႁိူဝ်း
via	လုၵ်ႉၼႆႈသေ
vibe	ၶုၺ်ႉႁူႉလွင်ႈၵပ်းသိုပ်ႇ
vibes	ၶုၺ်ႉႁူႉလွင်ႈၵပ်းသိုပ်ႇ
vicious	မိူၵ်ႈမႂ်ႈ
victim	ၵူၼ်းပၢႆႊၽေး
video	ငဝ်းႁၢင်ႊ
view	တူၺ်း
village	မူႇဝၢၼ်ႈ
villain	ၽူႈႁၢႆႉ
vinegar	လဝ်ႈ
vintage	လဝ်ႈ
violence	လၢႆးႁူၵ်းႁၢႆႉ
violent	ဢၼ်ပေႉၵိၼ်
viral	ယွၼ်ႉမႅင်းဝၢႆးရၢတ်ႉ
virgin	သၢဝ်သူၺ်ႇပီႇ
virtual	ထိုင်တီႈ
virtue	ၽူႈသူင်သိၼ်
vision	တႃႈယိူင်း
visit	တီႈလႄႇ
visit	ထွင်ႊ
visual	ႁၼ်လႆႈၸႅင်ႈ
vital	ဢမ်ႇမီးဢမ်ႇပဵၼ်
vivid	ဝီးဝိတ်ႇ
vocabulary	ထွၺ်ႈၵႂၢမ်း
voice	သဵင်
void	ပဝ်ႇပူင်
volume	တၢင်ႉႁႅင်းသဵင်
volunteer	ၽူႈၸွၺ်ႈၽႂ်ႇ
vomit	ႁၢၵ်ႈ
vomit	ထုၵ်ႈဢွၵ်ႇမႃး
vulnerable	ၸုတ်ႈဢူၼ်ႈ
wage	ၵႃႊၸၢင်ႈ
wages	ၵေႃႊႁႅင်း
waist	ဢႅဝ်
wait	ပႂ်ႉ
waiter	ၵူၼ်းတမ်းၽိူၼ်
waiting	ပႂ်ႉ
wake	ပူၵ်း
wake up	ၼွၼ်းတိုၼ်ႇ
walk	ပႆတၢင်း
walking	ပႆတၢင်း
wall	ၽႃ
wallet	ဢႅပ်ႇငိုၼ်း
wander	လႄႇၵႂႃႇတိၵ်းတိၵ်း
wanna	ၶႂ်ႈပဵၼ်
want	ၶႂ်ႈလႆႈ
wanted	ၶႂ်ႈလႆႈ
war	ပၢင်တိုၵ်း
wardrobe	တူႈသႂ်ႇၶူဝ်း
warehouse	ႁူင်းဝႆႉၵုၼ်ႇ
warm	ဢုၼ်ႇ
warm	ပၼ်ၾၢင်ႉ
warn	ပၼ်ၾၢင်ႉ
warning	ပၼ်ၾၢင်ႉ
warrior	သိုၵ်းႁၢၼ်
was	ပဵၼ်
wash	လၢင်ႉ
waste	ပိၼ်ႉပႅတ်ႈ
watch	တူၺ်း
water	ၼမ်ႉ
watermelon	တႅင်ၽၢင်
wave	ပိူမ်းၼမ်ႉ
way	သဵၼ်ႈတၢင်း
we	ၸိူဝ်းႁဝ်း
we are	ၸိူဝ်းတူႊပဵၼ်
we can	ႁဝ်းႁဵတ်းလႆႈ
weak	ဢၼ်ဢူၼ်ႈဢွၼ်ႇ
weakness	တၢင်းၸုတ်ႈဢူၼ်ႈ
wealth	မၢၵ်ႈမီး
wealthy	ၾႃႉၾူၼ်
wear	ၼုင်ႈ
wearing	ၼုင်ႈဝႆႉ
weather	ၾိင်ႈၾႃႉ
wedding	ႁဵတ်းပၢင်ၶႅၵ်ႇ
Wednesday	ဝၼ်းပုတ်ႉ
weed	တူၼ်ႈပၢင်း
week	ၵမ်ႊ
weekend	ဝၼ်းတိတ်ႉသဝ်
weight	တၢင်းၼၵ်း
weight	ယွင်ႈၼၵ်း
weird	ဢၼ်လၢၵ်ႇလၢႆး
welcome	ငိၼ်းၸူမ်းႁပ်ႉတွၼ်ႈ
welfare	ၵမ်ႉၸွၺ်ႈႁႂ်ႈယူႇသႃႇလူမ်
Well	လီယဝ်ႉ
well done	လီတေႉယဝ်ႉ
went	ၵႂႃႇ
were	ပဵၼ်
west	ၽၢႆႇဝၼ်းတူၵ်း
wet	ယမ်း
whale	ပႃမုင်းလူင်
what	ဢီႈသင်
what about you	သူလူး
what are you doing	သူတိုၵ်ႉႁဵတ်းသင်ယူႇ
what are you doing now	မိူဝ်ႈလဵဝ်သူတိုၵ်ႉႁဵတ်းသင်ယူႇ
what are you doing right now	သူႁဵတ်းသင်ဝႆႉ
what do you do	မႂ်းၶႂ်ႈလႆႈသင်
what do you do for a living	သူႁဵတ်းၵၢၼ်သင်
what do you mean	သူၶႂ်ႈဝႃႈသင်
what do you want	သူၶႂ်ႈလႆႈသင်
what happened	ပဵၼ်သင်မႃး
what is	ပဵၼ်ဢီႈသင်
what is this	ၼႆႉပဵၼ်သင်
what is your job	သူႁဵတ်းၵၢၼ်သင်
what is your name	ၸိုဝ်ႈသူႁွင်ႉဝႃႈႃႁိုဝ်ၶႃႈ
what's up	ပဵၼ်ႁိုဝ်ပဵၼ်ႁႃ
what's your name	ၸိုဝ်ႈသူႁွင်ႉသင်
whatever	ပဵၼ်သင်ၵေႃႈလီ
wheat	ၶဝ်ႈမႅၼ်ႇ
wheel	မၢၵ်ႇလေႃႉ
when	မိူဝ်ႈလႂ်
whenever	ပိူၼ်ႁိုဝ်ၵေႃႈလၢႆး
where	တီႈလႂ်
where are you	သူမီးတီႈလႂ်
where are you from	သူလုၵ်ႉတီႈလႂ်မႃးၶႃႈ
where are you now	တေႃႈလဵဝ် သူမီးလႂ်
where do you live	သူယူႇတီႈလႂ်
where is	တီႈလႂ်
whereas	ယွၼ်ႉၼၼ်
whether	သေတႃႉၵေႃႈ
which	ဢၼ်လႂ်
while	ၽွင်းမိူဝ်ႈ
whisper	သွပ်ႉသႅပ်ႉ
whistle	သွပ်ႉသႅပ်ႉ
white	သီၶၢဝ်
who	ပဵၼ်ၽႂ်
who are you	သူပဵၼ်ၽႂ်
who is	ၽႂ်ၼၼ်ႉ
who is this	ပဵၼ်ၽႂ်ၼၼ်ႉ
whole	တင်းမူတ်း
whom	ၽႂ်
whose	ၶွင်ၽႂ်
why	ၵွပ်ႈသင်
why not	ႁဵတ်းသင်ဢမ်ႇလႆႈ
wicked	တိူဝ်ႉမၢတ်ႇ
wide	ၵႂၢင်ႈ
widow	ႁူးလႅင်း
width	တၢင်းၵႂၢင်ႈ
wife	မေး
wild	လိူင်း
will	တေ
willing	ၸႂ်ၶႂ်ႈသၢင်ႈ
win	ပေႉ
wind	လူမ်းပဝ်ႇ
window	ႁူးလႅင်း
windy	လူမ်းပဝ်ႇ
wine	လဝ်ႈမၢၵ်ႇ
winter	ၶၢဝ်းၵတ်း
wipe	ၸတ်းပႅတ်ႈ
wire	သၢႆၾႆး
wisdom	တၢင်းႁူႉ
wise	ႁူႉၼမ်
wish	ၶေႃႈယွၼ်းသူး
wish	ယွၼ်းသူး
wish you all the best	ယွၼ်းသူးပၼ်ယူႇ
witch	ၽိူဝ်ႉ
with	တင်း
withdraw	ထုၵ်ႈငိုၼ်း
withdrawal	ႁုပ်ႈသိမ်း
within	ၶဝ်ႈပႃး
without	ဢမ်ႇမီး
witness	ၼေလၵ်းထၢၼ်
witness	လၵ်းထၢၼ်
witty	ၺၢၼ်ႉႁုၼ်ႉၼူဝ်
wolf	မႃလႆး
woman	ၽူႈယိင်း
women	ၽူႈယိင်း
won	ဢွင်ႇပေႉ
won't	တေဢမ်ႇ
wonder	ၶႂ်ႈႁူႉ
wonderful	လီဢၢမ်း
wood	မႆႉ
wool	ၶူၼ်တူဝ်း
word	ၶေႃႈၵႂၢမ်း
words	ၶေႃႈၵႂၢမ်းတူဝ်လိၵ်ႈ
work	ႁဵတ်းၵၢၼ်
work	ၼႃႈၵၢၼ်
work out	လဵၼ်ႈႁႅင်းတူဝ်
working	ႁဵတ်းၵၢၼ်
world	ၶူင်းၵၢင်
worm	တိူၵ်ႇလိူၼ်ႊ
worn	ၼုင်ႈ
worried	မႆႈၸႂ်
worry	မႆႈၸႂ်
worse	ၽိတ်း
worship	တိူင်ႇၵၢဝ်ႇ
worst	တၢင်းၽိတ်း
worth	မီးၵႃႈၶၼ်
worth it	ၵိုင်ႇတၢၼ်ႇ
worthy	မီးၵႃႊၶၼ်
would	တေ
wound	ႁွၺ်းၸဵပ်း
Wow	ဢူဝ်ႉႁူဝ်
wrap	တႅၼ်
wrath	ၸႂ်လမ်သႆႈၵမ်ႇ
wrist	ၶေႃးမိုဝ်း
write	တႅမ်ႈ
Write here	တႅမ်ႈတီႈၼႆႈ
writing	တႅမ်ႈ
written	တႅမ်ႈယဝ်ႉ
wrong	ၽိတၼ်း
wrote	တႅမ်ႈ
yard	ဝႃး
yawn	ႁၢဝ်ၵၢင်း
yawn	ၽုၺ်ႇဝႆႉ
Yeah	ဢိုမ်း
year	ပီႊ
years	ပီႊ
yeast	ဢွၵ်ႇပူၵ်ႇ
yell	သႅၼ်ႇ
yellow	သီလိူင်
Yes	ၸႂ်ႈ
yes baby	ၸႂ်ႈဢိူဝ်ႈ ဢေ
yes dear	ၸႂ်ႈဢိူဝ်ႈ ႁၵ်ႉ
yes honey	ၸႂ်ႈယဝ်ႉ ႁၵ်ႉဢိူၺ်း
yes my love	ၸႂ်ႈယဝ်ႉ ႁၵ်ႉဢိူၺ်း
yes of course	တိုၼ်းပဵၼ်ၼၼ်
yesterday	မိူဝ်ႈဝႃး
yet	ဢမ်ႇပႆႇယဝ်ႉ
yield	မွၵ်ႇမႃး
you	မႂ်း
you are	သူပဵၼ်
you are beautiful	သူႁၢင်ႊလီတေႉ
you are so beautiful	သူႁၢင်ႊလီတေႉယဝ်ႉ
you are welcome	ယိၼ်းလီၶႃႈ
you can	သူႁဵတ်းလႆႈဢိူဝ်ႈ
You know	သူႁူႉယူႇ
you too	သူၵေႃႈၶဝ်
you're welcome	ယိၼ်းလီၶႃႈ
young	ၼုမ်ႇ
your	ၶွင်သူ
your welcome	ယိၼ်းလီၶႃႈ
yourself	ႁင်းၵွၺ်းသူ
youth	ၵူၼ်းၼုမ်ႇ
you’re welcome	ယိၼ်းလီၼႃ
yummy	ဝၢၼ်တေႉတေႉ
zero	သုၼ်
