a little	nnye
a lot	thata
a lot	ntsi
a lot of	tse dintsi
abandon	tlogela
abandoned	tlogela
abide	ikokobeletsa
abide	nna
ability	bokgoni
able	kgona
about	ka ga
above	fa godimo
abroad	mosega
absence	bo sa nneng teng
absent	tlhokafalo
absolutely	tota
absorb	monyela
abstract	tshobokanyo
absurd	mo go se nang tlhaloganyo
abundance	motlele
abundant	go nna motlele
abuse	tshotlakako
abuse	sotlakaka
accent	tsela ya go bua
accept	amogela
access	fitlhelela
accident	kotsi
accommodation	madulo
accomplish	fitlhelela
accomplished	fitlheletse
according	go ya ka
account	akhaonte
account	ikarabela
accuracy	nepo
accurate	nepile
accused	latofadiwa
ache	opa
achieve	fitlhelela
achievement	phitlhelelo
acknowledge	amogela
acquaintance	motho yo o tlwaetsweng
acquire	fitlhelela
acquired	bone
acquisition	pono
across	kgabaganya
act	dira
action	tiragalo
active	matlhagatlhaga
activities	ditiro
activity	tiro
actor	modiragatsi
actual	tota
actually	tota
acute	bogale
adapt	go tlwaela
add	oketsa
addicted	tlwaetse
addition	tlaleletso
additional	tsa tlaleletso
address	aterese
address	bua le
adequate	lekane
adjacent	mabapi
adjective	letlhalosi
adjust	siamisa
admire	kgatlhwa
admit	amogela
adopt	amogela
adorable	ratega
advance	tuelelopele
advance	pele
advanced	tsweletse pele
advantage	molemo
adventure	tekelelo
adverb	letlhalosi
advertisement	papatso
advertising	papatso
advice	kgakololo
advise	gakolola
advocate	mmueledi
aesthetic	temogo ya bontle
affair	morero
affect	maikutlo
affect	ama
affection	lerato
afford	kgona
affordable	kgonega
afraid	tshogile
after	morago
afternoon	motshegare
afterwards	morago ga moo
again	gape
against	kgatlhanong
age	dingwaga
age	tsofala
agency	mokgatlho
agent	modiredi
aggressive	dikgoka
agile	matšato
ago	fetileng
agree	dumelana
agreement	tumelano
agriculture	temothuo
ahead	kwa pele
aid	thuso
aim	maikaelelo
air	mowa
airport	boemelafofane
aisle	aele
alarm	alamo
alarm	mokgosi
alcohol	bojalwa
alert	ntlha
alive	tshela
all	otlhe
all right	go siame
all the best	masego ke ao
allow	letla
allowed	letleletswe
almost	batlile
alone	nosi
along	bapa le
already	setse
Alright	go siame
also	gape
alternative	e nngwe
although	le fa
always	ka metlha
am	a
amazing	gakgamatsang
ambiguous	bokaopedi
ambition	keletso
ambitious	lelela borena
amend	tlhabolola
amid	magareng ga
among	ma gareng ga
among us	magareng ga rona
amount	palo
amusing	tshegisa
analysis	tshekatsheko
ancestors	badimo
anchor	maitsepelo
ancient	kgologolo
and	le
and you	le wena
angel	moengele
anger	kgalefo
angle	khutlo
angry	galefa
animal	phologolo
ankle	lengenana
anniversary	letsatsi lamorago ga ngwaga la segopotso sa tiragalo nngwe
announcement	kitsiso
annoy	tena
annoyed	tenegile
annoying	tena
annual	ngwaga le ngwaga
anonymous	tlhokaina
another	o mongwe
answer	karabo
anticipate	solofela
anxiety	tlhobaelo
anxious	tlhobaela
any	nngwe
anymore	se tlhole
anyone	mongwe le mongwe
anything	sengwe le sengwe
anyway	le gale
anyways	le gale
apart	aroganeng
apartment	folete
apologize	kopa maitshwarelo
apparent	bonagala
apparently	ekare
appeal	boikuelo
appear	tlhagelela
appearance	tebego
appeared	tlhageletse
appetite	keletso ya dijo
apple	apole
application	kopo
apply	go kopa phatlha
appointment	lebaka
appreciate	itumelela
appreciation	itumelela
approach	tsela
approach	atamela
appropriate	matshwanedi
approval	tetlelelo
approve	letla
approved	letleletse
approximately	e ka nna
april	moranang
arbitrary	ka boithatelo
architect	moagiteke
architecture	boagi
archive	akhaefe
are	o
are you	a o
are you busy	a o tshwaregile
are you married	a o nyetse
are you married or single	a o nyetse kgotsa ga o a nyala
Are you still there?	A o santse o le foo?
Are you still there?	A o santse o le teng?
are you there	a o teng
area	lefelo
argue	ngangisana
argument	kganetsano
arise	nanoga
arm	letsogo
army	sesole
around	dikologa
arrange	rulaganya
arrangement	thulaganyo
arrival	kgorogo
arrive	goroga
arrived	gorogile
arrogant	ikgogomosa
arrow	motsu
art	botsweretshi
article	letlhatlhelelo
artificial	e seng ya nnete
artist	motsweretshi
as	jaaka
as long as	fa fela
as well	le
as well as	gape le
ash	molora
ashamed	swabile
ask	botsa
asked	boditse
asleep	robetse
aspect	tebo
Assamese	Assamese
assault	tlhaselo
assault	tlhasela
assembly	kopano
assertive	itshola ka boitshepo
assess	kgethisa
assess	sekaseka
assessment	tshekatsheko
asset	letlotlo
asset	asete
assets	letlotlo
assign	aba
assignment	asaenemente
assist	thuso
assistant	mothusi
associate	amana
associated	amangwa
association	kamano
association	mokgatlho
assume	tsaya
assumption	go tsaya gore
at	kwa
at least	bonnye
ate	jele
athlete	moatelete
attach	pataganya
attached	patagantswe
attachment	patagano
attack	tlhasela
attempt	leka
attend	sekegela tsebe
attend	tsena
attendance	tseno
attention	tshekegelo tsebe
attitude	mokgwaselebo
attract	gogela
attraction	kgogedi
attractive	gogela
attribute	setlhaodi
attribute	boleng
audience	balebeledi
august	phatwe
aunt	rakgadi
aunty	mmangwane
authentic	ya nnete
author	mokwadi
authority	bothati
authority	thata
autumn	letlhabula
available	go gone
average	tlwaelesego
avoid	tila
awake	tsogile
award	kabelo
aware	lemoga
awareness	temogo
away	kwa kgakala
awesome	gakgamatsa
awesome	boitshegang
awful	bosula
awkward	matlhogole
Aymara	Aymara
baby	lesea
bachelor	kgope
back	morago
background	lemorago
bad	maswe
bag	kgetsana
bait	phephiso
bake	baka
bakery	lebaka
baking soda	sota e e bakang
balance	lekalekanya
balance	selekanyo
ball	bolo
Bambara	Bambara
banana	panana
band	setlhopha
bang	itaanya
bank	banka
bar	bara
bar	kgoreletso
bar	kgoreletsa
barely	sa
bargain	sesolo
bark	lekwati
barley	bali
barrier	thibedi
base	motheo
base	letlase
based	ikaega
based	tswa kwa
basement	boalo kafa tlase ga kago
basic	theo
basically	sa motheo
basil	beisele
bastard	ngwana wa dikgora
batch	setlhopha
bath	bata
bathroom	phaposibotlhapelo
battery	beteri
battle	ntwa
bay	kgogometso
be	nna
be careful	ela tlhoko
beach	letshitshi
beam	letlhasedi
beans	dinawa
bear	bera
bear	sikara
bear	belega
beard	tedu
bearing	tshotse
beast	sebatana
beat	fenya
beat	betsa
beautiful	ntle
beauty	bontle
became	nnile le
because	ka gore
become	nna
bed	bolao
bedroom	phaposi ya borobalo
bee	notshi
beef	nama ya kgomo
been	kile
beer	biri
before	pele
began	simolotse
begin	simolola
beginning	tshimologo
behalf	mo boemong
behave	itshola
behavior	boitsholo
behaviour	maitshwaro
behind	kwa morago
being	e leng
belief	tumelo
believe	dumelang
belly	mpa
belong	ya
beloved	moratiwa
below	fa tlase
belt	lebanta
bench	setulo
bend	oba
beneath	kwa tlase
benefit	bona molemo
benefit	thuso
benefits	mesola
beside	ntle le
beside	fa thoko
besides	ntle le
best	gaisa
best of luck	nala
best of luck	katlego
best of luck	masego
best regards	weno
better	botoka
between	magareng ga
beverage	seno
beyond	go feta
Bhojpuri	Bhojpuri
bias	nna mo letlhakoreng la
biased	tsaya letlhakore
bicycle	baesekele
bid	raya
bid	bitsa
bid	laletsa
big	kgolo
bike	baeke
bill	tuediso
bill	molomo wa nonyane
bind	bofa
bird	nonyane
birthday	letsatsi la botsalo
bit	nnye
bite	loma
bitter	utlwile botllhoko
bitter	bogalaka
black	ntsho
blade	legare
blame	tshwaya phoso
blank	lelea
blanket	kobo
blast	thuba
bleach	go thuntsa
blend	tlhakanya
bless	segofatsa
blessed	segofetse
blind	foufetse
bliss	boitumelo
block	thibela
blood	madi
bloom	sethunya
bloom	thunya
blow	letsa
blue	botala jwa legodimo
blunt	botswa
board	boto
board	palama
boat	mokoro
body	mmele
boil	bedisa
boil	bela
bold	pelokgale
bond	kgolagano
bone	lerapo
book	buka
boost	godisa
booster	tlaleletso
boot	butshe
boot	butu
boots	dibutshe
border	thetha
border	molelwane
bore	boro
bore	fetlhela
bored	tshwarwa ke bodutu
boring	tshwarisa bodutu
born	belegwe
borrow	adima
boss	kgolokwane
boss	mothapi
both	bobedi
bother	tshwenya
bottle	botlolo
bottom	tlase
bought	rekile
bounce	tlola
bound	golegwa
bound	sekhutlo
bound	molelwane
boundaries	molelwane
bow	obama
bow	bora
bowl	sejana
box	lebokoso
boy	mosimane
boyfriend	lekau
bracelet	leseka
brain	boboko
branch	lekala
brand	letshwao
brand	tshwaya
brave	pelokgale
breach	tlola
bread	senkgwe
break	boikhutso
break	thuba
break	roba
breakfast	difitlholo
breast	letsele
breath	khemo
breathe	hema
breed	tsal
breed	mofuta
breed	godisa
brick	setene
bride	monyadiwa
bridge	borogo
brief	khutshwane
bright	phatsima
brilliant	botlhale
brilliant	manontlhotlho
bring	tlisa
bro	abuti
broad	atlhama
broadcast	kgaso
broke	botlhoka madi
broke	robegile
broken	robegile
broom	lefeelo
brother	morwarre
brother in law	mogwe
brought	tlisitse
brown	tlhokwa
brown	ntlhwa
brush	boratšhe
bucket	kgameleo
buddy	tsala
budget	tekanyetso
bug	tsitsiri
build	aga
building	kago
built	agile
bulk	kgoboko
bull	pholo
bully	mokgerisi
bump	borurusa
bunch	ngata
bunch	lesitlha
bundle	ngata
bundle	phutela
burden	morwalo
buried	fitlha
burn	fisa
burst	thuba
bury	fitlha
bus	bese
bush	setlhatlha
bush	sekgwa
business	kgwebo
bust	thuba
busy	tshwaregile
but	mme
but	fa e se
butter	botoro
butterfly	serurubele
button	konopo
buy	reka
by	fa
by	ka
by the way	kana
bye	tsamaya sentle
bye	sala sentle
cabbage	khabetšhe
cabinet	kabinete
cage	kheišhe
cake	kuku
calf	namane
call	bitsa
call	letsa mogala
call me	nteletsa
call me	mpitsa
called	biditse
called	biditswe
calm	tshisibalo
came	tlile
campaign	letsholo
can	kgona
can	ka
can't	kake
Cancel	Phimola
cancer	kankere
capable	kgona
capacity	bokgoni
capital	motsemošhate
capital	madi a go simolola kgwebo
caption	khepošene
capture	go gapa
car	koloi
career	mokgwa wa go itshetsa le tswelelopele
careful	kelotlhoko
carefully	ka kelotlhoko
careless	go sa kgathalele
caring	pelontle
carpenter	mmetli wa dikgong
carpet	khapete
carrot	segwete
carry	tshola
carry on	tswelela
carry out	ntshetsapele
case	kgetsi
cash	madi a seatleng
cast	latlhela
castle	khasetlele
casual	go sa tseye tsiya
casual	nakwana
cat	katse
catch	tshwara
category	setlhopha
cattle	dikgomo
caught	tshwere
cause	baka
caution	kgakololo
cautious	kelotlhoko
cave	legaga
cease	emisa
ceiling	sileng
celebrate	keteka
cell	sele
center	borakanelo
center	bogare
century	ngwagakgolo
cereal	ditsele
ceremony	mokete
certain	tlhomamisa
certain	rileng
certainly	ruri
certificate	setifikeiti
chain	ketane
chair	setulo
challenge	gwetlha
challenge	kgwetlho
chance	tšhono
change	fetola
chaos	mmudubudu
character	motshameki
character	semelo
characteristics	dipharologantsho
charge	latofatsa
charge	duedisa
charge	laya
charity	dikatso
charming	kgatlha
chart	tšhate
chase	lelekisa
chat	tlotla
cheap	tlhwatlhwatlase
cheat	tsietsa
cheating	tsietsa
check	tlhola
cheek	lerama
cheer	duduetsa
cheer	nametsa
cheerful	itumetse
cheers	cheers
cheese	tšhisi
chemistry	khemeseteri
cherish	rata
chess	tšhese
chest	sehuba
chew	tlhafuna
chicken	koko
chief	kgosi
child	ngwana
childhood	bongwana
children	bana
chill	iketle
chimneys	tšhemele
chin	seledu
chocolate	tšhokolete
choice	tlhopho
choose	tlhopha
chop	fatsa
chores	ditiro
chubby	nonne
church	kereke
cinnamon	sinamone
circle	sediko
circumstances	maemo
citizen	moagi
city	teropokgolo
claim	tatalala
clarify	itshekisa
clarify	tlhalosa
class	tlelase
clay	mmopa
clean	phepa
clear	phepa
clerk	tlelereke
clever	botlhale
client	moreki
cliff	logaga
climate	tlelaemete
climb	pagama
clingy	ngaparela
clock	orolose
close	tswala
closet	tlelosete
cloth	lesela
clothes	diaparo
cloud	leru
cloudy	maru a thibili
clown	radiserekisi
clue	lesedi
clumsy	marorongwane
cluster	sebothwana
coach	mokatisi
coal	legala
coast	lebopo
coat	baki
coffee	kofi
cognitive	tsa tlhaloganyo
coincidence	kwelano
cold	tsididi
collapse	phutlhama
collar	koloro
colleague	modirammogo
colleagues	badirammogo
collect	tsaya
collection	kgobokanyo
college	kholeiji
color	mmala
colorless green ideas slept furiously	dikakanyo tse ditala tse d se nang mmala di robetse ka natla
colour	mmala
column	kholomo
comb	kama
comb	kamo
combination	kopanyo
combine	kopanya
come	tlaya
come here	tla kwano
come on	tlaya
comfort	gomotsa
comfort	kgomotso
comfortable	phuthuloga
coming	tlang
coming soon	ya tla mo bogautshwaneng
command	taelo
command	laela
comment	akgela
commercial	tsa kgwebo
commission	khomišhene
commit	ineela
commitment	boineelo
committed	ineetse
commodity	phatlho
common	tlwaelesegile
communicate	tlhaeletsana
communication	tlhaeletsano
community	baagi
commute	go ya tirong le go boela gae ka gale
commute	fetola
companion	molekane
company	setlhopha
company	setlamo
compare	tshwantshanya
comparison	papiso
compassion	boutlwelobotlhoko
compassionate	utlwela botlhoko
compatible	tshwanelana
compete	gaisana
competent	na le bokgoni
competition	kgaisano
competitive	gaisana
complain	ngongorega
complaint	ngongorego
complement	akgola
complete	fetsa
completely	ka botlalo
complex	marara
compliance	latela melao
complicated	raraane
compliment	tlotlomatso
comply	obamela
composition	tlhamo
compound	kompone
compound	tswako
compound	tswaka
comprehension	tlhaloganyo
comprehensive	feleletseng
compromise	ineela
compulsory	pateletsega
computer	khomphiuta
concentrate	kopanya
concentrate	tebisa mogopolo
concept	kgopolo
concern	matshwenyego
concerned	tshwenyegile
concert	konsarata
conclusion	konosetso
concrete	konkereite
concrete	mmatota
condition	maemo
conditions	maemo
conduct	mokgwa
conduct	tsamaiso
conference	khonferense
confess	ipolela
confidence	boitshepi
confident	itshepile
confirm	tlhomamisa
conflict	kgotlhang
confused	etsaetsega
confusion	kgamarego
confusion	mapetepete
congrats	re motlotlo ka wena
congratulation	kakgolo
congratulations	re a go akgola
conjunction	lekopanyi
connect	kopanya
conquer	fenya
conscious	lemoga
consciousness	boitemogo
consent	tetla
consequences	ditlamorago
conservation	tshomarelo
conservative	konsebetifi
consider	akanya
considered	tseile gore
consist	na le
consistency	tlhomamo
consistent	tlhomama
constant	sa fetogeng
constantly	ka go sa fetogeng
constipation	pipelo
construction	kago
consume	ja
consumption	tiriso
contact	kgolagano
contagious	tshelanang
contain	na le
contains	na le
contemporary	sešweng
contempt	lenyatso
content	diteng
contest	kgaisano
contest	ganela
contest	tlhabana
context	bokao
continent	kontinente
continue	tswelela
contract	koteraka
contrast	farologanya
contrast	pharologanyo
contribute	atswa
contribution	katso
control	taolo
control	laola
controversial	ya kganatseno
convenience	tshiamelo
convenient	siametse
conversation	motlotlo
convert	fetola
convert	mosokologi
convey	fetisa
convince	fea
convinced	fentswe
convinced	tlhomamisegile
cook	apaya
cooking	apeile
cool	tsiditsana
cooperation	tirisanommogo
cope	emelana
copper	koporo
core	konokono
corn	mmidi
corner	sekhutlo
correct	nepile
cost	tlhwatlhwa
costume	khosetšhumu
cottage	thutsana
cotton	letseta
cotton	tlhale
couch	soufa
cough	gotlhola
could	ka
council	khansele
count	bala
counter	ganetsa
counter	khaontara
counter	sebadisi
country	naga
countryside	magaeng
couple	baratani
courage	bogatlhamelamasisi
course	motlhala
court	kgotlatshekelo
courtesy	tlotlo
cousin	ntsala
cover	bipa
cow	kgomo
coward	legatlapa
cozy	boiketlo
crab	lekakauwe
crack	phatloga
craft	botswerere
crap	matlakala
crash	thula
crash	thulano
craving	keletso
crawl	gagaba
crazy	makatsang
crazy	tsenwa
create	bopa
creative	go bopa
credit	keretiti
creep	gagaba
creepy	tsitsibanya mmele
crew	setlhopha
crime	bosenyi
cringe	ingodis
crisis	dipharagobe
criteria	dikaelo
critical	botlhokwa
criticism	tshekatsheko
criticism	kgalo
crop	ngotla
crop	thobo
crop	sejalo
crops	dijalo
cross	tlola
cross	sefapano
crow	legakabe
crowd	boididi
crowded	bokanetse
crown	serwalo sa bogosi
crucial	botlhokwa thata
cruel	setlhogo
crush	pitla
cry	lela
cucumber	komokomore
cuddle	tlamparela
culture	setso
cunning	boferefere
cup	kopi
cupboard	raka
curb	thibela
cure	alafa
curfew	Nako e o e beetsweng
curiosity	šwegašwega
curious	go batla go itse
curious	mo go gakgamatsang
curly	itshopileng
currency	madi
current	moela
current	ga jaana
currently	ga jaana
curse	hutsa
curse	phutso
curtain	garetene
cushion	mosamo
cushion	garela
custom	lekgetho la dithoto
custom	tlwaelo
customer	moreki
customs	letso
customs	makgetho
cut	sega
cute	ntlenyane
cycle	saekela
cycling	go palama baesekele
dad	rre
daddy	papa
daily	ka letsatsi
dairy	teiri
dam	letamo
dam	tama
damage	senya
damage	tshenyo
damp	bongola
dance	bina
danger	kotsi
dangerous	kotsi
dark	lefifi
darling	moratiwa
dash	phatlanya
dash	thaladi
data	deitha
data	dinewane
date	letlha
daughter	morwadi
day	letsatsi
dead	sule
deadline	letlha le le beilweng
deaf	susu
deal	tumelano
dear	tlhwatlhwa
dear	ratega
Dear All	Botlhe ba ba Rategang
Dear Customer	moreki yo tlotlegang
Dear Parents	Batsadi ba ba Tlotlegang
Dear Sir	Morena yo o Tlotlegang
Dear students	Baithuti ba ba tlotlegang
Dear Team	Setlhopha se se Rategang
death	leso
debate	ngangisano
debit	tebita
debit	molato
debris	matlhekge
debt	molato
decade	ngwagasome
decay	bola
deceased	tlhokafetseng
deceive	tsietsa
december	sedimonthole
decent	ntle
decide	swetsa
decided	sweditse
decision	tshwetso
deck	kgabisa
decline	gana
decrease	fokotsa
decrease	phokotso
dedicated	ineetse
dedication	boineelo
deed	tiro
deep	kwa teng
deer	kgama
default	tlhokomologo
defeat	fenya
defend	emela
define	tlhalosa
definitely	totatota
definition	tlhaloso
degree	dikirii
delay	dia
delayed	diegisitswe
delete	phimola
deliberate	akanya
deliberate	ka boomo
delicate	thubegang
delicate	temeka
delicious	balola
delight	itumelela
delighted	itumetse
deliver	go gololola
deliver	go rebola
delivered	rebotswe
delivered	golotswe
delivery	thebolo
demand	topo
demanding	sa kgotsofale
democracy	temokerasi
demon	letimona
demonstrate	supetsa
denied	ganetse
density	kitlano
dentist	ngaka ya meno
deny	ganela
department	lefapha
departure	pololo
depend	ikaega
deploy	romela
deposit	beeletsa
depressed	gateletswe maikutlo
depression	kgatelelo ya maikutlo
depth	boteng
describe	tlhalosa
description	tlhaloso
desert	sekaka
deserve	tshwanelwa
design	setshwantsho
designation	inakemo
desire	keletso
desk	deseke
despair	tsholofologo
desperate	thata
desperate	solofoga
despite	le mororo
dessert	phuting
destination	kwa go iwang teng
destiny	isagwe
destiny	tlholelo
destroy	senya
destruction	tshenyo
detail	ntlha
details	dintlha
detect	fitlhela
determination	boikaelelo
determine	ikaelela
determined	ikemiseditse
devastated	utlwile botlhoko
develop	tlhabolola
developed	tlhabolotse
development	tlhabololo
device	sediriswa
devil	tiabolo
devoted	ineetse
Dhivehi	Dhivehi
diabetes	daebitise
diarrhea	letshololo
diary	tayari
dictionary	thanodi
did	dirile
die	swa
die	tlhokafala
died	sule
diet	dijo
difference	pharologano
different	farologane
difficult	thata
dig	epa
dignity	seriti
diligent	ineetse
dinner	dilalelo
dip	ina
direct	laela
direction	ntlha
director	mokaedi
dirt	leswe
dirty	leswe
disable	nonofolotsa
disable	koafatsa
disabled	ntshitswe mo tirirsong
disabled	na le bogwele
disappear	nyelela
disappointed	swabile
disaster	masetlapelo
discard	latlha
discharge	tswile
discharge	kgololo
discipline	kgalemo
discipline	boineelo
discount	phokotsotlhwatlhwa
discover	fitlhela
discrimination	kgethololo
discuss	buisana
discussion	puisano
disease	bolwetse
diseases	malwetse
disguise	iphitlhile
disgusting	ferosa dibete
dish	sejana
dish	dijo
dishes	dijana
dismiss	leleka
dispatch	fofotsa
display	tshupetso
disposal	go latlha
dispute	ganetsanya
distance	sebaka
distinct	farologanya
distinguish	farologanya
distress	tlalelo
distribution	phatlalatso
district	kgaolo
disturb	kgoreletsa
ditch	latlha
ditch	mosima
dive	kodumela
diverse	farologane
diversity	pharologanyo
divide	aroganya
divine	semodimo
divorce	tlhalo
dizzy	tsewa ke sedidi
do	dira
do you	a o
do you love me	a wa nthata
doctor	ngaka
document	tokomane
does	dira
doesn't	ga
dog	ntša
Dogri	Dogri
doing	dira
doll	mpopi
domain	lephata
domestic	tsa selegae
dominant	phekeetsi
don't	se ka
Don't worry	Se tshwenyege
donate	aba
done	dirile
donkey	tonki
dope	diritibatsi
dope	ntle
double	gabedi
doubt	belaela
dough	tege
down	kwa tlase
download	laisolola
draft	tlhomo
drag	goga
drain	minolosa
drain	mosele
drama	terama
draw	goga
draw	taka
drawer	torowara
drawing	setshwantsho
drawing	a taka
dread	boifa
dread	poborano
dream	lora
dress	mosese
drill	fetlha
drill	phunya
drink	nwa
drive	kgweetsa
drop	diga
drop	lerothodi
drop	rotha
dropped	digile
drought	lešekere
drunk	nwele
drunk	tagilwe
dry	omile
duck	pidipidi
dude	mothaka
due	tshwanelo
due to	ka ntlha ya
dull	letobo
dumb	mumu
dump	latlhela
duration	paka
during	ka nako ya
dust	lerole
duty	tiro
dwell	nna
dying	swang
each	nngwe le nngwe
each other	o mongwe le o mongwe
eager	tlhwaafala
eagle	ntsu
ear	tsebe
earlier	pelenyana ga foo
early	go sa le gale
earn	amogela
ears	ditsebe
earth	lefatshe
earthquake	thoromo ya lefatshe
ease	boiketlo
easily	bonolo
east	botlhaba
easy	bonolo
eat	jaanong
eating	a ja
economic	tsa ekonomi
economy	ikonomi
edge	losi
edge	lelepe
edit	tseleganya
education	thuto
effect	tirafatso
effect	dira
effective	motia
efficiency	bokgoni
efficient	nonofile
effort	boiteko
egg	lee
eggplant	ekepolante
ego	boikgopolo
eight	robedi
eighteen	lesome le borobedi
eighty	masome a robedi
either	le fa e le
elaborate	tlhalosa go ya pele
elbow	sekgono
elder	mogolo
elderly	bagolo
elderly	golo
elegant	ntle
element	ntlha
elephant	tlou
eleven	lesome le bongwe
eligible	senkega
eliminate	fedisa
else	nngwe
embarrassed	swabile
embarrassing	swabisang
embrace	kampa
emerge	tlhagelela
emergency	tshoganyetso
emotional	thuba maikutlo
empathy	kakanyetso ya ba bangwe
emphasis	kgatelelo
emphasize	gatelela
employee	mothapiwa
employees	bathapiwa
employer	mothapi
employment	tiro
empty	leafatsa
empty	lolea
enable	kgontsha
encounter	kopano
encourage	rotloetsa
end	bokhutlo
end	fetsa
endangered	mo kotsing
endeavor	leka
endurance	boitsholo
endure	itshoka
enemy	sera
energy	maatla
engage	beeletsa
engaged	mo tirisong
engaged	beeleditswe
engagement	peeletso
engagement	kgolagano
engine	enjine
engineer	moenjiniere
English	Seesimane
enhance	tokafatsa
enjoy	natefelelwa
enormous	kgolo
enough	lekane
ensure	netefatsa
enter	tsenya
enter	tsena
entertainment	boitumediso
enthusiasm	phisego
enthusiastic	mafolofolo
entire	otlhe
entitled	tshwanetswe
entitled	setlhogo se se reng
entity	setlamo
entrance	botseno
entrepreneur	mogwebi
envelope	enfolopo
environment	tikologo
envy	tswela pelo
epic	kgolo
epic	ntle
epidemic	leroborobo
equal	lekana
equipment	sediriswa
equity	tekatekano
equivalent	lekanang
equivalent	tekano
eraser	rabara
error	phoso
escape	phalolo
escape	falola
especially	segolobogolo
essay	tlhamo
essence	palodisi
essence	boleng
essential	botlhokwa
establish	tlhomamisa
established	tlhomamisitse
estate	boswa
estimate	fopholetsa
estimated	fopholetsa
etc	jj
eternal	bosafeleng
ethics	boiphapo
evaluate	tlhotlhomisa
evaluation	tlhotlhomiso
even	borethe
even	fela
even though	le fa
evening	maitsibowa
event	tiragalo
eventually	kgabagare
ever	kile
every	nngwe le nngwe
everybody	mongwe le mongwe
everyone	mongwe le mongwe
everything	sengwe le sengwe
evidence	bopaki
evil	bosula
evolution	tlhagalelo
evolve	fetoga
Ewe	Ewe
ex	wa maloba
exact	tot
exactly	fela
exam	tlhatlhobo
examine	tlhatlhoba
example	sekai
exceed	fetisa
excellent	gaisa
except	ntle le
exception	phapogo
excess	fetisang
excessive	feteletseng
exchange	refosana
excited	gakatsega
excitement	boitumelo
exciting	gakatsa
exclusive	ka mo go feleletseng
exclusive	kgethegileng
excuse	boipato
excuse me	intshwarele
execute	diragatsa
execution	tiagatso
executive	khuduthamaga
exercise	rutuntsha
exhaust	lapisa
exhausted	phuegile
exhibit	bontsha
exhibition	pontsho
exist	nna teng
existence	boteng
existing	teng
exit	tswa
expand	atolosa
expect	lebelela
expected	solofetse
expenses	ditšego
expensive	tlhwatlhwagodimo
experience	maitemogelo
experiment	tekeletso
expert	moitseanape
expired	fedile
explain	tlhalosa
explanation	tlhaloso
exploit	go ja ntsoma
explore	batlisisa
export	seromelwantle
export	romela ntle
expose	senola
exposed	senotswe
exposed	senola
exposure	pontsho
express	tlhagisa
expression	polelo
extend	atolosa
extended	atolositswe
extension	katoloso
extent	bokgakala
external	kwa ntle
external	bokontle
extinct	fela
extra	koketso
extract	sentshwa
extraordinary	go feta
extreme	thata
extremely	phetelela
eye	leitlho
eyes	matlho
fabric	lesela
fabulous	-dinaane
fabulous	ntle
face	sefatlhego
facilitate	bebofatsa
facilities	mafelo
facility	kago
fact	bonnete
factor	lebaka
factor	katisani
factory	bodirelo
facts	dintlha
fade	nyelela
fail	retelelwa
failed	go sa falole
failure	go sa falole
failure	phoso
faint	idibala
fair	tekatekano
fair	borakanelo
fair	ntle
fairy	feri
faith	tumelo
faithful	tshepagala
fake	e seng ya nnete
fall	wa
false	E SENG NNETE
fame	tumo
familiar	tlwaelesegile
family	lelapa
famine	leuba
famous	tumile
fan	molatedi
fan	fene
fancy	makgabisa
fantastic	ntle
far	kgakala
farewell	dumedisa
farm	polase
farmer	molemi
fascinating	kgatlhisa
fashion	fešhene
fast	lebelo
fat	nonne
fatal	se se bolayang
fate	tlholelo
father	rre
fatigue	go lapa
fault	phoso
favorite	mamoratwa
favour	tlotla
favour	tlekeetsa
favour	thekegelo
favourite	mmamoratwa
fear	tshabo
feast	mokete
feather	lefofa
feature	popego
features	nang le
features	dipopego
february	tlhakole
fed up	tenega
fee	tuelo
feed	fepa
feedback	pegelo
feel	utlwa
feeling	maikutlo
feeling	ikutlwa
feet	diano
fell	wele
fellow	mothaka
fellow	feelo
fellow	monkana
felt	utlwile
female	tshegadi
fence	terata
fertile	nonneng
fertile	o ka kgona go ima
festival	moletlo
fetch	tsaya
fever	letshoroma
few	nnye
fewer	bannye go
fiance	motho yo o beeleditsweng
fiction	ditlhamane
field	naga
fierce	bogale
fifteen	lesome le botlhano
fifty	masome a matlhano
fight	lwa
fight	ntwa
fighting	lwana
figure	tlhakapalo
figure	popego
figure out	leka go tlhaloganya
file	faele
fill	tlatsa
filled	tletse
film	filimi
filthy	leswe
finally	kwa bokhutlong
finance	madi
financial	tsa madi
find	fitlhela
find out	batlisisa
fine	boleta
fine	tefiso
fine	ntle
finger	monwana
finish	fetsa
finished	feditse
fire	molelo
fire	koba
firm	feme
firm	tia
first	ntlha
first name	leina
fish	tlhapi
fit	tshwanela
fit	itekanetse
fit	kidibalo
five	tlhano
fix	baakanya
fixed	siamisitse
flag	folaga
flash	gadima
flat	sepapetla
flaw	molato
flawless	ntle le molato
flee	tshaba
flesh	nama
flew	fofile
flex	oba
flexible	obega
flight	phofo
flip	phetlha
flirt	tshegatshegisa
flirting	tshegatshegisa
float	kokobala
float	kokobadi
flood	morwalela
floor	boalo
flour	bupi
flow	elela
flower	sethunya
flu	mofikela
fluent	nonofile
fluent	tlhapileng
fluently	elela
fluffy	boleta
fluid	seela
fly	ntshi
fly	fofa
focus	toba
fog	mouwane
foggy	go na le mouwane
fold	mena
folks	batho
folks	batsadi
follow	latela
follow up	latedisa
following	latelang
food	dijo
fool	sematla
foolish	sematla
foot	lenao
football	kgwele ya dinao
for	-ela
for	ka gonne
For example	Sekai
for instance	sekai
for you	ya gago
forbidden	thibetswe
force	pateletsa
forecast	ponelopele
forehead	phatla
foreign	seeng
forest	sekgwa
forever	ruri
forget	lebala
forgive	itshwarele
forgot	lebetse
fork	foroko
form	foromo
form	popego
formal	semmuso
former	pele
fortunately	ka lesego
fortune	lesego
forty	masome a mane
forty-two	somamane le bobedi
forward	kwa pele
foster	tlamela
foster	godisa
fought	lwantsha
found	fitlhetse
foundation	motheo
four	nne
fourteen	somenne
fox	phokoje
fragile	bokoa
frame	foreimi
framework	letlhomeso
fraud	tsietso
freak	sa tlwaelegang
free	mahala
freedom	kgololosego
freeze	gatsetsa
frequency	seelo
frequent	gangwe le gape
frequently	ka gale
fresh	forešhe
friday	labotlhano
fridge	setsidifatsi
friend	tsala
friendly	botsalano
friends	ditsala
friendship	botsala
frightened	tshogile
frightening	tshosa
frog	segwagwa
from	go tloga ka
from	go tswa mo
front	pele
frozen	gatseditswe
fruit	leungo
frustrated	retetsa
frustrated	tsupuetsa
fuel	leokwane
Fulfulde	Fulfulde
full	tletse
fun	boitumediso
function	tiro
fundamental	botlhokwa
funeral	phitlho
funny	tshegisa
fur	bobowa
furious	galefile
furniture	fenitšhara
further	fa pele
furthermore	go feta moo
future	isago
gain	boelwa
game	motshameko
gap	phatlha
garage	karatšhe
garbage	matlakala
garden	tshingwana
garlic	konofole
gate	heke
gather	kokoanya
gathering	kokoano
gauge	selekanyi
gauge	lekanya
gave	neile
gear	kere
gender	bong
general	kakaretso
generally	ka kakaretso
generate	tsala
generate	tlhola
generation	tshika
generous	pelo
genius	letlhale
genre	mofuta
gentle	bonolo
genuine	mmatota
gesture	puo ya matsogo
get	bona
get dressed	apara
get up	ema
get well soon	fola ka bonako
getting	nna
getting	bona
ghost	sepoko
ghosting	go nyelela
giant	dimo
gift	mpho
ginger	gemere
girl	mosetsana
girlfriend	lekgarebe
give	fa
give up	itlhoboga
given	neilwe
glad	itumetse
glance	go leba ka pele
glass	galase
glasses	digalase
glimpse	kgaodiso
global	ya bogotlhe
global	lefatshe ka bophara
gloomy	hutsafetse
gloves	ditlelafo
glow	phatsima
glow up	ntlafala
glue	sekgomaretsi
go	tsamaya
go ahead	tswelela
go away	tsamaya
go to bed	ya go robala
goal	boikaelelo
goal	sekgele
goals	maikemisetso
goals	dino
goat	podi
god	modimo
god bless you	modimo a go segofatse
goes	a tsamaya
going	ya
going to	ya go
gold	gauta
gone	ile
gonna	tla
good	molemo
good afternoon	dumelang
good bye	tsaaya sentle
good bye	sala sentle
good day	dumelang
good evening	dumelang
good job	tiro e ntle
good looking	montle
good luck	keleletso masego
good morning	dumelang
good morning my love	dumela moratiwa
good night	robalang sentle
goodbye	tsamaya sentle
goodbye	sala sentle
goodnight	robalang sentle
goods	dithoto
Google	Google
Google Translate	Phetolelo ya Google
goose	ganse
gorgeous	mebalabala
gossip	tshele
got	bone
got it	e bone
government	puso
grab	phamola
grade	tlhopha ka seemo
grade	seemo
gradually	ka bonya
graduate	sealogane
grain	tlhaka
grant	neya
granted	neetse
grapes	diterebe
grasp	huparela
grass	tlhaga
grateful	tletse ditebogo
gratitude	tebogo
grave	lebitla
gray	pududu
great	tona
great	kgolo
greed	bogagapa
greedy	bogagapa
green	tala
greet	dumedisa
greeting	tumediso
greetings	madume
greetings	ditumediso
grey	pududu
grid	keriti
grief	kutlobotlhoko
grind	sila
grip	tshwaro
grocery	kerosari
groom	monyadi
gross	palogotlhe
ground	mmu
group	setlhopha
grow	gola
growth	kgolo
grumpy	ngongorega ngongorega fela
Guarani	Guarani
guarantee	tshireletsego
guard	molebeledi
guard	lebelela
guess	fopholetsa
guest	moeng
guidance	tataiso
guide	kaela
guide	mosupatsela
guilty	molato
guy	moeka
guys	mathaka
gym	jimi
habit	tlwaelo
habitat	legaetlhago
had	nnile le
hail	sefako
hair	moriri
half	halofo
hall	holo
hand	seatla
handle	mogala
handsome	montle
hang	kaletsa
hang	lepelela
hang out	dula mmogo le ditsala
happen	diragala
happened	diragetse
happiness	boitumelo
happy	itumetse
happy birthday	masego a letsatsi la tsalo
happy birthday to you	itumelele letsatsi la botsalo
happy new year	masego a ngwaga o mošwa
hard	thata
hardly	ka bonnye
hardly ever	le go ka
harm	utlwisa botlhoko
harm	tshenyo
harmful	kotsi
harmony	kutlwano
harsh	bogale
harvest	thobo
has	na le
hate	tlhoa
have	na le
have a good day	tlhola sentle
have a nice day	itumelele letsatsi
have breakfast	ja difitlholo
have fun	ja monate
have you eaten	a o jele
having	na le
hazard	kotsi
haze	lotobo
he	o
he has	o na le
he is	o
head	tlhogo
headache	tlhogo e opang
heal	fola
heal	fodisa
healing	fola
healing	phodiso
health	boitekanelo
healthy	itekanetse
hear	utlwa
heard	utlwile
heart	pelotelele
heat	mogote
heaven	legodimo
heavy	bokete
hectic	lapisa
height	botelele
heir	mojaboswa
heist	kgothoso
held	tshwere
hell	bobipo
Hello	dumelang
hello dear	dumela moratiwa
hello how are you	dumelang le kae
hello how are you doing	dumelang le kae
helmet	helemete
help	thusa
help	thuso
helpful	thusa
hence	ka jalo
her	ene
herd	disa
herd	motlhape
here	fano
heritage	ngwaoboswa
hesitate	okaoka
Hey	Heela
Hi	dumelang
hi how are you	dumelang le kae
Hi there	Dumelang
hidden	fitlhegile
hide	fitlha
hierarchy	tatelano
high	kwa godimo
highlight	supa
hike	haeka
hike	haeke
hiking	tlhatlhogang
hiking	haekang
hilarious	tshegisa
hill	thabana
him	ene
hint	maele
hip	noka
hips	dinoka
hire	thapa
hiring	thapang
his	gagwe
history	hisetori
hit	iteya
Hmm	Ehee
hobby	hobi
hold	tshwara
hold on	tshwarelela
hole	mosima
holiday	khunulogo
hollow	khobetsega
hollow	khuti
home	gae
homework	tirogae
honest	tshepega
honestly	ka nnete
Honey	Mamepe
Honey	Motho wa me
honor	tlotla
hood	lefelo
hook	sekgoge
hop	tlolatlola
hope	tsholofelo
hopefully	ka lesego
hopeless	go tlhoka tsholofelo
horizontal	rapame
horn	lenaka
horrible	maswe
horror	poifo e e rerang
horse	pitse
hospital	bookelo
hospitality	kamogelo
host	moamogelabaeng
hostile	bobaba
hot	bolelo
hotel	hotele
hour	ura
hours	diura
house	ntlo
household	lelapa
how	jang
how about you	wena
how are you	le kae
how are you doing	o ntse o ya jang
how are you doing today	o ntse o ya jang gompieno
how are you today	le tlhotse jang gompieno
how are you today	le tsogile jang gompeino
how do you do	le kae
how is	e jang
how many	kae
how much	bokae
how often	ga kae
how old are you	o na le dingwaga tse kae
how was your day	o tlhotse jang
how was your night	maitiso a gago a ne a le jang
however	le fa go ntse jalo
hub	lefelo
hubby	monna
hug	tlamparela
huge	kgolo
human	motho
humble	boikobo
humid	longola
humidity	bongola
hundred	lekgolo
hungry	tshwerwe ke tlala
hunt	tsoma
hurricane	sesatlana
hurry	itlhaganela
hurry up	itlhaganele
hurt	utlwisa botlhoko
husband	monna
hustle	maiteko
hut	ntlo
hygiene	boitekanelo
I	ke
I am	Ke
I am fine	Ke siame
I am fine	Ke teng
I can	Ke ka
I can	Ke a kgona
I can't	ga ke kgone
I do	Ke a dira
I do not know	Ga ke itse
I do not understand	ga ke tlhaloganye
I don't	Ga ke
I don't know	ga ke itse
I don't understand	ga ke tlhaloganye
I don't understand what you mean	Ga ke tlhaloganye gore o raya jang
I don't understand you	Ga ke go tlhaloganye
I don’t know	Ga ke itse
I don’t understand	Ga ke tlhaloganye
i guess	ke tsaya jalo
I had	ke ke ke na le
I have	Ke na le
I have been	Ke ntse ke
I hope so	Ke solofela jalo
I know	ke a itse
I like	Ke rata
I like you	Ke a go rata
I love	Ke rata
I love my big brother	ke rata mogolole
I love my big sister	ke rata nkgonne
I love my father	ke rata rre
I love my little brother	ke rata nnake
I love my little sister	ke rata nnake
I love my mother	ke rata mme
I love you	ke a go rata
I love you so much	Ke go rata jang
I love you too	ke a go rata le nna
I mean	Ke raya gore
I miss you	ke go tlhwaafaletse
I miss you so much	Ke tlhwaafaletse gore
I see	Ke a bona
I think	Ke nagana
I understand	Ke a tlhaloganya
I want	Ke batla
I want to see you	Ke batla go go bona
I want you	Ke a go batla
I was	Ke ne ke
I will	Ke tla
I would be	Ke ne ke
I'm	Ke
I'm fine	Ke teng
I'm good	Ke siame
I'm here	Ke fano
I'm sorry	ke maswabi
ice	aese
ice cream	bebetsididi
idea	kakanyo
ideal	kgopolo e e eletsegang
ideal	boleng jo bo kwa godimo
identical	tshwanang tota
identify	supa
identity	itshupo
idiot	seeleele
idle	go sa dire sepe
if	fa
ignore	itlhokomolola
ill	bobola
illegal	e seng mo molaong
illness	bolwetse
Ilocano	Ilocano
image	setshwantsho
imagine	akanya
immediate	jaanong jaana
immediately	jaanong jaana
immense	golo thata
impact	go ama
impatient	go se itshoke
implement	tsenyatirisong
import	romela teng
important	botlhokwa
impose	lefisa
impose	laola
impossible	ga go kgonege
impress	kgatlhisa
impression	kakanyo
impressive	kgatlhisa
improve	tokafala
improvement	tokafalo
in	mo
in addition	mo godimo ga foo
In fact	Tota
in front of	mo pele ga
in order to	gore go tle go
inappropriate	eseng matshwanedi
incentive	thotloetso
incident	tiragalo
include	akaretsa
including	go akaretsa
income	letseno
inconvenience	kgoreletsa
increase	oketsa
increased	oketsegile
incredible	go se dumelesege
indeed	ruri
independent	itaola
India	Intiya
indicate	supa
indigenous	segae
individual	mong
industry	madirelo
inevitable	ka se tilwe
infant	lesea
infection	tshwaetso
infinity	bosakhutleng
inflammation	boruruga
inflation	enfoleišene
influence	susumetsa
inform	itsise
information	tshedimosetso
ingredients	ditswaki
inheritance	boswa
initial	pele
initiative	itshimolelo
injured	gobetse
injury	kgobalo
innocent	phepa
innocent	ga a na molato
innovation	boitlhamelo
inquiry	patlisiso
insane	botseno
insect	tshenekegi
insecure	sa tshepe
insert	tsenya
inside	mo teng
insight	temogo
insist	gatelela
insomnia	go tlhoka boroko
inspiration	tlhotlheletso
inspire	rotloetsa
install	tsenya
instance	tshupo
instant	ka gangwe
instead	mo boemong
instead of	mo boemong jwa
instructions	ditaelo
instrument	sediriswa
instrument	seletswa
insult	tlhapa
insurance	inšhorense
intact	ntse sentle
integrity	seriti
intellectual	motlhalefi
intelligence	botlhalefi
intelligent	botlhale
intend	ikaelela
intended	ikaeletse
intense	bogale
intention	boitlhomo
interact	dirisana
interaction	tirisano
interest	kgatlha
interest	kgatlhego
interested	kgatlhegela
interesting	kgatlhisa
interfere	tshwenya
intermediate	magareng
internal	tsa ka fa teng
international	boditšhaba
internship	go ithuta o le mo tirong
interpret	tšhomolola
interpreter	motšhomolodi
interrupt	tsena ganong
interview	potsolotso
interview	botsolotsa
intimate	atamelane
into	mo
introduce	itsise
introduction	kitsiso
introvert	moipone
intuition	poneloteng
invalid	sekoa
invalid	se amogelesege
invent	tlhama
inventory	lenanethoto
invest	beeletsa
investigate	batlisisa
invitation	taletso
invite	laletsa
invoice	lenanetheko
involve	akaretsa
involved	akareditse
involved	nnile le seabe
iron	aene
is	ke
island	setlhaketlhake
isolated	tlhaotswe
issue	kgang
issues	matso
it	se
it is	ke
it was	e ne e le
it's	ke
it's ok	go siame
It's okay	Go siame
item	tema
items	ntlhana e e mo thulaganyong
its	sa
I’m	ke
jacket	baki
jail	kgolegelo
January	Ferikgong
jar	morufa
jaw	motlhagare
jealous	lefufa
jerk	thufulo
jerk	seeleele
jewelry	dibenya
job	tiro
jogging	taboga
join	lomagana
join	lomaganya
joint	tlhakanelo
joke	motlae
journalist	mmegakgang
journey	loeto
joy	boitumelo
judge	atlhola
judge	moatlhodi
juice	matute
july	phukwi
jump	tlola
june	seetebosigo
junk	matlakala
just	fela
just	siama
just do it	dira fela
justice	tshiamiso
justify	siamisa
Kalaallisut	Kalaallisut
keen	tlhaga
keep	tshola
keep it up	tshwara fela jalo
kept	tshwere
kettle	ketlele
key	senotlolo
kick	raga
kid	potsane
kidding	tshameka
kidney	philo
kids	bana
kids	a tshameka
kill	bolaya
kind	mofuta
kind	pelonomi
kinda	ekare
kindly	ka bopelotlhomogi
kindness	pelonomi
king	kgosikgolo
kiss	atla
kitchen	kitšhi
kite	khaete
kitten	katsenyana
knee	lengole
knew	itsitse
knife	thipa
knight	mogale
know	itse
knowledge	kitso
known	itsege
Konkani	Konkani
Krio	Krio
label	setshwao
label	tshwaya
labor	tiro
labour	tiro
lack	tlhaela
ladder	lere
lady	mohumagadi
laid	beilwe
lake	letsha
lamb	kwana
lame	golafetse
lamp	lebone
land	lefatshe
landscape	lenaga
language	puo
lap	latsa
lap	dirope
large	kgolo
last	bofelo
last but not least	sa bofelo mme se e se gore ga se mosola
last name	sefane
late	thari
lately	sešeng
later	kgantele
latest	tsa bošweng
latter	morago
laugh	tshegadi
laughing	tshegang
laughter	setshego
launch	thangkgololo
launch	thangkgolola
laundry	wašhene
law	molao
lawn	bojang
lawn	loboa
lawyer	mmueledi
lay	rapama
lay	beela
layer	tlhatlhagano
layout	boalo
lazy	botswa
lead	etelapele
leader	moeteledipele
leaf	letlhare
leak	dutla
lean	tshesane
leap	tlola
learn	ithuta
learning	ithuta
lease	khiriso ya setsha
least	botlana
leather	letlalo
leave	tloga
leave	lesa
leaves	tsamaile
leaves	matlhare
led	eteletse
left	tlogetse
left	molema
left	tsamaile
leg	leoto
legacy	boswa
legal	semolao
legend	mogaka
legit	mo molaong
leisure	boiketlo
lend	adima
length	boleele
less	bobotlana
lesson	thuto
let	letla
let	hira
letter	lekwalo
letter	tlhaka
lettuce	lethise
level	bogodimo
leverage	neela thata
leverage	sebetsa
liability	maikarabelo a go duela
liability	molato
library	laeborari
lick	gora
lie	aka
lie	rapama
lies	maaka
life	botshelo
lift	tsholetsa
lift	lefiti
light	bofefo
light	lesedi
lightning	legadima
like	rata
likely	kooteng
likely	eletsega
likewise	fela jalo
line	mola
Lingala	Lingala
link	segoke
link	gokaganya
lion	tau
liquid	seedi
list	lenane
listen	reetsa
listening	reeditse
literally	totatota
literature	ditlhangwa
litter	matlakala
little	nnye
live	aga
live	tshela
liver	sebete
lives	matshelo
living	tshelang
living room	phaposi ya kamogelo ya baeng
lizard	mokgantitshwane
load	mokgweleo
load	foraga
loaf	loufu
loan	kadimo
local	selegae
location	lefelo
lock	lotlela
lock	seloto
lockdown	go tswalelwa
log	legong
lol	thubega ka setshego
lonely	jewa ke bodutu
long	telele
long	eletsa
long time no see	kgale re sa bonane
look	leba
loop	segole
loose	repisa
loose	golola
lord	morena
lose	latlha
loss	tatlhegelo
lost	latlhega
lot	ntsi
loud	gelebetega
lounge	boamogelelo baeng
love	rata
love you	rata
lovely	monate
lovely	ntle
low	kwa tlase
lower	tlase
loyal	ikanyegang
loyalty	boikanyego
luck	lesego
lucky	lesego
Luganda	Luganda
luggage	thoto
lump	lekwete
lump	kuruga
lunch	dijo tsa motshegare
lungs	makgwafo
luxury	manobonobo
lying	aka
machine	motšhini
mad	tenegile
mad	tsenwa
madam	mme wa tlotlego
made	dirile
magazine	makasine
magnificent	tlotlometse
maid	mothusi wa mo lapeng
maid	morweetsana
main	kgolo
maintain	babalela
maintenance	tlhokomelo
Maithili	Maithili
major	kgolo
majority	bontsi
make	dira
make up	meikapo
male	tona
mall	mmolo
man	monna
manage	tsamaisa
management	botsamaisi
manager	motsamaisi
mandatory	patelediwa
manifest	senola
manipulate	tshwara
manner	mokgwa
manual	ya diatla
manual	mosupatsela
many	ntsi
many many happy returns of the day	nna le letsatsi le le monate le le segofetseng
march	mopitlwe
margin	morato
market	maraka
marriage	lenyalo
married	nyetse
mask	mmaseke
mask	fitlha
mass	matšhwiti
mass	mmese
massive	boitshegamg
master	mong
master	fenya
match	lekanya
match	motshameko
match	mokgwaro
mate	gwela
mate	molekane
material	didiriso
material	lesela
math	mathemetiki
matter	selo
maturity	bogodi
may	ka
maybe	gongwe
me	nna
me	m (prefix added to a verb)
me too	le nna
meal	dijo
mean	raya
mean	setlhogo
meaning	bokao
means	dithata
means	go raya gore
meant	kaile gore
meanwhile	go sa ntse go le jalo
measure	lekanya
measures	seelo
measures	lekanya
meat	nama
medical	tsa kalafi
medicine	bongaka
medicine	ditlhare
meditation	dikgopolo
medium	magareng
meet	kopana
meeting	kopano
Meiteilon	Meiteilon
melt	gakologa
memories	digopotso
memory	segopotso
mental	tsa tlhaloganya
mention	umaka
mentioned	umakilwe
mentor	morutisi
merchant	mogwebi
mercy	mautlwelobotlhoko
merely	fela
merry christmas	itumelele keresemose
mess	tlhakatlhakano
message	molaetsa
messy	boatla
metal	tshipi
method	mmeo
method	mokgwa
mice	magotlo
middle	gare
midnight	bosigogare
might	ka
mild	bonolo
milestone	kgato e e botlhokwa
military	sesole
milk	mašwi
million	miliyone
mind	tlhaloganyo
mindset	mokgwa wa kakanyo
mine	sa me
mingle	tlhakanya
minor	potlana
minute	motsotso
minutes	metsotso
miracle	motlholo
mirror	seipone
miscellaneous	tsele le tsele
mischievous	senya
miserable	tlhomola pelo
misery	bohutsana jo bogolo
miss	fosa
miss you	go tlhwaafaletse
missing	latlhegile
missing	tlhaelang
mission	mmišhene
mist	mouwane
mistake	phoso
Mizo	Mizo
mobile	mobaele
mock	sotla
model	mmotlolo
moderate	go le gonnye
modern	segompieno
modest	boingotlo
moist	bongola
moisture	khawa
mold	mouto
mole	serunya
mom	mmele
moment	motsotso
monday	mosupulogo
money	madi
monitor	molebeledi
monitor	lebela
monkey	tshwene
month	kgwedi
mood	boikutlo
moody	na le maikutlo a a sa siamang
moon	ngwedi
moral	ngwao
more	go fetisa
moreover	go feta foo
morning	phakela
mortgage	peelo
most	bogolo
mostly	segolo
mother	mme
motion	tsamao
motivation	tlhotlheleso
mountain	thaba
mouse	legotlo
mouth	molomo
move	suta
movement	motsamao
movement	mokgatlho
movie	filimi
mrs	mohumagadi
much	thata
mud	seretse
mug	lebekere
muscle	mosifa
museum	musiamo
mushroom	lebowa
mushroom	gola
music	mmino
must	tshwanetse
mute	didima
my	ya me
My dear	Moratiwa
my friend	tsala ya me
My hovercraft is full of eels	Hovakherafote ya me e tletse ditlhapidikanoga
my love	lerato la me
my name is	leina la me ke
my pleasure	boitumelo jwa me
myself	nna
mysterious	sa itseweng
mystery	masaitsweng
myth	dikinane
nail	lenala
nail	sepekere
naive	sengwana
name	leina
narrative	kanelo
narrow	tshesane
nasty	maswe
national	bosetšhaba
nationality	bosetšhaba
native	semelafa
natural	sa tlholego
nature	tlholego
nausea	go feroga sebete
near	gaufi
nearby	gaufi
nearly	batlile
neat	ithata
necessary	tlhokagala
neck	thamo
necklace	sebaga
need	tlhoko
negative	sa siamang
neglect	tlhokomologo
neglect	tlhokomologa
negotiate	rerisana
neighbor	moagisani
neighborhood	tikologo
neither	epe
nephew	setlogolo
nerd	mankge wa dibuka
nerd	lesutlha
nervous	tshoga
nest	sentlhaga
net	letlowa
network	mararang
neutral	go se tseye letlhakore
never	legoka
never give up	se ke wa bo wa ineela
never mind	itlhokomolose
nevermind	tlogela
nevertheless	le fa go le jalo
new	ntšha
news	dikgang
next	latelang
next to	go bapa le
nice	monate
nice to meet you	ke itumelela go kopana le wena
niece	setlogolo
night	bosigo
nightmare	segateledi
nine	robongwe
nineteen	somerobongwe
ninety	somarobongwe
No	nnyaa
no problem	ga go na mathata
no way	ga go tsela
nobody	ope
noise	modumo
noisy	modumo
none	epe
noon	motshegare
nope	nnyaa
nor	le fa e le
normal	tlealegileng
north	bokone
nose	nko
nostalgic	tlhwafetse
not	eseng
not at all	le e seng
not bad	ga go maswe
Not now	E seng jaanong
not yet	ise
note	kwala
note	tsaya tsia
note	nnoto
noted	etse tlhoko
noted	kwadile
nothing	sepe
notice	kitsiso
notice	ela tlhoko
noticed	lemogile
noun	leina
nouns	maina
novel	ntšha
novel	padi
november	ngwanaatsele
now	jaanong
nowadays	malatsing a
nuisance	letshwenyo
null	lefela
numb	setlasu
number	palo
number	nomore
nurse	mooki
nurse	oka
nut	kgeru
nutmeg	natemeke
nutrition	kotlo
oath	maikano
obesity	monono
obey	obamela
object	selo
objective	morero
objective	ikgaogantsho
obligation	maitlamo
obscure	go nna bofitlha
observation	temogo
observe	ela tlhoko
obsessed	rata tlolo
obsession	lerato la
obsession	go lemalela
obsolete	se se sa tlholeng se dirisiwa
obstacle	sekgoreletsi
obtain	bona
obtained	bone
obvious	bonagala
obviously	go a bonala
occasionally	nako nngwe
occupation	tiro
occupied	nnang
occupied	tshwaregile
occur	diragala
occurred	diragetse
occurs	diragala
ocean	lewatle
october	diphalane
odd	thwadi
odd	setlholo
odds	metso
of	ya
of course	ee gone
off	tswa go
offensive	kgopisa
offer	neela
office	kantoro
official	semmuso
often	gantsi
Oh	Ao
oh really	ao ruri
oil	leokwane
ok	go siame
ok dear	go siame moratiwa
ok honey	go siame moratiwa
ok my love	go siame moratiwa
okay	go siame
okay baby	go siame motho wa ka
okay dear	go siame moratiwa
okay honey	go siame motho wa ka
okay my love	go siame moratiwa
old	tsofetse
on	mo
once	gangwe
once	fa
once	kile
one	nngwe
one language is never enough	puo e le esi ga e kake ya lekana
onion	eie
online	mo inthaneteng
only	fela
open	bula
operation	karo
opinion	kakanyo
opportunities	ditšhono
opportunity	tšhono
opposite	bolebana
optimistic	go nna le tsholofelo
option	tlhopho
optional	ga e patelediwe
or	kgotsa
orange	namune
order	otara
order	taelo
ordinary	tlwaelegile
organization	thulaganyo
orientation	kakanyo
origin	tshimologo
original	tshimologo
Oromo	Oromo
orphan	khutsana
other	nngwe
otherwise	e seng jalo
ought	tshwanetse
our	ya rona
Our mission: to enable everyone, everywhere to understand the world and express themselves across languages.	Maikaelelo a rona: go kgontsha batho botlhe, gongwe le gongwe go tlhaloganya lefatshe le go tlhagisa dikakanyo tsa bone go ralala dipuo.
Our mission: to organize the world's information and make it universally accessible and useful.	Maikaelelo a rona: go rulaganya tshedimosetso ya lefatshe le go dira gore e fitlhelesege le go nna mosola mo lefatsheng ka bophara.
out	tswa
out	ntle
outcome	botso
outfit	diaparo
outgoing	tswang
outlet	kgoro ya go ya kwantle
outline	thadiso
outline	thadisa
outside	kwa ntle
outstanding	saletseng kwa morago
oven	onto
over	fela
over	mo godimo ga
over there	kwa
overall	gotlhegotlhe
overcome	fentse
overthinking	go akanya phetelela
overwhelmed	fekeediwa
overwhelming	fekeetsang
owe	kolota
owl	morubisi
own	rua
owner	mongwe
ox	pholo
pace	lebelo
pack	phuta
package	sephutelwana
package	phutela
paid	duetse
pain	botlhoko
paint	penta
paint	pente
painting	pentang
painting	setshwantso se se pentilweng
pair	sebedi
pale	setlhafetse
palm	legofi
palm	palema
pan	pane
pandemic	leroborobo
panic	tlalelo
pants	tlhologelelwa
pants	fegelwa
pants	marokgwe
paper	pampiri
paradise	parateisi
parallel	bapa
parcel	phasele
pardon	tshwarelo
parents	batsadi
park	phaka
parrot	papalagae
parsley	phasili
part	karolo
participate	tsaya karolo
particular	rileng
particularly	bogolosegolo
partner	molekane
party	moletlo
pass	feta
pass	falola
passage	phaseišhe
passed	falotse
passion	tšhakgalo
passionate	fisegela
passive	upalala
password	khunololamoraba
past	fetileng
patch	pitielo
patch	bitia
path	tsela
pathetic	tlhomola pelo
patience	boitshoko
patient	pelotelele
patient	molwetsi
pattern	sekao
pause	kgaotso
pause	kgaotsa
pavement	pheifemente
pay	tuelo
pay	duela
payment	tuelo
peace	kagiso
peaceful	na leng kagiso
peach	perekisi
peak	setlhowa
pear	pere
peas	dierekisi
peculiar	sa tlwaelegang
pee	ntsha metsi
peel	obola
peer	thaka
peers	dithaka
pen	kwala
pen	pene
pencil	phensele
pending	letetse
people	batho
pepper	pepere
perceive	go lemoga
perception	pono
perfect	itekanetsa
perform	diragatsa
performance	tiragatso
perhaps	gongwe
period	nako
permanent	leruri
permission	tetla
permit	letla
permit	tetlo
perseverance	boitshoko
persistent	tataletse
persistent	tsweletseng
person	motho
personal	sebele
personality	botho
perspective	pono
persuade	tlhotlheletsa
pervert	yo o sokameng
pervert	sokamisa
pet	seotlwana
phase	legato
phenomenon	kgakgamatso
philosophy	filosofi
phone	mogala
photo	senepe
phrase	sekapolelo
physical	ka nama
pick	kgetla
pick	tlhopha
pick up	sela
pick up	tsaya
picture	setshwantsho
piece	setoki
pieces	dikabetla
pig	kolobe
pigeon	leeba
pile	mokoa
pile	kokowanya
pillow	mosamo
pilot	mokgweetsi wa sefofane
pin	kopela
pin	sepelete
pineapple	peineapole
pink	pinki
pit	molete
pitch	boka
pitch	segalo sa lentswe
pity	tlhomogela pelo
pity	kutlwelobotlhoko
place	lefelo
places	mafelo
plague	leroborobo
plain	lebala
plain	tlhamaletseng
plan	leano
plane	sefofane
plant	semela
plants	dimela
plate	poleiti
platform	seralo
play	tshameka
playing	tshameka
pleasant	itumedisang
please	tsweetswee
pleased	itumetse
pleasure	natefo
pledge	itlamo
pledge	peelo
plenty	ntsi
plot	poloto
plug	polaka
plum	poreimi
plumber	polambara
plural	bontsi
podcast	photekhasete
poem	leboko
poetry	poko
point	ntlha
poison	botlhole
police	maphodisa
policy	pholisi
polite	maitseo
pollution	tshilafatso
pond	mogobe
pool	phulu
pool	lekadiba
poop	makaka
poor	humanegile
pop	phunya
popular	itsege
population	palo
pork	nama ya kolobe
porridge	motogo
port	boemakepe
position	maemo
positive	molemo
possess	rua
possession	thuo
possessive	thui
possible	kgonega
post	phoustu
post	poso
postpone	busetsa morago
potato	tapole
potential	bokgoni
pound	thuga
pound	ponto
poverty	lehuma
power	maatla
powerful	maatla
practical	tiriso
practice	bodiri
practice	go dira
praise	pako
praise	baka
prank	motlae
pray	rapela
precious	ratega
precise	molotwe
precisely	re tshe
predict	bonelapele
prefer	rata bogolo
preference	leakanyetsopele
pregnant	imile
prejudice	kgobelelo
premises	mafelo
premises	dikgopolo
premium	karolotuelo
preparation	paakanyo
prepare	baakanya
prepared	ipaakantse
preposition	letlama
presence	boteng
present	mpho
present	teng
present	tlhagisa
presentation	tlhagiso
preserve	dibela
president	moporesidente
press	tobetsa
press	bobega dikgang
pressure	kgatelelo
pretend	dira ekare
pretty	ntle
prevent	kganela
previous	fetileng
prey	sebolawa
price	tlhwatlhwa
pride	mabela
pride	boipelo
priest	moruti
primary	konokono
primary	potlana
prime	golo
prime	boitekanelo
prime	ntlha
princess	kgosigatsana
principal	mogokgo
prior	pele go moo
priority	selo se se tlang pele
prison	kgolego
privacy	bosephiri
private	poraefete
privilege	tlotla
prize	sekgele
prize	rata thata
probably	gongwe
problem	bothata
procedure	thulaganyo
proceed	tswelela
process	tirego
produce	uma
product	kungo
production	kumo
profession	porofešhene
professional	porofešhenale
profile	porofaele
profit	poelo
profit	molemo
profound	boteng
progress	tswelelopele
project	khutlola
project	porojeke
prominent	tlhageletseng
prominent	boemo
promise	tsholofetso
promote	tlhatlhosa
promotion	tlhatlhoso
prompt	rotloetsa
prone	tshabelelwa
pronouns	maemedi
pronunciation	kapodiso
proof	bopaki
proper	siame
properly	sentle
properties	thoto
properties	pharologantsho
property	thoto
proposal	tlhagiso
prospect	potiela
prosperity	tswelelo
prosperous	tswelela
protect	sireletsa
proud	motlotlo
prove	supa
provide	tlamela
provided	tlametse
province	porofense
provision	tlamelo
puberty	bokau
puberty	bokgarebe
public	batho
public	ya setšhaba
pull	goga
pumpkin	lephutsi
punctual	mo nakong
pupil	thaka
pupil	morutwa
purchase	theko
pure	phepa
purple	phepole
purpose	boikaelelo
purse	sekgwama
pursue	latela
pursuit	go sal morago
push	kgorometsa
put	baya
qualification	borutegi
quality	boleng
quantity	palo
quarantine	tlhaolo
quarrel	komano
quarrel	omana
quarter	kwatara
Quechua	Quechua
queen	kgosigadi
queer	yo sa tlwaelegang
query	potso
question	potso
queue	mola
quick	ka pele
quick	itlhaganele
quickly	ka pele
quiet	didimetse
quilt	khwilete
quit	tlogela
quite	ruri
quiz	khwizi
quotation	lenanetlhwatlhwa
quotation	nopolo
quote	nopolo
quotes	mananetlhwatlhwa
quotes	dinopolo
rabbit	mmutla
race	lotso
race	lebelo
rage	kgalefo
rain	pula
raise	godisa
raised	tsholeditse
raised	godisitse
ran	tabogile
random	kgethafela
range	tlhatlhamano
rapid	bofefo
rapidly	ka bonako
rare	sa tlwaelega
rarely	sewelo
rash	boswata
rat	peba
rate	seelo
rather	bogolo
ratio	kabo
rational	rašenala
raw	tala
re	ka ga
reach	filthelela
reached	fitlhile
reaction	tsibogo
read	buisa
reading	puiso
reading	a buisa
ready	siame
real	ya tota
reality	boteng
realize	lemoga
realized	lemogile
really	tota
rear	morago
reason	lebaka
reasonable	isega
recall	gopola
receipt	kamogelo
receipt	rasiti
receive	amogela
received	amogetse
recent	bošeng
recently	gautshwane
reception	kamogelo
recipe	resipi
reckless	se nne kelotlhoko
recognition	temogo
recognize	lemoga
recommend	gakolola
recommended	atlenegisitswe
recommended	atlenegisitse
record	gatisa
recover	busa
recovery	nonofa
rectangle	khutlonnetsepa
red	khibidu
redeem	rekolola
redemption	thekololo
reduce	fokotsa
redundant	fetileng palo
refer	bua ka
refer	romela
reference	tshupetso
reflect	supatshwano
reflection	kakanyo
reflection	tshupotshwano
refrain	ikgogela morago
refrigerator	foritšhi
refund	pusetsomorago ya madi
refuse	gana
refused	ganetse
regard	tsaya
regarding	mabapi le
regardless	ntle le
regards	ka ga
regards	ditumediso
region	kgaolo
register	rejesetara
regret	ikotlhaya
regular	ya gale
regularly	ka gale
reject	galala
relate	amana
related	amana
relationship	kamano
relative	lesika
relative	leamanyi
relatives	masika
relax	iketle
release	golola
released	golotse
relevant	maleba
reliable	ikanyega
relief	thuso
relieve	imolola
relieve	golola
relieved	imolotse
relieved	wetse makgwafo
religion	tumelo
religious	bodumedi
reluctant	itsemeletsa
rely	ikanya
remain	sala
remaining	setseng
remarkable	tlhomogileng
remedy	pheko
remember	gopola
remind	gakolola
reminder	kgakololo
remote	kgakala
remove	tlosa
render	gagola
render	ranola
rent	gagoga
rent	hira
repair	baakanya
repeat	boeletsa
replace	emisetsa
reply	araba
reply	karabo
report	bega
represent	emela
reputation	serodumo
request	kopo
require	batla
required	tlhoka
rescue	falosa
research	patlisiso
resemble	tshwana le
resentment	kgalefo
reservation	pelaelo
reservation	rasefe
reservation	peeletsomanno
reserve	beela
resident	moagi
resign	leboga tiro
resilience	boitsetsepelo
resilient	na le boitsetsepelo
resist	ema kgatlhanong
resistance	twantsho
resolution	tshwetso
resolve	rarabolola
resolve	ikaelela
resort	go ineela
resort	lefelo la boikhutso
resources	metswedithuso
respect	tlotla
respect	tlotlo
respond	araba
response	tsibogo
responsibility	maikarabelo
responsible	nna le maikarabelo
rest	boikhutso
rest in peace	robala ka kagiso
restaurant	resetšhurente
restore	busetsa
restrict	thibela
result	botso
results	dipholo
resume	simolola gape
retail	kgwebo
retain	tshegetsa
retention	go tshegetsa
retired	rotse tiro
retreat	boela morago
retrieve	tsaya
return	busa
return	bowa
reveal	senola
revealed	senotse
revenge	boipusolosetso
revenge	ipusolosetsa
revenue	letseno
reverse	busa
review	sekaseka
revise	boeletsa
revision	poeletso
revolution	modikologo
revolution	tsulolo
reward	tuelo
rhythm	moribo
rib	kgopo
rice	raese
rich	huma
rid	tlosa
rid	golola
ride	palama
ridiculous	sa boeleele
right	moja
right	nepile
right	akere
right now	jaanong jaana
rigid	popota
ring	palamonwana
rinse	tsokotsa
riot	pheretlho
rip	gagola
ripe	butswitse
rise	tlhatlhoga
risk	kotsi
rival	mogadika
river	noka
road	mmila
roast	besa
robust	thata
rock	lejwe
rod	lere
role	seabo
roll	mogaro
roll	pitika
roof	marulelo
room	phaposi
root	modi
rope	kgwele
rotten	bodile
rough	magwata
roughly	ka tekanyetso
roughly	ka kgobololo
round	kgolokwe
route	tsela
routine	modirotlwaelo
row	komang
row	mola
row	fudua
rub	sedila
rub	tshasa
rubber	rabara
rubbish	matlakala
rude	makgakga
rug	mmata
ruin	senya
rule	busa
rule	molao
ruler	mmusi
ruler	rulara
rules	melao
run	taboga
running	tabogang
rural	selegae
rush	lepotlapotla
rush	itlhaganela
sack	kgetsi
sacred	boitshepo
sacrifice	setlhabelo
sacrifice	ntsha setlhabelo
safe	bolokesega
safe flight	leoto la sefofane le le babalesegileng
safety	polokego
sage	seiji
said	rile
sail	saile
sail	tsamaya ka sekepe
sailing	tsamaya ka sekepe
sake	ntlha
salary	tuelo
sale	thekiso
sale	sesolo
salmon	salemone
salt	letswai
same	tshwana
Same here	Go a tshwana le fano
sample	sampole
sand	santa
Sanskrit	Sanskrit
sarcastic	na le ngongolo
sassy	makgakga
sat	dutse
satisfaction	kgotsofalo
satisfied	kgotsofetse
satisfy	kgotsofatsa
satisfying	kgotsofatsang
Saturday	Lamatlhatso
sausage	boroso
savage	motho yo motala
save	boloka
saw	bone
say	re
scale	sekale
scam	tsietsa
scam	tsietso
scar	lebadi
scarce	tlhokega
scared	tshogile
scarf	sekhafo
scary	tshosang
scattered	phatlhaletse
scene	felo
scene	tema
scenery	lenaga
scent	monkgo
schedule	thulaganyo
school	sekolo
science	bonetetshi
scientist	monetitshi
scientists	banetetshi
scissors	dikere
scold	omanya
scope	sekoupu
score	sekoro
score	nosa
scrap	thatanyana
scratch	ngapa
scream	gowa
screen	sekerine
screw	kurufelela
script	lokwalo
sea	lewatle
seal	sekano
seal	letshwao
search	phuruphutsa
season	paka
seat	bodulo
second	bobedi
secret	sephiri
section	karolo
secure	tlhomameng
secure	bolokesega
security	tshireletso
see	bona
see you	ke tla go bona
see you later	ke tla go bona kgantele
see you soon	ke tla go bona mo bogautshwaneng
see you tomorrow	ke tla go bona kamoso
seed	peo
seek	batla
seem	lebega e kare
seems	ekete
seen	bone
seize	tshwara
seizure	go ngatega
seldom	sewelo
select	tlhopha
self	bonna
self	boena
self healing	iphodiso
selfish	timana
sell	rekisa
send	romela
send me your picture	nthomelela setshwantsho sa gago
senior	mogolo
sense	kutlo
sensible	molemo
sensitive	sisimoga
sent	rometse
sent	romile
sentence	katlholo
sentence	polelo
sentences	dipolelo
separate	tlhaola
separate	kgaoganya
Sepedi	Sepedi
september	lwetse
sequence	tatelano
series	tlhatlhamano
serious	masisi
serious	tlhonama
seriously	ka tlhwaafalo
serve	direla
service	tirelo
session	kopano
set	tlhoma
set	sete
set up	siamisa
setting	lefelo
setting	tlhomo
settle	ineela
settle	itshetlega
seven	supa
seventeen	somesupa
seventy	somasupa
several	mmalwa
severe	thata
sew	rokile
shade	moriti
shadow	moriti
shake	tsikinya
shall	tla
shallow	seng boteng
shame	tlhabisa ditlhong
shame	ditlhong
shape	popego
share	arolelana
sharp	bogale
she	o
she has	o na le
she is	o
shed	tsholola
shed	tlhotlhorega
shed	leobo
sheep	nku
sheet	lakane
sheet	letlhare
shelf	šelofo
shell	kokola
shell	kgapetla
shell	kgopana
shelter	botshabelo
shield	sireletsa
shield	thebe
shift	sutisa
shine	phatsima
ship	sekepe
shipping	go romela
shirt	hempe
shoes	ditlhako
shoot	thunya
shop	lebenkele
shopping	go reka
shore	losi
short	khutshwane
shortage	tlhaelo
shot	thuntsitse
should	tshwanetse
shoulder	legetla
shout	goa
show	pontsho
show	bontsha
show me	mpontshe
shower	shawara
shrimp	šhirimpo
shrink	ngotlega
shut	tswala
shut up	didimala
shy	ditlhong
sibling	ngwana wa ko gaabo
sibling	ngwana wa ko gae
siblings	bana ba motho
sick	lwala
side	letlhakore
sigh	go kgwa mowa
sight	pono
sightseeing	bona mafelo a a kgatlisang
sign	letshwao
signature	tshaeno
significant	botlhokwa
silence	tidimalo
silent	didimetse
silk	silika
silly	o seeleele
silver	selefera
similar	tshwanang
simp	seso
simple	bonolo
simultaneously	ka gangwe
since	e re ka
since	e sa le
sincere	pelo e phepa
sincerely	ka botswapelo
sing	opela
singer	moopedi
single	nosi
sink	nwela
Sir	Morena
sister	nnake
sister	nkgonne
sister	kgaitsedi
sister in law	mogwe
sister in law	mogokane
sit	dula
site	lefelo
situation	seemo
six	thataro
sixteen	somethataro
sixty	somamarataro
size	tekanyo
skill	kgono
skills	dikgono
skin	letlalo
skinny	sesane
skip	tlola
skirt	sekete
sky	loapi
slave	lelata
sleep	robala
sleeping	robetse
sleepy	otsela
sleeve	letsogo
slice	selae
slide	relela
slide	theletsane
slightly	go se sekae
slim	sesane
slip	thupana
slope	mogkokolosa
slot	nako
slow	bonya
slowly	ka bonya
small	nnye
smart	botlhale
smart	ntle
smell	monkgo
smile	monyenyo
smile	nyenya
smoke	mosi
smooth	borethe
snack	seneke
snail	kgopa
snake	noga
snap	kgagogela
snap	kgaoga
snow	semathana
so	jalo
so cute	ntle jang
so far	ga jaana
soak	inela
soap	sesepa
sober	ikgaphile
soccer	kgwele ya dinao
social	seloago
society	loago
socks	dikausu
soft	boleta
software	serweboleta
soil	mmu
sold	rekisitswe
sold out	fedile
soldier	lesole
sole	nosi
solid	tiileng
solution	tharabololo
solve	rarabolola
some	ngwe
somebody	mongwe
somehow	ka tsela nngwe
someone	mongwe
something	sengwe
sometimes	dinako dingwe
song	pina
soon	kgantele
sophisticated	marara
Sorani	Sorani
sore	botlhoko
sore throat	mometso o botlhoko
sorrow	kutlobotlhoko
Sorry	ikwatlhaya
Sorry	kutlobotlhoko
sort	mofuta
sort	tlhaola
sought	batlile
soul	motho
soul	mowa
sound	modumo
soup	sopo
sour	botlhale
source	motswedi
south	borwa
space	lefaufau
space	sebaka
spam	sepeme
span	paralatsa
span	sepane
Spanish	Spanish
spare	falodisa
spare	nngwe
speak	bua
special	kgethegileng
species	mefuta
specific	rileng
spectacular	morekaarekise
speech	puo
speechless	tlhoka puo
speed	lebelo
spell	peleta
spell	kgakge
spend	dirisa
spent	dirisitse
spent	nnile
spicy	baba
spike	tlhaba
spike	tlhatlhoga
spike	lomapo
spin	dikolosa
spinach	sepinatšhe
spirit	mowa
spit	kgwa
spit	mathe
splendid	ntle
split	phatloganya
spoil	senya
spoiled	sentse
spontaneous	ka nosi
spoon	leso
spot	lefelo
spot	bona
spouse	mogatsa
spread	phatlalatsa
spring	motswedi
spring	dikgakogolo
square	sekwere
squeeze	gamola
squid	sekwidi
squirrel	mošha
stab	tlhaba
stable	setale
stable	tlhomama
stack	mokoa
stack	tlhatlhaganya
staff	badiri
stage	seralo
stage	kgato
stain	selabe
stairs	ditepose
stake	seteiki
stalk	motlhaka
stalk	kukuna
stall	botlhatlhelo
stamp	setempe
stand	ema
standard	maemo
star	naledi
start	simolola
started	simolotse
starving	tshwere ke tlala
state	mmuso
state	boemo
statement	polelo
station	seteišhene
statue	sefikantswe
status	seemo
stay	dula
stay safe	nna o bolokesegile
steady	tsepama
steak	seteike
steal	utswa
steam	fufutsa
steam	phufudi
steel	tshipi
steep	ina
stem	kutu
step	kgato
stick	matarela
stick	thupa
stiff	tiile
still	kokobala
still	sa
sting	loma
sting	lobolela
stingy	timana
stir	fuduwa
stock	setoko
stolen	utswitswe
stomach	mpa
stone	letlapa
stood	eme
stool	mantle
stool	setilo
stop	emisa
storage	polokelo
store	lebenkele
store	setoro
storm	sefefo
story	kgang
stove	setofo
straight	tlhamaletse
straightforward	tlhamaletse
strain	kgatelelo
strange	seeng
stranger	moeng
strategy	togamaano
straw	lotlhaka
strawberry	setoroberi
streak	ralala
streak	moraladi
stream	molapo
street	mmila
strength	maatla
stress	kgatelelo
stress	gatelela
stretch	ngantsolola
strict	bogale
strike	ditshupetso
strike	tlhasela
string	mogala
string	senara
strip	sekgetšhana
strive	lwa
strive	leka ka natla
stroke	titeo
stroke	seterouku
strong	thata
struck	beditswe
structure	popego
struggle	kgaratlha
struggle	kgaratlho
struggling	sokola
stubborn	tlhogo e thata
stuck	kgomaretse
student	moithuti
study	ithuta
studying	ithutang
studying	ithuta
stuff	dilo
stunning	ntle
stunning	gakgamamtsa
stupid	sematla
style	setaele
subject	ikobela
subject	kgang
subject	serutwa
submission	boineelo
submit	tsenya
substance	sere
substitute	moemedi
subtle	matsetseleko
succeed	atlega
success	tswelelopele
successful	atlegile
such	ntse jalo
such as	jaaka
suck	momona
sudden	ka tshoganyetso
suddenly	ka tshoganyetso
suffer	boga
suffering	tshotlego
sufficient	lekane
sugar	sukiri
suggest	tsitsinya
suggestion	tlhagiso
suit	sutu
suit	tshwanela
suitable	tshwanela
suitcase	sutukheise
sum	palo
sum	tlhakano
summary	tshobokanyo
summer	selemo
summit	samiti
summit	setlhoa
sun	letsatsi
sunday	Latshipi
sunny	nang le letsatsi
sunset	phirimo ya letsatsi
sunshine	phatsimo ya letsatsi
super	golo
superior	gaisang
supervisor	motlhatlhobedi
supper	difitlholo
supply	naya
support	tshegetso
suppose	tsaya gore
supposed	tshwanetse
supposed	naganne
sure	tlhomama
surface	tlhaga
surface	boalogodimo
surge	kgomogo
surge	koketsego
surgery	karolo
surgery	boalafelo
surname	sefane
surprise	gakgamatsa
surprise	kgagamalo
surprised	maketse
surrender	ineela
surrounding	tikologo
surveillance	tshekatsheko
surveillance	tekanyo
survey	lekanya
survey	tshekatsheko
survive	go phologa
suspect	mmelaelwa
suspect	belaela
suspended	beetswethoko
suspicious	belaetsa
sustain	tsweletsa
sustainability	go tswelela
sustainable	ya leruri
swag	moswenko
swallow	kometsa
swap	refosana
swear	ikana
swear	rogana
sweat	fufula
sweat	mofufutso
sweater	jeresi
sweep	gogola
sweep	feela
sweet	botshe
sweet dreams	ditoro tse di monate
sweet tooth	rata botshe
sweetheart	mokapelo
swell	ruruga
swelling	boruruga
swim	thusa
swimming	thumang
swing	ya kwa pele le kwa morago
switch	fetola
swollen	rurugile
sword	sabole
symbol	letshwao
sympathy	kutlwelobotlhoko
symptoms	ditshupo
system	thulaganyo
table	tafole
tackle	rarabolola
tag	theke
tail	mogatla
take	tsaya
take away	tsamaya ka yona
take care	tlhokomela
take off	tloga
take off	tlosa
taken	tseilwe
talk	bua
talkative	balabala
tall	telele
tap	thepe
tap	kokota
tape	theipi
target	setotiwa
task	tiro
taste	tatso
tasty	latswega
taught	rutile
tea	mogodungwana
teach	ruta
teacher	morutabana
team	setlhopha
tear	gagola
tear	keledi
tears	dikeledi
tease	rumola
technology	thekenoloji
teeth	meno
tell	bolelela
tell me	mpolelela
temper	bogale
temperature	themperetšha
temple	tempele
temporary	nakwana
ten	lesome
ten thousand	dikete tse di lesome
tenant	mohiri
tend	a tle
tend	oka
tend	disa
tendency	tlwaelo
tender	thendara
tender	nolo
tense	paka
tense	gagamala
tension	kgogakgogano
tension	kgagamatso
tent	tente
tentative	sa totobalang
term	paka
terms	mafoko
terms	metlha
terrible	maswe
terrific	gaisa
territory	naga
test	teko
test	leka
text	sekwalwa
than	go na le
thank	leboga
thank you	Ke a leboga
Thank you for your patience while we investigate shipment	Re lebogela bopelotelele fa re ntse re batlisisa thoto e e rometsweng
thank you so much	ke leboga thata
thank you very much	ke leboga thata
thanks	Ke a leboga
Thanks for using our app	Re lebogela fa o dirisitse epo ya rona
that	gore
that	e
that is	ke gore
that's good	go siame
theft	bogodu
their	tsa bona
them	bone
theme	morero
themselves	bone ka bobone
then	ka nako eo
theory	tiori
there	foo
there are	go na le
there is	go na le
therefore	ka jalo
these	tse
they	ba
they are	ba
thick	kima
thief	legodu
thigh	serope
thin	tshesane
thing	selopo
things	dilo
think	nagana
third	boraro
thirsty	tshwerwe ke lenyora
thirteen	lesometharo
thirty	masomeamararo
this	se
this is	se ke
thorough	feta mo
thorough	ka
thoroughly	ka botlalo
those	bao
though	ntswa
thought	kakanyo
thoughtful	boakanyetsi
thoughts	dikakanyo
thousand	sekete
thread	mogala
threat	tshosetsa
threat	matshosetsi
threaten	tshosetsa
three	tharo
threshold	serepodi
thrilled	itumetse tota
thrive	gola sentle
throat	mometso
through	ka
throughout	ka nako ya
throw	latlhela
thumb	kgonotswe
thunder	duma
thunder	modumo wa tladi
Thursday	Labone
thus	jalo
tick	kgofa
tick	tshwaya
tide	lekhubu le le tlhatlogang
tidy	ithata
tie	bofa
tie	thae
tiger	nkwe
tight	gagamala
Tigrinya	Tigrinya
time	nako
timid	boi
tiny	nnyenyane
tip	kgakololo
tips	maele
tire	lapisa
tired	lapile
tissue	thitšhu
title	setlhogo
title	leina
to	go
to be	go nna
toast	thousotu
today	gompieno
toddler	mapimpana
toes	menwana ya dinao
together	mmogo
toilet	ntlwana
told	boleletse
tolerance	go itshokelana
tolerate	itshokela
tomato	tamati
tomorrow	kamoso
tongue	leleme
tonight	bosigong bono
too	thata
too	le
took	tseile
tool	sediriswa
tools	didiriswa
tooth	leino
top	godimo
topic	setlhogo
torn	gagogile
torture	bogisa
total	palogotlhe
touch	ama
tough	thata
tour	go ja nala
tour	loeto
toward	go
towards	go
towel	toulo
town	teropo
toxic	botlhole
trace	gatisa
trace	motlhala
trace	latela motlhala
track	motlhala
trade	gweba
tradition	dingwao
traditional	tsa setso
traffic	pharakano
trail	motlhala
train	terena
training	katiso
training	katisa
trait	ponalo
traits	dipopego
transfer	fetisa
transition	phetogo
translate	fetolela
transparent	letsatsa
transport	tsamaisa
transport	dipalangwa
transportation	thwalo
trap	serai
trash	matlakala
trash	senya
trauma	manokonoko
travel	eta
tray	terei
treasure	letlotlo
treat	tshwara
treatment	kalafi
treatment	tsholo
tree	setlhare
tremendous	golo
trend	ganelela go
trend	kganelelo
trial	tsheko
trick	tsietsa
trick	leano
tried	lekile
tried	sekisitswe
trigger	tsosa
trim	kera
trip	loeto
trouble	mathata
trouble	tshwenya
trousers	borokgwe
truck	teraka
true	NNETE
trunk	kutu
trunk	selopo
trunk	teranka
trust	tshepa
truth	nnete
try	leka
Tsonga	Tsonga
Tswana	Setswana
tube	tšhupu
Tuesday	Labobedi
tuition	thuto
turkey	kalakune
turmeric	tšhumeriki
turn	tsoketso
turn	faposa
turtle	turtle
tutor	morutisi
twelve	some le bobedi
twenty	masomamabedi
twenty-one	somamabedinngwe
Twi	Twi
twice	gabedi
twist	lokolola
twist	soka
two	pedi
type	thaepa
type	mofuta
typical	tlhophegileng
ugly	maswe
ultimate	gaisang
ultimate	ya bofelo
umbrella	sekgele
unable	se kgone
uncle	malome
unconscious	idibetse
unconscious	idibetseng
under	kwa tlase
underneath	tlase
underrated	tseelwa tlase
understand	tlhaloganya
understood	tlhalogantse
unfortunately	ka bomadimabe
uniform	yunifomo
unique	kgethegileng
unit	yuniti
university	yunivesithi
unknown	ga e itsege
unless	fa
until	go fitlha
unusual	sa tlwaelega
up	godimo
up to you	go tswa mo go wena
update	tlhabolola
upgrade	tokafatsa
upon	mo godimo ga
upset	kgophola
urban	seteropo
urge	rotloetsa
urgent	makgabeadipapetla
us	rona
use	dirisa
used	dirisitse
used	dirisitsweng
useful	mosola
useless	go tlhoka molemo
usual	tlwaelegileng
usually	tle
utility	sediriswa
vacation	itapoloso
vaccination	moento
vaccine	moento
vacuum	lolea
vague	go sa totobal
valid	amogelesega
valley	mogorogoro
valuable	nang le boleng
value	tlhwatlhwa
variety	mothalethale
various	farologaneng
vary	farologana
vase	morufašeše
vast	kgolo
vegetable	morogo
vegetables	merogo
vehicle	serori
vendor	morekisi
venom	botlhole
venture	bowelo
venue	lefelo
verify	rurifatsa
versatile	fetogangfetogang
version	thanolo
vertical	molatsepama
very	thata
very good	bontle tota
vessel	setsholo
via	ka
vibe	natefelwa
vibes	maikutlo a natefo
vicious	bogale
victim	motswasetlhabelo
video	vidiyo
view	pono
village	motse
villain	molotsana
vinegar	vinekara
vintage	tsa bogologolo
violence	dikgoka
violent	nna dikgoka
viral	ka ga mogare
viral	tlalatlala
virgin	legammana
virtual	mo inthaneteng
virtue	nonofo
vision	pono
visit	eta
visit	ketelo
visual	tsa pono
vital	botlhokwa
vivid	bonalang sentle
vocabulary	tlotlofoko
voice	lentswe
void	dirolola
volume	volumu
volunteer	moithaopi
volunteer	ithaopa
vomit	tlhatsa
vulnerable	mo kotsing
wage	mogolo
wages	dituelo
waist	letheka
wait	leta
waiter	moabadijo
waiting	eme
wake	tsosa
wake up	tsoga
walk	tsamaya
walking	tsamaya
wall	lebota
wallet	walete
wander	kaila
wanna	batla
want	batla
wanted	batlile
war	ntwa
wardrobe	wotoropo
warehouse	polokelo
warm	bothito
warn	tlhagisa
warning	tlhagiso
warrior	motlhabani
was	ne
wash	tlhatswa
waste	matlakala
waste	senya
watch	tshupanako
watch	leba
water	metsi
watermelon	legapu
wave	lekhubu
way	tsela
we	re
we are	re
we can	re ka
we can	re a kgona
weak	bokoa
weakness	bokowa
wealth	khumo
wealthy	humile
wear	apara
wearing	apereng
weather	bosa
wedding	lenyalo
Wednesday	Laboraro
weed	mofero
week	beke
weekend	mafelo a beke
weight	bokete
weird	sa tlwaelega
welcome	amogelesega
welfare	katlaatleloloago
Well	siame
well done	dirile sentle
well done	botsisitswe
went	ile
were	ne
west	bophirima
wet	kolobile
whale	leruarua
what	eng
what about you	go tweng ka wena
what are you doing	o dirang
what are you doing now	o dirang jaanong
what are you doing right now	o dira eng jaanong jaana
what do you do	o dira eng
what do you do for a living	o dira eng go itshedisa
what do you mean	o raya jang
what do you want	o batlang
what happened	go diragetseng
what is	ke eng
what is this	ke eng se
what is your job	tiro ya gago ke eng
what is your name	leina la gago ke mang
what's up	dintshang
what's your name	leina la gago ke mang
whatever	eng kapa eng
wheat	korong
wheel	leotwana
when	motlhang
when	leng
whenever	nako nngwe le nngwe
where	kae
where are you	o ko kae
where are you from	o tswa kae
where are you now	o ko kae jaanong
where do you live	o nna kae
where is	e kae
whereas	le mororo
whether	kana
which	efe
while	ya re
while	lobaka
whisper	seba
whistle	molodi
whistle	letsa molodu
white	tshweu
who	mang
who	yo
who are you	o mang
who is	ke mang
who is this	ke mang yo
whole	feletse
whom	yoo
whose	ga mang
why	goreng
why not	goreng
wicked	ikepa
wide	atlhama
widow	motlholagadi
width	bophara
wife	mosadi
wild	tlhaga
will	tla
will	thato
willing	batla
win	fenya
wind	phefo
window	letlhaphefo
windy	diphefo
wine	veine
winter	mariga
wipe	phimola
wire	terata
wisdom	botlhale
wise	botlhale
wish	keletso
wish you all the best	nala
wish you all the best	katlego
wish you all the best	masego
witch	moloi
with	ka
with	le
withdraw	gogela morago
withdrawal	kgogo
within	mo teng
without	ntle le
witness	paki
witty	ka matlhajana
wolf	phiri
woman	mosadi
women	basadi
won	fentse
won't	nkitla
wonder	kgagamatso
wonderful	gakgamatsa
wood	legong
wool	bobowa
word	lefoko
words	mafoko
work	tiro
work out	tsamaya sentle
work out	itshidila mmele
working	dirang
world	lefatshe
worm	seboko
worn	aperwe
worried	tshwenyegile
worry	tshewenyega
worse	maswe go feta
worship	obamela
worst	maswe go gaisa
worth	boleng
worth it	go mosola
worthy	tshwanelwa ke
would	o ne a tla
wound	ntho
Wow	Haa!Haa!
wrap	phutela
wrath	tšhakgalo
wrist	letlhalela
write	kwala
Write here	Kwala fa
writing	mokwalo
written	kwadilwe
wrong	fosa
wrote	kwadile
yard	jarata
yawn	edimola
Yeah	Mm
year	ngwaga
years	dingwaga
yeast	yisiti
yell	goa
yellow	serolwane
Yes	ee
yes baby	ee motho wa ka
yes dear	ee moratiwa
yes honey	ee moratiwa
yes my love	ee moratiwa
yes of course	ee nnete
yesterday	maabane
yet	ise
yield	ntsha
yield	kungo
you	wena
you are	o
you are beautiful	o montle
you are so beautiful	o montle jang
you are welcome	o amogelesegile
you can	o ka
You know	Waitse
you too	le wena
you're welcome	O amogelesegile
young	nšha
your	gago
your welcome	kamogelo ya gago
yourself	wena ka wesi
youth	boša
youth	baša
you’re welcome	o amogetswe
yummy	monate
zero	lefela
