a	kaisa
a	Khoroksa
a	masa
a little	kisasa
a lot	kwbangma
a lot of	kwbangma
abandon	yakarwi thangmani
abandoned	khibi kwlangjak
abide	kok khwnai tongmani
ability	chukmung
able	chukjak
about	no twiwi
above	sakao
abroad	phatar hathai
absence	manjagwiya
absence	kwrwi wngmani
absent	manjakphailya
absent	kwrwi
absolutely	Ahaino
absorb	bisingo kusubuisio
abstract	abstract
absurd	mwnwikothok
abundance	khurumpui
abundant	nangmani saibo bkwbang
abuse	satokmung
accent	kok samani goron
accept	gosimani
access	hablam
accident	lahar patimung
accommodation	tongjaknai thiti khlaimani
accomplish	mungsaswk khlaimanmung
accomplished	accomplished
according	hainohai
account	lekhama
accuracy	kwkwrwk
accurate	kosol
accused	majra berjak
ache	samani
achieve	manmung
achievement	manmung
acknowledge	gosimung rwmani
acquaintance	sinilaimani
acquire	manmani
acquired	manjak
acquisition	paijak manwi
across	gwnangwi
act	toke mwsamani
action	yapri
active	kwsrang
activities	samung bwtangrok
activity	samung khlaimanirok
actor	toke mwsanaisa
actual	kubuio
actually	kubui sana thangkhe
acute	belaikheno
adapt	gwdalwi namani
add	thepamani
addicted	loi yakarmaya wngmani
addition	kwtharwmani
additional	teibo
address	nikuma
adequate	kulokmani
adjacent	nanglaijak
adjective	adjective
adjust	jora bai gwdalwi tongma
admire	naithokjakmani
admit	damani
adopt	dottok naharmani
adorable	maya mannani chukjak
advance	swkang bariya
advanced	swkangjak
advantage	sep kaham
adventure	adventure
adverb	Samungni dal
advertisement	awaimung
advertising	awai khlaimung
advice	dagimung
advise	kokbiti
advocate	advocate
aesthetic	naithothok
affair	patimung
affect	mari kwlaimani
affection	maya
afford	rang kwrwini bagwi mungsaswk paimaya wngmani
affordable	pai manthokmani
afraid	kirijak
after	ulo
afternoon	dipor
afterwards	yagulo
again	teisa
against	kebengwi
age	umor
agency	khajak kaisa motha eba baniya
agent	agent
aggressive	jolikwrak
agile	Kwsrang
ago	swkango
agree	gosimani
agreement	gosimung bwlai
agriculture	hukbar
ahead	bwskango
aid	chubachu
aim	naharmung
air	nobar
airport	Birkhungkhola
aisle	doglam
alarm	Sakhlaimung
alcohol	chuwak
alert	hojak
alive	kwthang
all	joto
all right	doh ako
all the best	kwplai wngdi
allow	gosimung rwmani
allowed	gosimung manjak
almost	paitwtwi
alone	saichung
along	bai baksa
already	swkang bariyano
Alright	Ako
also	bo
alternative	kubuni lama
although	haitwtwi phano
always	molbrum
am	wngkha
amazing	Belai naithok
ambiguous	thiti wngjakya
ambition	naharmung
ambitious	ambitious
amend	swlaimung
amid	kwcharo
among	ni bisingo
among us	chini bisingo
amount	swk
amusing	mwnwikothok
analysis	amjogwi naimani
ancestors	agini borokrok
anchor	anchor
ancient	agini joog ni
and	tei
and you	nwngkhe
angel	suari
anger	jolimung
angle	babai
angry	jolijak
animal	malmata
ankle	yakarai
anniversary	bisi pungmani
announcement	saklaimung
annoy	jolirwma
annoyed	jolijak
annoying	jolimasingsa
annual	bisibrum
anonymous	Mungjuda
another	kubuni
answer	kok kiphilmung
anticipate	wansuk tongmani
anxiety	wanamani
anxious	wanama bagwi kha tongthokya wngmani
any	jesa
anymore	teibo
anyone	kebo khoroksa
anything	jesa manwi
anyway	jesa wngthung
anyways	jesaphano wngthung
apart	karwi
apart	hakchal
apartment	apartment
apologize	nakarmung sanmani
apparent	dadak-sidak
apparently	tumung no
appeal	koimung
appear	nukjakmani
appearance	nukjakmani
appeared	nukjakmani
appetite	okhuima
apple	apel
application	koimung
apply	koimani
appointment	malaina jora thiti khlaimani
appreciate	mungsaswk eba khoroksaswk no twiwi kaham samani
appreciation	samung chajakmani
approach	thang kok saimani
appropriate	kwkwrwk
approval	gosimung
approve	gosimung rwmani
approved	gosimung manjak
approximately	andaj khlaimani
april	Tallang-Taltung
arbitrary	muchungmatwi
architect	tangkwrwng
architecture	architecture
archive	archive
are	Wngkha
are you	Nwng ___ da
are you busy	Nwng samung pailaya da wngjak
are you married	Nwng kaijak da
are you married or single	Nwng kaijak da na sikla
Are you still there?	Nwng tamo samung khlai
are you there	Nwng to da tong
area	amchai
argue	kok banglaimani
argument	kok banglaimani
arise	sichamani
arm	kangkhung
army	sengkrakrok
around	ganagini
arrange	manjumani
arrangement	tiyari khlaimani
arrival	phai sokphaimani
arrive	sokphaimani
arrived	phai shokphaikha
arrogant	jolikrak
arrow	teer
art	rigmung
article	swimung
artificial	kubui ya
artist	akinakwrwg
as	haikhe
as long as	tongsak
as well	bo
as well as	bo
ash	thapla
ashamed	lachijak
ask	swngdi
asked	swngjak
asleep	mwktrwi thangjak
aspect	nai-nukmung
Assamese	Assamni borok
assault	assault
assembly	luku kuthummung
assertive	kebono kiriya
assess	amjogwi naimani
assessment	amjokmung
asset	asset
assets	assets
assign	samung yapharmani
assignment	samung bakjak
assist	chubamani
assistant	assistant
associate	tanglogisong
associated	gwdaljak
association	motha
assume	sak sak wansugwi namani
assumption	assumption
at	wo
at least	kisaphano
ate	chakha
athlete	thwngkwrwng
attach	thepadi
attached	kwthajak
attachment	kwthamung
attack	hamla khlaijakmani
attempt	chaitokmung
attend	manjakmung
attendance	manjakmung
attention	kha rwmani
attitude	khoroksani wansukmung kitingwi bini tongmung
attract	kha sotonmung
attraction	kha sotonma
attractive	mokol sotonnai
attribute	goon
audience	naitongnairok
august	Taltuk-Talbang
aunt	kaki
aunt	totoi
aunty	Moi
aunty	mami
aunty	yong bwrwi
authentic	kwkwrwk
author	bijap swinai
authority	bubagra
autumn	bwlai kwlaimani mol
available	manthogo
average	cholidrop
avoid	nukyamasikhe tongmani
awake	sichajak
award	sokat
aware	hojak
awareness	hojak khlaimung
away	hakchalo
awesome	belaikheno kaham
awful	belai chaya
awkward	lachimasingsa wngmani
Aymara	Aymara
baby	kwlwi bwsa
bachelor	sikla
back	unklog
background	background
bad	chaya
bag	bag
bait	lubh rwmani
bake	shongmani
bakery	ruti phalnok
baking soda	chajaknai soda
balance	balance
ball	ball
Bambara	Bambara
banana	thalik
band	band
bang	tokmani
bank	bank
bar	bar
barely	belaino kisa
bargain	swk khailaimani
bark	buphang bukur
bark	swi swngmani
barley	bojra
barrier	kasumung
base	base
based	rwkjak
based	gwdaljak
based	kitingjak
basement	basement
basic	nangmani kokrok
basically	sana thangkhe
basil	banta
bastard	borok hamya
batch	batch
bath	tukumani
bathroom	tukumani khotol
battery	battery
battle	choba
bay	twiwar
be	wngdi
be careful	be careful
beach	twibomrukung
beam	chwngmari
beans	koshoirok
bear	rujumani
bear	twimani
beard	shengkhari
bearing	rujui tongmani
beast	maya kwrwiborok
beat	bumani
beautiful	Naithok
beauty	naithokmung
became	wngma
because	tangwi hinkhe
become	wngkha
bed	khat
bedroom	thumani khotol
bee	pia
beef	musuk bahan
been	tongmani
beer	beer
before	swkango
began	chengkha
begin	chengmani
beginning	chengphuru
behalf	bini wngwi
behave	tongmung
behavior	tomung
behaviour	tongmung
behind	unklugo
being	tongwi tongmani
belief	poito chamani
believe	poito chamani
belly	bohok
belong	keboni wngmani
beloved	hamjakma borok
below	tolao
belt	belt
bench	bench
bend	kongmani
beneath	tolao
benefit	kaham sep
benefits	sep saprok
beside	ganao
besides	obo bai baksano
best	kahamkuk
best of luck	kwplai wngdi
best regards	khakchangma yapharo
better	teisa kaham
between	kwcharo
beverage	nwngjaknairok
beyond	laijak
Bhojpuri	Bhojpuri
bias	chajakma borokno simi sep rwmani
biased	Babaisa bwkhak
bicycle	cycle
bid	swk chongmani
bid	ringhormani
big	kotor
bike	bike
bill	bill
bind	khamani
bird	tok
birthday	achaima sal
bit	kisa
bite	warmani
bitter	kwkha
black	kosom
blade	kubuk bukhuk
blame	dush bogmani
blank	Bukcha
blanket	dulai
blast	permani
bleach	manwi phursarwnai
blend	mishimani
bless	diyari
blessed	hamari manjak
blind	mokol kana
bliss	hamari
block	kasumani
blood	thwi
bloom	kiyokmani
blow	hama shubdi
blue	nokha pali
blunt	bugya
board	naikolmotha
boat	rung
body	sak
boil	rugmani
bold	kebono kiriya
bond	halok
bone	bekereng
book	bijap
boost	phan rwmani
booster	chubachu khlainai
boot	bootrok
boots	bootrok
border	ari
bore	selema
bored	selejak
boring	selemasingsa
born	achaikha
borrow	solok naharmani
boss	bubagra
both	kwnwi no
bother	jala rwmani
bother	keboni bagwi wansukmani
bottle	bottle
bottom	tola
bought	paikha
bounce	baharwi thangmani
bound	khobmani
boundaries	arirok
bow	swmai
bowl	bati
box	box
boy	chwla
boyfriend	hamjakma chwla
bracelet	Mathiya
brain	brain
branch	bedek
brand	peyara
brave	kha kotor
breach	raida swbaimani
bread	ruti
break	swbaimani
breakfast	phungni chamung
breast	abuk
breath	hama
breathe	hama namani
breed	bosong
brick	it
bride	kwina kwtal
bridge	yakhrai
brief	chikontia
bright	kwchwng
brilliant	kwrwng borok
bring	tubudi
bro	takhuk
broad	kuwar
broadcast	awaimung
broke	baijak
broken	kwbai
broom	nokshi
brother	phayung
brother in law	Buprangsa
brother in law	Kumui
brought	tubukha
brown	ha pali
brush	hujaknai
bucket	balti
buddy	yaar
budget	borok bangjak
bug	yongsa kuksa
build	tangmani
building	pakanok
built	tangjak
bulk	kwbangmakhe
bull	miship
bully	sikrimani
bump	atumsa thutaimani
bunch	bunch
bundle	bundle
burden	barja hilik
buried	phobjak
burn	khammani
burst	phatimani
bury	phobmani
bus	bus
bush	sham
business	baniya
bust	abuk
busy	samung pailaya
but	Phiya
butter	makhon
butterfly	larima
button	butam
buy	paimani
by	yaktui
by the way	sana thangkhe
bye	thangkha
cabbage	kopi
cabinet	montrisabha
cage	along
cake	Nangkukma jora
calf	musuk bwsa
call	ringmani
call me	ano call khaidi
called	ringjakha
calm	kwchang kwchang
came	phaikha
campaign	shibir
can	mano
can't	maya
Cancel	rosai namani
cancer	cancer bemar
capable	chukjak
capacity	bangmung
capital	auli amchai
caption	caption
capture	romwi chobwi tonimani
capture	segwi namani
car	malkhung
career	samung
careful	kahamkhe
careful	bailkhe
carefully	kahamkhe
carefully	jaikhe
careless	careless
caring	nainai borok
carpenter	mistri
carpet	lamthai
carrot	gajor
carry	twimani
carry on	lamsogwi thangmani
carry out	samung bomani
case	majra
cash	rang cash
cast	rwmani
castle	nuyungma
casual	haino tongma
cat	aming
catch	yachakdi
category	berem
cattle	rwmani malmata
caught	yachakha
cause	mungsaswk wngmani unklugo tongmani kok
cause	wngrwmani
caution	kahamkhe wansugwi yapri sedi
cautious	cautious
cave	guha
cease	mwthakjak
ceiling	nukhung saka
celebrate	palailaimani
cell	kush
center	kendra
century	philsara bisi
cereal	cereal
ceremony	panda
certain	kaisaswk
certainly	abono
certificate	sinimung bwlai
chain	bwtang
chair	achukphang
challenge	batiama
chance	sep
change	swlaimung
chaos	chaos
character	goron
characteristics	goron
charge	barja
charity	charity
charming	naithok
chart	chart
chase	rwktharma
chat	kok samani
cheap	rang kisao
cheat	thokaimani
cheating	phemlokmani
check	amjogwi naidi
cheek	khanga
cheer	mwnwirwma
cheerful	mwnwi tongnai borok
cheers	cheers
cheese	cheese
chemistry	chemistry
cherish	muitu khlaimani
chess	daba
chest	khakwlab
chew	warmani
chicken	tok bahan
chief	ojama
child	cherai
childhood	cheraiphuru
children	cherairok
chill	kha tongthogwi tongma
chimneys	hoku thangmani lam
chin	khosai
chocolate	chocolate
choice	chongwi namani
choose	saidi
chop	tanmani
chores	nokni samungrok
chubby	khanga ongkhorjak
church	Girja
cinnamon	dalchini
circle	kiting
circumstances	wngma
citizen	amchai ni borok
city	auli
claim	dabi khlaimani
clarify	kahamkhe buchirwmani
class	rem
clay	harpek
clean	kwsap
clear	kwsap
clerk	clerk
clever	simani
client	client
cliff	hapung kinar
climate	nobar twibar
climb	sakao kasamani
clingy	kwphaimang tongnai
clock	ghori
close	kholobdi
closet	alna
cloth	ri
clothes	richumrok
cloud	chumui
cloudy	chumui koboljak
clown	joker
clue	clue
clumsy	yapai chaya
cluster	kuthumjak
cluster	khajak
coach	phwrwngnai
coal	hoki
coast	coast
coat	kutai kutung
coffee	coffee
cognitive	gyan rwkjak
coincidence	coincidence
cold	kwchang
collapse	collapse
collar	Bokrom
colleague	samung tangsong
colleagues	samung tanglogisong
collect	thummani
collection	thummung
college	Rwngnok kotor
color	pali
colorless green ideas slept furiously	pali kwrwi kwkhrang wansukmungrok jolijaklai thulaikha
colour	pali
column	column
comb	betra
combination	gwdalmung
combine	gwdalwi
come	phaidi
come here	oro phaidi
come on	phainaba
comfort	tongthok chathok
comfortable	tongthothok
coming	phai tongo
coming soon	daktino phai tongo
command	dagimung
comment	comment
commercial	baniya rwkjak
commission	commission
commit	commit
commitment	kok rwmani
committed	kha chabjak
commodity	manwi-khwnwirok
common	tong kosong
communicate	kwrwnglaimani
communicate	kok salaimani
communication	kok kwrwngmung
community	hoda
commute	thanglaisu
companion	logisong
company	motha
compare	batai naimani
comparison	comparison
compassion	maya nangmani
compassionate	maya gwnang
compatible	kwthamani
compete	bataimung
competent	Sisukjak
competition	bataimung
competitive	batainani wansukmung
complain	kok silsamung
complaint	kok silsamung
complement	complement
complete	samung khlai paimani
completely	jotophasingtui
complex	kwlai ya
compliance	gosimung rwmani
complicated	kwlai ya
compliment	kebono bolaimani
comply	gosimani
composition	swnamjakmani
compound	nokhla
comprehension	simani
comprehensive	kwbang
compromise	buchiwui tongmani
compulsory	nango no
computer	computer
concentrate	concentrate
concept	wansukmung
concern	keboni bagwi wanamani
concerned	wanamani
concert	hukumu
conclusion	kok kisao samani
concrete	paka ni
condition	kaham hamya tongmani
conditions	raidarok
conditions	kaham hamyarok
conduct	songchamani
conference	kok malaimung panda
confess	chayano gosimani
confidence	sak baithang poito chamani
confident	sak baithangni sakao poito chamani
confirm	thiti khlaima
conflict	kok thaisa wngya
confused	chabwimaya
confusion	Ubrumjabrum
congrats	chibai nono
congratulation	chibai
congratulations	chibai
conjunction	malaimani
connect	connect
conquer	manmani
conquer	jitimani
conscious	hojak
consciousness	saimanmung
consent	gosimung rwmani
consequences	bwthairok
conservation	khatimung
conservative	khati tonimung
consider	wansukjadi
considered	chongjak
consist	bisingo tongmani
consistency	consistency
consistent	consistent
constant	bar bar khlaimani
constantly	bar bar
constipation	bohok rakjak
construction	tangmani
consume	chamani
consume	namani
consumption	chamani
contact	kwrwngmani
contagious	solothothok
contain	narwk tongmani
contains	oro tongo
contemporary	tabukni jora
contempt	lachima rwmani
content	kok bothoma
content	kha tongthokmani
contest	bataimung
context	context
continent	kwbangma island gwnang hathai
continue	lamsogwi thangdi
contract	chukti khamani
contrast	kisaphano solya
contribute	chubamani
contribution	chubachu
control	thung naikolwi tonimani
controversial	controversial
convenience	je chajakmatuikhe
convenient	khoroksani bagwi kwlai
conversation	kok salaimani
convert	swlaidi
convey	koktun kwcharmani
convince	gosirwmani
convinced	gosinamani
cook	shongmung
cooking	songmani
cool	Doh khe
cooperation	gwdalwi samung khlaimani
cope	samlokmung
copper	tama
core	bisingni
corn	mogodam
corner	kuna
correct	soi
cost	swk
costume	ri chum
cottage	chikontia kaisa nok
cotton	tula
cotton	suti ni ri
couch	sofa
cough	kuchuk
could	khamu
council	Kokchapnok
count	lekhamung
counter	kebengmung
country	haktor
countryside	hapung hathai
couple	hisangnwi
courage	kha kwrak
course	lama
court	dorbarnok
courtesy	tongmung kaham
cousin	mamani bwsa
cousin	kakani bwsa
cover	bukur
cow	mushuk
coward	khetopa
cozy	tongthogo
crab	khangrai
crack	phatimani
craft	baniya
crap	kok sitra
crash	thutai kwlaimani
craving	mungsaswk chana muchungmani
crawl	malmani
crazy	kobor suluk
create	swnammani
creative	creative
credit	credit
creep	creep
creepy	kirimasingsa
crew	samung tangsong
crime	samung sitra
cringe	lachimasingsa wngmani
crisis	biyali
criteria	je nangmanirok
critical	wanamasingsa wngjak
criticism	criticism
crop	muikwthwngrok
crops	kaijak buphangrok
cross	laimani
crow	tokha
crowd	luku kubung
crowded	luku kwbang
crown	mukut
crucial	nangkukma
cruel	maya kwrwi
cruise	cruise
crush	naithokjakmani borok
cry	kabmani
cucumber	sosa
cuddle	kwbagmani
culture	hukumu
cunning	belai chalak
cup	kap
cupboard	alna
curb	kasumung
cure	sak kaham khlaiphimani
curfew	curfew
curiosity	saimanna muchungmani
curious	saimanna muchungmani
curly	koitroi
currency	chol
current	wngtong jora
currently	wngtong jorao
curse	swraimung
curtain	porda
cushion	tusuk
custom	raida
customer	painai
customs	tongkaham
cut	rajakmani
cute	naithotok
cycle	cycle
cycling	cycle kajak
dad	Baba
daddy	baba
daily	salbrum
dairy	dairy
dam	Baan
damage	chaya khlaima
damn	hiro
damp	kishi
dance	mwsamung
danger	danger
dangerous	kirimasingsa
dark	andar
darling	khachuk
dash	thutaimani
data	kokthumrok
date	salmari
daughter	sajwk
day	sal
dead	kwthwi
deadline	khajak jora
deaf	khunju khwnaya
deal	chukti
dear	khajani
Dear All	Khajani takhuk-bukhungsong
Dear Customer	Khajani
Dear Parents	Khajani buma-buphasong
Dear Sir	Borom Gwnang Sir
Dear students	Khajani swrwngnairok
Dear Team	Khajani motha
death	Langma chomani
debate	debate
debit	rang swbaimani
debris	debris
debt	solok
decade	bisi chi ni yagulo
decay	shogwi thangmani
deceased	kwthwi
deceive	thokokmani
december	Talbung-Talhing
decent	kahamno
decide	kokchabmani
decided	kokchapjak
decision	kokchap
deck	sajokmani
deck	Rung kotorni paka
decline	hache thangmani
decrease	kisai thangmani
dedicated	saktarjak
dedication	dedication
deed	khlaithai
deep	kuthuk
deer	mwswi
default	chugya wngmani
defeat	mechenma
defend	kasuma
define	define
definitely	Ao khlainaino
definition	soi mane
degree	college o pori pass wngmani
delay	lermani
delayed	lerjak
delete	hui rwmani
deliberate	muchungtwtwi khlaimani
delicate	kwlwi
delicious	kothok
delight	tongthokmung
delighted	tongthokjak
deliver	yapharmung
delivered	yapharjak
delivery	tunwimani
demand	dabi khlaimani
demanding	sanmung
democracy	Luku chongraida
demon	mwtai hamya
demonstrate	khlai phunukmani
denied	gosiliya
density	rwjamani
dentist	buwa nainai
deny	gosiya wngmani
department	bedek
departure	lam rwmani
depend	shungjak
deploy	samungo tichokmani
deposit	yapharma
depressed	belai wanajak
depression	wanamung kuplung
depth	thukmani
describe	sukrubui sadi
description	sukrubui samani
desert	hasingkhor
deserve	manna tongmani
design	design
designation	samung khlaithani
desire	muchungmung
desk	table
despair	tei poito chaliya
despair	jora hamya
desperate	muchungsukjak
despite	haiphano
dessert	kwtwi
destination	thang shogwijaknai thai
destiny	destiny
destroy	chaya khaisibaima
destruction	swbaisibaimani
detail	sukrubui
details	details
detect	naitukmanmani
determination	determination
determine	kha chongwi najak
determined	Kha chabjak
devastated	wanajak
develop	tormani
developed	hamkrai manjak
development	hamari
device	pherang bai samung khlainai manwi
devil	soitan
devoted	kha thonjak
Dhivehi	Dhivehi
diabetes	Swtwibemar
diarrhea	khimani bemar
diary	diary
dictionary	dictionary
did	khlaikha
die	thwidi
died	thwikha
diet	chamung
difference	solya wngmani
different	juda juda
difficult	kwlai ya
dig	khurdi
dignity	borom
diligent	porisrom khlainai borok
dinner	horni mai
dip	mishima
direct	dadak-sidak
direction	digio
director	dagiphang
dirt	shimuk
dirt	harpek
dirty	sitra
disable	disable
disabled	disabled
disappear	kwmamani
disappointed	kha baijak
disaster	deramung
discard	khibima
discharge	kogwi manmani
discharge	rwi rohorjakha
discipline	raida bai tongmani
discount	rang khairwirwmaiba
discover	naituk karimung
discrimination	borok saimani
discuss	kok chablaima
discussion	kok chablaimung
disease	bemar
diseases	bemarrok
disguise	sinijakyatwikhe
disgusting	selengmasingsa
dish	chamung
dishes	chamungrok
dismiss	rohormani
dispatch	dakti rohormani
display	phunukmung
disposal	rohormani
dispute	kok banglaimani
distance	lama chalmani
distinct	juda
distinguish	shinimung
distress	birman
distribution	bakmung
district	hangkor
disturb	disturb
ditch	kwmai paimani
ditch	hakoor
dive	twi yokma
diverse	juda juda
diversity	dal bidal
divide	khagmani
divine	chuknohani
divine	kwthar
divorce	kaklaima
dizzy	dizzy
do	Khlaidi
do you	Nwng _____ da __
do you love me	nwng ano ha da hamjak
doctor	sak nainai
document	proman bwlairok
does	khlaio
doesn't	ya
dog	swi
Dogri	Dogri
doing	khlai tongo
doll	putla
domain	domain
domestic	nokni
dominant	jotoni sai kuchuk
don't	ta
Don't worry	Ta wanadi
donate	rang bai chubamani
done	khlaipaijak
donkey	gada
dope	sidi nwngmani
double	kwswngnwi
doubt	poito chaimaya wngmani
dough	ata
down	tolao
download	download
draft	draft
drag	sotonmani
drain	sokorwi khibimani
drama	toke
draw	rikmani
drawer	drawer
drawing	rigmani
dread	kirima
dream	Imang
dress	richum
drill	training rwjakmani
drill	phugmani machine
drink	nwngdi
drive	chalokdi
drop	khiklaimani
dropped	kwlaikha
dropped	kogkha
drought	ha ranjak
drunk	nwngjak
dry	kwran
duck	takhum
dude	takhuk
due	baki tongrwkma
due to	ni bagwi
dull	thwijak
dumb	siya kukya borok
dump	manwi tikhlai tonibaimani
duration	khajak jora
during	choli tongphuru
dust	haduli
duty	khlaithai
dwell	haino beraimani
dying	thwi tongo
each	khoroksawui
each other	khoroksa tei khoroksano
eager	kha thonjak
eagle	tokling
ear	khunju
earlier	swkango
early	aisiri siri
early	jorani swkang
earn	ajimani
ears	khunjurok
earth	hayung
earthquake	bangla
ease	kwlai khlaimamani
easily	kwlaisakhe
east	Salka
easy	kwlai
eat	chadi
eating	chai tongo
economic	rangsimung
economy	rang-rini raida
edge	kuna
edit	swnamphimung
education	rwng swrwng
effect	wngmung
effective	samung khlaio
efficiency	chukmung
efficient	kwrwng
effort	chaitokmani
egg	toktwi
eggplant	phantok
ego	ohonkar wngmani
eight	char
eighteen	chichar
eighty	charchi
either	eba
elaborate	subrubui kok samani
elbow	kunee
elder	okra
elderly	okra-chakra
elegant	naithothok
element	Bokcho
elephant	mayung
eleven	chisa
eligible	chukjak
eliminate	tikhlai rwmani
else	hayakhe
embarrassed	lachimung manmani
embarrassing	lachimasingsa
embrace	gosi namani
emerge	bachai phaimani
emergency	nangkukma jora
emotional	khao nangnai
empathy	maya gwnang
emphasis	phan boksinmani
emphasize	phan boksinmani
employee	sebuk
employees	sebukrok
employer	samung rwnai
employment	sebuk tichokmani
empty	bukcha
enable	chugrwmani
encounter	malai rwmani
encourage	kha bachama
end	paithak
endangered	komorna naima
endeavor	thinangni samung
endurance	soimani phan
endure	soi tongmani
enemy	sejaknai borok
energy	phan
engage	kok swngjak
engaged	kok swnglaijak
engagement	gwdalmani
engine	engine
engineer	engineer
English	Ingraji
enhance	teibo kaham khlaimani
enjoy	tongthoklaidi
enormous	kotorma
enough	wngkha
ensure	thiti khlaima
enter	habmani
entertainment	kha tongthokrwnai
enthusiasm	muchungmung
enthusiastic	muchungmung tongmani
entire	bebak
entitled	mannani chukjak
entity	borok eba motha
entrance	hablam
entrepreneur	entrepreneur
envelope	kham
environment	tongkhor
envy	rishi twimani
epic	belai kotor
epic	belai kolok
epidemic	mahamari
equal	baksakhe
equipment	manwi-khwnwi
equity	kubui tongmani
equivalent	baksa baksa
eraser	hujaknai
error	chaya
escape	kharmung
especially	dorokuk
essay	kokbwkhal
essence	ros
essential	nangkukmani
establish	songchamani
established	songchajakha
estate	keboni paijak kuwar hathai
estimate	chongmani
estimated	chongjak
etc	akorok
eternal	eternal
ethics	langmani raida
evaluate	amjoknaimani
evaluation	amjoknaimung
even	phano
even though	haitwtwiphano
evening	sarik
event	panda
eventually	paithago
ever	waisaphano
every	joto
everybody	joto
everyone	joto
everything	bebak
evidence	mokol baithang nuknai
evidence	proman tongma
evil	chaya
evolution	chasamung
evolve	tesa tormani
Ewe	Ewe
ex	agini
exact	khoropsa
exactly	khoropsakhe
exam	amjokmung
examine	amjogwi naimani
example	nukmari
exceed	lai thangmani
excellent	belaino kaham
except	karwi
exception	karmani
excess	belai kwbang
excessive	belai kwbangkheno
exchange	bodlao
excited	kha tongthokjak
excitement	kha tongthokmani
exciting	tongthothok
exclusive	abono karwi
excuse	nakarmani
excuse me	tamo hinkha
execute	samung bomani
execution	bwtharmani
executive	executive
exercise	biyam khlaimani
exhaust	khibimani
exhaust	lengmani
exhausted	lengprajak
exhibit	phunukmani
exhibition	phunukmung
exist	tongwi tongmani
existence	hayungo tongmani
existing	tongwi tongmani
exit	thanglam
expand	warmung
expect	kha chongma
expected	je wansukmani
expenses	rang baimanirok
expensive	morok
experience	manjakphaimani eba nugwiphaimani gyan
experiment	amjogwi maimung
expert	kwrwng borok
expired	jora laijak
explain	buchirwmani
explanation	sukrubui buchirwmani
exploit	satokmani
explore	cherwi naimani
export	phalhorma
expose	phataro
exposed	bswkango kubui tubujak
exposed	phiyokjak
exposure	nukjakma
express	janokmani
expression	mwkhang wnwgi phunukmani
extend	phuwarmung
extended	phuwarjak
extension	warmani
extent	kisasa le
external	phatartui
extinct	komorwi thangjak
extra	teibo kubuni
extract	extract
extraordinary	buino solya
extreme	belaikheno
extremely	belaino
eye	mokol
eyes	mokolrok
fabric	rini dal
fabulous	belai naithok
face	mwkhang
facilitate	sep rwmani
facilities	sep-saprok
facility	sep sap
fact	kubui kok
factor	wngmani karon
factory	swnammungkhor
facts	kubui kok
fade	fade
fail	mechenma
failed	mechenkha
failure	mechenmani
faint	faint
fair	soi
fairly	soi lamtui
fairy	suari
faith	poito
faithful	poito chajaknai borok
fake	tatal
fall	kwlaimani
FALSE	tatal
fame	Borom
familiar	sinijak
family	nukhung
famine	famine
famous	mung gwnang
fan	kiship
fancy	wansukmungo chajakmani
fancy	imang
fantastic	belainon kaham
far	hakchal
farewell	kaklaimung panda
farm	kheto
farmer	hukbar khlainai
fascinating	belaino kha sotonnai
fashion	fashion
fast	dakti
fat	kuphung
fatal	Kirimasingsa
fate	kwpalo swijak tongmani
father	pha
fatigue	lengmani
fault	chaya wngmani
favorite	hamjakukmani
favour	sep rwmani
favourite	hamjakukmani
fear	kirimung
feast	kotor chamung
feather	bwkrang
feature	goron
features	goronrok
february	Talrung-Talslang
fed up	akaikha
fee	rwthai
feed	charwmani
feedback	kok kiphilmung
feel	mungasaswk hai ma tongmani
feeling	ma tongmani
feet	yakung
fell	kwlaikha
fellow	borok
felt	matongkha
female	bwrwi
fence	bera
fertile	bwthai thainai
festival	ter
fetch	thang naharwimani
fever	kulum
few	kisasa
fewer	teibo kisa
fiance	Kokswngjak chwla
fiction	fiction
field	kheto
fierce	belai tungphlajak
fifteen	chiba
fifty	bachi
fight	walaimai
fighting	walai tongo
fighting	solailai tongo
figure	mangpili
figure out	lama tikhlainai
file	file khata
fill	supungdi
filled	supungjak
film	toke
filthy	sitra
finally	paithago
finance	ranghalok
financial	ranghalokni kok
find	naitukdi
find out	naituk tikhlaimani
fine	kaham
finger	yasi
finish	paidi
finished	paikha
fire	hor
firm	kwrak
first	puila
first name	puila mung
fish	Aah
fit	chukjak
five	ba
fix	thepamani
fixed	khajak
flag	bana
flash	tikhlaiphunukmani
flash	phatsa
flash	philiksa
flat	chepta
flaw	chaya tongmani
flawless	Kahamkuk
flee	kharmani
flesh	bahan
flew	birwi thangkha
flex	kongmani
flexible	koithotok
flight	birmani
flip	uphildi
flirt	phatra thwngmani
flirting	kara thwngmani
float	float
flood	twi tormani
floor	paka
flour	ata
flow	lujakthangmani
flower	khum
flu	kulum-kongrai
fluent	kahamkheno rwngmani
fluently	kwchayaui
fluffy	sopung sopung
fluid	twi hai
fly	birmani
focus	kha thonjak
fog	siari
foggy	Siyari Kupulwng
fold	thebdi
folks	lukurok
follow	yapri songma
follow up	kwrwngmung
following	rwktharmani
food	chamung
fool	siya kukya borok
foolish	kobor hai
foot	yakung yapha tola
football	football
for	ni bagwi
For example	jemon romdi
for instance	romwi nadi
for you	nini bagwi
forbidden	khlaimaya
force	phan rwi mungsaswk khlaimani
forecast	forecast
forehead	talka
foreign	fatar hathai
forest	bolong
forever	langma choyasak
forget	pokmani
forgive	nakarmung rwmani
forgot	pogkha
fork	kata chamis
form	koimung bwlai
formal	samung rwkjak
former	agini
fortunately	Kwpal kaham
fortune	kwpal kaham
forty	bwrwichi
forty-two	brwichinwi
forward	swkangjak
foster	pushimani
fought	walaikha
found	naitugwi mankha
foundation	yarwng
four	bwrwi
fourteen	chibwrwi
fox	siyal
fragile	baina kwlai
frame	sak
framework	bekherep
fraud	tatal borok
freak	kobor suluk
free	samung kwrwi
freedom	yokmung manmani
freeze	lorimaya
freeze	changrwma
frequency	frequency
frequent	prai no
frequently	jora kwbang romwi
fresh	kwtal kwtal
friday	phasal
fridge	fridge
friend	kiching
friendly	jotobai kwthanai
friends	kichingsong
friendship	kiching ni halok
frightened	kirijak
frightening	kirimasingsa
frog	yongwla
from	ni thani
front	bswkang
frozen	borof wngmani
fruit	bwthai
frustrated	frustrated
fuel	thok
Fulfulde	Fulfulde
full	kuplung
fun	tongthok
function	samung khlaimani
fundamental	nangkukmani
fundamental	puilani
funeral	shradho
funny	mwnwikothok
fur	bikhumu
furious	belai jolijak
furniture	furniture
further	teibo
furthermore	teibo
future	thinang
gain	ajimani
game	thwngmung
gap	phaak
garage	garage
garbage	khibijaknai manwi
garden	bagan
garlic	risun
gate	thanglam
gather	kuthummung
gathering	luku kuthumlaimung
gauge	suinaimani
gave	rwjak
gear	gear
gender	shir
general	tong kosong
generally	tong kosongo
generate	tikhlaima
generation	swnammani
generous	kha gwnang
genius	kwrwng borok
genre	berem
gentle	kwchang
genuine	swraiswrai
gesture	tongmung bai phunukmani
get	manmung
get dressed	kaham richum chumma
get up	bachadi
get well soon	dakti kaham wngdi
getting	manwi tongo
ghost	burasa
ghosting	kwmai tongma
giant	danob
gift	yakpai
ginger	haching
girl	bwrwi cherai
girlfriend	hamjakma bwrwi
give	rwdi
give up	yakarwi rwmani
given	rwjak
glad	khakchangjak
glance	philiksa nukmani
glass	glass
glasses	chosma
glimpse	philiksa
global	hayung gwnangwi
gloomy	dujak
gloves	yakni muja
glow	kwchwng
glow up	chwngwi phaima
glue	atha
go	thangdi
go ahead	thangdi
go ahead	agukdi
go away	kutuldi
go to bed	thuna thangdi
goal	naharmung
goals	Paithak
goat	pun
god	Mwtai
god bless you	Mwtai no hamari rwthung
goes	thango
going	thangwi tongo
going to	khlaina nai tongo
gold	rangchak
gone	thangpaijak
gonna	khaina nai tongo
goo	harpek ebakhe jesaphano swrabnai manwi
good	Kaham
good afternoon	dipor kaham
good bye	thangkha
good day	sal kaham
good evening	Sarik kaham
good job	samung kaham
good looking	naithothok
good luck	samung khlaithani kwplai wngdi
good morning	Phung Kaham
good morning my love	Phung Kaham ani hamjakma
good night	hor kaham
goodbye	thangkha
goodnight	hor kaham
goods	manwi-khwnwirok
Google	Google
Google Translate	Google Kokswlaima
goose	takhum
gorgeous	Belai naithok
gossip	gossip
got	mankha
got it	saimankha
government	haphang
grab	grab
grade	rem
gradually	twrwk twrwkhe
graduate	college pass wngjak
grain	gom dalni manwi
grant	gosimung rwmani
granted	gosijakha
grapes	angur
grasp	manmung
grasp	romwi narwkmani
grass	shaam
grateful	habai ma yapharo
gratitude	hambai yapharmani
grave	grave
gray	thapla hai
great	Kahamkuk
greed	lubh wngmani
greed	manna muchungsukmani
greedy	lubh soya
green	kwkhrang
greet	lamsokmani
greeting	Lamsokmani
greetings	Hamsokrwma
grey	thapla hai
grid	grid
grief	kha khammani
grind	hulmani
grip	rommani
grocery	phalnok
groom	naithokrwmani
gross	bebagwi
ground	thwngkhola
ground	ha sakao
group	dol
grow	tormani
growth	tormani
grumpy	thamchi tungjak
Guarani	Guarani
guarantee	guarantee
guard	mwrwknai borok
guess	chongwi naidi
guest	nograi
guidance	lama phunukmung
guide	lama phunukmung
guilty	chaya samung khlainai
guy	chwla
guys	bayarok
gym	biyam
habit	loi
habitat	tongthai
had	chakha
hail	kothor kwlaimani
hair	khwnai
half	khaksa
hall	hall
hand	yak
handle	naikolmung (to handle)
handsome	chwla naithok
hang	khachidi
hang out	phataro beraimani
happen	patimani
happen	wngmani
happened	patimung wngkha
happiness	kha tongthokma
happy	kha tongthok
happy birthday	Tongthok Achaima Sal ni Chibai
happy birthday to you	Nono tongthok achaima salni chibai
happy new year	Tongthok bisi kwtalni chibai
hard	kwrak
hardly	belia kisano
hardly ever	waisaphanoseya
harm	dukhu
harmful	chaya
harmony	tongkwchang tonmung
harsh	belai no kora
harvest	kai achaibaimanirok
has	tongo
hate	nashlemung
have	thani tongma
have a good day	nini sal kaham wngthung
have a nice day	nini sal kaham wngthung
have breakfast	phungni mai chadi
have fun	tongthoklaidi
have you eaten	nwng chakha da
having	tongo
hazard	hazard
haze	siari wngjak
he	Boro
he has	bini thani tongo
he is	Bo wngkha
head	bokhorok
headache	bokhorok samani
heal	kha swrangrwmani
healing	hamphimani
health	sakham
healthy	kaham kwrwng
hear	khwnadi
heard	khwnakha
heart	bwkha
heat	tungphlamani
heaven	chuknuha
heavy	hilik
hectic	pailaya wngjak
height	lokmung
heir	Sandai
heist	heist
held	songchajakha
hell	kundul
Hello	Khulumkha
hello dear	Khulumkha takhuk
hello how are you	Khulumkha Nwng bahai tong
hello how are you doing	Khulumkha Nwng bahai tong
helmet	Khorokthukulup
help	chubagradi
helpful	chubachu rio
hence	hinkhe
her	bini
herd	malmata rwnaisa
here	oro
heritage	hukumu
hesitate	mungsaswk khlaina soiya wngma
Hey	Oi
Hi	Khulumkha
hi how are you	Hi nwng bahai tongsa
Hi there	khulumkha
hidden	huijak
hide	huijakmani
hierarchy	berem
high	kuchuk saka
highlight	nukjakrwmani
hike	Rangmari barima
hiking	hiking
hilarious	mwnwikothok
hill	hapung hathai
him	bono
hint	maar manmani
hip	khichlang
hips	khichwlangrok
hire	samungo tichokmani
hiring	tichogwi tongo
his	bini
history	laibuma
hit	sugwi kwlangmani
Hmm	hmm
hobby	khlaina chajakmani
hold	romdi
hold on	tongradi
hole	hakor
holiday	sal duamung
hollow	bisingo bukcha
home	nok
homework	nogo swijaknai
honest	kubui borok
honestly	kubuisano
Honey	Khachuk (beloved)
Honey	Pia bwtwi
honor	borom
hood	bwklap
hook	hook
hop	tor tor baharmani
hope	kha khlaima
hopefully	kha khlaio
hopeless	kha baijak
horizontal	rokojak
horn	bokorong
horrible	belaino chaya
horror	Selengsuk
horse	korai
hospital	sakham nok
hospitality	Naruwai Palaima
host	panda lamsoknai
hostile	walaikwrak
hot	kutung
hotel	Chathainok
hour	daam
hours	dam
house	nok
household	nukhung
how	Bahaikhe
how about you	Nwngkhe bahai sa
how are you	Nwng Bahai Tong
how are you doing	Nwng Bahai Tong
how are you doing today	Nwng tini bahai tong
how are you today	Nwng tini bahai tongsa
how do you do	Nwng bahai tong
how is	bahai
how many	kaibwswk
how much	bwswk
how often	wai bwswk
how old are you	Nini umor bwswk
how was your day	Nini sala bahai tongmani
how was your night	Nini hor bahai tongmani
however	phano
hub	hub
hubby	sai
hug	kwbangmani
huge	kotorma
human	borok munuisu
humble	kung chukya borok
humid	moisture kwbang
humidity	humidity
hundred	ra
hungry	okhuimani
hunt	shikar khlaimani
hurricane	nobor kotorkuk
hurry	dodi
hurry up	Dodi
hurt	kha baijak
husband	sai
hustle	dodoro
hut	phangnok
hygiene	Saksimung
I	Ang
I am	Ang wngkha
I am fine	Ang kahamno
I can	Ang mano
I can't	Ang maya
I do	Ang khlaio
I do not know	Ang saimaya
I do not understand	Ang buchiya
I don't	Ang _____ya
I don't know	ang siya
I don't understand	Ang bujiya
I don't understand what you mean	Nwng tamo sana nai ang buchiya
I don't understand you	Ang nono buchi maya
I don’t know	Ang siya
I don’t understand	Ang buchiya
i guess	ang kha khlaio
I had	Ang mankha
I had	Ang chakha
I have	Ani ____ tongo
I have been	Ang ______ tongmani
I hope so	Ang abono wansugo
I know	Ang saimano
I like	Ang chajago
I like you	Ang nono chajago
I love	ang hamjago
I love my big brother	Ang ani ata
I love my big sister	Ang ani Bai
I love my father	Ang apha no hamjago
I love my little brother	Ang aphayung
I love my little brother	kwkwi no hamjago
I love my little sister	Ang ahanok
I love my little sister	kwkwi no hamjago
I love my mother	Ang ama no hamjago
I love you	Ang nono hamjago
I love you so much	ang nono hamjaksugo
I love you too	Angbo nono hamjago
I mean	Ang sana naimakhe
I miss you	ang nono khatangjago
I miss you so much	Ang nono belai khatango
I miss you so much	Ang nono khatangsukha
I see	Ang saimankha
I think	Ang wansugo
I understand	Ang buchio
I want	Ang muchungo
I want to see you	Ang nono naina muchungo
I want you	Ang nono nango
I was	Ang ______ tongmani
I will	Ang khlainai
I would be	Ang ______khamu
I'm	ang wngkha
I'm fine	ang kahamno
I'm good	Ang kahamno
I'm here	Ang oro tongo
I'm sorry	ano nakarjadi
ice	borof
ice cream	ice cream
idea	wansuktang
ideal	ideal
identical	kosol
identify	sinidi
identity	sinimung
idiot	mungsa siya borok
idle	samung kwrwi
if	wngkhe
ignore	gona khaya
ill	lumjak
illegal	raidao kwrwi
illness	kulum
Ilocano	Ilocano
image	mangpili
imagine	wansukdi
immediate	dodoro
immediately	dodoro
immense	kwbangkhlaiwi
impact	phirok-ungmung
impatient	doijo kwrwi
implement	samung bomani
import	tubumani
important	nangkukmani
impose	samungo bomani
impossible	wngwi maya
impress	impress
impression	mari
impressive	kha sotonnai ahai
improve	chasamani
improvement	chasarimung
in	wo
in addition	abo bai baksano
In fact	kubuio
in front of	ni bwskango
in order to	ni bagwi
inappropriate	mwchangya wngmani
incentive	incentive
incident	patimung
include	khobmani
including	no khobui
income	ajimung
inconvenience	subidha wngya
increase	bangrwmani
increased	bangjak
incredible	wansugwi maya
indeed	Ahaino
independent	yokmung manjak
India	Bharat haktor
indicate	phunugo
indigenous	janajati lukurok
individual	khoroksa
industry	swnammungkhor
inevitable	je kwpalo wngna tongmani
infant	kwlwi bwsa
infection	bemar kwphamani
infinity	paiphllaya
inflammation	yokmani
inflation	inflation
influence	logi
inform	saimanrwmani
information	kokthum
ingredients	ingredients
inheritance	bosongni manmani
initial	swkango
initiative	yapri
injured	dukhu manjak
injury	dukhu manmani
injury	kwsa chamani
innocent	khairokmasingsa
innovation	innovation
inquiry	cherwi naimani
insane	bokhorok chaya
insect	yongsa-kuksa
insecure	kirithoro
insert	dadi
inside	bisingo
insight	kuthuk wansukmung
insist	jid khlaimani
insomnia	Mwktwrwi Bemar
inspiration	inspiration
inspire	kha bachajakma
install	damani
instance	romwi nadi
instant	phatsakhe
instead	no karwi
instead of	abono karwi
instructions	dagimungrok
instrument	manwirok
insult	lachimung rwmani
insurance	bima khlaimani
intact	bayatwikhe tonijak
integrity	kubui bai tongnani wansukmung
intellectual	soi sikwrwng
intelligence	sikukmani
intelligent	si kwrwng
intend	khlaina muchungmani
intended	wansugwi khlamani
intense	belai phankhe
intention	muchungmung
interact	kwrwnglaimani
interaction	kok kwrwnglaimung
interest	saimanna muchungmani
interested	muchungmung tongma
interesting	kha sotonnai
interfere	kwcharo habmani
intermediate	kwchar majar
internal	bisingni
international	hayung beremni
internship	internship
interpret	buchirwmani
interpreter	kok bujhogwi sanai
interrupt	kwcharo kok samani
interview	interview
intimate	belai ganamani
into	wo
introduce	shinirwma
introduction	shinilaimani
introvert	bui bai misiya
intuition	ma tongmani
invalid	chaya
invent	Kwtal Swnamma
inventory	inventory
invest	rang swbaimani
investigate	amjokmung
invitation	kwcharmung
invite	kwcharhormung
invoice	receipt
involve	gwdalmung
involved	gwdaljak tongmani
iron	sor
is	wngkha
island	island
isolated	kebobai ma miliya
issue	majra
issues	jwngjalrok
it	Obo
it is	obo wngkha
it was	obo tongmani
it's	obo wngkha
it's ok	kok kwrwi
It's okay	kok kwrwi
item	item
items	items
its	obo wngkha
I’m	Ang wngkha
jacket	jacket
jail	along
January	Talhing-Talrung
jar	bottle
jaw	kholai
jealous	rishi twimani
jerk	bupramani
jewelry	khunju
job	samung
jogging	jogging
join	manjakmung
joint	pal baksa
joke	kara
journalist	kokthumnai
journey	beraimung
joy	tongthokmani
judge	bichar khlainai borok
juice	bwtwi
july	Talyung-Taltuk
jump	baharmani
june	Talkran-Talyung
junk	khibijaknai manwi
just	simi
just do it	khase khlaisidi
justice	soi bichar manmani
justify	bichar khlaimani
Kalaallisut	Kalaallisut
keen	saimanna muchungma
keep	tonidi
keep it up	Ahaikhe no agugwi thangdi
kept	tonijak
kettle	Twitwk
key	chabi
kick	usta rwmani
kid	cherai
kidding	kara thwngmani
kidney	kidney
kids	Cherairok
kill	bwtharma
kind	dal
kinda	hahai
kindly	doya khlai
kindness	maya nangma
king	bubagra
king	raja
kiss	motom sumani
kitchen	gantinok
kite	gurti
kitten	aming bwsa
knee	kunee
knew	saimanjak
knife	degar
knight	Kaham
know	saimanmung
knowledge	soi simung
known	sinijak
Kok Borok	Kok Borok
Konkani	Konkani
Krio	Krio
label	sinilaih
labor	samung tangmani
labour	samung tangmani
lack	mungsaswk kwrwi wngmani
ladder	chokam
lady	bwrwi borok
laid	rokojak
lake	twithu
lamb	mera
lame	jukti kwrwi
lamp	chati
land	hathai
landscape	naithok tongkhor
language	kok
lap	khuri
large	kotor
last	paithak
last but not least	paithago
last name	paithak mung
late	hor kuthuk
late	lermani
lately	sal kisa swkango
later	ulo
latest	tabukni jorani
latter	ulo
laugh	mwnwimani
laughing	mwnwi tongo
laughter	mwnwimung
launch	chengmani
laundry	laundry
law	khajak raida
lawn	nuhuka
lawyer	advocate
lay	phehelwi rwma
layer	belep
layout	wansuktang
lazy	sele
lead	lama phunukmani
leader	ojama
leaf	bwlai
leak	leak
lean	keram
leap	baharmani
learn	swrwngdi
learning	swrwngwi tongo
lease	Patta
least	belai kisasa
leather	malmata bukur
leave	yakardi
leaves	bwlairok
led	lama phunukmani
left	debra
left	thangkha
leg	yakhung
legacy	yaphar kwlangjak nukhung
legal	raida bai
legend	legend
legit	kerong-lama
leisure	lenglama jora
lend	solok rwmani
length	lokmani
less	kisa
lesson	swrwngmung
let	khlaina rwmani
letter	koktun bwlai
lettuce	lettuce bwlai
level	berem
leverage	sep saprok
liability	barja
library	bijapkhor
lick	swlakma
lie	tatal
lies	tatal kokrok
life	langma
lift	sakao tisamani
light	pohor
lightning	pherang kokma
like	chajago
likely	wngthothok
likewise	obo haino
line	mari rikjak
Lingala	Lingala
link	link
lion	singho
liquid	bwtwi
list	mung bwtang
listen	khwnadi
listening	khwnai tongo
literally	dadak sidak
literature	kokrwbai
litter	khibijaknai manwi
little	kisasa
live	kwthang tongdi
liver	bokholo
lives	tongo
lives	langmarok
living	tongwi tongo
living	kwthang
living room	achukmani khotol
lizard	nobraisa
load	tisamani
loaf	budul kolok
loan	lakai
local	amchaini
location	thai
lock	tala
lockdown	lockdown
log	buphang tanjak
lol	mwnwikothok
lonely	saichung
long	kolok
long time no see	nukya balukha
look	nahardi
loop	loop
loose	khwrap wngya
lord	Mwtai
lose	kwmamani
loss	kwmajakmani
lost	kwmajak
lot	kwbangkhe
loud	khorang tormani
lounge	lenglamani khotol
love	hamjakma
love you	Hamjago nono
lovely	naithokmani
low	kisajak
lower	tolani
loyal	logi choya
loyalty	loyalty
luck	kwpal kaham
lucky	kwpal kaham
Luganda	Luganda
luggage	manwi-khwnwirok
lump	budul
lunch	diporni mai
lungs	bwkha sobom
luxury	tongthok-chathok
lying	lying
machine	machine
mad	kobor
madam	madam
made	swnamkha
magazine	magazine
magnificent	kahamma
maid	maid
main	kotor
maintain	kahamkhe khatiwui tonimani
maintenance	naikolwi tonimani
Maithili	Maithili
major	kotorma
majority	kwbangkukno
make	swnammani
make up	swnammani
make up	mwkhango phuljaknai
male	chwla borok
mall	mall
man	chwla borok
manage	naikolmung
management	naikolmung
manager	naikolnai
mandatory	jekhephano magosinai
manifest	manifest
manipulate	manipulate
manner	tongna rwngmani
manual	yakbai khlaimani
many	kwbangma
many many happy returns of the day	achaimani salni chibai
march	Talslang-Tallang
margin	line tanmani
market	hati
marriage	kailaimung
married	kaijak
mask	bukhuk muthupjaknai
mass	kwbangmakhe
massive	kotorma
master	kwrwng
match	kwthalaimani
mate	logi
material	manwi
math	onko
matter	majra
maturity	khasimani
may	_____mano
maybe	wngwi mano
me	ano
me too	ang bo
meal	chamung
mean	sana naimani
mean	kha kosom borok
meaning	mane
means	tamo hinkhe
meant	sana muchungmani
meanwhile	aswk jorao no
measure	shumani
measures	sumani
meat	muihan
medical	sakduk
medicine	bithi
meditation	dhyan khlaimani
medium	kwchar majar
meet	malaidi
meeting	kokchapmung panda
Meiteilon	Meitei
melt	goli thangkha
memories	mukumurok
memory	muitu
mental	bokhorokni
mention	kok tisamani
mentioned	mentioned
mentor	lama phunuknai
merchant	baniya khlainai
mercy	maya
mercy	nakarmung
merely	simi no
merry christmas	Tongthok Christmas ni chibai
mess	ubru-jabru
message	koktun
messy	sitra mitra
metal	sor nij manwi
method	samung tangraida
mice	sinjo
middle	kwchar
midnight	hor kuthuk
might	wngwi mano
mild	khitarma
milestone	Mailholong
military	sipai
milk	dudh
million	chirasai
mind	bokhorok
mindset	wansukmung
mine	ani
mingle	kwthalaimani
minor	chikontia
minute	soti
minutes	soti
miracle	miracle
mirror	aina
miscellaneous	kubuni juda juda
mischievous	mirik
miserable	khairokmasingsa wngjak
misery	biyal
miss	khatangmani
miss you	khatango nono
missing	kwmajak
mission	mission
mist	siari
mistake	chaya wngmani
Mizo	sikam
mobile	mobile
mock	titkari rwmani
model	model
moderate	kwchar majar
modern	kwtal jorani
modest	kung chukya borok
moist	sobormani
moisture	kishi wngmani
mold	mold
mole	sobai koksa
mom	ma
moment	philiksa
monday	Tangsal
money	rang
monitor	naikolmani
monkey	mwkhra
month	taal
mood	muchungmani
moody	moody
moon	taal
moral	moral
more	teibo
moreover	teibo
morning	phung
mortgage	bondhok tonimani
most	kwbangmano
mostly	kwbangma amchaiono
mother	ma
mother	ama
motion	lorimani
motivation	kha swrangrwmani
mountain	hapung hathai
mouse	shinjo
mouth	bukhuk
move	lorimani
movement	lorimani
movie	toke
mrs	bukhukjwk
much	aswk
mud	harpek
mug	mog
muscle	Hankora
museum	museum
mushroom	muikhumu
music	rwchabmung
music	tammung
must	wngna nango
mute	siring
mutual	mutual
my	Ani
My dear	Ani khachuksa
my friend	ani kiching
My hovercraft is full of eels	ani birkhungo kuicha kuplung
my love	ani hamjakma
my name is	Ani mung wngkha
my pleasure	ani kha swrangkha
myself	sak baithang
mysterious	Bisingkok Gwnang
mystery	huijak kok
myth	kerang kothoma
nail	yasku
naive	bwkha kwlai borok
name	mung
narrative	kothoma
narrow	kesep
nasty	hamya
national	haktor beremni
nationality	bo haktorni
native	amchaini borok
natural	natural
nature	tongkhor
nausea	okhlai chamani
near	gana
nearby	ganao
nearly	wngtwtwi
neat	kwsap
necessary	nangkukmani
neck	totra
necklace	totrao kanjaknai
need	nangwi tongmani
negative	chaya
neglect	nukyamasikhe tongmani
negotiate	negotiate
neighbor	nok gana tongnairok
neighborhood	ganagini amchai
neither	mungsaboya
nephew	bagina
nerd	porikwrak
nervous	kirithoro wngjak
nest	bothop
net	gunda
network	network
neutral	keboni babai naya
never	waisaphanoya
never give up	kha no mwthangwi tonidi
never mind	kok kwrwi
nevermind	kok kwrwi
nevertheless	haiphano
new	kwtal
news	koktuma
next	tei kubuni
next to	ni ganao
nice	Kaham kok
nice to meet you	Nwngbai malai tongthokha
niece	bagini
night	hor
nightmare	imang hamya
nine	chuku
nineteen	chichuku
ninety	chukuchi
No	Ihi
no problem	kok kwrwi
no way	Ihi
nobody	keboya
noise	keche keche
noisy	keche keche
none	mungsaya
noon	dipor
nope	Ihi
nor	bo ya
normal	tong kosong
north	Salgra
nose	bukung
nostalgic	khatangma
not	ya
not at all	kisaphano ya
not bad	chaya wngya
Not now	tabukyakhu
not yet	tabukyakhu
note	swijaknai
noted	mung gwnang
noted	swi najak
nothing	mungsaya
notice	nukmani
noticed	nukjak
noun	noun
novel	novel
november	Taluang-Talbung
now	tabuk
nowadays	tabuk rogo
nuisance	jala rwmani
null	null
numb	mungsaphano wngya wngma
number	lombor
nurse	nurse
nut	badal
nutmeg	jaiphol
nutrition	kaham chamung
oath	swmai
obesity	phungmani
obey	kok khwnai tongmani
object	manwi
objective	kok bothoma
obligation	barja
obscure	kahamkhe sijakya
observation	naikolmung
observe	naichommani
obsessed	kha habjak
obsession	manna muchungmani
obsolete	komorjak
obsolete	kwmajak
obstacle	deramung
obtain	naharmani
obtained	manmani
obvious	atwino
obviously	ahaino
occasionally	jora jorao
occupation	samung
occupied	busy tongmani
occupied	naipaijak
occur	patimani
occurred	patimung wngkha
occurs	patimung wngmani
ocean	twijlang
october	Talumai-Taluang
odd	mwchangya
odds	gwdalya
of	ni
of course	Ao
off	mwthakmani
offensive	jolirwnai dalni kok
offer	yapharmani
office	tangkhor
official	haphang sebuk
often	waisa wuisu
Oh	Oh
oh really	kubui da
oil	thok
ok	Ao
ok	Ako
ok	Do Ako
ok dear	Ako doh
ok honey	Ao khachuk
ok my love	Ao ani hamjakma
okay	Ako
okay baby	ako khachuk
okay dear	Ako dear
okay honey	Ako khachuk
okay my love	Ao ani khachuk
old	kwcham
on	wo
once	waisa
one	sa
one language is never enough	kaisa kok bai simi wngya
onion	pyaz
online	online o
only	simi
open	phiyokjak
operation	operation
opinion	wansukmung
opportunities	sep
opportunity	tangsep
opposite	ulta
optimistic	optimistic
option	option
optional	optional
or	eba
orange	komla
order	raida
ordinary	kepeleng
organization	motha
orientation	teibo saimanmani
origin	muk
original	soisoi
Oromo	Oromo
orphan	buma-bupha kwrwija
other	kubuni
otherwise	hayakhe
ought	wngwi mano
our	chini
Our mission: to enable everyone, everywhere to understand the world and express themselves across languages.	Chini naharmung: jesa amchaio tongtwtwi jotono juda juda kok ni bisigtui hayungno buchina tei sak baithangni wansukmungrokno phiyogwi sai manrwmung.
Our mission: to organize the world's information and make it universally accessible and useful.	Chini naharmung: hayungni kokthumrokno jotoni bagwi manthokrwna tei abono samungo thepathothok swnamna.
out	phatar
outcome	bwthai
outfit	richum
outgoing	outgoing
outlet	phalnok
outline	phatarni line
outside	phataro
outstanding	kahamkuk
oven	oven
over	paijak
over there	arowo
overall	joto miliwui
overcome	laimani
overthinking	barawansukma
overwhelmed	khapang swrangmani
overwhelming	belaikheno
owe	kebono lakai rwthai tongma
owl	takhuk
own	sak baithangni
owner	bubagra
ox	damri
pace	domung
pack	packet
package	package
paid	rang rwipaijak
pain	samani
paint	pali shilmani
painting	akimani
painting	pali shilmani
pair	jura
pale	phur rere
palm	yakni yapha
palm	taal bwthai
pan	tawa
pandemic	mohamari
panic	kirijakmani
pants	suitrok
paper	lai
paradise	paradise
parallel	kosol
parcel	parcel
pardon	tei waisa sadi
pardon	nakarjadi
parents	ma-phasong
park	park
parrot	tiyapakhi
parsley	dhania hai bwlai
part	mungsaswk manwi ni
participate	manjakmung
particular	mungsaswk
particularly	nangkukma hinkhe
partner	logisong
party	tongthok panda
pass	kubuni borokno yaphrw rwma
passage	laimani
passed	kwplai wngkha
passion	bwkhani muchungmani samung
passionate	passionate
passive	passive
password	password
past	agi
patch	manjumani
path	lama
pathetic	khairokmasingsa
patience	doijo
patient	kha logwi tongma
pattern	loi
pause	bathakgramani
pavement	pakani lama
pay	rang rwmani
payment	rang rwmung
peace	tongkwchang tongmung
peaceful	tongkwchang tongmung
peach	peach
peak	kuchukuk
pear	goyam
peas	motor
peculiar	wanamasingsa
pee	swtwi
peel	bukur swkakmani
peel	sirikmani
peer	samung tanglogisong
peers	samung tangsong
pen	swikong
pencil	pencil
pending	chabna tongrwkma
people	lukurok
pepper	mosho kiting
perceive	wansukmung wansukjakmani
perception	chongwi namani
perfect	waisabaino soi
perform	mungsaswk khlai phunukmani
performance	samung khlai phunukmani
perhaps	wngwi mano
period	jora
permanent	molbrum ni bagwi
permission	gosimung rwmani
permit	gosimung lai
perseverance	perseverance
persistent	persistent
person	borok
personal	baithangni
personality	borokni goron
perspective	chongmung
persuade	koimani
pervert	bihia borok
pet	rwmani
phase	theka
phenomenon	je wngo no
philosophy	Yungsimung
phone	phone
photo	mangpili
phrase	sajakmani kokrok
physical	bwsakni
pick	khosamani
pick up	khochadi
picture	mangpili
piece	phonsa
pieces	bokcho
pig	wak
pigeon	pharuk
pile	rungjak
pillow	kobong
pilot	birkhung chaloknai
pin	pin
pineapple	anaros
pink	gulapi
pit	hakor
pitch	khitarma
pity	khairokma
place	thai
places	amchairok
plague	solonai mahamari
plain	hamil thai
plan	kokchap
plane	birkhung
plant	buphang bwsa
plants	buphang chikonrok
plate	piyang
platform	platform
play	thwngdi
playing	thwngwi tongo
pleasant	tongthokma
please	___jadi
pleased	chajaksukmani
pleasure	tongthok chathok
pledge	swmai tangmani
plenty	kwbangma
plot	thai
plug	plug
plum	plum
plumber	pipe swnamnai borok
plural	kaisani kwbang
podcast	podcast
poem	koklob
poetry	koklob
point	kok bothoma
poison	bish
police	naimwthang
policy	raida
policy	niti
polite	kahamkhe kok sanai borok
pollution	pollution
pond	twikhor
pool	pool
poop	khi
poor	rang kwrwija
pop	phatsa phatima
pop	phatsa phai rwma
popular	mung gwnang
population	lukubangmani
pork	wahan
porridge	payesh hai songmani
port	Rungtorari
position	achukthai
positive	kaham
possess	mwtai hamya kwphajakmani
possess	yago tongmani
possession	dokhol khlaimani
possessive	possessive
possible	wngwi manma
post	achukthai
postpone	ler riwui rwmani
potato	alu
potential	chugmung tongmani
pound	shukjak
poverty	bigra
power	phan
powerful	phan gwnang
practical	mwkthango
practice	mungsa samung khlaimang tongwi swrwngmani
praise	kebonotui kok kaham samani
prank	phatra thwngmani
pray	surio
precious	belaino nangkukmani manwi
precise	kwkwrwk
precisely	khoropsa wngsukjak
predict	predict
prefer	chajakmani
preference	chajakukmani
pregnant	ok gwnang
pregnant	ogo bwsa gwnang
prejudice	prejudice
premises	nokhlao
premium	kahamkuk
preparation	tiyari
prepare	tiyari khlaimani
prepared	tiyari khlaijak
preposition	preposition
presence	tongwi tongma
present	wngtong jora
presentation	yakpai
preserve	khati tonima
president	twiphang
press	sebmani
pressure	sepmung
pretend	wng phunukmani
pretty	goronti
prevent	kasumani
previous	swkangni
prey	shikar
price	swk
pride	kung chungmani kok
priest	ochai
primary	puila berem
prime	kotor
princess	rajkumari
principal	principal
prior	swkango
priority	swkango tonimani
prison	along
privacy	saichung tongmani
privacy	hui tonimani
private	sak bathangni
privilege	kaham sep
prize	sokat
probably	wngthothok
problem	jwnghjal
procedure	samung tangraida
proceed	agukmani
process	samungrok
produce	produce
product	product
production	kai achaimani
profession	samung khlaithini
professional	baniya khlainai
profile	sinimung
profit	labh
profound	belaikheno maar
profound	kuthuk
progress	bwskang agokmani
project	samung bwtang
prominent	mung gwnang
promise	kok rwmani
promote	awaimung
promotion	pirmung
prompt	daktino
prone	wngthothok
pronouns	pronounrok
pronunciation	sai khwnarwmani
proof	proman
proper	kahamkhe
properly	kahamkhe
properties	goron
property	ajiwui manbaimani manwirok
proposal	kok swngmani
prospect	wngthothok
prosperity	khurumpui
prosperous	prosperous
protect	sak katima
proud	kung chukmani
prove	proman khlaimani
provide	rwmani
provided	yapharjak
provided	rwjak
province	amchai
provision	kokphin
puberty	sikla wngmani
public	lukurok
pull	sotonmani
pumpkin	chakumra
punctual	lerya borok
pupil	swrwngnai
purchase	paimani
pure	kwthar
purple	phantok hai pali
purpose	khlaijaknai
purse	purse
pursue	koimani
pursuit	mannani chaitokmung
push	dunmani
put	tonidi
qualification	rwngmung
quality	manwi kaham hamya wngmani
quantity	bangmani eba kisamani
quarantine	quarantine
quarrel	walaimung
quarter	kaibwrwi bhag
Quechua	Quechua
queen	isri
queer	queer
query	swngmung
question	kok swngmung
queue	bwtang
quick	dodoro
quickly	phatsa
quickly	dodoro
quiet	siring siring
quilt	rijai
quit	samung yakarmani
quite	kisasa
quiz	Swngsimung
quotation	samani kokrok
quote	samani kok
quotes	samani kokrok
rabbit	khorgosh
race	khachikmani bataimung
rage	jolimung
rain	uatwi
raise	tisamani
raised	tisajak
ran	khachikha
random	haino jesa
range	ari
rapid	dodoro
rapidly	daktikhe
rare	kwlaikhe nukjakya
rarely	belaino kisa
rash	rash
rat	shinjo
rate	khajak swk
rather	oboni swlai
ratio	ratio
rational	jukti gwnang
raw	kwthwng
re	____phi
reach	kwrwnglaimani
reach	sogwimani
reached	sogwikha
reaction	kok kiphilmung
read	poridi
reading	pori tongo
ready	tiyar wngjak
real	kubui
reality	mwkthang
realize	buchumani
realized	saimankha
really	Kubuisano
rear	unklog
reason	mungsaswk wngmani ungklugo tongmani kok
reasonable	soi
recall	muitu khlaiphimani
receipt	bill
receive	manmani
received	mankha
recent	sal kisa swkango
recently	okhepo
reception	reception
recipe	shongmani raida
reckless	reckless
recognition	sinimung manmani
recognize	sinimani
recommend	kokbiti rwman
recommended	mungsaswk chao
record	record
recover	teisa hamphimani
recovery	kaham wngphimani
rectangle	rectangle
red	kwchak
redeem	naharmani
redemption	yokmung
reduce	kisarwmani
redundant	nangya
refer	refer
reference	sinimung rwi samung khlairwmani
reflect	mangpili nukjakmani
reflection	manpili
refrain	refrain
refrigerator	fridge
refund	rang kiphil rwjakmani
refuse	gosiya wngmani
refused	gosiliya
regard	regard
regarding	no tui
regardless	hai twtwi phano
regards	regards
region	amchai
register	swi narwkmani
regret	kha samani
regular	salbrum
regularly	salbrumno
reject	gosiya wngmani
reject	chajakya wngmani
relate	kok samani
related	rwkjak
relationship	halok
relative	jati kwlainarok
relatives	jati gustirok
relax	lenglamani
release	phiyogwi rwmani
released	phiokjak
relevant	jora bai gwdaljak
reliable	poito chajaknai borok
relief	chubamung
relieve	lenglama manmani
relieved	tei wanajakliya
religion	tongkwthar
religious	religious
reluctant	muchunya wngma
rely	poito chamani
remain	baki tongrwkmani
remaining	baki tongrwkmani
remarkable	muitu-narwkmari
remedy	hamrwnani lama
remember	muitu khlaimani
remind	muitu khlairwmani
reminder	muitu khairwmani
remote	hakchal amchai
remove	normani
render	rwmani
rent	rent
repair	teisa swnamphimani
repeat	teisa khlaiphidi
replace	swlai rwmani
reply	kok kiphilmung
report	saphaimani
represent	represent
reputation	borom
request	koimung
require	nangmani
required	nangmani
rescue	biyalni tikhlaima
research	naichermung
resemble	solmani
resentment	kha koima
reservation	khatimung
reserve	khati tonimani
resident	tongnai
resign	haba
resilience	soi tongmani phan
resilient	resilient
resist	kasumani
resistance	kasumung
resolution	baithang kok chabmung
resolve	lama tikhlaimani
resort	resort
resources	resources
respect	borom
respond	respond
response	kok kiphilmung
responsibility	barja
responsible	khasijak borok
rest	lenglama
rest in peace	phola lenglama manthung
restaurant	chathainok
restore	restore
restrict	kasumani
result	bwthai
results	bwthairok
resume	chengphimani
retail	phalmung
retain	romwi narwkmani
retention	twi tonimani
retired	haba yakarjak
retreat	rosama
retrieve	teisa naharphimani
return	kiphilmani
reveal	phunukmung
revealed	bwskango tubujakha
revenge	sejagwi
revenue	aji
reverse	ulta khlaimani
review	kokchablaiphima
review	mungsaswk no twiwi wansukmung sai khwnarwma
revise	teisa porimani
revise	swlaiphijak
revision	teisa naiphimani
revolution	revolution
reward	sokat
rhythm	sur
rib	khakwlab bekereng
rice	mairum
rich	gwnang borok
rid	karmani
ride	kadi
ridiculous	jukti kwrwi kok
right	soi
right now	tabukno
rigid	kwrak
ring	yashtem
rinse	shumani
riot	ur patimung
rip	sichikdi
ripe	munjak
rise	bachadi
risk	kirimasingsa samung
rival	batainai borok
river	twima
road	lahar
roast	shokmani
robust	belai kwrak
rock	holong
rod	sor
role	khlaithai tongmani
roll	dulmani
roof	nukhung
room	khotol
root	yarwng
rope	dwkhwi
rotten	shokjak
rough	thamchi kutung
rough	milikya
roughly	cholidrop
round	kiting
route	lama
routine	routine
row	bwtang
rub	hupredi
rubber	rubber
rubbish	khibijaknai anwi
rude	thamchi kutung
rug	bojagnai
ruin	chaya khlaimani
rule	raida
ruler	scale
rules	raidarok
run	khachikdi
running	khachik tongo
rural	kaami amchai
rush	dophra-kaphra
sack	bosta
sacred	kwthar
sacrifice	boli rwmani
safe	kaham kwrwng
safe flight	kahamkhe sogwidi
safety	sak katimung
sage	sage
said	samani
sail	chokmani
sailing	chogwi tongo
sake	ni bagwi
salary	dormai
sale	phaljaknai
salmon	kaisa dalni aah
salt	som
same	kaisano wngmani
Same here	angbo
sample	sample
sand	haching
Sanskrit	Sanskrit
sarcastic	Bengaima
sassy	kebono kiriya
sat	achukha
satisfaction	kha chajakmani
satisfied	kha chajak
satisfy	kha chajakmani
satisfying	chajakmani
Saturday	Chasal
sausage	sausage
savage	mwkhang kwrak
save	khati narwkmani
saw	nukha
say	sadi
scale	scale
scam	borokno thokimani
scar	kwsa
scarce	manthokya
scared	kirijak
scarf	scaf
scarf	mafla
scary	kirimasingsa
scattered	pirjak
scene	nukmani
scenery	naithok thai
scent	bahai motom
schedule	samung bwtang
school	rwngnok
science	soi simani
scientist	si kwrwng
scientists	si kwrwngrok
scissors	kechi
scold	jolijagwi hinmani
scope	sep sap
score	score
scrap	katakutirok
scratch	pukmani
scream	chirikhokmani
screen	screen
screw	khili
script	swimung swimani
sea	twibom
seal	mungtok
search	naitukdi
season	mol
seat	achukthai
second	philnwi
secret	secret
section	bedek
section	berem
secure	kirina kwrwi
security	sak katimung
see	nahardi
see you	teisa malainai
see you later	Nwngbai ulo malaiphinai
see you soon	nwngbai dakti malaiphinai
see you tomorrow	khwna malaiphinai
seed	bwchwlwi
seek	sanmani
seem	matongo
seems	matongmani
seen	nukha
seize	segwi namani
seizure	romjakmani
seizure	dokhol khlaimani
seldom	waisaphanoya
select	saidi
self	sak baithang
self healing	sak sak hamwi thangnai
selfish	rishi twinai borok
sell	phalmani
send	rohordi
send me your picture	Nini manpili rohordi
senior	okra
sense	khasima
sensible	khasinai borok
sensitive	kha koina kwlai
sent	rohorkha
sentence	kok bwtang
sentences	kok bwtangrok
separate	juda
Sepedi	Sepedi
september	Talbang-Talumai
sequence	sequence
series	rem
serious	belaino doro
seriously	kubuino
serve	yapharmani
service	samung
session	malai-achuk
set	thithi khlaimani
set up	csongchamani
setting	setting
settle	thiti wngmani
seven	sni
seventeen	chisni
seventy	snichi
several	dal bidal
severe	belaino maar wngjak
sew	subkha
sh	siring tongdi
shade	sakwlam
shadow	sampili
shake	lorirwmani
shall	khlainai
shallow	thena
shame	lachimung
shape	goron
share	bakdi
sharp	kubuk
she	Bo
she has	bini thani tongo
she is	Bo wngkha
shed	kogmani
sheep	mera
sheet	bojaknai ri
shelf	thag
shell	bwkwlap
shelter	nok
shield	sak katimung
shift	normani
shine	chwngmani
ship	Rung
shipping	twitui manwi yaktun
shirt	shirt
shoes	jutarok
shoot	kogdi
shop	phalnok
shopping	manwi paimani
shore	shore
short	bara
shortage	soksukya wngmani
shot	kogkha
should	khlaithai
shoulder	kangkhung
shout	chirikhokmani
show	phunukdi
show me	ano phunukdi
shower	tukumani
shrimp	athuk
shrink	chikonwi thangmani
shut	muthubdi
shut	kholobdi
shut	thuklubdi
shut up	siringkhe tongdi
shy	lachimani
sibling	takhuk-bukhuksong
siblings	takhuk eba bukhuksong
sick	lumjak
side	babai
sigh	hama kolok namani
sight	nukmani
sightseeing	berai naimani
sign	mari
signature	soi rwmani
significant	nangkukmani
silence	siring
silent	siring
silk	toshor ni ri
silk	phele phele
silly	suluk salak
silver	ruphai
similar	kosol
simp	buchiya borok
simple	kwlaisa
simultaneously	logi logino
since	ni simi
sincere	kha kubui borok
sincerely	kha baino
sing	rwchabdi
singer	rwchab kwrwng
single	sikla
sink	kwlwgmani
Sir	borom gwnang
sister	bai
sister in law	Buprangjwk
sister in law	Bachwi
sit	achukdi
site	thai
situation	ungjora
six	dok
sixteen	chidok
sixty	dokchi
size	tormanirok
skill	rwngmung
skills	rwngmungrok
skin	bukur
skinny	keram
skip	sei thangmani
skirt	skirt
sky	nokha
slave	slave
sleep	thudi
sleeping	thui tongo
sleepy	thuna mucungma
sleeve	yak
slice	lepsa
slide	lama
slightly	kisasa
slim	keram
slip	keplei kwlaimani
slope	hacham tola
slot	achukthai
slow	keler
slowly	twrwk twrwkhe
small	chikontia
smart	khasijak
smell	bahai
smile	mwnwidi
smoke	hoku
smooth	milik
snack	chajaknai manwi
snail	shikamuk
snake	chibuk
snap	jolijakmani
snow	borof kwlaimani
so	Hinkhe
so cute	omayu naithokmani
so far	awsk hakchak
soak	mishi tonima
soap	saban
sober	kaham kwrwng
soccer	football
social	luku rwkjak
society	dopha
socks	mujarok
soft	romthok
software	software
soil	ha
sold	phaljak
sold out	phaljak thangkha
soldier	sengkrak
sole	saichung
solid	kwrak manwi
solution	lama tikhlaima
solve	lama tikhlaimani
some	baksa
somebody	kebo
somehow	jesakhe
someone	khoroksa borok
something	mungsaswk
sometimes	waisa wuisu
song	rwchabmung
soon	daktino
sophisticated	nukjak sijak
Sorani	Sorani
sore	dunokmani
sore throat	totra moro moro
sorrow	biyal
Sorry	Nakarjadi
sort	bailkhe tonimani
sought	sanmani
soul	phola
soulmate	bwkhani borok
sound	khorang khlaimani
soup	bwtwi
sour	kwkhwi
source	muk
south	dokhin gwlang
space	hakchalma
spam	soi ya
span	jora
Spanish	Spanish
spare	baki tongrwkma
speak	kok sadi
special	khachuksa
species	dal
specific	saijak manwi
spectacular	naikhe naithothok
speech	kok tonmani
speechless	kok saimaya wngthangkha
speed	domung
spell	sai khwnarwdi
spend	swbaidi
spent	swbaikha
spicy	yog
spike	phatsa kasamani
spin	kitingrwmani
spinach	palang sak
spirit	phola
spit	khuktwi khibimani
splendid	kwchwng
split	khagmani
spoil	chaya khlairwmani
spoiled	chaya wngjak
spontaneous	spontaneous
spoon	chamich
spot	khain
spouse	logisong
spread	pirjak
spring	khum barmani mol
square	thekakbwrwi
squeeze	sokormani
squid	squid
squirrel	mandar
st	janajati bosong
stab	shugwi rwmani
stable	thiti
stack	Burung
staff	samung tangsong
stage	stage
stain	gaap nangmani
stairs	siri
stake	baji rwlaimani
stalk	khoroksa borok tamo tamo khlai abo tepkhe naimani
stall	phalnok
stamp	Maritok
stand	bachadi
standard	raida
star	athukiri
start	chengmung
started	chengjak
starving	okhui tongo
state	haste
statement	koktang samani
station	station
statue	kaya
status	kaham hamya
stay	tongdi
stay safe	Kaham kwrwng tongdi
steady	thiti
steak	bahan kotorma
steal	khokmani
steam	phap
steel	steel
steep	bachajak
stem	bokong
step	yapri semani
stick	waphi
stiff	kwrak
still	tabuk phano
sting	chwkmani
stingy	stingy
stir	kolmani
stock	stock
stolen	khokjakha
stomach	bohok
stone	holong
stood	bachakha
stool	khamplai
stop	bathakdi
storage	storage
store	khati tonimani
storm	nobar kotor
story	kothoma
stove	stove
straight	lama botok
straightforward	dadak-sidak
strain	sokormani
strange	wanamasingsa
stranger	siniya borok
strategy	wansuktang
straw	chekap
strawberry	strawberry
streak	mari tanmani
stream	twisa
street	lama
strength	phan
stress	wanamung
stretch	sotonmani
strict	kwrak
strike	bumani
string	khwtwng
strip	pata
strive	chaitokma
strive	choba khlaima
stroke	ayukmuyuk
strong	phan gwnang
struck	nangjakha
struck	kokjakha
structure	goron
struggle	choba
struggling	chaitogwi tongma
stubborn	mwkang kwrak borok
stuck	kwchajak
student	swrwngnai
study	rwng swrwngdi
studying	pori tongo
stuff	manwirok
stunning	daksa khlairwnai
stupid	siya kukya borok
style	tongma-chama
style	kanmung-chummung
subject	kok bothoma
submission	yapharmani
submit	yapharwi rwma
substance	manwi
substitute	substitute
subtle	aswk sijaksukya
succeed	kwplai wngmani
success	kwplai wngmani
successful	kwplai wngmani
such	atwi
such as	jemon romdi
suck	kusupmani
sudden	atumsa
suddenly	atumsa
suffer	biyal manmani
suffering	biyal wngwi tongo
suffering	kosto soi tongo
sufficient	kulogo
sugar	chini
suggest	kokbiti rwmani
suggestion	kokbiti
suit	mwchangmani
suitable	mwchangmani
suitcase	suitcase
sum	rang
summary	kok kisao
summer	satung mol
summit	summit panda
sun	sal
sunday	Koktisal
sunny	satung pajak
sunset	salhab
sunshine	salni pohor
super	super
superior	kotor
superior	okra
superior	bokhorok
supervisor	naikolnaisa
supper	horni chamung
supply	manthokmani
support	chubachu
suppose	chongma
supposed	wngna nangmani
sure	Ao
surface	tola
surge	atumsa bangmani
surgery	operation
surname	paithak bumung
surprise	atumsa wanajakma
surprised	atumsa wanamani
surrender	yapharwi rwma
surrounding	gana gini
surveillance	naichomwi tongmani
survey	amjokmung
survive	kwthang
suspect	suspect
suspended	mwthakjak
suspicious	poito chaya
sustain	thangwi tongma
sustainability	mwthangwi tonimani
sustainable	tikinai
swag	khokjakmani manwi
swallow	monokdi
swap	swlaimani
swear	swmai tangmani
sweat	kolomtwi
sweater	ri kutung
sweater	sweater
sweep	pharmani
sweet	kwtwi
sweet dreams	imang kaham nukdi
sweet tooth	kwtwi hamjaknai
sweetheart	khachuksa
swell	phulima
swelling	robonmani
swim	twi yokmani
swimming	swimming
swing	waying
switch	swlaimani
swollen	phulijak
sword	seng
symbol	mukumu
sympathy	maya nangmani
symptoms	bemar manjakmani marirok
system	system
table	songphang
tackle	katimani
tag	tag
tail	khitung
take	nadi
take away	twlang thangmani
take care	Kaham tongdi
take off	khukmani
taken	nahar paijak
talk	kok sadi
talkative	kok sakwrak
tall	kolok
tap	shinmani
tape	Riduk
target	kha chongmani
task	samung
taste	thokmung
tasty	kothok
taught	phwrwngkha
tea	cha
teach	phwrwngmung
teacher	phwrwngnai
team	dol
tear	sichikdi
tears	mwktwi
tease	phatra khlaimani
technology	tangsep
teeth	buwa
tell	sadi
tell me	Ano sadi
temper	thamchi
temperature	temperature
temple	mwtainok
temporary	swrapsani bagwi
ten	chi
ten thousand	chi sai
tenant	tenant
tend	wngthothok
tendency	wngthothok
tender	kwlwi
tense	wanama
tension	wanamani kokrok
tent	tent
tentative	chabjakya
term	kokthai
terms	chongjak-jora
terrible	kirimasingsa
terrific	uanamasingsa
territory	amchai
test	amjokmung
text	swimung
than	ni swlai
thank	hambai
thank you	Hambai
Thank you for your patience while we investigate shipment	Chwng manwi kogmani no tui naikolwi nai tongphuru nini kha logwi tongjamani bagwi nono hambai
thank you so much	belaikheno hambai nono
thank you very much	belai belai hambai nono
thanks	Hambai
Thanks for using our app	Chini app no samungo thepamani bagwi hambai nono
that	Abo
that is	abo wngkha
that's good	kaham kok
theft	khokjakmani
their	bohrokni
them	bohrokno
theme	theme
themselves	themselves
then	yagulo se
theory	theory
there	Aro
there are	obohrok wngkha
there is	aro tongo
therefore	hinkhe
these	oborok
they	Bohrok
they are	bohrok wngkha
thick	rwja
thief	shikok
thigh	biya
thin	keram
thing	manwi
things	manwi-khwnwirok
think	wansukdi
third	phil-tham
thirsty	twi kangmani
thirteen	chitham
thirty	thamchi
this	Obo
this is	obo wngkha
thorough	kahamkhe
thoroughly	khahamkhe naikha
those	jerok
though	phano
thought	Wansukha
thoughtful	wansuknai borok
thoughts	wansukmungrok
thousand	sai
thread	khwtwng
threat	humki rwmani
threaten	humki rwmani
three	tham
threshold	chengmani
thrilled	kha bachajak
thrive	teibo chasamani
throat	totra
through	tui
throughout	joto phasingo
throw	khitardi
thumb	yasi buma
thunder	pherang kokmani
Thursday	sangrongsal
thus	hinkhe
tide	twi lujagwi phaima
tidy	saf-sutra
tie	khamani
tiger	mwsa
tight	belai swrabjak
Tigrinya	Tinrinya
time	jora
timid	lachinai
tiny	chikontia
tip	kokbiti
tips	kokbitirok
tire	lengmani
tired	lengjak
tissue	tissue
title	mung pharmani
to	no
to be	wngmani
toast	toast
today	tini
toddler	kwlwi
toes	yakungni yasirok
together	pal baksa
toilet	sak suklainok
told	sakha
tolerance	soinani phan
tolerate	soimani
tomato	phantok mwkhwi
tomorrow	khwna
tongue	bwchwlai
tonight	tini horo
too	____bo
took	nakha
tool	tool
tools	manwirok
tooth	buwa
top	kuchuk saka
topic	kok bothoma
torn	kichikjak
torture	satok
total	jotoi
total	bebagwi
touch	romdi
tough	kwrak
tour	beraimung
toward	phasingo
towards	digio
towel	tawli
town	aguli
toxic	bishkara
trace	mari
track	lama
trade	baniya
tradition	hukumuni gwrwng
traditional	hukumu rwkjak
traffic	traffic
trail	lama
train	train
training	phwrwngmung
trait	goron
traits	goronrok
transfer	thai swlaimani
transition	swlaijakmani
translate	translate
transparent	transparent
transport	thanglaisu
transportation	thanglaisu
trap	thokokmung
trash	manwi khibijaknai
trauma	trauma
travel	beraimani
tray	tray
treasure	rang kwbangma
treat	tongwi eba wngwi phunukma
treatment	sak naijakmani
tree	buphang
tremendous	belaikheno
trend	chol
trial	amjoknaimung
trick	thwngmani
tried	chaithokha
trigger	silai o sebkhakheno guli kogjakmani
trim	khagwi khibimani
trip	beraimani
trip	thutai kwlaimani
trouble	jwngjal
trousers	suitrok
truck	truck
TRUE	kubui
trunk	buphangni bedekrok
trust	poito
truth	kubui
try	chaitokmani
Tsonga	Tsonga
tube	tube
Tuesday	Kraksal
tuition	tuition
turkey	turkey
turmeric	swtwi
turn	koidi
turtle	kasing
tutor	pora phwrwngphainai
twelve	chinwi
twenty	nwichi
twenty-one	nwichisa
Twi	Twi
twice	wainwi
twist	kokoi khlaimani
two	nwi
type	dal
typical	hainohai
ugly	sitra
ultimate	paithak
ultimate	belai
umbrella	chati
unable	maya
uncle	mama
uncle	kaka
unconscious	sichajakya
under	bisingo
underneath	tolao
underrated	underrated
understand	buchidi
understood	buchikha
unfortunately	samung chaya wngmani
uniform	uniform
unique	judakuk
unit	unit
university	University
unknown	siniya
unless	wngyakhe
until	___yasak
unusual	tong kosongya
up	sakao
up to you	ni thani se
update	chasama
upgrade	upgrade
upon	sakao
upset	kha dujak
urban	aguli amchai
urge	muchungmung
urgent	nangkukmani
us	chwng
use	samungo thepamani
used	samungo thepajak
useful	samungo thepthothok
useless	samungo nangya
usual	tong kosong
usually	sana thangkhe
utility	utility
vacation	jora kolokni sal duamung
vaccination	vaccine rwmung
vaccine	vaccine
vacuum	bukcha
vague	sijaksukya
valid	soi
valley	valley
valuable	nangkukmani
value	swk
variety	dal
various	juda juda
vary	solya
vary	juda wngmani
vase	khum tonijaknai
vast	kotorma
vegetable	mui kwthwng
vegetables	muikwthwngrok
vehicle	malkhung
vendor	phalnai
venom	bis
venture	yapri
venue	thai
verify	amjokmung
versatile	versatile
version	dal
vertical	bachajak
very	belai
very good	belai kaham
vessel	gamla
via	tui
vibe	tongmung
vibes	munsaswk hai ma tongmani
vicious	kirima singsa
victim	satokjaknai
video	video
view	nukmung
village	kami
villain	samung sitra tangnai
vinegar	vinegar
vintage	agini joogni
violence	ur patimung
violent	thamchi gwnang
viral	pirjakthangmani
virgin	waisaphano samungo thepajakya
virtual	mwkthang ya
virtue	wansukmungrok
vision	mokol nukmani
visit	malaiuimani
visual	nukmani
vital	nangkukma
vivid	muitu narwkjaknai
vivid	kwswrang
vocabulary	kokthairok
voice	khorang
void	bukcha
volume	volume
volunteer	volunteer
vomit	kwbamani
vulnerable	phan kwrwijak
wage	dormai
wages	ajimungrok
waist	bwchang
wait	tongradi
waiter	waiter
waiting	nasingwi tongo
wake	sichamani
wake up	sichadi
walk	himdi
walking	himwi tongo
wall	dewal
wallet	rang bag
wander	haino beraimani
wanna	muchungo
want	muchung
wanted	muchungmani
war	choba
wardrobe	wardrobe
warehouse	godown
warehouse	gudam
warm	tunglele
warn	warn
warning	warning
warrior	sengkrak
was	tongmani
wash	shudi
waste	nangya jagao rang eba jora swbaijakmani
waste	khibijaknai manwi
watch	nahardi
water	twi
watermelon	momphol
wave	wave
way	lama
we	Chwng
we are	chwng wngkha
we can	Chwng mano
weak	phan kwrwi wngjak
weakness	phan kisamani
wealth	khurumpui
wealthy	rang gwnang
wear	chummani
wearing	kanwi tongjak
weather	nobar twibar
wedding	kailaibari
Wednesday	Swrangsal
weed	siddi
week	hati
weekend	hatini paithago
weight	hilikmani
weird	wanamasingsa
welcome	lamsogo
welfare	hamkrai
Well	Kaham
well done	well done
went	thangma
were	tongmani
west	Salthang
wet	kishi
whale	whale ah
what	Tamo
what about you	nwngkhe
what are you doing	Nwng tamo Khlai tong
what are you doing now	Nwng tabuk tamo khlai tong
what are you doing right now	Nwng tabuk tamo khlai
what do you do	Nwng tamo samung khlai
what do you do for a living	Nwng tamo samung khlai
what do you mean	Nwng tamo sana nai
what do you want	Nwng tamo nai
what happened	tamo wngkha
what is	Tamo
what is this	obo tamo
what is your job	Nwng tamo samung khlai
what is your name	Nini mung tamo
what's up	tamosa khobor
what's your name	Nini mung tamo
whatever	jesaphano
wheat	gom
wheel	chaka
when	Buphuru
whenever	jephuru
where	Boro
where are you	Nwng boro
where are you from	Nwng bo amchai ni
where are you now	Nwng tabuk boro
where do you live	Nwng boro tong
where is	boro
whereas	yangkhe
whether	wda
which	Bobo
while	phuru
whisper	whisper
whistle	bukhuk musubmani
white	kuphur
who	Sabo
who are you	Nwng sabo
who is	Sabo wngkha
who is this	Sabo obo
whole	bebak
whom	sabono
whose	saboni
why	Tangwi
why not	tamoni wngya wngnai
wicked	wicked
wide	kuwar
widow	randi
width	warmung
wife	hik
wild	bolongni
will	nai
willing	soio
win	kwplai wngmani
wind	nobar
window	phorki
window	tailam
windy	nobar shibmani
wine	chuwak
winter	masing
wipe	hujaknai
wire	dwkhwi
wire	taar
wisdom	simani
wise	si kwrwng
wish	muchungmung
wish you all the best	Ang muchungo nwng kwplai wngthung hwnwi
witch	swkal
with	bai baksa
withdraw	rosai naharma
withdrawal	tisai naharmani
within	ni bisingo
without	karwi
witness	nuksong
witty	khwnai
wolf	siyal
woman	bwrwi borok
women	bwrwi borokrok
won	kwplai wngjak
won't	khaya
wonder	wansugwi naimani
wonderful	belaino kaham kok
wood	kath
wool	ool
word	kokthai
words	kokthairok
work	samung
work out	samung chai thangmani
work out	biyam khlaimani
working	working
world	hayung
worm	yong
worn	kichikjak
worn	chumkha
worried	wanajak
worry	wanama
worse	hamyakuk
worship	surimani
worst	hamsukya
worth	swk
worth it	chukjak
worthy	chukjak
would	khamu
wound	kwsa
Wow	bah
wrap	duldi
wrath	belaikhe jolimani
wrist	yak
write	swidi
Write here	Oro swidi
writing	swimung
written	swijak
wrong	chaya
wrote	swikha
yard	nokhla
yawn	Hamanasama
Yeah	Em
year	bisi
years	bisirok
yeast	yeast
yell	chirikhokma
yellow	kormo
Yes	E
yes baby	E khachuk
yes dear	Ao mating
yes honey	Ao khachuk
yes my love	Ao ani hamjakma
yes of course	ao ahaino
yesterday	miao
yet	tabukbo
yield	achaimani
you	Nwng
you are	nwng wngkha
you are beautiful	nwng naithogo
you are so beautiful	nwng belaino naithok
you are welcome	lamsogo
you can	Nwng mano
You know	Nwng saimano
you too	nono bo
you're welcome	Lamsogo
young	sikla
your	nini
your welcome	lamsogo
yourself	baithang
yourself	nwng
youth	sikla jora
you’re welcome	lamsogo nono
yummy	kothok
zero	Bukcha
