a	ida
a little	uitoan
a lot	barak
a lot of	barak husi
abandon	husik hela
abandoned	husik hela
abide	hela
ability	abilidade
able	bele
about	kona-ba
above	iha leten
abroad	rai liur
absence	auzensia
absent	absénsia
absolutely	absolutamente
absorb	supa
abstract	abstratu
absurd	absurdu
abundance	abundansia
abundant	abundante
abuse	abuzu
abuse	viola
accent	sotake
accept	aseita
access	asesu
accident	asidenti
accommodation	akomodasaun
accomplish	kompleta
accomplished	realizada
according	akordu
account	konta
accuracy	akuradu
accurate	akuradu
accused	akuzadu
ache	moras
achieve	alkanse
achievement	konkista
acknowledge	rekoñese
acquaintance	koñesidu
acquire	obten
acquired	hetan
acquisition	sosa
across	liuhosi
across	kruza
act	asaun
action	asaun
active	ativu
activities	atividade
activity	atividade
actor	Ator
actual	atual
actually	loloos ne'e
acute	agudu
adapt	adapta
add	aumenta
addicted	Vísiu
addition	adisionál
additional	adisionál
address	enderessu
address	hato'o
adequate	adekuadu
adjacent	besik-malu
adjective	adjetivu
adjust	ajusta
admire	orgullu
admit	konfesa
adopt	adota
adorable	adorável
advance	avansu
advance	promove
advanced	avansadu
advantage	advantajen
adventure	aventura
adverb	advérbiu
advertisement	anúnsiu
advertising	publisidade
advice	lia-menon
advice	sujestaun
advise	konsola
advocate	advokasia
aesthetic	estétika
affair	asuntu
affair	lia
affect	afeita
affection	efeksaun
afford	fó
affordable	bele hola
afraid	ta'uk
after	depoisde
afternoon	lokraik
afterwards	depois
again	fali
against	kontra
age	idade
agency	Ajensia
agent	ajente
aggressive	agresivu
agile	ájil
ago	liu bá
agree	akordu
agreement	akordu
agriculture	agrikultura
ahead	iha oin
aid	ajuda
aim	alvu
air	anin
airport	aeroportu
aisle	korredór
alarm	alarma
alcohol	alku
alert	alerta
alive	moris
all	hotu-hotu
all right	Diak
all the best	buat hotu di'ak
allow	permite
allowed	permite ona
almost	kuaze
alone	mesak
along	hamutuk
already	tia ona
Alright	di'ak
also	mós
alternative	alternativu
although	maski
always	sempre
always	hela de'it
am	ha'u mak
amazing	inkrível
ambiguous	ambigu
ambition	ambisaun
ambitious	ambisaun
amend	altera
amid	entre
among	entre
among us	entre ita
amount	montante
amount	totál
amusing	halo kontente
an	ida
analysis	analiza
ancestors	ensestrál
anchor	ankor
ancient	antigu
and	no
and you	no ita-boot
angel	anju
anger	hirus
angle	angulu
angry	hirus
animal	animál
ankle	ain sikun
anniversary	halo tinan
announcement	avizu
annoy	sateia
annoyed	sateia
annoying	iritante
annual	anuál
anonymous	anónimu
another	seluk fali
answer	responde
answer	resposta
anticipate	antisipa
anxiety	tuur la hakmatek
anxiety	ansiedade
anxious	tuur la hakmatek
anxious	ansiedade
any	kualkér
any	saida de'it
anymore	tan
anyone	se deit
anything	kualkér
anyway	enfín
anyways	maski nune'e
apart	aparte
apartment	apartamentu
apologize	deskulpa
apparent	aparenta
apparently	aparantemente
appeal	apela
appear	mosu
appearance	aparese
appeared	mosu
appeared	haree hanesan
appetite	vontade
appetite	apetite
apple	masa
application	aplikasaun
apply	aplika
appointment	konsulta
appreciate	apresia
appreciation	apresiasaun
approach	hakbesik
approach	aproximasaun
appropriate	apropriadu
appropriate	loloos
approval	Aprovasaun
approve	aprovadu
approved	aprovadu
approximately	aproximadamente
april	abril
arbitrary	arbitraria
architect	arkitetu
architecture	arkitektura
archive	arkivu
are	sira mak
are you	o ka
are you busy	ita-boot okupadu
are you married	o kaben ona ka seidauk
are you married or single	ita-boot kaben nain ka solteiru
Are you still there?	ita-boot sei iha ne'ebá?
are you there	o iha ne'ebá ka
area	área
argue	deskute
argument	argumentu
arise	Mosu
arm	liman
army	ezersitu
around	haleu
arrange	aranja
arrangement	arranju
arrival	to'o-mai
arrive	to'o
arrived	to'o ona
arrogant	halo an
arrow	rama-oan
art	arte
article	artigu
artificial	artifisial
artist	artista
as	nu'udar
as long as	karin nune'e nafatin
as well	no mos
as well as	no mos
ash	ahu kdesan
ashamed	moe
ask	husu
asked	husu
asleep	dukur
aspect	aspeitu
Assamese	Assamese
assault	asaltu
assembly	tutan
assertive	asertivu
assess	avaliasaun
assessment	avaliasaun
asset	aset
assets	riku-soin
assign	koloka
assignment	atribuisaun
assist	ajuda
assist	tulun
assistant	asistente
associate	asosiadu
associated	asosiadu
association	asosiasaun
assume	prezume
assumption	ipóteze
at	iha
at least	pelumenus
ate	han ona
athlete	atleta
attach	aneksa
attached	aneksu
attachment	aneksu
attack	Atake
attempt	tenta
attend	partisipa
attendance	prezensa
attention	atensaun
attitude	hahalok
attract	atrai
attraction	atrasaun
attractive	atrativu
attribute	atributu
audience	audiénsia
august	agostu
aunt	tia
aunty	tia
authentic	auténtiku
author	na'in
authority	autoridade
autumn	autonu
available	disponivel
average	média
avoid	evita
awake	hader
award	premiu
aware	siente
awareness	konsiente
away	dook
awesome	di'ak los
awful	aat los
awkward	lajeitu
Aymara	Aymara
baby	bebe
bachelor	klosan
bachelor	lisensiadu
back	kotuk
background	fundu
bad	aat
bag	pasta
bait	iska
bake	tunu
bakery	padaria
baking soda	bakin soda
balance	ekuilíbriu
balance	balansu
ball	bola
Bambara	Bambara
banana	hudi
band	banda
bang	tarutu
bank	banku
bar	barra
barely	oituan deit
bargain	negosia
bark	ai-kulit
barley	trigu
barrier	Bareira
base	baze
based	bazeada
basement	baze
basement	poraun
basic	báziku
basically	bazikamente
basil	ikan saboko
bastard	desgrasadu
batch	lote
bath	hariis
bathroom	hariis fatin
battery	bateria
battle	luta
bay	be lihun
be	sai
be careful	kuidadu
beach	tasi-ibun
beam	nabilan
beans	fore
bear	ursu
bear	aguenta
beard	hasan-rahun
bearing	konsekuensia
beast	balada
beat	baku
beat	ritmu
beautiful	Furak
beauty	bonita
became	sai
because	tanba
become	sai
bed	kama
bedroom	kuartu
bee	bani
beef	na'an karau
been	Ba ona
beer	serveja
before	molok
began	komesa
begin	komesa
beginning	inísiu
behalf	reprezenta
behave	hahalok
behavior	hahalok
behaviour	hahalok
behind	iha kotuk
being	sai
belief	fiar
believe	fiar
belly	kabun
belong	pertense
beloved	ema ne'ebé ita hadomi
below	iha kraik
below	okos
belt	sintu
bench	banku
bend	kurva
beneath	okos
benefit	benefisiu
benefits	benefisiu
beside	aleinde
besides	aleinde
best	mellor
best	di'ak liu
best of luck	boa sorte
best regards	saudasoens
better	di'ak liutan
between	entre
beverage	bebida
beyond	aleinde
Bhojpuri	Bhojpuri
bias	tendênsia
biased	ho viéz
bicycle	bisikleta
bid	oferta
big	boot
bike	bisikleta
bill	fatura
bind	matan delek
bird	manu-rade
birthday	loron halo tinan
bit	oituan
bite	tata
bitter	moruk
black	metan
blade	lamina
blame	kulpa
blame	duun
blank	mamuk
blanket	manta
blast	esplozaun
bleach	bee-hamutin
blend	mistura
blend	kahur
bless	bensaun
blessed	abensoadu
blind	matan-delek
bliss	rahun-di'ak
block	bloku
blood	raan
bloom	nafunan
blow	hu
blue	azul
blunt	matan aat
board	kabelak
boat	ró
body	isin
boil	da'an
bold	brani
bond	liga
bone	ruin
book	livru
book	rezerva
boost	enkoraja
boost	dudu
booster	intensifikadór
boot	botas
boots	Botas
border	fronteira
bore	baruk
bored	baruk
boring	baruk
born	moris
borrow	impresta
boss	xefe
both	Rua ne'e hotu
bother	alin-mane
bother	maun
bottle	botir
bottom	baze
bought	hola
bounce	haksoit
bound	vinkula
boundaries	baliza
bow	hakruk
bowl	fijela
box	kaixa
boy	labarik mane
boyfriend	namoradu
bracelet	pulseira
brain	kakutar
branch	filial
brand	marka
brave	brani
breach	viola
bread	paun
break	deskansa
break	sobu
breakfast	matabixu
breast	susu
breath	dada is
breathe	dada iis
breed	hakiak
brick	tijolu
bride	noiva
bridge	ponte
brief	sumáriu
bright	klaru
brilliant	brillante
bring	lori
bro	maun
broad	luan
broadcast	transmisaun
broke	tezu
broken	tohar ona
broom	ai-saar
brother	alin mane
brother	maun
brother in law	kuñadu
brought	lori ona
brown	kastanhu
brush	eskova
bucket	balde
buddy	kompañeiru
budget	orsamentu
bug	eru
build	harii
building	edifisiu
built	harii
bulk	barak
bull	karau-aman
bully	Goza
bully	trata
bump	kolisaun
bunch	ramu
bundle	futun
burden	fó todan
burden	karga
buried	hakoi
burn	sunu
burst	esplozaun
bury	hakoi
bus	bis
bush	du'ut laran
business	negosiu
bust	susun
busy	okupadu
but	maibe
butter	manteiga
butterfly	borboleta
button	botaun
buy	sosa
buy	hola
by	ho
by	husi
by the way	koa'lia ona hanesan ne'e
bye	adeus
cabbage	repollu
cabinet	gabinete
cage	gaiola
cake	bolu
calf	ain-kabun
call	bolu
call	konvite
call me	kontaktu ha'u
called	bolu ona
calm	kalma
came	mai
campaign	kampaña
can	bele
can	kalen
can't	Labele
Cancel	Kansela
cancer	kankru
capable	kapáz
capacity	kapasidade
capital	kapitál
caption	esplikasaun
capture	kaptura
car	karreta
career	kareira
careful	kuidadu
carefully	ho kuidadu
careless	la-kuidadu
caring	kuida
carpenter	karpintaria
carpet	tapete
carrot	senoura
carry	lori
carry on	kontinua
carry out	hala'o
case	kazu
cash	osan-tahan
cast	soe
castle	kastelu
casual	kazual
cat	busa
catch	kaer ona
category	kategoria
cattle	Karau Vaka
caught	kaer ona
cause	razaun
cause	kauza
caution	kuidadu
cautious	kuidadu
cave	fatuk-kuak
cease	para
ceiling	uma tetu
celebrate	selebra
cell	sela
center	sentru
century	sekulu
cereal	sereál
ceremony	serimonia
certain	serteza
certain	balun
certainly	sertamente
certificate	sertifikadu
chain	korenti
chair	kadeira
challenge	dezafiu
challenge	dezafia
chance	oportunidade
change	muda
chaos	inseguransa
character	karákter
characteristics	karakteristiku
charge	kustu
charity	karidade
charming	Atrasaun
charming	Enkantu
chart	grafiku
chase	duni
chat	dada-lia
chat	konversa
cheap	baratu
cheat	traisaun
cheating	fraudulentu
check	verifika
check	ezamina
cheek	hasan
cheer	haklalak
cheerful	haksolok
cheers	tos
cheese	keiju
chemistry	kímika
cherish	estima
chess	xadres
chest	hirus-matan
chew	nata
chicken	manu
chief	xefe
child	labarik
childhood	infansia
children	labarik sira
chill	kalma
chill	halo malirin
chimneys	xaminé
chin	keixu
chocolate	xokolate
choice	opsaun
choose	hili
chop	taa
chores	tarefas
chubby	kabosu
church	igreja
cinnamon	ai-kanela
circle	sirkulu
circumstances	sirkunstânsia
citizen	Sidadaun
city	sidade
claim	afirma
claim	reklamasaun
clarify	klariika
class	klase
clay	rai-mean
clean	mós
clear	klaru
clear	hamós
clerk	a
clerk	empregadu
clever	matenek
client	kliente
cliff	fatuk lolon
climate	klima
climb	sa'e
clingy	bele ka'er
clock	relojiu
close	taka
closet	armariu
cloth	Hena
clothes	roupa
cloud	kalohan
cloudy	kalohan
clown	pallasu
clue	dalan
clumsy	bilaan
cluster	kategoria
coach	treinu
coach	treinadór
coal	anar-fatuk
coast	costa
coat	kazaku
coffee	kafe
cognitive	kognitivu
coincidence	koinsidensia
cold	malirin
collapse	dezmaia
collar	kolár
colleague	kolega
colleagues	kolega sira
collect	koleta
collection	kolesaun
college	kolega
color	kor
colorless green ideas slept furiously	ideia la ho kór toba ho perigu
colour	kór
column	koluna
comb	sasuit
combination	kombinasaun
combine	kombina
come	mai
come here	mai iha ne'e
come on	mai ona
comfort	konfortu
comfortable	konfortável
coming	mai
coming soon	la kleur to'o mai
command	komanda
comment	komentariu
commercial	komersiál
commission	komisaun
commit	komete
commitment	kompromisu
committed	kometidu
commodity	merkadoria
common	komún
communicate	komunika
communication	komunikasaun
community	komunidade
commute	komuta
commute	viajen loron-loron
companion	maluk
company	kompaña
compare	kompara
comparison	komparasaun
compassion	kompaisaun
compassionate	kompasionadu
compatible	kompativel
compete	kompete
competent	Kompente
competition	kompetisaun
competitive	kompetetivu
complain	keixa
complaint	keixa
complement	komplementu
complement	komplementa
complete	kompletu
completely	kompletamente
complex	susar
compliance	konformidade
complicated	komplikadu
compliment	gaba
comply	kumpri
composition	kompozisaun
compound	kadoek
comprehension	komprensaun
comprehensive	komprehensivu
compromise	kompromete
compromise	kompromisu
compulsory	obrigatóriu
computer	komputadór
concentrate	konsentradu
concept	konseitu
concern	preokupa
concern	problema
concerned	preokupa
concert	konsertu
conclusion	konklusaun
concrete	konkretu
concrete	konkreta
condition	kondisaun
conditions	kondisaun
conduct	kondutu
conference	konferensia
confess	konfesa
confidence	konfidente
confident	konfiansa
confirm	konfirma
conflict	konflitu
confused	konfuzaun
confusion	konfuzaun
congrats	parabens
congratulation	parabens
congratulations	parabens
conjunction	konjunsaun
connect	liga
conquer	konkista
conscious	konsiente
consciousness	konsiensia
consent	konsenti
consent	konsentimentu
consequences	konsekuênsia
conservation	konservasaun
conservative	konservativu
consider	konsidera
considered	konsidera ona
consist	kompostu
consistency	konsisténsia
consistent	konsistente
constant	konstante
constantly	beibeik
constipation	konstipasaun
construction	konstruisaun
consume	konsumu
consumption	konsume
contact	kontaktu
contagious	kontajiozu
contain	konten
contains	kontein
contemporary	kontemporariu
contempt	desprezu
content	konteudu
contest	kotensta
context	kontestu
continent	kontinente
continue	kontinua
contract	kontrata
contract	kontratu
contrast	naroman
contrast	haroman
contribute	kontribui
contribution	kontribuisaun
control	kontrola
controversial	kontroversa
convenience	konveniente
convenient	konveniente
conversation	konversa
convert	konverte
convey	transmite
convince	konvense
convinced	Konvensidu
cook	tein-nain
cook	tein
cooking	Tein
cool	jeitu
cool	malirin
cooperation	Kooperasaun
cope	apár
copper	riti
core	esensiál
corn	batar
corner	kantu
correct	koretu
cost	iha folin
cost	folin
costume	kostume
cottage	uma-du'ut
cotton	kabas
couch	sofá
cough	mear
could	bele
council	konsellu
count	konta
counter	balkaun
country	nasaun
countryside	area rural
couple	kazal
courage	koraja
course	kursu
court	tribunál
courtesy	kortezia
cousin	primu
cover	taka
cow	karau
coward	ta'uk-teen
cozy	hakmatek
crab	kadiuk
crack	sinál
craft	arte
crap	bosok-ten
crash	hamonu
crash	monu
craving	deseju
crawl	rasta
crazy	bulak
create	kria
creative	kreativu
credit	kreditu
creep	dada
creepy	kredu
crew	ekipa
crime	krime
cringe	hakribi
cringe	haraik an
crisis	krize
criteria	kritéria
critical	krítiku
criticism	kritika
crop	kolleita
crops	plantasaun
cross	kruz
cross	la'o liu
crow	kawaa
crowd	ema barak
crowded	nakonu
crown	koroa
crucial	krusial
crucial	importante
cruel	bárbar
cruise	kruzeiru
crush	laran monu
crush	nakfera
cry	tanis
cucumber	pipinu
cuddle	ko'us
culture	kultura
cunning	kakutak la'o
cup	kopu
cupboard	armáriu
curb	hafreun
cure	kura
curfew	rekolla
curiosity	kuriozidade
curious	kuriozu
curly	mulatu
currency	moeda
current	atuál
currently	foin dadauk
curse	fó-malisan
curtain	kurtina
cushion	sumasu
custom	kostume
customer	kliente
customs	alfandega
cut	korta
cut	ko'a
cute	bonitu
cycle	sikulu
cycling	siklizmu
dad	apaa
daddy	apa
daily	loroloron
dairy	diáriu
dam	barrajem
damage	estraga
damage	defeitu
damn	kondenasaun
damp	boko
dance	dansa
danger	perigu
dangerous	perigu
dark	nakukun
darling	amor
dash	trasu
data	dadus
date	ba namora
date	data
daughter	oan-feto
day	loron
dead	mate
deadline	loron ikus
deaf	diuk
deal	negosia
deal	akordu
dear	prezadu
Dear All	Ba imi hotu ne'ebé hau respeitu
Dear Customer	Prezadu Kliente
Dear Parents	keridu inan-aman
Dear Sir	keridu señor
Dear students	keridu estudantes
Dear Team	keridu ekipa
death	morte
debate	debate
debit	debitu
debris	sasan-rahun
debt	dívida
decade	dekada
decay	rai-han
deceased	mate
deceive	bosok
december	dezembru
decent	aseitável
decide	deside
decided	deside ona
decision	dezisaun
deck	ulun
deck	konves
decline	diminui
decrease	hamenus
dedicated	dedikadu
dedication	dedikasaun
deed	hahalok
deep	klean los
deer	bibi rusa
default	padraun
defeat	lakon
defeat	halakon
defend	defende
define	defini
definitely	definitivamente
definition	definisaun
degree	graun
delay	atrazu
delay	demora
delayed	atrazadu
delete	apaga
deliberate	delberadu
delicate	dedika
delicious	gostu
delight	kontente
delighted	enkantadu
deliver	entrega
delivered	enteregada
delivery	entrega
demand	ezije
demand	pedidu
demanding	demanda
democracy	demokrasia
demon	demóniu
demonstrate	hatudu
denied	nega
density	densidade
dentist	dentista
deny	nega
department	departamentu
departure	embarka
depend	depende
deploy	prepara
deposit	depósitu
deposit	depósita
depressed	laran-tun
depression	depresaun
depth	profundu
describe	deskreve
description	deskrisaun
desert	desertu
deserve	merese
design	projetu
design	projeta
designation	dezignadu
desire	vontade
desire	hakarak
desk	meza
despair	dezesperu
desperate	desperadu
despite	maski
dessert	sobre-meza
destination	destinasaun
destiny	destinu
destroy	harahun
destruction	destrusaun
detail	detallu
details	detallus
detect	deteta
determination	determinasaun
determine	determina
determined	determina ona
devastated	naksobu
develop	dezenvolve
developed	dezenvolvidu
development	dezenvolvimentu
device	dispositivu
devil	diabu
devoted	dedikada
Dhivehi	Dhivehi
diabetes	diabetes
diarrhea	diarea
diary	diaria
dictionary	Disciplinarian
did	halo ona
die	mate
died	mate
diet	dieta
difference	diferensia
different	diferente
difficult	difikuldade
dig	kee
dignity	dignidade
diligent	badinas
dinner	han kalan
dip	habokon
direct	direta
direction	diresaun
director	diretór
dirt	fo'er
dirty	foer
disable	aleijadu
disabled	aleijadu
disappear	lakon
disappointed	laran moras
disaster	dezastre
discard	soe
discharge	deskarga
discipline	disiplina
discount	deskonta
discover	diskobre
discrimination	diskriminasaun
discuss	deskute
discussion	diskusaun
disease	moras
diseases	Moras
disguise	disfarsa
disgusting	hakribi
dish	bikan
dishes	bikan
dismiss	demiti
dispatch	dipaixa
display	ezibisaun
disposal	soe
dispute	deskute malu
distance	distánsia
distinct	distintu
distinguish	diferensia
distress	neon-susar
distribution	fahe
district	distritu
disturb	perturbasaun
ditch	bee-dalan
dive	luku
diverse	oin-oin
diversity	diversidade
divide	fahe
divine	Divinu
divorce	divorsia
divorce	soe-malu
dizzy	oin-halai
do	halo
do you	ita-boot maka
do you love me	ita-boot hadomi ha'u
doctor	dotor
document	dokumentu
does	halo
doesn't	la
dog	asu
Dogri	Dogri
doing	halo hela
doll	boneka
domain	dominiu
domestic	doméstiku
dominant	dominante
don't	la bele
Don't worry	labele preokupa
donate	doasaun
done	hotu ona
done	halo ona
donkey	burru
dope	droga
double	dobra
double	duplu
doubt	dúvida
dough	massa
down	tuun
download	download
draft	projetu
draft	esbosa
drag	dada
drain	sulin
drama	drama
draw	dezeña
drawer	gaveta
drawing	dezeñu
dread	sentimentu ta'uk
dream	espera
dream	mehi
dress	bistidu
drill	fura
drink	hemu
drink	bee hemu
drive	kondus
drop	hamonu
drop	monu
dropped	hamonu
drought	maran
drunk	lanu
dry	maran
duck	manu-rade
dude	kolega
due	tanba
due to	tanba
dull	baruk
dumb	beikten
dump	soe
duration	durasaun
during	durante
dust	rai rahun
duty	kna'ar
dwell	abitat
dying	besik mate
each	kada
each other	ba malu
eager	hakarak duni
eagle	makikit
ear	tilun
earlier	sedu
early	sedu
earn	manaan
ears	tilun
earth	mundu
earthquake	rai-nakdoko
ease	redus
easily	fásil
east	leste
easy	fasil
eat	han
eating	han
economic	Ekonomiku
economy	ekonomia
edge	sorin
edit	edita
education	edukasaun
effect	efeitu
effective	efetivu
efficiency	efisiénsia
efficient	efisiente
effort	esforsa
effort	haka'as an
egg	manu-tolun
eggplant	brinjela
ego	egoismu
eight	ualu
eighteen	sanulu resin ualu
eighty	ualu nulu
either	kada
elaborate	elaborasaun
elbow	liman-tunur
elder	ferik
elder	katuas
elderly	idoza
elegant	elegánsia
element	elementu
elephant	elefate
eleven	sanuu-resin ida
eligible	elejível
eliminate	elimina
else	seluk
embarrassed	sente moe
embarrassing	moe
embrace	haku'ak
emerge	mosu
emergency	emerjénsia
emotional	emosional
empathy	empatia
emphasis	enfatiza
emphasize	enfatiza
employee	empregadu
employees	a
employees	empregadu
employer	empregadór
employment	empregu
empty	mamuk
enable	permite
encounter	enkontru
encourage	enkoraja
end	remata
endangered	ameasadu atu lakon
endeavor	esforsa an
endurance	rezistensia
endure	aguenta
enemy	inimigu
energy	Enerjia
engage	envolve
engaged	kontratadu
engagement	engajamentu
engine	mákina
engineer	enjeñeiru
English	Inglés
enhance	mellora
enjoy	Aproveita
enjoy	bomproveitu
enormous	enorme
enough	naton
ensure	asegura
enter	tama
entertainment	espetákulu
enthusiasm	animasaun
enthusiastic	entuziasmu
entire	tomak
entitled	iha direitu
entity	entidade
entrance	tama fatin
entrepreneur	emprezariu
envelope	envelope
environment	ambiente
envy	laran moras
epic	epiku
epidemic	epidemia
equal	hanesan
equipment	ekipamentu
equity	ekuidade
equivalent	ekivalente
eraser	apagador
error	erru
escape	halai
especially	espesialmente
essay	ensaiu
essence	substansia
essential	esensial
establish	estabelese
established	estabelese
estate	Estadu
estimate	estima
estimated	estimadu
etc	sst
eternal	rohan-laek
eternal	eterna
ethics	étika
evaluate	avalia
evaluation	avaliasaun
even	maske
even	mesmu
even though	maski
evening	kalan
event	eventu
eventually	afinál
ever	sempre
every	kada
everybody	ema hotu
everyone	ema hotu-hotu
everything	buat hotu-hotu
evidence	evidênsia
evil	diabu
evolution	evolusaun
evolve	envolve
Ewe	Ewe
ex	eis
exact	ezatu
exactly	loos duni
exam	ezame
examine	ezamina
example	ezemplu
exceed	liu
excellent	excelente
except	esklui
exception	esepsaun
excess	resin
excessive	esesivu
exchange	troka
excited	haksolok
excitement	entuziasmu
exciting	kontente duni
exclusive	esklusivu
excuse	razaun
excuse me	lisensa
execute	ezekuta
execution	Ezekusaun
executive	ezekutivu
exercise	ezersiu
exercise	ezersisiu
exhaust	hakole
exhausted	kolen loos
exhibit	hatudu
exhibition	hatudu
exist	eziste
existence	ezistensia
existing	eziste
exit	saida
expand	halu'an
expect	espera
expected	espera
expenses	gastu
expenses	despeza
expensive	karun
experience	infrenta
experience	esperiênsia
experiment	esperimenta
expert	péritu
expired	prazu liu
explain	esplika
explanation	esplikasaun
exploit	esplora
explore	esplora
export	esporta
expose	nakloke
exposed	deskobre
exposure	ekspozisaun
express	espressa
expression	espresaun
extend	prolonga
extended	estendida
extension	estensaun
extent	estende
external	esterna
extinct	mohu
extinct	lakon ona
extra	estra
extract	estrai
extraordinary	extraordináriu
extreme	estremu
extremely	estremamente
eye	matan
eyes	matan
fabric	fabrika
fabulous	fabulozu
face	hasoru
face	oin
facilitate	fasilita
facilities	fasilidade sira
facility	fasilidade
fact	faktu
factor	Fator
factory	fabrika
facts	faktu
fade	kamutis
fail	falta
fail	falha
failed	falla
failure	falla
faint	desmaia
fair	justu
fair	Feira
fairly	ho justu
fairy	fada
faith	konfiansa
faithful	fiel
fake	falsu
fall	bee monu
fall	monu
false	FALSU
fame	naran-boot
fame	fama
familiar	koñese
family	familia
famine	Rai hamlaha
famous	famozu
fan	admiradór
fan	vintunha
fancy	furak
fantastic	fantástiku
far	dook
farewell	despedida
farm	toos
farmer	agrikultor
fascinating	fasinante
fashion	moda
fast	lalais
fat	bokur
fatal	fatal
fatal	mate
fate	destinu
father	apaa
fatigue	kolen demais
fault	falta
favorite	favoritu
favour	favor
favourite	favoritu
fear	tauk
feast	selebrasaun
feather	fulun
feature	karakteríza
feature	karakterístika
features	karakterístiku
february	fevereiru
fed up	fó han
fee	taxa
feed	fó han
feedback	opiniaun
feel	sente
feeling	sentimentu
feet	ain sira
fell	monu ona
fellow	kolega
felt	sente ona
female	feto
fence	moru
fertile	fertíl
festival	festa
festival	festival
fetch	buka
fever	isin-manas
few	hirak
fewer	ituan liu
fiance	noivu
fiction	fiksaun
field	kampu
fierce	kro'at
fifteen	sanulu resin lima
fifty	lima nulu
fight	luta
fight	baku malu
fighting	baku-malu
figure	imajina
figure	figura
figure out	buka hatene
file	arkiva
fill	enxe
filled	hakonu
film	Filme
filthy	buradu
finally	finalmente
finance	finansa
financial	finansiál
find	buka
find out	buka-hatene
fine	multa
fine	di'ak
finger	liman-fuan
finish	hotu
finished	remata
fire	ahi
firm	empreza
firm	metin
first	primeiru
first name	naran primeiru
fish	ikan
fit	ajusta
five	lima
fix	fiksu
fixed	fiksu
flag	bandeira
flash	piska
flat	planu
flat	apartementu
flaw	defeitu
flawless	perfeita
flee	Halai
flesh	na'an
flew	semo
flex	silu kleuk
flexible	fleksível
flight	aviaun
flip	dulas
flirt	garidu
flirting	book feto
flirting	mane
float	namlele
flood	bee sai
floor	rai-simentu
flour	farinha
flow	sasulik
flow	suli
flower	aifunan
flu	gripe
fluent	moos
fluently	fluente
fluffy	mamar
fluid	nabeen
fly	semo
focus	fokaliza
focus	foku
fog	abuabu
foggy	kalohan taka-rai
fold	lipat
folks	povu
follow	tuir
follow up	akompañamentu
following	tuir
food	hahaan
fool	beik-ten
fool	beik
foolish	beik
foot	ain
football	futebol
for	ba
For example	purezemplu
for instance	pur ezemplu
for you	ba ita-boot
forbidden	bandu
force	forsa
forecast	previzaun
forehead	reen-toos
foreign	estranjeiru
forest	ai-laran
forever	ba nafatin
forget	haluhan
forgive	perdua
forgot	haluha
fork	garfu
form	forma
form	formuláriu
formal	formál
former	eis
fortunately	Felizmente
fortune	sorte
forty	haat nulu
forty-two	haat nulu resin rua
forward	passa ba oin
foster	hakiak
fought	luta
found	hetan ona
foundation	fundasaun
four	haat
fourteen	sanulu resin haat
fox	asu-fuik
fragile	fraku
frame	kuadru
framework	enkuadramentu
fraud	fraude
freak	anormál
free	livre
freedom	liberdade
freeze	jelu
frequency	frekuensia
frequent	frekuente
frequently	freküentemente
fresh	fresku
friday	sexta
fridge	jaleira
friend	belun
friendly	amigável
friends	kolega
friendship	amizade
frightened	sente tauk
frightening	be hata'uk
frog	manduku
from	husi
front	oin
frozen	jelu
fruit	ai-fuan
frustrated	frustradu
fuel	kombustível
Fulfulde	Fulfulde
full	nakonu
fun	kontente
function	funsaun
fundamental	fundamentál
funeral	funerál
funny	kómiku
fur	fulun
furious	hirus loos
furniture	ekipamentu
further	liután
further	ba oin
furthermore	liutan
future	futuru
gain	obten
gain	aumenta
game	jogu
gap	lakuna
garage	garajen
garbage	fo'er
garden	jardin
garlic	lis mutin
gate	portaun
gather	halibur
gathering	halibur
gauge	indikador
gave	fó ona
gear	engrenájen
gender	jeneru
general	jerál
generally	jeralmente
generate	hahoris
generation	jerasaun
generous	generozu
genius	jeniu
genre	jeneru
gentle	jentíl
genuine	autêntiku
gesture	jestu
get	foti
get dressed	troka ona
get up	hadeer
get well soon	di'ak lalais
getting	hetan
ghost	mate-klamar
ghosting	mateklamar
giant	jigantesku
gift	premiu
ginger	ai-lia
girl	feto
girlfriend	namorada
give	fó
give up	abandona
given	fo ona
glad	kontente
glance	haree-kois
glass	vidru
glasses	oklu
glimpse	haree kois
global	globál
gloomy	solok-laek
gloves	luvas
glow	naroman uitoan
glow	naroman fraku
glow up	naroman
glue	goma
go	ba
go ahead	ba deit
go away	ses tia
go to bed	ba toba
goal	objetivu
goals	metas
goals	objetivu
goat	bibi
god	maromak
god bless you	maromak fó bensaun
goes	ba
going	ba
going to	atu ba
gold	osan mean
gone	lakon
gonna	sei
goo	gosma
good	kapas
good	di'ak
good afternoon	loron di'ak
good bye	adeus
good day	loron di'ak
good evening	kalan di'ak
good job	bom traballu
good looking	bonitu
good luck	boa susesu
good morning	Dadeer di'ak
good morning my love	dadeer di'ak ha'u-nia domin
good night	kalan di'ak
goodbye	adeus
goodnight	kalan-di'ak
goods	sasan
Google	Google
Google Translate	Google Tradus
goose	manu-rade
gorgeous	bonita
gossip	lori lia
got	hetan ona
got it	komprende ona
government	governu
grab	kaer
grade	grau
gradually	gradualmente
graduate	graduasaun
grain	musan
grant	garante
granted	garantidu
grapes	uvas
grasp	komprensaun
grass	duut
grateful	agradável
gratitude	gratidaun
grave	rate
gray	malahun
gray	sinzentu
great	kapas tebtebes
greed	kaan-teen
greedy	kaan-ten
green	verde
greet	hasee
greet	kumprimenta
greeting	Kumprime
greetings	kumprimentus
grey	sinza
grid	grella
grief	lutu
grind	grinda
grip	kaer metin
grocery	merkadoria
groom	noivu
gross	bruto
ground	terenu
group	grupu
grow	moris
growth	kreximentu
grumpy	jeniu-aat
Guarani	Guarani
guarantee	garante
guard	guarda
guess	Si'ik
guest	bainaka
guidance	Matadalan
guide	guia
guide	orienta
guilty	sente sala
guy	mane
guys	maluk sira
gym	jinaziu
habit	ábitu
habitat	abitat
had	iha ona
hail	saudasaun
hair	fuuk
half	balun
hall	salaun
hand	liman
handle	jere
handsome	bonitu
hang	tara
hang out	passa tempu hamutuk
happen	akontese
happened	Akontese ona
happiness	felisidade
happy	haksolok
happy	kontente
happy birthday	Feliz aniversáriu
happy birthday to you	feliz aniversáriu ba ita-boot
happy new year	feliz ano novu
hard	araska
hardly	difisilmente
hardly ever	susar liu
harm	danu
harm	ofende
harmful	perigozu
harmony	armonia
harsh	toos
harvest	kolleta
has	iha
hate	hakribi
have	iha
have a good day	loron di'ak
have a nice day	iha loron ne'ebé di'ak
have breakfast	matabixu
have fun	diverte an
have you eaten	Ita-boot han ona
having	iha
hazard	perigu
haze	abuabu mihis
he	nia
he has	nia iha
he is	nia
head	ulun
headache	ulun-moras
heal	kura
healing	kura
health	saúde
healthy	saudável
hear	rona
heard	rona
heart	fuan
heat	halo manas
heat	manas
heaven	lalehan
heavy	todan
hectic	serbisu barak
height	altura
heir	erdeiru
heist	roubu
held	kaer ona
hell	infernu
Hello	Óla
hello dear	Óla amor
hello how are you	Óla o di'ak ka lae
hello how are you doing	ola di'ak ka lae
helmet	kapaseti
help	tulun
helpful	ajuda loos
hence	konseküentemente
her	ninian (feto)
herd	lubun
here	iha ne'e
heritage	heransa
hesitate	hesite
Hey	Oi
Hi	Óla
hi how are you	olá ita di'ak ka lae
Hi there	Ola
hidden	subar
hide	subar
hierarchy	ierarkia
high	aas
highlight	foku
hike	pasiar iha foho
hiking	sa'e foho
hilarious	komik
hill	foho
him	nia
hint	sujestaun
hip	kelen
hips	kidan
hire	kontratu
hiring	kontratu
his	ninian
history	istória
hit	baku
Hmm	Humm
hobby	hobi
hold	kaer
hold on	kaer metin
hole	kuak
holiday	feriadu
hollow	mamuk
home	uma
homework	traballu de kaza
honest	onestu
honestly	Ho onestu
Honey	Bani-been
honor	onra
hood	kapús
hook	kail
hook	ganxu
hop	haksoit
hope	esperansa
hope	espera
hopefully	espera
hopeless	lakon esperansa
horizontal	orizontal
horn	korneta
horrible	aat loos
horror	orror
horse	kuda
hospital	ospitál
hospitality	ospitalidade
host	uma nain
host	simu bainaka
hostile	neon-aat
hot	manas
hotel	otel
hour	oras
hours	oras
house	uma
household	uma-kain
how	Oinsá
how about you	oinsa ho ita-boot
how are you	Di'ak ka lae
how are you doing	Ita-boot di'ak ka lae
how are you doing today	ohin ne'e o di'ak ka lae
how are you today	ohin ita-boot di'ak ka lae
how do you do	oinsá maka ita-boot halo ne'e
how is	oinsa maka
how many	hira
how much	hira
how often	dala hira
how old are you	Ita-boot tinan hira
how was your day	ita-boot nia loron ohin oinsá
how was your night	oinsá ho ita-boot nia kalan
however	entantu
hub	sentru
hubby	katuas oan
hug	haku'ak
huge	boot
human	umanu
humble	umilde
humid	umidu
humidity	umidade
hundred	atus
hungry	hamlaha
hunt	kasa
hurricane	anin-fuik
hurry	ansi
hurry up	lais uituan
hurt	kanek
hurt	moras
husband	katuas-oan
hustle	barullu
hustle	dudu makaas
hut	barraka
hygiene	ijiene
I	Ha'u
I am	Ha'u maka
I am fine	ha'u di'ak
I can	Ha'u bele
I can't	Ha'u la bele
I do	Ha'u halo
I do not know	ha'u lahatene
I do not understand	ha'u la komprende
I don't	labele
I don't	ha'u lae
I don't know	Ha'u la hatene
I don't understand	Ha'u la komprende
I don't understand what you mean	ha'u lakomprende saida maka ita-boot dehan
I don't understand you	Ha'u la komprende ita-boot
I don’t know	ha'u lahatene
I don’t understand	Ha'u la komprende
i guess	ha'u si'ik
I had	ha'u iha ona
I have	Ha'u iha
I have been	ha'u iha ona
I hope so	ha'u espera hanesan ne'e
I know	Ha'u hatene
I like	Ha'u gosta
I like you	ha'u gosta ó
I love	Ha'u hadomi
I love my big brother	ha'u hadomi ha'u nia maun boot
I love my big sister	ha'u hadomi ha'u nia bin boot
I love my father	ha'u hadomi ha'u nia aman
I love my little brother	ha'u hadomi ha'u nia alin mane ki'ik
I love my little sister	ha'u hadomi hau nia alin feto ki'ik
I love my mother	ha'u hadomi ha'u nia inan
I love you	Ha'u hadomi o
I love you so much	Ha'u hadomi los o
I love you too	ha'u mós hadomi ó
I mean	Ha'u signifika ba
I miss you	Ha'u saudades o
I miss you so much	ha'u saudades loos ó
I see	Ha'u hare
I think	ha'u hanoin
I understand	Ha'u komprende
I want	Ha'u hakarak
I want to see you	Ha'u hakarak atu hasoru ita-boot
I want you	Ha'u hakarak ita-boot
I was	Ha'u uluk
I will	Ha'u sei
I would be	ha'u sei
I'm	Ha'u maka
I'm fine	Ha'u di'ak
I'm good	H'au di'ak
I'm here	ha'u iha ne'e
I'm sorry	deskulpa
ice	jelu
ice cream	eskrim
idea	ideia
ideal	loloos
identical	identikal
identify	identifika
identity	identidade
idiot	beik
idle	paradu
if	sé
if	karik
ignore	ignora
ill	moras
illegal	ilegal
illness	moras
Ilocano	Ilocano
image	imajen
imagine	imajina
immediate	imediata
immediately	kedas
immense	imensa
impact	impaktu
impact	soke malu
impatient	la pasiensia
implement	implementa
import	importasaun
import	importa
important	importante
impose	impoin
impossible	imposível
impress	impresional
impression	impresaun
impressive	impressionante
improve	hadi'ak
improvement	melloramentu
in	iha laran
in addition	aliende
In fact	defaktu
in front of	iha oin
in order to	atu hodi
inappropriate	la apropriadu
incentive	insintivu
incident	insidente
include	inklui
including	inklui
income	reseita
inconvenience	la konviniente
increase	hasa'e
increase	aumenta
increased	aumenta
incredible	inkrível
indeed	ne'e duni
independent	independente
India	India
indicate	indika
indigenous	rai-na'in
individual	pesoal
industry	industria
inevitable	inevitável
infant	ki'ikoan
infection	infesaun
infinity	infinidade
inflammation	inflamasaun
inflation	inflasaun
influence	influênsia
inform	informa
information	informasaun
ingredients	ingridientes
inheritance	eransa
initial	inisial
initiative	inisiativu
injured	kanek
injury	kanek
innocent	inosenti
innovation	inovasaun
inquiry	inkéritu
insane	bulak
insect	inseto
insecure	la seguru
insert	hatama
inside	iha laran
insight	haree-borus
insist	insiste
insomnia	toba la dukur
inspiration	inspirasaun
inspire	inspira
install	instala
instance	instánsia
instant	instantaneu
instead	duke
instead of	Envezde
instructions	instrusaun
instrument	instrumentu
insult	insulta
insurance	seguru
intact	sei tomak
integrity	integridade
intellectual	matenek-na'in
intelligence	intelijensia
intelligent	intelijente
intend	intensaun
intended	intensaun
intense	intensu
intention	intensaun
interact	interasaun
interaction	interasaun
interest	interese
interested	interese
interesting	interesadu
interfere	interfere
intermediate	intermediáriu
internal	interna
international	internasional
internship	estajiu
interpret	interpreta
interpreter	interpreter
interrupt	interrompe
interview	intervista
intimate	intimadu
into	tama ba
introduce	introdus
introduction	introdusaun
introvert	introvertidu
intuition	intuisaun
invalid	invalidu
invent	Inventa
inventory	inventóriu
invest	investe
investigate	investiga
invitation	konvite
invite	konvida
invoice	nota
invoice	anota
involve	envolve
involved	envolve
iron	ferru
iron	strika
is	maka
island	illa
isolated	izoladu
issue	kestaun
issue	emite
issues	problema sira
it	sasan ne'e
it	buat
it is	ida ne'e
it was	ne'e maka ne'e
it's	ne'e
it's ok	ne'e di'ak hela
It's okay	La buat ida
item	sasan
items	sasan
its	ninia
I’m	Ha'u maka
jacket	faru-manas
jail	Kadeia
January	Janeiru
jar	jarra
jaw	hasan-ruin
jealous	oin-toos
jerk	beik-teen
jewelry	Joia
job	servisu
jogging	halai
join	partisipa
joint	konjuntu
joke	ko'alia-halimar
journalist	jornalista
journey	viajen
joy	alegria
judge	julga
judge	juiz
juice	jus
july	jullu
jump	haksoit
june	juñu
junk	sasan
just	justu
just	só
just do it	halo deit
justice	justisa
justify	justifika
Kalaallisut	Kalaallisut
keen	entusiástiku
keep	rai
keep it up	mantein nafatin
kept	rai
kettle	buli bee manas
key	xave
kick	tebe
kid	Labarik
kidding	halimar
kidney	rins
kids	labarik
kill	oho
kind	hanesan
kind	tipe
kinda	tipi
kindly	oin-mamar
kindness	laran-di'ak
king	liurai
kiss	rei
kitchen	te'in fatin
kite	papagaiu
kitten	busa-oan
knee	ain-tunur
knew	hatene
knife	tudik
knight	kavaleiru
know	hatene
knowledge	koñesimentu
known	hatene
Konkani	Konkani
Krio	Krio
label	etiketa
labor	traballu
labour	servisu
lack	falta
ladder	eskada
lady	feto
laid	latan
lake	mota
lamb	bibi
lame	aat loos
lamp	lampu
land	rai
land	desembarka
landscape	paizajen
language	lingua
lap	dere
large	boot
last	ikus
last but not least	ikus maibé lamenus
last name	naran ikus
late	tarde
lately	ikus ne'e
later	depois
latest	mais resente
latter	ida ikus
laugh	hamnasa
laughing	hamnasa
laughter	hamnasa
launch	lansa
laundry	fasi
law	lei
lawn	du'ut laran
lawyer	advogadu
lay	toba
layer	kamada
layout	formatu
lazy	baruk
lead	lidera
leader	lider
leaf	ai-tahan
leak	kuak
lean	sadere
leap	haksoit
learn	aprende
learning	aprendijazen
lease	aluga
least	menus liu
leather	kulit
leave	husik tiha
leave	ai-tahan
leaves	ai-tahan
led	lidera
left	liman karuk
left	husik hela
leg	ain
legacy	legadu
legal	legál
legend	lejenda
legit	lejitima
leisure	deskansa
lend	impresta
length	naruk
less	oituan
lesson	lisaun
let	husik tiha
letter	karta
lettuce	alfase
level	nivel
leverage	aproveita
liability	responsabilidade
library	biblioteka
lick	lambe
lie	bosok
lie	toba
lies	bosok
life	moris
lift	elevadór
lift	hiit
light	ahi
light	kmaan
lightning	rai-lakan
like	hanesan
likely	hanesan
likewise	hanesan
line	liña
Lingala	Lingala
link	ligasaun
lion	liaun
liquid	likuidu
list	lista
listen	rona
listening	rona
literally	literalmente
literature	literatura
litter	Litru
little	ki'ik
little	uituan
live	transmisaun direta
live	moris
liver	aten
lives	vida
living	moris
living room	sala bainaka
lizard	teki-liras
load	tula
loaf	paun
loan	empresta
local	lokál
location	lokál
lock	xave
lockdown	xave
log	rejistu
lol	hamnasa boot
lonely	solitáriu
long	naruk
long time no see	kleur lahetan
look	haree
loop	halo kabuar
loose	livre
loose	la metin
lord	na'i
lose	lakon
loss	lakon
lost	lakon ona
lot	rahun
loud	barullu
lounge	sala vizita
love	hadomi
love you	hadomi o
lovely	kapas
low	baixa
lower	kraik
loyal	dedikadu
loyalty	loialdade
luck	sorte
lucky	sorte
Luganda	Luganda
luggage	bagájen
lump	Lampu
lunch	han meudia
lungs	pulmaun
luxury	luxu
lying	bosok
machine	mákina
mad	hirus
madam	senora
made	halo ona
magazine	revista
magnificent	magnífiku
maid	kriadu
maid	a
main	prinsipál
maintain	mantein
maintenance	manutensaun
Maithili	Maithili
major	boot
majority	maioria
make	halo
make up	inventa
male	mane
mall	sentru komersiak
man	mane
manage	jere
management	jerensiamentu
manager	jerente
mandatory	obrigatóriu
manifest	manifesta
manipulate	manipula
manner	maneira
manual	manuál
many	barak
many many happy returns of the day	retornu ida ne'ebé barak tebes iha loron ikus
march	marsa
margin	marjen
market	merkadu
marriage	kaben
married	kaben
mask	maskara
mass	Missa
massive	boot tebes
master	mestri
match	koresponde
match	partida
mate	maluk
material	materiál
math	matematika
matter	matéria
matter	importa
maturity	maturidade
may	bele
may	karik
maybe	karik
me	ha'u
me too	ha'u mós
meal	hahaan
mean	signifika
meaning	signifika
means	meius
meant	signifika
meanwhile	enkuantu
measure	medida
measures	medida
meat	na'an
medical	mediku
medicine	ai-moruk
meditation	meditasaun
medium	médiu
meet	hasoru
meeting	reuniaun
Meiteilon	Meiteilon
melt	nabeen
memories	memoria
memory	memoria
mental	mentál
mention	temi
mentioned	mensiona
mentor	akompana
merchant	komersiante
mercy	mizerikordia
merely	simplesmente
merry christmas	feliz natal
mess	rungu ranga
message	mensajen
messy	sabraut
metal	besi metál
method	metodu
mice	laho
middle	klaran
midnight	kalan boot
might	dalaruma
might	karik
mild	kmaan
milestone	pasu-boot
military	militar
milk	susubeen
million	milliaun
mind	hanoin
mind	kakutak
mindset	mentalidade
mine	Ha'u nian
mine	mina
mingle	kahur
minor	menor
minute	minutu
minutes	minutu
miracle	milagre
mirror	espellu
miscellaneous	oin-oin
mischievous	nakar
miserable	sofre
misery	moris-susar
miss	hanoin
miss	saudades
miss you	hanoin o
missing	lakon
mission	misaun
mist	abuabu
mistake	buat sala
Mizo	Mizo
mobile	movel
mock	halo trosa
model	modelu
moderate	moderadu
modern	modernu
modest	modestu
moist	bok-bokon
moisture	umidade
mold	molde
mold	molda
mole	tailalat
mom	amaa
moment	momentu
monday	Segunda
money	osan
monitor	monitór
monkey	Lekirauk
month	fulan
mood	sentimentu
moody	sentimentu loos
moon	fulan
moral	morál
more	liután
moreover	liutan
morning	dadeer
mortgage	ipoteka
most	maioria
mostly	liuliu
mother	amaa
motion	mosaun
motivation	motivasaun
mountain	foho
mouse	laho
mouth	ibun
move	muda
movement	movimentu
movie	filme
mrs	sra
much	barak
mud	tahu
mug	kopu
muscle	múskulu
museum	muzeum
mushroom	kogumelu
music	músika
must	obrigasaun
must	tenke
mute	Nonok
mutual	mutua
my	ha'u nian
My dear	hau nia keridu
my friend	ha'u nia kolega
My hovercraft is full of eels	ha'u nia ró nakonu ho ahi oan sira
my love	ha'u nia doben
my name is	Ha'u nia naran
my pleasure	ha'u nia ksolok
myself	ha'u an rasik
mysterious	misteriozu
mystery	mistériu
myth	ai-knanoik
myth	mitu
nail	pregu
nail	liman-kukun
naive	beik-teen
name	naran
narrative	narativa
narrow	klo'ot
nasty	hakribi
national	Nasional
nationality	nasionalidade
native	nativu
natural	natureza
nature	natureza
nausea	laran-sa'e
near	besik
nearby	besbesik
nearly	besik
nearly	falta uitoan
neat	arumadu
necessary	nesesáriu
neck	kakorok
necklace	korente
need	nesesidade
need	presiza
negative	negativu
neglect	deskuida
negotiate	negosia
neighbor	vizinu
neighborhood	bairru
neither	la iha
nephew	sobrinhu
nerd	ema estranu
nervous	nervozu
nest	knuuk
net	rede
network	rede
neutral	neutru
never	nunka
never give up	nunka dezisti
never mind	husik tiha
nevermind	husik ona ba
nevertheless	entantu
new	foun
news	notisia
next	tuir mai
next to	besik bá
nice	kapas
nice	furak
nice to meet you	sente di'ak ba hasoru ita
niece	sobriña
night	kalan
nightmare	mehi-aat
nine	sia
nineteen	sanulu resin sia
ninety	sia nulu
No	Lae
no problem	la iha problema
no way	laiha dalan
nobody	laiha ema ida
noise	barullu
noisy	barullu
none	la iha
noon	meiudia
nope	lae
nor	lae
normal	normál
north	norte
nose	inus
nostalgic	nostalgia
not	laos
not at all	lae liu
not bad	la aat
Not now	la'ós agora
not yet	seidauk
note	nota
noted	nota
nothing	la iha buat ida
notice	notisia
noticed	notifika
noun	substantivu
nouns	substantivu
novel	novela
november	novembru
now	agora
nowadays	ohin loron
nuisance	xatise
nuisance	masada
null	mamuk
numb	maten
number	númeru
nurse	enfermeiru
nut	nos
nutmeg	nozmoskada
nutrition	nutrisaun
oath	juramentu
obesity	obesidade
obey	obedese
object	objetu
objective	objetivu
obligation	obrigasaun
obscure	obskuru
observation	observasaun
observe	observa
obsessed	obsesadu
obsession	obsesaun
obsolete	la uza tan
obstacle	obstakulu
obtain	obten
obtained	obtein
obvious	duni
obviously	klaru duni
occasionally	dalaruma
occupation	okupasaun
occupied	okupadu
occur	akontese
occurred	akontese
occurs	akontese
ocean	oseania
october	outubru
odd	estrañu
odds	estranu
odds	oin seluk
of	husi
of course	klaru
off	taka
off	sai
offensive	Ofensivu
offer	fó
offer	oferese
office	eskritóriu
official	ofisiál
often	beibeik
Oh	Oih
oh really	oh ne'e ka
oil	mina
ok	Di'ak
ok dear	Ok queridu
ok honey	oke doben
ok my love	di'ak amor
okay	di'ak
okay baby	okey amor
okay dear	prontu amor
okay honey	sin amor
okay my love	sin ha'u nia doben
old	tuan
on	iha
once	dala ida
one	ida
one language is never enough	lingua ida nunka natoon
onion	liis bombai
online	online
only	só
open	loke
operation	operasaun
opinion	opiniaun
opportunities	oportunidade
opportunity	oportunidade
opposite	kontráriu
optimistic	otimistiku
option	opsaun
optional	opsional
or	ka
orange	kór de laranja
orange	sabraka
order	ordena
order	orden
ordinary	ordináriu
organization	organizasaun
orientation	orientasaun
origin	orijen
original	orijinál
Oromo	Oromo
orphan	órfanatu
other	seluk
otherwise	kontráriu
ought	obrigasaun
our	ami nian
Our mission: to enable everyone, everywhere to understand the world and express themselves across languages.	Ami-nia misaun: atu permite ema hotu, iha ne'ebe deit atu komprende mundu ne'e no espresa sira-nia an iha lingua oioin.
Our mission: to organize the world's information and make it universally accessible and useful.	Ami-nia misaun: atu organiza informasaun mundu nian no atu halo informasaun ne'e universalmente asesivel no util.
out	sai
outcome	rezultadu
outfit	roupa
outgoing	sai
outlet	tomada
outline	esbosu
outside	iha liur
outstanding	prominente
oven	fornu-oven
over	liuhosi
over there	iha ne'e
overall	jerál
overcome	ultrapasa
overthinking	hanoin barak liu
overwhelmed	rungu ranga
overwhelming	barak
owe	tusan
owl	kakuuk
own	rasik
own	na'in
owner	na'in
ox	karau-aman
pace	ritmu
pack	pakote
package	pakote
paid	selu
pain	moras
paint	tinta
painting	tinta
pair	par
pale	kamutis
palm	tali
pan	sanan
pandemic	pandemia
panic	paniku
pants	kalsa
paper	suratahan
paradise	paraizu
parallel	paralelu
parcel	parsela
pardon	fo perdaun
parents	inan-aman
park	jardin
parrot	manu-loriku
parsley	salsa
part	parte
participate	partisipa
particular	espesial
particularly	partikularmente
partner	parseiru
party	festa
pass	passa
passage	pasajen
passed	pasa
passion	paixão
passionate	pasionadu
passive	pasivu
password	liafuan xave
past	pasadu
patch	baban
patch	Tiras
path	dalan
pathetic	patétiku
patience	pasiensia
patient	pasiente
patient	pasiensia
pattern	padraun
pause	pauza
pavement	trotoar
pay	selu
payment	pagamentu
peace	dame
peaceful	hakmatek
peach	pésegu
peak	tutun
pear	pera
peas	ervilla
peculiar	espesial
peculiar	estranu
pee	mii
peel	loke kulit
peer	par
peers	par
pen	lapijera
pencil	lápis
pending	pendente
people	ema sira
pepper	pimenta
perceive	komprende
perception	persepsaun
perfect	perfeitu
perform	realiza
performance	dezempeñu
perhaps	karik
period	periodu
permanent	permanente
permission	permisaun
permit	lisensa
perseverance	perseveransa
persistent	persistenti
person	ema
personal	pesoál
personality	personalidade
perspective	perspektivu
persuade	hamaus
pervert	pervertidu
pet	animál hakiak
phase	faze
phenomenon	fenomena
philosophy	Filozofia
phone	telefone
photo	fotografia
phrase	fraze
physical	fíziku
pick	foti
pick up	foti
picture	fotografia
piece	pedasu
pieces	pedasu
pig	fahi
pigeon	manu pombu
pile	bou
pillow	sumasu
pilot	pilotu
pin	daun tutun
pineapple	ai-nanas
pink	kor de roza
pit	raik kuak luan
pitch	tuda
pity	kuitadu
place	tau
place	fatin
places	fatin
plague	peste
plague	epidemia
plain	simples
plan	planu
plane	aviaun
plant	planta
plants	plantasaun
plate	bikan
platform	plataforma
play	jogus
play	joga
playing	halimar
pleasant	gostu
please	por favór
please	halo kontenti
pleased	satisfeitu
pleasure	gozu
pledge	kompromisu
plenty	barak
plot	planu
plug	tu
plum	abrunus
plumber	kanalizador
plural	plurál
podcast	podcast
poem	dadolin
poetry	poezia
point	pontu
poison	veneno
police	polisia
policy	politika
polite	edukadu
pollution	poluisaun
pond	lagoa
pool	pixina
pool	lagoa
poop	tee
poor	ki'ak
pop	pop
popular	populár
population	populasaun
pork	na'an-fahi
porridge	sasoro
port	portu
position	pozisaun
positive	positivu
possess	iha
possess	posa
possession	posesaun
possessive	posesivu
possible	posivél
post	postu
post	kolokadu
postpone	adia
potato	fehuk-ropa
potential	potensial
pound	fai
poverty	pobreza
power	poder
powerful	forsa
practical	pátikal
practice	prátika
praise	konsagrasaun
prank	brinkadeira
pray	reza
precious	presiozu
precise	loloos
precisely	loloos kedas
predict	predisaun
prefer	prefere
preference	preferensia
pregnant	isin-rua
prejudice	prejudika
premises	instalasaun
premium	premiu
preparation	preparasaun
prepare	prepara
prepared	preparadu
preposition	prepozisaun
presence	prezensa
present	prezente
present	aprezenta
present	agora
presentation	aprezentasaun
preserve	prezerva
president	prezidente
press	hanehan
pressure	presaun
pretend	halo finji
pretty	bonita
pretty	naton
prevent	prevene
previous	uluk nian
prey	preza
price	folin
pride	orgullu
priest	padre
primary	primáriu
prime	primariu
princess	prinseza
principal	prinsipál
prior	uluk
priority	prioridade
prison	prizaun
privacy	privasidade
private	privadu
privilege	priviléjiu
prize	prémiu
probably	dalaruma
probably	karik
problem	problema
procedure	prosidementu
proceed	prosesadu
process	prosesu
process	prosesa
produce	produs
product	produtu
production	produsaun
profession	profisaun
professional	profissional
profile	perfil
profit	lukru
profound	profunda
profound	koak naruk
progress	progresu
progress	avansa
project	projetu
prominent	prominenti
promise	promesa
promise	promete
promote	promove
promotion	promosaun
prompt	prontu
prone	fasil atu
pronouns	pronome
pronunciation	pronunsia
proof	prova
proper	apropriadu
properly	apropriadamente
properties	propriedade
property	propriedade
proposal	proposta
prospect	perspetiva
prosperity	prosperidade
prosperous	prospero
protect	proteje
proud	orgullu
prove	komprova
provide	fornese
provided	fornesidu
province	provínsia
provision	fornesimentu
puberty	puberdade
public	públiku
pull	dada
pumpkin	lakeru
punctual	pontual
pupil	alunu
pupil	a
purchase	sosa
purchase	hola
pure	puru
purple	vermellu
purpose	objetivu
purse	pasta
pursue	prokura
pursuit	persegisaun
push	dudu
put	tau
qualification	kualifikasaun
quality	kualidade
quantity	kuantidade
quarantine	kuarentena
quarrel	haksesuk-malu
quarter	quartu
quarter	dahaat
Quechua	Quechua
queen	liurai-feto
queer	eskizitu
query	pergunta
question	pergunta
queue	hein
queue	fila
quick	lais
quickly	lalais
quiet	nonok
quilt	kolxa
quit	sai
quite	oituan
quite	nonok
quiz	kadi kakutak
quotation	Kotasaun
quote	sita
quote	sitasaun
quotes	sita
rabbit	koellu
race	halai-taru
rage	laran-manas
rain	udan
raise	foti sa'e
raise	aumenta
raised	hakiak
ran	halai
random	aleatóriu
range	alkanse
rapid	rapidu
rapidly	Ho rapidu
rare	raru
rarely	rarumente
rash	kulit-katar
rat	laho
rate	taxa
rather	Di'ak liu
ratio	rasio
rational	rasional
raw	matak
re	ré
reach	alkanse
reached	to'o
reaction	Reasaun
read	lee
reading	lee
ready	prontu
real	reál
reality	realidade
realize	realiza
realized	persebe
really	tebes
rear	kotuk
reason	razaun
reasonable	razoável
recall	hanoin fila-fali
receipt	resibu
receive	simu
received	simu ona
recent	ohin
recently	foin dadauk
reception	resepsaun
recipe	reseita
reckless	la responsável
recognition	rekoñese
recognize	rekoñese
recommend	rekomenda
recommended	rekomendadu
record	rejistru
record	grava
recover	rekupera
recovery	rekupara
rectangle	rektangulu
red	mean
redeem	sosa fali
redemption	redensaun
reduce	redus
redundant	redundante
refer	refere
reference	referênsia
reflect	reflete
reflection	reflesaun
refrain	hadook an
refrigerator	jelera
refund	re-embolsu
refuse	rejeita
refused	Rekuza
regard	konsidera
regarding	relasaun ba
regardless	sein konsidera
regards	prémiu sira
region	rejiaun
register	rejistu
regret	arepende
regular	regulár
regularly	regularmente
reject	rejeita
relate	relasiona
related	relasiona
relationship	relasaun
relative	maluk
relatives	parente
relax	kalma
release	libera
release	lansamentu
released	husik
relevant	relevante
reliable	konfiável
relief	sente kmaan
relieve	hakmaan
relieved	sente-kmaan
religion	relijiaun
religious	relijozu
reluctant	dúvida
rely	depende
remain	hela nafatin
remaining	nafatin
remarkable	notavel
remedy	remediu
remember	lembra
remind	fo hanoin
reminder	lembrete
remote	remotu
remove	muda
render	rende
rent	aluga
repair	repara
repeat	repete
replace	troka
reply	responde
reply	resposta
report	relatóriu
report	relata
represent	reprezenta
reputation	reputasaun
request	husu
request	pedidu
require	presija
required	presija
rescue	resgata
research	peskiza
resemble	hanesan
resentment	resentimentu
reservation	rezervasaun
reserve	rezerva
resident	rezidente
resign	rezigna
resilience	reziliénsia
resilient	reziliente
resist	reziste
resistance	rezisténsia
resolution	rezolusaun
resolve	rezolve
resort	rezort
resources	rekursu
respect	kumprimentu
respect	respeita
respond	responde
response	responde
responsibility	responsabilidade
responsible	responsavél
rest	deskansa
rest	restu
rest in peace	deskansa iha paz
restaurant	restorante
restore	restaura
restrict	restrita
result	rezulta
results	rezultadu
resume	rezumu
retail	vareja
retain	hela ho
retention	retensaun
retired	reformadu
retreat	rekua
retrieve	bá buka
return	fila fali
reveal	revela
revealed	revela
revenge	vingánsa
revenue	reseita
reverse	fila
reverse	hakiduk
review	análize
review	reviza
revise	revizaun
revision	revizaun
revolution	revolusaun
reward	prémiu
rhythm	Ritmu
rib	kanosen
rice	etu
rich	riku
rid	halakon
ride	ba ho kareta
ride	sai
ridiculous	beik
right	los
right	liman los
right now	agora daudaun
rigid	ríjidu
ring	kadeli
rinse	hamoos
riot	runguranga
rip	nakless
rip	less
ripe	tasak
rise	hadeer
rise	aumenta
risk	risku
rival	rivalidade
river	mota
road	estrada
roast	lalar
robust	forte
rock	fatuk
rod	rota
role	knaar
roll	rolu
roof	uma leten
room	quartu
root	abut
rope	tali
rotten	dodok
rough	tarak
roughly	la ho kuidadu
round	rai
route	rota
routine	rutina
row	liña
rub	kose
rubber	boraixa
rubbish	lixu
rude	brutu
rude	malkriadu
rug	tapeti
ruin	at
rule	regra
ruler	régua
rules	regras
run	halai
running	halai
rural	rurál
rush	okupadu los
rush	halai
sack	karon
sacred	sagradu
sacrifice	sakrifisiu
safe	salva
safe flight	boa viajén
safety	seguridade
sage	matenek-na'in
said	dehan
sail	laan
sailing	navegasaun
sake	kauza
salary	saláriu
sale	faan
salmon	salmaun
salt	masin
same	hanesan
Same here	hanesan iha ne'e
sample	amostra
sand	rai-uut
Sanskrit	Sanskrit
sarcastic	sarkástiku
sassy	petulante
sat	tur
satisfaction	satisfasaun
satisfied	satisfeitu ona
satisfy	satisfas
satisfying	satisfeitu
Saturday	Sábadu
sausage	xurisu
savage	primitivu
save	salva
saw	hare ona
say	dehan
scale	eskala
scam	fraude
scar	fitar
scarce	arraska
scared	sente tauk
scarf	lensu
scary	ta'uk
scattered	naklekar
scene	sena
scenery	paizajen
scent	morin
schedule	oráriu
school	eskola
science	siênsia
scientist	sientista
scientists	sientista
scissors	tizoura
scold	sensura
scope	eskopu
score	pontua
scrap	baluk-oan
scratch	rakut
scream	hakilar
screen	ekran
screw	parafuzu
script	eskrita
sea	tasi
seal	taka
search	ba buka
season	tempu
seat	tur fatin
second	segundu
secret	segredu
section	seksaun
secure	seguru
security	seguransa
see	hare
see you	haree ita-boot
see you later	ate logo
see you soon	ate hasoru malu falu
see you tomorrow	hasoru malun fali aban
seed	fini
seek	ba buka
seem	haree
seems	haree hanesan
seen	haree
seize	prende
seizure	konfiska
seldom	raru
select	hili
self	an rasik
self healing	di'ak rasik
selfish	egoísta
sell	faan
send	enviadu
send me your picture	Haruka ita-boot nia foto mai hau
senior	seniór
sense	sentidu
sensible	sensível
sensitive	sensitivu
sent	manda ona
sentence	sentensa
sentences	sentensa
separate	haketak
Sepedi	Sepedi
september	setembru
sequence	sekuénsia
series	serie
serious	sériu
seriously	sériu tebes
serve	servi
service	servisu
session	sesaun
set	konjuntu
set	ordena
set up	konfigura
setting	senariu
settle	rezolve
seven	hitu
seventeen	sanulu resin hitu
seventy	hitu nulu
several	hirak
several	balun
severe	todan
sew	suku
sh	nonok
shade	fo-mahon
shadow	lalatak
shake	doko
shall	tenke
shallow	la kle'an
shame	moe
shape	forma
share	fahe
sharp	kro'at
she	nia (feto)
she has	nia iha
she is	nia maka (feto )
shed	baraka
sheep	bibi
sheet	hena taka
shelf	pratelleira
shell	pratelleira
shelter	uma-mahon
shield	eskudu
shift	tornu
shine	nabilan
ship	roo
shipping	remessa
shirt	kamizola
shoes	sapatu
shoot	tiru
shop	loja
shopping	kompras
shore	tasi-ibun
short	badak
shortage	falta
shot	tiru
should	tenke
shoulder	kabaas
shout	taka
show	aprezenta
show	eventu
show me	hatudu mai ha'u
shower	ba haris
shrimp	boek
shrink	hamenus
shut	taka
shut up	nonok ona
shy	moe
sibling	maun alin
sibling	bin alin
siblings	maun-alin
sick	moras
side	sorin
sigh	dada-iis
sight	vizaun
sightseeing	turizmu
sign	marka
signature	asinatura
significant	signifikadu
silence	silénsiu
silent	silensiu
silk	seda
silly	beik
silver	osan-mutin
similar	hanesan
simp	simploriu
simple	simples
simultaneously	tempu ne'ebé hanesan
since	desde
sincere	ho laran
sincerely	sinseru
sing	kanta
singer	kantór
single	mesak
sink	mout
sink	pia
Sir	Senhor
sister	alin feto
sister	mana
sister in law	kuñada
sit	tuur
site	sítiu
situation	situasaun
six	neen
sixteen	sanulu resin neen
sixty	neen nulu
size	tamañu
skill	abilidade
skills	abilidade
skin	kulit
skinny	isin-krekas
skip	hakat
skirt	saia badak
sky	lalehan
slave	eskravu
sleep	toba
sleeping	toba
sleepy	dukur
sleeve	faru-liman
slice	fatia
slide	namdoras
slightly	oituan
slim	lotuk
slip	kois
slope	rai-lolon
slot	kaleen-kuak
slow	neineik
slowly	ho neneik
small	kiik
smart	matenek
smell	horon
smile	hamnasa
smile	oin hamnasa
smoke	suar
smooth	kabeer
snack	merenda
snail	karakól
snake	samea
snap	foto
snow	neve
so	entaun
so cute	Furak
so far	até agora
soak	halo bokon
soap	sabaun
sober	ain-moos
soccer	futebol
social	sosiál
society	sosiedade
socks	meias
soft	mamar
software	programa komputador
software	software
soil	rai
sold	faan ona
sold out	fa'an hotu ona
soldier	Soldadu
sole	ain-tanen
solid	sólidu
solution	solusaun
solve	rezolve
some	balun
somebody	Ema ruma
somehow	oinsá deit
someone	ema ida
something	buat ida
sometimes	dalaruma
song	muzika
soon	lakleur
sophisticated	sofistikadu
Sorani	Sorani
sore	siin
sore	moras
sore throat	garganta moras
sorrow	tristeza
Sorry	Deskulpa
sort	tipu
sought	ema buka
soul	klamar
soulmate	alma zemea
sound	lian
soup	sopa
sour	siin
source	rekursu
south	sul
space	espasu
spam	korreiu-lixu
span	roha
Spanish	españa
spare	livre
spare	poupa
speak	ko'alia
special	espesial
species	espésies
specific	espesifiku
spectacular	espektakular
speech	diskursu
speechless	Liafuan laiha
speed	velosidade
spell	enkantu
spend	gasta
spent	gasta
spicy	manas
spike	tarak
spin	dulas
spinach	baiaun
spirit	espiritu
spit	tafui
splendid	kmanek
split	fahe
split	soe malu
spoil	estraga
spoiled	mana
spontaneous	espontaneu
spoon	kanuru
spot	pontu
spouse	kazal
spread	haluan
spread	divulga
spring	primavera
square	quadradu
squeeze	buti
squid	suntu
squirrel	eskilu
st	Estrada
stab	sona
stable	estável
stack	hada
staff	funsionáriu
stage	etapa
stain	noda
stairs	eskada
stake	estaka
stalk	kain
stalk	tuir subasubar
stall	kios
stamp	karimbu
stand	hamriik
stand	aguenta
standard	padraun
star	fitun
start	inisiu
started	hahu
starving	mate-hamlaha
state	estadu
state	deklara
statement	deklarasaun
station	estasaun
statue	estatua
status	estadu
stay	hela
stay	nafatin
stay safe	mantein seguru nafatin
steady	estável
steak	naan karau
steal	naok
steam	suar
steel	besik
steep	subida
steep	sa'e maka'as
stem	tronku
step	pasu
stick	ai-tonka
stiff	rins toos
still	hakmatek
still	nafatin
sting	ki'i
stingy	britas
stir	kahur
stock	estokue
stolen	hetan na'ok
stomach	kabun
stone	fatuk
stood	hamriik
stool	banku
stop	para
storage	garájen
store	loja
storm	tempestade
story	istoria
stove	fogaun
straight	loos
straight	direta
straightforward	direta
strain	tensaun
strange	estranju
stranger	ema fuik
strategy	estratejia
straw	kanudu
strawberry	morangu
streak	makerek
stream	mota kiik
street	estrada
strength	forsa
stress	estres
stretch	estika
strict	estritu
strike	baku
string	tali
strip	hamolik
strive	esforsu
stroke	golpe
strong	forte
struck	sokadu
structure	estrutura
struggle	luta
struggle	guerra
struggling	luta
stubborn	ulun toos
stuck	emperadu
student	estudante
study	estuda
study	estudu
studying	estuda
stuff	buat
stunning	esplêndidu
stupid	beik
style	estilu
subject	sujeitu
submission	submisaun
submit	submete
substance	substánsia
substitute	sasesuk
subtle	finu
succeed	susesu
success	susesu
successful	susesu
such	hanesan
such as	hanesan
suck	hakmumu
sudden	derrepente
suddenly	derepenti
suffer	sofre
suffering	sofrimentu
sufficient	sufisiente
sugar	masin-midar
suggest	sujere
suggestion	sujestaun
suit	faru-boot
suit	pedidu
suitable	adekuadu
suitcase	mala
sum	soma
summary	rezumu
summer	tempu manas
summit	Simeira
sun	sol
sunday	domingu
sunny	loro-naroman
sunset	loro matan monu
sunshine	loro-naroman
super	súper
superior	superior
superior	leten
supervisor	supervizor
supper	han-kalan
supply	fornesementu
supply	fornese
support	suporta
support	apoiu
suppose	loloos ne'e
supposed	supostu
sure	klaru
surface	superfísie
surge	bubu sa'e
surgery	sirurjia
surname	naran apelidu
surprise	surpreza
surprised	hakfodak
surrender	rende
surrounding	haleu
surveillance	vijilansia
survey	ezame
survey	peskiza
survive	sobrevive
suspect	suspeita
suspect	suspeitu
suspended	suspensu
suspicious	suspeitu
sustain	sustein
sustainability	sustentabilidade
sustainable	sustentavel
swag	sasan na'ok
swallow	tolan
swap	troka
swear	promete
sweat	midar
sweater	faru-manas
sweep	dasa
sweet	midar
sweet dreams	mehi-furak
sweet tooth	nihan midar
sweetheart	a
sweetheart	keridu
swell	bubu
swelling	bubu
swim	nani
swimming	natasaun
swing	balansu
swing	balansa
switch	troka
switch	taka
swollen	bubu
sword	surik
sword	espada
symbol	Simbolu
sympathy	simpatia
symptoms	simtoma
system	sistema
table	meza
tackle	enfrenta
tag	marka
tag	etiketa
tail	ikun
take	simu
take away	foti sai
take care	kuidadu
take off	loke
taken	foti
talk	ko'alia
talk	lia
talkative	ko'alia barak
tall	aas
tap	dere
tape	fita
target	planu
target	alvu
task	tarefa
taste	gostu
taste	koko
tasty	gostu
taught	hanorin ona
tea	xá
teach	hanorin
teacher	e
teacher	profesora
team	ekipa
tear	les
tears	matan-been
tease	goza
technology	teknolojia
teeth	nihan
tell	hatete
tell me	hatete mai hau
temper	temperu
temperature	temperatura
temple	templu
temporary	temporáriu
ten	sanulu
ten thousand	rihun sanulu
tenant	inklinu
tend	hali'is
tendency	tendensia
tender	aprovizionamentu
tense	manas
tension	tensaun
tent	tenda
tentative	tentativa
term	termu
terms	termu
terrible	aat
terrific	di'ak liu
territory	teritóriu
test	koko
Tetum	Tetun
text	testu
than	duke
thank	obrigada
thank you	obrigado
Thank you for your patience while we investigate shipment	Obrigado ba Ita-boot nia pasiénsia enkuantu ami investiga aremesa ida-ne'e
thank you so much	obrigado barak
thank you very much	obrigado barak
thanks	obrigado
Thanks for using our app	obrigadu tanba uza ona ami nia aplikativu
that	iha ne'ebá
that is	ne'e mak
that's good	ne'e di'ak
the	artigu definidu ne'e
theft	na'ok-teen
their	sira nian
them	sira
theme	tema
themselves	sira-nia an rasik
then	depoide
theory	teoria
there	iha ne'ebé
there are	iha
there is	iha ne'ebá
therefore	tanba ne'e
these	sira ne'e
they	sira
they are	sira maka
thick	mahar
thief	na'ok-ten
thigh	kelen
thin	lotuk
thin	mihis
thing	buat
things	buat sira
think	hanoin
third	datoluk
thirsty	hamrook
thirteen	sanulu resin tolu
thirty	tolu-nulu
this	ida ne'e
this is	ida ne'e
thorough	halo didi'ak
thoroughly	didi'ak
those	sira ne'ebá
though	maski
thought	liu
thoughtful	neon-na'in
thoughts	pesamentu
thoughts	hanoin
thousand	rihun ida
thread	fiu
threat	ameasa
threaten	ameasa
three	tolu
threshold	limite
thrilled	kontente-tebes
thrive	buras
throat	kakorok
through	liuhosi
throughout	tomak
throw	soe ona
thumb	liman-fuan boot
thunder	rai-tarutu
Thursday	Kinta-feira
thus	entaun
tick	markasaun
tide	meti
tidy	ordenadu
tie	lasu
tie	kesi
tiger	Tigri
tight	metin
Tigrinya	Tigrinya
time	oras
timid	ta'uk-teen
tiny	kiikoan
tip	ponta
tips	dikas
tire	roda
tired	kolen
tissue	suratahan tisu
title	titulu
to	ba
to be	atu sai
toast	lalar
toast	tunu
today	ohin loron
toddler	bebe foin la'o
toes	ain-fuan
together	hamutuk
toilet	hariis fatin
told	hateten
tolerance	toleransia
tolerate	tolera
tomato	tomate
tomorrow	aban
tongue	nanal
tonight	ohin-kalan
too	mós
took	foti ona
tool	ferramenta
tools	ferramenta
tooth	nehan
top	tutun
topic	tópiku
torn	lees
torture	tortura
total	totál
touch	kaer
tough	forte
tour	eskursaun
toward	hasoru
towards	hasoru
towel	toalla
town	sidade
toxic	tóxiku
trace	trasu
track	lokaliza
trade	troka
trade	komérsiu
tradition	tradisaun
traditional	tradisionál
traffic	tráfiku
trail	ain-fatin
train	treinu
training	treinamentu
trait	karakteristika
traits	karakteristika
transfer	transfere
transition	tranzisaun
translate	tradús
transparent	tranparente
transport	Transporte
transportation	transportasaun
trap	lasu
trash	lixu
trauma	trauma
travel	viajen
tray	bandeja
treasure	tezouru
treat	trata
treatment	tratamentu
tree	ai
tremendous	kapás
trend	tendénsia
trial	julgamentu
trick	lia-bobar
trick	finta
tried	koko
trigger	inisiu
trigger	gatillu
trim	tesi
trip	viajen
trouble	problema
trousers	kalsa
truck	kamiaun
true	lia-loos
true	loos
trunk	tronku ai
trust	fiar
trust	konfiansa
truth	verdade
try	koko
Tsonga	Tsonga
tube	tubu
Tuesday	Tersa
tuition	osan-eskola
turkey	peru
turmeric	kinur
turn	kedok
turtle	lenuk
tutor	mestre
twelve	sanulu-resin rua
twenty	rua-nulu
twenty-one	rua nulu resin ida
Twi	rua
twice	dalarua
twist	dulas
two	rua
type	tipu
typical	típiku
ugly	oin aat
ultimate	ikus liu hotu
umbrella	sumbrina
unable	labele
uncle	apa ki''ik
uncle	apa boot
uncle	Tiu
unconscious	mate ki'ik
under	iha okos
underneath	iha okos
underrated	ladun fo valor
understand	komprende
understood	komprende
unfortunately	infelizmente
uniform	uniforme
unique	úniku
unit	unidade
university	universidade
unknown	deskonese
unless	se lae
until	to'o
unusual	la normál
up	leten
up to you	depende ita-boot
update	atualiza
update	atualizasaun
upgrade	hadi'ak
upon	iha
upset	laran moras
urban	rural
urge	urjente
urge	enkoraja
urgent	urjenti
us	ami
use	uza
used	uzadu
useful	útil
useless	util
usual	baibain
usually	baibain
utility	utilidade
vacation	ba féria
vaccination	Vasinasaun
vaccine	vasina
vacuum	supa rai rahun
vague	la klaru
valid	validu
valley	foho-leet
valuable	valór boot
value	avalia
value	valór
variety	variedade
various	variedade
vary	varia
vase	vazu
vast	boot
vegetable	modo
vegetables	modo
vehicle	veíkulu
vendor	faan na'in
venom	veneno
venture	emprendimentu
venue	lokál
verify	verifika
versatile	versatil
version	versaun
vertical	vertikal
very	tebes
very good	di'ak los
vessel	ró
via	liu husi
vibe	vibrasaun
vibes	vibrasaun
vicious	vísiu
victim	vítima
video	vidio
view	vizaun
village	aldeia
villain	bandidu
villain	ema aat
vinegar	tua-siin
vintage	buat-foun
violence	violénsia
violent	violentu
viral	virál
virgin	virjen
virtual	virtuál
virtue	virtude
vision	vizaun
visit	vizitasaun
visit	vizita
visual	vizual
vital	vitál
vivid	kapas
vivid	lakan
vocabulary	vokabuláriu
voice	Lian
void	fatin mamuk
volume	volume
volunteer	voluntáriu
vomit	muta
vulnerable	vulneravél
wage	salariu
wages	salariu
waist	kanotak
wait	hein
waiter	servente
waiting	hein
wake	hadeer
wake up	hadeer
walk	la'o
walk	andar
walking	Lao
wall	ninin
wallet	karteira
wander	bilibala
wanna	hakarak atu
want	hakarak
wanted	hakarak
war	funu
wardrobe	almari
warehouse	garájen
warm	hamanas
warm	manas
warn	alerta
warning	alerta
warrior	asuwa'in
was	uluk ne'e
wash	fase
waste	foer
waste	ba soe
watch	tau-matan
water	bee
watermelon	pateka
wave	onda
way	dalan
we	ami
we are	ami maka
we can	ita bele
weak	fraku
weakness	fraku
wealth	riku
wealthy	riku
wear	hatais
wearing	uza
wearing	hatasi
weather	klima
wedding	kazamentu
Wednesday	Kuarta
weed	duut
week	semana
weekend	finál de semana
weight	todan
weight	fó todan
weird	estrañu
welcome	benvindo
welfare	di'ak
Well	Di'ak
well done	di'ak tebes
went	ba ona
were	ne'ebé
west	weste
wet	bokon
whale	baleia
what	Saida
what about you	Oinsá ho ita-boot
what are you doing	Ita-boot halo saida
what are you doing now	agora o halo sa'ida
what are you doing right now	agora daudauk ita-boot halo saida
what do you do	saida maka ita-boot halo
what do you do for a living	saida maka ita-boot halo hodi moris
what do you mean	sa'ida mak o nia hanoin
what do you want	saida maka ita-boot hakarak
what happened	sa'ida mak mosu
what is	saida
what is this	saida maka ne'e
what is your job	ita-boot nia servisu saida
what is your name	ita-boot nia naran saida
what's up	di'ak ka lae
what's your name	ita-boot nia naran saida
whatever	saida deit
wheat	trigu
wheel	roda
when	bainhira
whenever	bainhira deit
where	iha ne'ebé
where are you	o iha ne'ebé
where are you from	o husi ne'ebé
where are you now	o iha ne'ebé
where do you live	ita-boot hela iha ne'ebé
where is	iha ne'ebe
whereas	enkuantu
whether	sé
whether	karik
which	ida ne'ebé
while	enkuantu
while	bainhira
whisper	bis-bisi
whistle	hakfuik
white	mutin
who	Sé
who are you	o ne'e sé
who is	se mak
who is this	sé maka ne'e
whole	tomak
whom	sé
whose	sé nian
why	tanba sá
why not	tanbasa lae
wicked	kruél
wide	luan
widow	faluk
width	belar
wife	ferik-oan
wild	fuik
will	sei
willing	hakarak
win	manaan
wind	anin
window	janela
windy	anin
wine	tintu
winter	invernu
wipe	hamoos
wire	fiu
wisdom	prudênsia
wise	prudente
wish	espera
wish	hakarak
wish you all the best	dejezu di'ak ba imi hotu
witch	feitiseira
with	ho
withdraw	dada an
withdrawal	dada
within	iha laran
without	sein
witness	testemuña
witness	sasin
witty	neon-lais
wolf	asu-fuik
woman	feto
women	feto sira
won	manan
won't	sei la
wonder	hanoin
wonderful	magnífiku
wood	ai
wool	bibi-fulun
word	lia-fuan
words	liafuan sira
work	servisu
work	traballu
work out	ezersisiu fíziku
working	servisu
world	mundu
worm	lombriga
worn	uzadu
worried	hanoin boot
worry	preokupa
worse	aat
worship	adora
worst	aat liu
worth	valór
worth it	ne'e folin iha
worthy	merese
worthy	serve
would	sei
wound	kanek
Wow	Eipa
wrap	falun
wrath	hirus
wrist	pulsu liman
write	hakerek
Write here	hakerek iha ne'e
writing	hakerek
written	eskrita
wrong	sala
wrote	Hakerel
yard	uma huun
yawn	maas
Yeah	Sin
year	tinan
years	tinan
yeast	fermentu
yell	hakilar
yellow	kinur
Yes	Sin
yes baby	sim doben
yes dear	sim keridu
yes honey	sin amor
yes my love	sin, ha'u nia amor
yes of course	sim konserteza
yesterday	horiseik
yet	seidauk
yield	produsaun
you	Ita-boot
you are	o
you are beautiful	ó bonita
you are so beautiful	Ita-boot bonita los
you are welcome	nada
you are welcome	ita-boot benvindu
you can	o bele
You know	Ita hatene
you too	ita-boot mós
you're welcome	nada
young	nurak
your	o nian
your	ita-boot nian
your welcome	ita-boot bemvindu
yourself	ita-boot nia an
youth	jóven
you’re welcome	ita-boot benvindu
yummy	gostu
zero	mamuk
