a little	hin gutiay
a lot	damo
a lot of	hin damo nga
abandon	pagbaya
abandoned	binayaan
abide	pagsunod
ability	abilidad
able	makakahimo
about	mga
about	hi-onong
above	ha igbaw
absence	kawara
absent	waray didto
absolutely	gud
absorb	pagsupsop
abstract	diri matin-aw
absurd	waray pulos
abundance	kadamu
abundant	hura
abuse	abusoha
abuse	abuso
accent	tono
accept	karawata
access	makasulod
access	sudla
accident	aksidente
accommodation	pag ukoy
accomplish	nahimo
accomplished	nahimo
accomplished	nahuman
according	sumala
accuracy	pagkahusto
accurate	husto
accurate	iksakto
accused	akusado
ache	ul-ol
ache	paul-oli
achieve	makab-ot
achievement	malapuson
acknowledge	pagkarawat
acquaintance	kakilala
acquire	pag angkon
acquired	nakuha
acquisition	pagpalit
across	ha luyo
act	buhat
action	aksyon
active	aktibo
activities	mg buruhaton
activity	aktibidad
actor	artista
actual	tinuod
actually	ha pagkamatuod
actually	tinuod
acute	duro
adapt	mapahiuyon
add	pagdugang
addicted	adik
addition	pagdugang
additional	dugang
address	adrese
address	adres
adequate	igo
adjacent	kasapit
adjacent	luyo
adjective	adhetibo
adjust	pag adjust
admire	pagdayaw
admit	magpadayag
adopt	susubaron
adorable	makaruruyag
advance	pag uswag
advance	pauswaga
advanced	pag uswag
advantage	bentaha
adventure	panghitabo
adverb	adberyo
advertisement	pasamwak
advertising	pagpasamwak
advice	sagdon
advise	sagdon
advocate	parasuporta
advocate	suportahi
aesthetic	estetika
affair	buruhaton
affect	nakakaapekto
affection	paghigugma
afford	makabayad
affordable	barato
afraid	nahadlok
after	katapos
afternoon	kulop
afterwards	katapos
again	ngahaw
again	daman
again	utro
against	kontra
age	edad
agency	ahensya
agent	ahente
aggressive	agresibo
agile	malaksi
ago	naglabay
agree	nauyon
agreement	kasabotan
agriculture	agrikultura
ahead	unahan
aid	bulig
aim	tuyo
air	hangin
airport	paluparan
aisle	agianan
alarm	alarma
alcohol	alkohol
alert	alerto
alive	buhi
all	ngatanan
all right	maopya ngatanan
all the best	an ngatanan nga gimaopayi
allow	tugoti
allowed	gintugotan
almost	haros
alone	nag uusaan
along	upod
already	human na
Alright	Sige
Alright	Hala gad
also	liwat
also	ngan
alternative	alternatibo
although	bisan kon
always	pirme
am	ako
amazing	urusahon
ambiguous	diri klaro
ambition	ambisyon
ambitious	ambisyoso
amend	pagbag-o
amid	ha butnga
among	ha butnga
among us	ha aton
amount	kantidad
amusing	makatatawa
an	an
analysis	pag usisa
ancestors	mga kaapoy-apoyan
anchor	angkla
ancient	kadaan
and	ngan
and you	ngan ikaw
angel	anghel
anger	kasina
angle	anggulo
angry	masina
animal	hayop
ankle	mukongbukong
anniversary	anibersaryo
announcement	pagpahibaro
annoy	naaringit
annoyed	nasisina
annoying	nakaka insulto
annoying	makaaaringit
annual	tinuig
anonymous	waray ngaran
another	iba pa
answer	baton
answer	batona
anticipate	naglalaom
anxiety	kabaraka
anxious	mabidoon
any	bisan ano
anymore	waray na
anyone	bisan hin-o
anything	bisan ano
anyway	bisan pa
anyways	bisan pa
apart	nagbulag
apologize	pangaro hin pasaylo
apparent	makikita
apparently	baga hin
appeal	pag apela
appear	magpakita
appearance	hitsura
appeared	inulpot
appeared	nagpakita
appetite	gana
apple	mansanas
application	aplikasyon
apply	aplikar
appointment	pagtudlok
appreciate	pasalamat
appreciation	pagpapasalamat
approach	duoki
approach	duok
appropriate	angayan
approval	pagtugot
approve	pag aprobar
approved	pag uyon
approximately	haros
april	abril
arbitrary	surundon
architect	arkitekto
architecture	arkitektura
archive	koleksyon
are	mga
are you	ikaw ba
are you busy	sagipo ka ba
are you married	inasaw-an ka
are you married or single	may ada ka ba asawa o waray
Are you still there?	Aadto pa ba kamo
are you there	aada ka
area	lugar
argue	paghibaton
argue	mag away
argument	away
arise	pagbangon
arm	kamot
army	kasundalohan
around	harani
around	palibot
around	dida la
arrange	naghihikay
arrangement	kahikayan
arrival	pag abot
arrive	umabot
arrived	inabot
arrogant	arogante
arrow	pana
art	arte
article	artikulo
artificial	artipisyal
artist	artista
as	nga
as long as	tubtob nga
as long as	basta la
as well	sugad man
as well as	sugad man
ash	abo
ashamed	naawod
ask	pakiana
asked	ginapakianhan
asleep	nakaturog
aspect	bahin
assault	pag atake
assembly	pagtirok
assertive	agresibo
assess	pag usisa
assessment	pagtagad
asset	panag-iya
assets	panag-iya
assign	ighatag
assignment	toka
assist	pagbulig
assistant	kabulig
associate	kaupod
associated	maykalabotan
association	asosasyon
assume	paghunahuna
assumption	paghunahuna
at	ha
at least	ha pinakaminos
ate	kinaon
athlete	atleta
attach	iginlakip
attached	iginlakip
attachment	paglakip
attack	atake
attempt	pagsulay
attempt	pagsulayi
attend	pag-ataman
attend	pagtambong
attendance	pagtambong
attention	atensyon
attitude	batasan
attitude	kinaiya
attract	pagdani
attraction	pagdani
attractive	maanyag
attribute	kalidad
audience	mamarati
audience	magkurulaw
august	agosto
aunt	dada
aunty	dada
authentic	tinuod
author	manunurat
authority	awtoridad
autumn	katlaya
available	may ada
available	mayda
average	aberids
avoid	likayan
awake	pagmata
award	premyo
aware	maaram
awareness	paghibaro
away	pahirayo
awesome	urusahon
awful	makaharadlok
awkward	nakakainsulto
baby	bata
bachelor	ulitawo
bachelor	waray asawa
back	balik
background	gintikangan
bad	maraot
bad	dunot
bag	bag
bait	paon
bake	pagluto
bakery	panaderya
balance	balanseha
balance	balanse
ball	bola
banana	saging
band	banda
bang	pagbuto
bank	bangko
barely	danay la
bargain	barato
bark	panit
bark	paniti
barley	sebada
barrier	ulang
base	basado
based	base
basic	importante
basically	ungod gud
basically	basihan
basil	basil
bastard	bastardo
batch	grupo
bath	karigoan
bathroom	banyo
battery	baterya
battle	pakiggirra
be	magin
be careful	paghirot
beach	baybayon
beam	sanag
beans	mga liso
bear	pag antos
bear	pag antosa
beard	bungot
bearing	nagsasangyaw
beast	hayop
beat	pagkastigo
beat	kastigoha
beautiful	mahusay
beautiful	husay
beauty	husay
became	nagin
because	tungod kay
become	nagin
bed	kama
bed	kuwarto
bed	higdaan
bedroom	kwarto
bee	putyukan
beef	karne hin baka
been	ginhimo
beer	serbisa
before	antes
began	nagtikang
begin	magtikang
beginning	gintikangan
behalf	para ha
behave	paggawi
behavior	panggawi
behavior	kinaiya
behaviour	panggawi
behind	hinbabayaan
behind	luyo
being	pagkaada
belief	pagtoo
believe	tumoo
belly	tiyan
belong	kaapi
beloved	hinigugma
below	ubos
belt	paha
bench	bangko
bend	yumokbo
beneath	ubos
beneath	ilarom
benefit	benipisyo
benefits	mga benepisyo
beside	sapit
besides	gawas
best	pinakamaopay
best of luck	maupay nga kapalaran
best regards	gimaopayi nga pangumusta
better	mas maopay
between	butnga han
beverage	irinmon
beyond	lampos
bias	pag ugop
biased	may dinadapigan
bicycle	bisikleta
bid	hangyo
big	daku
bike	bisikleta
bill	baraydan
bind	pagbugkos
bird	tamsi
birthday	kompleanyo
bit	gutiay
bite	tukbon
bite	tukob
bitter	mapait
black	itom
blade	tarum
blame	pagbasol
blame	pagbasola
blank	blangko
blanket	taklap
blast	pagbuto
bleach	pagpapus-aw
blend	timpla
bless	bendisyonan
blessed	ginbendisyonan
blind	buta
bliss	kalipay
block	bloke
blood	dugo
bloom	bukad
blow	pag huyop
blow	pag awas
blue	asul
blunt	prangka
board	tabla
boat	baluto
body	lawas
boil	pakaladkari
bold	madasigon
bond	pakigsangkay
bone	tul-an
book	gin-book
boost	pagpauswag
boost	pauswaga
booster	pagpauswag
boot	botas
boots	botas
border	giutan
bore	makauuyam
bored	nauuyam
boring	makauuyam
born	natawo
borrow	huram
boss	amo
boss	agaron
both	pareho
bother	nakasamok
bottle	botelya
bottom	ubos
bottom	ilarom
bought	ginpalit
bounce	inuntol
bound	nakagapos
bound	ginhigutan
boundaries	mga tubtoban
bow	pagyukbo
bow	pana
bowl	mangkok
box	kahon
boy	bata
boyfriend	sangkay nga lalaki
boyfriend	uyab
bracelet	purseras
brain	utok
branch	sanga
brave	maisugon
breach	pagtalapas
bread	tinapay
break	pagpahuway
break	pahuway
breakfast	pamahaw
breast	suso
breath	pagginhawa
breathe	pagginhawa
breed	lahi
brick	baldosa
bride	maarasawa nga babaye
bridge	tulay
brief	halipot
bright	maaram
bright	malamrag
brilliant	maranggat
bring	dad-a
bring	dara
broad	haluag
broadcast	pagbrodkast
broke	nabungkag
broken	nabungkag
broom	silhig
brother	bugto nga lalaki
brother in law	bayaw
brought	gindara
brown	bulaw
bucket	blade
buddy	sangkay
budget	badyet
bug	sudlot
bug	kulisap
build	pagtukod
built	ginhimo
bulk	kadak-an
bull	baka
bully	maraugdaog
bump	pagbangga
bunch	bugkos
bundle	bugkos
burden	bug-ati
burden	bug-at
buried	ginlubong
burn	pagkasunog
burst	bukwag
bury	paglubong
bus	bus
bush	kagurangan
business	negosyo
bust	pagbulag
busy	okupado
but	kondi
butter	mantikilya
butterfly	alibangbang
button	butones
buy	pagpalit
by	nga
by the way	ha pagkamatuod
cabbage	repolyo
cabinet	kabinet
cage	prisohan
calf	baka
call	tawag
call	tawaga
call me	tawagi ako
called	gintawag
calm	kalmado
came	inabot
campaign	kampanya
can	mahimo
can	himoa
can't	diri makakahimo
Cancel	pagkansela
cancer	kanser
capable	may kapas
capacity	kapasidad
capital	kapital
caption	kapsyon
capture	pagkadakop
car	awto
career	karera
careful	paghirot
carefully	pagi kmat
careless	kawaray pagtagad
caring	pagmangno
carpenter	panday
carpet	karpet
carrot	karot
carry	pagdara
carry on	padayon
carry out	pagbuhat
case	kaso
cash	salapi
cast	pagripa
castle	kastilyo
casual	kasuwal
cat	misay
catch	pagdakop
category	kategorya
cattle	bakahan
cattle	baka
caught	nadakop
cause	pahinungdi
cause	hinungdan
caution	pagbantay
cautious	mabinantayon
cave	lungib
cease	paghunong
ceiling	kisame
celebrate	selebrar
cell	selula
center	sentro
century	siglo
cereal	lugas
ceremony	seremonya
certain	sigurado
certainly	Syempre
certainly	sigurado
certificate	sertipiko
chain	kadena
chair	lingkoranan
challenge	pag ayata
challenge	pag ayat
chance	higayon
change	ibaha
change	pagbag-o
chaos	kasamok
character	kinaiya
characteristics	mga kinaiya
charge	bayad
charity	ayuda
charming	makaruruyag
chart	tsart
chase	paglanat
chat	pakiistoryahi
chat	pakiistorya
cheap	barato
cheat	paglimbong
cheating	paglimbong
check	usisa
check	usisaha
cheek	bayhon
cheer	paglipay
cheerful	malipayon
cheers	paglipay
cheese	keso
chemistry	kimika
cherish	pinaura
chest	dughan
chew	kisamon
chicken	manok
chief	punoan
child	bata
childhood	pagkabata
children	kabataan
chill	kalma
chill	kalmaha
chill	ginkalma
chimneys	tsimniya
chin	sulang
chocolate	tsokolate
choice	pagpili
choose	pagpili
chop	pagpulod
chores	mga buruhaton
chubby	tambok
church	singbahan
cinnamon	sinamon
circle	lidong
circumstances	mga kahimtang
citizen	pagkatuminungnong
city	syudad
claim	pag angkon
claim	angkona
clarify	pagsaysay
class	klase
clay	lapok
clean	limpyo
clear	linawa
clear	malinaw
clerk	klerk
clever	maabtik
client	kliyente
cliff	pangpang
climate	klema
climb	sagka
clingy	makapot
clock	relo
close	harani
closet	aparador
closet	kabinet
cloth	panapton
cloth	bado
clothes	mga panapton
clothes	mga bado
cloud	dampog
cloudy	masirom
clown	bantay kibot
clue	tigaman
clumsy	kimas
cluster	urapong
coach	igtutdo
coach	paragtutdo
coal	uring
coast	baybayon
coat	panapton
coffee	kape
cognitive	kognitibo
coincidence	pagkaurusa
cold	matugnaw
collapse	marumpag
collar	kwelyo
colleague	sangkay
colleagues	mga kasangkayan
collect	pagkolekta
collection	koleksyon
college	kolehiyo
color	kolor
colorless green ideas slept furiously	an waray kolor nga berde nga mga ideya nahingaturog nga aringit gud.
colour	kolor
column	kolum
comb	sudlay
combination	kombinasyon
combine	pagtirok
come	kadi
come here	kadi
come on	kadi gowa
comfort	kaliawan
comfortable	komportable
coming	naabot
coming	tikang
coming soon	maabot dayon
command	ginsugo
comment	komento
commercial	komersyal
commission	komisyon
commit	pagkompromiso
commitment	pagkompromiso
committed	gintutuman
commodity	pamaligya
common	komon
communicate	komunikasyon
communication	komunikasyon
community	komunidad
commute	pagbiyahe
companion	kaupod
company	kompanya
compare	itanding
comparison	pagtanding
compassion	kalooy
compassionate	mapinairon
compatible	nauyon
compete	kompetisyon
competent	may kapas
competition	kompetisyon
competitive	makumpitensya
complain	nagreklamo
complaint	reklamo
complement	komplemento
complement	igkomplemento
complete	kompleto
completely	bug-os
complex	komplikado
compliance	pagsunod
complicated	komplikado
compliment	pagdayaw
comply	pagtuman
composition	komposisyon
compound	kombinasyon
comprehension	pagsabot
comprehensive	kompleto
compromise	igkompromiso
compromise	kompromiso
compulsory	ngatanan
compulsory	obligado
computer	kompyuter
concentrate	konsentrasyon
concept	konsepto
concern	paghunahunaa
concern	paghunahuna
concerned	may kalabotan
concert	konsyerto
conclusion	konklusyon
concrete	semento
concrete	sementoha
concrete	ginsemento
condition	kahimtang
conditions	mga kondisyon
conduct	paggawi
conference	komperensya
confess	magkompisal
confidence	kompyansa
confident	nasarig
confirm	kumpirma
conflict	away
confused	nalilisang
confusion	kasamok
congratulation	pagdayaw
congratulations	mga pahalipay
conjunction	panugtong
connect	pagkonektar
conquer	magdaog
conscious	konsensya
consciousness	pamurobuot
consent	pagtugot
consent	tugoti
consequences	mga resulta
conservation	pagtipig
conservative	konserbatibo
consider	hunahunaa
consider	kulawi
consider	kitaa
considered	ginhunahuna
consist	nagsusulod
consistency	pagkaurosa
consistent	paripareho
constant	pirme
constantly	pirme
constipation	konstipasyon
construction	pagtukod
consume	pagkonsumo
consumption	pagkonsumo
contact	kontaka
contact	kontak
contagious	nakakatapon
contain	nagsusulod
contains	nagsusulod
contemporary	mederno
contempt	pagtamay
content	sulod
contest	kompetisyon
context	konteksto
continent	kontinente
continue	padayon
contract	kontrata
contract	ikontrata
contrast	ibaha
contrast	kaibahan
contribute	pag amot
contribution	kontribusyon
control	pagkontrol
controversial	kontrobersyal
convenience	kaopayan
convenient	magin masayon
conversation	pakiistorya
convert	pagbalhini
convert	pagbalhin
convey	igpapasabot
convince	makombinse
convinced	nakombinse
cook	pagluto
cook	pagluto-a
cooking	pagluto
cool	mauroupay
cool	giuupayi
cooperation	kooperasyon
cope	paga tubang
copper	tumbaga
core	butnga
corn	mais
corner	kanto
corner	surok
correct	husto
cost	kantidad
cost	kantidari
costume	panapton
cottage	balay
cottage	malaybalay
cotton	gapas
couch	higdaan
cough	pag ubo
could	mahimo
could	pwede
council	konseho
count	pag ihap
counter	ginbaton
country	nasud
countryside	kaumhan
couple	mag-asawa
courage	kaisog
course	kurso
course	gin-aagian
court	korte
courtesy	pagpakita hin kaanyag
cousin	patod
cover	tabon
cover	putos
cow	baka
coward	matalaw
cozy	komportable
crab	masag
crack	natipak
crack	tipaka
craft	mga barko
crap	uru
crash	ighulog
crash	nahulog
craving	paghingyap
crawl	pagkamang
crazy	lurong
create	maghimo
creative	mamugnaon
credit	kredito
creep	nagkakamang
creepy	makaharadlok
crew	mga tripulante
crime	krimen
cringe	kuroga
cringe	kinurog
crisis	krisis
criteria	suruklan
critical	kritikal
criticism	pakaraot
crop	pananom
crops	mga tanom
cross	pagtabok
cross	taboka
crow	uwak
crowd	kadam-an
crowded	puno hin tawo
crown	korona
crucial	importante
cruel	madarahog
cruise	paglalayag
crush	bungkaga
crush	nabungkag
cry	nagtatangis
cucumber	pepino
cuddle	paghangkop
culture	kultura
cunning	malimbong
cup	tasa
cupboard	aparador
curb	pagpugong
cure	tambal
cure	tambala
curiosity	pagkamausisa
curious	interesado
curly	kurong
currency	kwarta
currency	salapi
current	yana
currently	yana
curse	sumpa
curtain	kurtina
cushion	ulonan
custom	kustom
customer	kustomer
customs	mga kustomre
cut	pag utod
cut	utda
cute	makangurudyot
cute	matahom
cycle	siklo
cycling	pagbisikleta
dad	tatay
daddy	amay
daddy	tatay
daily	inadlaw
dairy	gatas
dam	dam
damage	daota
damage	daot
damn	magningaraot
damp	alisngaw
dance	sayaw
danger	peligro
dangerous	peligroso
dark	masirom
darling	hinigugma
dash	bagis
data	datos
date	kirigta
date	petsa
daughter	anak nga babaye
day	adlaw
dead	patay
deadline	itinanda
deaf	bungol
deal	pagtratara
deal	pagtratar
dear	hinigugma
Dear All	Minahal  nga mga tawo
Dear Customer	Hinigugma nga Kustomer
Dear Parents	Hingugma nga mga Kag-anak
Dear Sir	Hinigugma nga Ginoo
Dear students	Hinigugma  nga mga estudyante
Dear Team	Hinigugma nga Grupo
death	kamatayon
debate	debate
debit	utang
debris	mga guba
debt	utang
decade	dekada
decay	pagkadunot
deceased	namatay
deceive	paglimbong
december	disyembre
decent	maopay
decide	magdesisyon
decided	nagdesisyon
decision	desisyon
deck	kubyerta
decline	pag ubos
decrease	pag iban
dedicated	dedikado
dedication	dedikasyon
deed	ginbuhat
deep	hilarom
deer	bugsok
default	kawaray
defeat	pirde
defeat	napirde
defend	panalipdan
define	naghahatag kahulogan
definitely	sigurado
definition	kahulugan
degree	grado
delay	paglangana
delay	paglangan
delayed	paglangan
delete	pagpara
deliberate	tinuyo
delicate	delikado
delicious	matam-is
delight	kalipay
delighted	nalilipay
deliver	paghatod
delivered	pagtalwas
delivery	paghatud
demand	kinahanglana
demand	panginahanglan
demanding	nagkinahanglan
democracy	demokrasya
demon	demonyo
demonstrate	ipakita
denied	ginsalikway
density	kasuok
dentist	dentista
deny	pagdumiri
department	departamento
departure	pagbaya
depend	madepende
deploy	pakadto-a
deposit	ideposito
deposit	deposito
depressed	nasusubo
depression	depresyon
depth	kahiladman
describe	paghulagway
description	paghulagway
desert	disyerto
deserve	angay
design	disenyo
design	pagdisenyo
designation	designasyon
desire	hingyapa
desire	hingyap
desk	lamesa
despair	kawad-i hin paglaom
desperate	desperado
despite	bisan pa
dessert	matam-is
destination	destinasyon
destiny	kapalaran
destroy	pagbungkag
destruction	kabungkagan
detail	detalye
details	detalye
detect	inabat
detect	mahibaroan
determination	determinasyon
determine	pagtino
determined	determinado
devastated	nadaot
develop	pagpauswag
developed	nag uswag
development	pag uswag
device	aparato
devil	demonyo
devil	yawa
devoted	debosyon
diarrhea	pagtatae
diarrhea	pag urouro
diary	dayari
dictionary	diskyonaryu
did	ginhimo
die	mamatay
died	namatay
diet	pagkaon
difference	kalainan
different	iba
difficult	makuri
dig	pag ukad
dignity	dignidad
diligent	maduruto
dinner	pangiklop
dip	itunlob
direct	direkta
direction	direksyon
director	direktor
dirt	hugaw
dirty	mahugaw
disable	baldado
disabled	baldado
disappear	pagkawara
disappointed	nasusubo
disaster	kalamidad
discard	iginlabog
discharge	gin gawas
discipline	disiplina
discount	diskwento
discover	hibaro
discrimination	diskriminasyon
discuss	paghisgot
discussion	paghisgot
disease	sakit
diseases	mga sakit
disguise	pagpakunokuno
disgusting	makasisina
dish	pagkaon
dishes	mga pagkaon
dismiss	pagwara
dispatch	ginsugo
display	pagpakita
disposal	paglabay
dispute	away
distance	distansiya
distinct	naiiba gud
distinguish	paglain
distress	kasakitan
distribution	pagbahinbahin
district	distrito
disturb	pagkasamok
ditch	kanal
dive	nalukso
diverse	iba-iba
diversity	kalainan
divide	pagbahin
divine	diyosnon
divorce	igdiborsyo
divorce	diborsyo
dizzy	nalilipong
do	pagbuhat
do you	ikaw ba
do you love me	hinigugma mo ba ako
doctor	doktor
document	dokumento
does	nagbubuhat
doesn't	diri karuyag
dog	ayam
doing	pagbuhat
doll	monyeka
domain	nasasakopan
domestic	panimalay
dominant	nagmamando
don't	ayaw
Don't worry	ayaw kabaraka
donate	pagdonar
done	nahuman
donkey	asno
dope	droga
double	dobleha
double	doble
doubt	pagruhaduha
doubt	nagruhaduha
dough	minasa nga harina
down	ha ilarom
draft	plano
draft	planoha
drag	gindanas
drain	paturuon
drain	pagpa-ubsi
drama	drama
draw	pag-guhit
draw	pagtirok
drawer	hunos
drawing	pagdrowing
dread	kahadlok
dream	pag-inop
dream	inop
dress	bado
drill	barina
drink	inuma
drink	inom
drive	pagmaneho
drop	ihulog
drop	hulog
dropped	nahulog
drought	huraw
drunk	hubog
dry	mamara
duck	pato
dude	pustoriyoso
due	nga kinahanglan
due to	tungod han
dull	waray pulos
dumb	lurong
dump	paglabay
duration	kahilawigon
during	niyan han
during	durante
dust	tapotapo
duty	obligasyon
dwell	pag ukoy
dying	namamatay
each	kada
each other	an usa kag usa
eager	naghingyap
eagle	agila
ear	talinga
earlier	antes hito
early	temprano
earn	makarawat
ears	talinga
earth	kalibutan
earthquake	linog
ease	kapahuwayan
easily	madali
east	este
easy	madali
eat	kaon
eating	pagkaon
economic	ekonomiya
economy	ekonomiya
edge	gilid
edit	pagliwat
education	edukasyon
effect	epekto
effective	epektibo
efficiency	kahusayan
efficient	epektibo
effort	paningkamot
egg	bunay
eggplant	tarong
eight	walo
eighteen	napulo kag walo
eighty	kawaloan
either	bisan
elaborate	detalyado
elbow	siko
elder	tigurang
elder	lagas
elderly	tigurang
elderly	mga lagas
elegant	maanyag
element	elemento
elephant	elepante
eleven	onse
eligible	katugbang
eliminate	pagwara
else	iba
embarrassed	naawod
embarrassing	nakakaawod
embrace	pagkarawat
emerge	pag abot
emotional	emosyonal
empathy	empatiya
emphasis	pabug-atan
emphasize	pagpabug-at
employee	empleyado
employees	mga empleyado
employer	amo
employment	trabaho
empty	waray sulod
enable	pagpaandar
encounter	pakigkita
encourage	pagdasig
end	kataposan
endangered	mameligro
endeavor	mangalimbasog
endurance	pagpailob
endure	pag antos
enemy	kaaway
energy	enerhiya
engage	pag api
engaged	nakabudlay
engagement	pakigbahin
engine	makina
engineer	inhinyero
English	Ininglis
enhance	pagpauswag
enjoy	malipayon
enjoy	rayhak
enormous	daku gud
enough	sadang
enough	igo na
ensure	pagsiguro
enter	sulod
entertainment	kaliawan
enthusiasm	kadasig
enthusiastic	madasigon
entire	bug-os
entitled	may katungod
entity	persona
entrance	mga entrada
entrepreneur	negosyante
environment	palibot
envy	kaawa
epic	epiko
epidemic	epidemya
equal	katugbang
equipment	kagamitan
equity	kapital
equivalent	katugbang
eraser	pamara
error	sayop
escape	paglikay
especially	labi na gud
essay	isinurat
essence	kahulogan
essential	importante
establish	pagtukod
established	gintukod
estate	estado
estimate	pagbanabana
estimated	ginbanabana
etc	ngan iba pa
eternal	waray kataposan
ethics	etika
evaluate	pag usisa
evaluation	pag usisa
even	bisan
even	pa ngani
even though	bisan kon
evening	gab-i
event	hitabo
eventually	ha kataposan
ever	waray gud
every	kada
everybody	ngatanan
everybody	nalimas
everyone	ngatanan
everything	ngatanan
evidence	ebidensya
evil	maraot
evolution	ebolusyon
evolve	pag uswag
exact	husto
exactly	tinuod
exactly	ito gud
exam	eksamin
examine	pag usisa
example	ehemplo
exceed	labaw
excellent	maopay gud
except	gawas
except	diri-upod
exception	labot
excess	sobra
excessive	sobra
excessive	lampos
exchange	pagbalhin
excited	naikag
excited	nalipay
excitement	pagkadasig
exciting	makapainteres
exclusive	esklusibo
excuse	pasaylo
excuse me	pasayloa ako
execute	iginpadapat
execution	pagpatuman
executive	ehekutibo
exercise	ehersisyo
exercise	pag-ehersisyo
exhaust	kapoy
exhausted	nakapoy
exhausted	nabutlaw
exhibit	nagpapakita
exhibition	pasundayag
exist	aada
exist	mayda
existence	pag eksister
existing	aada
exit	paggawas
expand	pagpadako
expect	ginalalaoman
expected	ginlalaoman
expenses	gastos
expensive	mahal
experience	eksperyensya
experience	eksperyensyaha
experiment	eksperimento
expert	eksperto
expired	linampos na
explain	pagsaysay
explanation	pagsaysay
exploit	pagpahimulos
explore	pag usisa
export	eksport
expose	pagbuhayhag
exposed	pagbuhayhag
exposure	pagkaada
express	iginsiring
expression	pulong
extend	pagpadako
extended	ginpadako
extension	pagpadako
extent	kadako
external	gawasnon
extinct	waray na
extra	sobra
extract	pagkuha
extraordinary	talagsahon
extreme	duro
extremely	duro gud
eye	mata
eyes	mata
fabric	tela
fabulous	urusahon
face	atubanga
face	atubang
facilitate	pagpadali
facilities	mga pasilidad
facility	pasilidad
fact	kamatuoran
factor	hinungdan
factory	pabrika
facts	mga kamatuoran
fade	nagtitikawara
fail	pakyas
fail	pakyasa
failed	napakyas
failure	pakyas
faint	pagluya
fair	malamrag
fair	matadong
fairly	husto
fairy	diwata
faith	pagtapod
faith	pagtoo
faithful	matinumanon
fake	buwa
fall	pagkahulog
fall	ighulog
false	BUWA
fame	kabantogan
familiar	pamilyar
family	pamilya
famine	katgutom
famous	sikat
famous	bantog
fan	gindadayaw
fan	pamaypay
fancy	hingyapon
fancy	maupay
fantastic	urusahon
far	hirayo
farewell	panamilit
farm	uma
farmer	parauam
fascinating	makaurusa
fashion	uso
fast	makusog
fast	madagmit
fat	tambok
fatal	makamatay
fate	kapalaran
father	amay
father	tatay
fatigue	kakapoy
fatigue	kabutlaw
fault	sayop
favorite	paborito
favour	pabor
favourite	paborito
fear	kahadlok
fear	paghadloka
feast	piyesta
feather	barahibu
feature	kilala
feature	kilal-a
features	mga bahin
february	pebrero
fed up	nagsawa na
fee	bayad
feed	pagkaon
feedback	baton
feel	inabat
feeling	pag abat
feet	mga tiil
fell	nahulog
fellow	igkasi
felt	inabat
female	babaye
fence	alad
fertile	mabunga
festival	piyesta
fetch	pagkuha
fever	hiranat
few	guti la
few	pira la
fewer	mas gutiay
fiance	pangasaw-onon
fiction	susmatanon
field	hagna
field	kapatagan
field	uma
fierce	mapintas
fifteen	napulo kag lima
fifty	kalim-an
fight	awaya
fight	away
fighting	makikig away
figure	simboliko
figure	igsimbolo
figure out	pagdiskobre
file	pila
fill	pagpuno
filled	ginpuno
film	sine
filthy	mahugaw
finally	ha kataposan
finance	panalapi
financial	pinansyal
find	turuya
find	tudya
find	pangitaa
find out	hibaroi
fine	diri maupay
fine	maupay
finger	tudlo
finish	human na
finished	nahuman
fire	kalayo
firm	ginparig-on
firm	marig-on
first	una
first name	ngaran
fish	isda
fit	angay
five	lima
fix	pag ayad
fixed	marig-on
flag	bandera
flash	largo
flash	tigda
flat	patag
flat	ginpatag
flaw	kaluyahan
flawless	waray depekto
flee	pumalagiw
flesh	unod
flew	linupad
flex	pagpilopilo
flexible	mapauyon-uyon
flight	paglupad
flip	pinakli
flirt	pagpikat
flirting	napikat
float	lutaw
flood	baha
floor	salog
flour	harina
flow	ig-awas
flow	pag awas
flower	bukad
flu	hiranat
fluent	maopay magyakan
fluently	mahayag
fluffy	mahumok
fluid	likido
fly	lupad
focus	pagsentro
focus	sentro
fog	burong
foggy	maburong
fold	pilo
folks	mga tawo
follow	sunod
follow up	kulawi ngahaw
following	pagsunod
food	pagkaon
fool	lurong
fool	paglurunga
foolish	lurong
foot	tiil
for	para
for	ha
For example	pananglitan
for instance	pananglitan
for you	para ha imo
forbidden	igindidiri
forbidden	ginbabawal
force	kusog
force	pagpirit
forecast	pagtagna
forehead	agtang
foreign	langyaw
forest	kagurangan
forever	ha kadayonan
forget	hikalimti
forgive	pasayloa
forgot	nahingalimot
fork	tinidor
form	pormaha
form	porma
formal	pormal
former	hadto
former	an una
fortunately	panhimalad
fortune	bahandi
forty	kap-atan
forty-two	kap-atan kag duha
forward	ha unahan
foster	pag ataman
fought	nakig away
found	hin agian
foundation	pundasyon
four	upat
fourteen	napulo kag upat
fox	garong
fragile	magluya
frame	hamba
framework	basihan
fraud	panlimbong
freak	kabangis
free	libre
freedom	kagawasan
freeze	pagyelohon
frequency	kaagsob
frequent	agsob
frequently	agsob
fresh	bag-o
friday	biyernes
fridge	pridyeder
friend	sangkay
friendly	makigsangkayon
friends	kasangkayan
friendship	kasangkayan
frightened	nahadlok
frightening	makaharadlok
frog	pakla
from	tikang
front	unahan
frozen	nagyiyelo
fruit	prutas
frustrated	nasusubo
fuel	enerhiya
full	bug-os
fun	makalilipay
function	gamit
fundamental	importante
funeral	paglubong
funny	pataraw-an
fur	barahibo
furious	nasisina
furniture	muwebles
further	dugang pa
furthermore	dugang pa
future	tidaratong
future	umaabut
gain	karawta
gain	pagkarawat
game	uyag
game	uyas
gap	lat-ang
garage	garahe
garbage	basura
garden	hardin
garlic	lasona
gate	ganghaan
gather	pagtirok
gathering	pagtirok
gauge	ginsusukol
gauge	bana-banaa
gave	ginhatag
gear	kagamitan
gender	kinatawo
general	para hit ngatanan
generally	kasagaran
generate	maghimo
generation	henerasyon
generous	mahinatagon
genius	intelihente
gentle	malumo
genuine	tinuod
gesture	pagkompas
get	pag abot
get	kuhaa
get dressed	pagliwan
get up	buhat
get well soon	mag-opay dayon
getting	pagkuha
ghost	espiritu
ghosting	multohon
giant	higante
gift	regalo
ginger	laya
girl	babaye
girlfriend	sangkay nga babaye
girlfriend	uyab
give	paghatag
give up	pagbaya
given	iginhatag
glad	malipayon
glance	pagkita
glass	baso
glass	salamin
glasses	mga baso
glimpse	tan-au
global	kalibotan
gloomy	masurub-on
gloves	mga gwantes
glow	paranggata
glow	nagraranggat
glow up	naglamrag
glue	pandukot
go	lakat
go	tikang na
go ahead	padayon
go away	magpahirayo ka
go to bed	kumaturog
goal	tumong
goals	mga tumong
goat	kanding
god	dios
god bless you	bendisyonan ka han ginoo
goes	kinadto
going	pagkadto
going to	tikadto ha
gold	bulawan
gone	tinikang na
gone	waray na
gonna	magtitikang
good	mamaupay
good	maupay
good afternoon	Maupay nga kulop
good bye	malakat na
good day	maupay nga adlaw
good evening	maupay nga gab-i
good job	maupay nga trabaho
good looking	maupay kulawan
good luck	swerte
good morning	maupay nga aga
good morning my love	maupay nga aga hinigugma ko
good night	maupay nga gab-i
goodnight	maupay nga gab-i
goods	mga butang
goose	gansa
gorgeous	maanyag
gorgeous	matahom
gossip	libak
got	nakuha
got	nasayuran
got it	nakuha ko ito
government	gobyerno
grab	pagdakop
grade	grado
gradually	hinayhinay
graduate	graduado
grain	lugas
grant	grasya
granted	ginhatag
grapes	mga ubas
grasp	masasabtan
grass	banwa
grateful	mapasalamaton
gratitude	pagpasalamat
grave	lubnganan
gray	abuhon
great	hinduro
great	makarit
great	daku gud
greed	kahakog
greedy	hakog
green	berde
greet	pangumusta
greeting	pangumusta
greetings	mga pangumusta
grey	abuhon
grief	kasubo
grind	pag giling
grip	pagkaput
grocery	tindahan
groom	pangasaw-onon
gross	malaw-ay
ground	tuna
group	grupo
grow	pagtubo
growth	pagtubo
grumpy	maaringit
guarantee	garantiya
guard	bantay
guess	patigo
guest	bisita
guidance	giya
guide	igiya
guide	giya
guilty	salaan
guy	lalaki
guys	mga tawo
habit	batasan
habitat	urukyan
had	mayda
hail	yelo
hair	buhok
half	tunga
hall	ruwang
hand	kamot
handle	pagdumara
handsome	matahom
handsome	guwapo
hang	pagbitay
hang out	mag upod
happen	nahinabo
happened	nahinabo
happiness	kalipay
happy	malipayon
happy birthday	malipayon nga kaadlawan
happy birthday to you	Malipayon nga adlaw nga natawhan ha imo
happy new year	malipayon nga bag-o nga tuig
hard	makuri
hard	matig-a
hardly	diri gud
hardly ever	diri gud
harm	kadaoti
harm	kadaot
harmful	nakakadaot
harmony	pagkaurosa
harsh	mapintas
harvest	pag ani
has	may
hate	pagdumot
have	mayda
have	may
have a good day	maupay nga adlaw
have a nice day	maupay nga adlaw
have breakfast	pamahaw
have fun	malipay
have you eaten	kinaon ka ba
having	may
hazard	peligro
haze	tun-og
he	hiya
he has	may ada hiya
he is	hiya
head	ulo
headache	suol ha ulo
heal	mag-opay
healing	pagtambal
health	kahimsog
healthy	mahimsog
hear	pamati
heard	nabatian
heart	kasingkasing
heat	pasoa
heat	mapaso
heaven	langit
heavy	mabug-at
hectic	okupado
height	kahitaas
heir	manurunod
heist	panikas
held	gindumara
hell	impyerno
hello dear	kumusta hinigugma
hello how are you	hello kumusta ka
hello how are you doing	kumusta ka na
helmet	helmet
help	bulig
helpful	nakakabulig
hence	tungod hini
her	hiya
her	niya
herd	kawan
herd	panon
here	dinhi
heritage	panurundon
hesitate	nagruhaduha
hi how are you	kumusta ka
Hi there	Kumusta kamo
hidden	tinago
hide	magtago
hierarchy	hirarkiya
high	hitaas
highlight	pagpabug-at
hike	sagka
hiking	pagbaktas
hilarious	makatatawa
hill	bungtod
him	hiya
hint	tigaman
hip	baliatang
hips	baliatang
hire	pagkuha
hiring	pagsuhol
his	iya
history	kasaysayan
hit	pag atake
hobby	hilangkagan
hold	kapti
hold	tipigi
hold	pagpabilin
hold on	maghulat
hole	buho
holiday	bakasyon
hollow	lungag
home	panimalay
homework	trabaho ha balay
honest	tangkod
honestly	tangkod
Honey	Dugos
Honey	Arog
honor	tahora
hood	nakatabon
hook	kaw-it
hop	lukso
hope	paglaom
hope	laomi
hopefully	ginlalaoman
hopeless	waray paglaom
horizontal	pabalabag
horn	sungay
horrible	makaharadlok
horror	makaharadlok
horse	kabayo
hospital	ospital
hospitality	pagkamaabiabihon
host	nag imbitar
host	imbitara
hostile	pagkontra
hot	mapaso
hotel	hotel
hour	oras
hours	oras
house	balay
household	panimalay
how	paonan-o
how about you	kumusta ka man
how are you	kumusta ka
how are you doing	kumusta ka man
how are you doing today	kumusta ka yana
how are you today	kumusta ka yana
how do you do	kumusta ka
how is	paonan-o
how many	pira
how much	pira
how often	mationon-o kaagsob
how old are you	pira na an imo  edad
how was your day	kumusta an imo adlaw
how was your night	kumusta an gab-i mo
however	kondi
hub	sentro
hubby	asawa
hug	paghangkop
hug	hangkopi
huge	daku
huge	paligid
human	tawo
humble	mapainubsanon
humid	maalindanga
humidity	maalindanga
hundred	usa ka gatos
hungry	gutom
hunt	panganop
hunt	pagturoy
hurricane	bagyo
hurry	pagdagmit
hurry up	pagdagmit
hurt	sinul-an
hurt	nasamad
husband	bana
husband	asawa nga lalaki
hustle	paghinay
hustle	hinayhinay
hut	payag
hygiene	kalimpyo
I am	ako
I am fine	Maupay ako
I can	Mahimo ko
I can't	diri ako makakahimo
I do	Oo nga
I do not know	Diri ako maaram
I do not understand	diri ako nasabot
I don't	diri ako
I don't know	diri ako maaram
I don't understand	diri ko nasabot
I don't understand what you mean	diri ako nasabot  han imo karuyg buot sidngon
I don't understand you	diri ko kamo nasabot
I don’t know	diri ako maaram
I don’t understand	Waray ako makasabot
i guess	siguro
I had	Mayda ako
I have	ako may
I have been	Ako nagin
I hope so	Naglalaom ako
I know	Maaram ako
I like	karuyag ko
I like you	karuyag ko ikaw
I love	Ginhigugma ko
I love my big brother	Hinigugma ko an akon magurang nga lalaki
I love my big sister	Hinigugma ko an akon magurang nga babaye
I love my father	Hinigugma ko an akon amay
I love my little brother	Hinigugmako an akon manghod nga lalaki
I love my little sister	Hinigugma ko an akon manghod nga babaye
I love my mother	Hinigugma ko an akon nanay
I love you	Hinigugma ko ikaw
I love you so much	Hinigugma ko ikaw hin duro
I love you too	Higugmaon ko liwat ikaw
I mean	karuyag ko sidngon
I miss you	gimingaw ak ha imo
I miss you so much	gin mimingaw ako ha imo hin duro
I see	kita ko
I think	naghuhunahuna ako
I understand	Nasabtan ko
I want	Karuyag ko
I want to see you	karuyag ko makita ka
I want you	karuyag ko ikaw
I was	Ako an
I will	hihimuon ko
I would be	Ako magigin
I'm	Ako
I'm fine	Maupay ako.
I'm good	Ayos la ako
I'm here	Aadi ako
I'm sorry	Pasayloa ako
ice	yelo
ice cream	sorbetes
idea	ideya
ideal	gimaopayi
identical	pareho
identify	pagkilala
identity	pagkilala
idiot	lurong
idle	waray gamit
if	kon
ignore	igbalewaray
ill	masakit
illegal	ilegal
illness	sakit
image	imahen
imagine	handurawa
immediate	dayon
immediately	largo
immediately	dayon
immense	daku gud
impact	epekto
impact	i-epekto
impatient	waray pasensya
implement	magpatuman
import	angkata
import	angkat
important	importante
impose	namimirit
impossible	imposible
impress	mapabilib
impression	impresyon
impressive	urusahon
improve	pagpauswag
improve	pag-upay
improvement	pagpauswag
in	ha
in addition	dugang pa
In fact	ha pagkamatuod
in front of	ha atubangan han
in order to	basi
inappropriate	diri angay
incentive	hinungdan
incident	insidente
include	nag uupod
including	lakip an
income	kita
inconvenience	kakurian
increase	pagdugangi
increase	pagdugang
increased	nadugang
incredible	urosahon
indeed	oo gud
indeed	pinakamatuod
indeed	tinuod
independent	independente
India	Indya
indicate	igpakita
indigenous	nitibo
individual	indibiduwal
industry	industriya
inevitable	diri malilikyan
infant	minasus-an
infection	impeksyon
infinity	waray kataposan
inflammation	paghubag
inflation	implasyon
influence	impluwensya
influence	impluwensiyahi
inform	pagpahibaro
information	impormasyon
ingredients	mga sangkap
inheritance	panurundon
initial	tinikangan
initiative	pagtikang
injured	nasamaran
injury	kadaot
innocent	waray sala
innovation	inobasyon
inquiry	pagpakiana
insane	lurong
insect	insekto
insecure	waray kompyansa
insert	ginlakip
inside	sulod
insight	pagsabot
insist	magpipirit
inspiration	inspirasyon
inspire	giniyahan
install	iginbutang
instance	pananglitan
instant	dayon
instead	lugod
instead of	imbes nga
instructions	mga instruksyon
instrument	instrumento
insult	insulto
insurance	seguro
intact	bug-os
integrity	integridad
intellectual	kinaadman
intelligence	intelihensya
intelligent	intelihente
intend	gintuyo
intended	ginlarang
intense	duro gud
intention	tuyo
interact	pakig upod
interaction	pakig upod
interest	interes
interested	interesado
interesting	makapainteres
interfere	makakaulang
intermediate	pagbutnga
internal	ha sulod la
internship	pagpraktis
interpret	paghubad
interrupt	naulang
interview	interbyu
intimate	duok
into	in
introduce	igpahibaro
introduction	pagpakilala
introvert	awdonon
intuition	intuwisyon
invalid	waray pulos
invent	inimbento
inventory	imbentaryo
invest	pagpuhunan
investigate	pag usisa
invitation	imbitasyon
invite	imbitar
invoice	resibo
invoice	resibohi
involve	pag upod
involved	nahiupod
iron	pirensa
iron	pirensaha
is	nga
island	puro
isolated	nahibubulag
issue	isyu
issue	ig-isyu
issues	mga isyu
it	iton
it is	amo ito
it was	amo ito
it's	ito
it's ok	ok la
It's okay	Waray problema
item	itom
items	mga butang
its	iya
I’m	Ako
jail	prisohan
January	Enero
jar	botelya
jaw	panga
jealous	may kasina
jerk	asno
jewelry	alahas
job	trabaho
join	mag upod
joint	kaluluthan
joke	pagdurugas
journalist	peryodista
journey	pagbiyahe
joy	kalipay
judge	hukom
judge	paghukumi
juice	duga
july	hulyo
jump	paglukso
june	hunyo
junk	basura
just	gintagan hin hustisya
just	may ada hustisya
just do it	buhata ito
justice	hustisya
justify	pagmatuod
keen	pursigido
keep	itago
keep	tipigi
keep	padayon
keep it up	Padayon
kept	gintitipigan
kettle	takuri
key	yawi
kick	banyak
kid	bata
kid	laksi
kidding	paglilinaksi
kidding	pagbibinuwa
kidney	bato
kids	kabataan
kill	pagpatay
kind	klase
kind	hitaas nga klase
kinda	medyo
kindly	mapinairon
kindness	pagkabuotan
king	hadi
kiss	harok
kitchen	kusina
kite	manogbanog
kitten	misay
knee	tuhod
knew	nahibaro
knife	kutsilyo
knight	kabalyero
know	maaram
knowledge	kahibaro
known	kilala
label	pangarani
label	ngaran
labor	pagtrabaho
labour	trabaho
lack	kakulang
ladder	hagdanan
lady	daraga
lady	babaye
laid	ginbutang
lake	danaw
lamb	nati nga karnero
lame	magluya
lamp	lampara
land	iglanding
land	landing
landscape	lugar
language	yinaknan
lap	ginsasabak
large	daku
last	urhi
last	kataposan
last but not least	katapusan pero diri minus nga  importante
last name	apelyido
late	atrasado
lately	bag-o pa
later	sunod
later	unina
latest	pinakabag-o
latter	urhi
laugh	pagtawa
laughing	pagtinawa
laughter	pagtawa
launch	paglunsad
laundry	paglaba
law	balaod
lawn	libong
lawyer	abogado
lay	pagbutang
layer	suon
layout	plano
lazy	hubya
lead	nangunguna
lead	nahiuuna
leader	lider
leaf	dahon
leak	pag agos
lean	mahina
leap	paglukso
learn	pag aram
learning	pagbaro
lease	pagpaplete
least	pinakaminos
leather	anit
leave	baya-i
leave	baya
leaves	mga dahon
led	gindara
left	wala
leg	tiil
legacy	panurundon
legend	sugilanon
leisure	pagpahuway
lend	pahuram
length	kahalabaan
length	kahirayo
less	mas gutiay
lesson	leksyon
let	pabay-i
letter	surat
lettuce	letsugas
level	sukol
leverage	pahimulos
liability	obligasyon
liability	utang
library	librarya
lick	gindidilaan
lie	buwa
lie	pagbuwa
lies	mga buwa
life	kinabuhi
lift	alsa
lift	alsaha
light	palamraga
light	lamrag
light	malamrag
lightning	linti
like	pareho hin
like	sugad
likely	posible
likewise	sugad man
line	linya
link	koneksyon
lion	leon
liquid	likido
list	lista
listen	pamati
listening	pagpamati
literally	literal nga
literature	literatura
litter	sasarang
little	gutiay
live	buhi-a
live	waray kinabuhi
liver	atay
lives	kinabuhi
living	buhi
living room	sala
lizard	tabili
load	karga
loaf	tinapay
loan	pautang
local	lokal
location	lugar
lock	trangka
lockdown	pagtrangka
log	kahoy
lonely	nag uusahan
long	hilaba
long	hilawig
long time no see	maiha na nga waray kita magkita
look	kitaa
loop	turotalinga
loose	ginbuhian
loose	buhii
lord	ginoo
lose	mawawara
loss	pagkawala
lost	nawawara
lot	lote
loud	maaringasa
lounge	sala
love	higugma
love	higugmaa
love you	hinigugma ko ikaw
lovely	mahusay
lovely	maupay
low	ubos
low	hibubo
lower	ubos
loyal	maunungon
loyalty	pagkamaunungon
luck	swerte
lucky	swerte
luggage	bagahe
lump	bukol
lunch	paniudto
lungs	baga
luxury	marahalon
lying	pagbuwa
machine	makina
mad	lurong
madam	madam
made	ginhimo
magazine	magasin
magnificent	urusahon
maid	daraga
maid	surugoon
main	nanguna
maintain	pagtipig
maintenance	pagtipig
major	una
major	gin-una
majority	kadam-an
make	himo
make up	pag andam
male	lalaki
man	tawo
man	lalaki
manage	pagdumara
management	pagdumala
manager	manedyer
mandatory	ngatanan
mandatory	obligado
manifest	iginpakita
manipulate	pagmaniobra
manner	paagi
manual	mano-mano
many	damu
many many happy returns of the day	Damo nga malipayon han pagbalik han adlaw
march	marso
margin	ligid
market	merkado
marriage	pag asawa
married	nag asawa
mask	maskara
mass	misa
mass	masa
massive	pinakadaku
master	eksperto
match	tupungi
match	magtupong
mate	kasangkayan
material	materyal
math	matematika
matter	butang
matter	ibutang
maturity	pagkahamtong
may	bangin dumatong
may	bangin
maybe	bangin
me	ako
me too	ako daman
me too	ako man
meal	pagkaon
mean	gin isogan
mean	pag isog
meaning	kahulogan
means	paagi
means	nangangahulogan
meant	karuyag sidngon
meanwhile	samtang
measure	paagi
measures	mga paagi
meat	karne
medical	medikal
medicine	medisina
meditation	meditasyon
medium	kasangkapan
meet	pagkita
meeting	katirok
melt	matunaw
memories	mga hinumdoman
memory	hinumdoman
mental	panhunahuna
mention	maunabi
mentioned	gin unabi
mentor	magturutdo
merchant	negosyante
mercy	kalooy
merely	basta
merry christmas	malipayon nga pasko
mess	kasamok
message	mensahe
messy	maras-ang
method	paagi
mice	mga yatot
middle	butnga
midnight	katutnga
might	bangin
mild	mahinay
mild	malumo
military	militar
milk	gatas
million	milyon
mind	hunahunaa
mind	hunahuna
mindset	paghunahuna
mine	akon
mine	Juan
mingle	pag upod-upod
minute	minuto
minutes	minuto
miracle	milagro
mirror	espiho
miscellaneous	iba-iba
mischievous	sutil
miserable	kablas
miserable	makaluluoy
misery	kasakitan
miss	nahidlaw
miss	babaye
miss you	gimingaw ako ha imo
missing	nawawara
missing	nahihidlaw
mission	misyon
mist	alisngaw
mistake	sayop
mock	pagpakaalo
model	modelo
moderate	igsadang
moderate	ginsadang
modern	moderno
modest	mapainubsanon
moist	mahulos
moisture	mahulos
mold	pagmolde
mold	molde
mole	ila
mom	nanay
moment	panahon
monday	lunes
money	kwarta
monitor	bantayan
monkey	amo
month	bulan
mood	kahimtang
mood	kabutangan
moody	sumpungon
moon	bulan
moral	moral
more	dugang pa
moreover	dugang pa
morning	aga
mortgage	pag prenda
most	kadam-an
mostly	kadam-an
mother	nanay
motion	pagkiwa
motivation	pag aaghat
mountain	bukid
mouse	yatot
mouth	baba
move	pagbalhin
movement	pagkiwa
movie	pelikula
much	damu
mud	lagay
mug	tasa
muscle	kaunoran
museum	museo
mushroom	ulaping
music	musika
must	kinahanglana
must	kinahanglan
mute	ngula
mutual	kada tagsa
my	akon
My dear	An akon pinalangga
my friend	akon sangkay
My hovercraft is full of eels	An akon hovercraft puno hin mga anke
my love	hinigugma ko
my name is	an akon ngaran amo
my pleasure	an akon kalipayan
myself	ako mismo
mysterious	misteryoso
mystery	misteryo
myth	susmatanon
nail	raysang
nail	kulo
naive	uwat
name	ngaran
narrative	asoy
narrow	haligot
nasty	maraot
nasty	makaaaringit
national	nasudnon
nationality	nasyonalidad
native	natawo
nature	kinaiyahan
nausea	paghingasuka
near	hirani
nearby	hirani
nearly	haros
neat	limpyo
necessary	kinahanglan
neck	liog
necklace	kwintas
need	kinahanglana
need	kinahanglan
negative	negatibo
neglect	pasibay-an
negotiate	pakigsabot
neighbor	amyaw
neighborhood	maga ramyaw
neither	diri liwat
nephew	umangkon
nervous	nagugupong
nest	salag
net	pukot
never	waray gud
never give up	ayaw gud umundang
never mind	ayaw kabaraka
nevermind	ayaw kabaraka
nevertheless	bisan pa hito
new	bag-o
news	sumat
next	sunod
next to	sapit ha
nice	kaupay
nice	maupay
nice to meet you	nalipay ako hin pagkilala ha imo
niece	umangkon
night	gab-i
nightmare	inop
nine	siyam
nineteen	napulo kag siyam
ninety	kasiyaman
No	Diri
no problem	waray problema
no way	waray gud
nobody	waray
noise	kasaba
noisy	maaringasa
none	waray
noon	udto
nope	diri
nope	waray
nor	o
north	norte
nose	irong
nostalgic	paghandom
not	diri
not	ayaw
not at all	diri gud
not bad	diri maraot
Not now	Diri yana
not yet	diri pa
note	nota
noted	gin unabi
nothing	waray
notice	pahibaro
noticed	hinkit-an
noticed	naobserbaran
noun	ngaran
nouns	nombre
novel	nobela
november	nobyembre
now	yana
nowadays	yana
nuisance	nakakadisturbo
null	diri
null	waray
numb	pamanhod
number	numero
nurse	nars
nut	liso
nutrition	nutrisyon
oath	panumpa
obesity	pagkamatambok
obey	pagsugot
object	butang
objective	katuyoan
obligation	obligasyon
obscure	diri klaro
observation	obserbasyon
observe	obserba
obsessed	pagpaniguro
obsession	pagkahilig
obsolete	kadaan
obstacle	mga ulang
obtain	makuha
obtained	nakuha
obvious	dayag
obviously	syempre
occasionally	usahay
occupation	trabaho
occupation	propesyon
occupied	gin okupar
occur	nahinabo
occurred	nahinabo
occurs	nahinabo
ocean	kalawdan
october	oktubre
odd	diri magkapariho
odds	diri nagkakauyon
of	han
of course	oo gad
of course	syempre
off	ginpagawas
offensive	pag atake
offer	ighatag
offer	hatag
office	opisina
official	opisyal
often	agsob
oh really	o tinuod
oil	lana
ok dear	sige arog
ok honey	sige arog
ok my love	ok hinigugma ko
okay	sige
okay baby	okay baying
okay dear	sige arog
okay honey	sige arog
okay my love	Okay, hinigugma ko
old	kadaanan
old	lagas
old	dumog
on	ha
once	makausa
one	usa
one language is never enough	an usa nga yinaknan diri gud igo
onion	sibuyas
only	la
open	abre
operation	operasyon
opinion	opinyon
opportunities	mga oportunidad
opportunity	oportunidad
opposite	kontra
optimistic	positibo
option	kapilian
optional	opsyonal
or	o
orange	dalandan
orange	kahel
order	ordera
order	order
ordinary	ordinaryo
organization	organisasyon
orientation	oryentasyon
origin	gintikangan
original	orihinal
orphan	ilo
other	iba
otherwise	kon diri
ought	kinahanglan
our	aton
Our mission: to enable everyone, everywhere to understand the world and express themselves across languages.	An amon misyon: basi ngatanan, bisan diin, makasabot han kalibotan ngan magpahayag han ira kalugaringon ha iba nga mga yinaknan.
Our mission: to organize the world's information and make it universally accessible and useful.	An amon misyon: pag-organisa han impormayon ha kalibotan ngan himoon ito nga komon ngan mapulsanon.
out	gawas
outcome	resulta
outfit	panapton
outgoing	makisangkayon
outlet	guwaan
outline	plano
outside	gawas
outstanding	susbaranan
outstanding	diri pa natatapos
oven	pugon
over	labaw
over	igbaw
over	lampos
over there	didto
overall	ngatanan
overall	bug-os
overcome	ginlampos
overthinking	sobra nga panhunahuna
overwhelmed	nag antos
overwhelmed	nabaraka
overwhelming	makusog
owe	may utang
owl	bukaw
own	kalugaringa
own	kalugaringon
owner	tag-iya
ox	baka
pace	paspas
pack	putos
package	padara
paid	ginbayad
pain	ul-ol
pain	suol
paint	pintura
painting	pintura
pair	padis
pale	duason
palm	palma
pan	karaha
pandemic	pandemya
panic	kalisang
pants	saruwal
paper	papel
paradise	paraiso
parallel	katugbang
parcel	iginpadara
pardon	pagpasaylo
parents	mga kag-anak
park	parke
parrot	pikoy
parsley	perehil
part	parte
participate	makigbahin
particular	partikular
particularly	partikular
partner	kaupod
party	partido
pass	paglabay
passage	paglabay
passed	pinasar
passion	makusog nga hingyap
passionate	madasigon
passive	pagkamahilom
past	naglabay
patch	igintangkop
path	dalan
pathetic	makangingirhat
pathetic	makalulooy
patience	pagpailob
patient	grabe nga pasyente
patient	pasyente
pattern	susbaranan
pause	maundang
pavement	simentado
pay	pagbayad
payment	pagbayad
peace	kamurayawan
peaceful	malinawon
peak	pungkay
pear	piras
peas	gisantes
peculiar	talagsaon
pee	ihi
pee	ihii
peel	pagbakbak
peer	kaapi
peers	kaupod
pen	pansurat
pencil	lapis
pending	naghuhulat
people	mga tawo
pepper	paminta
perceive	pagsabot
perception	panhunahuna
perfect	hingpit
perform	magbuhat
performance	nabubuhat
perhaps	bangin
period	peryodo
period	panahon
permanent	permanente
permission	permiso
permit	permiso
perseverance	pagbailob
persistent	nagpapadayon
person	tawo
personal	personal
personality	personalidad
perspective	panlantaw
persuade	pag aghat
pervert	bastos
pervert	ginlulubag
pervert	manyak
pet	hayop
phase	bahin
phenomenon	panhitabo
philosophy	pilosopiya
phone	telepono
photo	litrato
phrase	pulong
physical	pisikal
pick	purot
pick up	puruta
picture	hulagway
piece	piraso
pieces	mga piraso
pig	baktin
pigeon	sarapati
pile	tambak
pillow	ulonan
pilot	piloto
pin	pin
pineapple	pinya
pink	rosas
pit	luong
pitch	paglugaring
pity	kalooy
place	ilugar
place	lugar
places	mga lugar
plague	peste
plain	simple
plan	plano
plane	sapyo
plane	eroplano
plane	patag
plant	tanom
plants	mga tanom
plate	plato
platform	plataporma
play	uyag
play	pag uyag
playing	mag uyag
pleasant	nakakalipay
please	alayoni
please	gin alayonan
pleased	nailipay
pleasure	kalipay
pledge	garantiya
plenty	damu
plot	mga lugar
plot	plano
plumber	tubero
poem	siday
poetry	siday
point	punto
poison	hilo
police	pulis
policy	balaud
polite	matinalahuron
pollution	polusyon
pond	danaw
pool	danaw
poop	tae
poor	pobre
pop	tigda
pop	ulpot
popular	popular
population	populasyon
pork	karne han baboy
porridge	lugaw
port	duruongan
position	posisyon
positive	positibo
possess	may ada
possession	pagtag-iya
possessive	panag-iya
possible	posible
post	poste
post	iposte
postpone	pag atras
potato	patatas
potential	potensyal
pound	tutudturon
poverty	pobre
poverty	kablas
power	gahum
powerful	gamhanan
practical	praktikal
practice	praktis
practice	praktisa
praise	pagdayaw
prank	kalokohan
pray	pag ampo
precious	mahal
precious	importante
precise	husto
precisely	husto
predict	pagtagna
prefer	ginpili
preference	mas karuyag
pregnant	burod
prejudice	pagpasulabi
premises	lugar
preparation	pag andam
prepare	pag andam
prepared	gin andam
preposition	preposisyon
presence	presensya
present	regalo
present	pamasko
present	Pasko
presentation	presentasyon
preserve	pagtipig
president	presidente
press	pinduta
press	pindot
pressure	presyur
pretend	kuno
pretty	mahusay
pretty	gihuhusayi
prevent	paglikay
previous	naglabay
prey	biktima
price	presyo
pride	pagpahitaas
priest	padi
primary	primaryo
prime	primero
princess	prinsesa
principal	kapital
prior	unahan
prior	antes
priority	prayoridad
prison	pirisohan
privacy	pribado
private	pribado
privilege	prebelehiyo
prize	premyo
probably	bangin
problem	problema
procedure	pamaagi
proceed	padayon
process	proseso
process	prosesoha
produce	produkto
product	produkto
production	produksyon
profession	propesyon
professional	propesyonal
profit	kita
profound	hilarom
profound	sakto
progress	pag uswag
progress	pauswaga
project	proyekto
prominent	prominente
promise	saad
promise	igsaad
promote	pagpauswag
promotion	promosyon
prompt	pag gios
prone	masayon
pronouns	pronombre
pronunciation	pagluwas
proof	ebidensya
proper	husto
properly	husto
properties	gintatag iya
property	propyedad
proposal	mga suhestyon
prospect	paglaom
prosperity	kauswagan
prosperous	mauswagon
protect	panalipdi
proud	mapahitas-on
prove	pagpamatuod
provide	paghatag
provided	ginhatag
province	probinsya
provision	pagtagana
puberty	pagdaraga
public	publiko
pull	pagbutong
pumpkin	karabasa
punctual	maagap
pupil	estudyante
purchase	pagpalit
pure	puro
purple	purpura
purpose	katuyoan
purse	pitaka
pursue	pagpadayon
pursuit	paglanat
push	duso
put	ibutang
qualification	kwalipikasyon
quality	kalidad
quantity	kadamu
quarantine	kwarentinas
quarrel	awaya
quarrel	away
quarter	kwarto
queen	rayna
queer	kakaiba
query	pakiana
question	pakiana
queue	ipila
queue	pila
quick	madagmit
quickly	magdagmit
quiet	hilom
quiet	mingaw
quilt	panapton
quit	paghunong
quite	bug-os gud
quite	bangin gud
quiz	pakiana
quotation	kotasyon
quote	kotara
quote	kotar
quotes	ginkotar
rabbit	koneho
race	lahi
race	karera
rage	kasina
rain	uran
raise	dugangi
raise	pagdugang
raised	gin alsa
ran	dinalagan
random	panapang
range	nasasakop
rapid	madagmit
rapidly	madagmit
rare	talagsa
rarely	danay la
rash	agresibo
rat	yatot
rate	kalaksi
rather	lugod
rather	diri
rather	imbes
ratio	pagtunga-tunga
rational	rasyonal
raw	hilaw
re	nga
reach	pagkaabot
reached	nakaabot
reaction	reaksyon
read	pagbasa
reading	pagbasa
ready	andam na
real	tinuod
reality	ungod
realize	masabtan
realized	nahibaro
really	ungod
really	tinuod
rear	urhi
rear	luyo
reason	rason
reason	hinungdan
reasonable	makatadungan
recall	nahinunumdoman
receipt	resibo
receipt	pagkarawat
receive	makarawat
received	kinarawat
recent	bag-o pa
recently	bag-o pa
reception	pagkarawat
recipe	resipe
reckless	kimas
recognition	pagkilala
recognize	kilal-on
recommend	irekomendar
recommended	iginrirekomendar
record	rekord
record	irekord
recover	pag ayo
recovery	pagbawi
rectangle	rektangulo
red	pula
redeem	pagbayad
redemption	paglukat
reduce	pagpaubos
reduce	pag-bawas
redundant	labis
redundant	sobra
refer	pag unabi
reference	ginhihisgotan
reflect	ginpapakita
reflection	pagpakita
refrain	paglikay
refrigerator	pridyeder
refund	pagbalik han bayad
refuse	pagdumiri
refused	pagdumiri
regard	pagtagad
regarding	may kalabotan
regardless	anoman
regards	mga pagbati
region	rehiyon
register	pagrehistro
regret	pagbasol
regularly	regular nga
reject	igsalikway
relate	kalabotan
related	may kalabotan
relationship	relasyon
relative	paryente
relative	damo an paryente
relatives	mga paryente
relax	pahuway
release	igawas
release	pagpagawas
released	ginpagawas
relevant	may kalabotan
reliable	masasarigan
relief	pagbulig
relieve	nakaginhawa
relieved	ginpagawas
religion	relihiyon
religious	relihiyoso
reluctant	diri andam
rely	sarig
remain	magpabilin
remaining	nahibilin
remarkable	makatirigamnan
remedy	solusyon
remember	hinumdumi
remind	pahinumdom
reminder	pahinumdom
remote	harayo
remove	kuhaon
render	iginhubad
rent	plete
repair	pag ayad
repeat	pag utro
replace	pagliwan
reply	baton
reply	batona
report	sumat
report	sumati
represent	representante
reputation	reputasyon
request	hangyo-a
request	paghangyo
require	kinahanglan
required	kinahanglan
rescue	pagtalwas
research	pagsaliksik
resemble	magkapareho
resentment	pagdumot
reservation	reserbasyon
reserve	pagtipig
resident	residente
resign	pag undang
resilience	pag antos
resilient	makusog
resist	pag ato
resist	pag diri
resistance	atohan
resolution	resolusyon
resolve	pagsulbad
resources	mga bahandi
respect	tahori
respect	pagtahod
respond	batona
response	baton
responsibility	responsabilidad
responsible	responsable
rest	iba
rest	pahuway
rest in peace	pahuway ha kamurayawan
restaurant	restawran
restore	ibalik
restrict	paglimita
result	resulta
results	resulta
resume	iginpadayon
retail	parte la
retain	pagtipig
retention	pagtipig
retired	nagretiro
retreat	atras
retrieve	pagkuha
return	pagbalik
reveal	pagpadayag
revealed	iginpadayag
revenge	pagbulos
revenue	kita
reverse	pagbalik
review	pagrepasoha
review	pagrepaso
revise	pagrepaso
revision	rebisyon
revolution	rebolusyon
reward	balos
rhythm	ritmo
rib	gusok
rice	bugas
rice	humay
rich	riko
rid	pagwara
ride	igsakay
ride	sakay
ridiculous	waray pulos
right	tuo
right	tama
right now	yana gud
rigid	istrikto
ring	singsing
rinse	paghugas
riot	kasamok
rip	bulagi
rip	pagbulag
ripe	hinog
rise	pagtindog
rise	tindog
risk	peligroha
risk	peligro
rival	karibal
river	salog
road	kalsada
roast	inihaw
roast	sinanlag
robust	makusog
rock	bato
rod	sungkod
role	papel
roll	paglunay
roof	atop
room	kwarto
root	gamot
rope	higut
rotten	dunot
rough	malumo
roughly	haros
round	malidong
route	ruta
routine	rutina
row	linya
rub	ighihirog
rubber	goma
rubbish	basura
rude	waray batasan
rug	tapi
rug	hinis
ruin	kabungkagan
rule	balaud
ruler	magmarando
rules	mga balaud
run	pagdalagan
running	dinalagan
rural	baryo
rush	pagdagmit
rush	dagmita
sack	sako
sacred	sagrado
sacrifice	sakripisyo
safe	talwas
safe flight	luwas nga paglupad
safety	seguridad
sage	maaramon
said	nagsiring
sail	layag
sailing	paglalayag
sake	tungod
salary	sweldo
sale	pagbaligya
salmon	salmon
salt	asin
same	pareho
Same here	amo liwat ini
sample	sampol
sand	baras
sarcastic	sarkasmo
sat	naglingkod
satisfaction	natatagbaw
satisfied	nagtagbaw
satisfy	pagtagbaw
satisfying	makapatagbaw
Saturday	Sabado
sausage	suriso
savage	mapintas
save	pagtipig
save	talwas
saw	nakita
say	pagsiring
scale	kadako
scam	panlimbong
scar	ulat
scarce	gutiay
scared	nahadlok
scarf	bandana
scary	makahadlok
scattered	nagsasarang
scene	kiritaon
scenery	kiritaon
scent	baho
schedule	ig-eskedyol
schedule	eskedyol
school	eskwelahan
science	syensya
scientist	syentista
scientists	mga syentista
scissors	gunting
scold	mag isog
scope	katubtoban
score	karuhaan
scrap	basura
scratch	pag iskay
scream	guliat
screen	salipod
screw	turnilyo
script	iskrip
sea	dagat
seal	selyo
search	pamiling
season	panahon
seat	lingkuran
second	ikaduha
secret	sekreto
section	seksyon
secure	talwas
security	seguridad
see	kitaa
see you	magkita kita
see you later	magkita-kita na
see you soon	Magkita kita dayon
see you tomorrow	magkita kita buwas
seed	liso
seek	pamiling
seem	baga hin
seems	sugad hin
seen	nakita
seize	pagdakop
seizure	pagkisikisi
seldom	talagsa
select	pagpili
self	kalugaringon
self healing	pag-opay ha kalugaringon
selfish	makikalugaringon
sell	ibaligya
send	pagpadara
send me your picture	ipadara ha akon an imo retrato
sense	panhunahuna
sensible	maaramon
sensitive	sensitibo
sent	ginpadara
sentence	pulong
sentences	mga pulong
separate	bulag
september	setyembre
sequence	sunodsunod
series	serye
serious	seryoso
seriously	seryoso
serve	pag alagad
service	serbisyo
session	sesyon
set	butang
set	ibutang
set up	ginpatindog
setting	kahimtang
settle	pag ukoy
seven	pito
seventeen	napulo kag pito
seventy	kapitoan
several	pira
several	damo
severe	grabe
sew	gintahi
shade	lambong
shadow	lambong
shake	pag uyog
shall	kinahanglan
shallow	waray kahiladman
shame	awod
shape	porma
share	bahin
sharp	maaram
sharp	matarom
she	hiya
she has	may hiya
she is	hiya
shed	kamalig
sheep	karnero
sheet	tabla
shelf	estante
shell	balayan
shelter	panalipod
shield	panalipod
shift	pagbalhin
shine	naglamrag
ship	barko
shipping	pagpadara
shirt	kamiseta
shoes	sapatos
shoot	pusila
shop	tindahan
shopping	pagpalit
shore	baybayon
short	halipot
shortage	kakulang
shot	pusila
shot	pinusil
should	kinahanglan
shoulder	sugbong
shout	pag guliat
show	igpakita
show	pakita
show me	ipakita ha akon
shower	pagparigo
shower	uran
shrimp	pasayan
shrink	umondang
shut	ginsadhan
shut up	maghilom ka
shy	awdanon
sibling	bugto
siblings	magbugto
sick	masakit
side	ligid
sigh	panhayhay
sight	pagkita
sightseeing	pamasyada
sightseeing	pag kulaw
sign	tigaman
signature	pirma
significant	importante
silence	hilom
silent	hilom
silk	sida
silly	kalokohan
silver	plata
similar	pareho
simp	luko
simple	simple
simultaneously	durungan
since	tikang
sincere	sinsero
sincerely	sinsero
sing	pagkanta
singer	magkaranta
single	uusa la
single	waray asawa
sink	nalunod
sink	ilunod
sister	bugto nga babaye
sister in law	hipag
sit	lingkod
site	lugar
situation	kahimtang
six	unom
sixteen	napulo kag unom
sixty	kaunman
size	kadako
skill	abilidad
skills	mga abilidad
skin	panit
skinny	magasa
skip	lukso
skirt	saya
sky	langit
slave	uripon
sleep	pagkaturog
sleeping	naturog
sleepy	paghingaturog
sleeve	manggas
slice	paghiwa
slice	paghiwaa
slightly	hinay-hinay
slim	manipis
slip	hipatalindas
slope	bakilid
slot	puwang
slow	mahinay
slowly	hinay hinay
small	gutiay
smart	maaramon
smell	baho
smile	paghiyom
smile	hiyom
smoke	aso
smooth	mahamis
snack	meryenda
snail	suso
snake	halas
snap	nautod
snow	niyebe
so	salit
so cute	maopay gud
so far	tubtob yana
soak	paghurom
soap	sabon
sober	murayaw
social	sosyal
society	katilingban
socks	medyas
soft	malumo
soil	tuna
sold	ginbaligya
sold out	iginbaligya
soldier	sundalo
sole	rapadapa
solid	solido
solution	solusyon
solve	pagsulbad
some	pira
somebody	usa ka tawo
somehow	baga hin
someone	usa ka tawo
something	usa ka butang
sometimes	usahay
sometimes	danay
song	kanta
soon	harani na
soon	niyan
sophisticated	sopistikado
sore	masu-ol
sore	ginsuolan
sore throat	sakit ha but-ol
sorrow	kasubo
Sorry	Pasayloa
sort	klase
sought	ginbiling
soul	kalag
soulmate	bugto nga kalag
sound	tunog
soup	sabaw
sour	maaslom
source	gintikanan
south	sur
space	lugar
span	katubtoban
Spanish	kinatsila
spare	iginreserba
spare	ireserba
speak	pagyakan
special	espesyal
species	species
specific	espisipiko
spectacular	urusahon
speech	panyakan
speechless	diri nakakayakan
speed	kalaksi
spell	pagkasurat
spend	paggasto
spent	ginasto
spicy	maharang
spike	durho
spin	pagtuyok
spirit	espiritu
spit	linura
splendid	makaruruyag
split	pagbulaga
split	pagbulag
spoil	pagkadunot
spoiled	ginpabay-an
spontaneous	awtomatiko
spoon	kutsara
spot	lugar
spouse	asawa
spouse	bana
spread	ipasamwak
spread	ipahibaro
spread	ipadasig
spring	burabod
square	kwadrado
squeeze	pagpirit
squid	nuos
stab	nagtugob
stable	marig-on
stack	pagtirok
staff	mga empleyado
stage	yugto
stage	entablado
stain	mantsa
stairs	hagdanan
stake	taya
stalk	uhay
stall	kwadra
stamp	selyo
stand	pagtindog
stand	tindogi
standard	suruklan
star	bitoon
start	pagtikang
started	nagtikang
starving	gutom
state	estado
statement	ginsiring
station	istasyon
statue	estatwa
status	kahimtang
stay	magpabilin
stay	bilina
stay safe	magin luwas
steady	marig-on
steak	karne
steal	pangawat
steam	alisngaw
steel	asero
steep	bakilid
stem	sanga
step	hagdan
step	pitad
stiff	makusog
still	pirmi kalmado
still	kalmado
sting	malara
stingy	kuripot
stir	pag awas
stock	pundo
stolen	ginpangawat
stomach	tiyan
stone	bato
stood	natindog
stool	tungtongan
stop	paghunong
storage	bodega
store	tindahan
storm	bagyo
story	istorya
stove	kalan
stove	lutoan
straight	tadong
straightforward	pranka
strain	pag antos
strange	urusahon
stranger	estranghero
strategy	estratehiya
straw	uhot
streak	bagis
stream	sapa
street	kalsada
strength	kusog
stress	kaguol
stretch	pag unat
strict	istrikto
strike	kastigo
string	lubid
string	higot
strip	paghukas
strive	pagtinguha
stroke	atake
stroke	paghaplos
strong	makusog
struck	gintagan
structure	istruktura
struggle	kakurian
struggle	kurii
struggling	nakukurian
stubborn	matig-a an ulo
stuck	nadukot
stuck	nahiluho
student	estudyante
study	pag aram
study	pag admi
studying	pag aram
stuff	mga butang
stunning	urusahon
stunning	nakakadaku
stunning	mahusay
stupid	lurong
style	estilo
subject	butang
subject	sakop
subject	hintungod
submission	pagsumite
submit	magpasakop
submit	igsumat
substance	sustansya
substitute	ginliwanan
subtle	mahinay la
succeed	maglampos
success	kalamposan
successful	malampuson
such	sugad hini
such as	sugad hin
suck	magsupsop
sudden	tigda
suddenly	tigda
suffer	nag aantos
suffering	kakurian
suffering	pag antos
sufficient	igo
sugar	asukar
suggest	suhestyon
suggestion	suhestyon
suit	isul-ot
suit	sul-ot
suitable	angay
suitcase	maleta
sum	pagsuma
summary	sumaryo
summer	katpaso
summit	pungkay
sun	adlaw
sunday	domingo
sunny	masirak
sunset	katunod han adlaw
sunshine	adlaw
super	super
superior	labaw
supervisor	superbisor
supper	panihapon
supply	suplay
supply	suplayi
support	suporta
support	suportahi
suppose	hunahunaa
suppose	bangin la
supposed	ginlalaoman
sure	syempre
sure	sigurado
surface	bawbaw
surge	pagsulog
surgery	operasyon
surname	apelyido
surprise	sorpresa
surprised	nahipausa
surrender	pagtubyan
surrounding	palibot
surveillance	pagbantay
survey	surbey
survey	pagsurbey
survive	mabuhi
suspect	suspetsahi
suspect	suspetsa
suspended	pag undang
suspicious	nagsuspetsa
sustain	pagpadayon
sustainability	pagpadayon
sustainable	pagpapadayon
swallow	pagtulon
swap	pagbalyoay
swear	pagsumpa
sweat	balhas
sweater	panhagkot
sweep	pag anod
sweet	matam-is
sweet dreams	matam-is nga mga inop
sweet tooth	matam-is
sweetheart	hinigugma
swell	pag awas
swelling	nadako
swelling	nahubag
swim	paglangoy
swimming	paglangoy
swing	igduyan
swing	duyan
switch	balhin
switch	igbalhin
swollen	manhubag
sword	espada
symbol	simbolo
sympathy	pagpaid
symptoms	mga sintomas
system	sistema
table	lamesa
tackle	pag abre
tackle	pag atubang
tag	etiketa
tail	ikog
take	kuhaa
take	kuhaon
take away	kuhaon
take care	pag atamana
take off	tanggala
taken	ginkuha
talk	pagyakan
talk	yakan
talkative	mayakan
tall	hitaas
tap	tapika
tap	tapik
target	puntiryaha
target	puntirya
task	buruhaton
taste	rasahi
taste	rasa
tasty	marasa
taught	gintutdoan
tea	tsaa
teach	tutdo
teacher	magturutdo
team	grupo
tear	luha
tear	pag-gisi
tears	luha
tease	pagsunlog
technology	teknolohiya
teeth	ngipon
tell	pagsumat
tell me	sumati ako
temper	panhunahuna
temper	mapaso it ulo
temper	malipong it ulo
temperature	temperatura
temple	templo
temporary	temporaryo
ten	napulo
ten thousand	napulo ka yukot
tenant	umurukoy
tend	nagtitinguha
tendency	tendensya
tender	pagpaid
tense	tensyonado
tension	tensyon
tent	tolda
tentative	probisyonal
term	termino
terms	mga termino
terrible	makaharadlok
terrific	urusahon
territory	teritoryo
test	pagsari
test	pagsarihi
text	teksto
than	labaw pa
thank	salamat
thank you	salamat
Thank you for your patience while we investigate shipment	Salamat han iyo pagpailbo samtang gin uusia namon an kargamento
thank you so much	damo nga salamat
thank you very much	damo nga salamat
thanks	salamat
Thanks for using our app	Salamat ha paggamit han amon app
that	iton
that is	ito an
that's good	maopay ito
the	an
theft	kawatan
their	ira
them	ira
theme	tema
themselves	kalugaringon
then	kon sugad
theory	teorya
there	didto
there are	mayda
there is	may ada
therefore	salit
these	ini
they	nira
they	ira
they	hira
they are	hira
thick	madakmol
thief	kawatan
thigh	hita
thin	manipis
thing	butang
things	mga butang
think	paghunahuna
third	ikatulo
thirsty	uhaw
thirteen	napulo kag tulo
thirty	trenta
this	ini
this is	ini
thorough	bug-os
thoroughly	bug-os
those	ito
though	bisan
though	kun
thought	hunahunaa
thought	hunahuna
thoughtful	mahunahunaon
thoughts	mga hunahuna
thousand	yukot
thread	gahi
threat	pagtarhog
threaten	gintarhog
three	tulo
threshold	ganghaan
thrilled	nalilipay
thrive	pag uswag
throat	but-ol
through	ha
throughout	ha bug-os
throw	paglabay
thumb	tamuragko
thunder	dalugdog
Thursday	Huwebes
thus	sugad hini
tick	tulbok
tide	tubig
tidy	limpyo
tie	higoti
tie	higot
tiger	tigre
tight	hugot
time	oras
time	panahon
timid	awdonon
tiny	gudtiay
tire	kaliding
tired	kapoy
tired	binubotlaw
tissue	tisyu
title	titulo
to	ha
to be	magigin
toast	nakipagtagay
today	yana
toddler	bata
toes	tudlo
together	kaupod
toilet	kasilyas
told	ginsumatan
tolerance	pag antos
tolerate	nagtutugot
tomato	kamatis
tomorrow	buwas
tongue	dila
tonight	yana nga gab-i
too	liwat
took	ginkuha
tool	garamiton
tools	mga garamiton
tooth	ngipon
top	nahiuuna
top	kahitas-an
topic	tema
torn	gin gisi
torture	pasakitan
total	kabug-osan
touch	paghikap
tough	makusog
tough	makuri
tough	maisog
tour	paglibot
toward	tipakadto
towards	ngadto
towel	tualya
town	bungto
toxic	makahilo
trace	ginsusog
track	inaagian
trade	igbalyo
trade	makigbalyo
tradition	tradisyon
traditional	tradisyonal
traffic	trapik
trail	agianan
train	tren
training	pagbansay
trait	kinaiya
traits	mga kinaiya
transfer	pagbalhin
transition	pagbalhin
translate	paghubad
transparent	masilhag
transport	sarakyan
transportation	transportasyon
trap	lit-ag
trash	basura
trauma	kasakit
travel	pagbiyahe
treasure	bahandi
treat	pagtambal
treat	pagtratar
treatment	pagdumara
treatment	pagtambal
tree	kahoy
tremendous	daku gud
trend	uso
trial	pagsari
trial	paglitis
trick	limbong
tried	nagsari
tried	ginbista
trigger	pagtikang
trigger	pagtikangi
trim	pag arot
trip	biyahe
trouble	problema
trousers	saruwal
truck	trak
true	TINUOD
trunk	puno
trust	sarigi
trust	pagsaring
truth	kamatuoran
try	pangalimbasog
tube	tubo
Tuesday	Martes
tuition	matrikula
turmeric	dulaw
turn	paglingi
turtle	bao
tutor	magturutdo
twelve	napulo kagduha
twenty	karuhaan
twenty-one	karuhaan kag usa
twice	duha ka beses
twist	ginbaliko
two	duha
type	tipo
typical	tipikal
ugly	maraot
ugly	mapurot
ultimate	katapusan
umbrella	payong
unable	waray kapas
uncle	bata
unconscious	kawaray sarabotan
under	ha ubos
underneath	ubos
underneath	ilarom
underrated	gin ubos
understand	masabtan
understood	nasasabtan
unfortunately	ikasubo
uniform	uniporme
unique	talagsaon
unit	yunit
university	unibersidad
unknown	diri kilala
unless	gawas kon
until	tubtob
unusual	urusahon
up	alsa
up to you	imo ito
update	bag-oha
update	bag-o
upgrade	pagpauswag
upgrade	pauswaga
upon	ha
upset	nasusubo
urban	syudad
urge	pag aghata
urge	pag aghat
urgent	apurado
us	kita
use	gamita
use	gamiton
used	gin gamit
useful	mapulsanon
useless	waray pulos
usual	kasagaran
usually	agsob
usually	kasagaran
utility	gamit
vacation	bakasyon
vaccination	bakuna
vaccine	bakuna
vacuum	bakyum
vague	diri klaro
valid	makatadungan
valley	walog
valuable	importante
value	pahimulos
value	pahimulosi
variety	klase
various	iba-iba
vary	magkalainlain
vase	plorera
vast	daku
vegetable	utan
vegetables	mga utan
vehicle	sakyanan
vendor	parabaligya
venom	lara
venture	pagsapalaran
venue	lugar
verify	pag usisa
versatile	maabtik
version	bersyon
vertical	bertikal
very	gud
very good	maopay gud
vessel	sarakyan
vessel	barko
via	pinaagi
vibe	pag awas
vibes	pag awas
vicious	pagtimaraot
victim	biktima
view	pagkita
village	baryo
villain	magraot
vinegar	suoy
vintage	antigo
violence	kamadarahog
violent	madarahog
virgin	birhen
virtual	haros
virtue	pagkamaopay
vision	panan-awon
visit	bisita
visit	bisitaha
visual	handuraw
vital	importante
vivid	matin-aw
vocabulary	bokabularyo
voice	tingog
void	waray pulos
volume	kadaku
volunteer	boluntaryo
vomit	suka
vomit	pagsuka
vulnerable	maluya
wage	sweldo
wages	sweldo
wages	sahod
waist	hawak
wait	paghulat
waiter	paraserbi
waiting	naghuhulat
wake	magmata
wake up	pagmata
walk	lakat
walk	paglakat
walking	paglakat
wall	pader
wallet	pitaka
wander	paglinakat
wanna	karuyag
want	karuyag
wanted	ginbiling
war	gera
Waray	Waray
wardrobe	aparador
warehouse	bodega
warm	pasoa
warm	mapaso
warn	pahimangno
warning	pahimangno
warrior	girriro
was	nah
wash	paghugas
waste	basura
waste	ibasura
watch	pagkulaw
watch	pagbantay
water	tubig
watermelon	pakwan
wave	balud
wave	pag-para
way	paagi
way	dalan
we	kami
we are	kami ini
we can	mahimo naton
weak	maluya
weakness	kaluyahan
wealth	bahandi
wealthy	riko
wear	pagsul-ot
wearing	pagsul-ot
weather	panahon
wedding	kasal
Wednesday	Miyerkules
weed	banwa
week	semana
weekend	katapusan han semana
weight	bug-ati
weight	bug-at
weird	urusahon
welcome	maupay nga pag abot
welfare	kaopayan
Well	Maupay
well done	maopay nga buhat
went	kinadto
were	mga
west	katundan
wet	mahulos
whale	balyena
what	ano
what about you	kumusta ka man?
what are you doing	ano an imo ginbubuhat
what are you doing now	ano an imo ginbubuhat yana
what are you doing right now	ano an imo ginbubuhat yana
what do you do	ano an imo ginbubuhat
what do you do for a living	ano an imo trabaho
what do you mean	Ano an karuyag mo sidngon?
what do you want	ano imo karuyag
what happened	ano an nahitabo?
what is	ano an
what is this	ano ini
what is your job	ano imo trabaho
what is your name	ano an imo ngaran
what's up	ano an nahinabo
what's your name	ano imo ngaran
whatever	bisan ano
wheat	trigo
wheel	kaliding
when	kan-o
whenever	bisan san-o
where	diin
where are you	hain ka
where are you from	taga diin ka
where are you now	hain ka yana?
where do you live	diin ka naukoy
where is	hain na
whereas	nga
whether	kon
which	nga
which	hain
while	samtang
whisper	paghinuring
whistle	silbato
whistle	nagtaghoy
white	puti
who	hin-o
who are you	hin-o ka?
who is	hin-o an
who is this	hin-o ini
whole	ngatanan
whole	bug-os
whom	kanay
whose	kan kanay
why	kay ano
why not	kay ano nga diri
wicked	maraot
wide	halapad
wide	haluag
widow	balo nga babaye
width	kahilapad
wife	asawa
wild	layaw
wild	ihalas
will	determinasyon
will	magin dereminado
willing	andam
win	pagdaog
wind	hangin
window	bintana
windy	mahangin
wine	bino
winter	kathagkot
wipe	pagpahid
wire	kable
wisdom	kinaadman
wise	maaramon
wish	tinguha
wish	tinguha-a
wish you all the best	hangyo ko ha iyo han ngatanan nga kaopayan
witch	aswang
with	nga may
withdraw	pagbaya
withdraw	pagkuha
withdrawal	pag atras
within	ha sulod
without	waray
witness	igtestigo
witness	testigo
witty	pagpasulay
wolf	lobo
woman	babaye
women	kababayin-an
won	nagdaog
won't	diri
wonder	paghipausa
wonderful	urusahon
wood	kahoy
wool	lana
word	pulong
words	mga pulong
work	trabaho
work	trabahoa
work out	pag ehersisyo
working	nagtatrabaho
world	kalibotan
worm	ulod
worn	nagamit
worried	nababaraka
worry	kabaraka
worse	mas maraot pa
worship	pagsingba
worst	pinakagrabe
worth	pulos
worth	puros
worth it	takos ito
worthy	takos
would	magigin
would	bangin la
wound	samad
wrap	pagputos
wrath	kasina
wrist	purso
write	pagsurat
Write here	Isurat dinhi
writing	panurat
written	sinurat
wrong	sayop
wrote	nagsurat
yard	bungsaran
yawn	paghuyam
yawn	huyam
Yeah	Oo
Yeah	Asya
year	tuig
years	mga tuig
yeast	lebadura
yell	guliatan
yellow	dulaw
Yes	Oo
yes baby	oo baying
yes dear	oo arog
yes honey	oo hinigugma
yes my love	oo hinigugma ko
yes of course	oo syempre
yesterday	kakulop
yet	pero
yet	bisan pa
yield	abot
you	ikaw
you are	ikaw
you are beautiful	mahusay ka
you are so beautiful	matahom ka gud
you are welcome	Gina-aabiabi ka
you can	mahimo mo
You know	Maaram ka
you too	ikaw daman
you're welcome	gin aabiabi ka
young	batan-on
your	imo
your welcome	imo pagkarawat
yourself	imo kalugaringon
youth	batan-on
you’re welcome	waray sapayan
yummy	marasa
zero	waray
