Ein	a
eitt sindur	a little
ein rúgva	a lot
eina rúgvu	a lot
ein rúgva av	a lot of
sleppa	abandon
oyðin	abandoned
vera verandi	abide
førleiki	ability
førur	able
kring	about
um	about
omanfyri	above
uppiyvir	above
uttanlands	abroad
frávera	absence
frávernadi	absent
avgjørt	absolutely
súgva upp í seg	absorb
samandráttur	abstract
skilaleyst	absurd
yvirflóð	abundance
ríkiligur	abundant
misnýta	abuse
máldámur	accent
góðkenna	accept
góðtaka	accept
atgongd	access
vanlukka	accident
eftirlaging	accommodation
avrika	accomplish
gávuríkur	accomplished
sambært	according
konta	account
neyvleiki	accuracy
neyvt	accurate
ákærdur	accused
pína	ache
fremja	achieve
útynna	achieve
útynning	achievement
viðganga	acknowledge
kennskapur	acquaintance
fáa	acquire
fingin	acquired
ognir	acquisition
yvir um	across
tvørtur um	across
tvørtur ígjøgnum	across
verk	act
gerð	action
virkin	active
virksemi	activities
virksemi	activity
sjonleikari	actor
veruligur	actual
í roynd og veru	actually
veruliga	actually
spískur	acute
gera til	adapt
leggja avtrat	add
bundin	addicted
uppískoyti	addition
eyka	additional
bústaður	address
adressa	address
nóg mikil	adequate
grannæstur	adjacent
lýsingarorð	adjective
skipa	adjust
hámeta	admire
viðganga	admit
ættleiða	adopt
undurvakur	adorable
hugtakandi	adorable
framstig	advance
framkomin	advanced
fyrimunur	advantage
ævintýr	adventure
hjáorð	adverb
lýsing	advertisement
lýsing	advertising
ráð	advice
ráð	advise
talsmaður	advocate
fagurfrøðiligur	aesthetic
mál	affair
ávrka	affect
alskur	affection
hava ráð til	afford
hava ráðini til	afford
rímuligur prísur	affordable
bangin	afraid
efitr	after
seinnapartur	afternoon
aftaná	afterwards
aftur	again
ímóti	against
aldur	age
umboð	agency
umboðsmaður	agent
ágangandi	aggressive
kvikur	agile
síðan	ago
taka undir við	agree
avtala	agreement
landbúnaður	agriculture
frammanfyri	ahead
hjálp	aid
miða	aim
luft	air
flogvøllur	airport
gangur millum stólarøðir	aisle
ávaring	alarm
alkohol	alcohol
fyribúgva	alert
alvakin	alert
livandi	alive
altíð	all
í lagi	all right
alt tað besta	all the best
loyva	allow
loyva	allowed
nærum	almost
einsamallur	alone
við	along
longu	already
í lagi	Alright
í ordan	Alright
við	also
eisini	also
val	alternative
tó at	although
hóast	although
tó	although
altíð	always
eri	am
ótrúligt	amazing
tvítýddur	ambiguous
framsøkni	ambition
ærusjúkur	ambitious
rætta	amend
mitt í	amid
ímillum	among
millum okkara	among us
mongd	amount
undirhaldandi	amusing
ein	an
greining	analysis
forfedrar	ancestors
akker	anchor
gamal	ancient
avgamal	ancient
og	and
eisini tú	and you
og tú	and you
eingil	angel
vreiði	anger
vinkul	angle
óður	angry
djór	animal
økil	ankle
ársdagur	anniversary
lýsing	announcement
órógva	annoy
argur	annoyed
ótolandi	annoying
argiligur	annoying
árligur	annual
dulnevndur	anonymous
ein annar	another
onkur annar	another
svara	answer
svar	answer
vænta	anticipate
ótti	anxiety
fjálturstungin	anxious
bangin	anxious
nakar	any
ein og hvør	any
hvør	any
longur	anymore
meiri	anymore
ein oghvør	anyone
nakað	anything
kortini	anyway
í hvussu er	anyway
onkursvegna	anyway
á ongan hátt	anyways
burturfrá	apart
íbúð	apartment
umbera	apologize
eyðsæð	apparent
eyðsýniliga	apparently
ákallan	appeal
daga undan	appear
koma fram	appear
koma undan	appear
útsjónd	appearance
framkoma	appearance
koma	appearance
kom til sjóndar	appeared
matarhugur	appetite
súrepli	apple
umsókn	application
søkja	apply
avtala	appointment
hámeta	appreciate
meta høgt	appreciate
meta	appreciate
viðurkenning	appreciation
koma	approach
hóskandi	appropriate
undirtøka	approval
taka undir við	approve
viðurkendur	approved
umleið	approximately
apríl	april
tilivldarligur	arbitrary
arkitektur	architect
arkitekturur	architecture
skráseta	archive
er	are
er tú	are you
er tú upptikin	are you busy
er tú giftur	are you married
er tí gift	are you married
er tú giftur ella stakur	are you married or single
Er tú framvegis har?	Are you still there?
er tú har	are you there
øki	area
træta	argue
próvgrund	argument
koma í	arise
armur	arm
herur	army
kring	around
skipa	arrange
skipan	arrangement
koma einum undir	arrival
koma fram	arrive
komin	arrived
hugmóðligur	arrogant
ørvur	arrow
list	art
grein	article
tilgjørdur	artificial
listafólk	artist
sum	as
eins	as
í	as
so leingi sum	as long as
eins og	as well
eins og	as well as
askur	ash
forskammaður	ashamed
spyrja	ask
spurdi	asked
svevur	asleep
ásjón	aspect
Assamese	Assamese
snarálop	assault
samkoma	assembly
tvørur	assertive
meta um	assess
skatting	assessment
skattaálíknan	assessment
ognir	asset
ognir	assets
áseta	assign
tilluting	assignment
avhending	assignment
hjálpa til	assist
hjálparfólk	assistant
feagi	associate
vinmaður	associate
vinir	associated
felag	association
taka	assume
átaka	assume
taka sær	assume
hugsan	assumption
hjá	at
í	at
í minsta lagi	at least
át	ate
ítróttarmaður	athlete
festa	attach
festur	attached
viðfest fylgiskjal	attachment
álop	attack
roynd	attempt
luttaka	attend
hjávera	attendance
nærvera	attendance
gætur	attention
far	attention
støða	attitude
hugburður	attitude
draga at sær	attract
atdráttarmegi	attraction
dámligur	attractive
eginleiki	attribute
áskoðari	audience
august	august
pápasystir	aunt
mammusystir	aunt
fastir	aunty
sannur	authentic
høvundur	author
mynduleiki	authority
heyst	autumn
tøkur	available
til taks	available
miðal	average
miðaltal	average
sleppa sær undan	avoid
vakin	awake
samsýna	award
varugur	aware
vitan	awareness
burtur	away
hátt virdur	awesome
øgiligur	awesome
virdur	awesome
øgiligur	awful
smæðin	awkward
lorkutur	awkward
klombrutur	awkward
Aymara	Aymara
pinkubarn	baby
smábarn	baby
nýføðingur	baby
gamal drongur	bachelor
aftur	back
ryggur	back
bak	back
baksýni	background
vánaligur	bad
ringur	bad
taska	bag
agn	bait
baka	bake
bakarí	bakery
natron	baking soda
javnvág	balance
bóltur	ball
Bambara	Bambara
banan	banana
band	band
brak	bang
slag	bang
peningastovnur	bank
barr	bar
valla	barely
neyvan	barely
handil	bargain
goyggja	bark
neyvan	barley
bummur	barrier
byrging	barrier
grund	base
staðsettur	based
kjallari	basement
grundleggjandi	basic
í grundini	basically
basilikum	basil
beist	bastard
bunki	batch
bakstur	batch
bað	bath
baðirúm	bathroom
battarí	battery
bardagi	battle
vík	bay
vera	be
ansa tær	be careful
strond	beach
biti	beam
bønir	beans
bjørn	bear
skegg	beard
hugburður	bearing
beist	beast
buka	beat
vakurt	beautiful
vakur	beautiful
vøkur	beautiful
vakurleiki	beauty
gjærdist	became
tíð	because
gerast	become
song	bed
kamar	bedroom
býfluga	bee
búffur	beef
hevur verið	been
bjørn	beer
áðrenn	before
byrjaði	began
byrja	begin
byrjan	beginning
fyri hann	behalf
skikka sær	behave
atburður	behavior
atburður	behaviour
aftanfyri	behind
verða verandi	being
vera	being
sannføring	belief
trúgva	believe
búkur	belly
hoyra til	belong
elskaður	beloved
undir	below
belit	belt
bonkur	bench
bogi	bend
undir	beneath
fyrimunur	benefit
fyrimunur	benefits
við síðuna av	beside
umframt	besides
best	best
bestu eydnu	best of luck
bestu heilsur	best regards
kærar heilsur	best regards
bøta um	better
betra	better
millum	between
ímillum	between
drykkur	beverage
handan	beyond
fyri handan	beyond
Bhojpuri	Bhojpuri
fordómur	bias
skráskurður	bias
partískur	biased
súkkla	bicycle
boð	bid
stórur	big
súkkla	bike
rokning	bill
band	bind
fuglur	bird
føðingardagur	birthday
biti	bit
petti	bit
biti	bite
bíta	bite
beiskur	bitter
svartur	black
blað	blade
ákæra	blame
glopp	blank
teppi	blanket
hvirla	blast
bleikja	bleach
blanda seg við	blend
vælsigna	bless
signaður	blessed
blindur	blind
sæla	bliss
kubbi	block
blóð	blood
blóma	bloom
blása	blow
blátt	blue
óhvassur	blunt
borð	board
fara umborð	board
bátur	boat
kroppur	body
kóka	boil
djarvur	bold
óræddur	bold
band	bond
bein	bone
bók	book
lyft	boost
kraftøkjari	booster
stivli	boot
stivlar	boots
mark	border
keðsemi	bore
keðir seg	bored
keðiligt	boring
føddur	born
læna	borrow
stjóri	boss
bæði	both
plága	bother
hávi	bother
ampi	bother
fløska	bottle
grundarlag	bottom
grund	bottom
botnur	bottom
keypti	bought
spring	bounce
mark	bound
mørk	boundaries
bukka	bow
skál	bowl
eskja	box
drongur	boy
unnusti	boyfriend
armband	bracelet
heili	brain
grein	branch
merkisvøra	brand
djarvur	brave
brot	breach
breyð	bread
bróta	break
morgunmatur	breakfast
bringa	breast
bróst	breast
andi	breath
anda	breathe
aling	breed
múrsteinur	brick
brúður	bride
brúgv	bridge
stutt	brief
ljóst	bright
avbært	brilliant
koma við	bring
bera	bring
vinmaður	bro
flógvi	broad
varpa út	broadcast
brotið	broke
brotin	broken
kustur	broom
bróður	brother
beiggi	brother
svágur	brother in law
kom við	brought
brúnur	brown
busta	brush
spann	bucket
vinur	buddy
fíggjarætlan	budget
skordýr	bug
byggja	build
bygningur	building
bygdi	built
stødd	bulk
tarvur	bull
bølmenni	bully
slag	bump
bundi	bunch
knýti	bundle
bundi	bundle
byrða	burden
grivin	buried
brenna	burn
spreinging	burst
jarða	bury
bussur	bus
runnur	bush
handilsskapur	business
handil	business
bringumynd	bust
íðin	busy
stríðast við	busy
men	but
smør	butter
firvaldur	butterfly
knappur	button
keypa	buy
við	by
framvið	by
melda pass	by
annars	by the way
farvæl	bye
kál	cabbage
kamar	cabinet
hola	cage
køka	cake
kálvur	calf
rópa	call
uppkall	call
róp	call
ring til mín	call me
ringdi	called
rógv	calm
ró	calm
kvirra	calm
kom	came
herferð	campaign
fáa loyvi til	can
kunna	can
vera førur fyri	can
kann ikki	can't
strika	Cancel
gera til onkis	Cancel
krabbamein	cancer
førur	capable
føri	capacity
høvuðsstaður	capital
yvirskrift	caption
fanga	capture
bilur	car
starv	career
varliga	careful
varisliga	carefully
líkasælur	careless
umsorgan	caring
timburmaður	carpenter
teppi	carpet
gularót	carrot
bera	carry
halt á	carry on
liðugur rættur	carry out
føri	case
tilburður	case
reiður peningur	cash
kast	cast
slott	castle
tilvildarligur	casual
ketta	cat
køttur	cat
fangaði	catch
flokkur	category
neyt	cattle
fangaði	caught
orsøk	cause
grund	cause
orsøki	cause
varni	caution
varin	cautious
hola	cave
steðga	cease
loft	ceiling
hátíðarhalda	celebrate
kykna	cell
miðseta	center
øld	century
korn	cereal
halgisiður	ceremony
vissur	certain
ivaleyst	certainly
vist	certainly
við vissu	certainly
prógv	certificate
keta	chain
stólur	chair
avbjóðing	challenge
møguleiki	chance
broyta	change
ruðuleiki	chaos
náttúra	character
eyðkenni	characteristics
útreiðslur	charge
løða	charge
skuldseting	charge
vælgerð	charity
hugtakandi	charming
sjókort	chart
jagstra	chase
prát	chat
bíligur	cheap
ódýrur	cheap
snýta	cheat
sviking	cheating
kekkur	check
forðing	check
skjálki	cheek
fagnaðarróp	cheer
glaður	cheerful
skál	cheers
ostur	cheese
evnafrøði	chemistry
verja um	cherish
talv	chess
bringa	chest
tyggja	chew
høsnarungi	chicken
høvdingi	chief
barn	child
barndómur	childhood
børn	children
kuldi	chill
krím	chill
skorsteinar	chimneys
kjálki	chin
skjokláta	chocolate
val	choice
velja	choose
slag	chop
uppgávur	chores
køggutur	chubby
kirkja	church
kanel	cinnamon
ringrás	circle
umstøður	circumstances
borgari	citizen
býur	city
uppáhald	claim
krav	claim
klárna	clarify
klára	clarify
flokkur	class
leir	clay
reinur	clean
rudda	clear
reinsa	clear
skrivari	clerk
klókur	clever
viðskiftafólk	client
berg	cliff
umhvørvi	climate
klatra	climb
halda fast	clingy
klokka	clock
lata aftur	close
skáp	closet
klútur	cloth
klæði	clothes
skýggj	cloud
skýggja	cloudy
íspegil	clown
spor	clue
klombrutur	clumsy
bólkur	cluster
venjari	coach
lærari	coach
kol	coal
strond	coast
frakki	coat
kaffi	coffee
fatanarligur	cognitive
tilvildarliga	coincidence
kaldur	cold
kalt	cold
falla saman	collapse
kragi	collar
samstarvsfelagi	colleague
samstarvsfelagi	colleagues
innsavning	collect
savn	collection
læristovnur	college
litur	color
litleys grøn hugskot svóvu í øðini	colorless green ideas slept furiously
litur	colour
súla	column
greiða	comb
samanseting	combination
sameina	combine
koma	come
kom higar	come here
kom nú	come on
trpyst	comfort
hugnaligur	comfortable
makligur	comfortable
fýsligur	comfortable
komandi	coming
kemur skjótt	coming soon
komi skj´tt	coming soon
boð	command
viðmerking	comment
lýsing	commercial
starv	commission
binda seg til	commit
avhending	commitment
bundin	committed
vøra	commodity
vanligt	common
samskifta	communicate
samskifti	communication
samfelag	community
pendla	commute
felagi	companion
samvera	company
vertskapur	company
samanbera	compare
samanbering	comparison
samhugi	compassion
samkennandi	compassionate
sameinast	compatible
kappast	compete
dugnaligur	competent
førur fyri	competent
kapping	competition
stríðandi	competitive
klaga	complain
klaga	complaint
fullgerð	complement
fullgera	complete
fullfíggja	complete
fullkomuliga	completely
heild	complex
semja	compliance
torskilt	complicated
fagurorð	compliment
lata sær eftirlíka	comply
samanseting	composition
blandingur	compound
fatan	comprehension
drúgvur	comprehensive
neyðsemja	compromise
tvingaður	compulsory
telda	computer
miðsavna	concentrate
hugtakandi	concept
mál	concern
søk	concern
viðurskifti	concern
áhugaður	concerned
stúrin	concerned
konsert	concert
niðurstøða	conclusion
betong	concrete
treyt	condition
støða	condition
standur	condition
leiðslur	conditions
førsla	conduct
ráðstevna	conference
viðganga	confess
álit	confidence
sannførdur	confident
ivaleysur	confident
vátta	confirm
orrusta	conflict
ráðaleysur	confused
ørkymlaður	confused
ógreiða	confusion
tillukku	congrats
tillukku	congratulation
tillukku	congratulations
samband	conjunction
sambinda	connect
vinna á	conquer
tilvitaður	conscious
tivit	consciousness
samstykki	consent
játtan	consent
avleiðingar	consequences
friðing	conservation
umsiting	conservation
siðbundin	conservative
umhugsa	consider
umhugsa	considered
vera úr	consist
sambæri	consistency
sambærur	consistent
áhaldandi	constant
støðugur	constantly
hart lív	constipation
bygging	construction
brúka	consume
brúk	consumption
samband	contact
smittandi	contagious
innihalda	contain
innihalda	contains
samtíðar	contemporary
vanvirðing	contempt
innhihald	content
styrkiroynd	contest
samanhangur	context
meginland	continent
halda á fram	continue
sáttmáli	contract
mótsetningur	contrast
veita	contribute
íkast	contribution
vald	control
sum ósemja er um	controversial
hentleiki	convenience
hentur	convenient
hóskandi	convenient
samrøða	conversation
trúarskiftingur	convert
flyta	convey
sannføra	convince
sannførdur	convinced
matgera	cook
matgerða	cooking
óført	cool
kul	cool
samarbeiði	cooperation
vera mentur	cope
kopar	copper
tað innasta	core
korn	corn
horn	corner
rætta	correct
kostnaður	cost
útreiðslur	cost
búni	costume
smátta	cottage
silkibummull	cotton
sofa	couch
hosta	cough
kundi	could
umboðsráð	council
telja	count
mótvirka	counter
land	country
bygdarlag	countryside
par	couple
dirvi	courage
gongd	course
skeið	course
rættur	court
kurteisi	courtesy
systkinabarn	cousin
áklæði	cover
kúgv	cow
ræðuskítur	coward
hugnaligur	cozy
krabbi	crab
riva	crack
handverk	craft
lortur	crap
brak	crash
tráan	craving
grulva	crawl
ørur	crazy
skapa	create
skapandi	creative
álit	credit
krúpan	creep
andstyggiligt fólk	creep
óhugnaligur	creepy
manning	crew
brotsgerð	crime
kreppa tærnar	cringe
krøkja seg saman	cringe
krúpa saman	cringe
kreppa	crisis
eyðkenni	criteria
vandin	critical
atfinning	criticism
kjós	crop
avgrøði	crops
krossur	cross
kráka	crow
mannamongd	crowd
ovfyltur	crowded
krúna	crown
týdningarmikið	crucial
óreinur	cruel
langferð	cruise
knasan	crush
knúsan	crush
gresjan	crush
gráta	cry
agurk	cucumber
klemmast	cuddle
mentan	culture
snildur	cunning
koppur	cup
skáp	cupboard
teymur	curb
viðgerð	cure
útgongubann	curfew
forvitni	curiosity
forvitin	curious
purlutur	curly
umferð	currency
streymur	current
rák	current
í løtuni	currently
alsamt	currently
banning	curse
gardina	curtain
koddi	cushion
skikkur	custom
viðskiftafólk	customer
tollur	customs
klippa	cut
skera	cut
fittur	cute
snildur	cute
listinlærdur	cute
súkkla	cycle
súkkling	cycling
pápi	dad
babba	daddy
pápi	daddy
dagliga	daily
mjólkavirki	dairy
byrging	dam
skaði	damage
illbøn	damn
eiður	damn
rai	damp
dansur	dance
vandi	danger
vandamikil	dangerous
myrkur	dark
unnusti	darling
eygnasteinur	darling
skattur	darling
slag	dash
sannroyndir	data
tíð	date
dagur í mánaðinum	date
dadla	date
dóttir	daughter
dagur	day
deyður	dead
evstamark	deadline
deyvur	deaf
avtala	deal
elskaði	dear
kæri	dear
góði	dear
góðu tit øll	Dear All
Góða viðskiftafólk	Dear Customer
Góðu foreldur	Dear Parents
Góð	Dear Sir
Góðu lesandi	Dear students
Góða toymi	Dear Team
deyði	death
kjak	debate
skuld	debit
leivdir	debris
skuld	debt
áratíggju	decade
órøkt	decay
deyður	deceased
svikja	deceive
desembur	december
sámilgur	decent
avgerða	decide
avgjørdi	decided
avgerð	decision
dekk	deck
afturgongd	decline
lækking	decrease
halgaður	dedicated
halgan	dedication
verktakari	deed
djúp	deep
kæri	deer
vansketni	default
vanrøkt	default
ósigur	defeat
verja	defend
greiða frá	define
avgjørt	definitely
ásetan	definition
stig	degree
tarn	delay
seinkað	delayed
strúka burtur	delete
umráða seg	deliberate
fínligur	delicate
leskiligt	delicious
lekkurt	delicious
deiggj	delight
glaður	delighted
bera	deliver
úborið	delivered
avhending	delivery
krevja	demand
krevjandi	demanding
fólkaræði	democracy
illur andi	demon
mótmæla	demonstrate
sýna fram	demonstrate
sýtttur	denied
tættleiki	density
tannlækni	dentist
nokta	deny
súta	deny
deild	department
fráferð	departure
treytað av	depend
spjaða	deploy
trygdarfæ	deposit
tungur í huga	depressed
tunglyndi	depression
dýpd	depth
lýsa	describe
frágreiðing	description
lýsing	description
oyðimørk	desert
uppiborið	deserve
snið	design
navn	designation
brell	desire
ynski	desire
hugur	desire
skriviborð	desk
vónloysi	despair
vónleysur	desperate
hoast	despite
omaná	dessert
mál	destination
lagna	destiny
oyðileggja	destroy
oyðilegging	destruction
staklutur	detail
staklutir	details
varnast	detect
avgerð	determination
gera av	determine
taka avgerð um	determine
avgjørdur	determined
oyða	devastated
menna	develop
verktakari	developed
gongd	development
menning	development
íkoma	development
amboð	device
uppfinning	device
tól	device
djevul	devil
trúfastur	devoted
Dhivehi	Dhivehi
sukursjúka	diabetes
leyst lív	diarrhea
dagbók	diary
orðabók	dictionary
gjørdi	did
doyggja	die
doyði	died
kostur	diet
munur	difference
ørðvísi	different
trupult	difficult
grava	dig
virðing	dignity
íðin	diligent
døgverði	dinner
dypp	dip
beinleiðis	direct
leið	direction
leiðari	director
skittur	dirt
Skitin	dirty
gera óarbeiðsføran	disable
avlamin	disabled
hvørva	disappear
vónsvikin	disappointed
vanlukka	disaster
vrakaður lutur	discard
úttøming	discharge
læra	discipline
avsláttur	discount
varnast	discover
mannamunur	discrimination
trætast	discuss
kjak	discussion
sótt	disease
sjúka	disease
sjúkdómur	disease
sjúkur	diseases
dularbúni	disguise
andstyggiligur	disgusting
rættur	dish
tallerkar	dishes
rættir	dishes
senda heim	dismiss
sending	dispatch
sýna fram	display
ræði	disposal
stríð	dispute
fjarstøða	distance
týðiligur	distinct
skilja	distinguish
neyð	distress
útbýting	distribution
øki	district
órógva	disturb
veit	ditch
grøv	ditch
kava	dive
ólíkur	diverse
fjølbroytni	diversity
skilja	divide
guddómligur	divine
hjúnaskilnaður	divorce
svimbul	dizzy
ger	do
ger tú	do you
elskar tú meg	do you love me
lækni	doctor
skjal	document
ger	does
ger ikki	doesn't
hundur	dog
Dogri	Dogri
gerð	doing
dukka	doll
ríki	domain
hús	domestic
ráðandi	dominant
ikki	don't
ikki hugsa um tað	Don't worry
veita	donate
geva	donate
liðugur	done
gjørdur	done
asni	donkey
doyvingarevni	dope
dupult	double
ivi	doubt
dieggj	dough
niðurgongd	down
taka niður	download
niðurtøka	download
tekna	draft
stríð	drag
tøma	drain
harmleikur	drama
tekna	draw
skuffa	drawer
tekning	drawing
ræðsla	dread
dreymur	dream
kjóli	dress
bora	drill
drikkur	drink
koyra	drive
missa	drop
mist	dropped
turkur	drought
fullur	drunk
ávirkaður	drunk
turrur	dry
dunna	duck
knassi	dude
stavnur	dude
jassur	dude
ið hansara er	due
geva honum tað	due
sambært	due to
doyva	dull
káma	dull
býttur	dumb
ruskpláss	dump
tíðarbil	duration
undir	during
meðan	during
støv	dust
skylda	duty
dvøjla	dwell
doyggjandi	dying
hvør einstakur	each
hvør	each
hvør sær	each
hønn annan	each other
ágrýtin	eager
ørn	eagle
oyra	ear
fyrr	earlier
tíðliga	early
tæna	earn
oyru	ears
jørð	earth
jarðskjálvti	earthquake
hugnaður	ease
lættliga	easily
eystur	east
lætt	easy
eta	eat
et	eat
etur	eating
fíggjarligur	economic
búskapur	economy
egg	edge
ritstjórnan	edit
rætta	edit
útbúgving	education
ávirkan	effect
virkin	effective
virkni	efficiency
virkin	efficient
stríð	effort
strev	effort
baks	effort
egg	egg
aubergina	eggplant
eg	ego
átta	eight
átjan	eighteen
áttati	eighty
annar	either
hvør	either
onnur	either
evna til	elaborate
albogi	elbow
eldri persónur	elder
eldri	elderly
fínur	elegant
lutur	element
fílur	elephant
ellivu	eleven
vælbarur	eligible
sleppa av við	eliminate
ella	else
annar	else
annars	else
foyur	embarrassed
smæðin	embarrassed
snópisligur	embarrassing
fevna	embrace
koma undan kavi	emerge
stingast upp	emerge
neyðstøða	emergency
kenslusamur	emotional
innlivan	empathy
áhreðsla	emphasis
leggja dent á	emphasize
starvsfólk	employee
starvsfólk	employees
arbeiðsgevari	employer
arbeði	employment
tøma	empty
gera føran fyri	enable
fundur	encounter
eggja	encourage
endi	end
komin í vanda	endangered
roynd	endeavor
treysti	endurance
halda á	endure
fíggindi	enemy
orka	energy
binda seg	engage
trúlovaður	engaged
skylda	engagement
motorur	engine
verkfrøðingur	engineer
Enskt	English
hækka	enhance
stuttleika sær við	enjoy
njóta	enjoy
ómetaliga stórur	enormous
ómetaligur	enormous
nóg mikið	enough
tryggja	ensure
fara í	enter
undirhald	entertainment
eldhugi	enthusiasm
eldhugaður	enthusiastic
allur	entire
heilur	entire
hevur rætt til	entitled
veran	entity
inngongd	entrance
arbeiðstakari	entrepreneur
brævbjálvi	envelope
umhvørvi	environment
øvunda	envy
episkt	epic
farsótt	epidemic
eins	equal
útgerð	equipment
útbúnaður	equipment
rættvísi	equity
javngildur	equivalent
viskileður	eraser
feilur	error
rýma	escape
serliga	especially
stutt ritgerð	essay
ritroynd	essay
kjarni	essence
kjarni	essential
høvuðstáttur	essential
stovna	establish
viðurkendur	established
góðs	estate
meting	estimate
mett at vera	estimated
osfr	etc
ævigur	eternal
siðalæra	ethics
meta	evaluate
meting	evaluation
enntá	even
sjálvt	even
tó so	even though
kvøld	evening
tiltak	event
at enda	eventually
endiliga	eventually
nakrantíð	ever
hvør	every
øll	everybody
øll	everyone
alt	everything
prógv	evidence
vitnisfrágreiðing	evidence
vitnisburður	evidence
óreinur	evil
lívmenning	evolution
menna	evolve
Ewe	Ewe
latið	ex
beinrakin	exact
akkurát	exactly
neyvt	exactly
netupp	exactly
próvtøka	exam
kanna	examine
dømi	example
bera av	exceed
frmúr	excellent
vænta	except
undantak	exception
avlop	excess
ómetaligur	excessive
skifti	exchange
spentur	excited
spenningur	excitement
spennandi	exciting
einasta	exclusive
einasti	exclusive
umbering	excuse
orsaka meg	excuse me
útinna	execute
útinning	execution
stjóri	executive
venjing	exercise
útblástur	exhaust
tømdur	exhausted
framsýning	exhibit
framsýningarlutur	exhibit
framsýning	exhibition
vera til	exist
tilvera	existence
sum eru	existing
útgongd	exit
víðka	expand
vænta	expect
væntaður	expected
útreiðslur	expenses
dýrt	expensive
royndir	experience
roynd	experience
roynd	experiment
serfrøðingur	expert
útgingið	expired
greiða frá	explain
frágreiðing	explanation
roysni	exploit
rannsaka	explore
útflutningur	export
koma einum undir	expose
sjónligur	exposed
at vera fyri	exposure
siga	express
snarboð	express
máliska	expression
víðka	extend
útrættur	extended
víðkan	extension
vídd	extent
ytri	external
slóknaður	extinct
eyka	extra
úrdráttur	extract
ómetaligur	extraordinary
útmark	extreme
ógvuliga	extremely
eyga	eye
eygu	eyes
klæði	fabric
sagnkendur	fabulous
andlit	face
lætta um	facilitate
hjálparlutir	facilities
dugnaskapur	facility
sannroynd	fact
táttur	factor
virki	factory
royndur lutur	facts
følna	fade
heyst	fail
miseydnað	failed
feilur	failure
svíma	faint
marknaður	fair
klára í	fair
klárna	fair
rættvísiliga	fairly
álvur	fairy
trúgva	faith
trúgvur	faithful
falskur	fake
detta	fall
heyst	fall
FALSKUR	false
mæti	fame
kendur	familiar
familja	family
kvinnulig	famine
kendur	famous
veittra	fan
fjeppari	fan
ímyndarevni	fancy
hugflog	fancy
tokki	fancy
ótrúligur	fantastic
fjarur	far
fjarlagdur	far
farvæl	farewell
garður	farm
bóndi	farmer
Føroysk	Faroese
hugtakandi	fascinating
móti	fashion
skjótur	fast
feitur	fat
drepandi	fatal
lagna	fate
pápi	father
faðir	father
máttloysi	fatigue
ekkamøði	fatigue
feilur	fault
yndis	favorite
tænasta	favour
yndis	favourite
ottast fyri	fear
ótti	fear
gidli	feast
fjøður	feather
sermerki	feature
andlitsbragd	feature
andlitsskap	features
sermerki	features
andlitsbragd	features
februar	february
hevur fingið nóg mikið	fed up
gjald	fee
fóðra	feed
geva mat	feed
afturgerð	feedback
kenna	feel
kensla	feeling
føtur	feet
datt	fell
maður	fellow
kendi	felt
kvinna	female
garður	fence
burðardygg	fertile
festivalur	festival
fanga	fetch
fepur	fever
fá	few
færri	fewer
unnusti	fiance
fagrar bókmentir	fiction
jørð	field
bøur	field
mark	field
villur	fierce
fimtan	fifteen
fimmti	fifty
berjast	fight
bardagi	fight
bardagar	fighting
skap	figure
mynd	figure
finna útav	figure out
loysa	figure out
fíla	file
fylla	fill
fyltur	filled
filmur	film
skitin	filthy
at enda	finally
endiliga	finally
loksins	finally
fígging	finance
fíggjarligur	financial
finna	find
finn útav	find out
fá greiðu á	find out
reinur	fine
vakur	fine
fínur	fine
fingur	finger
gera liðugt	finish
liðugur	finished
eldur	fire
virki	firm
fyrst	first
fornavn	first name
fiskur	fish
passing	fit
tað at passa	fit
fimm	five
festa	fix
fastur	fixed
flagg	flag
snarljós	flash
íbúð	flat
brek	flaw
lýtaleysur	flawless
flýggja	flee
kjøt	flesh
fleyg	flew
benda	flex
liðiligur	flexible
flúgving	flight
klikk	flip
fjeppan	flirt
fjeppan	flirting
flóta	float
flóð	flood
gólv	floor
mjøl	flour
flóð	flow
vøkstur	flow
blóma	flower
beinkrím	flu
flótandi	fluent
flótandi	fluently
dúnutur	fluffy
væta	fluid
flúgva	fly
brennidepil	focus
mjørki	fog
támut	foggy
brot	fold
fólk	folks
vinir	folks
fylgja	follow
málsframhald	follow up
fyljga	following
matur	food
býttlingur	fool
býttligur	foolish
býttlingur	foot
fótbóltur	football
fyri	for
til dømis	For example
til dømis	for instance
fyri teg	for you
til tín	for you
forboðið	forbidden
máttur	force
styrki	force
forsøgn	forecast
panna	forehead
fremmandur	foreign
skógur	forest
altíð	forever
gloyma	forget
fyrigeva	forgive
gloymdi	forgot
gaffil	fork
skap	form
formligur	formal
fyrrverandi	former
tíbetur	fortunately
lagna	fortune
fjøruti	forty
tvey og fjøruti	forty-two
avgreiða	forward
senda	forward
fostra	foster
stríddist	fought
bardist	fought
funnin	found
stovnan	foundation
fýra	four
fjúrtan	fourteen
revur	fox
viðbrekin	fragile
ramma	frame
grind	framework
svikagerð	fraud
løgin	freak
sleppa leysum	free
fría	free
frælsi	freedom
frysting	freeze
títtleiki	frequency
títt	frequent
ofta	frequently
frískur	fresh
fríggjadagur	friday
kuldaskáp	fridge
vindur	friend
vinarligur	friendly
vinir	friends
vinalag	friendship
bangin	frightened
ræðandi	frightening
froskur	frog
frá	from
forsíða	front
fryst	frozen
frukt	fruit
vónbrotin	frustrated
brennievni	fuel
Fullfulde	Fulfulde
fullur	full
f	fun
stuttleiki	fun
virki	function
grundarlag	fundamental
jarðarferð	funeral
stuttligur	funny
pelsur	fur
í øðini	furious
innbúgv	furniture
víðari	further
harafturat	furthermore
framtíð	future
røkka	gain
spæl	game
hol	gap
bilhús	garage
rusk	garbage
urtagarður	garden
hítleykur	garlic
portur	gate
savna	gather
savnan	gathering
mát	gauge
gav	gave
útgerð	gear
kyn	gender
generalur	general
vanligur	general
vanliga	generally
framleiða	generate
ættarlið	generation
gávumildur	generous
hásinnaður	generous
flogvit	genius
slag	genre
varligur	gentle
sannur	genuine
bragd	gesture
fáa	get
fáa hendur á	get
lat teg í	get dressed
oom upp	get up
statt upp	get up
góðan bata	get well soon
fáa	getting
spøkilsi	ghost
at slíta persónlig sambond uttan orð ella eið	ghosting
risi	giant
gáva	gift
ingifer	ginger
genta	girl
unnusta	girlfriend
geva út	give
geva upp	give up
givið	given
glaður	glad
eygnabragd	glance
glas	glass
brillur	glasses
glotti	glimpse
alheimsligur	global
myrkur	gloomy
handskar	gloves
glóð	glow
lýs upp	glow up
lím	glue
fara	go
koyr avstað	go ahead
far burtur	go away
far í song	go to bed
máliska	goal
mál	goals
geit	goat
guð	god
gud signi teg	god bless you
gongur	goes
fer	going
fer	going to
gull	gold
farin	gone
fari	gonna
smikur	goo
gott	good
góðan seinnapart	good afternoon
farvæl	good bye
góðan dag	good day
gott kvøld	good evening
væl úr hondum greitt	good job
sær gott út	good looking
góða eydnu	good luck
góðan morgun	good morning
góðan morgun, mín elskaði	good morning my love
góðan morgun, mín elskaða	good morning my love
góða nátt	good night
farvæl	goodbye
góða nátt	goodnight
ognarlutir	goods
Google	Google
Google týðing	Google Translate
gás	goose
glæsiligur	gorgeous
prýðiligur	gorgeous
strálandi	gorgeous
slatur	gossip
fekk	got
eg skilji	got it
stjórn	government
taka	grab
stig	grade
smátt um smátt	gradually
taka prógv	graduate
korn	grain
játtan	grant
viðganga	granted
drúur	grapes
tak	grasp
gras	grass
takksamur	grateful
takksemi	gratitude
grøv	grave
grátt	gray
stórfingin	great
frálíkt	great
stórur	great
girnd	greed
grammur	greedy
grønt	green
heilsa	greet
heilsan	greeting
helsur	greetings
gráur	grey
rist	grid
grind	grid
sorg	grief
knúsan	grind
tak	grip
vøra	grocery
røkta	groom
meginpartur	gross
jørð	ground
bólkur	group
vaksa	grow
vøkstur	growth
í ringum lag	grumpy
Guarani	Guarani
garanti	guarantee
vakt	guard
gita	guess
gestur	guest
leiðbeining	guidance
leiðari	guide
skydlugur	guilty
jassur	guy
dreingir	guys
venjingarstøð	gym
vani	habit
heimstaður	habitat
umhvørvi	habitat
hevði	had
heilsa	hail
heglingur	hail
hár	hair
hálvur	half
høll	hall
hond	hand
handa	hand
handtak	handle
vakur	handsome
hongur	hang
hanga út	hang out
henda	happen
fara fram	happen
hendi	happened
eydna	happiness
glaður	happy
tillukku	happy birthday
tillukku við føðingardegnum	happy birthday to you
gott nýggjár	happy new year
harður	hard
hart	hard
neyvan	hardly
so at siga aldri	hardly ever
skaða	harm
skaðiligur	harmful
samljóð	harmony
harður	harsh
akurskurður	harvest
hevur	has
hatur	hate
hava	have
eg ynski tær ein góðan dag	have a good day
eg ynski tær ein góðan dag	have a nice day
fá tær morgunmat	have breakfast
stuttleika sær	have fun
hevur tú etið	have you eaten
hava	having
tilvild	hazard
tám	haze
hann	he
hann hevur	he has
hann er	he is
høvd	head
høvuðpína	headache
lekja	heal
leking	healing
heilsa	health
sunnur	healthy
hoyra	hear
hoyrdi	heard
hjarta	heart
hiti	heat
himmalin	heaven
himmiríkið	heaven
tungur	heavy
fjáltrandi	hectic
hædd	height
arvingi	heir
rán	heist
helt	held
helviti	hell
helheimur	hell
Hey	Hello
hey góði	hello dear
hey góða	hello dear
hey, hvussu hevur tú tað	hello how are you
hey, hvussu hevur tú tað	hello how are you doing
hjálmur	helmet
hjálp	help
hjálpsamur	helpful
eftir hetta	hence
hennara	her
fylgi	herd
her	here
arvalutur	heritage
drála	hesitate
Hey	Hey
Hey	Hi
hey, hvussu hevur tú tað	hi how are you
Hey	Hi there
goymdur	hidden
goyma	hide
stigveldi	hierarchy
høgur	high
høgt	high
hápunkt	highlight
gongutúrur	hike
gongutúrur	hiking
látuligt	hilarious
heyggjur	hill
hann	him
ábending	hint
nútímans	hip
mjadnar	hips
bústaðareiga	hire
leigan	hiring
hansara	his
søga	history
sláa	hit
Hmmm	Hmm
frítíðaráhugi	hobby
halda	hold
bíða við	hold on
hol	hole
frídagur	holiday
hola	hollow
heima	home
heim	home
heimaarbeiði	homework
reiðiligur	honest
heiðurligur	honest
ærligur	honest
ærliga	honestly
góði	Honey
søti	Honey
Hunangur	Honey
æra	honor
hetta	hood
grannalag	hood
húkur	hook
hopp	hop
vón	hope
vóna	hope
vónandi	hopefully
vónleysur	hopeless
vætnrættur	horizontal
lúður	horn
horn	horn
ræðuligt	horrible
ræðsla	horror
hestur	horse
sjúkrahús	hospital
gestablídni	hospitality
húsbóndi	host
vertur	host
illviljaður	hostile
heitur	hot
heitt	hot
gistingarhús	hotel
tími	hour
tímar	hours
hús	house
húsarhald	household
hvussu	how
hvussu við tær	how about you
hvussu hevur tú tað	how are you
hvussu hevur tú tað	how are you doing
hvussu hevur tú tað í dag	how are you doing today
hvussu hevur tú tað í dag	how are you today
hvussu hevur tú tað	how do you do
hvussu hevur	how is
hvussu nógv	how many
hvussu nógv	how much
hvussu ofta	how often
hvussu gamal er tú	how old are you
hvussu gomul er tú	how old are you
hvussu var dagur tín	how was your day
hvussu var kvøld títt	how was your night
kortini	however
hvussu enn	however
miðdepil	hub
maður	hubby
klemm	hug
stórt	huge
menniskja	human
eyðmjúkur	humble
slagin	humid
slag	humidity
hunrað	hundred
svangur	hungry
veiða	hunt
ódn	hurricane
skundur	hurry
skunda tær	hurry up
pína	hurt
skaði	hurt
illkennan	hurt
maki	husband
maður	husband
fólk við áræði	hustle
trokan	hustle
smátta	hut
reinføri	hygiene
Eg	I
Eg eri	I am
eg havi tað gott	I am fine
eg kann	I can
eg kann ikki	I can't
eg geri	I do
eg veit ikki	I do not know
eg skilji ikki	I do not understand
eg ikki	I don't
eg veit ikki	I don't know
Eg skilji ikki	I don't understand
eg skilji teg ikki	I don't understand what you mean
eg skilji ikki	I don't understand what you mean
hvat tú meinar	I don't understand what you mean
eg skilji teg ikki	I don't understand you
eg veit ikki	I don’t know
eg skilji ikki	I don’t understand
eg haldi	i guess
eg hevði	I had
eg havi	I have
eg havi verið	I have been
Tað vóni eg	I hope so
Eg veit	I know
Eg eri greiður yvir	I know
mær dámar	I like
mær dámar teg	I like you
Eg elski	I love
eg elski stórabeiggja mín	I love my big brother
eg elski stórusystir mína	I love my big sister
eg elski pápa mín	I love my father
eg elski beiggja mín	I love my little brother
eg elski lítlusystir mína	I love my little sister
eg elski mammu mína	I love my mother
Eg elski teg	I love you
eg elski teg so høgt	I love you so much
eg elski teg so nógv	I love you so much
eg elski eisini teg	I love you too
i meini	I mean
Eg sakni teg	I miss you
eg sakni teg so nógv	I miss you so much
eg skilji	I see
eg haldi	I think
Eg skilji	I understand
eg vil	I want
eg vil síggja teg	I want to see you
eg vil hava teg	I want you
eg var	I was
eg vil	I will
I vildi verið	I would be
Eg eri	I'm
Eg havi tað gott	I'm fine
eg eri góður	I'm good
eg eri her	I'm here
orsaka	I'm sorry
tað harmar meg	I'm sorry
ísur	ice
ísur	ice cream
hugskot	idea
fyrimynd	ideal
samlíkur	identical
eyðmerkja	identify
samleiki	identity
býttlingur	idiot
letast	idle
um	if
skúgva til viks	ignore
sjúk	ill
ólógligur	illegal
sjúka	illness
Ilocano	Ilocano
mynd	image
ímynda	imagine
í stundini	immediate
í stundini	immediately
beinanvegin	immediately
ómetaligur	immense
ávirkan	impact
ótolin	impatient
fremja	implement
tól	implement
innflutningur	import
týdningarmikið	important
áleggja	impose
ógjørligt	impossible
merki	impress
seta dám á	impress
mynd	impression
undranarverdur	impressive
betra	improve
betran	improvement
í	in
avtrat	in addition
satt at siga	In fact
framman fyri	in front of
í mun til	in order to
óhóskandi	inappropriate
eggjan	incentive
hending	incident
fata um	include
fevna um	include
íroknaður	including
inntøka	income
ómakur	inconvenience
víðka	increase
økt	increased
ótrúligt	incredible
í roynd og veru	indeed
ja	indeed
veruliga	indeed
sjálvstøðugur persónur	independent
India	India
vísa á	indicate
innføddur	indigenous
persónur	individual
menniskja	individual
einstaklingur	individual
íðni	industry
óumberligur	inevitable
barn	infant
smitta	infection
endaloysi	infinity
bruni	inflammation
virðisminkan	inflation
ávirkan	influence
upplýsa	inform
kunning	information
partar	ingredients
arvur	inheritance
forbókstavur	initial
framtakshugur	initiative
særdur	injured
skaði	injury
ósekur	innocent
nýmenning	innovation
spurningur	inquiry
ørur	insane
vitleysur	insane
skordýr	insect
ósikkur	insecure
innskot	insert
innaní	inside
inni	inside
innlit	insight
halda fast við	insist
andvekur	insomnia
íblástur	inspiration
íblása	inspire
seta í	install
skel	instance
í stundini	instant
i staðin fyri	instead
í staðin	instead
í staðin fyri	instead of
vegleiðingar	instructions
ljóðføri	instrument
misbjóðing	insult
trygging	insurance
órørdur	intact
heild	integrity
mentafólk	intellectual
skilvit	intelligence
gløggur	intelligent
hava í huga	intend
ætlað	intended
inniligur	intense
endamál	intention
ávirkan	interact
sín ámillum ávirkan	interaction
áhugi	interest
áhugaður	interested
áhugavert	interesting
fara uppí	interfere
leggja uppí	interfere
sum liggur ímillum	intermediate
innan	internal
altjóða	international
starvsvenjing	internship
tulka	interpret
tolkur	interpreter
órógva	interrupt
samrøða	interview
inniligur	intimate
inn í	into
navnkenna	introduce
byrja við	introduce
innleiðsla	introduction
innanhokið fólk	introvert
hugskygni	intuition
ógildugur	invalid
avlamisfólk	invalid
uppfinna	invent
uppgerð	inventory
seta í	invest
kanna	investigate
innbjóðan	invitation
bjóða	invite
faktura	invoice
draga inn í	involve
torgreiddur	involved
jarn	iron
er	is
oyggj	island
avbyrgdur	isolated
spurningur	issue
trupulleiki	issue
stríðsmál	issue
trupulleiki	issues
tað	it
tað er	it is
tað var	it was
tað er	it's
tað er í lagi	it's ok
tað er í lagi	It's okay
lutur	item
lutir	items
tað er	its
eg eri	I’m
jakki	jacket
fongsul	jail
januar	January
krukka	jar
kjálkabein	jaw
øvundsjúkur	jealous
rykk	jerk
prýðislutur	jewelry
starv	job
jogging	jogging
luttaka	join
marihuanasigarett	joint
skemt	joke
tíðindafólk	journalist
ferð	journey
gleði	joy
døma	judge
saft	juice
juli	july
loypa	jump
juni	june
skrell	junk
beint	just
júst	just
ger tað bara	just do it
rættvísi	justice
rættvísgera	justify
Kalaallsut	Kalaallisut
harmast um	keen
syrgja	keen
borgartorn	keep
halda	keep
hava	keep
halt á	keep it up
hevði	kept
ketil	kettle
lykil	key
sparka	kick
barn	kid
roksa	kidding
nýra	kidney
børn	kids
drepa	kill
fittur	kind
vinaligur	kind
blíður	kind
eitt slag av	kinda
vinaliga	kindly
blíðskapur	kindness
kongur	king
mussur	kiss
køkur	kitchen
dreki	kite
kettlingur	kitten
knæ	knee
visti	knew
knívur	knife
riddari	knight
vita	know
vitan	knowledge
kendur	known
Konkani	Konkani
Krio	Krio
frámerki	label
arbeiði	labor
arbeiði	labour
trongd	lack
tørvur	lack
trot	lack
stigi	ladder
kvinna	lady
legði	laid
pappír við vatnmerkjum	laid
á	lake
lamb	lamb
gera haltan	lame
lampa	lamp
land	land
landslag	landscape
mál	language
fang	lap
stórur	large
seinast	last
síðstur	last
at enda, men ikki minst	last but not least
eftirnavn	last name
seinur	late
nýliga	lately
seinni	later
síðstur	latest
seinni	latter
flenna	laugh
flenna	laughing
látur	laughter
seta gongd á	launch
klædnavask	laundry
lóg	law
grasvøllur	lawn
sakførari	lawyer
liggja	lay
lag	layer
skipna	layout
dovin	lazy
leiða	lead
leiðari	leader
blað	leaf
leki	leak
klænur	lean
lop	leap
lærari	learn
læring	learning
leiga	lease
minstur	least
leður	leather
fara frá	leave
fara avstað	leave
fara	leave
bløð	leaves
leiddi	led
vinstru	left
bein	leg
arvur	legacy
lógligur	legal
søgn	legend
halgistøða	legend
sambært reglunum	legit
frítíð	leisure
læna	lend
longd	length
minni	less
leksia	lesson
lat	let
bræv	letter
høvuðssalat	lettuce
stig	level
vág	leverage
lyndi	liability
bókasavn	library
slikka	lick
lygn	lie
lúgva	lie
lygnir	lies
lív	life
lívið	life
lyfta	lift
lætt	light
ljós	light
snarljós	lightning
beinleiðis	like
næstan	like
sum ein	like
sannlíkur	likely
somuleiðis	likewise
lína	line
Lingala	Lingala
leinkja	link
ljón	lion
væta	liquid
listi	list
lurta	listen
lurta	listening
bókstaviliga	literally
orðarætt	literally
bókmentir	literature
ólag	litter
rusk	litter
lítil	little
liva	live
livur	liver
lív	lives
lív	living
stova	living room
oydla	lizard
byrði	load
breyð	loaf
lán	loan
innføddur	local
staður	location
lás	lock
afturlating	lockdown
bulur	log
lol	lol
einsamallur	lonely
langur	long
langt síðan seinast	long time no see
hygg	look
útsjónd	look
lykkja	loop
tapa	loose
harri	lord
missa	lose
missur	loss
missa	lost
mongd	lot
hart	loud
setstova	lounge
kærleiki	love
eg elski teg	love you
yndisligur	lovely
elskuligur	lovely
vænur	lovely
djúpur	low
lágur	low
veikur	low
lægri	lower
trúgvur	loyal
trúfesti	loyalty
hepni	luck
heppin	lucky
Luganda	Luganda
viðføri	luggage
knykil	lump
miðmáli	lunch
løtt máltíð	lunch
lungu	lungs
marglæti	luxury
liggur	lying
maskina	machine
óður	mad
frú	madam
gjørdur	made
vikublað	magazine
frálíkur	magnificent
arbeiðskona	maid
høvuðs	main
varðveita	maintain
halda skil á	maintain
skilahald	maintenance
røkt	maintenance
varðveiðsla	maintenance
Mathili	Maithili
stórur	major
majorur	major
meirlutin	majority
gera	make
smyrsl	make up
maður	male
handilsmiðdepil	mall
maður	man
standa fyri	manage
leiðsla	management
leiðari	manager
yvirræðisveldi	mandatory
kravdur	mandatory
álagdur	mandatory
yvirlýsing	manifest
manipulera	manipulate
háttur	manner
handbók	manual
mong	many
nógv	many
nógvar nógvar gleðiligar afturkomur	many many happy returns of the day
hergonga	march
breddi	margin
marknaður	market
hjúnarband	marriage
giftur	married
maska	mask
mongd	mass
førur	massive
meistarin	master
maki	match
dystur	match
svávulpinnur	match
felagi	mate
tilfar	material
støddfrøði	math
mál	matter
søk	matter
sak	matter
búning	maturity
kunna	may
kanska	maybe
møguliga	maybe
mær	me
meg	me
og eg	me too
eisini eg	me too
máltíð	meal
týða	mean
merkja	mean
týdningur	meaning
merkir	means
meinti	meant
ímeðan	meanwhile
mál	measure
mát	measure
mátingar	measures
kjøt	meat
heilsukanning	medical
heilivágur	medicine
meditatión	meditation
miðal	medium
møta	meet
fundur	meeting
Meteillon	Meiteilon
bráðna	melt
minni	memories
minni	memory
andligur	mental
nevna	mention
umrøddi	mentioned
vegleiðari	mentor
handilsmaður	merchant
miskunn	mercy
bara	merely
gleðilig jól	merry christmas
órudd	mess
boð	message
óruddiligur	messy
málmur	metal
háttur	method
mýs	mice
miðal	middle
midnátt	midnight
máttur	might
kunna	might
mildur	mild
blíður	mild
mílasteinur	milestone
hervaldið	military
mjólk	milk
millión	million
vit	mind
sinni	mind
skil	mind
hugburður	mindset
mínir	mine
mítt	mine
mín	mine
blanda seg við	mingle
moll	minor
lítil	minor
minutt	minute
minuttir	minutes
undur	miracle
spegil	mirror
ymiskur	miscellaneous
skálkaligur	mischievous
vánaligur	miserable
vesaladómur	misery
sakna	miss
ikki raka mál	miss
sakni teg	miss you
horvin	missing
sendinevnd	mission
tám	mist
mistak	mistake
Mizo	Mizo
flytførur	mobile
halda fyri gjøldur	mock
modell	model
tálma	moderate
nútíðar	modern
lítillátaður	modest
bleytt	moist
væta	moisture
evna	mold
moldvørpa	mole
mamma	mom
móðir	mom
løta	moment
mánadagur	monday
peningur	money
vakmyndatól	monitor
apa	monkey
mánaði	month
hugalag	mood
lag	mood
lúnutur	moody
máni	moon
boðskapur	moral
meir	more
og so	moreover
morgun	morning
veðbræv	mortgage
flestir	most
mestur	most
helst	mostly
mamma	mother
móðir	mother
rørsla	motion
íblástur	motivation
fjall	mountain
mús	mouse
muður	mouth
rørsla	move
rørsla	movement
filmur	movie
frú	mrs
nógv	much
runa	mud
krúss	mug
vøddi	muscle
savn	museum
hundaland	mushroom
tónleikur	music
mást	must
ljóðdoyvari	mute
felags	mutual
mín	my
mín kæri	My dear
mín kæra	My dear
vinur mín	my friend
mítt luftpútfar er fult av ????	My hovercraft is full of eels
mín elskaði	my love
eg eiti	my name is
gleðin er mín	my pleasure
eg	myself
loyndarfullur	mysterious
loynidómur	mystery
frumsøgn	myth
negl	nail
góðvarin	naive
navn	name
søga	narrative
smalur	narrow
andstyggiligur	nasty
ræðuligur	nasty
ríkisborgarar	national
tjóðskapur	nationality
upprunaligur	native
natúrtalent	natural
náttúra	nature
vaml	nausea
nærka seg	near
nær	near
nærkast	near
nærindis	nearby
næstan	nearly
nossligur	neat
reinur	neat
neyt	neat
neyðugt	necessary
halsur	neck
hálsketa	necklace
hava tørv á	need
neiligur	negative
misrøkt	neglect
tingast	negotiate
samráðast	negotiate
granni	neighbor
grannalag	neighborhood
hvørgan	neither
hvørki	neither
bróðursonur	nephew
systirsonur	nephew
nørdur	nerd
fjáltrutur	nervous
reiður	nest
net	net
netverk	network
uttanveltaður	neutral
aldri	never
gev aldri upp	never give up
gott er	never mind
líkamikið	never mind
líka mikið	nevermind
líkamikið	nevertheless
óansæð	nevertheless
nýgjgur	new
tíðindi	news
næsti	next
næstur at	next to
góður	nice
vakur	nice
deiligur	nice
hugnaligt at hitta teg	nice to meet you
gott at hitta teg	nice to meet you
systirdóttir	niece
nátt	night
marra	nightmare
nýggju	nine
nítjan	nineteen
níti	ninety
hálvfems	ninety
Nei	No
ikki nakar trupulleiki	no problem
ikki ein trupulleiki	no problem
ongin trupulleiki	no problem
aldri í lívinum	no way
ongin	nobody
larmur	noise
larmandi	noisy
eingin	none
middagur	noon
nei	nope
heldur ikki	nor
vanligur	normal
norður	north
nøs	nose
sorgblíður	nostalgic
ikki	not
yvirhøvir ikki	not at all
ikki so galið	not bad
ikki nú	Not now
ikki enn	not yet
upprit	note
kendur	noted
onki	nothing
bitið merki í	notice
leggja til merkis	notice
frásøgn	noticed
navn	noun
navnorð	nouns
stuttsøga	novel
novembur	november
nú	now
nú	nowadays
plága	nuisance
null	null
stirðna	numb
nummar	number
sjúkrasystir	nurse
nøt	nut
muskatnøt	nutmeg
føðsla	nutrition
matur	nutrition
eiður	oath
fiti	obesity
akta	obey
lutur	object
mið	objective
skuldbinding	obligation
krógva	obscure
eygleiðing	observation
eygleiða	observe
tráseta	obsessed
tráseting	obsession
avlagdur	obsolete
forðan	obstacle
fáa	obtain
útgvegað	obtained
eyðsýndur	obvious
sjálvandi	obviously
eyðsæð	obviously
vituliga	obviously
av og á	occasionally
starv	occupation
upptikin	occupied
henda	occur
koma fyri	occur
bera á	occur
hendi	occurred
fór fram	occurred
hendur	occurs
koma fyri	occurs
hav	ocean
oktobur	october
løgin	odd
løgið	odd
útlit	odds
av	of
sjálvandi	of course
sjálvsagt	of course
rýma	off
fara	off
atsókn	offensive
bjóða	offer
skrivstova	office
almennur	official
ofta	often
tíðum	often
mangan	often
Áh	Oh
veruliga	oh really
olja	oil
ok	ok
í lagi, góða	ok dear
í lagi, góði	ok dear
okey, góði	ok honey
okey, góða	ok honey
í lagi, mín elskaði	ok my love
í lagi, mín elskaða	ok my love
okey	okay
tað er í lagi	okay
okey, góði	okay baby
okey, góða	okay baby
okey, góði	okay dear
okey, góða	okay dear
okey, góða	okay honey
alt í lagi, mín elskaða	okay my love
í lagi, mín elskaði	okay my love
okey, mín elskaða	okay my love
gamal	old
á	on
einusinni	once
eina ferð	once
ein	one
mál okkara er aldri nóg mikið	one language is never enough
leykur	onion
álinju	online
einans	only
opin	open
virksemi	operation
meining	opinion
áskoðan	opinion
hugsan	opinion
møguleikar	opportunities
møgueliki	opportunity
mótsetningur	opposite
bjartskygdur	optimistic
møguleiki	option
valfríur	optional
ella	or
appilsin	orange
sum fæst í lag	order
sum valdar	order
sum er	order
vanligur	ordinary
felag	organization
kunning	orientation
uppruni	origin
frumrit	original
Oramo	Oromo
faðir- og móðirloysingur	orphan
onnur	other
øðrvísi	otherwise
átti	ought
iókkara	our
Ørindi okkara: at gera øll, allastaðni før fyri at skilja heimin og at úttrykkja seg	Our mission: to enable everyone, everywhere to understand the world and express themselves across languages.
Ørindi okkara: at skipa heimsins kunning og gera hana alheims atkomuliga og nýtiliga	Our mission: to organize the world's information and make it universally accessible and useful.
út	out
úrslit	outcome
búni	outfit
vinaligur og fryntligur	outgoing
sølustaður	outlet
yvilit	outline
uttandura	outside
uttanfyri	outside
framúrskarandi	outstanding
ovnur	oven
yvir	over
yviri har	over there
arbeiðskittil	overall
basa	overcome
yvirhugsan	overthinking
floyma yvir	overwhelmed
fløða	overwhelmed
øgiligur	overwhelming
eiga	owe
ugla	owl
egið	own
eigari	owner
ánari	owner
oksi	ox
ferð	pace
knýti	pack
pakki	package
rindaði	paid
pína	pain
máling	paint
máling	painting
par	pair
bleikur	pale
lógvi	palm
panna	pan
farsótt	pandemic
ótti	panic
skelkur	panic
ræðsla	panic
buksur	pants
pappír	paper
paradís	paradise
samsvara	parallel
pakkiu	parcel
fyrgeving	pardon
foreldur	parents
park	park
pappageykur	parrot
persilla	parsley
partur	part
vera við í	participate
eina helst	particular
serstakliga	particular
serliga	particularly
maki	partner
veitsla	party
skarð	pass
atgonguseðil	pass
pass	pass
gjøgnumgongd	passage
staðin	passed
ovurhugur	passion
gessur	passion
ovurhugaður	passionate
óvirkin	passive
loyniorð	password
fortíð	past
lappi	patch
gøta	path
leið	path
rás	path
syndarligur	pathetic
tolmóð	patience
tolni	patience
sjúklingur	patient
tolin	patient
mynstur	pattern
støðgur	pause
gongubreyt	pavement
gjalda	pay
rinda	pay
gjalding	payment
friður	peace
friðarligur	peaceful
ferska	peach
toppur	peak
pera	pear
bønir	peas
løgin	peculiar
piss	pee
flus	peel
stara	peer
javnlíkar	peers
pennur	pen
pennur	pencil
sum liggur í óvissu	pending
óavgjørdur	pending
menniskju	people
fólk	people
pipar	pepper
hoyra	perceive
fatan	perception
fullkomin	perfect
framføra	perform
framførsla	performance
kanska	perhaps
møguliga	perhaps
mánasjúka	period
tíðarskeið	period
varandi	permanent
loyvi	permission
loyvi	permit
áhaldni	perseverance
áhaldandi	persistent
persónur	person
persónligur	personal
persónsmenska	personality
sjónarmið	perspective
fáa	persuade
yvirtala	persuade
kynsligur frávíkur	pervert
kelidjór	pet
stig	phase
merkisvert fyribrigdi	phenomenon
heimspeki	philosophy
telefon	phone
myndapartur	photo
orðafelli	phrase
kropsliga	physical
heinta	pick
heinta	pick up
taka upp í	pick up
mynd	picture
friður	piece
stykkir	pieces
grísur	pig
dúgva	pigeon
stápla	pile
koddi	pillow
flogskipari	pilot
nál	pin
ananas	pineapple
ljósareytt	pink
hol	pit
í hæddini	pitch
tóni	pitch
kast	pitch
samkensla	pity
staður	place
støð	places
plaga	plague
pest	plague
slætti	plain
skilligur	plain
greiður	plain
ætlan	plan
flogfar	plane
planta	plant
plantur	plants
borðiskur	plate
pallgrund	platform
spæla	play
spælur	playing
góður	pleasant
vinaliga	please
ger so væl	please
nøgdur	pleased
gleði	pleasure
frøi	pleasure
hugur	pleasure
tilsøgn	pledge
nógv	plenty
ráðagerð	plot
proppur	plug
blomma	plum
rørsmiður	plumber
fleirtal	plural
poddvarp	podcast
yrking	poem
yrkingar	poetry
punkt	point
oddur	point
eitur	poison
løgregla	police
politikkur	policy
høviskur	polite
dálking	pollution
hylur	pond
svimjihylur	pool
kukka	poop
fátakur	poor
popptónleikur	pop
vælumtóktur	popular
íbúgvar	population
grísur	pork
greytur	porridge
havnarbýur	port
støða	position
jaligur	positive
eiga	possess
ognir	possession
ráðaríkur	possessive
møguliga	possible
postur	post
útseta	postpone
epli	potato
møgulig megi	potential
menningarmøguleiki	potential
pund	pound
fátækradømi	poverty
máttur	power
megi	power
styrki	power
vald	powerful
verkligur	practical
venja	practice
rós	praise
skálkabragd	prank
bøn	pray
virðismikil	precious
nágreinur	precise
nágreiniliga	precisely
spáa	predict
dáma betur	prefer
serstakur tokki	preference
við barn	pregnant
fordómur	prejudice
inngangur	premises
høgt mettur	premium
viðbót	premium
fyrireiking	preparation
fyrireika	prepare
fyrireikaður	prepared
fyriseting	preposition
nærvera	presence
gáva	present
nútíð	present
framløga	presentation
súltað	preserve
forseti	president
pressa	press
trýst	pressure
lata eins og	pretend
vakur	pretty
fyribyrgja	prevent
virðismikil	previous
fongur	prey
kostnaður	price
erpni	pride
stoltleiki	pride
hugmóð	pride
prestur	priest
høvuðsmál	primary
besta tíð	prime
prinsessa	princess
stjóri	principal
fyrri	prior
raðfesting	priority
fongsul	prison
fangahús	prison
einvera	privacy
einskildur	private
framíhjárættur	privilege
kostnaður	prize
møguliga	probably
trupulleiki	problem
mannagongd	procedure
líða	proceed
gongd	process
framleiða	produce
vøra	product
framleiðsla	production
starv	profession
yrkisfólk	professional
vangamynd	profile
vinningur	profit
ógvuliga	profound
framgongd	progress
verkætlan	project
framúrskarandi	prominent
lyfti	promise
arbeiða fyri	promote
virkan	promotion
áminning	prompt
fram á	prone
fornøvn	pronouns
framburður	pronunciation
prógv	proof
rættiligur	proper
ogn	properly
ognir	properties
ognarlutir	property
ogn	property
fæ	property
uppskot	proposal
útlit	prospect
ogn	prosperity
múgvandi	prosperous
verja	protect
errin	proud
prógva	prove
síggja fyri	provide
útvega	provide
treytað av	provided
landslutur	province
útvegan	provision
kynsbúningur	puberty
almenningur	public
skumpa	pull
graskar	pumpkin
stundisligur	punctual
næmingur	pupil
útvegan	purchase
keyp	purchase
ognan	purchase
reinur	pure
korkalittur	purple
mál	purpose
mið	purpose
endamál	purpose
taska	purse
elta	pursue
elta	pursuit
skumpa	push
leggja	put
seta	put
útbúgving	qualification
góðska	quality
mongd	quantity
sóttarhald	quarantine
klandur	quarrel
fjórðingur	quarter
Quechua	Quechua
drottning	queen
djeikari	queer
spurningur	query
spurningur	question
røð	queue
skjótur	quick
skjótt	quickly
stilt	quiet
kvirt	quiet
vattteppi	quilt
fara úr	quit
siga upp	quit
gevast	quit
heilt	quite
fullkomuliga	quite
púra	quite
spurnakapping	quiz
sitat	quotation
taka til	quote
sitera	quote
sitera	quotes
hara	rabbit
kappleikur	race
vreiði	rage
regn	rain
reisa	raise
ala	raise
framskorin	raised
rann	ran
tilvildarligt	random
rað	range
skjótur	rapid
í skundi	rapidly
sjáldsamur	rare
óvanligur	rare
dýrur	rare
sjaldan	rarely
útbrot	rash
rotta	rat
stig	rate
heldur	rather
lutfall	ratio
skyndamur	rational
rátt	raw
røkka	reach
rokkið	reached
viðbragd	reaction
lesa	read
lesing	reading
til reiðar	ready
veruligur	real
veruleiki	reality
seta í verk	realize
útinna	realize
setti í verk	realized
álvaratos	really
veruliga	really
afturpartur	rear
orsøk	reason
skynsamur	reasonable
minnast	recall
kvittan	receipt
móttøka	receipt
fáa	receive
taka ímóti	receive
fáa	received
taka ímóti	received
hoyra	received
nýliga	recent
fyri stuttum	recently
stutt síðan	recently
móttøka	reception
uppskrift	recipe
forsin	reckless
afturkenning	recognition
kennast við	recognize
kenna aftur	recognize
viðmæla	recommend
viðmæla	recommended
skjal	record
koma fyri seg	recover
heilsubót	recovery
rættvinklaður	rectangle
reytt	red
gjalda skuldina aftur	redeem
útgjalding	redemption
minka	reduce
óneyðugur	redundant
vísa til	refer
tilvísing	reference
varpa aftur	reflect
afturbragd	reflection
niðurlag	refrain
kuldaskáp	refrigerator
endurgjaldiing	refund
nokta	refuse
sýttur	refused
at meta høgt	regard
viðvíkjandi	regarding
uttan mun til	regardless
virðing	regards
øki	region
skrá	register
angra	regret
fastur kundi	regular
regluliga	regularly
kveistra burtur	reject
siga frá	relate
skyldur við	related
parlag	relationship
skyldfólk	relative
skyldfólk	relatives
slappa av	relax
leysgeving	release
geva út	release
sleppa av við	release
leysgivin	released
sum hevur týdning	relevant
álítandi	reliable
lætti	relief
lætta	relieve
lætnaður	relieved
átrúnaður	religion
trugvandi	religious
trekur	reluctant
líta á	rely
verða	remain
standa eftir	remain
blíva	remain
verandi	remaining
óvanligur	remarkable
hjálparráð	remedy
minnast	remember
áminning	remind
áminning	reminder
fjarur	remote
taka burtur	remove
veiting	render
leiga	rent
umvæla	repair
endurtøka	repeat
seta í staðin	replace
svara	reply
endurtaka	reply
frágreiðing	report
tíðindasending	report
umboða	represent
mæti	reputation
umbøn	request
krevja	require
kravdur	required
ásettur	required
skydligur	required
bjarging	rescue
gransking	research
minna um	resemble
líkjast	resemble
agg	resentment
bílegging	reservation
goymsla	reserve
íbúgvi	resident
fara úr starvi	resign
lívsmáttur	resilience
seigur	resilient
standa ímóti	resist
mótstøða	resistance
støðufesti	resolution
loysa	resolve
útvegur	resort
snarræði	resources
megi	resources
virðing	respect
aftursvar	respond
svar	response
aftursvar	response
ábyrgd	responsibility
sum ber ábyrgd av	responsible
ábyrgur	responsible
hvíla	rest
hvíl í friði	rest in peace
matstova	restaurant
umvæla	restore
avmarka	restrict
úrslit	result
úrslit	results
taka uppaftur	resume
smásøla	retail
varðveita	retain
varðveiðsla	retention
loystur úr starvi	retired
afturtøka	retreat
fara	retrieve
heimkoma	return
afturkoma	return
avhylja	reveal
siga frá	reveal
avdúka	reveal
avdúkaður	revealed
hevnd	revenge
inntøka	revenue
vend	reverse
yvirlit	review
endurskoðan	revise
endurskoðan	revision
uppreistur	revolution
samsýning	reward
rútma	rhythm
rivjabein	rib
rís	rice
ríkur	rich
loysa	rid
túrur	ride
súkklutúrur	ride
koyritúrur	ride
tápuligt	ridiculous
láturligt	ridiculous
rættindi	right
rættur	right
beint nú	right now
stívur	rigid
ringur	ring
reinsan	rinse
ófriður	riot
skrædl	rip
búgvin	ripe
rísa	rise
vandi	risk
sambiðil	rival
kappingarneyti	rival
á	river
vegur	road
steik	roast
treystur	robust
rokkur	rock
stong	rod
leiklutur	role
rulla	roll
tak	roof
rúm	room
rót	root
reip	rope
rotið	rotten
ráur	rough
harðliga	roughly
rundur	round
farleið	route
handahógv	routine
røð	row
vandamál	rub
gummi	rubber
rusk	rubbish
ófólkaligt	rude
ófólkaligur	rude
teppi	rug
toft	ruin
at stýra	rule
lineal	ruler
valdsharri	ruler
reglugerð	rules
renna	run
renning	running
bygdarligur	rural
skund	rush
sekkur	sack
heilagur	sacred
offur	sacrifice
tryggur	safe
trygga flogferð	safe flight
trygd	safety
vísmaður	sage
segði	said
salt	sail
siglur	sailing
søk	sake
løn	salary
søla	sale
útsøla	sale
laksur	salmon
salt	salt
sama	same
sama her	Same here
roynd	sample
sandur	sand
Sanskrit	Sanskrit
speiskur	sarcastic
frekur	sassy
sat	sat
nøgdsemi	satisfaction
nøgdur	satisfied
nøktandi	satisfy
nøktandi	satisfying
leygardagur	Saturday
pylsa	sausage
villmaður	savage
illmenni	savage
bjarga	save
sá	saw
sig	say
siga	say
lønarstigi	scale
skálkagerð	scam
arr	scar
knappur	scarce
bangin	scared
turriklæði	scarf
ræðandi	scary
knústur	scattered
pallur	scene
vakurt landslag	scenery
angi	scent
skrá	schedule
tíðarætlan	schedule
arbeiðsætlan	schedule
skúli	school
vísund	science
vísindafólk	scientist
vísindafólk	scientists
saksur	scissors
skelda	scold
rúmar ræsur	scope
støða	score
spjørr	scrap
klóran	scratch
skíggja	scream
skýggi	screen
skrúva	screw
handrit	script
hav	sea
innsigli	seal
leita	search
árstíð	season
setur	seat
sekund	second
loyndarmál	secret
partur	section
tryggur	secure
trygd	security
síggja	see
vit síggjast	see you
síggjast seinni	see you later
síggjast skjótt	see you soon
síggjast í morgin	see you tomorrow
fræ	seed
leita eftir	seek
tykist	seem
tykist	seems
sá	seen
tríva í	seize
tøka	seizure
sjáldan	seldom
kjósa	select
velja	select
sjálvur	self
sjálvsleking	self healing
sjálvsøkin	selfish
selja	sell
senda	send
send mær tína mynd	send me your picture
eldri	senior
sansa	sense
vitugur	sensible
viðkvæmur	sensitive
sent	sent
setningur	sentence
setningar	sentences
skilja	separate
sundurluta	separate
Sepedi	Sepedi
septembur	september
partur	sequence
sendirøð	series
álvarsamur	serious
álvarsamt	serious
álvarsom	serious
í álvara	seriously
tæna	serve
tænasta	service
seta	session
seta	set
skipna	set up
at fara niður	setting
bonkur	settle
sjey	seven
seytjan	seventeen
sjeyti	seventy
fleiri	several
álvarsamur	severe
seyma	sew
Sh	sh
skuggi	shade
skuggi	shadow
rysta	shake
skulu	shall
grunnur	shallow
skomm	shame
snið	shape
skap	shape
formur	shape
deila	share
luta	share
hvassur	sharp
hon	she
hon hevur	she has
hon er	she is
skúr	shed
seyður	sheep
ark	sheet
hill	shelf
skal	shell
vernd	shelter
skjødur	shield
skifti	shift
skina	shine
lýsa	shine
skip	ship
skipan	shipping
skjúrta	shirt
skógvar	shoes
skjót	shoot
handil	shop
keypa	shopping
strond	shore
stuttur	short
trot	shortage
skot	shot
skuldi	should
øksl	shoulder
rópa	shout
framførsla	show
vísa	show
sýna	show
vís mær	show me
bað	shower
rækja	shrimp
svinna	shrink
afturlatið	shut
tig	shut up
leypa til viks	shy
smæðin	shy
systkin	sibling
systkin	siblings
sjúkur	sick
síða	side
suffa	sigh
sjón	sight
vitjan á kendum støðum	sightseeing
teknin	sign
skelti	sign
undirskrift	signature
týdningarmikil	significant
týðandi	significant
stilli	silence
stillur	silent
silki	silk
býtt	silly
býttlingur	silly
býttur	silly
silvur	silver
eins	similar
býttlingur	simp
einfalt	simple
samsundis	simultaneously
síðan	since
hjartaligur	sincere
ærliga	sincerely
syng	sing
sangari	singer
stakur	single
støk	single
vask	sink
Harri	Sir
systir	sister
bróðurkona	sister in law
sit	sit
stað	site
støða	situation
seks	six
sekstan	sixteen
trýss	sixty
seksti	sixty
stødd	size
gávur	skill
evni	skills
húð	skin
klænur	skinny
lop	skip
kjóli	skirt
himmal	sky
trælur	slave
svav	sleep
svevur	sleeping
linur	sleepy
erma	sleeve
flís	slice
glið	slide
eitt sindur	slightly
slakna	slim
glið	slip
skrái	slope
riva	slot
seinur	slow
spakuliga	slowly
lítil	small
snildur	smart
luktur	smell
smíl	smile
roykur	smoke
smildliga	smooth
argjamáltíð	snack
snigil	snail
slanga	snake
klamsur	snap
kavi	snow
so	so
so elskuligur	so cute
so fittur	so cute
higartil	so far
dýggjan	soak
sápa	soap
edrúur	sober
fóbóltur	soccer
sosialur	social
samfelag	society
sokkar	socks
bleytur	soft
forrit	software
mold	soil
seld	sold
útselt	sold out
hermaður	soldier
sóli	sole
fast evni	solid
avgerð	solution
loysa	solve
nakrir	some
nøkur	some
nakrar	some
onkur	somebody
onkusvegna	somehow
onkur	someone
okkurt	something
eitthvørt	something
viðhvørt	sometimes
av og á	sometimes
songur	song
skjótt	soon
fínligur	sophisticated
Sorani	Sorani
sárur	sore
ilt í hálsinum	sore throat
sorg	sorrow
Orsaka	Sorry
Umber	Sorry
slag	sort
umbiðin	sought
sál	soul
andans vinur	soulmate
ljóð	sound
suppa	soup
súrur	sour
kelda	source
suður	south
rúm	space
ruskpostur	spam
spenni	span
spanskt	Spanish
spara	spare
tosa	speak
serligur	special
slag	species
serstakur	specific
neyvur	specific
stórfingin	spectacular
røða	speech
málleysur	speechless
ferð	speed
stava	spell
nýta	spend
brúka	spend
nýtti	spent
kryddaður	spicy
píkur	spike
hvirlan	spin
spinat	spinach
andi	spirit
spíta	spit
framúrskarandi	splendid
klúgva	split
oðileggja	spoil
spiltur	spoiled
spontanur	spontaneous
skeið	spoon
stað	spot
maki	spouse
spjaða	spread
vár	spring
fýrkantur	square
kroysta	squeeze
høgguslokkur	squid
íkorn	squirrel
stinga	stab
rossafjós	stable
lað	stack
starvsfólk	staff
pallur	stage
blettur	stain
trappur	stairs
steyri	stake
tráelta	stalk
steðgaði	stall
frimerki	stamp
standa	stand
støði	standard
stjørna	star
byrjan	start
byrjaði	started
hungurstungin	starving
lega	state
støða	state
ríki	state
boð	statement
frásøgn	statement
fráboðan	statement
støð	station
standmynd	statue
støða	status
standur	status
verða verandi	stay
uppihald	stay
ansa eftir tær	stay safe
støðugur	steady
búffur	steak
stjala	steal
dampur	steam
sjala	steel
bratti	steep
stelkur	stem
fet	step
pinnur	stick
stívur	stiff
framvegis	still
longu	still
enn	still
stinga	sting
pírin	stingy
rørsla	stir
goymsla	stock
stolið	stolen
búkur	stomach
steinur	stone
stóð	stood
skjóta	stool
steðga	stop
goymslurúm	storage
handil	store
ódnarveður	storm
søga	story
ovnur	stove
beint	straight
beinur teinur	straight
beint strekki	straight
beina leið	straightforward
órógva	strain
løgin	strange
fremmandur	stranger
strategi	strategy
strá	straw
jarðber	strawberry
strika	streak
streymur	stream
stroyma	stream
gøta	street
styrki	strength
strongd	stress
toyggja	stretch
teinur	stretch
strangur	strict
slag	strike
snórur	string
ál	strip
stremba	strive
tilburður	stroke
sterkur	strong
sligin	struck
uppbygging	structure
stríð	struggle
strev	struggle
stríðist	struggling
treiskur	stubborn
tvørur	stubborn
fangaður	stuck
lesandi	student
lestur	study
nám	study
lesnaður	studying
evni	stuff
tilfar	stuff
yndisligur	stunning
býttur	stupid
stílur	style
evni	subject
undirgivin	submission
geva seg undir	submit
evni	substance
eftirgerð	substitute
hárhvassur	subtle
eydnast	succeed
gott úrslit	success
væleydnaður	successful
slíkur	such
tílíkur	such
sovorðin	such
sum til dømis	such as
súgving	suck
knappligur	sudden
brádliga	suddenly
knappliga	suddenly
líða	suffer
pínast	suffer
líðing	suffering
nóg mikið	sufficient
sukur	sugar
skjóta upp	suggest
sipa til	suggest
uppskot	suggestion
klædningur	suit
hóskandi	suitable
sum hóskar	suitable
kuffert	suitcase
peningaupphædd	sum
samanumtøka	summary
summar	summer
tindur	summit
sól	sun
sunnudagur	sunday
sólskygdur	sunny
sólsetur	sunset
sólskin	sunshine
nógvur	super
yvirmaður	superior
umsjónarfólk	supervisor
nátturði	supper
útgerð	supply
stuðul	support
halda	suppose
væntaður	supposed
vissur	sure
ivaleyst	sure
vísur	sure
yvirfláti	surface
brotasjógvur	surge
skurðviðgerð	surgery
fornavn	surname
kemur óvart á	surprise
tikin á bóli	surprised
at lata av hondum	surrender
umhvørvi	surrounding
eftirlit	surveillance
umsjón	survey
yvirlit	survey
kanning	survey
yvirliva	survive
undir illgruna	suspect
hongdur upp	suspended
illgrunasamur	suspicious
halda á	sustain
burðardygni	sustainability
burðardyggur	sustainable
blómuleinkja	swag
svølg	swallow
umbýti	swap
svørja	swear
sveitta	sweat
troyggja	sweater
sópan	sweep
søtt	sweet
søtur	sweet
droym søtt	sweet dreams
søt tonn	sweet tooth
elskaði	sweetheart
elskaða	sweetheart
bólgnan	swell
bólgnaður	swelling
svimja	swim
svimjing	swimming
reiggja	swing
kontakt	switch
bólgnaður	swollen
hovin	swollen
svørð	sword
tekin	symbol
samkensla	sympathy
eyðkenni	symptoms
skipan	system
borð	table
reiðskapur	tackle
spjaldur	tag
hali	tail
taka	take
sum kann takast heim við	take away
ansa eftir tær	take care
fráferð	take off
tikin	taken
tosa	talk
prátingarsamur	talkative
høgur	tall
klikk	tap
band	tape
mið	target
starv	task
smakkur	taste
munnbiti	taste
smakkgott	tasty
lærdi	taught
te	tea
læra	teach
frálæra	teach
lærari	teacher
toymi	team
tár	tear
tár	tears
arga	tease
tøkni	technology
tenn	teeth
siga frá	tell
sig mær	tell me
sinnalag	temper
hitastig	temperature
tempul	temple
fyribils	temporary
tíggju	ten
tíggju túsund	ten thousand
leigari	tenant
røkja	tend
lyndi	tendency
eymur	tender
mjukur	tender
fjálturstungin	tense
spentur	tense
spenning	tension
tjald	tent
roynd	tentative
skeið	term
máliska	terms
ræðuligur	terrible
øgiligur	terrible
framúrskarandi	terrific
lendi	territory
roynd	test
tekstur	text
enn	than
tøkk	thank
Takk fyri	thank you
Takk fyri títt tolsemi meðan vit kannað ferming	Thank you for your patience while we investigate shipment
stóra tøkk	thank you so much
stóra tøkk	thank you very much
Takk fyri	thanks
takk fyri at tú nýtti app okkara	Thanks for using our app
tað	that
hetta er	that is
tað er gott	that's good
tað	the
stuldur	theft
teirra	their
tey	them
evni	theme
sjávlir	themselves
sjálvar	themselves
tá	then
ástøði	theory
har	there
har eru	there are
har er	there is
tí	therefore
hesi	these
tey	they
tey eru	they are
tjúkkur	thick
tjóvur	thief
lær	thigh
klænur	thin
tunnur	thin
lutur	thing
lutir	things
hugsa	think
triðingur	third
tystur	thirsty
trettan	thirteen
tríati	thirty
hetta	this
hetta er	this is
nágreiniligur	thorough
fullkomuliga	thoroughly
hasi	those
hasar	those
hasir	those
tó at	though
hóast	though
men	though
tanki	thought
hugsan	thought
hugsunarsamur	thoughtful
tankar	thoughts
túsund	thousand
tráður	thread
hótta	threat
hótta	threaten
trý	three
gátt	threshold
eldhugaður	thrilled
trivnaður	thrive
hálsur	throat
gjøgnum	through
alla tíðina	throughout
úr enda í enda	throughout
blaka	throw
tummil	thumb
tora	thunder
hosdagur	Thursday
á henda hátt	thus
soleiðis	thus
slikka	tick
fljóð og fjøra	tide
nossligt	tidy
reint	tidy
binda	tie
tikari	tiger
tættur	tight
tættskipaður	tight
Tigrinya	Tigrinya
tíð	time
mótleysur	timid
lítil	tiny
oddur	tip
drykkipengar	tips
dekk	tire
troyttur	tired
vevnaður	tissue
heiti	title
til	to
at vera	to be
skál	toast
í dag	today
smábarn	toddler
óviti	toddler
tær	toes
saman	together
vesi	toilet
segði frá	told
tolsemi	tolerance
tola	tolerate
tomat	tomato
í morgin	tomorrow
tunga	tongue
í kvøld	tonight
eisini	too
taka	took
amboð	tool
amboð	tools
tonn	tooth
tindur	top
toppur	top
evni	topic
sundurskræddur	torn
píning	torture
samantald upphædd	total
nerta	touch
tó	tough
rundferð	tour
imóti	toward
móti	towards
handklæði	towel
býur	town
eitrandi	toxic
spor	trace
gøta	track
slóð	track
rás	track
starv	trade
siðvenja	tradition
siðbundin	traditional
ferðsla	traffic
gøta	trail
tok	train
venjing	training
andlitsbragd	trait
eginleiki	traits
flutningur	transfer
yvirgonga	transition
týða	translate
skyggin	transparent
sending	transport
flutningur	transport
flutningur	transportation
fella	trap
skrell	trash
sálarligur snuddur	trauma
ferðast	travel
bakki	tray
skattur	treasure
fara við	treat
viðgerð	treatment
træ	tree
skelkandi	tremendous
stevna	trend
royndarkoyring	trial
rættarkanning	trial
snildir	trick
royndi	tried
elva til	trigger
formur	trim
ferð	trip
trupulleiki	trouble
buksur	trousers
lastbilur	truck
sandur	true
viðførisrúm	trunk
álit	trust
sannleiki	truth
royna	try
Tsonga	Tsonga
slanga	tube
týsdagur	Tuesday
undirvísing	tuition
leiðbeining	tuition
kalkun	turkey
gurkemaia	turmeric
snúningur	turn
skjaldbøka	turtle
universitetslærari	tutor
tólv	twelve
tjúgu	twenty
einogtjúgu	twenty-one
Twi	Twi
tvær reisur	twice
surra	twist
tvey	two
slag	type
eyðkendur	typical
ljótur	ugly
endaligur	ultimate
regnskjól	umbrella
ikki vera førur fyri	unable
pápabeiggi	uncle
mammubeiggi	uncle
i óviti	unconscious
undir	under
undirsíða	underneath
undirmeta	underrated
skilja	understand
skilti	understood
tíverri	unfortunately
til alla vanlukku	unfortunately
vanlukkutíð	unfortunately
herbúni	uniform
framúrskarandi	unique
eindømi	unique
frálíkur	unique
eind	unit
lærdur háskúli	university
ókendur	unknown
uttan	unless
inntil	until
óvanligur	unusual
upp	up
tað er upp til tín	up to you
dagføring	update
betring	upgrade
á	upon
óð	upset
uppøst	upset
býar	urban
eggjan	urge
skund	urgent
okkum	us
nýta	use
brúktur	used
gagnligur	useful
ónýtiligur	useless
vanligur	usual
vanliga	usually
gagn	utility
frítíð	vacation
fráflyting	vacation
koppseting	vaccination
koppingarevni	vaccine
tómi	vacuum
veikur	vague
væl grundaður	valid
dalur	valley
virðismikið	valuable
verð	value
fjølbroytni	variety
ymisir	various
ymissir	various
ymiskir	various
broytast	vary
vasi	vase
ovurstórur	vast
grønmeti	vegetable
grønmeti	vegetables
akfar	vehicle
seljari	vendor
eitur	venom
váðaverk	venture
staður	venue
kanna	verify
fjølkønur	versatile
útlegging	version
frágreiðing	version
avbrigdi	version
loddrættur	vertical
ógvuliga	very
sera	very
berur	very
sera gott	very good
kar	vessel
um	via
darran	vibe
titran	vibe
darran	vibes
titran	vibes
óreinur	vicious
offur	victim
sjónband	video
útsýni	view
bygd	village
illmenni	villain
edikur	vinegar
árgangs	vintage
harðskapur	violence
harðligur	violent
fer sum eldur um alnetið til teldupostar og sosialar miðlar	viral
jomfrú	virgin
veruligur	virtual
dygd	virtue
sjón	vision
vitjan	visit
myndapartur	visual
lívsneyðugur	vital
livandi	vivid
orðafeingi	vocabulary
rødd	voice
tómrúm	void
ljóðstyrki	volume
nøgd	volume
sjálvboðin	volunteer
spýggja	vomit
viðbrekin	vulnerable
løn	wage
løn	wages
miðja	waist
bíða	wait
tænari	waiter
bíðing	waiting
vakin	wake
vakna	wake up
ganga	walk
ganga	walking
veggur	wall
pengamappa	wallet
ganga	wander
vil	wanna
vilja	want
verða ynsktur	wanted
kríggj	war
klædnaskáp	wardrobe
vøruhús	warehouse
heitt	warm
ávara	warn
hitandi	warning
hermaður	warrior
var	was
vaska	wash
spilla	waste
hyggja	watch
síggja	watch
varðhald	watch
vatn	water
vatnmelón	watermelon
alda	wave
vegur	way
vit	we
vit eru	we are
vit kunnu	we can
veikur	weak
veikleiki	weakness
ríkidømi	wealth
ríkur	wealthy
ílatin	wear
brúkt	wearing
veður	weather
brúdleyp	wedding
mikudagur	Wednesday
illgras	weed
veikur	week
vikuskifti	weekend
vekt	weight
lodd	weight
løgi	weird
ger so væl	welcome
vælkomin	welcome
vælferð	welfare
Gott	Well
væl frágingið	well done
fór	went
vóru	were
vestur	west
vátur	wet
hvalur	whale
hvat	what
hvussu við tær	what about you
hvat ger tú	what are you doing
hvat ger tú nú	what are you doing now
hvat ger tú í løtuni	what are you doing now
Hvat ger tú beint nú	what are you doing right now
hvat ger tú	what do you do
hvørjum arbeiðir tú við	what do you do for a living
hvørjum tekst tú við	what do you do for a living
Hvat er starv títt	what do you do for a living
hvat meinar tú við	what do you mean
hvat vilt tú	what do you want
hvat hendi	what happened
hvat fór fram	what happened
hvat er	what is
hvat er hetta	what is this
hvørjum starvast tú við	what is your job
hvussu eitur tú	what is your name
Hvussu gongur	what's up
hvussu eitur tú	what's your name
óansæð	whatever
hveiti	wheat
hjól	wheel
tá	when
tá tað liggur fyri	whenever
hvar	where
hvar ert tú	where are you
hvaðini er tú	where are you from
hvaðani er tú	where are you from
Hvar er tú frá	where are you from
hvar er tú nú	where are you now
hvar byr tú	where do you live
hvar er	where is
harafturímóti	whereas
um	whether
antin	whether
hvat	which
hvør	which
ímeðan	while
tíð	while
løta	while
teska	whisper
floyta	whistle
hvítt	white
hvør	who
hvør er tú	who are you
hvør er	who is
hvør er hetta	who is this
heilt	whole
hvør	whom
hvørs	whose
hví	why
hví ikki	why not
óndur	wicked
óreinur	wicked
miskast	wide
breiður	wide
einkja	widow
vídd	width
maki	wife
kona	wife
villur	wild
vil	will
viljugur	willing
vinna	win
vindur	wind
vindeyga	window
gluggi	window
vindmikil	windy
vín	wine
vetur	winter
at turka av	wipe
veirur	wire
vísdómur	wisdom
vísur	wise
ynski	wish
eg ynski tær alt tað besta	wish you all the best
heks	witch
við	with
taka aftur	withdraw
afturtøka	withdrawal
innan	within
innvortis	within
við ongum	without
uttan	without
vitni	witness
stuttligur	witty
úlvur	wolf
kvinna	woman
kvinnur	women
vunnu	won
vil ikki	won't
undur	wonder
undurverk	wonder
ótrúligur	wonderful
undurfullur	wonderful
undursamur	wonderful
træ	wood
ull	wool
orð	word
orð	words
arbeiði	work
íðka	work out
arbeiður	working
heimur	world
ormur	worm
brúkt	worn
stúrin	worried
ekki	worry
verri	worse
guddyrkan	worship
ringast	worst
virði	worth
tað var tað vert	worth it
verdigur	worthy
vil	would
vildi	would
sár	wound
Wow	Wow
balla uttan um	wrap
vreiði	wrath
handlið	wrist
skriva	write
skriva her	Write here
skriva	writing
skrivað	written
skeift	wrong
skrivaði	wrote
garður	yard
geisp	yawn
Ja	Yeah
ár	year
ár	years
ger	yeast
róp	yell
gult	yellow
Ja	Yes
ja, góða	yes baby
Ja, góði	yes baby
ja, góða	yes dear
ja, góði	yes dear
ja, góða	yes honey
ja, góði	yes honey
ja, mín elskaða	yes my love
ja, mín elskaði	yes my love
ja, sjálvsagt	yes of course
í gjár	yesterday
enn	yet
avgrøði	yield
tú	you
tú er	you are
tú er vøkur	you are beautiful
tú er vakur	you are beautiful
tú er so vøkur	you are so beautiful
tú er so vakur	you are so beautiful
onki at takka	you are welcome
ger so væl	you are welcome
tú kanst	you can
tú kann	you can
tú veit	You know
eisini tú	you too
ger so væl	you're welcome
ungur	young
tín	your
ger so væl	your welcome
sjálvur	yourself
ungdómur	youth
ger so væl	you’re welcome
lekkurt	yummy
null	zero
