peteĩ	a
hejarei	abandon
ojehejapyre	abandoned
pu'aka	abide
ipyrusúva	ability
katupyry	able
hi'ári	above
pore'ỹ	absence
pore'ỹ	absent
upeichaite	absolutely
mbopyte	absorb
mombyky	abstract
vyrésa	absurd
hembýva	abundance
oĩhetáva	abundant
meg̃uamboru	abuse
muanduhẽ	accent
moneĩ	accept
jeike	access
japaro	accident
kotykoha	accommodation
hupyty	accomplish
jehupytypyre	accomplished
oje'eháicha	according
mba'erepy	account
hesetéva	accurate
mombe'uaipyra	accused
tasy	ache
g̃uahẽ	achieve
jehupyty	achievement
jehechakuaa	acknowledge
kuaapyre	acquaintance
mba'ejoguáva	acquire
amba'ejogua	acquired
jeguereko	acquisition
apo	act
ojejapóva	action
kyre'ỹ	active
mba'aporã	activities
mba'apo	activity
ha'ãngakuaáva	actor
añete	actual
Añetehápe	actually
akua	acute
jepokuaa	adapt
cultural adaptation	given
moinge	add
jeikerypy´ũ	addicted
jepokuaavai	addition
mbohetave	additional
heséva	adequate
ykeregua	adjacent
terayke	adjective
jejopy	adjust
guerohory	admire
moneĩpyréva	admit
ñemomba'e	adopt
juky	adorable
jehotenonde	advance
tenonde	advanced
yvytu	advantage
tembiasapyreita	adventure
ñe'ẽteykéva	adverb
moñe'ẽ	advice
moñe'ẽ	advise
pysyrõhára	advocate
porãreko	aesthetic
porohayhu	affair
hupytýva	affect
porayhu	affection
hepyme'ẽkuaa	afford
hepy'ỹva	affordable
kyhyjeha	afraid
rire	after
ka'aru	afternoon
upéi	afterwards
jey	again
hovaigua	against
arykuéra	age
mba'aporenda	agency
oñemombaretéva	aggressive
pya'e	agile
kupe	ago
ñemoneĩ	agree
ñoñe'ẽme'ẽ	agreement
ñemitỹ	agriculture
upéva aha'arõ	I hope so
tenonde	ahead
yvy ahoja	rug
pytyvõ	aid
monguatia	aim
ápe aime	I'm here
yvytu	air
aviõguejyha	airport
guatahapo'i	aisle
upe aja	meanwhile
upe aja	while
mombayhapu	alarm
kaguy	alcohol
marandu	alert
michĩmi	a little
aiko	alive
opavave	all
heja	allow
ojejapokuaáva	allowed
iporãmba	all right
mba'eporãmbaite	all the best
haimete	almost
ha'eño	alone
ipukukuévo	along
heta	a lot
atýragua	a lot of
oĩma	already
oiporã	Alright
avei	also
ambuekua	alternative
jepe	although
akói	always
che	am
ndaroviái	amazing
nahesakãporãiva	ambiguous
mba'epota	ambition
imba'epotaitereíva	ambitious
tetã ambuépe	abroad
myatyrõ	amend
mbytépe	amid
mbytépe	among
mboýpa	amount
vy'araity	amusing
peteĩ	an
hesa'ỹijo	analysis
tekove aña	villain
ypykuéra	ancestors
pindakakuaa	anchor
ymaguare	ancient
ha	and
Ah, añete	oh really
tupãremimbou	angel
pochy	anger
che angirũ	my friend
apy	angle
pochy	angry
mymba	animal
pyñuã	ankle
aramboty	anniversary
marandu	announcement
myangekói	annoy
pochyreko	annoyed
pochypópe	annoying
aryñavõgua	annual
mboy áño eguereko	how old are you
kuaa'ỹva	anonymous
ambue	another
mbohovái	answer
motenonde	anticipate
py'atarova	anxiety
py'atarova	anxious
oimeraẽva	any
nahanirivéima	anymore
mavave	anyone
oimeraẽva	anything
opaicharei	anyway
ha'eño	apart
mboja'oha	apartment
yvy ape arigua	global
eju ápe	come here
ehai ápe	Write here
mba'e apoha	factor
ñeñyrõuka	apologize
gua'u	apparent
tembijerurejey	appeal
apysẽ	appear
ojehechaháicha	appearance
osẽmbaite	appeared
vare'a	appetite
gjuavirana'a	apple
porupyrã	application
poru	apply
hysýi	appointment
momorã	appreciate
jehecharamo	appreciation
ñemboja	approach
hekópe	appropriate
moneĩpyre	approval
hasapyre	approve
ñemoneĩmby	approved
ag̃uiete	approximately
jasyrundy	april
mba'ekua apu'a	tube
ñande apytépe	among us
guatapuku ára ñavõ	commute
ko arapegua	nowadays
ko árape	today
opaite arapygua	everyone
arquitecto	architect
arquitectura	architecture
ñongatuha	archive
oĩ	are
hendaha	area
Nerembiapópa	are you busy
Remendápa	are you married
reimegueterípa	Are you still there?
jeikovai	argue
tembiakuaapy	argument
oñemotenonde	arise
jyva	arm
Guarini'aty	army
jerére	around
mohenda	arrange
myatyrõ	arrangement
g̃uahẽ	arrival
g̃uahẽ	arrive
g̃uahẽpyre	arrived
oñembotuicháva	arrogant
hu'y	arrow
temiporã	art
akytã	article
gua'úva	artificial
temiporãhára	artist
sa ary	century
pa ary	decade
vy'apavẽ arymbotýre	happy new year
mba'éicha	as
tusukue	ash
ñemotĩ	ashamed
jerure	ask
omba'eporandu	asked
kerambi	asleep
katuetévo	as long as
ha'ãnga	aspect
asamés	Assamese
monda	assault
mbosako'i	assembly
hesakuaitépe	assertive
hepyme'ẽ	assess
kuaara'ã	assessment
kyre'ỹ	asset
naiñate'ỹíva	assets
me'ẽ	assign
me'ẽ	assignment
pytyvõ	assist
pytyvõhára	assistant
moirũ	associate
atygua	associated
ñembyaty	association
ñemomba'e	assume
mo'ã	assumption
avei	as well
upeichaháicha	as well as
pe	at
okarúkuri	ate
hetekatupyry	athlete
pévajepe	at least
mbojoaju	attach
oñembojoapýva	attached
g̃uahẽmbaite	attack
ñeha'ãjey	attempt
ñangareko	attend
ñeime	attendance
jesareko	attention
lája	attitude
poropy'areraha	attract
hecharamo	attraction
oporopy'ara'ãva	attractive
aporãkatu	attribute
tekojoja'apoha aty	court
ñemoña aty	litter
henduharakuéra	audience
jasypoapy	august
pehẽngue	aunt
pehẽngue	aunty
tekoite	authentic
apohára	author
tendota	authority
araroguekúi	autumn
oĩ	available
rohayhu avei	I love you too
che avei	me too
nde avei	you too
mbytegua	average
jehekýi	avoid
páy	awake
me'ẽ	award
andukuaa	aware
andukuaa	awareness
mombyry	away
jarýi	awesome
ivairasa	awful
nahendáiva	awkward
aimara	Aymara
mitãra'y	baby
omenda'ỹva	bachelor
kupe	back
tapykuere	background
vai	bad
voko	bag
ñandy	bait
mbyakuha	bake
mbujaperenda	bakery
bicarbonato	baking soda
mbojoja	balance
manga	ball
Bámbara	Bambara
pakova	banana
mbopuha'aty	band
mbokapu	bang
Viruñeñongatuha	bank
guarirenda	bar
haimetéva	barely
ñemu	bargain
ape	bark
avatimirĩchu	barley
apañuãi	barrier
pyenda	base
oñemboguapypyre	based
koty'yvyguy	basement
pererĩva	basic
ñepyrũ'ypy	basically
albahaca	basil
ra'yoka	bastard
pehẽ	batch
jahuha	bath
koty'i	bathroom
ñaniryiryru	battery
ñorairõ	battle
ysyryrembe'y	bay
pararembe'y	beach
háse	beam
kumanda	beans
oso	bear
hendyva	beard
Oguerahávo	bearing
tytýi	beat
iporãiterei	beautiful
porãngue	beauty
moambue	became
eñangarekóke	be careful
rupi	because
jeikojey	become
tupa	bed
kotykeha	bedroom
káva	bee
vaka	beef
tetã	been
guariryju	beer
mboyve	before
moñepyrũ	began
ñepyrũ	begin
oñepyrũ	beginning
hérape	behalf
jeikoporã	behave
teko	behavior
Hapykuere	behaviour
kupépe	behind
upévo	being
jeroviapy	belief
guerovia	believe
tye	belly
imba'erehegua	belong
ojehayhúva	beloved
guýpe	below
ku'ajokoha	belt
mopẽ	bend
karape	beneath
jopoipyhy	benefit
mba'eporã	benefits
ipýpe	beside
avei	besides
iporãvéva	best
tandepo'aite	best of luck
jesarekópe	best regards
porãve	better
mbyte	between
jey'urã	beverage
hasave	beyond
Bhojpuri	Bhojpuri
omba'aposéva	bias
ag̃aguareko	biased
bicicleta	bicycle
poravorãrenói	bid
tuicha	big
apajerekõi	bike
kuatiarepykue	bill
mbojoaju	bind
guyra	bird
aramboty	birthday
sa'i	bit
su'u	bite
ro	bitter
hũ	black
kysepuku	blade
mboja	blame
nandi	blank
ahoja	blanket
mbokapu	blast
tanimbury	bleach
jehe'a	blend
hovasa	bless
ikaraipyre	blessed
ohecha'ỹva	blind
vy'apavẽ	bliss
tape	block
tuguy	blood
ñemboyvoty	bloom
peju	blow
hovy	blue
hãimbe'ỹva	blunt
techaukaha	board
yga	boat
tete	body
mbopupu	boil
iñakuã	bold
jokupyty	bond
kangue	bone
aranduka	book
mbohetave	boost
jejopyveha	booster
pyrehegua	boot
pyrehegua	boots
tetãkorapy	border
kaigue	bore
kaigue	bored
kuerái	boring
heñóiva	born
poru	borrow
momba'apohára	boss
mokõivéva	both
moangekói	bother
liméta	bottle
hypykue	bottom
jogua	bought
opopojevy	bounce
ojoajúva	bound
rembe'y	boundaries
guyrapa	bow
harroguasu	bowl
mba'yru	box
mitãrusu	boy
menarã	boyfriend
pyapyjeguaka	bracelet
apytu'ũ	brain
yvyrarakã	branch
téra	brand
py'aguasúva	brave
pa'ũnandi	breach
mbujape	bread
pytu'u	break
rambosa	breakfast
pyti'a	breast
pytu	breath
pytuhẽ	breathe
mongakuaa	breed
yvy'atã	brick
tembirekorã	bride
jehasaha	bridge
sapy'aite	brief
overa	bright
overáva	brilliant
gueru	bring
pehẽngue	bro
pe	broad
mbohasa	broadcast
jesoite	broke
jeka	broken
typycha	broom
hermano	brother
rovaja	brother in law
oguerúkuri	brought
yvysa'y	brown
kytyha	brush
reiete	bucket
irũ	buddy
hepykuaarã	budget
jejavy	bug
mba'e'apo	build
oga'apo	built
hetakuére	bulk
Vakame	bull
oporojukáva	bully
kandu	bump
aty	bunch
ejapo	bundle
mba'erepy	burden
oñeñotỹma	buried
hapy	burn
kapu	burst
ñotỹ	bury
mba'yruguata	bus
ñanandy	bush
ñemuharenda	business
pyti'a	bust
hembiapoheta	busy
hakatu	but
kyramonarã	butter
panambi	butterfly
votõ	button
jogua	buy
rupi	by
ñañe'ẽnguévo	by the way
tajao	cabbage
mburuvichakoty	cabinet
mymbarokái	cage
mbujapehe'ẽ	cake
vakara'y	calf
henói	call
ñehenói	called
cherenoimi	call me
py'aguapy	calm
og̃uahẽ	came
Myasãi	campaign
ikatu	can
Heja	Cancel
mba'asyvai	cancer
tovamokõi	can't
katupyry	capable
katupyry	capacity
tavaguasu	capital
ñe'ẽakãguy	caption
japyhy	capture
mba'yruguata	car
ñangareko	careful
reñangarekóke	carefully
oñangareko'ỹva	careless
py'apy	caring
yvyrapandára	carpenter
yvyhoja	carpet
sanaoria	carrot
raha	carry
japo	carry out
ojehúva	case
viruete	cash
poi	cast
ogakakuaa	castle
jehureíva	casual
mbarakaja	cat
japyhy	catch
hendápe	category
tymba	cattle
ojapyhy	caught
gui	cause
jesarekópe	caution
jepy'amongeta	cautious
itakua	cave
joko	cease
ogahoja	ceiling
guerovy'a	celebrate
koty'i	cell
mombyte	center
mba'era'ỹi	cereal
atypavẽ	ceremony
añete	certain
oje'ehaichaite	certainly
moañeteha	certificate
itasã	chain
apyka	chair
porohekáva	challenge
juruja	chance
guerova	change
sarambikue	chaos
heseguáva	character
heseguáva	characteristics
oĩha	charge
pytyvõreko	charity
ombopajéva	charming
haipyre	chart
hapykuereho	chase
mongeta	chat
hepy'ỹ	cheap
moñuha	cheat
guata'oka	cheating
vichea	check
tovayke	cheek
jekuaauka	cheer
hory	cheerful
porã	cheers
kesu	cheese
néi che kunu'ũ	yes dear
taneko´ẽporãit che mborayhujára	good morning my love
NÉI, che mborayhu	okay my love
oĩma chemborayhu	ok honey
néi che mborayhu	yes baby
héẽ, che mborayhu	yes honey
héẽ, che mborayhu	yes my love
kímika	chemistry
oĩma chera'a	ok dear
Ahayhu che reindýpe	I love my little sister
Ahayhu che reindy tenonderépe	I love my big sister
Néi che rembiayhu	ok my love
hecharamo	cherish
ahayhu che rúpe	I love my father
ahayhu che ryke'ýpe	I love my big brother
ahayhu che ryvýpe	I love my little brother
ajedréz	chess
pyti'a	chest
ahayhu che sýpe	I love my mother
Ehechaukápy chéve	show me
ñamindu'u	chew
ryguasu	chicken
mburuvucha	chief
mitã	child
mitãreko	childhood
mitã	children
ho'ysã	chill
tatatĩsẽha	chimneys
tañykã	chin
chocolate	chocolate
jeporavo	choice
poravo	choose
jopi	chop
mba'aporã	chores
kyraite	chubby
oñe'ẽ chupe	address
Tupão	church
canela	cinnamon
apu'a	circle
oikóvare	circumstances
tavayguára	citizen
táva	city
he'i	claim
myesakã	clarify
mbo'ehakoty	class
ñai'ũ	clay
ipotĩ	clean
hesakã	clear
pytyvõhára	clerk
arandu	clever
ñemuhára	client
pararembe'y	cliff
arareko	climate
jejupi	climb
ojapareíva	clingy
aravopapaha	clock
mboty	close
aorenda	closet
ao	cloth
ao	clothes
arai	cloud
araipa	cloudy
toryja	clown
marandurendapy	clue
ipomberu	clumsy
aty	cluster
mba'yrumýi	coach
tatapỹihũ	coal
yrembe'y	coast
Aokate	coat
café	coffee
apytu'ũmegua	cognitive
jejuhumo'ã'ỹre	coincidence
ho'ysã	cold
ñembyaipa	collapse
mbo'y	collar
javegua	colleague
oñoirũva	colleagues
mbyaty	collect
ñembyatyteĩre	collection
mbo'ehaovusu	college
sa'y	color
sa'y	colour
ytaguasu	column
kygua	comb
mbojeporukuaa	combination
mbojoja	combine
ju	come
jaha	come on
jejúvo	coming
tenondeve	coming soon
japouka	command
oje'éva	comment
ñemurã	commercial
japo	commit
ñe'ẽme'ẽ	commitment
porojokuáva	committed
mba'erepy	commodity
jepigua	common
mombeupy	communicate
ñe'ẽkuaamyasãi	communication
avarekoha	community
irũ	companion
tembiaporenda	company
mbojoja	compare
mbojoja	comparison
poriahuvereko	compassion
poriahuvereko	compassionate
hesegua	compatible
oñemoañotenondeséva	compete
katupyry	competent
ñeha'ã	competition
ipu'akáva	competitive
chi'õ	complain
ñemombe'u	complaint
moĩmbaha	complement
orekopáva	complete
opaite	completely
hypy'ũ	complex
py'ajoja	compliance
mbojetu'u	complicated
mongele'e	compliment
mboajeha	comply
oñondiveguáva	composition
oñondiveguáva	compound
kũmby	comprehension
kũmbykuaa	comprehensive
ñe'ẽme'ẽmby	compromise
jejapova'erã	compulsory
mohendaha	computer
jesarekoite	concentrate
kuaapy	concept
jepy'apy	concern
py'apy	concerned
mba'epujoyvy	concert
mohu'ã	conclusion
tekovia	condition
teko	conditions
teko	conduct
ñe'esyry	conference
mombe'u	confess
jerovia	confidence
jeroviapy	confident
moneĩ	confirm
ñorairõ	conflict
jesarea	confused
Guyryry	confusion
vy'apavẽ	congrats
mbovy'apavẽ	congratulation
Vy'apavẽ	congratulations
mbojoapy	conjunction
mbojoaju	connect
mosã	conquer
hechakuáva	conscious
apytu'ũjera	consciousness
potárupi	consent
apopyre'a	consequences
jeguereko	conservation
nomoambueséiva	conservative
hechakuaa	consider
jehechakuaa	considered
mba'erehegua	consist
hetepy'atãva	consistency
mba'e'atã	consistent
mantereiguáva	constant
mantereíva	constantly
tekakapa'ã	constipation
mopu'ã	construction
u	consume
hi'upyje'u	consumption
jekuaaverã	contact
ovakuaáva	contagious
oguereko	contains
ko'ag̃aguáva	contemporary
royrõ	contempt
pypegua	content
kuaara'ãmby	contest
ñe'ẽnda	context
yvyvusu	continent
mbojoapy	continue
ñoñe'ẽme'ẽ	contract
hesakãngue	contrast
pytyvõkuaa	contribute
pytyvõrã	contribution
jehechaukaha	control
mboikovaikuaáva	controversial
juporã	convenience
ouporãva	convenient
ñomongeta	conversation
moambuejey	convert
ñe'ẽmyasãi	convey
roviauka	convince
rovia	convinced
tembi'u'apo	cook
Otembi'u'apo	cooking
piro'ysã	cool
ñopytyvõ	cooperation
mbohovake	cope
kuarepotipytã	copper
mbyte	core
avati	corn
ykejoajuha	corner
hekokatúva	correct
repykue	cost
aogua'u	costume
óga	cottage
mandyju	cotton
apykaguasu	couch
hu'u	cough
ikatúne	could
Ñemoñe'ẽ	council
jepapa	count
hi'arigua	counter
tetã	country
ñu	countryside
ñemoirũ	couple
tekotee	courage
guerojera	course
poroguerekokuaa	courtesy
tiora'y	cousin
mo'ã	cover
vaka	cow
py'amirĩ	coward
py'aguapyreko	cozy
japeusa	crab
jeka	crack
apopyre	craft
vyrorei	crap
mbokapu	crash
mba'epotapy	craving
poñy	crawl
tavy	crazy
mboypy	create
iñapytu'ũrokypavẽ	creative
ijeroviaha	credit
mbojoha	creep
pirĩmba	creepy
mba'evai'apo	crime
otĩeterei	cringe
hasa'asy	crisis
temimo'ã	criteria
hemianduteĩva	critical
kaguai	criticism
ñemitỹ	crop
kóga	crops
kurusu	cross
yryvu	crow
atyguasu	crowd
je'oiha	crowded
akãngora	crown
tekotevẽterei	crucial
aña	cruel
ygaguasu	cruise
jopy	crush
tasẽ	cry
pepino	cucumber
añuã	cuddle
arandupy	culture
ikarakatúva	cunning
kaguaka	cup
tembiporurenda	cupboard
taperembe'y	curb
monguera	cure
oikuaaséva	curiosity
kuaase	curious
apopẽ	curly
Ko'ag̃agua	current
ko'ág̃aramo	currently
ñe'ẽngai	curse
ovetãhoja	curtain
aramboha	cushion
jepokuaa	custom
ñemuhára	customer
virumba'erepýre	customs
kytĩ	cut
porã	cute
vore	cycle
ciclismo	cycling
túva	dad
ru	daddy
kambyrenda	dairy
yno'õ	dam
mbyai	damage
añaretãygua	damn
mohe'õ	damp
jeroky	dance
ñemongyhyje	danger
iñangave'ỹva	dangerous
pytũ	dark
kunu'ũ	darling
ku'i	dash
marandurenda	data
fecha	date
tajýra	daughter
ára	day
mano	dead
apysape	deaf
ñe'ẽpeteĩ	deal
mi	dear
hayhupára	Dear All
Marchánte	Dear Customer
karaimi	Dear Sir
temimbo'ekuérami	Dear students
atymi	Dear Team
te'õngue	death
ñembohovake	debate
ojeíva	debit
ytymbyaty	debris
tepyme'ẽrã	debt
kaigue	decay
manopyre	deceased
mbotavy	deceive
jasypakõi	december
porã	decent
py'apeteĩ	decide
py'apeteĩ'apo	decided
py'apeteĩ	decision
pyendavusu	deck
mbotove	decline
mopokã	decrease
aranduhetakuaáva	dedicated
jejapoporã	dedication
apopy	deed
hypýva	deep
guasu	deer
upevakuére	default
po'ẽ	defeat
pysyrõ	defend
upeichaite	definitely
he'iséva	definition
jehupive	degree
mbegue	delay
ojejagarrába	delayed
mboje'oha	delete
japovaisevoi	deliberate
tekomirĩ	delicate
heterei	delicious
mytuẽ	delight
vy'a	delighted
me'ẽ	deliver
ñeme'ẽmbyre	delivered
me'ẽ	delivery
oñeikotevẽva	demand
jopy	demanding
jekupyty	democracy
aña	demon
hechauka	demonstrate
oñembotovéva	denied
pohyikue	density
tãipohãnohára	dentist
mbotove	deny
jeikorenda	department
ñesẽha	departure
joaju	depend
pyso	deploy
kotyñongatuha	deposit
motĩndýva	depressed
ãngakangy	depression
hypy'ũ	depth
techaukahai	describe
techaukaha	description
Yvymeme	desert
momba'eguasu	deserve
apora'ãngarã	design
me'ẽ	designation
potapy	desire
py'aropu	despair
py'aropu	desperate
mahe'ẽ	dessert
jehoha	destination
jehoha	destiny
mbyai	destroy
mbyai	destruction
sa'iha	detail
kuaa	detect
py'apeteĩ	determination
hekome'ẽ	determine
hekome'ẽva	determined
mbokusugue	devastated
guerojera	develop
guerojera	developed
guerojera	development
tembiporu	device
aña	devil
jeroviahára	devoted
Dhivehi	Dhivehi
tuguyasuka	diabetes
Tye	diarrhea
aragua	diary
ñe'ẽryru	dictionary
ojapo	did
mano	die
mano	died
karuporã	diet
joavy	difference
iñambue	different
hasy	difficult
jo'o	dig
katupyry	diligent
karupyhare	dinner
monaha	dip
hesete	direct
ogarenda	direction
myakãhára	director
mba'eky'a	dirt
ky'a	dirty
mbogue	disable
ñemonandi	disabled
kañy	disappear
mokangy	disappointed
sarambi	disaster
ñemboyke	discard
ñemboguejy	discharge
tekokuaaporu	discipline
hepysa'ive	discount
juhu	discover
apo'i	discrimination
jeikovai	discuss
jeikovai	discussion
mba'asy	disease
mba'asykuéra	diseases
tova'ãnga	disguise
mbojeguarúva	disgusting
ña'ẽmbe	dish
ña'ẽmbekuéra	dishes
mboyke	dismiss
guerahauka	dispatch
techaukahára	display
ñemoĩpyre	disposal
ñorãirõ	dispute
pukukue	distance
ojoavýva	distinct
jehechakuaa	distinguish
angata	distress
mboja'o	distribution
táva	district
myangekói	disturb
yvykua	ditch
typeka	dive
ikoéva	diverse
jopara	diversity
mboja'o	divide
jopoi	divorce
akãnga'u	dizzy
japo	do
pohãnohára	doctor
kuatia	document
ojapo	does
nahániri	doesn't
jagua	dog
dogri	Dogri
apohápe	doing
pyapy	doll
poguýpe	domain
ogayguáva	domestic
pu'akapa	dominant
me'ẽrei	donate
apopyre	done
Chavurro	donkey
Nahániri	don't
pohãvai	dope
kõi	double
py'amokõi	doubt
mbaipy	dough
iguýpe	down
mboguejy	download
cherayhúpa	do you love me
yvytupa'ũ	draft
mbosyryry	drag
hykue'o	drain
moha'anga	draw
kahõ	drawer
ta'anga	drawing
kyhyje	dread
kerecha	dream
sái	dress
mbokuaha	drill
mboy'u	drink
mboguataha	drive
mondoho	drop
ho'áva	dropped
ka'u	drunk
hypa	dry
Ype	duck
tío	dude
oñemoha'arõva	due
peicharupi	due to
kaigue	dull
výro	dumb
yñohẽha	dump
hi'arekue	duration
aja	during
yvytimbo	dust
tembiapo	duty
jeiko	dwell
omanopotáva	dying
peteĩteĩ	each
ojupe	each other
py'atarova	eager
apakani	eagle
nambi	ear
mboyve	earlier
voi	early
ñesẽtenonde	earn
nambi	ears
yvy	earth
yvyryrýi	earthquake
mbohasy'ỹ	ease
hasy'ỹme	easily
kóva	east
hasy'ỹ	easy
karu	eat
karuhápe	eating
hepy'ỹva	economic
virureko	economy
tembe'y	edge
moambue	edit
tekombo'e	education
hahykuere	effect
ha'eve	effective
hembiapoporãva	efficiency
hembiapoporãva	efficient
ñeha'ã	effort
ryguasurupi'a	egg
berenjena	eggplant
chénte	ego
poapy	eight
papoapy	eighteen
poapypa	eighty
oimeraẽva	either
apo	elaborate
jyvanga	elbow
tuichave	elder
tuja	elderly
ñembokate	elegant
elefante	elephant
pateĩ	eleven
poravokuaa	eligible
pe'a	eliminate
hetave	else
ñemotĩ	embarrassed
ñemotĩ	embarrassing
hupytypa	embrace
akarapu'ã	emerge
ojapuráva	emergency
py'andýireko	emotional
py'aporã	empathy
mbojekuaaverã	emphasis
hechaukave	emphasize
mba'apohára	employee
mba'apohára	employees
momba'apóva	employer
mba'apoha	employment
nandi	empty
mbopu'aka	enable
jejuhu	encounter
mokyre'ỹ	encourage
paha	end
oguepotaitémava	endangered
ñeha'ã	endeavor
pu'aka	endurance
gueropu'aka	endure
ija'e'ỹva	enemy
mbaretekue	energy
ñe'ẽme'ẽtee	engage
poravopyre	engaged
ñe'ẽme'ẽpyre	engagement
mba'eka	engine
papapykuaahára	engineer
inglés	English
moporã	enhance
hasaporã	enjoy
tuicha	enormous
hetáma	enough
mbojerovia	ensure
jeike	enter
vy'arã	entertainment
kyre'ỹ	enthusiasm
kyre'ỹ	enthusiastic
paite	entire
oñembohera'ỹva	entitled
temimoĩmby	entity
g̃uahẽha	entrance
mba'apome'ẽha	entrepreneur
ári	envelope
ñandejere	environment
potangai	envy
mba'asysarambi	epidemic
ojoja	equal
aty	equipment
viru	equity
mbojoja	equivalent
mboje'oha	eraser
naikũmbýi ereséva	I don't understand what you mean
Mba'épa erese	what do you mean
nahesakãi eréva	I don't understand you
jejavy	error
jehekýi	escape
mba'erãite	especially
ha'ã	essay
tekoite	essence
oñeikotevẽva	essential
mboguapy	establish
je'epyre	established
mba'erepy	estate
mbojerovia	estimate
ojehayhúva	estimated
ambueve	etc
apyre'ỹ	eternal
tekoporã	ethics
kuaara'ã	evaluate
hepyme'ẽ	evaluation
joja	even
pyhare	evening
Jeguerohyha	event
jepe	even though
ipahaitépe	eventually
ñavo	every
opavave	everybody
opaite	everything
ñembojapyre	evidence
vai	evil
mbokakuaa	evolution
mongakuaa	evolve
Ewe	Ewe
kue	ex
ha'ete	exact
hesakuaitépe	exactly
aranduchauka	exam
jehechauka	examine
tembiecharã	example
rasa	exceed
jarýi	excellent
ndoikéi	except
pe'apyre	exception
hetaiterei	excess
imba'erasa	excessive
me'ẽjovái	exchange
py'akyrỹi	excited
py'andýi	excitement
ñandujoko'ỹ	exciting
ñoite	exclusive
mbojeko	excuse
ñyrõ	excuse me
apo	execute
jejapo	execution
japopya'éva	executive
tembiaporã	exercise
kane'õ	exhaust
kane'õrasa	exhausted
hechauka	exhibit
jehechauka	exhibition
oĩ	exist
jeiko	existence
oĩva	existing
Ñesẽha	exit
myasãi	expand
ñeha'arõ	expect
ñemotenondepyréva	expected
joguapyre	expenses
hepy	expensive
tembiasa	experience
apora'ãteĩ	experiment
katupyry	expert
Kaluka	expired
myesakã	explain
myesakãrã	explanation
kapu	exploit
jehyvykói	explore
rova	export
hechauka	expose
oñemoĩreiete	exposed
jehechauka	exposure
je'ẽpyre	express
je'e	expression
pysove	extend
ojepysóva	extended
mbotuicha	extension
pysokue	extent
okapegua	external
oguepámava	extinct
oñemoĩvéva	extra
guenohẽ	extract
jepivegua'ỹva	extraordinary
apýra	extreme
rasaite	extremely
tesa	eye
tesa	eyes
ao	fabric
iporãitereirasa	fabulous
tova	face
rembohape	facilitate
ñemoĩmbyre	facilities
ñemohendapyre	facility
apopyre	fact
apopyrãhaguasu	factory
oikóva	facts
py'amano	fade
meg̃ua	fail
ñesẽvai	failed
jejavyreko	failure
py'amano	faint
oiporãva	fair
ha'evéma	fairly
jarýi	fairy
jerovia	faith
jeroviapy	faithful
gua'u	fake
ho'a	fall
japu	false
terakuã	fame
ogayguáva	familiar
ogaygua	family
karu'ỹguasu	famine
herakuava	famous
pejuha	fan
hova'atã	fancy
jarýi	fantastic
mombyry	far
ñemitỹhára	farmer
guerovia'ỹ	fascinating
jeporumeméva	fashion
pya'e	fast
ñandy	fat
oporojukáva	fatal
jehoha	fate
túva	father
kane'õrasa	fatigue
angaipa	fault
poravoraẽte	favorite
jerure	favour
guerohoryvéva	favourite
kyhyje	fear
karuguasu	feast
tague	feather
heseguáva	feature
teko	features
jasykõi	february
mbyaju	fed up
mba'erepy	fee
tembi'urã	feed
mandu'arãjey	feedback
ñandu	feel
andu	feeling
py	feet
kytĩ	fell
irũ	fellow
ñandúva	felt
kuña	female
kora	fence
ñemoñakatúva	fertile
vy'aguasu	festival
oguerekojey	fetch
akãnundu	fever
sa'i	few
michĩve	fewer
menarã	fiance
apy'ãreko	fiction
ñu	field
pohýi	fierce
papo	fifteen
popa	fifty
ñorairõ	fight
ñorairõme	fighting
ha'ãnga	figure
kuaareka	figure out
tapykuererekahai	file
myanyhẽ	fill
henyhẽ	filled
ta'angaryrýi	film
ky'a	filthy
ipahápe	finally
viruporukuaa	finance
virume'ẽ	financial
juhu	find
jeporekuaa	find out
multa	fine
kuã	finger
mohu'ã	finish
opa	finished
tata	fire
teraguapy	firm
peteĩha	first
pira	fish
pytaporã	fit
po	five
myatyrõ	fix
oñemyatyrõva'ekue	fixed
poyvi	flag
mimbi	flash
Tenda	flat
tembiapovai	flaw
marã'ỹ	flawless
guari	flee
so'o	flesh
oveve	flew
pyso	flex
hu'ũva	flexible
veve	flight
jere	flip
Guereko	flirt
ñemboki	flirting
ombovevúiva	float
yjasuru	flood
tendapa'ũ	floor
hu'itĩ	flour
mbosyry	flow
yvoty	flower
tĩsyry	flu
syrykue	fluent
syrýpe	fluently
haviru	fluffy
hykuévo	fluid
mberu	fly
tatatĩna	fog
tatatĩna	foggy
mboape	fold
kuimba'ekuéra	folks
hakykuerereka	follow
uperiregua	following
rakykuerereka	follow up
hi'upyrã	food
ñembotavy	fool
tavyrai	foolish
py	foot
fútbol	football
g̃uarã	for
mbarete	force
ha'uvõ	forecast
tenonde	forehead
pytagua	foreign
ka'aguy	forest
arerã	forever
hesarái	forget
ñyrõ	forgive
hesarái	forgot
tembiecharã	for instance
kypa	fork
ysaja	form
hekóicha	formal
mboyvegua	former
Ha'etépe	fortunately
vurureta	fortune
irundypa	forty
mboatukupe	foster
ñorãirõmbyre	fought
mboypy	found
irundy	four
parundy	fourteen
aguara	fox
pererĩ	fragile
okẽnda	frame
hetepy	framework
mbotavy	fraud
ojehechakatu'ỹva	freak
reiguáva	free
sãso	freedom
mohatã	freeze
mantereíva	frequency
jepiguáva	frequent
mantereíva	frequently
piro'y	fresh
arapoteĩ	friday
moro'ysãha	fridge
angirũ	friend
rayhuha	friendly
ñoangirũ	friends
tekoayhu	friendship
ñemondýi	frightened
omongyhyjéva	frightening
ju'i	frog
gua	from
henondeguáva	front
hatãmbyre	frozen
yva'a	fruit
po'a'ỹ	frustrated
Ñandyratarã	fuel
Fulfulde	Fulfulde
orekopáva	full
vy'akuaa	fun
hembiapo	function
mopyenda	fundamental
manoha	funeral
kachiãi	funny
akãrague	fur
pochyvai	furious
ve	further
ha'eve	furthermore
tenondegua	future
ñembosarái	game
jeka	gap
yty	garbage
yvotyty	garden
áho	garlic
okẽ	gate
ñembyaty	gather
ñembyaty	gathering
techaukaha	gauge
ome'ẽkuri	gave
meña	gender
opavavépe	general
tuichaháicha	generally
moheñói	generate
pojera	generous
imba'ekuaáva	genius
meña	genre
hory	gentle
hekopegua	genuine
teterechaukapy	gesture
reko	get
ñemonde	get dressed
hupyty	getting
pu'ã	get up
taneresãivokói	get well soon
póra	ghost
póraicha	ghosting
tuichaitereíva	giant
jopói	gift
jengibre	ginger
mitãkuña	girl
Kichiha	girlfriend
me'ẽ	give
ojeheja	give up
vy'a	glad
ma'ẽ	glance
ñeangecha	glass
tesarenondegua	glasses
he'ipa'ỹva	glimpse
pytũ	gloomy
poao	gloves
omimbi	glow
mimbi	glow up
mbojaha	glue
ho	go
jehove	go ahead
gol	goal
ojehupytyséva	goals
kavara	goat
jeho	go away
ñandejára	god
oho	goes
aha'aína	going
aháta	going to
itaju	gold
ndahapykueréiva	gone
jeho	gonna
iporã	good
porãite	good looking
po'aite	good luck
mba'erepy	goods
Google	Google
ypeguasu	goose
iporãiterei	gorgeous
terakuã	gossip
oreko	got
aikũmby	got it
ambue gotyo	across
tenonde gotyo	forward
tetãrerekua	government
pyhy	grab
mbeguekatúpe	gradually
mba'ekuaaru'ã	graduate
ra'ỹi	grain
me'ẽ	grant
oñeme'ẽva	granted
úva	grapes
pyhy	grasp
ka'avo	grass
aguyjeme'ẽreko	grateful
aguyjereko	gratitude
tyvy	grave
hũngy	gray
iporã	great
mba'epotarasa	greed
imba'epotáva	greedy
hovyũ	green
momaitei	greet
maitei	greeting
maitei	greetings
hovyhũ	grey
kora'aty	grid
mba'asy	grief
mongu'i	grind
jejoko	grip
ñemuha	grocery
menarã	groom
ikoróchova	gross
yvy	ground
aty	group
kakuaa	grow
kakuaa	growth
chi'õ	grumpy
arange g̃uahẽ meve	deadline
ndéve g̃uarã	for you
cheverõ g̃uarã	i guess
guarani	Guarani
mbojeroviauka	guarantee
opavavépe g̃uarã	public
ñangarekohára	guard
mba'emotepa	guess
mbohupa	guest
neĩrã gueteri	not yet
Guatarã	guidance
moakãhára	guide
mbojaha	guilty
tekove	guy
ojueheguáva	guys
tetemongu'eha	gym
ára ha ára	daily
jepokuaa	habit
tekoha	habitat
orekókuri	had
ndépa ha'e	are you
Che ha'e	I’m
teko ha'ete	accuracy
Toikove	hail
áva	hair
mbyte	half
kotyguasu	hall
po	hand
saingo	hang
jehu	happen
oikova'ekue	happened
vy'apavẽ	happiness
vy'a	happy
vy'apavẽ	happy birthday
hatã	hard
hasýpe	hardly
mba'e'apovai	harm
oporombyaíva	harmful
puporã	harmony
hatã	harsh
mono'õ	harvest
oguereko	has
py'ako'õ	hate
reko	have
tande'araporãite	have a good day
rambosa	have breakfast
Vy'akuaa	have fun
rekarúpiko	have you eaten
oguerekóvo	having
cháke	hazard
tatatina	haze
ha'e	he
akã	head
akãrasyvai	headache
monguera	heal
monguera	healing
tesãi	health
hesãi	healthy
hendu	hear
ohendúkuri	heard
korasõ	heart
haku	heat
ára	heaven
pohýi	heavy
py'aropu	hectic
yvatekue	height
jararã	heir
ha'éva	he is
monda	heist
ojokókuri	held
añaretã	hell
Mba'éichapa	Hello
akãrehegua	helmet
pytyvõ	help
jokuaikuaa	helpful
upévare	hence
mba'e hepy	treasure
i	her
ndururu	herd
ápe	here
imba'eteéva	heritage
oñembohory hese	mock
Eho hese péicha	keep it up
itavyete hese	thrilled
ambojoaju heseve kuatia	attachment
ipya'amokõi	hesitate
Nde	Hey
Mba'éichapa	Hi
kañy	hidden
mongañy	hide
tuvicharenda	hierarchy
yvate	high
jehechaukakuaave	highlight
guata	hike
tapepo'i	hiking
ikyre'ỹetereíva	hilarious
yvytymi	hill
ha'e	him
iporãko hína	worth it
kuaaukavy	hint
ku'a	hip
kuakuéra	hips
jasyporuka	hire
momba'apo	hiring
imba'e	his
tembiasakue	history
pete	hit
Maitei	Hi there
mmm	Hmm
akãraku	hobby
joko	hold
ha'arõ	hold on
kuára	hole
arete	holiday
pa'ũ	hollow
óga	home
mba'e'aporã	homework
tekoporã	honest
tekopotĩme	honestly
Kunu'ũ	Honey
terakuãguasu	honor
akãmo'ãha	hood
potãi	hook
yvyra	hop
esperanza	hope
hi'ãite	hopefully
jeroviaha'ỹre	hopeless
ipekuévo	horizontal
hatĩ	horn
ivaieterei	horrible
kyhyjevai	horror
kavaju	horse
tasyo	hospital
tekorory	hospitality
ogajára	host
myangekói	hostile
haku	hot
pytu'uha	hotel
aravo	hour
aravokuéra	hours
óga	house
ogaygua	household
akãreñói hovyũ isa'yỹva oke pochypópe	colorless green ideas slept furiously
mba'éicha	how
mba'éicha	how is
mboýpa	how many
mboýpa	how much
Mba'eichaitépa	how often
mbyte	hub
ména	hubby
añuã	hug
tuichaiterei	huge
yvypóra	human
noñemomba'eguasúi	humble
he'õ	humid
havẽmba	humidity
sa'aty	hundred
ñembyahýi	hungry
marika	hunt
yvytu'atã	hurricane
py'arag̃e	hurry
pya'eve	hurry up
mbohasy	hurt
ména	husband
myaña	hustle
óga	hut
potĩreko	hygiene
che	I
che	I am
ikatukuaa	I can
ndikatúi	I can't
yrypy'a	ice
temimo'ã	idea
oñeha'ãrõháicha	ideal
joguaha	identical
jekuaapyre	identify
herakuaáre	identity
tavyrai	idiot
ndoku'evéi	idle
ajapo	I do
Ndaikuaái	I do not know
naikũmbýi	I do not understand
Ndaikuaái	I don't know
Ndaikuaái	I don’t know
Naikũmbýi	I don't understand
Naikũmbýi	I don’t understand
ramo	if
ñembotavy	ignore
arekókuri	I had
areko	I have
aiméva	I have been
mba'e ijaisýva	goo
péicha ikatukuaa	in order to
Aikuaa	I know
arohory	I like
roguerohory	I like you
hasýva	ill
leimboykeha	illegal
mba'asy	illness
ilocano	Ilocano
oikoite	I love
Rohayhu	I love you
rohayhueterei	I love you so much
Che	I'm
ta'ãnga	image
ha'ãngáva	imagine
ha'ese	I mean
Rohechaga'u	I miss you
rohechaga'ueterei	I miss you so much
ag̃aiteguáva	immediate
ag̃aiténtema	immediately
tuichaitereíva	immense
hapykueréva	impact
py'arag̃e	impatient
moingeñepyrũ	implement
pytaguañemu	import
momba'eguasu	important
japouka	impose
ikatu'ỹva	impossible
jehechaukase	impress
temimo'ã	impression
guerovy'a'ỹ	impressive
moporãve	improve
ñemoporã	improvement
Cheñyrõ	I'm sorry
pe	in
avei	in addition
hekope'ỹ	inappropriate
mokyre'ỹ	incentive
jeikovai	incident
moinge	include
jeikéva	including
jeike	income
hekopegua'ỹ	inconvenience
moĩve	increase
mbotuichave	increased
ojeguerovia'ỹva	incredible
upeichaite	indeed
hekosã'ỹva	independent
India	India
hechauka	indicate
te'ýi	indigenous
teko'año	individual
reha'arõ'ỹva	inevitable
upeichaite	In fact
mitãrekóva	infant
ai	infection
apyra'ỹreko	infinity
ruru	inflammation
viruguejy	inflation
ipokatu	influence
momarandu	inform
marandu	information
henondépe	in front of
porupyrã	ingredients
hejapyre	inheritance
ñepyrũ	initial
hasýva	injured
ñehunga	injury
mitãreko	innocent
mbopyahuha	innovation
mba'eporandu	inquiry
tavy	insane
vícho	insect
py'amirĩ	insecure
moinge	insert
hyepy	inside
hechapy	insight
jerurejey	insist
keve'ỹ	insomnia
moapytu'ũroky	inspiration
mokyre'ỹ	inspire
tembiecharã	instance
ko'ag̃aite	instant
rãngue	instead
hendaguépe	instead of
jejaporaẽva	instructions
tembiporu	instrument
ja'o	insult
kyhyje'ỹha	insurance
ojepoko'ỹva	intact
hekopeteĩva	integrity
iñarandúva	intellectual
katupyry	intelligence
arandu	intelligent
ha'ã	intend
intended	intended
pohýi	intense
potapy	intention
jekupyty	interact
jekupyty	interaction
virumemby	interest
oikuaaseteéva	interested
iporãite	interesting
oñemombyte	interfere
mbytegua	intermediate
hyepygua	internal
tetãnguéra	international
hasyñenóva	internship
ñeikũmby	interpret
ñe'ẽmbohasahára	interpreter
joko	interrupt
ñe'ẽjovake	interview
oñondivegua	intimate
pype	into
moinge	introduce
moñepyrũmby	introduction
hekoñembotýva	introvert
kuaatenonde	intuition
moneĩ'ỹ	invalid
moheñói	invent
jeguerokorysýi	inventory
moambue	invest
hapykuerereka	investigate
ñeipepirũ	invitation
ñepepirũ	invite
ñemumbyrehai	invoice
moinge	involve
oikepáva	involved
oreko ipype	contain
kuarepoti	iron
ha'e	is
ahecha	I see
yno'õ	island
ñemomombyry	isolated
mba'e	issue
upéva	it
ytaguasu itaguigua	concrete
artículo	item
rehegua	items
arovia	I think
oĩ	it is
ha'e	it's
imba'e	its
oho	it was
aikũmby	I understand
ndaipóri ivaíva	no problem
aipota	I want
rohechase	I want to see you
roipota	I want you
chékuri	I was
aháta	I will
chéne	I would be
chakéta	jacket
ka'irãi	jail
ko'ẽrõ jajohecháta	see you tomorrow
jasyteĩ	January
hárro	jar
ikatu jave	ever
upe jave	whereas
tañykã	jaw
hakate'ỹreko	jealous
poyvi jeguaka	strip
tenda jehechaukaha	stage
upéicharamo jepe	despite
upéicharamo jepe	however
výro	jerk
jeguaka	jewelry
peteĩ jey	once
hekopeteĩ joavy	miscellaneous
mba'apo	job
ñanipopo	jogging
mbyaty	join
kanguejoajuha	joint
jaru	joke
apañuãi jora	settle
maranduhára	journalist
guatapuku	journey
tory	joy
tekojojahára	judge
yvarykue	juice
jasypokõi	july
po	jump
jasypoteĩ	june
mba'evaikue	junk
tembi'u jurujokoha	snack
hekopotĩ	just
ejaponte'arã	just do it
tekojoja	justice
mba'érepa	justify
Kamisa jyva	sleeve
Kalaallisut	Kalaallisut
ao kate	suit
tetia'éva	keen
jeguereko	keep
oguerekókuri	kept
Ytakuryru	kettle
ndavoka	key
pyvoi	kick
mitã	kid
ñembojaru	kidding
pitikiri'ĩ	kidney
mitãnguéra	kids
porojuka	kill
rory	kind
michĩmi	kinda
hory	kindly
py'aporã	kindness
réi	king
Hetũ	kiss
kosina	kitchen
mbyjarata	kite
mbarakaja'i	kitten
tenypy'ã	knee
oikuaákuri	knew
kyse	knife
Kuimba'e	knight
kuaa	know
kuaa	knowledge
ojekuaáva	known
anga kõingue	soulmate
Konkani	Konkani
mba'yrumýi koty	garage
Krio	Krio
nuez ku'i	nutmeg
avena ku'i	porridge
amo kuña ha'e	she is
Mba'éichapa, kunu'ũ	hello dear
néi, kunu'ũ	okay baby
Néi, kunu'ũ	okay honey
jeveve kyhyje'ỹre	safe flight
maranduhaipyre	label
mba'apo	labor
tembiapo	labour
guereko'ỹ	lack
jupiguejyha	ladder
kuñakarai	lady
oñemboguapypyre	laid
ypa	lake
ovechara'y	lamb
kaigue	lame
tesapeha	lamp
yvy	land
ñupyso	landscape
ñe'ẽ	language
tapypa'ũ	lap
tuicha	large
paha	last
terajoapy	last name
ka'aru	late
ipahaitépe	lately
ka'aruve	later
ramoiteguavéva	latest
paha	latter
puka	laugh
hory	laughing
puka	laughter
myasãi	launch
aojoheirenda	laundry
léi	law
kapi'ipe	lawn
ñe'ẽngára	lawyer
moĩ	lay
apeao	layer
ta'ãnga	layout
ate'ỹ	lazy
myakã	lead
omoakãva	leader
togue	leaf
ñekañy	leak
porãguerojera	lean
po	leap
kuaapyhy	learn
ñembokatupyrykuévo	learning
porukavepy	lease
sa'ive	least
pire	leather
sẽ	leave
osẽ	leaves
LED	led
asu	left
tetyma	leg
hapykuereja	legacy
tekome'ẽhe'íva	legal
mombe'ugua'u	legend
ha'etéva	legit
tekoreíva	leisure
poru	lend
pukukue	length
mbovy	less
mbo'epy	lesson
heja	let
kuatiañe'ẽ	letter
tajaomirĩ	lettuce
yvatekueha'ã	level
poru	leverage
arigua	liability
arandukarenda	library
heréi	lick
japu	lie
japu	lies
teko	life
mopu'ã	lift
tesakã	light
aravera	lightning
arohory	like
ikatukuaa	likely
avei	likewise
kytarysýi	line
Lingala	Lingala
joajuha	link
leõ	lion
hykuéva	liquid
rysýi	list
hendu	listen
hendyhápe	listening
he'ihaichaite	literally
ñe'ẽporãhaipyre	literature
michĩ	little
ko	live
py'akue	liver
oiko	lives
guapyha	living
kotyñeimehã	living room
teju	lizard
mba'epohýi	load
mbujape	loaf
jeporupy	loan
hendaite	local
ñeimeha	location
mbotyha	lock
ñemboty	lockdown
mboguapyha	log
puka	lol
ha'eño	lonely
puku	long
Jesareko	look
sã	loop
poipyre	loose
karai	lord
takykue	lose
po'ẽ	loss
kañýva	lost
yvy	lot
hyapúva	loud
kotyguasu	lounge
mborayhu	love
hekopajéva	lovely
rohayhu	love you
iguýpe	low
guejy	lower
jerovia	loyal
jeroviaha	loyalty
po'a	luck
ipo'áva	lucky
Luganda	Luganda
voko	luggage
jokuapy	lump
karu	lunch
ñe'avevúi	lungs
mba'ehepy	luxury
japu	lying
mba'eka	machine
pochy	mad
kuñakarai	madam
apopyre	made
kuatiahai	magazine
jarýi	magnificent
tembiguái	maid
tuichavéva	main
guereko	maintain
ñangareko	maintenance
Maithili	Maithili
momba'eguasu	major
hetavéva	majority
japo	make
moingo	make up
kuimba'e	male
nemurenda	mall
kuimba'e	man
mongu'e	manage
motenondeha	manager
katuetéva	mandatory
haipy	manifest
japurã	manipulate
teko	manner
Aguyje mante reha'arõ haguére roheka aja umi mba'e ojeguerukava'ekue	Thank you for your patience while we investigate shipment
popeguáva	manual
heta	many
jasyapy	march
pa'ũnandi	margin
ñemuguasu	market
haimete márõ	hardly ever
menda	marriage
omendáva	married
tovajo'a	mask
tuichakue	mass
tuichakue	massive
Mba'ekuaavetehára	master
partido	match
irũ	mate
iñapỹiva	material
Papapykuaa	math
mba'e	matter
hi'aju	maturity
mayo	may
mesa mba'apoha	desk
mesa mba'aporã	bench
Ore mba'e'aporã: opavave toikũmby ha toñomongeta ñe'ẽnguéra rupive	Our mission: to enable everyone, everywhere to understand the world and express themselves across languages.
Ore mba'e'aporã: yvóra marandu ñemohenda opapave oikuaa ha oiporúva.	Our mission: to organize the world's information and make it universally accessible and useful.
Maitei mba'éichapa	hello how are you
Maitei, mba'éichapa reime	hello how are you doing
Nde mba'éicha reime	what about you
ikatu mba'e	maybe
taheta mba'eporã pejujeyhágui	many many happy returns of the day
ko'ã mba'ére	issues
ndaipóri mba'érepa	you are welcome
tuicha mba'éva	significant
tembiapo mbohapehára	agent
che mborayhu	my love
che	me
tembi'u	meal
he'ise	mean
he'iséva	meaning
mbytevoréva	means
je'eva'ekue	meant
ha'ã	measure
ha'ã	measures
so'o	meat
pohãnohára	medical
pohanokuaa	medicine
py'amongeta	meditation
mbyte	medium
ñombyaty	meet
aty	meeting
Meiteilon	Meiteilon
mboyku	melt
mandu'a	memories
mandu'a	memory
apytu'ũregua	mental
jehechakuaa	mention
oñe'ẽva'ekue	mentioned
sãmbyhyhára	mentor
ñemuhára	merchant
poriahuvereko	mercy
tasy'ỹ	merely
guyryry	mess
marandu	message
iky'a	messy
kuatepoti	metal
tapereko	method
anguja	mice
mbyte	middle
pyharepytũ	midnight
pokatu	might
vevúi	mild
mba'eguasu	milestone
milíko	military
kamby	milk
sua	million
pensar	mind
apy'ãháicha	mindset
chemba'e	mine
jejehe'a	mingle
imitãvéva	minor
aravo'i	minute
aravo'i	minutes
jehupavẽkatu	miracle
itangecha	mirror
oporombyaíva	mischievous
heko'asýva	miserable
tekoasy	misery
techaga'u	miss
okañýva	missing
mba'e'aporã	mission
rohechaga'u	miss you
aratĩmbo	mist
jejavy	mistake
Mizo	Mizo
omýiva	mobile
techapyrãramo	model
akãguapy	moderate
iyahúva	modern
jejapo'ỹva	modest
mboguejy mohendahápe	install
he'õva	moist
he'õ	moisture
irundypa mokõi	forty-two
ta'ãnga	mold
ñuaũ	mole
sy	mom
ko'ag̃aite	moment
arakõi	monday
apopyrã moñepyrũ	initiative
viru	money
mymba mongakuaaha	farm
apu'ajere mongu'e	gear
jehechaha	monitor
ka'i	monkey
jasy	month
teko	mood
pirevai	moody
Jasy	moon
tova mopeteĩha	trait
tekoporã	moral
heta	more
hi'arijey	moreover
Ko'ẽ	morning
mbo'itaguy	mortgage
heta	most
ñepyrũrãitevoi	mostly
aty motendeha	commission
sy	mother
mongu'e	motion
mokyre'ỹ	motivation
yvyty	mountain
anguja	mouse
juru	mouth
mongu'e	move
mongu'e	movement
ta'ãngamýi	movie
Kuñakarai	mrs
heta	much
tuju	mud
hárro	mug
tajygue	muscle
apokatuĩro	museum
capiñón	mushroom
mba'epu	music
hembiapo	must
ñe'ẽngu	mute
oñondive	mutual
che	my
Mi	My dear
cheréra	my name is
torypápe	my pleasure
chete	myself
herug̃ua	mysterious
kañymby	mystery
mombe'ugua'u	myth
Che nahániri	I don't
Ko'ag̃a nahániri	Not now
mba'érepa nahániri	why not
pyapẽ	nail
výro	naive
téra	name
araka'eve nañañeme'ẽiva'erã	never give up
mba'asy ñangarekoha	nurse
po'i	narrow
ay	nasty
tetãygua	national
tetãygua	nationality
ypykuéra	native
tekoha	nature
py'ajere	nausea
aretéma ndajajehechavéi	long time no see
ipahápe, ndatuichamba'evéiramo	last but not least
ha nde	and you
Mba'éichapa nde árara'e	how was your day
ha nde	how about you
mba'éichapa ndepyhare	good evening
mba'éichapa ndepyhare	good morning
mba'éichapa ndepyhare	good night
mba'éichapa ndepyhare	goodnight
mba'eichaitépa ndepyhare	how was your night
mba'éichapa nderéra	what is your name
mba'éichapa nde réra	what's your name
Vy'apavẽ ndéve g̃uarã	happy birthday to you
Mávapa nde	what do you want
moõguápa nde	where are you from
máva nde	who are you
marãve ndoikói	nevermind
ñe'ẽveve ndojeipotáiva	spam
ag̃ui	near
ag̃ui	nearby
haimete	nearly
mohendakuaa	neat
oñeikotevẽva	necessary
ajúra	neck
mbo'y	necklace
Google ñe'ẽasa	Google Translate
kotevẽ	need
peteĩ ñe'ẽ ndahetái araka'eve	one language is never enough
mbotove	negative
techagi	neglect
ñemoñe'ẽpeteĩ	negotiate
jepyta ñehenói	curfew
ogaykeregua	neighborhood
mba'evéichagua	neither
mba'éichapa neko'ẽ	good day
tembiapo ñemboaporekopýva	industry
manga ñembosarái	soccer
mano ñembyahýigui	starving
viru ñemoambue	currency
tai ñemoñe'ẽ	spell
atyguasu ñemopyendarã	foundation
marandu ñemurã	advertisement
marandu ñemurã	advertising
sobrino	nephew
egueruka ne ra'anga	send me your picture
iñarandúva	nerd
Mba'épa ne rembiapo	what is your job
py'atytýi	nervous
rupa	nest
jeipyso'oso'ỹre	net
ñanduti	network
ñemombyte	neutral
araka'eve	never
tanderesarái	never mind
jepéramo	nevertheless
pyahu	new
marandu	news
ag̃ui	next
ipýpe	next to
iporãiterei	nice
pehẽngue	niece
pyhare	night
kerai	nightmare
porundy	nine
paporundy	nineteen
porundypa	ninety
nahániri	No
avave	nobody
tyapu	noise
hyapúva	noisy
avave	none
marandu ñongatuha	track
asajepyte	noon
nahániri	nope
jepe	nor
jepigua	normal
yvatévo	north
tĩ	nose
techaga'u	nostalgic
nahániri	not
mba'eveichavérõ	not at all
porã	not bad
haipy	note
ojehechaukáva	noted
mba'eve	nothing
hechakuaa	notice
ojehechakuaáva	noticed
téra	noun
téra	nouns
mombe'upyrusu	novel
jasypateĩ	november
ko'ág̃a	now
mba'eveichavérõ	no way
angekói	nuisance
mba'evegua	null
japa	numb
papapy	number
upéicha nunga	apparently
nue	nut
ñe'ẽme'ẽ	oath
kyrarasa	obesity
ñe'ẽrendu	obey
mba'e	object
jehupytyrã	objective
apopyrãtee	obligation
pytũ	obscure
jesareko	observation
jesareko	observe
py'ajopy	obsessed
py'ajopy	obsession
tujapyre	obsolete
apokytã	obstacle
jeguereko	obtain
ojeguerekóva	obtained
ojekuaaháicha	obvious
ojekuaapámava	obviously
sapy'ánteva	occasionally
tembiapo	occupation
oikorei'ỹva	occupied
oiko	occur
oiko	occurred
oikóva	occurs
paraguasu	ocean
jasypa	october
joja'ỹva	odd
joja'ỹ	odds
gua	of
upeichaite	of course
oguehápe	off
royrõ	offensive
hepy'ỹva	offer
mba'apoha	office
tetãmba'éva	official
jepi	often
ha'e oguereko	he has
oh	Oh
mba'eitarysýi oikóva	streak
Mba'e oiko	what's up
ñandyhũ	oil
ipoguýpe oĩva	handle
liñoitére oĩva	online
ipepe oĩva	properties
pe oje'eséva	that is
tembiasakue ojehecharamóva	epic
mba'épa ojehu	what happened
ndovaléiva ojejapo	forbidden
mba'éichapa ojejapóva'erã	process
ambue ojeporavokuaáva	option
avakuéra ojojaveguáva	generation
oĩma	ok
néi	okay
jehayhúva	okay dear
tuja	old
pe	on
peteĩ	one
ao oñeñongatuha	wardrobe
sevói	onion
ha'eño	only
ojejapóva opa ára	routine
ñepyrũpýgui opa peve	throughout
pe'a	open
apo	operation
oje'éva	opinion
juruja	opportunities
juruja	opportunity
joavýva	opposite
jeroviakuaa	optimistic
poravokuaa	optional
térã	or
narã	orange
hekopete	order
jepivegua	ordinary
ha'e oreko	she has
mohendakuaa	organization
mbohape	orientation
ypykue	origin
ypykue	original
Oromo	Oromo
tyre'ỹ	orphan
ambue	other
ambueháicha	otherwise
ñande	our
okápe	out
sẽ	outcome
ñemonde	outfit
sẽpotáva	outgoing
tendyrysẽha	outlet
jere	outline
okápe	outside
jepivegua'ỹva	outstanding
mbyakuha	oven
rehe	over
tuichaháicha	overall
pu'aka	overcome
Pérupi	over there
ñamindu'ueterei	overthinking
hekoasýva	overwhelmed
jopy	overwhelming
hembiaporã	owe
urukure'a	owl
areko	own
jára	owner
guéi	ox
hasa	pace
jejokuapyeta	pack
mba'epehẽ	package
maitei paha	farewell
hepyme'ẽmbyre	paid
hasy	pain
ta'ãnga	paint
takambyrundy	painting
papyjoja	pair
hesa'yju	pale
karanda'yrogue	palm
virumba'asy	pandemic
kyhyjevai	panic
kasõmbuku	pants
kuatia	paper
yvotyrokái	paradise
ijyvijojáva	parallel
mba'yrupehẽ	parcel
ñyrõ	pardon
túva	parents
okarusu	park
gua'a	parrot
perejil	parsley
pehẽ	part
jejapo	participate
poravpyre	particular
avateĩgua	particularly
irũ	partner
vy'arã	party
hasa	pass
pyrũ	passage
ymaguare	passed
vy'apota	passion
akãraku	passionate
ipy'aguapýva	passive
taiñomi	password
hasapyréva	past
mbotyha	patch
tapepo'i	path
mopirĩva	pathetic
jahei'ỹ	patience
ra'arõkuaa	patient
momba'apohára	pattern
pa'ũ	pause
yvy'atã	pavement
hepyme'ẽ	pay
hepyme'ẽ	payment
py'aguapy	peace
py'aguapy	peaceful
melocotón	peach
hu'ã	peak
yvavo'ĩ	pear
kumandareko	peas
teete	peculiar
kuaru	pee
piro	peel
papapyete	peer
ñoirũ	peers
so'o pehẽngue	steak
haiha	pen
haiha	pencil
oha'arõva	pending
yvypóra	people
ky'ỹi	pepper
ñandupyre	perceive
japyhykatúva	perception
japepo pererĩ	pan
Iporãmbajepéva	perfect
apo	perform
ojapokuaáva	performance
ikatu	perhaps
arapa'ũ	period
tapiaguáva	permanent
jehechagi	permission
jurujái	permit
ñepia'ã	perseverance
jeyjey	persistent
yvypóra	person
ha'ete	personal
teko	personality
hechamombyry	perspective
roviauka	persuade
tie'ỹ	pervert
tymba	pet
téra peteĩha	first name
sa'ỹijo peteĩteĩ	details
jajohecha peve	bye
jajohecha peve	good bye
Jajoecha peve	goodbye
jajoecha peve	see you later
ko'a peve	so far
aravore	phase
ojehukakuaáva	phenomenon
arandupukuaaty	philosophy
pumbyry	phone
ta'ãnga	photo
ñe'ẽ'apesã	phrase
hete	physical
poravo	pick
ñembyatyjey	pick up
ha'ãnga	picture
pehẽ	piece
koty	pieces
kure	pig
pykasu	pigeon
tendyme'ẽha	pile
aramboha	pillow
mba'yrumbovevehára	pilot
ju	pin
avakachi	pineapple
Pytãngy	pink
kuára	pit
ñembosaraiha	pitch
ñembyasy	pity
tenda	place
tenda	places
Mba'evai	plague
ñupyso	plain
aponde'a	plan
aviõ	plane
yvyra	plant
ñana	plants
ña´ẽmbe	plate
pyendavusu	platform
ñembosarái	play
ñembosaraihápe	playing
ijuky	pleasant
mína	please
tyg̃uatã	pleased
mbovy'aha	pleasure
ñe'ẽme'ẽ	pledge
heta	plenty
ñepu'ãse	plot
mbotyha	plug
ciruela	plum
fontanero	plumber
papyeta	plural
podcast	podcast
ñe'ẽpoty	poem
ñe'ẽpoty	poetry
kyta	point
tykuevai	poison
tahachi	police
tetãrayhu	policy
hekorory	polite
ñembohekotyai	pollution
yrenda	pond
ytarenda	pool
tekaka	poop
mboriahu	poor
ojehayhúva	popular
tetãyguára	population
ñeñandu porã	comfort
jeiko porã	comfortable
mba'apo porã	good job
ipínta porã	handsome
hasa porã	hang out
aime porã	I am fine
aime porã	I'm fine
aime porã	I'm good
tandeka'aru porãite	good afternoon
tande'ára porãite	have a nice day
oĩ porã	it's ok
oĩ porã	It's okay
mba'e'apo porandu'ỹre	arbitrary
karu porã	nutrition
tandekera porã	sweet dreams
oĩ porã	that's good
japo porã	well done
kure	pork
Ygag̃uahẽha	port
ñeĩha	position
py'aporã	positive
guereko	possess
guerekopy	possession
rerekopaséva	possessive
ikatukuaaite	possible
jehechauka	post
mbohasa	postpone
makychĩ	potato
kyre'ỹ	potential
libra	pound
mboriahureko	poverty
pokatu	power
pokatu	powerful
apokuaa	practical
japo	practice
Ñemomorã	praise
jaru	prank
ñembo'e	pray
porãiterei	precious
ha'ete	precise
katuete	precisely
hechatenonde	predict
potaveha	prefer
motenonde	preference
hyeguasu	pregnant
mbyai	prejudice
tenda	premises
prima	premium
ñembosako'i	preparation
ñembosako'i	prepare
apopyre	prepared
ñe'ẽriregua	preposition
tovake	presence
ĩ	present
hechauka	presentation
ñongatu	preserve
mburuvicha	president
marandumyasãiha	press
jejopy	pressure
ñembotavy	pretend
iporã	pretty
pia	prevent
mboyvegua	previous
pyhypyre	prey
hepykue	price
juruvu	pride
pa'i	priest
tenondeguáva	primary
tenondeguáva	prime
princesa	princess
tenondetegua	principal
mboyve	prior
ñemotenonde	priority
ka'irãi	prison
iimba'etee	privacy
jekuaa'ỹva	private
hayhuve	privilege
hepyme'ẽ	prize
ikatukuaa	probably
apañuãi	problem
guerojera	procedure
jehove	proceed
ojapo	produce
mba'eapopyre	product
apopyre	production
tembiapo	profession
katupyrytee	professional
yke	profile
tembiaporepy	profit
pypuku	profound
akãrapu'ã	progress
apopyrã	project
ñe'ẽme'ẽngue	promise
moherakuã	promote
moherakuã	promotion
pya'e	prompt
hekopoi	prone
terarãngue	pronouns
ñemokũjera	pronunciation
kuaara'ã	proof
heseguáva	proper
imba'erekóva	properly
imba'éva	property
mba'ekuave'ẽmby	proposal
oñeha'arõva	prospect
po'areko	prosperity
po'a	prosperous
ñangareko	protect
juruvu	proud
ha'ã	prove
me'ẽ	provide
taupéichanteke	provided
tetãpehẽ	province
tekotevẽva	provision
mitã'aky	puberty
ndokyvéi puku	drought
mombo	pull
andai	pumpkin
aravoietépe	punctual
temimbo'e	pupil
pop purahéi	pop
jogua	purchase
marã'ỹ	pure
pytãũ	purple
rembipota	purpose
vosa	purse
hapykuéri	pursue
jeheka	pursuit
myaña	push
moĩ	put
tembiporu pyahu	technology
ko pyharépe	tonight
jehyvykói pypuku	thorough
ñeime pysyrõhápe	stay safe
hepyme'ẽ	qualification
porãngue	quality
hetakue	quantity
ñemoha'eño	quarantine
ñorairõ	quarrel
jasyapy'aty	quarter
quechua	Quechua
reina	queen
kuimba'ese	queer
mba'eporandu	query
porandu	question
tuguái	queue
pya'e	quick
pya'e	quickly
py'aguapy	quiet
ñuvãha	quilt
heja	quit
rasa	quite
mba'era'a	quiz
ñembyatykuaaha	quotation
hysýi	quote
jojuhu	quotes
hembiapo ra'arõva	willing
tapiti	rabbit
ñemoñanga	race
ñeko'õi	rage
ama	rain
jehupi	raise
tekoyvate	raised
techapyrã ramo	For example
oñani	ran
ijykegua	random
teko	range
pya'e	rapid
pya'e	rapidly
jepivegua'ỹ	rare
sapy'aguáva	rarely
mbita'i	rash
anguja	rat
mbohepy	rate
rãngue	rather
tuichakue	ratio
apy'ãreguáva	rational
pýra	raw
hupyty	reach
ojehupytýva	reached
pu'ã	reaction
lee	read
moñe'ẽrã	reading
Oĩmbáma	ready
añete	real
añetegua	reality
hechakuaa	realize
jehechakuaa	realized
añetehápe	really
teviro'o	rear
temiandu	reason
apy'ãreko	reasonable
ñemomandu'a	recall
virume'ẽhare	receipt
japyhy	receive
japyhypyre	received
ramoitegua	recent
nda'areiete	recently
mog̃uahẽ	reception
teko rechauka	define
apopyrã	recipe
jehechakuaa	recognition
hechakuaa	recognize
jekuaauka	recommend
jeroviaha	recommended
mboguapyre	record
guerekojey	recover
ñeimeporãjey	recovery
hakãmbymbo'ýva	rectangle
pytã	red
jora	redeem
jora	redemption
momichĩ	reduce
ñe'ẽhetareíva	redundant
mombe'u	refer
kuaukarã	reference
hechauka	reflect
py'amongeta	reflection
pujoja	refrain
moho'ysãha	refrigerator
myengovia	refund
porujey	refuse
mbotove	refused
jehechakuaa	regard
oje'évare	regarding
jepevéramo	regardless
maitei	regards
tavapehẽ	region
Ñemboheraguapy	register
ñembyasy	regret
mbohekojoja	regular
katuínte	regularly
upéva rehegua	about
tupã rehegua	divine
mba'e rehegua	element
mombe'u rehegua	narrative
ygarata rehegua	ship
Nde rehénte	up to you
moõ reiko	where do you live
mba'éichapa reime	hi how are you
mba'éichapa reime	how are you
mba'éichapa reime	how are you doing
moõ reime ko'ág̃a	where are you now
mba'éichapa reime ko árape	how are you doing today
mba'éichapa reime ko árape	how are you today
Moõpa reime	where are you
Aguyjevete reiporuhaguére ore rembiporu	Thanks for using our app
mba'épa reja ko'ag̃aite	what are you doing right now
Mba'éichapiko rejapo	how do you do
mba'épa rejapo ko'ág̃a	what are you doing
mba'épa rejapo ko'ág̃a	what are you doing now
mombia	reject
Ani rejepy'apy	Don't worry
tereho reke	go to bed
ñembojoja	relate
heseguaite	related
jokupyty	relationship
hesegua	relative
pehẽnguekuéra	relatives
rekopy'aguapy	relax
mosãso	release
sasõpyre	released
heseguáva	relevant
jeroviaha	reliable
py'avevúi	relief
mbovevúi	relieve
okueramievéva	relieved
tupãjerovia	religion
tupãrayhu	religious
jejapojeýva	reluctant
jerovia	rely
ñeime	remain
hembýva	remaining
Ojehechakuaavéva	remarkable
mba'épe remba'apo	what do you do
Mba'épepa remba'apo	what do you do for a living
ogapy rembiporu	furniture
pohã	remedy
mandu'a	remember
Ndépa remendáva térã remenda'ỹva	are you married or single
mandu'a	remind
momandu'ahára	reminder
mombyryeterei	remote
pe'a	remove
jesareko renda	focus
mba'apoha renda	venture
apo	render
Kuarehy rendy	sunshine
nde reñemoneĩ	do you
mba'erepy	rent
myatyrõ	repair
je'ejey	repeat
myengovia	replace
mbohovái	reply
momarandu	report
myakã	represent
tekorechapy	reputation
tembijerure	request
mba'ejerure	require
apopeteĩrã	required
pyhyjey	rescue
tembikuaareka	research
jejogua	resemble
py'atyai	resentment
mohemby	reservation
ñemboyke	reserve
tendagua	resident
heja	resign
akãrapu'ãjey	resilience
tosã	resilient
ñemyatã	resist
jepytaso	resistance
apoukapy	resolution
apañuãijora	resolve
mba'eguerekopy	resort
tembiporu	resources
momba'e	respect
mbohovái	respond
mbohovái	response
hembiaporeko	responsibility
poguypegua	responsible
pytu'u	rest
karurenda	restaurant
topytu'u	rest in peace
mbohekopyahu	restore
joko	restrict
ohejáva	result
ojehecháva	results
moñepyrũjey	resume
ñemumirĩ	retail
ñongatu	retain
jejoko	retention
jeipyre	retired
jeyjey	retreat
rekojey	retrieve
jujey	return
myesakã	reveal
mbojekuaa	revealed
py'arasykue	revenge
virumono'õ	revenue
guevi	reverse
vichea	review
vichea	revise
hechajey	revision
ñepu'ã	revolution
mbojopói	reward
purysýi	rhythm
ñarukã	rib
arro	rice
iviruhetáva	rich
jei	rid
guata	ride
jepuka	ridiculous
akatúa	right
ko'ag̃aite	right now
omyi'ỹva	rigid
kuãirũ	ring
joheijo'a	rinse
guyryry	riot
jeka	rip
hi'aju	ripe
moĩve	rise
kyhyjerã	risk
hovaigua	rival
ysyry	river
tape	road
moka'ẽ	roast
kakuaa	robust
itaguasu	rock
yvyra	rod
cherory roikuaáre	nice to meet you
kuatia	role
mbojere	roll
ogahoja	roof
irundyha	room
rapo	root
sã	rope
tuju	rotten
korócho	rough
hekoitépe	roughly
jere	round
tapeguasu	route
hysýi	row
mba'ere'ẽ ro'ysã	ice cream
pichy	rub
mangaysy	rubber
yty	rubbish
tie'ỹ	rude
sái ruguái	skirt
tapere	ruin
mbojojaha	rule
sãmbyhyhára	ruler
mbojojaha	rules
ñañi	run
mbosyryha	running
okaraygua	rural
rag̃e	rush
aokate	sack
itupãrekóva	sacred
jehasa'asy	sacrifice
katuete	safe
kyhyje'ỹ	safety
arandu	sage
he'íkuri	said
tataindy	sail
ytaha	sailing
mba'érepa	sake
tembiaporepy	salary
mboguejy	sale
salmón	salmon
juky	salt
viru sãmbyhykuaa	management
upeichaguaite	same
hechauka	sample
yvyku'i	sand
Sánscrito	Sanskrit
oñembohorýva	sarcastic
kachiãi	sassy
arapokõi	sat
tyg̃uatã	satisfaction
hyg̃uata	satisfied
mohyg̃uatã	satisfy
angapyhy	satisfying
arapokõi	Saturday
so'ojopypy	sausage
ñarõ	savage
pysyrõ	save
ohechákuri	saw
e	say
pirapire	scale
mbotavy	scam
pere	scar
pokã	scarce
ñemondýi	scared
ajuriaogua	scarf
mongyhyjéva	scary
sarambi	scattered
oikóva	scene
ñupyso	scenery
tyakuã	scent
tiempo	schedule
mitãrusumbo'ehao	school
tembikuaa	science
tembikuaarekahára	scientist
mba'ekuaahára	scientists
jetapa	scissors
ja'o	scold
hupyty	scope
kytame'ẽ	score
mba'ekue	scrap
karãi	scratch
sapukái	scream
pejuha	screen
kutujereha	screw
apopyrã	script
para	sea
ta'ãnga'i	seal
jeheka	search
aravore	season
guapyha	seat
mokõiha	second
ñemigua	secret
tenda	section
kyhyje'ỹ	secure
kyhyje'ỹ	security
hecha	see
ra'ỹi	seed
heka	seek
jehu	seem
ni'ãche	seems
ojehecháva	seen
jajohecháta	see you
juru'akua	seize
ñemomba'e	seizure
jepive'ỹguáicha	seldom
poravo	select
mba'éva	self
ñemboguera	self healing
ha'enteséva	selfish
hepyme'ẽ	sell
rahauka	send
tuichavéva	senior
ñandukuaáva	sense
akãguapy	sensible
andukuaa	sensitive
guerahauka	sent
ñembo'e	sentence
ñe'ẽjoaju	sentences
mboja'o	separate
Sepedi	Sepedi
jasyporundy	september
takykuerigua	sequence
tysýi	series
vaieterei	serious
añetehápe	seriously
ñangareko	serve
tembiapopy	service
aporã	session
mohenda	set
jejopyrã	setting
mbohete	set up
pokõi	seven
papokõi	seventeen
pokõipa	seventy
hetaichagua	several
ivaietereíva	severe
mbovyvy	sew
sh	sh
ta'anga	shade
kuarahy'ã	shadow
jetyvyro	shake
mba'aporã	shall
pererĩ	shallow
poriahuvereko	shame
molde	shape
mboja'o	share
hãimbe'e	sharp
ha'e	she
mo'ãha	shed
ovecha	sheep
savana	sheet
mba'erenda	shelf
pire	shell
kañyrenda	shelter
ape'atã	shield
ha'arõkuaa	shift
overa	shine
Oguerahaukáva	shipping
kamisa	shirt
sapatukuéra	shoes
japi	shoot
ñemurenda	shop
jogua	shopping
rembe'y	shore
mbyky	short
mbovy	shortage
mbokapu	shot
va'erã	should
ati'y	shoulder
sapukái	shout
hechauka	show
jahuha	shower
kamarõ	shrimp
ñyñýi	shrink
mboty	shut
ekirirĩ	shut up
hi'otĩva	shy
pehẽngue	sibling
pehẽngue	siblings
hasýva	sick
yke	side
ãho	sigh
hecha	sight
Guataha	sightseeing
mboheraguapy	sign
teraguapy	signature
kirirĩ	silence
kirirĩme	silent
ysorenimbo	silk
výro	silly
viru	silver
joguaha	similar
výro	simp
ndahekohetáiva	simple
ojovái	simultaneously
guive	since
japu'ỹ	sincere
jesarekópe	sincerely
purahéi	sing
puraheihára	singer
imenda'ỹ	single
moñapymi	sink
karai	Sir
pehẽngue	sister
uke'i	sister in law
guapy	sit
tendapy	site
teko	situation
poteĩ	six
papoteĩ	sixteen
poteĩpa	sixty
tuichakue	size
katupyry	skill
katupyrykuéra	skills
pire	skin
piru	skinny
jepopo	skip
ára	sky
tembiguái	slave
ke	sleep
kehápe	sleeping
keparei	sleepy
hi'upy	slice
ta''ãngarechauka	slide
mbeguekatu'asy	slightly
Po'i	slim
pysyrỹ	slip
oha'arõva	slope
pa'ũ	slot
mbegue	slow
mbeguekatu	slowly
michĩ	small
arandu	smart
hetũ	smell
pukavy	smile
tatatĩ	smoke
apesỹi	smooth
Jatyta	snail
mbói	snake
so	snap
yrypy'avavúi	snow
upéicharõ	so
Ñapymi	soak
havõ	soap
akãporã	sober
ava'aty	social
avano'õ	society
py'ao	socks
iporãite	so cute
sỹi	soft
software	software
sapy'ajepi	soil
ñemumbyrémava	sold
guarini	soldier
hepyme'ẽmbyre	sold out
hekopeteĩva	sole
hatãva	solid
myatyrõ	solution
mbo'aipo'i	solve
peteĩva	some
máva	somebody
oimeháicha	somehow
máva	someone
mba'e	something
akóinte	sometimes
purahéi	song
pya'e	soon
hekojegua	sophisticated
Sorani	Sorani
susu'a	sore
ahy'orasy	sore throat
ñembyasy	sorrow
chediskulpa	Sorry
mohenda	sort
ojehekáva	sought
ãnga	soul
pu	sound
tykue'i	soup
hái	sour
heñoipy	source
ñemby	south
pa'ũ	space
tuichakue	span
karaiñe'ẽ	Spanish
rekoviarã	spare
ñe'ẽ	speak
mba'eraite	special
nungakuéra	species
ha'etéva	specific
mopirĩ	spectacular
eñe'ẽ	speech
Ñe'ẽngu	speechless
pya'eterei	speed
jehepyme'ẽ	spend
tuja	spent
rokuete	spicy
jopi	spike
mbojere	spin
ka'anaite	spinach
ãnga	spirit
ndyvu	spit
iporãitereíva	splendid
jeho	split
mokunu'ũ	spoil
oñemokunu'ũva	spoiled
ijeheguirei	spontaneous
kũimbe	spoon
marã	spot
kichiha	spouse
mona	spread
arapoty	spring
hakambyrundýva	square
hykue'o	squeeze
kuatĩ	squirrel
kutu	stab
ñeimeporã	stable
mbochovi	stack
mba'apohára	staff
para	stain
jupiha	stairs
ha'ã	stake
tapo	stalk
mymbaróga	stall
ta'angajopy	stamp
ñemboyhápe	stand
techaukarã	standard
mbyja	star
ñepyrũ	start
moñepyrũ	started
teko	state
mombe'u	statement
arajere	station
ta'angaita	statue
tetã	status
pyta	stay
ndoku'éiva	steady
monda	steal
timbo	steam
kuarepotitã	steel
yvate	steep
sy	stem
pyrũ	step
yvyra	stick
mohatã	stiff
ne'írã	still
jopihare	sting
jopy	stingy
pyvu	stir
apopy	stock
mondapy	stolen
py'a	stomach
ita	stone
oĩkuri	stood
tekaka	stool
pyta	stop
mono'õha	storage
ñemurenda	store
yvytu'atã	storm
tembiasa	story
tembi'u'aporenda	stove
naikarẽiva	straight
yvype	straightforward
pochy	strain
jepigua'ỹva	strange
hekomarãva	stranger
akãporukuaa	strategy
Kapi'i	straw
fresa	strawberry
Ysyry	stream
tape	street
mbarete	strength
kane'õpyre	stress
pehẽngue	stretch
hekoitére	strict
mba'apopyta	strike
sã	string
ñepia'ã	strive
mbota	stroke
mbarete	strong
poronupã	struck
hetepy	structure
hasýva	struggle
ñorãirõme	struggling
tova'atã	stubborn
ojáva	stuck
temimbo'e	student
ñemoarandu	study
ñemoarandu	studying
mba'e	stuff
iporãitéiko	stunning
tovatavy	stupid
tekopy	style
ñe'ẽrã	subject
poguyguáva	submission
rahauka	submit
mbaipy	substance
myengovia	substitute
vevui	subtle
hupyty	succeed
ñesẽporã	success
hekovepo'a	successful
ha'eteháicha	such
peichaite	such as
pyte	suck
ojehureíva	sudden
peichahágui	suddenly
jepy'apy	suffer
tekoasy	suffering
oĩporãma	sufficient
asuka	sugar
momarandu	suggest
momarandu	suggestion
heseguáva	suitable
voko	suitcase
mbohetave	sum
mombyky	summary
arahaku	summer
tu'ã	summit
kuarahy	sun
arateĩ	sunday
ikuarahy	sunny
kuarahyresẽ	sunset
oikoite	super
yvateve	superior
jesarekohára	supervisor
karupyhare	supper
jehupytyka	supply
pytyvõ	support
mo'ã	suppose
ñeimo'ãva	supposed
upeichaite	sure
ape	surface
mbotuicha	surge
ñembovo	surgery
rerajoapy	surname
oñeha'ãrõ'ỹva	surprise
noha'arõite	surprised
ojeheja	surrender
ojerévo	surrounding
jesareko	surveillance
porandueta	survey
jeikove	survive
ñemo'ã	suspect
jejokopyre	suspended
ñembojaha	suspicious
mbojoko	sustain
guerojerapuku	sustainability
hekojokopykuaáva	sustainable
tekoporãmby	swag
mokõ	swallow
ñomoambue	swap
ñe'ẽme'ẽpy	swear
ty'ái	sweat
ao	sweater
typei	sweep
he'ẽ	sweet
kunu'ũ	sweetheart
mba'ehe'ẽ'uha	sweet tooth
ruru	swell
ruru	swelling
yta	swim
ytakuaa	swimming
ñemyatymói	swing
myandyha	switch
ruru	swollen
kysegi	sword
mba'ejehero	symbol
tory	sympathy
ñandukuaa	symptoms
mohendapyrã	system
aripaka	table
ñemboja	tackle
mbohéra	tag
tuguái	tail
japyhy	take
pe'a	take away
ejesarekóke	take care
jaipyhypyre	taken
pe'o	take off
ñe'ẽ	talk
oñe'ẽva	talkative
yvate	tall
Tupã tanderovasa	god bless you
ysẽha	tap
apoype	tape
morotĩ	target
heko tarováva	reckless
mba'aporã	task
kũmby	taste
heterei	tasty
ombo'ékuri	taught
kojói	tea
mbo'e	teach
mbo'ehára	teacher
aty	team
tesay	tear
tesay	tears
moñeko'õi	tease
kuaara'ã techaukaha	grade
tãi	teeth
mba'apokuaa teéva	career
e	tell
ere	tell me
mbohekoporã	temper
arapytureko	temperature
haty	temple
ag̃aguarã	temporary
pa	ten
mbohupa	tenant
mosãingo	tend
je'ereta	tendency
kyrỹi	tender
ñesẽ tenonde	gain
jeho tenondeve	carry on
ára	tense
pyatã	tension
ñemuha	tent
ikatúneva	tentative
pasu	ten thousand
ñe'ẽ	term
teko	terms
ivairasáva	terrible
iporãrasa	terrific
yvytuicha	territory
aranduchauka	test
maranduhai	text
aguyjeme'ẽ	thank
aguyjevete	thanks
aguyje	thank you
aguyjevete	thank you so much
aguyjevete	thank you very much
péva	that
ha'e	the
monda	theft
imba'ekuéra	their
hikuái	them
ñe'ẽrã	theme
upéicharõ	then
kuaapy	theory
amo	there
oĩ	there are
upevakuére	therefore
oĩ	there is
ko'ãva	these
ha'ekuéra	they
hikuái	they are
poguasu	thick
mondaha	thief
ñeñongatupýva	thigh
Po'i	thin
mba'e	thing
mba'e	things
jepy'amongeta	think
mbohapyha	third
y'uhéi	thirsty
paapy	thirteen
mbohapypa	thirty
kóva	this
kóva	this is
jehechasa'imimi	thoroughly
umíva	those
jepe	though
upéicharõ	thought
mba'erechakuaa	thoughtful
apytu'ũroky	thoughts
su	thousand
inimbo	thread
ja'o	threat
ha'anga	threaten
mbohapy	three
rembe'y	threshold
ñakãrapu'ã	thrive
ahy'o	throat
rupi	through
mombo	throw
kuãnguasu	thumb
arasunu	thunder
arapo	Thursday
upéicha	thus
jatevu	tick
yjupi	tide
omohendakuaáva	tidy
ñapytĩ	tie
Jaguarete	tiger
jopypópe	tight
Tigrinya	Tigrinya
aravo	time
otĩ	timid
mirĩ	tiny
virujopói	tip
tekombo'e	tips
mba'ejerepytu	tire
kane'õ	tired
pyahapy	tissue
myakãha	title
g̃uarã-hag̃ua	to
maimbe	toast
mitã'i	toddler
pysãnguéra	toes
oñondive	together
koty'i	toilet
oikohague	told
techagi	tolerance
pu'aka	tolerate
tomáte	tomato
ko'ẽrõ	tomorrow
ñe'ẽ	tongue
avei	too
ojapyhýkuri	took
tembiporu	tool
tembiporu	tools
tãi	tooth
yvate	top
ñe'ẽrã	topic
karãimbyre	torn
ñembyepotíva	torture
opaite	total
poko	touch
hasy	tough
ñeikundaha	tour
gotyo	toward
gotyo	towards
mokãha	towel
táva	town
oporombyaíva	toxic
takykuere	trace
ñemurenda	trade
jepokuaa	tradition
jepokuaa'yma	traditional
ku'eñemurã	traffic
tapejehoha	trail
ñembosako'i	train
ñembokatupyryve	training
teko	traits
mbohasa	transfer
jehasasapy'a	transition
ñe'ẽmbohasa	translate
marã'ỹ	transparent
rojaha	transport
mba'yru	transportation
ñuha	trap
yty	trash
moangata	trauma
guatapuku	travel
ña'ẽmbeguasu	tray
trata	treat
ñemboguata	treatment
yvyra	tree
jeporumeméva	trend
apy'ãpo	trial
truco	trick
ha'ãmbyre	tried
ñembokapu	trigger
ñekytĩ	trim
guatapuku	trip
apañuãi	trouble
kasõmbuku	trousers
kamiõ	truck
teete	true
vokorenda	trunk
jerovia	trust
añetegua	truth
ha'ã	try
Tsonga	Tsonga
araapy	Tuesday
andu tuicha	tremendous
mbo'erã	tuition
vy'apavẽ tupãra'ýre	merry christmas
jaku	turkey
cúrcuma	turmeric
jere	turn
karumbe	turtle
ñangarekohára	tutor
maitei tuvakuéra	Dear Parents
pakõi	twelve
mokõipa	twenty
mokõipapeteĩ	twenty-one
Twi	Twi
mokõijey	twice
jere	twist
mokõi	two
hesegua	type
ymareko	typical
ivai	ugly
ipahapeguáva	ultimate
mo'ãha	umbrella
pituva	unable
pehẽngue	uncle
ojaporeíva	unconscious
iguýpe	under
iguýpe	underneath
ra'ã	underrated
kũmby	understand
hesakã	understood
añarã	unfortunately
mbojojateĩ	uniform
ipeteĩva	unique
vorepeteĩ	unit
mbo'ehaovusu	university
kuaa'ỹva	unknown
ndaupéichairamo	unless
Peve	until
ojehecharamóva	unusual
yvate	up
mbopyahu	update
jepéramo upéicha	anyways
Ápe upéicha avei	Same here
Reimépa upépe	are you there
mbopyahu	upgrade
hi'ári	upon
pochy	upset
tavayguáva	urban
ñemuaña	urge
pya'eve	urgent
ore	us
poru	use
porupyre	used
purupykuaáva	useful
pituva	useless
ojeporupy'ỹiva	usual
jepi	usually
porupyrã	utility
pytu'u	vacation
pohãkutu	vaccination
vakuna	vaccine
ytypyteha	vacuum
hekoreíva	vague
mymba vai	beast
moañetéva	valid
yvytypa´ũ	valley
hepýva	valuable
hepykue	value
hetaháicha	variety
hetaichagua	various
moambue	vary
hárro	vase
tuichaitereíva	vast
ka'avo	vegetable
ka'avokuéra	vegetables
mba'yrumýi	vehicle
ñemuha	vendor
jukaha	venom
tendavore	venue
vichea	verify
hekopyta'ỹva	versatile
je'eháicha	version
ñembo'yakua	vertical
eterei	very
iporãiterei	very good
kagua	vessel
tape	via
tekoha	vibe
tekoryrýi	vibes
tekovai	vicious
jaheiha	victim
techarã	video
hecha	view
táva	village
kag̃uihái	vinegar
uva'aporykue	vintage
mbaretejeporu	violence
mbaretépe	violent
herakuã	viral
pyahúva	virgin
py'endaveve	virtual
tekokatu	virtue
techa	vision
mbohupa	visit
ojehecháva	visual
tekotevẽite	vital
jeikopyréva	vivid
ñe'ẽndy	vocabulary
ñe'ẽsẽ	voice
nandi	void
ha'ekuéra voi	themselves
rocheháta vokoiete	see you soon
tuichakue	volume
kyre'ỹ	volunteer
gue'ẽ	vomit
ipererĩva	vulnerable
mba'aporepyme'ẽ	wage
mba'apoharepy	wages
ku'a	waist
Eha'arõ	wait
tembigueruha	waiter
ha'arõhápe	waiting
páy	wake
epáy	wake up
guata	walk
oguatávo	walking
agyke	wall
viruryru	wallet
tavahu	wander
pota	wanna
pota	want
mi	wanted
ñorãirõ	war
ñemu	warehouse
haku	warm
momarandu	warn
ñemongyhyje	warning
ñorãirõhára	warrior
va'ekue	was
johéi	wash
hejarei	waste
reloj	watch
y	water
sandía	watermelon
ypyu'ã	wave
mba'éichapa	way
ore-ñande	we
kangy	weak
kangyreko	weakness
viruhetáva	wealth
viruhetáva	wealthy
ñemonde	wear
ñaime	we are
ñemonde	wearing
ára	weather
ñandeikatu	we can
Menda	wedding
ararundy	Wednesday
ka'avo	weed
arapokõindy	week
arapokõindypaha	weekend
pohýi	weight
noĩporãmbáiva	weird
tapeg̃uahẽporãite	welcome
tekoporã	welfare
iporã	Well
ohókuri	went
kuri	were
kuarahyreike	west
hykue	wet
vallena	whale
mba'épa	what
taha'éva	whatever
Mba'épa	what is
Mba'épiko	what is this
avatimirĩ	wheat
apu'a	wheel
araka'épa	when
oikóvo	whenever
moõpa	where
moõpa	where is
taha'e	whether
mba'eichagua	which
ñe'ẽñemi	whisper
turuñe'ẽ	whistle
morotĩ	white
mávapa	who
mávapiko	who is
Mávapa	who is this
paite	whole
máva	whom
mba'érepa	why
aña	wicked
tuichakue	wide
hembirekove'ỹva	widow
ipekue	width
tembireko	wife
sarigue	wild
upéichata	will
ñerumonga	win
yvytu	wind
ovetã	window
pyno	windy
kag̃ui	wine
araro'y	winter
mopotĩ	wipe
itaembo	wire
arandu	wisdom
arandu	wise
potapy	wish
tandepo'aite	wish you all the best
kuñapaje	witch
ndive	with
pe'a	withdraw
jehomombyry	withdrawal
hyepy	within
ỹ	without
hechapyréva	witness
katupyry	witty
jaguaru	wolf
kuña	woman
kuñanguéra	women
mymba'aty	won
ñeporandu	wonder
iporãitereíva	wonderful
nahániri	won't
yvyra	wood
taviju	wool
ñe'ereko	word
ñe'ẽnguéra	words
tembiapo	work
mba'apokuaa	working
japo	work out
arapy	world
yso	worm
tuja	worn
angapy	worried
jepy'apy	worry
ivaivénte	worse
Momorar	worship
ko'ýte	worst
ovaléva	worth
hepýva	worthy
upéichane	would
mba'epore	wound
!nde¡	Wow
ape	wrap
pochy	wrath
pyapy	wrist
hai	write
ohaihína	writing
haipy	written
hekope'ỹgua	wrong
hai	wrote
korapy	yard
topehýi	yawn
Héẽ	Yeah
ary	year
ary	years
mohag̃uinoha	yeast
sapukái	yell
sa'yju	yellow
heẽ	Yes
upeichaite	yes of course
kuehe	yesterday
gueteri	yet
che yga henyhẽ mbusúgui	My hovercraft is full of eels
yvyporakuéra ygapegua	crew
moingo	yield
óga ykeregua	neighbor
nde	you
nde	you are
neporã	you are beautiful
neporãitépa	you are so beautiful
ikatu	you can
reikuaápa	You know
tekopyahu	young
nde	your
mba'evére	you're welcome
mba'evére	you’re welcome
ndete	yourself
mba'evére	your welcome
tekopyahu	youth
heko ypýva	natural
heterei	yummy
óga yvate	building
teko yvate	dignity
heko yvatevéva	prominent
mboyve	zero
