एक	a
थोड़ा	a little
बहुत	a lot
बहुत ज़्यादा	a lot of
त्याग देना	abandon
त्यागा हुआ	abandoned
सहमत होना	abide
क्षमता	ability
योग्य	able
बारे में	about
ऊपर	above
विदेश	abroad
अनुपस्थिति	absence
अनुपस्थित	absent
बिल्कुल	absolutely
अवशोषित करना	absorb
अमूर्त	abstract
बेतुका	absurd
प्रचुरता	abundance
भरपूर	abundant
दुर्व्यवहार करना	abuse
लहजा	accent
स्वीकार करना	accept
पहुँच	access
दुर्घटना	accident
आवास	accommodation
पूरा करना	accomplish
कुशल	accomplished
अनुसार	according
खाता	account
शुद्धता	accuracy
सटीक	accurate
आरोपी	accused
दर्द	ache
प्राप्त करना	achieve
उपलब्धि	achievement
स्वीकार करना	acknowledge
परिचित	acquaintance
अर्जित करना	acquire
अर्जित	acquired
अधिग्रहण	acquisition
आर-पार	across
कार्यवाही करना	act
गतिविधि	action
सक्रिय	active
गतिविधियाँ	activities
गतिविधि	activity
अभिनेता	actor
वास्तविक	actual
वास्तव में	actually
तीव्र	acute
अनुकूल बनाना	adapt
जोड़ना	add
आदी	addicted
जोड़ना	addition
अतिरिक्त	additional
पता	address
पर्याप्त	adequate
नज़दीक	adjacent
विशेषण	adjective
समायोजित करना	adjust
प्रशंसा करना	admire
भर्ती होना	admit
गोद लेना	adopt
बहुत प्यारा	adorable
अग्रिम	advance
विकसित	advanced
फ़ायदा	advantage
साहसिक काम	adventure
क्रिया विशेषण	adverb
विज्ञापन	advertisement
विज्ञापन देना	advertising
सलाह	advice
सलाह देना	advise
वकील	advocate
सौंदर्य संबंधी	aesthetic
मामला	affair
प्रभावित करना	affect
स्नेह	affection
खर्च वहन करना	afford
खरीदने की सामर्थ्य	affordable
डरना	afraid
बाद	after
दोपहर	afternoon
उसके बाद	afterwards
दोबारा	again
ख़िलाफ़	against
आयु	age
एजेंसी	agency
प्रतिनिधि	agent
आक्रामक	aggressive
फुर्तीला	agile
पहले	ago
सहमत होना	agree
समझौता	agreement
कृषि	agriculture
आगे	ahead
सहायता	aid
उद्देश्य	aim
हवा	air
एयरपोर्ट	airport
गलियारा	aisle
खतरे की घंटी	alarm
अल्कोहल	alcohol
चेतावनी	alert
जीवित	alive
सभी	all
ठीक है	all right
सब कुछ शुभ हो	all the best
अनुमति देना	allow
अनुमत	allowed
लगभग	almost
अकेला	alone
साथ-साथ	along
पहले से	already
ठीक	Alright
भी	also
विकल्प	alternative
यद्यपि	although
हमेशा	always
हूँ	am
विस्मयकारी	amazing
अस्पष्ट	ambiguous
महत्वाकांक्षा	ambition
महत्वाकांक्षी	ambitious
सुधार करना	amend
बीच में	amid
के बीच	among
हमारे बीच	among us
मात्रा	amount
विनोदी	amusing
एक	an
विश्लेषण	analysis
पूर्वज	ancestors
लंगर डालना	anchor
प्राचीन	ancient
और	and
और तुम	and you
देवदूत	angel
गुस्सा	anger
कोण	angle
नाराज़	angry
जानवर	animal
टखना	ankle
सालगिरह	anniversary
घोषणा	announcement
चिढ़ाना	annoy
नाराज़	annoyed
चिढ़ पैदा करने वाला	annoying
सालाना	annual
अनाम	anonymous
दूसरा	another
जवाब	answer
अंदाज़ा लगाना	anticipate
चिंता	anxiety
चिंतित	anxious
कोई	any
इसके बाद	anymore
कोई भी	anyone
कुछ भी	anything
फिर भी	anyway
वैसे भी	anyways
अलग	apart
अपार्टमेंट	apartment
क्षमा माँगना	apologize
प्रकट	apparent
प्रकट रूप से	apparently
अपील करना	appeal
दिखाई देना	appear
उपस्थिति	appearance
दिखाई दिया	appeared
भूख	appetite
सेब	apple
आवेदन पत्र	application
आवेदन करना	apply
नियुक्ति	appointment
प्रशंसा करना	appreciate
प्रशंसा	appreciation
दृष्टिकोण	approach
उचित	appropriate
अनुमति	approval
मंज़ूरी देना	approve
अनुमत	approved
लगभग	approximately
अप्रैल	april
स्वेच्छाचारी	arbitrary
आर्किटेक्ट	architect
वास्तुकला	architecture
संग्रहालय	archive
हैं	are
क्या तुम	are you
क्या आप व्यस्त हैं	are you busy
क्या आप शादीशुदा हैं	are you married
आप विवाहित हैं या अविवाहित	are you married or single
क्या आप अभी भी हैं?	Are you still there?
क्या आप हैं	are you there
क्षेत्र	area
बहस करना	argue
बहस	argument
उठना	arise
बाजू	arm
सेना	army
चारों ओर	around
व्यवस्थित करना	arrange
व्यवस्था	arrangement
आगमन	arrival
पहुँचना	arrive
पहुँचा	arrived
घमंडी	arrogant
तीर	arrow
कला	art
लेख	article
कृत्रिम	artificial
कलाकार	artist
जैसा	as
जब तक कि	as long as
भी	as well
साथ ही	as well as
राख	ash
शर्मिंदा	ashamed
पूछना	ask
पूछा गया	asked
सोना	asleep
पहलू	aspect
असमिया	Assamese
हमला	assault
सभा	assembly
निश्चयात्मक	assertive
आकलन करना	assess
आकलन	assessment
संपत्ति	asset
संपत्ति	assets
सौंपना	assign
सौंपा हुआ काम	assignment
सहायता देना	assist
सहायक	assistant
संबंद्ध करना	associate
संबंधित	associated
संगठन	association
मान लेना	assume
मान्यता	assumption
पर	at
कम से कम	at least
खाया	ate
धावक	athlete
संलग्न करना	attach
संलग्न	attached
अटैचमेंट	attachment
आक्रमण करना	attack
कोशिश करना	attempt
शामिल होना	attend
उपस्थिति	attendance
ध्यान	attention
नज़रिया	attitude
आकर्षित करना	attract
आकर्षण	attraction
आकर्षक	attractive
विशेषता	attribute
श्रोता	audience
अगस्त	august
चाची	aunt
चाची	aunty
प्रामाणिक	authentic
लेखक	author
प्राधिकरण	authority
पतझड़	autumn
उपलब्ध	available
औसत	average
बचना	avoid
जागना	awake
पुरस्कार	award
जागरूक	aware
जागरूकता	awareness
दूर	away
विस्मयकारी	awesome
भयानक	awful
अजीब	awkward
आइमारा	Aymara
बच्चा	baby
अविवाहित पुरुष	bachelor
पीछे	back
पृष्ठभूमि	background
बुरा	bad
थैला	bag
प्रलोभन	bait
सेंकना	bake
बेकरी	bakery
मीठा सोडा	baking soda
संतुलन	balance
गेंद	ball
बंबारा	Bambara
केला	banana
संगीत मंडली	band
टकराना	bang
किनारा	bank
छड़	bar
मुश्किल से	barely
मोलभाव करना	bargain
भौंकना	bark
जौ	barley
रुकावट	barrier
आधार	base
आधारित	based
बेसमेंट	basement
मूलभूत	basic
मूल रूप से	basically
तुलसी	basil
हरामी	bastard
बैच	batch
नहाना	bath
स्नानघर	bathroom
बैटरी	battery
युद्ध	battle
खाड़ी	bay
होना	be
ध्यान से	be careful
समुद्र तट	beach
खुशी से उछलना	beam
फलियाँ	beans
सहना	bear
दाढ़ी	beard
असर पड़ना	bearing
जानवर	beast
पीटना	beat
सुंदर	beautiful
सुंदरता	beauty
बन गया	became
क्योंकि	because
होना	become
बिस्तर	bed
सोने का कमरा	bedroom
मधुमक्खी	bee
गाय का मांस	beef
बीयर	beer
पहले	before
शुरू किया	began
शुरू करना	begin
शुरुआत	beginning
ओर से	behalf
ठीक से व्यवहार करना	behave
व्यवहार	behavior
व्यवहार	behaviour
पीछे	behind
प्राणी	being
विश्वास	belief
विश्वास करना	believe
पेट	belly
संबंधित होना	belong
प्यारा	beloved
नीचे	below
बेल्ट	belt
बेंच	bench
झुकना	bend
के नीचे	beneath
फ़ायदा	benefit
फ़ायदे	benefits
के बगल में	beside
के अलावा	besides
सबसे अच्छा	best
सब अच्छा हो	best of luck
साभार	best regards
बेहतर	better
बीच में	between
पेय पदार्थ	beverage
आगे	beyond
भोजपुरी	Bhojpuri
पक्षपात	bias
पक्षपाती	biased
साइकिल	bicycle
बोली लगाना	bid
बड़ा	big
बाइक	bike
बिल	bill
बाँधना	bind
चिड़िया	bird
जन्मदिन	birthday
काटा	bit
काटना	bite
कसैला	bitter
काला	black
ब्लेड	blade
दोष देना	blame
खाली	blank
कंबल	blanket
धमाका	blast
विरंजित करना	bleach
मिलाना	blend
आशीर्वाद देना	bless
सौभाग्यपूर्ण	blessed
नेत्रहीन	blind
परम आनंद	bliss
अवरोध पैदा करना	block
खून	blood
खिलना	bloom
फूँक मारना	blow
नीला	blue
कुंद	blunt
तख्ता	board
नाव	boat
शरीर	body
उबलना	boil
निडर	bold
बंधन	bond
हड्डी	bone
किताब	book
बढ़ाना	boost
बूस्टर	booster
गाड़ी की डिक्की	boot
घुटनों तक पहने जाने वाले जूते	boots
सीमा	border
ऊब पैदा करना	bore
ऊबा हुआ	bored
उबाऊ	boring
पैदा होना	born
उधार लेना	borrow
रोब जमाना	boss
दोनों	both
परेशान करना	bother
बोतल	bottle
नीचे	bottom
खरीदा	bought
उछलना	bounce
अवश्यंभावी	bound
सीमाएँ	boundaries
झुकना	bow
कटोरा	bowl
डिब्बा	box
लड़का	boy
दोस्त	boyfriend
ब्रेसलेट	bracelet
दिमाग	brain
शाखा	branch
ब्रैंड	brand
बहादुर	brave
उल्लंघन	breach
रोटी	bread
तोड़ना	break
नाश्ता	breakfast
स्तन	breast
साँस	breath
साँस लेना	breathe
नस्ल	breed
ईंट	brick
दुल्हन	bride
पुल	bridge
संक्षिप्त	brief
चमकीला	bright
प्रतिभाशाली	brilliant
लाना	bring
भाई	bro
चौड़ा	broad
प्रसारण	broadcast
टूट गया	broke
टूटा हुआ	broken
झाड़ू	broom
भाई	brother
जीजा	brother in law
लाया	brought
भूरा	brown
ब्रश	brush
बाल्टी	bucket
दोस्त	buddy
बजट	budget
तंग करना	bug
बनाना	build
इमारत	building
बनाना	built
थोक	bulk
साँड़	bull
धमकाना	bully
उभार	bump
गुच्छा	bunch
बंडल	bundle
बोझ	burden
दफ़नाया गया	buried
जलाना	burn
फोड़ना	burst
दफ़नाना	bury
बस	bus
झाड़ी	bush
व्यवसाय	business
तोड़ देना	bust
व्यस्त	busy
लेकिन	but
मक्खन	butter
तितली	butterfly
बटन	button
खरीदना	buy
द्वारा	by
वैसे	by the way
विदा	bye
पत्ता गोभी	cabbage
अलमारी	cabinet
पिंजरा	cage
केक	cake
बछड़ा	calf
पुकारना	call
मुझे फ़ोन करो	call me
बुलाया	called
शांत	calm
आया	came
अभियान	campaign
टीन का डिब्बा	can
नहीं कर सकता	can't
रद्द करना	Cancel
कैंसर	cancer
योग्य	capable
क्षमता	capacity
राजधानी	capital
कैप्शन	caption
कब्ज़ा करना	capture
कार	car
करियर	career
सावधान	careful
सावधानी से	carefully
लापरवाह	careless
परवाह करने वाला	caring
बढ़ई	carpenter
कालीन	carpet
गाजर	carrot
ले जाना	carry
जारी रखना	carry on
कार्यान्वित करना	carry out
मामला	case
नकद	cash
फेंकना	cast
महल	castle
लापरवाह	casual
बिल्ली	cat
पकड़ना	catch
श्रेणी	category
पशु	cattle
पकड़ा	caught
कारण	cause
सावधानी	caution
सावधान	cautious
गुफ़ा	cave
रोकना	cease
छत	ceiling
जश्न मनाना	celebrate
कोशिका	cell
केंद्र	center
शतक	century
अनाज	cereal
समारोह	ceremony
निश्चित	certain
निश्चित रूप से	certainly
प्रमाणपत्र	certificate
ज़ंजीर	chain
कुर्सी	chair
चुनौती	challenge
अवसर	chance
बदलना	change
अव्यवस्था	chaos
चरित्र	character
विशेषताएँ	characteristics
शुल्क	charge
दान	charity
आकर्षक	charming
चार्ट	chart
पीछा करना	chase
बात करना	chat
सस्ता	cheap
बेईमानी करना	cheat
बेईमानी करना	cheating
जाँच करना	check
गाल	cheek
खुश करना	cheer
खुश	cheerful
प्रोत्साहित करना	cheers
पनीर	cheese
रसायन विज्ञान	chemistry
संजोकर रखना	cherish
शतरंज	chess
छाती	chest
चबाना	chew
मुर्गा	chicken
मुखिया	chief
बच्चा	child
बचपन	childhood
बच्चे	children
ठंडा करना	chill
चिमनी	chimneys
ठोड़ी	chin
चॉकलेट	chocolate
पसंद	choice
चुनना	choose
काटना	chop
उबाऊ काम	chores
गोलमटोल	chubby
गिरजाघर	church
दालचीनी	cinnamon
घेरा	circle
परिस्थितियाँ	circumstances
नागरिक	citizen
शहर	city
दावा करना	claim
स्पष्ट करना	clarify
कक्षा	class
मिट्टी	clay
साफ़	clean
साफ़	clear
क्लर्क	clerk
चालाक	clever
ग्राहक	client
टीला	cliff
जलवायु	climate
चढ़ना	climb
चिपकने वाला	clingy
घड़ी	clock
बंद करना	close
अलमारी	closet
कपड़ा	cloth
कपड़े	clothes
बादल	cloud
बादलों से घिरा	cloudy
जोकर	clown
संकेत	clue
फूहड़	clumsy
झुंड	cluster
प्रशिक्षक	coach
कोयला	coal
तट	coast
परत	coat
कॉफ़ी	coffee
संज्ञानात्मक	cognitive
संयोग	coincidence
ठंडा	cold
गिर जाना	collapse
गले का पट्टा	collar
सहकर्मी	colleague
सहकर्मी	colleagues
इकट्ठा करना	collect
संग्रह	collection
कॉलेज	college
रंग	color
व्याकरण सही होने से हमेशा सही अर्थ नहीं निकलता	colorless green ideas slept furiously
रंग	colour
कॉलम	column
कंघा	comb
संयोजन	combination
मिलाना	combine
आना	come
यहाँ आओ	come here
चलो भी	come on
आराम	comfort
आरामदेह	comfortable
आ रहा	coming
जल्द आ रहा है	coming soon
आज्ञा	command
टिप्पणी	comment
व्यावसायिक	commercial
आयोग	commission
वादा करना	commit
प्रतिबद्धता	commitment
प्रतिबद्ध	committed
वस्तु	commodity
सामान्य	common
बातचीत करना	communicate
संचार	communication
समुदाय	community
आना-जाना	commute
साथी	companion
सोहबत	company
तुलना करना	compare
तुलना	comparison
करुणा	compassion
दयालु	compassionate
अनुरूप	compatible
पूरा	compete
सुयोग्य	competent
प्रतियोगिता	competition
प्रतिस्पर्द्धी	competitive
शिकायत करना	complain
शिकायत	complaint
पूरक होना	complement
पूरा	complete
पूरी तरह	completely
जटिल	complex
अनुपालन	compliance
उलझा हुआ	complicated
प्रशंसा करना	compliment
अनुपालन करना	comply
संघटन	composition
यौगिक	compound
समझ	comprehension
विस्तृत	comprehensive
समझौता	compromise
अनिवार्य	compulsory
कंप्यूटर	computer
ध्यान लगाना	concentrate
अवधारणा	concept
चिंता	concern
चिंतित	concerned
संगीत समारोह	concert
निष्कर्ष	conclusion
ठोस	concrete
स्थिति	condition
स्थितियाँ	conditions
आचरण	conduct
सम्मेलन	conference
अपराध स्वीकार करना	confess
आत्मविश्वास	confidence
आत्मविश्वासी	confident
पुष्टि करना	confirm
संघर्ष	conflict
भ्रमित	confused
भ्रम	confusion
बधाई	congrats
बधाई	congratulation
बधाई	congratulations
संयोजक	conjunction
जोड़ना	connect
जीतना	conquer
सचेत	conscious
चेतना	consciousness
अनुमति	consent
नतीजे	consequences
संरक्षण	conservation
रूढ़िवादी	conservative
विचार करना	consider
सोच-विचार किया हुआ	considered
निहित होना	consist
गाढ़ापन	consistency
लगातार	consistent
नियत	constant
लगातार	constantly
कब्ज़	constipation
निर्माण	construction
उपभोग करना	consume
उपभोग	consumption
संपर्क करना	contact
संक्रामक	contagious
रोकना	contain
रोकना	contains
समकालीन	contemporary
तिरस्कार	contempt
संतुष्ट	content
प्रतियोगिता	contest
प्रसंग	context
महाद्वीप	continent
जारी रखना	continue
अनुबंध	contract
अंतर	contrast
योगदान देना	contribute
योगदान	contribution
नियंत्रण	control
विवादित	controversial
सुविधा	convenience
सुविधाजनक	convenient
बातचीत	conversation
बदलना	convert
बताना	convey
राज़ी करना	convince
राज़ी	convinced
खाना पकाना	cook
खाना बनाना	cooking
ठंडा	cool
सहयोग	cooperation
सामना करना	cope
ताँबा	copper
मुख्य	core
भुट्टा	corn
कोना	corner
सही	correct
लागत	cost
पोशाक	costume
झोपड़ी	cottage
सूती	cotton
सोफ़ा	couch
खाँसी	cough
सका	could
परिषद	council
गिनती करना	count
विरोध करना	counter
देश	country
ग्रामीण क्षेत्र	countryside
जोड़ा	couple
साहस	courage
पाठ्यक्रम	course
अदालत	court
शिष्टाचार	courtesy
चचेरा	cousin
ढकना	cover
गाय	cow
कायर	coward
आरामदेह	cozy
केकड़ा	crab
दरार	crack
शिल्प	craft
बकवास	crap
टकरा जाना	crash
तीव्र इच्छा	craving
घुटनों के बल चलना	crawl
पागल	crazy
बनाना	create
रचनात्मक	creative
साख	credit
रेंगना	creep
रेंगने वाले प्राणी	creepy
टीम	crew
अपराध	crime
झेंप जाना	cringe
संकट	crisis
मापदंड	criteria
गंभीर	critical
आलोचना	criticism
फसल	crop
फसलें	crops
पार करना	cross
कौआ	crow
भीड़	crowd
भीड़-भाड़ वाला	crowded
मुकुट	crown
महत्वपूर्ण	crucial
निर्दयी	cruel
समुद्र में यात्रा करना	cruise
कुचलना	crush
चिल्लाना	cry
खीरा	cucumber
गले लगाना	cuddle
संस्कृति	culture
धूर्त	cunning
कप	cup
अलमारी	cupboard
निंयत्रण रखना	curb
इलाज	cure
कर्फ़्यू	curfew
जिज्ञासा	curiosity
जिज्ञासु	curious
घुँघराले	curly
मुद्रा	currency
मौजूदा	current
वर्तमान में	currently
अभिशाप	curse
परदा	curtain
तकिया	cushion
रिवाज़	custom
ग्राहक	customer
प्रथाएँ	customs
काटना	cut
प्यारा	cute
चक्र	cycle
साइकिल चलाना	cycling
पापा	dad
पापा	daddy
प्रतिदिन	daily
डेरी	dairy
बाँध	dam
हानि	damage
लानत है	damn
नमी	damp
नृत्य	dance
खतरा	danger
खतरनाक	dangerous
अँधेरा	dark
प्रिय	darling
थोड़ा सा	dash
डेटा	data
तारीख	date
बेटी	daughter
दिन	day
मृत	dead
अंतिम तारीख	deadline
बहरा	deaf
सौदा	deal
प्रिय	dear
हैलो	Dear All
प्रिय ग्राहक	Dear Customer
प्रिय अभिभावक	Dear Parents
प्रिय महोदय	Dear Sir
प्रिय विद्यार्थियों	Dear students
प्रिय टीम	Dear Team
मौत	death
वाद-विवाद	debate
खर्चे में लिखना	debit
मलबा	debris
ऋृण	debt
दशक	decade
क्षय	decay
मृत	deceased
धोखा देना	deceive
दिसंबर	december
शालीन	decent
तय करना	decide
तय	decided
फ़ैसला	decision
जहाज़ की छत	deck
मना करना	decline
घटाना	decrease
समर्पित	dedicated
समर्पण	dedication
काम	deed
गहरा	deep
हिरन	deer
गलती करना	default
हराना	defeat
रक्षा करना	defend
परिभाषित करना	define
निश्चित रूप से	definitely
परिभाषा	definition
डिग्री	degree
देरी	delay
देर से	delayed
मिटाना	delete
जानबूझकर किया गया	deliberate
नाज़ुक	delicate
स्वादिष्ट	delicious
खुश होना	delight
आनंदित	delighted
बाँटना	deliver
वितरित	delivered
वितरण	delivery
माँग	demand
बहुत अपेक्षाएँ रखने वाला	demanding
प्रजातंत्र	democracy
शैतान	demon
दिखाना	demonstrate
अस्वीकृत	denied
घनत्व	density
दाँतों का डॉक्टर	dentist
अस्वीकार करना	deny
विभाग	department
प्रस्थान	departure
निर्भर करना	depend
तैनात करना	deploy
जमा करना	deposit
अवसादग्रस्त	depressed
अवसाद	depression
गहराई	depth
वर्णन करना	describe
विवरण	description
रेगिस्तान	desert
योग्य होना	deserve
डिज़ाइन	design
पद का नाम	designation
इच्छा	desire
मेज़	desk
निराशा	despair
निराश	desperate
के बावजूद	despite
मीठा व्यंजन	dessert
मंज़िल	destination
तकदीर	destiny
नष्ट करना	destroy
विनाश	destruction
विवरण	detail
विवरण	details
पता लगाना	detect
दृढ़ निश्चय	determination
तय करना	determine
दृढ़ निश्चय वाला	determined
सदमाग्रस्त	devastated
विकास करना	develop
विकसित	developed
विकास	development
उपकरण	device
शैतान	devil
समर्पित	devoted
दिवेही	Dhivehi
मधुमेह	diabetes
दस्त	diarrhea
डायरी	diary
शब्दकोष	dictionary
मरना	die
मृत	died
खुराक	diet
अंतर	difference
अलग	different
मुश्किल	difficult
खोदना	dig
गरिमा	dignity
परिश्रमी	diligent
रात का खाना	dinner
डुबोना	dip
प्रत्यक्ष	direct
दिशा	direction
निर्देशक	director
गंध	dirt
गंदा	dirty
बंद करना	disable
अक्षम	disabled
गायब होना	disappear
निराश	disappointed
आपदा	disaster
खारिज करना	discard
स्राव होना	discharge
अनुशासन	discipline
छूट	discount
खोज करना	discover
विभेद	discrimination
विचार-विमर्श करना	discuss
बहस	discussion
बीमारी	disease
बीमारी	diseases
छिपाना	disguise
घृणित	disgusting
व्यंजन	dish
व्यंजन	dishes
नकार देना	dismiss
भेजना	dispatch
दिखाना	display
निपटान	disposal
विवाद	dispute
दूरी	distance
अलग	distinct
अलग करना	distinguish
तनाव	distress
वितरण	distribution
जिला	district
व्यवधान डालना	disturb
छोड़ देना	ditch
गोता लगाना	dive
विविध	diverse
विविधता	diversity
विभाजित करना	divide
अलौकिक	divine
तलाक	divorce
चक्कर आना	dizzy
करना	do
क्या आप	do you
क्या तुम मुझे प्यार करते हो	do you love me
चिकित्सक	doctor
दस्तावेज़	document
कुत्ता	dog
डोगरी	Dogri
कर रहा है	doing
गुड़िया	doll
डोमेन	domain
घरेलू	domestic
प्रभुत्व वाला	dominant
मत	don't
चिंता मत करो	Don't worry
दान देना	donate
हो गया	done
गधा	donkey
नशीली दवा	dope
दोहरा	double
संदेह	doubt
गुँथा हुआ आटा	dough
नीचे	down
डाउनलोड करना	download
प्रारूप	draft
खींचना	drag
नाली	drain
नाटक	drama
चित्र बनाना	draw
दराज	drawer
चित्रकला	drawing
डर लगना	dread
सपना	dream
पोशाक	dress
छेद करना	drill
पीना	drink
चलाना	drive
बूँद	drop
छोड़ा हुआ	dropped
सूखा	drought
पिया हुआ	drunk
सूखा	dry
बत्तख	duck
छैला	dude
बकाया	due
कारण	due to
उदासीन	dull
बेवकूफ़	dumb
फेंक देना	dump
अवधि	duration
दौरान	during
धूल	dust
कर्त्तव्य	duty
रहना	dwell
मरना	dying
प्रत्येक	each
एक-दूसरे से	each other
उत्सुक	eager
गरुड़	eagle
कान	ear
पहले	earlier
जल्दी	early
कमाना	earn
कान	ears
पृथ्वी	earth
भूकंप	earthquake
आराम	ease
आसानी से	easily
पूर्व	east
आसान	easy
खाना	eat
खाना	eating
आर्थिक	economic
अर्थव्यवस्था	economy
किनारा	edge
संपादन करना	edit
शिक्षा	education
प्रभाव	effect
असरदार	effective
क्षमता	efficiency
दक्ष	efficient
कोशिश	effort
अंडा	egg
बैंगन	eggplant
अहंकार	ego
आठ	eight
अठारह	eighteen
अस्सी	eighty
या	either
विस्तार में बताना	elaborate
कोहनी	elbow
बड़े	elder
बुज़ुर्ग	elderly
सुरुचिपूर्ण	elegant
तत्व	element
हाथी	elephant
ग्यारह	eleven
योग्य	eligible
हटाना	eliminate
अन्यथा	else
शर्मिंदा	embarrassed
शर्मिंदा करने वाला	embarrassing
अपनाना	embrace
उभरना	emerge
आपातकाल	emergency
भावनात्मक	emotional
समानुभूति	empathy
ज़ोर	emphasis
ज़ोर देना	emphasize
कर्मचारी	employee
कर्मचारी	employees
नियोक्ता	employer
रोज़गार	employment
खाली	empty
सक्षम करना	enable
सामना करना	encounter
प्रोत्साहित करना	encourage
अंत	end
विलुप्त होने के कगार पर	endangered
प्रयास करना	endeavor
सहनशीलता	endurance
सहन करना	endure
शत्रु	enemy
ऊर्जा	energy
व्यस्त रखना	engage
काम में लगा हुआ	engaged
सगाई	engagement
इंजन	engine
अभियंता	engineer
अंग्रेज़ी	English
बढ़ाना	enhance
आनंद लेना	enjoy
विशाल	enormous
पर्याप्त	enough
सुनिश्चित करना	ensure
प्रवेश करना	enter
मनोरंजन	entertainment
उत्साह	enthusiasm
उत्साही	enthusiastic
पूरा	entire
अधिकारी	entitled
इकाई	entity
प्रवेश	entrance
उद्यमी	entrepreneur
लिफाफा	envelope
पर्यावरण	environment
ईर्ष्या करना	envy
महाकाव्य	epic
महामारी	epidemic
बराबर	equal
उपकरण	equipment
हिस्सेदारी	equity
बराबर	equivalent
रबड़	eraser
गलती	error
बच निकलना	escape
विशेष रूप से	especially
निबंध	essay
सार	essence
ज़रूरी	essential
स्थापित करना	establish
स्थापित	established
जागीर	estate
अनुमान लगाना	estimate
अनुमानित	estimated
वगैरह	etc
शाश्वत	eternal
नैतिकता	ethics
मूल्यांकन करना	evaluate
मूल्यांकन	evaluation
समतल	even
चाहे	even though
शाम	evening
घटना	event
आखिरकार	eventually
हमेशा	ever
प्रत्येक	every
हर कोई	everybody
हर कोई	everyone
सब कुछ	everything
प्रमाण	evidence
बुराई	evil
विकास	evolution
विकसित होना	evolve
एवै	Ewe
पूर्व	ex
एकदम सही	exact
बिल्कुल	exactly
परीक्षा	exam
परीक्षण करना	examine
उदाहरण	example
सीमा पार करना	exceed
उत्कृष्ट	excellent
के अलावा	except
अपवाद	exception
अधिकता	excess
अत्यधिक	excessive
अदला-बदली	exchange
उत्तेजित	excited
उत्तेजना	excitement
रोमांचक	exciting
विशिष्ट	exclusive
बहाना	excuse
माफ़ करें	excuse me
अमल में लाना	execute
कार्यान्वयन	execution
कार्यकारिणी	executive
व्यायाम	exercise
थका देना	exhaust
थका हुआ	exhausted
दिखाना	exhibit
प्रदर्शनी	exhibition
अस्तित्व	exist
अस्तित्व	existence
मौजूदा	existing
बाहर निकलना	exit
बढ़ाना	expand
अपेक्षा करना	expect
अपेक्षित	expected
खर्चे	expenses
महँगा	expensive
अनुभव	experience
प्रयोग	experiment
विशेषज्ञ	expert
खत्म हो चुका	expired
व्याख्या करना	explain
व्याख्या	explanation
शोषण करना	exploit
खोजना	explore
निर्यात करना	export
खुलासा	expose
अनावृत	exposed
खुलासा	exposure
अभिव्यक्त करना	express
अभिव्यक्ति	expression
बढ़ाना	extend
विस्तारित	extended
विस्तार	extension
सीमा	extent
बाहरी	external
विलुप्त	extinct
अतिरिक्त	extra
निकालना	extract
असाधारण	extraordinary
चरम	extreme
बहुत ज़्यादा	extremely
आँख	eye
आँखें	eyes
कपड़ा	fabric
आश्चर्यजनक	fabulous
चेहरा	face
सुविधा देना	facilitate
सुविधाएँ	facilities
सुविधा	facility
तथ्य	fact
कारक	factor
कारखाना	factory
तथ्य	facts
हल्का होना	fade
असफल	fail
असफल	failed
असफलता	failure
बेहोश होना	faint
गोरा	fair
अच्छी तरह से	fairly
परी	fairy
विश्वास	faith
वफ़ादार	faithful
नकली	fake
गिरना	fall
गलत	false
यश	fame
परिचित	familiar
परिवार	family
अकाल	famine
मशहूर	famous
पंखा	fan
कल्पना	fancy
ज़बरदस्त	fantastic
दूर	far
विदाई	farewell
खेत	farm
किसान	farmer
मनमोहक	fascinating
फ़ैशन	fashion
तेज़	fast
मोटा	fat
घातक	fatal
भाग्य	fate
पिता	father
थकान	fatigue
गलती	fault
पसंदीदा	favorite
पक्ष	favour
पसंदीदा	favourite
डर	fear
दावत	feast
पंख	feather
विशेषता	feature
विशेषताएँ	features
फ़रवरी	february
त्रस्त	fed up
शुल्क	fee
खिलाना	feed
प्रतिक्रिया	feedback
अनुभव करना	feel
अनुभूति	feeling
पैर	feet
गिरा	fell
साथी	fellow
अनुभव किया	felt
मादा	female
बाड़	fence
उर्वर	fertile
त्योहार	festival
ले आना	fetch
बुखार	fever
कुछ	few
से कम	fewer
मंगेतर	fiance
कहानी	fiction
मैदान	field
भयंकर	fierce
पंद्रह	fifteen
पचास	fifty
झगड़ा करना	fight
लड़ाई करना	fighting
आकृति	figure
पता लगाना	figure out
फ़ाइल	file
भरना	fill
भरा हुआ	filled
पतली परत	film
गंदा	filthy
आखिरकार	finally
वित्त	finance
वित्तीय	financial
पाना	find
पता लगाना	find out
अच्छा	fine
उँगलिया	finger
खत्म करना	finish
खत्म	finished
आग	fire
अटल	firm
पहला	first
पहला नाम	first name
मछली	fish
उपयुक्त	fit
पाँच	five
हल करना	fix
हल किया गया	fixed
झंडा	flag
चमक	flash
समतल	flat
गलती	flaw
बेदाग	flawless
भाग जाना	flee
माँस	flesh
उड़ गया	flew
मोड़ना	flex
लचीला	flexible
उड़ान	flight
पलटना	flip
छिछले प्रेम का प्रदर्शन	flirt
फ़्लर्ट करना	flirting
तैरना	float
बाढ़	flood
ज़मीन	floor
आटा	flour
बहाव	flow
फूल	flower
बुखार	flu
प्रवाहमय	fluent
धाराप्रवाह रूप से	fluently
रोएँदार	fluffy
द्रव	fluid
उड़ना	fly
ध्यान केंद्रित करना	focus
कोहरा	fog
कोहरे वाला	foggy
तह करना	fold
जनसामान्य	folks
अनुसरण करना	follow
आगे की कार्रवाई करना	follow up
आगे दिए गए	following
खाना	food
मूर्ख	fool
मूर्ख	foolish
पैर	foot
फ़ुटबॉल	football
के लिए	for
उदाहरण के लिए	For example
उदाहरण के लिए	for instance
आपके लिए	for you
वर्जित	forbidden
ताकत	force
भविष्यवाणी	forecast
माथा	forehead
विदेशी	foreign
जंगल	forest
हमेशा के लिए	forever
भूलना	forget
माफ़ करना	forgive
भूल गया	forgot
काँटा	fork
रूप	form
औपचारिक	formal
पूर्व	former
सौभाग्य से	fortunately
सौभाग्य	fortune
चालीस	forty
बयालीस	forty-two
आगे	forward
पोषण करना	foster
लड़ा	fought
मिला	found
नींव	foundation
चार	four
चौदह	fourteen
लोमड़ी	fox
कमज़ोर	fragile
चौखटा	frame
रूपरेखा	framework
धोखा	fraud
विचित्र	freak
मुक्त	free
आज़ादी	freedom
जमाना	freeze
आवृत्ति	frequency
अक्सर	frequent
बार-बार	frequently
ताज़ा	fresh
शुक्रवार	friday
फ़्रिज	fridge
दोस्त	friend
दोस्ताना	friendly
दोस्त	friends
दोस्ती	friendship
डरा हुआ	frightened
डरावना	frightening
मेंढक	frog
से	from
सामने	front
जमा हुआ	frozen
फल	fruit
निराश	frustrated
ईंधन	fuel
फ़ुलफ़ुल्दे	Fulfulde
भरा हुआ	full
मज़ा	fun
समारोह	function
मौलिक	fundamental
अंत्येष्टि	funeral
मज़ेदार	funny
रोयां	fur
बहुत नाराज़	furious
फ़र्नीचर	furniture
आगे	further
आगे	furthermore
भविष्य	future
पाना	gain
खेल	game
अंतर	gap
गराज	garage
कूड़ा	garbage
बगीचा	garden
लहसुन	garlic
दरवाज़ा	gate
इकट्ठा करना	gather
सभा	gathering
थाह लेना	gauge
दिया	gave
गियर	gear
लिंग	gender
सामान्य	general
सामान्यतया	generally
बनाना	generate
पीढ़ी	generation
उदार	generous
तेज़ दिमाग वाला	genius
शैली	genre
सज्जन	gentle
ईमानदार	genuine
हाव-भाव	gesture
पाना	get
कपड़े पहनो	get dressed
उठना	get up
जल्दी ठीक होइए	get well soon
पाना	getting
भूत	ghost
प्रतिछाया	ghosting
बहुत बड़ा	giant
उपहार	gift
अदरक	ginger
लड़की	girl
दोस्त	girlfriend
देना	give
छोड़ देना	give up
दिया गया	given
खुश	glad
नज़र	glance
काँच	glass
चश्मा	glasses
झलक	glimpse
वैश्विक	global
निराशाजनक	gloomy
दस्ताने	gloves
चमकना	glow
खूब समझदार और आकर्षक बनो	glow up
गोंद	glue
जाना	go
आगे बढ़ो	go ahead
दूर जाओ	go away
सोने जाओ	go to bed
लक्ष्य	goal
लक्ष्य	goals
बकरी	goat
ईश्वर	god
भगवान का आशीर्वाद बना रहे	god bless you
जाता है	goes
जा रहा है	going
जा रहा हूँ	going to
सोना	gold
चला गया	gone
वाला	gonna
चिपचिपा पदार्थ	goo
अच्छा	good
नमस्कार	good afternoon
अलविदा	good bye
आपका दिन शुभ हो	good day
नमस्ते	good evening
अच्छी नौकरी	good job
सुंदर	good looking
सफलता मिले	good luck
सुप्रभात	good morning
डियर, गुड मॉर्निंग	good morning my love
शुभ रात्रि	good night
अलविदा	goodbye
शुभ रात्रि	goodnight
चीज़ें	goods
गूगल	Google
गूगल ट्रांसलेट	Google Translate
हंस	goose
मनमोहक	gorgeous
गप करना	gossip
मिलना	got
समझ गया	got it
सरकार	government
पकड़ना	grab
श्रेणी	grade
धीरे-धीरे	gradually
स्नातक	graduate
अनाज	grain
देना	grant
मंज़ूर किया गया	granted
अंगूर	grapes
पकड़	grasp
घास	grass
कृतज्ञ	grateful
कृतज्ञता	gratitude
कब्र	grave
स्लेटी	gray
महान	great
लालच	greed
लालची	greedy
हरा	green
अभिवादन करना	greet
अभिवादन	greeting
अभिवादन	greetings
स्लेटी	grey
जाल	grid
दुख	grief
पीसना	grind
पकड़	grip
किराने का सामान	grocery
दूल्हा	groom
कुल	gross
मैदान	ground
समूह	group
बढ़ना	grow
वृद्धि	growth
चिड़चिड़ा	grumpy
गुआरानी	Guarani
गारंटी	guarantee
रक्षक	guard
अनुमान लगाना	guess
मेहमान	guest
सलाह	guidance
मार्गदर्शन देना	guide
अपराधी	guilty
लड़का	guy
दोस्तो	guys
जिम	gym
आदत	habit
प्राकृतिक आवास	habitat
जयकार करना	hail
बाल	hair
आधा	half
बड़ा कमरा	hall
हाथ	hand
सँभालना	handle
आकर्षक	handsome
लटकाना	hang
लटकाना	hang out
होना	happen
घटित	happened
खुशी	happiness
खुश	happy
जन्मदिन की शुभकामनाएँ	happy birthday
आपको जन्मदिन की शुभकामनाएँ	happy birthday to you
नए साल की शुभकामनाएँ	happy new year
सख्त	hard
मुश्किल से	hardly
मुश्किल से	hardly ever
नुकसान पहुँचाना	harm
हानिकारक	harmful
समन्वय	harmony
कठोर	harsh
फसल काटना	harvest
नफ़रत करना	hate
पास	have
आपका दिन शुभ हो	have a good day
आपका दिन शुभ हो	have a nice day
नाश्ता कर लो	have breakfast
मस्ती करो	have fun
क्या आपने खाना खा लिया	have you eaten
रखना	having
खतरा	hazard
धुंध	haze
वह	he
उसके पास	he has
वह है	he is
सिर	head
सिर दर्द	headache
ज़ख्म भरना	heal
ज़ख्म भरना	healing
स्वास्थ्य	health
सेहतमंद	healthy
सुनना	hear
सुना	heard
दिल	heart
गर्मी	heat
स्वर्ग	heaven
भारी	heavy
अतिव्यस्तता	hectic
लंबाई	height
उत्तराधिकारी	heir
लूट	heist
पकड़ा	held
नर्क	hell
नमस्ते	Hello
हैलो दोस्त	hello dear
नमस्ते, आप कैसे हैं	hello how are you
नमस्ते, आप कैसे हैं	hello how are you doing
हेलमेट	helmet
मदद करना	help
मददगार	helpful
इस तरह	hence
उसका	her
झुंड	herd
यहाँ	here
विरासत	heritage
संकोच करना	hesitate
अरे	Hey
हैलो	Hi
हैलो, क्या हाल हैं	hi how are you
हैलो	Hi there
ऑनलाइन हो	Hi there
छिपा हुआ	hidden
छिपाना	hide
पदानुक्रम	hierarchy
ऊँचा	high
प्रमुखता से दिखाना	highlight
बढ़ोतरी	hike
लंबी दूरी पर पैदल चलना	hiking
हास्यपूर्ण	hilarious
पहाड़	hill
उसका	him
हिन्दी	Hindi
संकेत देना	hint
नितंब	hip
नितंब	hips
किराये पर लेना	hire
नियुक्तियाँ	hiring
उसका	his
इतिहास	history
मारना	hit
हम्म	Hmm
शौक	hobby
पकड़ना	hold
पकड़ना	hold on
छेद	hole
छुट्टी	holiday
खोखला	hollow
घर	home
गृहकार्य	homework
ईमानदार	honest
ईमानदारी से	honestly
शहद	Honey
सम्मान	honor
कनटोप	hood
अंकुश	hook
कूदना	hop
आशा	hope
उम्मीद है	hopefully
निराशाजनक	hopeless
क्षैतिज	horizontal
हॉर्न	horn
भयंकर	horrible
डरावना	horror
घोड़ा	horse
अस्पताल	hospital
मेहमाननवाज़ी	hospitality
मेज़बान	host
विरोधी	hostile
गर्म	hot
होटल	hotel
घंटा	hour
घंटे	hours
घर	house
परिवार	household
कैसे	how
आप कैसे हैं	how about you
आप कैसे हैं	how are you
आप कैसे हैं	how are you doing
आज आप कैसे हैं	how are you doing today
आज आप कैसे हैं	how are you today
आप कैसे हैं	how do you do
कैसा है	how is
कितने	how many
कितना	how much
कितनी बार	how often
आपकी आयु कितनी है	how old are you
आपका दिन कैसा रहा	how was your day
आपकी रात कैसी बीती	how was your night
हालाँकि	however
केंद्र	hub
पति	hubby
गले लगाना	hug
बहुत बड़ा	huge
मानवीय	human
विनम्र	humble
नमी	humid
नमी	humidity
सौ	hundred
भूखा	hungry
शिकार करना	hunt
चक्रवात	hurricane
जल्दी करो	hurry
जल्दी करो	hurry up
चोट पहुँचाना	hurt
पति	husband
धक्का-मुक्की करना	hustle
झोपड़ी	hut
स्वच्छता	hygiene
मैं	I
मैं हूँ	I am
मैं ठीक हूँ	I am fine
मैं कर सकता हूँ	I can
मैं नहीं कर सकता	I can't
मैं सहमत हूँ	I do
मुझे नहीं पता	I do not know
मैं समझा नहीं	I do not understand
मैं नहीं करता	I don't
मैं नहीं जानता	I don't know
मुझे समझ में नहीं आया	I don't understand
मैं आपका मतलब नहीं समझा	I don't understand what you mean
मुझे तुम्हारी बात समझ में नहीं आती	I don't understand you
मैं नहीं जानता	I don’t know
मैं समझा नहीं	I don’t understand
मेरे ख़याल से	i guess
मैंने खा लिया	I had
मेरे पास	I have
मैं रहा हूँ	I have been
ऐसा ही हो	I hope so
मैं जानता हूँ	I know
मुझे पसंद है	I like
मैं तुम्हें पसंद करता हूँ	I like you
मुझे पसंद है	I love
मुझे अपने बडे़ भाई से प्यार है	I love my big brother
मैं अपनी बड़ी बहन से प्यार करता हूँ	I love my big sister
मैं अपने पिता से प्यार करता हूँ	I love my father
मैं अपने छोटे भाई को प्यार करता हूँ	I love my little brother
मुझे अपनी बहन से प्यार है	I love my little sister
मुझे अपनी माँ से प्यार है	I love my mother
मैं आपसे प्यार करता हूँ	I love you
मैं तुमसे बहुत प्यार करता हूँ	I love you so much
मैं भी आपसे प्यार करता हूँ	I love you too
मेरा मतलब	I mean
मैं तुम्हें याद करता हूँ	I miss you
मैं तुम्हें बहुत याद करता हूँ	I miss you so much
में समझ गया	I see
मेरे ख़याल से	I think
मैं समझता हूँ	I understand
मैं चाहता हूँ	I want
मैं आपसे मिलना चाहता हूँ	I want to see you
मैं तुम्हें चाहता हूँ	I want you
मैं था	I was
मैं करूँगा	I will
मैं बनूँगा	I would be
मैं हूँ	I'm
मैं ठीक हूँ	I'm fine
मैं ठीक हूँ	I'm good
मैं यहाँ हूँ	I'm here
मुझे माफ़ करें	I'm sorry
बर्फ़	ice
आइसक्रीम	ice cream
विचार	idea
आदर्श	ideal
सदृश	identical
पहचान करना	identify
पहचान	identity
बेवकूफ़	idiot
निठल्ला	idle
यदि	if
अनदेखा करना	ignore
बीमार	ill
गैरकानूनी	illegal
बीमारी	illness
इलोकानो	Ilocano
छवि	image
कल्पना करना	imagine
तुरंत	immediate
तुरंत	immediately
व्यापक	immense
प्रभाव	impact
अधीर	impatient
अमल में लाना	implement
आयात करना	import
महत्वपूर्ण	important
आरोपित करना	impose
असंभव	impossible
प्रभावित करना	impress
प्रभाव जमाना	impression
प्रभावशाली	impressive
सुधार करना	improve
सुधार	improvement
में	in
इसके साथ ही	in addition
वास्तव में	In fact
के सामने	in front of
के लिए	in order to
अनुचित	inappropriate
प्रोत्साहन	incentive
घटना	incident
शामिल करना	include
शामिल	including
आय	income
असुविधा	inconvenience
बढ़ोतरी	increase
बढ़ा हुआ	increased
अविश्वसनीय	incredible
वास्तव में	indeed
स्वतंत्र	independent
भारत	India
संकेत देना	indicate
देशज	indigenous
व्यक्तिगत	individual
उद्योग	industry
अनिवार्य	inevitable
बच्चा	infant
संक्रमण	infection
अनन्त	infinity
सूजन और जलन	inflammation
मुद्रा स्फ़ीति	inflation
प्रभाव	influence
सूचित करना	inform
जानकारी	information
सामग्री	ingredients
विरासत	inheritance
शुरुआती	initial
पहल	initiative
चोटिल	injured
चोट	injury
मासूम	innocent
नवाचार	innovation
जाँच करना	inquiry
पागल	insane
कीड़ा	insect
असुरक्षित	insecure
डालना	insert
अंदर	inside
अंतर्दृष्टि	insight
आग्रह करना	insist
अनिद्रा	insomnia
प्रेरणा	inspiration
प्रेरित करना	inspire
स्थापित करना	install
उदाहरण	instance
तुरंत	instant
बजाय	instead
के बजाय	instead of
निर्देश	instructions
वाद्य यंत्र	instrument
अपमान करना	insult
बीमा	insurance
जुड़ा रहना	intact
अखंडता	integrity
बौद्धिक	intellectual
बुद्धिमत्ता	intelligence
बुद्धिमान	intelligent
इरादा रखना	intend
अभिप्रेत	intended
गहन	intense
इरादा	intention
इंटरैक्ट करना	interact
इंटरैक्शन	interaction
दिलचस्पी	interest
दिलचस्पी लेने वाला	interested
दिलचस्प	interesting
हस्तक्षेप करना	interfere
मध्यवर्ती	intermediate
आंतरिक	internal
अंतरराष्ट्रीय	international
प्रशिक्षण	internship
व्याख्या करना	interpret
दुभाषिया	interpreter
रुकावट डालना	interrupt
साक्षात्कार	interview
अंतरंग	intimate
में	into
परिचय देना	introduce
परिचय	introduction
अंतर्मुखी	introvert
अंतर्ज्ञान	intuition
अमान्य	invalid
आविष्कार करना	invent
भंडार	inventory
निवेश करना	invest
जाँच करना	investigate
आमंत्रण	invitation
आमंत्रित करना	invite
इनवॉइस	invoice
शामिल होना	involve
शामिल	involved
लोहा	iron
है	is
द्वीप	island
एकाकी	isolated
मुद्दा	issue
समस्याएँ	issues
यह	it
यह है	it is
वह था	it was
यह है	it's
कोई बात नहीं	it's ok
कोई बात नहीं	It's okay
वस्तु	item
सामान	items
इसका	its
मैं हूँ	I’m
जैकेट	jacket
जेल	jail
जनवरी	January
जार	jar
जबड़ा	jaw
ईर्ष्यालु	jealous
झटका देना	jerk
जेवर	jewelry
नौकरी	job
धीमी दौड़	jogging
जोड़ना	join
संयुक्त	joint
चुटकुला	joke
पत्रकार	journalist
यात्रा	journey
आनंद	joy
न्यायाधीश	judge
रस	juice
जुलाई	july
कूदना	jump
जून	june
कूड़ा	junk
अभी	just
बस यह कर दें	just do it
न्याय	justice
न्यायोचित ठहराना	justify
कलाल्लिसुत	Kalaallisut
उत्सुक	keen
रखना	keep
और बेहतर करो	keep it up
रखा	kept
पशु	kettle
चाबी	key
लात मारना	kick
बच्चा	kid
मज़ाक करना	kidding
किडनी	kidney
बच्चे	kids
मारना	kill
दयालु	kind
एक तरह का	kinda
कृपया	kindly
दयालुता	kindness
राजा	king
चूमना	kiss
रसोईघर	kitchen
पतंग	kite
बिल्ली का बच्चा	kitten
घुटना	knee
जानता था	knew
चाकू	knife
सामंत	knight
जानना	know
ज्ञान	knowledge
परिचित	known
कोंकणी	Konkani
क्रियो	Krio
लेबल	label
श्रम	labor
श्रम	labour
कमी	lack
सीढ़ी	ladder
महिला	lady
लिटा देना	laid
झील	lake
भेड़	lamb
झूठा	lame
चिराग	lamp
भूमि	land
परिदृश्य	landscape
भाषा	language
गोद	lap
बड़ा	large
अंतिम	last
आखिरी बात भी बहुत महत्वपूर्ण है	last but not least
उपनाम	last name
स्वर्गीय	late
हाल तक	lately
बाद में	later
नवीनतम	latest
बाद वाला	latter
हँसना	laugh
हँसना	laughing
हँसी	laughter
शुरू करना	launch
धोने लायक कपड़े	laundry
कानून	law
घास का मैदान	lawn
वकील	lawyer
बिछाना	lay
परत	layer
विन्यास	layout
आलसी	lazy
नेतृत्व करना	lead
नेता	leader
पत्ती	leaf
रिसना	leak
पतला	lean
छलाँग	leap
सीखना	learn
सीखना	learning
पट्टा	lease
कम से कम	least
चमड़ा	leather
छुट्टी	leave
पत्तियाँ	leaves
अगुआई की	led
बायाँ	left
पैर	leg
परंपरा	legacy
कानूनी	legal
विख्यात व्यक्ति	legend
वैध	legit
खाली समय	leisure
उधार देना	lend
लंबाई	length
कम	less
पाठ	lesson
होने देना	let
पत्र	letter
सलाद पत्ता	lettuce
स्तर	level
फ़ायदा उठाना	leverage
देयता	liability
पुस्तकालय	library
चाटना	lick
लेट जाना	lie
झूठ	lies
ज़िंदगी	life
उठाना	lift
रोशनी	light
बिजली चमकना	lightning
पसंद करना	like
संभावित	likely
वैसे ही	likewise
पंक्ति	line
लिंगाला	Lingala
जोड़ना	link
शेर	lion
तरल	liquid
सूची	list
सुनना	listen
सुनना	listening
वस्तुत:	literally
साहित्य	literature
कूड़ा फैलाना	litter
थोड़ा	little
रहना	live
यकृत	liver
ज़िंदगियाँ	lives
जीविका	living
बैठक	living room
छिपकली	lizard
भार	load
टुकड़ा	loaf
ऋृण	loan
स्थानीय	local
जगह	location
ताला	lock
लॉकडाउन	lockdown
लकड़ी का लट्ठा	log
अकेला	lonely
लंबा	long
बहुत दिनों से मुलाकात नहीं हुई	long time no see
देखना	look
फंदा	loop
ढीला	loose
स्वामी	lord
खोना	lose
नुकसान	loss
खोया हुआ	lost
बहुत	lot
ऊँचा स्वर	loud
विश्राम कक्ष	lounge
प्यार	love
तुमसे प्यार है	love you
प्यारा	lovely
कम	low
निचला	lower
निष्ठावान	loyal
निष्ठा	loyalty
भाग्य	luck
भाग्यशाली	lucky
लुगांडा	Luganda
सामान	luggage
पिंड	lump
दिन का खाना	lunch
फेफड़े	lungs
विलासिता	luxury
लेटा हुआ	lying
मशीन	machine
पागल	mad
महोदया	madam
निर्मित	made
पत्रिका	magazine
शानदार	magnificent
नौकरानी	maid
मुख्य	main
बनाए रखना	maintain
रखरखाव	maintenance
मैथिली	Maithili
मेजर	major
बहुलता	majority
बनाना	make
पूरा करना	make up
नर	male
मॉल	mall
आदमी	man
प्रबंधित करना	manage
प्रबंधन	management
प्रबंधक	manager
अनिवार्य	mandatory
व्यक्त करना	manifest
चालाकी से काम निकालना	manipulate
तरीका	manner
नियमावली	manual
अनेक	many
बार-बार दिन ये आए	many many happy returns of the day
मार्च	march
अंतर	margin
बाज़ार	market
शादी	marriage
विवाहित	married
नकाब	mask
द्रव्यमान	mass
बहुत बड़ा	massive
मालिक	master
मिलान	match
साथी	mate
सामग्री	material
गणित	math
मामला	matter
परिपक्वता	maturity
शायद	maybe
मुझे	me
मैं भी	me too
खाना	meal
मतलब	mean
अर्थ	meaning
साधन	means
मतलब था	meant
इस बीच	meanwhile
मापना	measure
पैमाने	measures
मांस	meat
चिकित्सा	medical
दवा	medicine
ध्यान	meditation
मध्यम	medium
मिलना	meet
बैठक	meeting
मैतैलोन	Meiteilon
पिघलना	melt
यादें	memories
याद	memory
मानसिक	mental
उल्लेख	mention
उल्लिखित	mentioned
पथप्रदर्शक	mentor
व्यापारी	merchant
दया	mercy
सिर्फ़	merely
क्रिसमस की बधाई	merry christmas
गड़बड़	mess
संदेश	message
अस्तव्यस्त	messy
धातु	metal
तरीका	method
चूहे	mice
मध्य	middle
मध्यरात्रि	midnight
ताकत	might
हल्का	mild
मील का पत्थर	milestone
सैन्य	military
दूध	milk
दस लाख	million
दिमाग	mind
नज़रिया	mindset
मेरा	mine
मिल जाना	mingle
नाबालिग	minor
मिनट	minute
मिनट	minutes
चमत्कार	miracle
आईना	mirror
मिश्रित	miscellaneous
शैतान	mischievous
दुखी	miserable
दुख	misery
कुमारी	miss
याद करना	miss you
गुम	missing
उद्देश्य	mission
कुहासा	mist
गलती	mistake
मिज़ो	Mizo
गतिमान	mobile
हँसी उड़ाना	mock
नमूना	model
संतुलित	moderate
आधुनिक	modern
विनम्र	modest
नम	moist
नमी	moisture
साँचे में ढालना	mold
तिल	mole
माँ	mom
पल	moment
सोमवार	monday
धन	money
निगरानी करना	monitor
बंदर	monkey
महीना	month
मनोदशा	mood
तुनकमिज़ाज	moody
चंद्रमा	moon
नैतिक	moral
अधिक	more
इसके अतिरिक्त	moreover
सुबह	morning
गिरवी रखना	mortgage
ज़्यादातर	most
अधिकतर	mostly
माता	mother
गति	motion
प्रेरणा	motivation
पर्वत	mountain
चूहा	mouse
मुँह	mouth
हिलाना	move
आंदोलन	movement
फ़िल्म	movie
श्रीमती	mrs
बहुत	much
कीचड़	mud
लूट के लिए हमला करना	mug
माँसपेशियाँ	muscle
संग्रहालय	museum
मशरूम	mushroom
संगीत	music
ज़रूरी	must
आवाज़ बंद करना	mute
परस्पर	mutual
मेरा	my
मेरे प्रिय	My dear
मेरा दोस्त	my friend
मेरा विमान ईल मछलियों से भरा हुआ है	My hovercraft is full of eels
मेरा प्यार	my love
मेरा नाम है	my name is
मुझे खुशी हुई	my pleasure
मैं	myself
रहस्यमयी	mysterious
रहस्य	mystery
मिथक	myth
नाखून	nail
सीधा-सादा	naive
नाम	name
आख्यान	narrative
सँकरा	narrow
बहुत खराब	nasty
राष्ट्रीय	national
राष्ट्रीयता	nationality
देशी	native
प्राकृतिक	natural
प्रकृति	nature
जी मिचलाना	nausea
पास में	near
आस-पास	nearby
लगभग	nearly
साफ़	neat
ज़रूरी	necessary
गरदन	neck
गले का हार	necklace
ज़रूरत	need
नकारात्मक	negative
ध्यान न देना	neglect
समझौते के लिए बातचीत करना	negotiate
पड़ोसी	neighbor
पड़ोसी	neighborhood
कोई भी नहीं	neither
भतीजा	nephew
पढ़ाकू	nerd
घबराया हुआ	nervous
घोंसला	nest
जाल	net
नेटवर्क	network
तटस्थ	neutral
कभी नहीं	never
कभी हार न मानना	never give up
कोई बात नहीं	never mind
कोई बात नहीं	nevermind
फिर भी	nevertheless
नया	new
समाचार	news
अगला	next
के पास	next to
अच्छा	nice
आपसे मिलकर अच्छा लगा	nice to meet you
भतीजी	niece
रात	night
बुरा सपना	nightmare
नौ	nine
उन्नीस	nineteen
नब्बे	ninety
नहीं	No
कोई समस्या नहीं	no problem
बिल्कुल नहीं	no way
कोई नहीं	nobody
शोर	noise
कोलाहलयुक्त	noisy
कोई भी नहीं	none
दोपहर	noon
नहीं	nope
न	nor
सामान्य	normal
उत्तर	north
नाक	nose
बीते वक्त की याद	nostalgic
नहीं	not
बिल्कुल भी नहीं	not at all
इतना खराब भी नहीं	not bad
अभी नहीं	Not now
अभी तक नहीं	not yet
टिप्पणी	note
विख्यात	noted
कुछ नहीं	nothing
सूचना	notice
ध्यान दिया	noticed
संज्ञा	noun
संज्ञा	nouns
उपन्यास	novel
नवंबर	november
अब	now
आजकल	nowadays
मुसीबत	nuisance
व्यर्थ	null
सुन्न	numb
संख्या	number
देखभाल करना	nurse
कड़े छिलके वाला फल	nut
जायफल	nutmeg
पोषण	nutrition
शपथ	oath
मोटापा	obesity
आज्ञा मानना	obey
वस्तु	object
उद्देश्य	objective
दायित्व	obligation
दुर्बोध	obscure
पर्यवेक्षण	observation
निरीक्षण करना	observe
ग्रस्त	obsessed
सनक	obsession
अप्रचलित	obsolete
व्यवधान	obstacle
प्राप्त करना	obtain
पाया हुआ	obtained
ज़ाहिर	obvious
ज़ाहिर तौर से	obviously
कभी-कभी	occasionally
व्यवसाय	occupation
व्यस्त	occupied
घटित होना	occur
घटित हुआ	occurred
घटित होना	occurs
महासागर	ocean
अक्टूबर	october
अजीब	odd
कठिनाइयाँ	odds
का	of
बिल्कुल	of course
बंद	off
आक्रामक	offensive
प्रस्ताव	offer
कार्यालय	office
आधिकारिक	official
अक्सर	often
ओह	Oh
सच में	oh really
तेल	oil
ठीक है	ok
ठीक है दोस्त	ok dear
ठीक है	ok honey
ठीक है, प्रिय	ok my love
ठीक है	okay
ठीक है, बेबी	okay baby
ठीक है दोस्त	okay dear
ठीक है, हनी	okay honey
ठीक है, प्रिय	okay my love
पुराना	old
पर	on
एक बार	once
एक	one
एक भाषा पर्याप्त नहीं होती	one language is never enough
प्याज़	onion
ऑनलाइन	online
सिर्फ़	only
खुला	open
संचालन	operation
राय	opinion
अवसर	opportunities
अवसर	opportunity
विलोम	opposite
आशावादी	optimistic
विकल्प	option
वैकल्पिक	optional
या	or
नारंगी	orange
आदेश देना	order
साधारण	ordinary
संगठन	organization
अभिविन्यास	orientation
मूल	origin
मौलिक	original
ओरोमो	Oromo
अनाथ	orphan
अन्य	other
अन्यथा	otherwise
चाहिए	ought
हमारा	our
हमारा लक्ष्य: हर जगह लोगों को दुनिया समझने के लिए सक्षम बनाना और सभी भाषाओं के लोगों को खुद को अभिव्यक्त करने में सक्षम बनाना।	Our mission: to enable everyone, everywhere to understand the world and express themselves across languages.
हमारा लक्ष्य: दुनिया की जानकारी को व्यवस्थित करना और इसे सबके लिए उपलब्ध करवाना व उपयोगी बनाना।	Our mission: to organize the world's information and make it universally accessible and useful.
बाहर	out
नतीजा	outcome
पोशाक	outfit
मिलनसार	outgoing
दुकान	outlet
खाका	outline
बाहर	outside
असाधारण	outstanding
तंदूर	oven
ऊपर	over
वहाँ	over there
कुल मिलाकर	overall
काबू पाना	overcome
बहुत ज़्यादा सोचना	overthinking
भावविह्वल	overwhelmed
भाव विह्वल करने वाला	overwhelming
ऋृणी होना	owe
उल्लू	owl
अपना	own
स्वामी	owner
बैल	ox
रफ़्तार	pace
सामान बाँधना	pack
पैकेट	package
चुकाया गया	paid
दर्द	pain
रँगना	paint
चित्रकारी	painting
जोड़ा	pair
फीका	pale
हथेली	palm
बरतन	pan
महामारी	pandemic
घबराना	panic
पैंट	pants
कागज़	paper
स्वर्ग	paradise
समानांतर	parallel
पार्सल	parcel
क्षमा	pardon
अभिभावक	parents
पार्क	park
तोता	parrot
अजमोद	parsley
भाग	part
हिस्सा लेना	participate
विशिष्ट	particular
विशेषतया	particularly
साझेदार	partner
समारोह	party
उत्तीर्ण	pass
रास्ता	passage
उत्तीर्ण	passed
जुनून	passion
जुनूनी	passionate
निष्क्रिय	passive
पासवर्ड	password
अतीत	past
पैबंद	patch
रास्ता	path
दयनीय	pathetic
धैर्य	patience
रोगी	patient
नमूना	pattern
रोकना	pause
सड़क की पटरी	pavement
भुगतान करना	pay
भुगतान	payment
शांति	peace
शांतिपूर्ण	peaceful
आड़ू	peach
चोटी	peak
नाशपाती	pear
मटर	peas
विचित्र	peculiar
पेशाब करना	pee
छीलना	peel
साथी	peer
समकक्ष लोग	peers
कलम	pen
पेंसिल	pencil
लंबित	pending
लोग	people
मिर्च	pepper
समझना	perceive
धारणा	perception
पूरी तरह से ठीक	perfect
अभिनय करना	perform
प्रदर्शन	performance
शायद	perhaps
अवधि	period
स्थायी	permanent
अनुमति	permission
आज्ञा देना	permit
धैर्य	perseverance
ज़िद्दी	persistent
व्यक्ति	person
निजी	personal
व्यक्तित्व	personality
परिप्रेक्ष्य	perspective
राज़ी करना	persuade
विकृत	pervert
पालतू	pet
चरण	phase
तथ्य	phenomenon
दर्शन	philosophy
फ़ोन	phone
फ़ोटो	photo
वाक्यांश	phrase
भौतिक	physical
चुनना	pick
उठाना	pick up
तस्वीर	picture
टुकड़ा	piece
टुकड़े	pieces
सुअर	pig
कबूतर	pigeon
बवासीर	pile
तकिया	pillow
पायलट	pilot
नत्थी करना	pin
अनन्नास	pineapple
गुलाबी	pink
गड्ढा	pit
पिच	pitch
दया	pity
स्थान	place
स्थान	places
प्लेग	plague
मैदान	plain
योजना	plan
विमान	plane
पौधा	plant
पौधे	plants
तश्तरी	plate
प्लैटफ़ॉर्म	platform
खेलना	play
खेलना	playing
सुखद	pleasant
कृपया	please
खुश	pleased
खुशी	pleasure
प्रतिज्ञा करना	pledge
बहुत	plenty
कथानक	plot
प्लग करना	plug
आलूबुखारा	plum
प्लंबर	plumber
बहुवचन	plural
पॉडकास्ट	podcast
कविता	poem
कविता	poetry
बिंदु	point
ज़हर	poison
पुलिस	police
नीति	policy
विनम्र	polite
प्रदूषण	pollution
पोखर	pond
पोखर	pool
जहाज़ का सबसे पिछला भाग	poop
गरीब	poor
जल्दी से आना	pop
लोकप्रिय	popular
जनसंख्या	population
सुअर का माँस	pork
दलिया	porridge
पत्तन	port
स्थिति	position
सकारात्मक	positive
धारण करना	possess
स्वामित्व	possession
अधिकार संबंधी	possessive
संभव	possible
डाक	post
स्थगित करना	postpone
आलू	potato
संभावित	potential
पाउंड	pound
गरीबी	poverty
शक्ति	power
ताकतवर	powerful
व्यावहारिक	practical
अभ्यास	practice
तारीफ़ करना	praise
मज़ाक	prank
प्रार्थना करना	pray
कीमती	precious
एकदम सही	precise
एकदम सही	precisely
भविष्यवाणी करना	predict
वरीयता देना	prefer
पसंद	preference
गर्भवती	pregnant
पूर्वाग्रह	prejudice
परिसर	premises
बीमा किस्त	premium
तैयारी	preparation
तैयार करना	prepare
तैयार	prepared
प्रेपोज़िशन	preposition
मौजूदगी	presence
वर्तमान	present
प्रस्तुति	presentation
संरक्षित करना	preserve
राष्ट्रपति	president
प्रेस	press
दबाव	pressure
दिखावा करना	pretend
सुंदर	pretty
रोकना	prevent
पिछला	previous
शिकार करना	prey
कीमत	price
गर्व	pride
पुजारी	priest
प्राथमिक	primary
मुख्य	prime
राजकुमारी	princess
प्रधानाचार्य	principal
पहले	prior
प्राथमिकता	priority
जेल	prison
निजता	privacy
निजी	private
विशेषाधिकार	privilege
इनाम	prize
शायद	probably
समस्या	problem
प्रक्रिया	procedure
आगे बढ़ना	proceed
प्रक्रिया	process
उत्पादन करना	produce
उत्पाद	product
उत्पादन	production
पेशा	profession
पेशेवर	professional
प्रोफ़ाइल	profile
लाभ	profit
गहरा	profound
प्रगति	progress
प्रोजेक्ट	project
प्रमुख	prominent
वादा करना	promise
पदोन्नति करना	promote
पदोन्नति	promotion
संकेत देना	prompt
प्रवृत्त	prone
सर्वनाम	pronouns
उच्चारण	pronunciation
सबूत	proof
उचित	proper
ठीक तरह से	properly
गुण	properties
संपत्ति	property
प्रस्ताव	proposal
संभावना	prospect
समृद्धि	prosperity
समृद्ध	prosperous
रक्षा करना	protect
गर्व	proud
सिद्ध करना	prove
उपलब्ध करवाना	provide
बशर्ते	provided
प्रांत	province
प्रावधान	provision
तरुणाई	puberty
जनता	public
खींचना	pull
कद्दू	pumpkin
समय का पाबंद	punctual
शिष्य	pupil
खरीदना	purchase
शुद्ध	pure
बैंगनी	purple
उद्देश्य	purpose
बटुआ	purse
पाने की कोशिश करना	pursue
तलाश	pursuit
धक्का देना	push
रखना	put
योग्यता	qualification
गुणवत्ता	quality
मात्रा	quantity
संगरोधन	quarantine
झगड़ना	quarrel
चौथाई	quarter
केचुआ	Quechua
रानी	queen
क्वीर	queer
सवाल	query
सवाल	question
पंक्ति	queue
जल्दी	quick
जल्दी से	quickly
शांत	quiet
रजाई	quilt
छोड़ना	quit
पूर्णतया	quite
प्रश्न पूछना	quiz
उद्धरण	quotation
उद्धरण	quote
उद्धरण	quotes
खरगोश	rabbit
प्रजाति	race
क्रोध	rage
बारिश	rain
उठाना	raise
बढ़ाया गया	raised
दौड़ा	ran
अनियमित	random
सीमा	range
तेज़	rapid
तेज़ी से	rapidly
दुर्लभ	rare
कभी-कभार	rarely
खरोंच	rash
चूहा	rat
दर	rate
की अपेक्षा	rather
अनुपात	ratio
विवेकी	rational
कच्चा	raw
दोबारा	re
पहुँचना	reach
पहुँच गया	reached
प्रतिक्रिया	reaction
पढ़ना	read
पढ़ना	reading
तैयार	ready
वास्तविक	real
वास्तविकता	reality
समझना	realize
समझना	realized
वास्तव में	really
पिछला	rear
कारण	reason
तर्कसंगत	reasonable
याद करना	recall
रसीद	receipt
पाना	receive
प्राप्त हुआ	received
हाल ही का	recent
हाल ही में	recently
स्वागत समारोह	reception
व्यंजन विधि	recipe
लापरवाह	reckless
मान्यता	recognition
मान्यता देना	recognize
अनुशंसा करना	recommend
अनुशंसित	recommended
अभिलेख	record
वापस पाना	recover
वसूली	recovery
आयत	rectangle
लाल	red
भुनाना	redeem
पाप मुक्ति	redemption
कम करना	reduce
बेकार	redundant
संदर्भ देना	refer
संदर्भ	reference
विचार करना	reflect
प्रतिबिंब	reflection
रोकना	refrain
रेफ़्रिजरेटर	refrigerator
पैसे वापस करना	refund
अस्वीकार करना	refuse
अस्वीकार करना	refused
सम्मान देना	regard
संबंधित	regarding
ध्यान दिए बिना	regardless
सम्मान	regards
क्षेत्र	region
पंजीकरण करवाना	register
पछतावा करना	regret
नियमित	regular
नियमित रूप से	regularly
अस्वीकार करना	reject
संबद्ध करना	relate
संबद्ध	related
रिश्ता	relationship
संबंधी	relative
सगे-संबंधी	relatives
आराम करना	relax
मुक्त करना	release
मुक्त	released
प्रासंगिक	relevant
भरोसेमंद	reliable
राहत	relief
छोड़ना	relieve
चिंतामुक्त	relieved
धर्म	religion
धार्मिक	religious
संकोची	reluctant
भरोसा करना	rely
अवशेष	remain
शेष	remaining
विलक्षण	remarkable
उपचार	remedy
याद करना	remember
याद दिलाना	remind
अनुस्मारक	reminder
दूर	remote
निकालना	remove
प्रदान करना	render
किराया	rent
मरम्मत करना	repair
दोहराना	repeat
बदलना	replace
जवाब	reply
शिकायत करना	report
प्रतिनिधित्व करना	represent
प्रतिष्ठा	reputation
अनुरोध	request
ज़रूरत होना	require
आवश्यक	required
बचाव	rescue
शोध करना	research
समान होना	resemble
क्रोध	resentment
आरक्षण	reservation
संरक्षित	reserve
निवासी	resident
इस्तीफ़ा देना	resign
लचीलापन	resilience
लचीला	resilient
प्रतिरोध करना	resist
प्रतिरोध	resistance
संकल्प	resolution
हल करना	resolve
सहारा लेना	resort
संसाधन	resources
आदर	respect
जवाब देना	respond
जवाब	response
ज़िम्मेदारी	responsibility
ज़िम्मेदार	responsible
आराम	rest
आत्मा को शांति मिले	rest in peace
रेस्टोरेंट	restaurant
पुनर्स्थापित करना	restore
प्रतिबंध लगाना	restrict
परिणाम	result
परिणाम	results
फिर शुरू करना	resume
खुदरा	retail
बरकरार रखना	retain
प्रतिधारण	retention
सेवानिवृत्त	retired
पीछे हटना	retreat
फिर से प्राप्त करना	retrieve
वापस करना	return
प्रकट करना	reveal
दिखाया गया	revealed
बदला	revenge
आय	revenue
उल्टा	reverse
समीक्षा	review
दोहराना	revise
दोहराव	revision
क्रांति	revolution
इनाम	reward
लय	rhythm
पसली	rib
चावल	rice
अमीर	rich
छुटकारा पाना	rid
सवारी करना	ride
हास्यास्पद	ridiculous
सही	right
अभी	right now
कठोर	rigid
अँगूठी	ring
कुल्ला करना	rinse
दंगा	riot
फाड़ना	rip
पका हुआ	ripe
उठना	rise
जोखिम	risk
प्रतिद्वंद्वी	rival
नदी	river
सड़क	road
भूनना	roast
मज़बूत	robust
चट्टान	rock
छड़	rod
भूमिका	role
लुढ़काना	roll
छत	roof
कमरा	room
जड़	root
रस्सी	rope
सड़ा हुआ	rotten
खुरदुरा	rough
अंदाज़न	roughly
गोल	round
रास्ता	route
रूटीन	routine
पंक्ति	row
रगड़ना	rub
रबड़	rubber
बकवास	rubbish
असभ्य	rude
गलीचा	rug
नष्ट करना	ruin
नियम	rule
शासक	ruler
नियम	rules
दौड़ना	run
लगातार	running
ग्रामीण	rural
जल्दबाज़ी करना	rush
थैला	sack
पवित्र	sacred
बलिदान	sacrifice
सुरक्षित	safe
सुरक्षित उड़ान	safe flight
सुरक्षा	safety
समझदार	sage
कहा	said
नाव चलाना	sail
नाव चलाना	sailing
कारण	sake
वेतन	salary
बिक्री करना	sale
सैमन	salmon
नमक	salt
वही	same
यहाँ भी ऐसा ही	Same here
नमूना	sample
रेत	sand
संस्कृत	Sanskrit
व्यंग्यपूर्ण	sarcastic
गुस्ताख	sassy
बैठा	sat
संतुष्टि	satisfaction
संतुष्ट	satisfied
संतुष्ट करना	satisfy
संतुष्टि देने वाला	satisfying
शनिवार	Saturday
सॉसेज	sausage
बर्बर	savage
बचाना	save
देखा	saw
कहना	say
पैमाना	scale
घोटाला	scam
निशान	scar
अपर्याप्त	scarce
डरा हुआ	scared
स्कार्फ़	scarf
डरावना	scary
फैला हुआ	scattered
दृश्य	scene
प्राकृतिक दृश्य	scenery
महक	scent
समय-सारिणी	schedule
स्कूल	school
विज्ञान	science
वैज्ञानिक	scientist
वैज्ञानिक	scientists
कैंची	scissors
भला-बुरा कहना	scold
दायरा	scope
अंक	score
कतरन	scrap
खरोंचना	scratch
चीखना	scream
स्क्रीन	screen
पेंच	screw
लिखी हुई कहानी	script
समुद्र	sea
नाकाबंदी करना	seal
खोजना	search
मौसम	season
सीट	seat
दूसरा	second
रहस्य	secret
खंड	section
सुरक्षित	secure
सुरक्षा	security
देखना	see
मिलते हैं	see you
बाद में मिलते हैं	see you later
जल्दी मिलते हैं	see you soon
कल मिलते हैं	see you tomorrow
बीज	seed
पाना	seek
प्रतीत होना	seem
प्रतीत होना	seems
देखा गया	seen
पकड़ना	seize
दौरा	seizure
कभी-कभी	seldom
चुनना	select
खुद	self
खुद से उपचार	self healing
स्वार्थी	selfish
बेचना	sell
भेजना	send
मुझे अपनी तस्वीर भेजो	send me your picture
वरिष्ठ	senior
समझ	sense
समझदार	sensible
संवेदनशील	sensitive
भेजा गया	sent
वाक्य	sentence
वाक्य	sentences
अलग करना	separate
सेपेडी	Sepedi
सितंबर	september
क्रम	sequence
शृंखला	series
गंभीर	serious
गंभीरता से	seriously
सेवा करना	serve
सेवा	service
सत्र	session
तय करना	set
स्थापित करना	set up
सेटिंग	setting
निपटारा करना	settle
सात	seven
सत्रह	seventeen
सत्तर	seventy
अनेक	several
गंभीर	severe
सिलना	sew
छाया	shade
छाया	shadow
हिलाना	shake
उथला	shallow
शर्म	shame
आकार	shape
शेयर करना	share
तेज़	sharp
वह	she
उसके पास	she has
वह है	she is
ओसारा	shed
भेड़	sheep
चादर	sheet
दराज	shelf
शंख	shell
शरण स्थल	shelter
कवच	shield
बदलाव	shift
चमकना	shine
जहाज	ship
शिपिंग	shipping
शर्ट	shirt
जूते	shoes
गोली मारना	shoot
दुकान	shop
खरीदारी	shopping
किनारा	shore
छोटा	short
कमी	shortage
गोली मारना	shot
चाहिए	should
कंधा	shoulder
चिल्लाना	shout
दिखाना	show
मुझे दिखाओ	show me
फव्वारा	shower
झींगा	shrimp
सिकुड़ना	shrink
बंद करना	shut
बंद करना	shut up
शर्मीला	shy
भाई-बहन	sibling
भाई-बहन	siblings
बीमार	sick
ओर	side
साँस	sigh
दृश्य	sight
पर्यटन	sightseeing
हस्ताक्षर	sign
हस्ताक्षर	signature
महत्वपूर्ण	significant
मौन	silence
चुपचाप	silent
रेशम	silk
नासमझ	silly
चाँदी	silver
समान	similar
सीधा	simple
इसके साथ ही	simultaneously
तब से	since
ईमानदार	sincere
ईमानदारी से	sincerely
गाना	sing
गायक	singer
अकेला	single
डूबना	sink
श्रीमान	Sir
बहन	sister
भाभी	sister in law
बैठना	sit
साइट	site
स्थिति	situation
छह	six
सोलह	sixteen
साठ	sixty
आकार	size
कौशल	skill
कौशल	skills
त्वचा	skin
पतला-दुबला	skinny
छोडना	skip
स्कर्ट	skirt
आकाश	sky
गुलाम	slave
सोना	sleep
सोना	sleeping
उनींदा	sleepy
आस्तीन	sleeve
टुकड़ा	slice
फिसलना	slide
हल्का सा	slightly
छरहरा	slim
फिसलना	slip
ढलान	slope
छेद	slot
धीमा	slow
धीरे से	slowly
छोटा	small
बुद्धिमान	smart
महक	smell
मुस्कुराना	smile
धुआँ	smoke
चिकना	smooth
नाश्ता	snack
घोंघा	snail
साँप	snake
चुटकी बजाना	snap
बर्फ़	snow
इसलिए	so
बहुत प्यारा	so cute
अब तक	so far
डुबाना	soak
साबुन	soap
सादगीपूर्ण	sober
फ़ुटबॉल	soccer
सामाजिक	social
समाज	society
मोज़े	socks
कोमल	soft
सॉफ़्टवेयर	software
मिट्टी	soil
बिका हुआ	sold
बिक गया	sold out
सैनिक	soldier
अकेला	sole
ठोस	solid
समाधान	solution
हल करना	solve
कुछ	some
कोई व्यक्ति	somebody
किसी तरह	somehow
कोई व्यक्ति	someone
कुछ	something
कभी-कभी	sometimes
गीत	song
जल्दी	soon
परिष्कृत	sophisticated
सोरानी	Sorani
घाव	sore
गला खराब होना	sore throat
दुख	sorrow
माफ़ करें	Sorry
क्रम से लगाना	sort
ढूँढा गया	sought
आत्मा	soul
जीवनसाथी	soulmate
आवाज़	sound
शोरबा	soup
खट्टा	sour
स्रोत	source
दक्षिण	south
अंतरिक्ष	space
स्पैम	spam
अवधि	span
स्पैनिश	Spanish
अतिरिक्त	spare
बोलना	speak
विशेष	special
प्रजातियाँ	species
विशिष्ट	specific
शानदार	spectacular
भाषण	speech
अवाक	speechless
रफ़्तार	speed
वशीकरण	spell
खर्च करना	spend
खर्च किया गया	spent
मसालेदार	spicy
नोकदार चीज़	spike
घुमाना	spin
पालक	spinach
आत्मा	spirit
थूकना	spit
भव्य	splendid
विभाजित करना	split
बिगाड़ना	spoil
बिगड़ा हुआ	spoiled
अविरल	spontaneous
चम्मच	spoon
धब्बा	spot
जीवनसाथी	spouse
फैलाना	spread
स्प्रिंग	spring
वर्ग	square
निचोड़ना	squeeze
स्क्विड	squid
गिलहरी	squirrel
छूरा भोंकना	stab
स्थिर	stable
ढेर	stack
कर्मचारी	staff
अवस्था	stage
धब्बा	stain
सीढ़ियाँ	stairs
हिस्सा	stake
पीछा करना	stalk
छोटी दुकान	stall
टिकट	stamp
खड़ा होना	stand
मानक	standard
तारा	star
शुरू करना	start
शुरू किया गया	started
भूख लगना	starving
राज्य	state
कथन	statement
स्टेशन	station
मूर्ति	statue
दर्जा	status
रहना	stay
सुरक्षित रहें	stay safe
स्थिर	steady
माँस का कबाब	steak
चुराना	steal
भाप	steam
इस्पात	steel
सीधी चढ़ाई	steep
तना	stem
कदम	step
चिपकना	stick
अकड़न	stiff
फिर भी	still
डंक मारना	sting
कंजूस	stingy
हिलाना	stir
शोरबा	stock
चुराया हुआ	stolen
पेट	stomach
पत्थर	stone
खड़ा हुआ	stood
स्टूल	stool
रुकना	stop
भंडारण	storage
इकट्ठा करना	store
तूफ़ान	storm
कहानी	story
चूल्हा	stove
सीधा	straight
सीधा	straightforward
छानना	strain
विचित्र	strange
अजनबी	stranger
रणनीति	strategy
पुआल	straw
स्ट्रॉबेरी	strawberry
धारी	streak
धारा	stream
सड़क	street
ताकत	strength
तनाव	stress
खींचना	stretch
सख्त	strict
हड़ताल	strike
डोरी	string
पट्टी	strip
कोशिश करना	strive
सहलाना	stroke
मज़बूत	strong
टकरा गया	struck
संरचना	structure
संघर्ष	struggle
संघर्षरत	struggling
हठी	stubborn
फँसा हुआ	stuck
विद्यार्थी	student
अध्ययन	study
पढ़ना	studying
सामान	stuff
अद्भुत	stunning
मूर्ख	stupid
शैली	style
विषय	subject
जमा करना	submission
जमा करना	submit
सत्व	substance
स्थानापन्न	substitute
जटिल	subtle
सफल होना	succeed
सफलता	success
सफल	successful
ऐसा	such
जैसे कि	such as
चूसना	suck
अचानक	sudden
अचानक	suddenly
कष्ट सहना	suffer
कष्ट	suffering
पर्याप्त	sufficient
चीनी	sugar
सुझाव देना	suggest
सुझाव	suggestion
सुविधाजनक होना	suit
उपयुक्त	suitable
सूटकेस	suitcase
जोड़	sum
सारांश	summary
गर्मी	summer
बैठक	summit
सूरज	sun
रविवार	sunday
धूप वाला	sunny
सूर्यास्त	sunset
धूप	sunshine
बहुत अच्छा	super
बेहतर	superior
सुपरवाइज़र	supervisor
खाना	supper
आपूर्ति	supply
सहारा	support
कल्पना करना	suppose
कल्पित	supposed
निश्चित	sure
सतह	surface
आवेश	surge
ऑपरेशन	surgery
उपनाम	surname
हैरत में डालना	surprise
हैरान	surprised
हार मान लेना	surrender
आस-पास	surrounding
निगरानी	surveillance
सर्वे	survey
जीवित बचना	survive
संदिग्ध व्यक्ति	suspect
निलंबित	suspended
संदिग्ध	suspicious
कायम रखना	sustain
वहनीयता	sustainability
टिकाऊ	sustainable
लूट का माल	swag
निगलना	swallow
बदलना	swap
कसम खाना	swear
पसीना	sweat
स्वेटर	sweater
झाड़ू  लगाना	sweep
मीठा	sweet
मीठी नींद आए	sweet dreams
मीठे का शौकीन	sweet tooth
प्रिय	sweetheart
सूजना	swell
सूजन	swelling
तैरना	swim
तैरना	swimming
झूला	swing
बदलना	switch
सूजा हुआ	swollen
तलवार	sword
प्रतीक	symbol
सहानुभूति	sympathy
लक्षण	symptoms
व्यवस्था	system
मेज़	table
जूझना	tackle
टैग	tag
पूँछ	tail
लेना	take
ले लेना	take away
देखभाल करना	take care
उड़ान भरना	take off
लिया गया	taken
बात करना	talk
बातूनी	talkative
लंबा	tall
नल	tap
फीता	tape
लक्ष्य	target
काम	task
स्वाद	taste
स्वादिष्ट	tasty
पढ़ाया	taught
चाय	tea
पढ़ाना	teach
शिक्षक	teacher
टीम	team
फाड़ना	tear
आँसू	tears
चिढ़ाना	tease
तकनीकी	technology
दाँत	teeth
बताना	tell
मुझे बताओ	tell me
गुस्सा	temper
तापमान	temperature
मंदिर	temple
अस्थायी	temporary
दस	ten
दस हज़ार	ten thousand
किरायेदार	tenant
झुकाव होना	tend
प्रवृत्ति	tendency
नाज़ुक	tender
तनावग्रस्त	tense
तनाव	tension
तंबू	tent
अंदाज़न	tentative
शर्त	term
शर्तें	terms
भयानक	terrible
कमाल का	terrific
इलाका	territory
परीक्षा	test
लेख	text
बजाय	than
धन्यवाद देना	thank
धन्यवाद	thank you
जब तक हम शिपमेंट की जाँच कर रहे हैं, तब तक धैर्य बनाए रखने के लिए आपका धन्यवाद	Thank you for your patience while we investigate shipment
आपका बहुत-बहुत धन्यवाद	thank you so much
आपका बहुत-बहुत धन्यवाद	thank you very much
धन्यवाद	thanks
हमारा ऐप इस्तेमाल करने के लिए धन्यवाद	Thanks for using our app
वह	that
वह है	that is
अच्छी बात है	that's good
चोरी	theft
उनका	their
उन्हें	them
थीम	theme
खुद	themselves
तब	then
लिखित	theory
वहाँ	there
वहाँ हैं	there are
वहाँ है	there is
इसलिए	therefore
ये	these
वे	they
वे हैं	they are
मोटा	thick
चोर	thief
जाँघ	thigh
पतला	thin
चीज़	thing
चीज़ें	things
सोचना	think
तीसरा	third
प्यासा	thirsty
तेरह	thirteen
तीस	thirty
यह	this
यह है	this is
अच्छी तरह	thorough
अच्छी तरह से	thoroughly
वे	those
यद्यपि	though
विचार	thought
विचारमग्न	thoughtful
विचार	thoughts
हज़ार	thousand
धागा	thread
धमकी	threat
धमकी देना	threaten
तीन	three
सीमा	threshold
रोमांचित	thrilled
फलना-फूलना	thrive
गला	throat
द्वारा	through
लगातार	throughout
फेंकना	throw
अँगूठा	thumb
गड़गड़ाहट	thunder
गुरुवार	Thursday
इस प्रकार	thus
सही का निशान लगाना	tick
ज्वार-भाटा	tide
सुव्यवस्थित	tidy
बाँधना	tie
चीता	tiger
कसा हुआ	tight
तिग्रिन्या	Tigrinya
समय	time
डरपोक	timid
बहुत छोटा	tiny
बख्शीश	tip
सलाह	tips
थका देना	tire
थका हुआ	tired
ऊतक	tissue
शीर्षक	title
को	to
होना	to be
सेंकना	toast
आज	today
बहुत छोटा बच्चा	toddler
पैर की उँगलियाँ	toes
साथ-साथ	together
शौचालय	toilet
बताया	told
सहनशीलता	tolerance
सहन करना	tolerate
टमाटर	tomato
कल	tomorrow
जीभ	tongue
आज रात	tonight
भी	too
लेना	took
औजार	tool
औजार	tools
दाँत	tooth
ऊपर	top
विषय	topic
फटा हुआ	torn
यातना	torture
कुल	total
छूना	touch
कठिन	tough
यात्रा	tour
की ओर	toward
की ओर	towards
तौलिया	towel
कस्बा	town
विषाक्त	toxic
पता लगाना	trace
रास्ता	track
व्यापार	trade
परंपरा	tradition
परंपरागत	traditional
ट्रैफ़िक	traffic
पगडंडी	trail
रेलगाड़ी	train
प्रशिक्षण	training
प्रवृत्ति	trait
विशेषताएँ	traits
स्थानांतरण करना	transfer
संक्रमण	transition
अनुवाद	translate
पारदर्शी	transparent
यातायात	transport
यातायात	transportation
जाल	trap
कूड़ा	trash
सदमा	trauma
यात्रा करना	travel
ट्रे	tray
खज़ाना	treasure
व्यवहार करना	treat
इलाज	treatment
पेड़	tree
ज़बरदस्त	tremendous
रुझान	trend
मुकदमा	trial
चाल	trick
कोशिश की	tried
चालू कर देना	trigger
काट-छांट करना	trim
यात्रा	trip
मुश्किल	trouble
पैजामा	trousers
ट्रक	truck
सही	true
तना	trunk
विश्वास	trust
सच	truth
कोशिश करना	try
त्सोंगा	Tsonga
नली	tube
मंगलवार	Tuesday
ट्यूशन	tuition
टर्की	turkey
हल्दी	turmeric
मोड़	turn
कछुआ	turtle
कोई विषय पढ़ाना	tutor
बारह	twelve
बीस	twenty
इक्कीस	twenty-one
ट्वी	Twi
दो बार	twice
मोड़	twist
दो	two
प्रकार	type
प्रतीकात्मक	typical
भद्दा	ugly
अंतिम	ultimate
छाता	umbrella
अक्षम	unable
चाचा	uncle
अचेत	unconscious
नीचे	under
नीचे	underneath
कम आँका गया	underrated
समझना	understand
समझा	understood
दुर्भाग्य से	unfortunately
वेशभूषा	uniform
अनोखा	unique
यूनिट	unit
विश्वविद्यालय	university
अज्ञात	unknown
जब तक	unless
तक	until
असामान्य	unusual
ऊपर	up
आप पर है	up to you
अपडेट करना	update
उन्नत करना	upgrade
ऊपर	upon
परेशान	upset
शहरी	urban
प्रबल इच्छा	urge
बहुत ज़रूरी	urgent
हम	us
प्रयोग करना	use
इस्तेमाल किया गया	used
उपयोगी	useful
बेकार	useless
साधारण	usual
आम तौर पर	usually
उपयोगिता	utility
छुट्टी	vacation
टीकाकरण	vaccination
टीका	vaccine
खालीपन	vacuum
अस्पष्ट	vague
वैध	valid
घाटी	valley
कीमती	valuable
कीमत	value
विविधता	variety
विविध	various
अलग होना	vary
गुलदान	vase
बहुत बड़ा	vast
सब्ज़ी	vegetable
सब्ज़ियाँ	vegetables
वाहन	vehicle
वेंडर	vendor
ज़हर	venom
जोखिम उठाना	venture
कार्यक्रम का स्थान	venue
सत्यापित करना	verify
बहुमुखी प्रतिभा संपन्न	versatile
संस्करण	version
लंबवत	vertical
बहुत	very
बहुत अच्छा	very good
जहाज़	vessel
ज़रिये	via
अनुभूति	vibe
अनुभूति	vibes
दुष्ट	vicious
पीड़ित	victim
वीडियो	video
देखना	view
गाँव	village
खलनायक	villain
सिरका	vinegar
बढ़िया शराब	vintage
हिंसा	violence
हिंसक	violent
वायरल	viral
कुँवारी	virgin
आभासी	virtual
गुण	virtue
नज़र	vision
मिलने जाना	visit
तस्वीर	visual
अत्यावश्यक	vital
जीवंत	vivid
शब्दावली	vocabulary
आवाज़	voice
खालीपन	void
मात्रा	volume
स्वयंसेवी	volunteer
उल्टी करना	vomit
असुरक्षित	vulnerable
वेतन	wage
वेतन	wages
कमर	waist
इंतज़ार	wait
परिचारक	waiter
इंतज़ार में	waiting
जागना	wake
जगाना	wake up
टहलना	walk
टहलना	walking
दीवार	wall
बटुआ	wallet
घूमना	wander
चाहना	wanna
चाहना	want
इच्छित	wanted
युद्ध	war
कपड़े की अलमारी	wardrobe
गोदाम	warehouse
गर्म	warm
चेतावनी देना	warn
चेतावनी	warning
योद्धा	warrior
था	was
धोना	wash
बरबाद करना	waste
घड़ी	watch
पानी	water
तरबूज	watermelon
हिलाना	wave
रास्ता	way
हम	we
हम हैं	we are
हम कर सकते हैं	we can
कमज़ोर	weak
कमज़ोरी	weakness
संपत्ति	wealth
धनवान	wealthy
पहनना	wear
पहना हुआ	wearing
मौसम	weather
शादी	wedding
बुधवार	Wednesday
खर-पतवार	weed
सप्ताह	week
सप्ताहांत	weekend
वज़न	weight
अजीब	weird
स्वागत	welcome
कल्याण	welfare
ठीक	Well
बहुत अच्छा	well done
गया	went
थे	were
पश्चिम	west
गीला	wet
व्हेल	whale
क्या	what
आप कैसे हैं	what about you
आप क्या कर रहे हैं	what are you doing
आप अभी क्या कर रहे हैं	what are you doing now
आप अभी क्या कर रहे हैं	what are you doing right now
आप क्या काम करते हैं	what do you do
आप जीविका के लिए क्या करते हैं	what do you do for a living
आपका क्या मतलब है	what do you mean
आप क्या चाहते हैं	what do you want
क्या हुआ	what happened
क्या है	what is
यह क्या है	what is this
आप क्या काम करते हैं	what is your job
आपका क्या नाम है	what is your name
क्या हाल	what's up
आपका क्या नाम है	what's your name
जो कुछ भी	whatever
गेहूँ	wheat
पहिया	wheel
जब	when
जब भी	whenever
कहाँ	where
तुम कहाँ हो	where are you
आप कहाँ से हैं	where are you from
अभी आप कहाँ हैं	where are you now
आप कहाँ रहते हैं	where do you live
कहाँ है	where is
जबकि	whereas
चाहे	whether
कौन सा	which
जबकि	while
फुसफुसाना	whisper
सीटी	whistle
सफ़ेद	white
कौन	who
आप कौन हैं	who are you
कौन है	who is
यह कौन है	who is this
साबुत	whole
किसको	whom
किसका	whose
क्यों	why
क्यों नहीं	why not
दुष्ट	wicked
चौड़ा	wide
विधवा	widow
चौड़ाई	width
पत्नी	wife
जंगली	wild
वसीयत	will
इच्छुक	willing
जीतना	win
हवा	wind
खिड़की	window
तूफ़ानी	windy
शराब	wine
सर्दी	winter
पोंछना	wipe
तार	wire
बुद्धि	wisdom
बुद्धिमान	wise
इच्छा	wish
आपको सफलता मिले	wish you all the best
चुड़ैल	witch
साथ	with
वापस लेना	withdraw
निकासी	withdrawal
अंदर	within
बिना	without
गवाह	witness
हाज़िर जवाब	witty
भेड़िया	wolf
महिला	woman
औरत	women
जीत गया	won
आश्चर्य	wonder
आश्चर्यजनक	wonderful
लकड़ी	wood
ऊन	wool
शब्द	word
शब्द	words
काम	work
कसरत करना	work out
कार्यरत	working
दुनिया	world
कीड़ा	worm
पुराना	worn
चिंतित	worried
चिंता	worry
बदतर	worse
पूजा करना	worship
बहुत बुरा	worst
कीमत	worth
इसके लायक था	worth it
योग्य	worthy
घाव	wound
वाह	Wow
लपेटना	wrap
गुस्सा	wrath
कलाई	wrist
लिखना	write
यहाँ लिखें	Write here
लिखना	writing
लिखा हुआ	written
गलत	wrong
लिखा	wrote
गज	yard
जम्हाई लेना	yawn
हाँ	Yeah
साल	year
साल	years
यीस्ट	yeast
चीखना	yell
पीला	yellow
हाँ	Yes
हाँ बेबी	yes baby
हाँ दोस्त	yes dear
हाँ, प्रिय	yes honey
हाँ, प्रिय	yes my love
हाँ बिल्कुल	yes of course
कल	yesterday
अभी तक	yet
पैदावार	yield
तुम	you
तुम हो	you are
आप सुंदर हैं	you are beautiful
आप बहुत सुंदर हैं	you are so beautiful
आपका स्वागत है	you are welcome
तुम कर सकते हो	you can
आपको पता है	You know
तुम्हें भी	you too
आपका स्वागत है	you're welcome
युवा	young
तुम्हारा	your
आपका स्वागत है	your welcome
खुद	yourself
युवा	youth
आपका स्वागत है	you’re welcome
स्वादिष्ट	yummy
शून्य	zero
