Yon	a
yon ti kras	a little
enpe	a little
Anpil	a lot
Alat	a lot
anpil	a lot of
yon anpil nan	a lot of
abandone	abandon
abandone	abandoned
respekte	abide
kapasite	ability
Abilite	ability
kapab	able
osijè	about
Sou	about
pi wo	above
An ro	above
Op	above
aletranje	abroad
absans	absence
absan	absent
absoliman	absolutely
Absòbe	absorb
abstrè	abstract
absoli	absurd
absid	absurd
abondans	abundance
anbondans	abundant
abondan	abundant
Abi	abuse
Abyuuz	abuse
aksan	accent
Aksepte	accept
Akses	access
aksè	access
aksidan	accident
aranjman	accommodation
Akomodasyon	accommodation
akonpli	accomplish
reyalize	accomplish
akonpli	accomplished
te reyalize	accomplished
dapre	according
selon dapre	according
kont	account
presizyon	accuracy
egzèsis	accuracy
egzat	accurate
egzak	accurate
te akize	accused
akize	accused
doulè	ache
Iek	ache
malmou	ache
Akonpli	achieve
reyalize	achieve
akonplisman	achievement
reyisit	achievement
rekonèt	acknowledge
konesans	acquaintance
zanmi	acquaintance
genyen	acquire
jwenn	acquire
te akeri	acquired
akeri	acquired
rakonte	acquisition
akizisyon	acquisition
atravè	across
an travèse	across
aji	act
Zak	act
Aksyon	action
Aktif	active
Aktivite	activities
Aktivite	activity
aktè	actor
aktyèl	actual
reyèl	actual
aktyèlman	actually
egu	acute
egi	acute
adapte	adapt
ajoute	add
adikte	addicted
dejwe	addicted
adisyon	addition
adisyonèl	additional
Ajres	address
Adrès	address
adekwat	adequate
adekwa	adequate
adjasan	adjacent
adjektif	adjective
ajiste	adjust
admire	admire
admèt	admit
adopte	adopt
adorabl	adorable
adorab	adorable
Advans	advance
Avans	advance
avanse	advance
avanse	advanced
avalwa	advanced
Avantaj	advantage
avanti	adventure
adverb	adverb
piblisite	adverb
reklam	advertisement
piblisite	advertising
Konsèy	advice
konseye	advise
Advoket	advocate
avoka	advocate
defann	advocate
estetik	aesthetic
ayestetik	aesthetic
zafè	affair
afekte	affect
afeksyon	affection
gen mwayen	afford
peye	afford
abòdab	affordable
abòtab	affordable
Pè	afraid
Apre	after
aprè midi	afternoon
Aaftawerdz	afterwards
apre sa	afterwards
apre	afterwards
Ankò	again
Gens	against
kont	against
laj	age
ajans	agency
ajan	agent
Agresif	aggressive
ajil	agile
ago	ago
de sa	ago
dakò	agree
akò	agreement
Agrikilti	agriculture
devan	ahead
èd	aid
vize	aim
Aeryen	air
Air	air
ayewopò	airport
ale	aisle
slam	alarm
alam	alarm
alkòl	alcohol
alèt	alert
vijilan	alert
Anvi	alive
vivan	alive
tout	all
oke	all right
tout dwa	all right
tout pi bon an	all the best
Tout pi bon bagay	all the best
Pèmèt	allow
Pèmèt	allowed
Preske	almost
prèske	almost
Poukont	alone
pou kont li	alone
ansanm	along
Deja	already
Oke	Alright
tou	also
altènatif	alternative
altènativ	alternative
Atravè	although
byenke	although
toujou	always
am	am
Mwen	am
etonan	amazing
angwasye	ambiguous
Limit	ambiguous
anbisyon	ambition
lanbisyon	ambition
anbisye	ambitious
amande	amend
amenajman	amend
nan mitan	amid
amid	amid
nan mitan	among
Pami	among
pami nou	among us
kantite	amount
Montan	amount
zam	amusing
amizan	amusing
Yon	an
Analiz	analysis
zansèt	ancestors
zansèt yo	ancestors
jete lank	anchor
lank	anchor
ansyen	ancient
E	and
ak	and
e ou menm	and you
ak ou	and you
zanj	angel
Kòlè	anger
ang	angle
fache	angry
Mwen en cole	angry
Zannimo	animal
cheviy	ankle
Chevi m	ankle
anivèsè	anniversary
Aniversri	anniversary
Anonsman	announcement
anons	announcement
anbete	annoy
anmède	annoy
énervé	annoyed
anmède	annoyed
nmègdan	annoying
anmèdan	annoying
anyèl	annual
anonim	anonymous
Neda	another
yon lòt	another
Lòt	another
Ansa	answer
Reponn	answer
antisipe	anticipate
tansyon	anticipate
la perèz	anxiety
enkyetid	anxiety
Kè m sere	anxious
anksyeu	anxious
nenpòt	any
Okenn	any
ankò	anymore
nenpòt moun	anyone
Moun	anyone
Anyen	anything
de tout pouvwa	anyway
de tout fason	anyway
de tout pouvwa	anyways
aniwe	anyways
apa	apart
separe	apart
apatman	apartment
eskize	apologize
aparan	apparent
aparamman	apparently
apèl	appeal
parèt	appear
aparans	appearance
parèt	appeared
te parèt	appeared
Did shuo op	appeared
apeti	appetite
Apple	apple
pòm	apple
aplikasyon	application
aplike	apply
Randevou	appointment
apresye	appreciate
apresyasyon	appreciation
apwòch	approach
Appruoch	approach
apròch	approach
apwopriye	appropriate
apwobasyon	approval
aprouve	approve
apwouve	approve
Apwouve	approved
apeprè	approximately
Avril	april
abitrè	arbitrary
achitèk	architect
achitek	architect
achitekti	architecture
achiv	archive
yo	are
se	are
èske ou	are you
ou	are you
eske ou okipe	are you busy
èske ou okipe	are you busy
eske ou marye	are you married
ou marye	are you married
eske ou marye oswa selibatè	are you married or single
èske ou marye oswa yon sèl	are you married or single
Èske ou toujou la?	Are you still there?
Èske ou la toujou?	Are you still there?
eske ou la	are you there
èske ou la	are you there
zòn	area
diskite	argue
diskisyon	argument
agiman	argument
Aagyument	argument
leve	arise
Bra	arm
Lame	army
alantou	around
Otou	around
fè aranjman	arrange
ranje	arrange
aranjman	arrangement
rive	arrival
arive	arrival
rive	arrive
rive	arrived
awogan	arrogant
flèch	arrow
atizay	art
atik	article
atifisyèl	artificial
atis	artist
kòm	as
osi lontan ke	as long as
osi byen	as well
osi byen ke	as well as
sann	ash
wont	ashamed
Did shiem	ashamed
Mande	ask
Did aaks	asked
Mande	asked
nan dòz	asleep
dòmi	asleep
aspè	aspect
Evalyasyon	Assamese
Assamese	Assamese
atak	assault
asanble	assembly
respekte	assertive
pèsiste mande	assertive
evalye	assess
Estimasyon	assessment
evalyasyon	assessment
avantaj	asset
byen	asset
byen	assets
deziyen	assign
asiyen	assign
plasman	assignment
devwa	assignment
ede	assist
asistan	assistant
kolaboratè	associate
asosye	associate
kolabore	associated
asosye	associated
Asosyasyon	association
Sipoze	assume
asime	assume
sipozisyon	assumption
at	at
alèz	at
omwen	at least
manje	ate
atlèt	athlete
tache	attach
tache	attached
atachman	attachment
atak	attack
tantativ	attempt
Atemp	attempt
Asiste	attend
ale	attend
prezans	attendance
predikasyon	attendance
Atansyon	attention
atitid	attitude
atire	attract
atraksyon	attraction
atire	attractive
atribi	attribute
odyans	audience
Out	august
montan	aunt
matant	aunt
Anti	aunt
matant	aunty
aunty	aunty
natif natal	authentic
otè	author
otorite	authority
otòn	autumn
Disponib	available
De ya nou	available
mwayèn	average
Evite	avoid
Waak waid	avoid
reveye	awake
eveye	awake
prim	award
okouran	aware
konsyans	awareness
konsyantizasyon	awareness
lwen	away
awizom	awesome
Nof rispek	awesome
Fantastik	awesome
terifyan	awful
terib	awful
Akwod	awkward
gòch	awkward
maladi	awkward
Aymara	Aymara
Bebe	baby
ti bebe	baby
bakaloreya	bachelor
moun ki parèy	bachelor
tounen	back
Do	back
background	background
orijin	background
move	bad
Sak	bag
Garnier	bait
zen	bait
kwit	bake
boulanje	bakery
boulanjri soda	baking soda
i kwit	baking soda
Balans	balance
ekilib	balance
boul	ball
Ball	ball
Bambara	Bambara
bannann	banana
misk	banana
bann	band
bande	band
frape	bang
bang	bang
labank	bank
Bank	bank
Bar	bar
apèn	barely
machande	bargain
negosye	bargain
mask	bark
Baak	bark
jape	bark
lòj	barley
baryè	barrier
Baz	base
Baze	based
sousòl	basement
Fondamantal	basic
debaz	basic
fondamantalman	basically
fondamanèman	basically
bazilik	basil
Basil	basil
bastard	bastard
bata	bastard
pakèt	batch
beny	bath
Bath	bath
Twalèt	bathroom
Batri	battery
batay	battle
gòlf	bay
Bay	bay
dwe	be
se	be
dwe fè atansyon	be careful
fè atansyon	be careful
plaj	beach
Beach	beach
travès	beam
Pwa	beans
lous	bear
Bier	bear
Bear	bear
bab	beard
Portant	bearing
efase	bearing
bèt	beast
kale	beat
bat	beat
Biit	beat
Luk gud	beautiful
bèl	beautiful
bote	beauty
Did bikom	became
Vin	became
te vin	became
paske	because
Bikaaz	because
Vin	become
kabann	bed
chanm a kouche	bedroom
chanm	bedroom
abèy	bee
myèl	bee
vyann bèf	beef
Bèf	beef
te	been
byè	beer
anvan	before
Kòmanse	began
Did bigin	began
te kòmanse	began
kòmanse	begin
Kòmansman	beginning
anfavè	behalf
non	behalf
konpòte	behave
fè konpòtman	behave
konpòtman	behavior
konpòtman	behaviour
Dèyè	behind
egzòtasyon	being
ke	being
kwayans	belief
kwè	believe
vant	belly
fè pati	belong
apatni	belong
renmen	beloved
mezane	beloved
Dong a batam	below
Anba	below
senti	belt
ban	bench
Bend	bend
anba	beneath
Benifit	benefit
Benefis	benefit
Benefis	benefits
bòykote	beside
akote	beside
akote yo	besides
san konte	besides
Meyè	best
pi bon	best
pi bon chans	best of luck
pi bon nan chans	best of luck
Salitasyon Espesyal	best regards
pi bon concerne	best regards
Pi bon	better
ant	between
bwason	beverage
depase	beyond
pi lwen	beyond
Bhojpuri	Bhojpuri
paspouki	bias
patipri	bias
partial	biased
patipri	biased
Bisiklèt	bicycle
òf	bid
Gwo	big
Bisiklèt	bike
Bil	bill
bòdwo	bill
mare	bind
zwazo	bird
anivèsè	birthday
bit	bit
Ti	bit
Bait	bite
mòde	bite
anmè	bitter
Noua	black
nwa	black
lam	blade
Bliem	blame
blame	blame
repwòch	blame
vid	blank
Blanch	blank
Lenn	blanket
dra	blanket
eksplozyon	blast
dekole	bleach
Klowòks	bleach
melanj	blend
Beni	bless
beni	blessed
benediksyon	blessed
avèg	blind
Bliss	bliss
benyen	bliss
blòk	block
san	blood
fleri	bloom
flè	bloom
Soufle	blow
kònen	blow
Blè	blue
ble	blue
Blunt	blunt
tablo	board
mete abo	board
batiman	boat
bato	boat
Kò	body
Bouyi	boil
fonse	bold
odè	bold
bon garanti	bond
kosyon	bond
Zo	bone
Liv	book
Buk	book
rechaje	boost
Buus	boost
ranfòse	boost
rapèl	booster
Booster	booster
bòt	boot
Bòt	boots
bòt yo	boots
fwontyè	border
Fontyè	border
raz	bore
adj. raz	bore
anwiye	bored
raz	boring
fèt	born
chagren	borrow
prete	borrow
bòs	boss
patwon	boss
tou de	both
Tuu a dem	both
Toude	both
anmède	bother
Boutèy	bottle
anba	bottom
bounda	bottom
achte	bought
te achte	bought
rebondi	bounce
rebondisman	bounce
limite	bound
mare	bound
limit	boundaries
limit yo	boundaries
Bow	bow
banza	bow
Bòl	bowl
bwat	box
ti gason	boy
Gason	boy
amour	boyfriend
konpayon	boyfriend
braslè	bracelet
sèvèl	brain
sèvo	brain
branch	branch
mak	brand
brav	brave
vyolasyon	breach
vyole	breach
pen	bread
kraze	break
kase	break
Briek	break
manje maten	breakfast
tete	breast
souf	breath
Respire	breathe
leve	breed
kwaze	breed
brik	brick
lamarye	bride
pon	bridge
Bridge	bridge
brèf	brief
klere	bright
klere	brilliant
briyan	brilliant
pote	bring
gro	bro
bro	bro
laj	broad
emèt	broadcast
emisyon	broadcast
kraze	broke
kase	broken
bale	broom
Frè	brother
Bòfrè	brother in law
frè nan lalwa	brother in law
pote	brought
te pote	brought
mawon	brown
Brose	brush
bwòs	brush
bokit	bucket
achay	buddy
zanmi	buddy
Bidjè	budget
ensèk	bug
Konstwi	build
bati	build
Bilding	building
konstwi	built
bati	built
Did bil	built
èstime	bulk
zo	bulk
Toro	bull
towo	bull
entileman	bully
entimide	bully
zoukloum	bump
boul	bump
pakèt	bunch
pake	bundle
Berdn	burden
mandyan	burden
fado	burden
antere	buried
antèman	buried
Bern	burn
boule	burn
Pete	burst
antere	bury
anvi	bury
Bis	bus
otobis	bus
touf	bush
Bush	bush
Biznis	business
jarèt	bust
otobis	bust
okipe	busy
men	but
bè	butter
mantèg	butter
papiyon	butterfly
papis	butterfly
boutonnen	button
bouton	button
achte	buy
by	by
Pa	by
Pandan wap di sa	by the way
nan chemen an	by the way
bye	bye
babay	bye
chou	cabbage
Kabinè	cabinet
kaj	cage
kalòj	cage
gato	cake
gachèt	cake
Molèt	calf
estati ti towo bèf	calf
rele	call
Kaal	call
rele m '	call me
rele mwen	call me
rele	called
Kalm	calm
vini	came
Kanpay	campaign
kapab	can
Ka	can
Kyaahn	can
Pat kapab	can't
pa kapab	can't
Anile	Cancel
Kansè	cancer
kapab	capable
konpetan	capable
kapasite	capacity
Kapital	capital
lejand	caption
caption	caption
kaptire	capture
machin	car
karyè	career
atansyon	careful
Pridan	careful
ak anpil atansyon	carefully
neglijan	careless
lese grennende	careless
k ap pran swen	caring
swanye	caring
Kaapinta	carpenter
bòs mason	carpenter
bòs chapant	carpenter
tapi	carpet
taks	carpet
kawòt	carrot
kawòtchou	carrot
pote	carry
egzekite	carry on
pote sou	carry on
pote soti	carry out
egzekite	carry out
Ka	case
lajan likch	cash
lajan kach	cash
Anplak	cast
jete	cast
chato	castle
Castle	castle
aksidantèl	casual
aksidans	casual
chat	cat
Kenbe	catch
trape	catch
Kategori	category
bèt	cattle
bèf	cattle
kenbe	caught
Kaat	caught
Kaaz	cause
lakòz	cause
prekosyon	caution
avètisman	caution
pridan	cautious
Cave	cave
twou wòch	cave
sispann	cease
plafon	ceiling
selebre	celebrate
sèlil	cell
selil	cell
sant	center
syèk	century
sereyal	cereal
Seremoni	ceremony
sèten	certain
sètènman	certainly
sètifika	certificate
Serfitikit	certificate
chenn	chain
chèn	chain
Chèz	chair
Chalenj	challenge
defi	challenge
Chans	chance
chanje	change
dezòd	chaos
Karaktè	character
Karakteristik	characteristics
Chaj	charge
charite	charity
Spacious	charming
cham	charming
tablo	chart
Chase	chase
chat	chat
Cheap	cheap
bon mache	cheap
tronpe	cheat
triche	cheat
triche	cheating
Chek	check
tcheke	check
Chèk	check
souflèt	cheek
mak	cheek
aplodi	cheer
djougan	cheer
kè kontan	cheerful
Trenken	cheers
cheers	cheers
fwomaj	cheese
chimi	chemistry
cheri	cherish
cherish	cherish
echèk	chess
pwatrin	chest
Kraze	chew
moulen	chew
poul	chicken
Chèf	chief
timoun	child
Pitit	child
anfans	childhood
Timoun	children
Chil	chill
fredi	chill
chemine	chimneys
man fè manm	chin
manton	chin
chokola	chocolate
chwa	choice
chwazi	choose
koupe	chop
travay yo	chores
kèk travay lap fè	chores
replèt	chubby
chubby	chubby
Legliz	church
kannèl	cinnamon
Sèk	circle
sikonstans yo	circumstances
sikonstans	circumstances
sitwayen	citizen
vil	city
reklamasyon	claim
Kliem	claim
klarifye	clarify
klas	class
.class	class
ajil	clay
Pwòp	clean
Netwaye	clean
klè	clear
Klier	clear
grefye	clerk
entelijan	clever
kliyan	client
falèz	cliff
Cliff	cliff
klima	climate
Monte	climb
grenpe	climb
mouye	clingy
clingy	clingy
Revèy	clock
Fèmen	close
klozèt	closet
Twal	cloth
rad	clothes
nwaj	cloud
Cloud	cloud
nyaje	cloudy
twoub	cloudy
klozèt	clown
kloun	clown
pout	clue
grap	clue
maladi	clumsy
maladwa	clumsy
grap	cluster
antrenè	coach
Kuoch	coach
chabon	coal
Coal	coal
litoral	coast
kòt	coast
rad	coat
manto	coat
kafe	coffee
mantal	cognitive
koyitif	cognitive
konyensans	coincidence
konyensidans	coincidence
Mwen fret	cold
frèt	cold
efondreman	collapse
tonbo	collapse
kolye	collar
kamarad	colleague
kolèg	colleague
kamarad	colleagues
kòlèg	colleagues
Kolekte	collect
koleksyon	collection
Kolèj	college
koulè	color
san koulè lide vèt mouri furiously	colorless green ideas slept furiously
lide vèt dòmi fache	colorless green ideas slept furiously
koulè	colour
Kolòn	column
peny	comb
kay	comb
konbinezon	combination
melanje	combine
konbine	combine
vini	come
Faawod	come
vini la	come here
vini isit la	come here
vini sou	come on
a monchè	come on
rekonfòte	comfort
konfò	comfort
konfòtab	comfortable
Ap vini	coming
vini	coming
vini byento	coming soon
lap vinin talè	coming soon
lòd	command
Kòmand	command
Kòmantè	comment
komèsyal	commercial
komisyon, Komisyon	commission
komèt	commit
angajman	commitment
komèt	committed
komodite	commodity
komen	common
kominike	communicate
kominikasyon	communication
kominote	community
vwayaje	commute
vòlè	commute
konpayon	companion
konpayi	company
konpare	compare
konparezon	comparison
kè sansib	compassion
konpasyon	compassion
kè sansib	compassionate
konpasyon	compassionate
Konpatib	compatible
konpetisyon	compete
konpetan	competent
Konpetisyon	competition
konpetitif	competitive
plenyen	complain
plent	complaint
konpleman	complement
Kompliment	complement
konplete	complete
ranpli	complete
konplètman	completely
Konplèks	complex
konfòmite	compliance
konplike	complicated
konpliman	compliment
respekte	comply
konfòme	comply
konpozisyon	composition
konpoze	compound
konpreyansyon	comprehension
konplè	comprehensive
Kompromaiz	compromise
konpwomi	compromise
obligasyon pouswiv	compulsory
obligatwa	compulsory
òdinatè	computer
Konpitè	computer
konsantre	concentrate
konsèp	concept
Kansern	concern
enkyetid	concern
konsène	concerned
konsè	concert
konklizyon	conclusion
konkrè	concrete
Kankriit	concrete
Kondisyon	condition
Kondisyon	conditions
Kandishanz	conditions
Konduit	conduct
konferans	conference
konfese	confess
Konfidans	confidence
konfyans	confidence
gen konfyans	confident
konfyans	confident
konfime	confirm
konfli	conflict
konfonn	confused
boulvèse	confused
kriz	confusion
konfizyon	confusion
kongrasyon yo	congrats
congrats	congrats
felisitasyon	congratulation
konplimante	congratulation
Konpliman	congratulations
Felisitasyon	congratulations
konjonksyon	conjunction
konekte	connect
konkeri	conquer
onsyan	conscious
konsyan	conscious
konsyans	consciousness
konnesans	consciousness
konsanti	consent
Kansent	consent
konsantman	consent
konsekans	consequences
konsekans yo	consequences
konsèvasyon	conservation
konsèvatif	conservative
Konsidere	consider
konsidere	considered
konpoze	consist
konsiste	consist
konsistans	consistency
konsistan	consistent
Konstan	constant
toujou	constantly
toujou ap chèche	constantly
konstipasyon	constipation
Konstriksyon	construction
konsome	consume
Konsomasyon	consumption
Kontak	contact
Kantak	contact
kontakte	contact
kontajye	contagious
gen	contain
genyen	contain
gen	contains
kontanporen	contemporary
mepri	contempt
kontni	content
konpetisyon	contest
Konkou	contest
kontèks	context
kontinan	continent
Kontinye	continue
Kontra	contract
Kanchrak	contract
kontras	contrast
Kanchraas	contrast
Kontribye	contribute
kontribisyon	contribution
Kontwòl	control
kontwovèsyal	controversial
konvenyans	convenience
pratik	convenient
konvèsasyon	conversation
konvèti	convert
Kanvert	convert
transmèt	convey
bay yon remèd	convey
konvenk	convince
te konvenk	convinced
konvenk	convinced
Kuk	cook
kwit	cook
kwit manje	cooking
fre	cool
Kuul	cool
Kòperasyon	cooperation
koperasyon	cooperation
Cope	cope
fè fas	cope
kwiv	copper
nwayo	core
mayi	corn
kwense	corner
kwen	corner
kòrèk	correct
pri	cost
Koute	cost
Kaas	cost
kostim	costume
Kostyuum	costume
Cottage	cottage
koton	cotton
kabann	couch
kanape	couch
tous	cough
te kapab	could
Kapab	could
Konsèy	council
konte	count
Counter	counter
kontre ak	counter
Peyi	country
peyi	countryside
pwovens	countryside
marye	couple
koup	couple
kouraj	courage
kou	course
Tribinal	court
koutwazi	courtesy
kouzen	cousin
kouvri	cover
bèf	cow
lach	coward
Coward	coward
briz	cozy
brikabrak	cozy
krab	crab
Crab	crab
fann	crack
krak	crack
avyon	craft
navèt	craft
krap	crap
kraponnen	crap
Krash	crash
aksidan	crash
anvi	craving
bzwen	craving
rale	crawl
ranpe	crawl
fou	crazy
Kreye	create
kreyatif	creative
Kredi	credit
glise	creep
ranpe	creep
grenpe	creepy
Ekipaj	crew
Krim	crime
monte	cringe
Krinj	cringe
cringe	cringe
kriz	crisis
kritè	criteria
Kritik	critical
kritik	criticism
rekòlt	crop
rekòt	crop
rekòt	crops
Kraas	cross
Cross	cross
kwa	cross
kouwòn	crow
Kònèy	crow
foul	crowd
ankonbre	crowd
ki gen anpil	crowded
anbòse	crowded
kouwòn	crown
kritik	crucial
mechan	cruel
kwazyè	cruise
kraze	crush
Krosh	crush
kriye	cry
konkonb	cucumber
karese	cuddle
kalbas	cuddle
Kilti	culture
pran tan	cunning
atizan konn fè	cunning
tas	cup
Gode	cup
pandri	cupboard
kofr	cupboard
twotwa	curb
koub	curb
kyuur	cure
remèd	cure
geri	cure
kouvrefe	curfew
kouvwefe	curfew
kiaryozite	curiosity
kiryozite	curiosity
kirye	curious
Curly	curly
riske	curly
Lajan	currency
Kouran	current
kounye a	currently
madichon	curse
rido	curtain
kousen	cushion
koutim	custom
kliyan	customer
koutim	customs
Dwan yo	customs
koupe	cut
kot	cut
Koupé	cut
bèl	cute
cute	cute
sik	cycle
bisiklèt	cycle
monte bisiklèt	cycling
papa	dad
papa	daddy
chak jou	daily
akizisyon	dairy
letye	dairy
baraj	dam
Domaj	damage
Damej	damage
modi	damn
mouye	damp
Bal	dance
dans	dance
Danje	danger
Danjere	dangerous
Nwa	dark
barik farin frans	darling
cheri	darling
tirè	dash
priz	dash
done	data
Dat	date
Diet	date
Pitit fi	daughter
Jou	day
Mouri	dead
dat limit	deadline
soud	deaf
Diil	deal
Kontra	deal
renmen	dear
Chè	dear
Chè tout	Dear All
Chè Kliyan	Dear Customer
Chè paran yo	Dear Parents
Chè Paran	Dear Parents
Chè Mesye	Dear Sir
Chè Sir	Dear Sir
Chè elèv	Dear students
Chè elèv yo	Dear students
Chè ekip	Dear Team
Lanmò	death
Deba	debate
debi	debit
debri	debris
Gyaabij	debris
Dèt	debt
dekad	decade
pouri	decay
pouriti	decay
Ded	deceased
delè	deceased
mouri	deceased
twonpe	deceive
Desanm	december
desandan	decent
desan	decent
Deside	decide
deside	decided
Desizyon	decision
pisin	deck
pil	deck
refize	decline
bès	decline
vini pi piti	decrease
diminye	decrease
dedye	dedicated
ve	dedication
devouman	dedication
papye kay	deed
aksyon	deed
Fon	deep
Deer	deer
sèf	deer
default	default
defèt	defeat
Defann	defend
defini	define
defire	define
definitivman	definitely
definisyon	definition
degre	degree
ret a ret tann	delay
Dilie	delay
reta	delay
an ta	delayed
reta	delayed
efase	delete
debat	deliberate
ekspre	deliberate
delika	delicate
elika	delicate
bon gou	delicious
plezi	delight
kontan	delighted
pran plezi	delighted
delivre	deliver
delivwe	deliver
delivre	delivered
Did diliva	delivered
Akouchman	delivery
livrezon	delivery
demann	demand
mande	demand
Dimaand	demand
eman	demanding
mande	demanding
Demokrasi	democracy
demon	demon
demontre	demonstrate
refize	denied
Did dinai	denied
te demanti	denied
dansite	density
Dantis	dentist
refize	deny
depatman	department
pati	departure
depa	departure
depann	depend
deplwaye	deploy
depo	deposit
Dipazit	deposit
deprime	depressed
Mwen akablé	depressed
tét vid	depression
depresyon	depression
Pwofondè	depth
Dekri	describe
deskripsyon	description
Desert	desert
dezè	desert
merite	deserve
konsepsyon	design
Dizain	design
deziyasyon	designation
Anvi	desire
Dizaiya	desire
dezi	desire
biwo	desk
dezespwa	despair
dezespere	desperate
malgre	despite
desè	dessert
destinasyon	destination
desten	destiny
detwi	destroy
destriksyon	destruction
detay	detail
Detay	details
detekte	detect
Detèminasyon	determination
Detèmine	determine
Detèmine	determined
devaste	devastated
devlope	develop
Did divelop	developed
devlope	developed
devlopman	development
Developman	development
Aparèy	device
dyab	devil
Devl	devil
konsakre	devoted
devwe	devoted
Dhivehi	Dhivehi
dyabèt	diabetes
Gin diare	diarrhea
dyare	diarrhea
Jounal	diary
jounal pèsonèl	diary
diksyonne	dictionary
diksyonè	dictionary
Èske	did
t	did
Mouri	die
Did ded	died
Mouri	died
rejim	diet
Diferans	difference
Difrent	different
Diferan	different
difisil	difficult
fouye	dig
Diyite	dignity
debouya	diligent
manje midi	dinner
dine	dinner
plonje	dip
Dirèk	direct
Direksyon	direction
direktè	director
pousyè	dirt
Sal	dirty
enfim	disable
andikape	disable
andikape	disabled
disparèt	disappear
wont	disappointed
desevwa	disappointed
dezas	disaster
Diskyaad	discard
jete	discard
Pèt	discharge
egzeyat	discharge
disiplin	discipline
rabè	discount
Dekouvri	discover
diskriminasyon	discrimination
Diskite	discuss
diskisyon	discussion
maladi	disease
maladi	diseases
degize	disguise
degoutan	disgusting
plat	dish
asyèt	dishes
rejte	dismiss
ranvwaye	dismiss
èkspédision	dispatch
epatch	dispatch
ekspozisyon	display
espozisyon	display
jete	disposal
diskisyon	dispute
dispit	dispute
distans	distance
disten	distinct
distenk	distinct
distenge	distinguish
alèt	distress
detrès	distress
distribisyon	distribution
Distri	district
enmède	disturb
deranje	disturb
fose	ditch
fouye	ditch
plonje	dive
divès	diverse
divèsite	diversity
divize	divide
Separe	divide
divin	divine
Divòs	divorce
Divuos	divorce
tèt vire	dizzy
Tèt Mwen ap viré	dizzy
fè	do
Èske	do
èske	do you
fè ou	do you
Yu/Yo lob mi?	do you love me
eske ou renmen mwen	do you love me
ou renmen m '	do you love me
doktè	doctor
Dokiman	document
fè	does
Èske	does
pa	doesn't
No du	doesn't
chen	dog
Dogri	Dogri
Chen	Dogri
fè	doing
poupe	doll
Domèn	domain
domestik	domestic
dominan	dominant
pa	don't
Pa enkyete	Don't worry
aladi gate vanyan	Don't worry
donasyon	donate
done	donate
fè	done
bourik	donkey
dwòg	dope
estipefje	dope
Dobl	double
Doub	double
dout	doubt
pat farin	dough
farin	dough
desann	down
Telechaje	download
rale tèt	download
Jraaf	draft
pwojè	draft
bouyon	draft
trennen	drag
drenaj	drain
dram	drama
trase	draw
tiwa	drawer
desen	drawing
dread	dread
pandye	dread
revelasyon	dream
rèv	dream
Jriim	dream
rad	dress
Drill	drill
egzèsis	drill
Jrink	drink
Bwè	drink
kondwi	drive
Chofè	drive
Jrap	drop
gout	drop
gout (noun)	drop
tonbe	dropped
ton deyò	dropped
sechrès	drought
gri kou yon po silabè	drunk
bwè	drunk
Sèk	dry
kanna	duck
kannal	duck
retire	dude
dude	dude
akòz	due
Due	due
akòz	due to
kazwèl	dull
mat	dull
bèbè	dumb
pil fatra	dump
dire	duration
Jurin	during
pandan	during
Pousyè	dust
Devwa	duty
rete	dwell
abitasyon	dwell
lagoni	dying
mouri	dying
chak	each
yon lò	each other
youn ak lòt	each other
enpas	eager
anvi	eager
malfini	eagle
Eagle	eagle
zòrèy	ear
Zorey	ear
pi bonè	earlier
bonè	early
touche	earn
fè lajan	earn
zòrèy	ears
latè	earth
tranbleman tè	earthquake
tranbleman	earthquake
fasilite	ease
alèz	ease
Fasil	easily
Ès	east
lès	east
Fasil	easy
Manje	eat
Manje	eating
ekonomik	economic
ekonomi	economy
kwen	edge
edite	edit
edikasyon	education
efè	effect
efikas	effective
Efektif	effective
efisyans	efficiency
efikasite	efficiency
efikas	efficient
efizak	efficient
Efò	effort
Efuort	effort
ze	egg
Egg	egg
berejenn	eggplant
brenzenglen	eggplant
ego	ego
uit	eight
dizwit	eighteen
Dizuit	eighteen
katreven	eighty
Swa	either
elabore	elaborate
Koud	elbow
ansyen	elder
granmoyin	elder
Granmoun	elderly
granmoun aje	elderly
elegan	elegant
elegant	elegant
eleman	element
elefan	elephant
Onz	eleven
elijib	eligible
elimine	eliminate
Lòt	else
anbarase	embarrassed
jennen	embarrassed
anbarasan	embarrassing
jennen	embarrassing
anbrase	embrace
parèt	emerge
sòti	emerge
Ijans	emergency
emosyonèl	emotional
senpati	empathy
konpasyon	empathy
anfaz	emphasis
mete aksan sou	emphasize
ensfaz	emphasize
anplwaye	employee
Anplwaye	employees
anplwayè	employer
Anplwa	employment
travay	employment
Vid	empty
pèmèt	enable
rankontre	encounter
rankont	encounter
Ankouraje	encourage
Fen	end
an danje	endangered
mete an danje	endangered
fèy	endeavor
jefò	endeavor
andirans	endurance
ezèv	endurance
andire	endure
ipòte	endure
lènmi	enemy
lennmi	enemy
enèji	energy
Angaje	engage
angaje	engaged
angajman	engagement
motè	engine
enjennyè	engineer
enjenyè	engineer
Anglè	English
Angle	English
amelyore	enhance
pran plezi	enjoy
jwi	enjoy
menmen	enormous
ase	enough
Asire	ensure
antre	enter
divètisman	entertainment
amizman	entertainment
antouzyas	enthusiasm
antouzyasm	enthusiasm
antouzyastik	enthusiastic
tout	entire
dwa	entitled
gen dwa	entitled
antite	entity
antre	entrance
antreprenè	entrepreneur
anvlòp	envelope
anviwònman	environment
jalouzi	envy
anvi	envy
sezon	epic
epis	epic
epidemi	epidemic
egal	equal
Ekipman	equipment
ekite	equity
egalite	equity
ekivalan	equivalent
gonm	eraser
epòk	eraser
erè	error
chape	escape
rechap	escape
Sitou	especially
espesyalman	especially
redaksyon	essay
esans	essence
sans	essence
esansyèl	essential
etabli	establish
etabli	established
byen imobilye	estate
imobilye	estate
Estimasyon	estimate
Estimietid	estimated
estime	estimated
evalye	estimated
elatriye	etc
etènèl	eternal
p'ap janm fini	eternal
etik	ethics
evalye	evaluate
evalyasyon	evaluation
menm	even
Siem	even
menm si	even though
aswè	evening
Evenman	event
evènman	event
Evantyèlman	eventually
tout tan	ever
Janm	ever
chak	every
tout moun	everybody
tout moun	everyone
tout bagay	everything
Evidans	evidence
prèv	evidence
sa ki mal	evil
Move	evil
evolisyon	evolution
evolye	evolve
zòrèy	Ewe
Ewe	Ewe
Ansyen	ex
ex	ex
egzak	exact
Egzakteman	exactly
egzamen	exam
egzaminen	examine
Egzamine	examine
Egzanp	example
depase	exceed
ekselan	excellent
trè bon	excellent
Eksepte	except
eksepsyon	exception
depase	excess
anplwaye	excess
twòp	excessive
echanj	exchange
eksite	excited
eksitasyon	excitement
enteresan	exciting
eksitan	exciting
Eksklizif	exclusive
eskize	excuse
eskiz	excuse
Eskize m	excuse me
eskize mwen	excuse me
egzekite	execute
ekzekisyon	execution
egzekitif	executive
Eksersaiz	exercise
egzèsis	exercise
echapman	exhaust
ò kraz	exhaust
fin itilize	exhausted
ò kraz	exhausted
ekspozisyon	exhibit
egzibisyon	exhibit
egzibisyon	exhibition
Egziste	exist
egzistans	existence
egziste	existing
sòti	exit
etann	expand
elaji	expand
atann	expect
Espere	expect
espere	expected
te espere	expected
depans	expenses
Chè	expensive
eksperyans	experience
Ekspiiriens	experience
eksperyans	experiment
esperimante	experiment
spè	expert
ekspè	expert
ekspire	expired
eksprime	expired
eksplike	explain
esplike	explain
eksplikasyon	explanation
esplwate	exploit
eksplore	explore
ekspòtasyon	export
ekspoze	expose
ekspoze	exposed
Ekspozisyon	exposure
ekspoze	exposure
eksprime	express
ekspresyon	expression
Espresyon	expression
lonje	extend
pwolonje	extend
Pwolonje	extended
ekstansyon	extension
limit	extent
ekstèn	external
Eksteryè	external
disparèt	extinct
egstrè	extinct
siplemantè	extra
ekstrè	extract
Ekstraòdinè	extraordinary
Ekstrèm	extreme
ekstrèmman	extremely
trè	extremely
je	eye
je	eyes
Zie Yo	eyes
twal	fabric
Fabulous	fabulous
abondan	fabulous
Figi	face
Fies	face
fasilite	facilitate
enstalasyon	facilities
Lokal	facilities
Plant	facility
Etablisman	facility
Reyalite	fact
Faktè	factor
faktori	factory
fè akonbrisman	facts
reyalite	facts
epafin	fade
fennen	fade
fail	fail
ebli	fail
Fiel	fail
echwe	failed
Did fiel	failed
echèk	failure
endispoze	faint
Mwen indisposé	faint
Fair	fair
Fier	fair
jis	fair
ekirite	fairly
jistis	fairly
jis	fairy
fe	fairy
Faith	faith
lafwa	faith
fidèl	faithful
fè dilatwa	fake
fo	fake
tonbe	fall
Faal	fall
FALSE	false
t'ap nonmen non	fame
t'ap renondi	fame
abitye	familiar
fanmi	family
Grangou	famine
pi popilè	famous
Fan	fan
fanatik	fan
Antilatè	fan
anpenpan	fancy
kokenn	fantastic
loue	far
lwen	far
adieu	farewell
te tonbe	farewell
Fèm	farm
kiltivatè	farmer
Farmer	farmer
kaptivan	fascinating
enteresan	fascinating
mòd	fashion
Fashion	fashion
vit	fast
grès	fat
mòtèl	fatal
fatal	fatal
Desten	fate
sò	fate
Papa	father
fatig	fatigue
fòt	fault
defo	fault
pi renmen	favorite
favè	favour
pi renmen	favourite
Krenn	fear
Fier	fear
pè	fear
fèt	feast
plim	feather
Fiicho	feature
karakteristik	feature
karakteristik yo	features
karakteristik	features
fevriye	february
fed anl	fed up
Bouke	fed up
Frè	fee
bay manje	feed
manje	feed
fidbak	feedback
Feedback	feedback
Fut dem	feel
Santi	feel
Santi	feeling
pye	feet
tonbe	fell
konpay	fellow
parèy	fellow
te santi	felt
Santi	felt
fanm	female
fi	female
Kloti	fence
fètil	fertile
fèt	festival
festival	festival
chèche	fetch
chache	fetch
Fyèv	fever
lafyèv	fever
kèk	few
mwens	fewer
fiyanse	fiance
fiksyon	fiction
jaden	field
Chan	field
fewòs	fierce
feròs	fierce
Kenz	fifteen
Senkant	fifty
Fait	fight
batay	fight
goumen	fight
Goumen	fighting
batay	fighting
Figi	figure
Figa	figure
figi	figure out
evalye	figure out
Ranpli	file
dosye	file
ranpli	fill
plen	filled
Did ful op	filled
Fim	film
sal	filthy
finalman	finally
Finans	finance
Finansye	financial
Jwenn	find
chèche konnen	find out
amann	fine
Fain	fine
Byen	fine
Douèt	finger
dwèt	finger
Fin	finish
fini	finish
Fini	finished
Did finish	finished
dife	fire
Ferm	firm
fèm	firm
antrepriz	firm
Fers	first
Pwemye	first
premye	first
premye non	first name
prenon	first name
Fers niem	first name
Pwason	fish
Anfòm	fit
Senk	five
Ranje	fix
fiks	fixed
Drapo	flag
flach	flash
flash	flash
Flat	flat
plat	flat
defo	flaw
andomaje	flawless
ewo fòt	flawless
kouri	flee
vyann	flesh
chè	flesh
te pran vòl	flew
vwayaje	flew
flechir	flex
fleksib	flex
liksib	flexible
fleksib	flexible
Vòl	flight
baskile	flip
ile	flirt
flirt	flirt
flète	flirting
fleurit	flirting
flote	float
inondasyon	flood
Etaj	floor
farin frans	flour
farin	flour
koule	flow
Fluo	flow
flè	flower
Grip	flu
kouran	fluent
efluan	fluent
Fen	fluently
kouraman	fluently
gonfle	fluffy
likid	fluid
vole	fly
Fwaye	focus
konsantre	focus
Fuokos	focus
bwouya	fog
bwouye	foggy
bwouya	foggy
pliye	fold
rezolisyon	folks
jan	folks
swiv	follow
kontinyete	follow up
swiv	follow up
swiv	following
Manje	food
moun fou	fool
moun sòt	fool
Fuul	fool
moun fou	foolish
sòt	foolish
Pie	foot
pye	foot
foutbòl	football
pou	for
Depi	for
Pa egzanp	For example
Pou egzanp	For example
pou egzanp	for instance
pa egzanp	for instance
pou ou	for you
pou ou menm	for you
entèdi	forbidden
fòs	force
fose	force
pwevwa	forecast
fwon	forehead
fon	forehead
etranje	foreign
Forest	forest
forè	forest
pou tout tan	forever
Toujou	forever
bliye	forget
Faget	forget
padonnen	forgive
Figev	forgive
padone	forgive
bliye	forgot
Faget	forgot
Fork	fork
fouchèt	fork
Fòm	form
Faam	form
fòmèl	formal
Ansyen	former
erezman	fortunately
fòtin	fortune
Karant	forty
karant-de	forty-two
karant de	forty-two
pi devan	forward
Avanse	forward
Foster	foster
adoptif	foster
Did fait	fought
batay	fought
goumen	fought
Jwenn	found
Did fain	found
fondman	foundation
fondasyon	foundation
Kat	four
katòz	fourteen
Fox	fox
rena	fox
frajil	fragile
ankripte	frame
ankadreman	frame
chapèl	framework
fondasyon	framework
Fwod	fraud
frennen	freak
freak	freak
Gratis	free
Libète	freedom
friz	freeze
glase	freeze
frekans	frequency
Fwekans	frequency
souvan	frequent
òdinè	frequent
souvan	frequently
frèch	fresh
fre	fresh
vandredi	friday
Fridge	fridge
frijidè	fridge
Zanmi	friend
amikalman	friendly
zanmitay	friendly
Zanmi	friends
amitye	friendship
pè	frightened
efreye	frightened
pè	frightening
efreye	frightening
krapo	frog
Sòti	from
soti	from
devan	front
jele	frozen
fwi	fruit
Donn	fruit
fristre	frustrated
Gaz	fuel
Fulfulde	Fulfulde
Konplè	Fulfulde
plen	full
plezi	fun
Amizan	fun
fonksyon	function
Fondamantal	fundamental
fineray	funeral
Komik	funny
fouri	fur
pwal	fur
firye	furious
mèb	furniture
pli pli tè	further
pli lwen	further
lòt demode	furthermore
Anplis	furthermore
Pwochen	future
lavni	future
genyen	gain
benefis	gain
Gien	gain
jwèt	game
gap	gap
garaj	garage
cho	garbage
Fatra	garbage
jaden	garden
Garden	garden
lay	garlic
Gate	gate
pòtay	gate
Rasanble	gather
rasanbleman	gathering
kalib	gauge
mezire	gauge
bay	gave
Did giv	gave
Ba	gave
Kovèti pou	gear
angrenaj	gear
sèks	gender
idantite senks	gender
jeneral	general
jeneralman	generally
jenere	generate
jenerasyon	generation
donan	generous
jenere	generous
jeni	genius
genius	genius
genre	genre
janti	gentle
dou	gentle
otantik	genuine
siy	gesture
jès	gesture
Gi-it	get
jwenn	get
abiye	get dressed
leve kanpe	get up
leve	get up
Get op	get up
M swete pou w refè vit	get well soon
jwenn byen byento	get well soon
ap resevwa	getting
Jwenn	getting
fantom	ghost
fnanj	ghost
ghosting	ghosting
flanm dilatwa	ghosting
jeyan	giant
Kado	gift
Jenjanm	ginger
Fi	girl
mennaj	girlfriend
amore	girlfriend
bay	give
Gi	give
ban	give
abandonnen	give up
bay moute	give up
bay	given
kontan	glad
gade	glance
koutje	glance
zenglen	glass
vè	glass
Linèt	glasses
aperçu	glimpse
mondyal	global
glorifye	gloomy
lugubr	gloomy
gan	gloves
klere	glow
lumineux	glow
Gluo	glow
klere	glow up
lumineux moute	glow up
lakòl	glue
Gwaan	go
Ale	go
ale devan	go ahead
ale pi devan	go ahead
Go ahed	go ahead
Al fè wout ou	go away
Go we	go away
ale	go away
Al nan kabann ou	go to bed
ale nan kabann	go to bed
objktif	goal
objektif	goal
objektif	goals
objktif yo	goals
Kabrit	goat
bondye	god
Bondye beni ou	god bless you
Bondye beni w	god bless you
Ale	goes
Pral	going
prale	going
prale	going to
ale	going to
lò	gold
Ale	gone
pral	gonna
prale	gonna
google	goo
goo	goo
N'ap boule	good
Gud	good
bon	good
bon apremidi	good afternoon
Bon aprèmidi	good afternoon
bon bye	good bye
Ba-bai	good bye
Babay	good bye
bonjou	good day
bon jou	good day
Bonswa	good evening
bon aswè	good evening
Bon bagay	good job
bon travay	good job
bèl	good looking
bon kap	good looking
bon chans	good luck
bon maten	good morning
Bonjou	good morning
Maanin	good morning
bon maten renmen mwen	good morning my love
bonjou lanmou mwen	good morning my love
Bòn nui	good night
bon lannwit	good night
Nait nait	good night
M ale	goodbye
orevwa	goodbye
goodnight	goodnight
bòns	goodnight
Byen	goods
machandiz	goods
Google	Google
Google Translate	Google Translate
Google Tradui	Google Translate
zwa	goose
fè renmèd	goose
bèl	gorgeous
supèrb	gorgeous
tripotay	gossip
fè trisi	gossip
te	got
Gen	got
te resevwa li	got it
konprann	got it
Gouvènman	government
gen pwan	grab
pwan	grab
klas	grade
piti piti	gradually
gradye	graduate
diplome	graduate
grenn	grain
sibvansyon	grant
akòde	granted
rezen	grapes
rezen yo	grapes
agrave	grasp
atrab	grasp
zèb	grass
Grass	grass
rekonesan	grateful
rekonesans	gratitude
kavo	grave
Grav	grave
gri	gray
Gwo	great
Gud	great
vòlè	greed
Evaris	greed
vòlè	greedy
visye	greedy
vèt	green
salye	greet
salitasyon	greeting
bonjou	greetings
salitasyon yo	greetings
gri	grey
gwiyay	grid
kadriyaj	grid
chagren	grief
lapenn	grief
moute	grind
moulen	grind
pwiyaj	grip
priz	grip
makèt	grocery
Veterinè cheval	groom
sal de fè	groom
brit	gross
gwòt	gross
tè	ground
Ground	ground
gwoup	group
grandi	grow
Devlope	grow
ogmantasyon	growth
kwasans	growth
mosad	grumpy
grip	grumpy
Guarani	Guarani
Garanti	Guarani
garanti	guarantee
Gad	guard
devine	guess
envite	guest
konsèy	guidance
gid	guide
Gaid	guide
Koupab	guilty
Nèg	guy
mesye	guys
nèg yo	guys
jimnya	gym
jimnastik	gym
abitid	habit
abita	habitat
te	had
lagrèl	hail
cheve	hair
mwatye	half
Demi	half
Hall	hall
sal	hall
men	hand
Min	hand
manch	handle
bèl	handsome
pann	hang
Heng	hang
pann soti	hang out
pandye	hang out
Heng out	hang out
rive	happen
Tek plies	happened
rive	happened
kontantman	happiness
Kontan	happy
kè kontan	happy
Bòn fèt	happy birthday
Appi ert die	happy birthday
kè kontan anivèsè nesans	happy birthday
kè kontan anivèsè nesans ou	happy birthday to you
bon anivesè	happy birthday to you
Bòn Ane	happy new year
bon ane	happy new year
difisil	hard
Di	hard
Haad	hard
prèske pa	hardly
diman	hardly
diman janm	hardly ever
Aadli eva	hardly ever
prèske pa janm	hardly ever
andomaje	harm
mal	harm
Haam	harm
danjere	harmful
Harmony	harmony
amoni	harmony
piman	harsh
piman bouk	harsh
rekòt	harvest
gen	has
genyen	has
rayi	hate
gen	have
genyen	have
Ab	have
pase bon jounen	have a good day
gen yon bon jou	have a good day
Pase yon bon jounen	have a nice day
gen yon jou bèl	have a nice day
pran manje maten	have breakfast
gen manje maten	have breakfast
pran plezi	have fun
Yu/Yo iit yet?	have you eaten
èske ou te manje	have you eaten
gen	having
danje	hazard
brouyar	haze
gwòsè	haze
Li	he
li genyen	he has
li gen	he has
li se	he is
tèt	head
mal tèt	headache
maltèt	headache
riban	heal
geri	heal
gerizon	healing
renmèd	healing
Sante	health
an sante	healthy
Ansante	healthy
tande	hear
tande	heard
kè	heart
chalè	heat
Hiit	heat
syèl	heaven
Lou	heavy
Evi	heavy
wo zo	hectic
ajitasyon	hectic
wotè	height
eritye	heir
rechiya	heist
ègzist	heist
fèt	held
te kenbe	held
lanfè	hell
Bonswa	Hello
Bonjou	Hello
Ai	Hello
alo mwen renmen anpil	hello dear
bonjou chè	hello dear
bonjou kijan ou ye	hello how are you
alo ki jan ou ye	hello how are you
alo ki jan ou ap fè	hello how are you doing
bonjou kijan ou ye	hello how are you doing
kas	helmet
ede	help
Anmwe	help
Elp	help
itil	helpful
kon	hence
pakonsekan	hence
Ii	her
li	her
bann bèt	herd
bèbè	herd
isit	here
Ya	here
eritaj	heritage
ezite	hesitate
Hey	Hey
Hi	Hi
Alo	Hi
alo kijan ou ye	hi how are you
hi kijan ou ye	hi how are you
Hi	Hi there
Alo	Hi there
kache	hidden
kache	hide
Sere	hide
yerachi	hierarchy
Gwo	high
segondè	high
mete aksan sou	highlight
souliye	highlight
vwayaje	hike
pwomnore	hike
monte mòn	hiking
randone	hiking
hilarious	hilarious
Hill	hill
l	him
Ii	him
allusion	hint
sijesyon	hint
ranch	hip
anch	hip
ranch	hips
ranch yo	hips
anboche	hire
anplwaye	hire
anbochaj	hiring
Ii	his
li	his
istwa	history
frape	hit
Hmm	Hmm
plezi	hobby
Hobi	hobby
pastan	hobby
kenbe	hold
kenbe	hold on
Kanpe la	hold on
twou	hole
Tou	hole
Holiday	holiday
jou ferye	holiday
kre	hollow
Hollow	hollow
lakay	home
Uomwok	homework
Devwa	homework
onèt	honest
onètman	honestly
Siwo myèl	Honey
onè	honor
kapòt	hood
kapo	hood
zen	hook
kwòk	hook
espere	hop
hop	hop
Ap	hop
espere	hope
Hope	hope
Uop	hope
èspere	hopefully
èspere ke	hopefully
san espwa	hopeless
dezespere	hopeless
kouche	horizontal
orizontal	horizontal
klaksonn	horn
kòn	horn
tèrib	horrible
terib	horrible
laterè	horror
chwal	horse
Lopital	hospital
Aspital	hospital
Ospitalite	hospitality
Huos	host
animatè	host
ostil	hostile
cho	hot
Mwen cho	hot
At	hot
otèl	hotel
Lè	hour
èdtan	hour
èdtan	hours
Kay	house
mezon retrèt	household
Kay	household
kijan	how
Kouman sou ou	how about you
e ou menm	how about you
Ou yo du?	how are you
kijan ou ye	how are you
Komon ou ye	how are you
Ou yo du?	how are you doing
ki jan ou ap fè	how are you doing
Kòman w ye	how are you doing
ki jan ou ap fè jodi a	how are you doing today
Wa gwaan tude/tide?	how are you doing today
kijan w ap fè jodi a	how are you doing today
ki jan ou ye jodi a	how are you today
kijan ou ye jodi a	how are you today
Waa gwaan tude/tide?	how are you today
ki jan ou fè	how do you do
kouman ou ye	how do you do
kouman se	how is
konbyen	how many
Konben	how many
konbyen	how much
Konben	how much
konbyen fwa	how often
Ki laj ou	how old are you
Yu/Yo a uu'moch?	how old are you
ki laj ou ye	how old are you
Kòman w pase jounen an	how was your day
ki jan yo te jou ou	how was your day
ki jan yo te lannwit ou	how was your night
kouman nuit ou te ye	how was your night
Sepandan	however
mwaye	hub
bonom	hubby
imilye	hubby
anbrase	hug
Hog	hug
akolad	hug
gwan	huge
gwo	huge
Imen	human
enb	humble
Ombl	humble
imilye	humble
imid	humid
imidite	humidity
san	hundred
grangou	hungry
Mwen grangou	hungry
lachas	hunt
siklòn	hurricane
Orikien	hurricane
Prese prese	hurry
Ori	hurry
prese	hurry
Ori op	hurry up
Fè vit	hurry up
prese moute	hurry up
Mal	hurt
fè mal	hurt
mari	husband
Hosl	hustle
ajitasyon	hustle
kabann	hut
joupa	hut
Ijyèn	hygiene
MWEN	I
Mwen	I am
Mwen byen	I am fine
Mwen amann	I am fine
Mwen kapab	I can
Mwen pa kapab	I can't
Wi mwen vle	I do
Mwen fè	I do
Mwen pa konnen	I do not know
Mwen pa konprann	I do not understand
Mwen pat fè sa	I don't
Mwen pa	I don't
I duo nuo	I don't know
Mwen pa konnen	I don't know
Mwen pa konprann	I don't understand
Mi no get ih	I don't understand
m pa konprann sa w vle di a	I don't understand what you mean
Mwen pa konprann sa ou vle di	I don't understand what you mean
Mi no get yu/yo	I don't understand what you mean
m pa konprann ou	I don't understand you
Mwen pa konprann ou	I don't understand you
Mi no nuo	I don’t know
Mwen pa konnen	I don’t know
Mwen pa konprann	I don’t understand
mwen devine	i guess
Mwen panse	i guess
mwen te genyen	I had
Mwen te gen	I had
Mwen gen	I have
Mouin	I have
Mwen te	I have been
Mwen espere sa	I hope so
Mwen konnen	I know
Mwen renmen	I like
Mwen renmen w	I like you
Mwen renmen ou	I like you
Mwen renmen	I love
Mi lob	I love
m renmen gwo frè m nan	I love my big brother
Mwen renmen gwo frè mwen an	I love my big brother
Mi lob mi big breda	I love my big brother
Mwen renmen gwo sè m '	I love my big sister
mwen renmen gwo sè m nan	I love my big sister
Mi lob mi big sista	I love my big sister
Mi lob mi pupa/pa/dadi	I love my father
Mwen renmen papa m	I love my father
m renmen ti frè m nan	I love my little brother
Mi lob mi likkl breda	I love my little brother
Mwen renmen ti frè mwen an	I love my little brother
Mi lov mi likkl sista	I love my little sister
Mwen renmen ti sè mwen an	I love my little sister
mwen renmen ti sè m nan	I love my little sister
Mwen renmen manman m	I love my mother
Mi lob mi muma/ma/mada	I love my mother
Mi lov yo	I love you
Mwen renmen w	I love you
Mwen renmen ou	I love you
Mwen renmen ou anpil	I love you so much
Mwen renmen w tou	I love you too
Mwen renmen ou tou	I love you too
Mwen vle di	I mean
Mi lang fi sii yu/yo	I miss you
Mwen manke ou	I miss you
Mwen sonje w	I miss you
Mwen manke ou anpil	I miss you so much
Mwen sonje ou anpil	I miss you so much
Mwen wè	I see
Mwen konprann	I see
Mwen panse	I think
Mwen konprann	I understand
M vle	I want
Mwen vle	I want
Mwen vle wè ou	I want to see you
Mi waahn yu/yo	I want you
Mwen vle w	I want you
Mwen vle ou	I want you
Mwen te	I was
Mwen pral	I will
Mwen prale	I will
Mwen ta dwe	I would be
Mwen ta pwal	I would be
Mwen	I'm
Mwen se	I'm
m anfavè	I'm fine
Mwen amann	I'm fine
m bon	I'm good
Mwen bon	I'm good
Mwen isit la	I'm here
Mwen regrèt	I'm sorry
Mwen regret sa	I'm sorry
Glas	ice
krèm (glase)	ice cream
krèm glase	ice cream
Lide	idea
ideyal	ideal
idantik	identical
Idantifye	identify
idantite	identity
Egare	idiot
idiot	idiot
flannen	idle
san fè anyen konsa	idle
si	if
inyore	ignore
pa okipe	ignore
malad	ill
Ilegal	illegal
maladi	illness
Ilocano	Ilocano
Ilokano	Ilocano
Imaj	image
imajinen	imagine
imajine	imagine
imedya	immediate
imedyat	immediate
Imedyatman	immediately
imans	immense
gwo anpil	immense
enpak	impact
npak	impact
Impak	impact
enpasyan	impatient
npasyan	impatient
aplike	implement
enpòte	import
Impuot	import
Enpòtan	important
enpoze	impose
enposib	impossible
enpresyone	impress
enpresyon	impression
enpresyonan	impressive
Amelyore	improve
Amelyorasyon	improvement
Iin	in
nan	in
epi tou	in addition
Anplis de sa	in addition
An reyalite	In fact
nan devan	in front of
anfas	in front of
yo nan lòd yo	in order to
nan lòd a	in order to
apwopriye	inappropriate
pa apwopriye	inappropriate
ankourajman	incentive
ensidan	incident
enkli	include
Enkli	including
Revni	income
deranjman	inconvenience
ogmante	increase
Ogmantasyon	increase
Inkriis	increase
ogmante	increased
enkwayab	incredible
annefè	indeed
Endepandan	independent
peyi Zend	India
endike	indicate
endijèn	indigenous
Endividyèl	individual
Endistri	industry
inevitab	inevitable
tibebe	infant
Enfeksyon	infection
enfinite	infinity
Infinity	infinity
Enflamasyon	inflammation
enflasyon	inflation
enfliyans	influence
Influens	influence
enfòme	inform
enfòmasyon	information
engredyan	ingredients
engredyan yo	ingredients
eritaj	inheritance
pòsyon	inheritance
Inisyal	initial
inisyativ	initiative
Blese	injured
blesi (noun)	injury
aksidan	injury
Inosan	innocent
inovasyon	innovation
rechèch	inquiry
ankèt	inquiry
fou	insane
ti bèt	insect
ensèk	insect
a anlè pa atè	insecure
anksyeu	insecure
nklizyon	insert
insert	insert
Anndan	inside
andedan	inside
insight	insight
ensiste	insist
lensomni	insomnia
oun ki gen pwoblèm dòmi	insomnia
enspirasyon	inspiration
enspire	inspire
enstale	install
egzanp	instance
enstantane	instant
olye	instead
piske	instead
olye pou yo	instead of
enstriksyon	instructions
enstriksyon yo	instructions
enstriman	instrument
joure	insult
ensilt	insult
asirans	insurance
entak	intact
leve	intact
Entegrite	integrity
entelektyèl	intellectual
entèlijans	intelligence
entelijan	intelligent
gen ltansyon	intend
gen entansyon	intend
gen lòd	intended
entansyon	intended
entans	intense
entansyon	intention
kominike	interact
interagir	interact
entèraksyon	interaction
enterè	interest
enterese	interested
te entèrese	interested
enteresan	interesting
entèfere	interfere
entèmedyè	intermediate
entèn	internal
Entènasyonal	international
estaj	internship
entèprete	interpret
ntèprete	interpret
entèprèt	interpreter
entèwonp	interrupt
koupe	interrupt
Entèvyou	interview
entim	intimate
nan	into
prezante	introduce
entwodiksyon	introduction
Entodiksyon	introduction
pentris	introvert
entrovèrti	introvert
entwisyon	intuition
zendik	intuition
valab	invalid
envalid	invalid
envante	invent
envantè	inventory
envesti	invest
envestige	investigate
envitasyon	invitation
envite	invite
fakti	invoice
Invais	invoice
enplike	involve
patisipe	involve
Enplike	involved
fè	iron
Iron	iron
Aiyan	iron
Se	is
zile	island
Island	island
izole	isolated
pwoblèm	issue
Issyu	issue
kesyon	issue
pwoblèm	issues
pwoblèm yo	issues
Li	it
li se	it is
se li	it is
li te	it was
se te	it was
se	it's
li	it's
li ok	it's ok
li pa pi mal	it's ok
Li nan oke	It's okay
Li oke	It's okay
atik	item
Atik	items
li	its
pou Ii	its
Mwen	I’m
Mwen se	I’m
levit	jacket
blouz	jacket
prizon	jail
Jamayiken kreyòl angle	Jamaican Creole English
janvye	January
bokal	jar
.jar	jar
machwè	jaw
jalouzi	jealous
jalou	jealous
sakrye	jerk
embesil	jerk
Bijou	jewelry
Travay	job
djògin	jogging
rankontre	join
rantre	join
Antrepriz	joint
jwenti	joint
blag	joke
bay blag	joke
Jounalis	journalist
vwayaj	journey
Joy	joy
kè kontan	joy
Joj	judge
Jij	judge
Dijesyon	juice
ji	juice
Jiyè	july
so	jump
grate	jump
jen	june
tenten	junk
tenk	junk
Jis	just
Jos	just
jis fè li	just do it
Jistis	justice
jistifye	justify
Kalaallisut	Kalaallisut
pike	keen
kenbe	keep
Kiip	keep
kenbe l	keep it up
kenbe li	keep it up
Kip op	keep it up
kenbe	kept
te kenbe	kept
Kettle	kettle
chodwon	kettle
kle	key
.key	key
choute	kick
kout pye	kick
jenn ti kabrit	kid
Pete	kid
kidding	kidding
jwe	kidding
Ren	kidney
Timoun	kids
touye	kill
kalite	kind
Kain	kind
kinda	kinda
yon jan	kinda
byenveni	kindly
jantiyès	kindly
bonkè	kindness
jantiyès	kindness
wa	king
rwa	king
bo	kiss
kwizin	kitchen
kite	kite
kap	kite
ti chat	kitten
jenou	knee
te konn	knew
konnen	knew
Kouto	knife
aswè a	knight
Knight	knight
konnen	know
konesans	knowledge
li te ye	known
Konnen	known
Konkani	Konkani
Krio	Krio
Liebl	label
etikèt	label
Travayè	labor
travay	labor
travay	labour
Manke	lack
mank	lack
nechèl	ladder
Dam	lady
Did lie	laid
mete	laid
lak	lake
Lake	lake
mouton	lamb
ti mouton	lamb
bwate	lame
bwete	lame
Lanp	lamp
Tè	land
peyi	land
Lam	land
jaden flè	landscape
Landscape	landscape
Lang	language
Wis	lap
labrim	lap
Laj	large
gwo	large
Dènye	last
dènye men pa pi piti	last but not least
Pa bliye mesaj ki pi enpòtan an	last but not least
iyati	last name
dènye non	last name
Ta	late
anreta	late
dènyèman	lately
pita	later
dènye	latest
lèt	latter
ri	laugh
ri	laughing
ri	laughter
lanse	launch
leswa	laundry
Lesiv	laundry
Lwa	law
lalwa	law
Lawn	lawn
gazon	lawn
avoka	lawyer
kouche	lay
kouch	layer
kouche	layout
Layout	layout
parese	lazy
Mennen	lead
plon	lead
lidè	leader
fèy	leaf
Leaf	leaf
koule	leak
Leak	leak
Panche	lean
mèg	lean
leve	leap
leap	leap
Aprann	learn
Laan	learn
Aprann	learning
kontra-lwaye	lease
lwaye	lease
pi piti	least
mwens	least
kwi	leather
Liiv	leave
kite	leave
fèy	leaves
abandone	leaves
dirije	led
kite	left
Goch	left
Janm	leg
eritaj	legacy
legal	legal
lejand	legend
lejann	legend
legité	legit
legi	legit
lwazi	leisure
prete	lend
longè	length
Mwens	less
leson	lesson
kite	let
Lèt	letter
leti	lettuce
Nivo	level
Lebl	level
ogmante	leverage
responsablite	liability
bibliyotèk	library
libreri	library
bwat	lick
niche	lick
Lai	lie
Kouche	lie
manti	lie
manti	lies
Lavi	life
Lif	lift
leve	lift
Lait	light
Limyè	light
zèklè	lightning
zeklè	lightning
renmen	like
gen anpil chans	likely
chans	likely
menm jan an tou	likewise
menm jan	likewise
Liy	line
Lengala	Lingala
Lingala	Lingala
lyen	link
lyon	lion
Likid	liquid
lis	list
Lisen	listen
koute	listen
tande	listening
koute	listening
literalman	literally
literati	literature
fatra	litter
lit	litter
Ti	little
Liv	live
Viv	live
Fwa	liver
lavi	lives
Viv	lives
Viv	living
k ap viv	living
Libing	living
salon	living room
chanm k ap viv	living room
zandolit	lizard
Lizaz	lizard
danje	lizard
mete abo	load
chaj	load
flannen	loaf
pen	loaf
prè	loan
Lokal	local
kote	location
fèmen	lock
Vewouyaj	lockdown
verouyaj	lockdown
.log	log
Log	log
ri pou tout moun tande	lol
lol	lol
lonely	lonely
chagren	lonely
Tan	long
lontan	long
bon bout tan pa wè	long time no see
Lontan pa wè ou	long time no see
gade	look
Luk	look
riban	loop
dekole	loose
lach	loose
Luus	loose
Seyè	lord
Mèt	lord
pèdi	lose
Pèdi	loss
pèt	loss
pèdi	lost
Anpil	lot
byen fò	loud
fò	loud
sal rebò	lounge
sal	lounge
renmen	love
Lov	love
Lanmou	love
renmen ou	love you
bèl	lovely
ba	low
basen	low
pi ba	lower
Lower	lower
Fidèl	loyal
lwayote	loyalty
Chans	luck
chans	lucky
Luganda	Luganda
bagaj	luggage
Boul	lump
fèt yon sèl kou	lump
manje midi	lunch
poumon	lungs
liksye	luxury
bay manti	lying
ouche	lying
machin	machine
oblije	machine
fache	mad
Madanm	madam
madame	madam
fè	made
peryodik	magazine
magazin	magazine
manyifik	magnificent
manyif	magnificent
sèvant	maid
restavèk	maid
Pwensipal	main
prensipal	main
kenbe	maintain
Antretyen	maintenance
Maithili	Maithili
Gwo	major
Mieja	major
majorite	majority
fè	make
monte	make up
fè moute	make up
gason	male
sant komèsyal	mall
Mall	mall
Moun	man
nonm	man
jere	manage
Dirije	manage
Jesyon	management
manadjè	manager
Direktè	manager
obligasyon	mandatory
obligatwa	mandatory
manifeste	manifest
kontwole	manipulate
manipile	manipulate
Fason	manner
mannyè	manner
manyèl	manual
Anpil	many
anpil anpil retounen kè kontan nan jounen an	many many happy returns of the day
anpil retounen nan jounen an	many many happy returns of the day
mach	march
Mas	march
magin	margin
Marge	margin
mache	market
maryaj	marriage
marye	married
mask	mask
Mas	mask
Mas	mass
masiv	massive
metrize	master
mèt	master
Mach	match
matche	match
koresponn	match
konpayon	mate
mate	mate
materyèl	material
matematik	math
Pwoblèm	matter
matyè	matter
Mata	matter
ebli	maturity
matirite	maturity
Me	may
ka	may
Mie	may
petèt	maybe
mwen	me
m	me
m 'tou	me too
mwen menm tou	me too
repa	meal
Manje	meal
vle di	mean
Miin	mean
siyifikasyon	meaning
vle di	means
Mwayen	means
vle di	meant
siyifi	meant
Did miin	meant
pandan se tan	meanwhile
alatandan	meanwhile
Mezi	measure
mezire	measure
Mezi	measures
vyann	meat
Medikal	medical
Medikaman	medicine
meditasyon	meditation
mwayen	medium
rankontre	meet
Miit	meet
reyinyon	meeting
mèy	Meiteilon
Meiteilon	Meiteilon
fonn	melt
souvren	memories
memwa	memories
memwa	memory
mantal	mental
mansyone	mention
Did menshan	mentioned
mansyone	mentioned
konseye	mentor
komèsan	merchant
mizèrikòd	mercy
pitye	mercy
senpleman	merely
Jwaye Nwèl	merry christmas
dezòd	mess
mesaj	message
dezòd	messy
sal	messy
metal	metal
Metòd	method
sourit	mice
souri	mice
Midl	middle
mitan	middle
Mwayen	middle
minwi	midnight
minui	midnight
Ka	might
ta ka	might
pa grav	mild
modere	mild
etap	milestone
etap enpòtan	milestone
militè	military
Lèt	milk
milyon	million
lespri	mind
lide	mind
Main	mind
attitude	mindset
atitid	mindset
mwen	mine
min	mine
Main	mine
melanje	mingle
minè	minor
Minit	minute
minit	minutes
Mirak	miracle
glas	mirror
Iwa	mirror
move zo	miscellaneous
divès	miscellaneous
malfezans	mischievous
malveyan	mischievous
mizab	miserable
mizerab	miserable
Mizè	misery
manke	miss
Sonje	miss
sonje ou	miss you
manke ou	miss you
disparèt	missing
manke	missing
misyon, Misyon	mission
farin frans	mist
brouyar	mist
erè	mistake
Mizo	Mizo
mobil	mobile
mock	mock
moke	mock
modèl	model
Maderet	moderate
modere	moderate
modèn	modern
a la mòd	modern
modès	modest
imid	moist
mikte	moist
imidite	moisture
midite	moisture
mwazi	mold
kanmenm	mold
Muol	mold
mol	mole
boutik	mole
manman	mom
Mum	mom
moman	moment
lendi	monday
Lajan	money
kontwole	monitor
makak	monkey
mwa	month
atitid	mood
Moody	moody
atitid	moody
lalin	moon
moral	moral
Plis	more
anplis	moreover
maten	morning
Ipotèk	mortgage
Pifò	most
sitou	mostly
manman	mother
Mosyon	motion
mouvman	motion
motivasyon	motivation
mòn	mountain
Mountain	mountain
sourit	mouse
Bouch	mouth
deplase	move
Fe mouvman	move
Mouvman	movement
Fim	movie
madan	mrs
mrs	mrs
Anpil	much
labou	mud
tas	mug
labouyi	mug
Misk	muscle
mize	museum
djondjon	mushroom
Mizik	music
Mos	must
Dwe	must
bèbè	mute
Mityèl	mutual
mwen	my
Cheri	My dear
Mwen renmen anpil	My dear
zanmi m '	my friend
zanmi mwen	my friend
Hovercraft mwen an se tout anguilles	My hovercraft is full of eels
Hovercraft mwen plen ak zanj	My hovercraft is full of eels
cheri	my love
renmen mwen	my love
Fi mi lob	my love
M'rele	my name is
non mwen se	my name is
plezi m '	my pleasure
se plezi mwen	my pleasure
mwenmenm	myself
tèt mwen	myself
misterye	mysterious
mistè	mystery
mit	myth
klou	nail
nayis	naive
nayif	naive
non	name
fe-apel	name
naratif	narrative
etwat	narrow
anbarasan	nasty
dezagreyab	nasty
nasyonal	national
nasyonalite	nationality
Natifnatal	native
natirèl	natural
lanati	nature
nati	nature
Anvi vomi	nausea
noze	nausea
tou pre	near
toupre	near
tou pre	nearby
toupre	nearby
Prè	nearly
prèske	nearly
nèt	neat
pwòp	neat
Nesesè	necessary
kou	neck
kolye	necklace
niid	need
Beouin	need
bezwen	need
Negatif	negative
neglijans	neglect
eglijans	neglect
negosye	negotiate
vwazen	neighbor
katye	neighborhood
ni	neither
neve	nephew
eve	nephew
òdinè	nerd
nèrd	nerd
Mwen enèvé	nervous
nève	nervous
nich	nest
nèt	net
filè	net
Rezo	network
net	neutral
pa janm	never
Janm	never
pa janm abandonnen	never give up
pa janm bay moute	never give up
pa janm lide	never mind
Ou mèt bay sa vag	never mind
nevermind	nevermind
pa janm bliye	nevermind
kanmenm	nevertheless
nouvo	new
New	new
Nouvèl	news
Pwochen	next
akote	next to
pwochen	next to
Bon	nice
bèl	nice
Mwen kontan fè konesans ou	nice to meet you
Glad fi si yu/yo	nice to meet you
bèl al kontre ou	nice to meet you
yès	niece
nyès	niece
lannwit	night
Aswè	night
kochma	nightmare
move rèv	nightmare
nèf	nine
diznèf	nineteen
Disnèf	nineteen
Katrevendis	ninety
Non	No
Pa	No
Pa gen pwoblem	no problem
pa gen okenn pwoblèm	no problem
janme	no way
okenn fason	no way
pèsonn	nobody
bri	noise
bri	noisy
bwi	noisy
pa gen pyès	none
okenn	none
midi	noon
nope	nope
non	nope
ni	nor
Nòmal	normal
nò	north
Nin	nose
nen	nose
nostaljik	nostalgic
Nostalgic	nostalgic
pa	not
pa nan tout	not at all
pa ditou	not at all
pa mal	not bad
pa move	not bad
Pa kounye a	Not now
Pa kounye-a	Not now
poko	not yet
pa ankò	not yet
nòt	note
te note	noted
note	noted
Anyen	nothing
avi	notice
notis	notice
remake	noticed
Noun	noun
nouns	nouns
non	nouns
roman	novel
Novanm	november
Kounye-a	now
kounye	now
sèjèt	nowadays
sèjousi	nowadays
nwuizans	nuisance
anmègdan	nuisance
nil	null
Li mò	numb
angoudi	numb
Nimewo	number
enfimyè	nurse
Mis	nurse
nwa	nut
ntmèg	nutmeg
noutmèg	nutmeg
ti ponyen	nutrition
nitrisyon	nutrition
sèman	oath
obezite	obesity
obeyi	obey
objè	object
objektif	objective
obligasyon	obligation
fènwa	obscure
obscures	obscure
obsèvasyon	observation
obsève	observe
obsede	obsessed
mani	obsession
bsesyon	obsession
demode	obsolete
obstak	obstacle
Jwenn	obtain
jwenn	obtained
evidan	obvious
evidamman	obviously
detanzantan	occasionally
okipasyon	occupation
Metye	occupation
te okipe	occupied
okipe	occupied
rive	occur
fèt	occurred
te rive	occurred
Did aker	occurred
rive	occurs
Ocean	ocean
oseyan	ocean
Oktòb	october
enpè	odd
chans	odds
enpèmeyab	odds
de	of
Of	of
nan	of
natirèlman	of course
nan kou	of course
koupe	off
etire	off
ofansif	offensive
ofri	offer
Afa	offer
biwo	office
ofisyèl	official
souvan	often
Oh	Oh
O	Oh
oh vrèman	oh really
oh reyèlman	oh really
Lwil	oil
Oke	ok
ok	ok
ok mwen renmen	ok dear
chè dèyè	ok dear
ok siwo myèl	ok honey
dèyè siwo myèl	ok honey
ok cheri	ok my love
ok renmen mwen	ok my love
oke	okay
oke ti bebe	okay baby
oke mwen renmen anpil	okay dear
oke chè	okay dear
oke siwo myèl	okay honey
oke renmen mwen	okay my love
oke lanmou mwen	okay my love
OK mi lob	okay my love
fin vye granmoun	old
Ansyen	old
Sou	on
De pan	on
yon fwa	once
En	one
youn	one
yon lang pa janm ase	one language is never enough
yon sèl lang pa janm ase	one language is never enough
zonyon	onion
sou entènèt	online
Sèlman	only
Louvri	open
Operasyon	operation
Opinyon	opinion
opòtinite	opportunities
opòtinite	opportunity
Opoze	opposite
optimis	optimistic
opsyon	option
si ou ousyonèl	optional
opsyonèl	optional
Oubyen	or
oswa	or
Arinj	orange
zoranj	orange
Orange	orange
Lòd	order
Aada	order
Òdinè	ordinary
Òganizasyon	organization
oryantasyon	orientation
annal/lèt	orientation
orijin	origin
Orijinal	original
Oromo	Oromo
of ofans	orphan
òfelen	orphan
Lòt	other
sinon	otherwise
otreman	otherwise
ta dwe	ought
dwe	ought
nou	our
Misyon nou: pou pèmèt tout moun, tout kote konprann mond lan epi eksprime tèt yo atravè lang yo., Misyon nou: pou pèmèt tout moun, toupatou pou konprann mond lan epi eksprime tèt yo atravè lang.	Our mission: to enable everyone, everywhere to understand the world and express themselves across languages.
Misyon nou: òganize enfòmasyon nan mond lan epi fè li inivèsèl aksesib ak itil., Misyon nou: òganize enfòmasyon nan mond lan epi fè li inivèsèl aksesib ak itil.	Our mission: to organize the world's information and make it universally accessible and useful.
deyò	out
rezilta	outcome
tenyen	outfit
ekipe	outfit
sòti	outgoing
sortan	outgoing
priz	outlet
deskripsyon	outline
dekri	outline
andeyò	outside
deyò	outside
eksepsyonèl	outstanding
fou	oven
Sou	over
sou la	over there
laba a	over there
jeneral	overall
an jeneral	overall
simonte	overcome
ranvèse	overthinking
overthinking	overthinking
akable	overwhelmed
nkontwolab	overwhelmed
akablan	overwhelming
nkontwolab	overwhelming
akòde	owe
dwe	owe
chwèt	owl
bèf	owl
Uon	own
pwòp	own
posede	own
Mèt	owner
bèf	ox
mach	pace
pasèl	pace
pake	pack
pake	package
Peye	paid
doulè	pain
penti	paint
pentire	paint
penti	painting
pè	pair
pal	pale
blaze	pale
Palm	palm
palmis	palm
kastwòf	pan
chodyè	pan
Pandemi	pandemic
panike	panic
panik	panic
Pantalon	pants
Papye	paper
Paradise	paradise
paradi	paradise
paralèl	parallel
pasèl	parcel
palè	parcel
padonnen	pardon
paran	parents
Park	park
pak	park
jako	parrot
dominasyon	parrot
pèsi	parsley
.part	part
pati	part
Patisipe	participate
patikilye	particular
Patikilyè	particular
patikilyèman	particularly
patnè	partner
pati	party
Pase	pass
Pasaj	passage
Pase	passed
Did paas	passed
pasyon	passion
pasyone	passionate
pasif	passive
Paaswod	password
modpas	password
Pase	past
sot pase	past
pansman	patch
patch	patch
chemen	path
wòch	path
patikilye	pathetic
pathetic	pathetic
Pasyans	patience
Pieshent	patient
Malad	patient
pasyan	patient
modèl	pattern
poz	pause
poze	pause
afriken	pavement
pave	pavement
Peye	pay
Peman	payment
lapè	peace
lapè	peaceful
Pasifik	peaceful
pèch	peach
pik	peak
pwa	pear
pwa	peas
spesyalis	peculiar
spesifik	peculiar
ipòtan	pee
pipi	pee
Pii	pee
kale	peel
kanmarad	peer
kamarad klas yo	peers
kamarad	peers
Fren dem	peers
Plim	pen
kreyon	pencil
annatant	pending
anbans	pending
moun	people
pwav	pepper
wè	perceive
pèsekisyon	perceive
pèsepsyon	perception
pafè	perfect
fè	perform
akonpli	perform
Pèfòmans	performance
petèt	perhaps
peryòd	period
pèmanan	permanent
pèmisyon, Pèmisyon	permission
pèmi	permit
pèmèt	permit
pèseverans	perseverance
pèsistan	persistent
moun	person
Sumadi	person
pèsonèl	personal
pèsonalite	personality
pèspektiv	perspective
konvenk	persuade
pèsuade	persuade
pervert	pervert
pèvèti	pervert
bèt kay	pet
bèt	pet
faz	phase
fenomèn	phenomenon
Filozofi	philosophy
Telefòn	phone
foto	photo
fraz	phrase
Fizik	physical
chwazi	pick
ranmase	pick
ranmase	pick up
foto	picture
moso	piece
Pyès	piece
moso	pieces
kochon	pig
pijon	pigeon
pil	pile
Zòrye	pillow
Pilòt	pilot
zepeng	pin
PIN	pin
anana	pineapple
woz	pink
wòz	pink
twou	pit
anplasman	pitch
Lapenn	pity
pitye	pity
kote	place
Plies	place
Plas	place
kote	places
epidemi	plague
Pès / flewo	plague
Plain	plain
plenn	plain
plan	plan
planifye	plan
avyon	plane
plant	plant
plante	plant
plant	plants
plant yo	plants
plak	plate
platfòm	platform
Plie	play
jwe	play
jwe	playing
Pleasant	pleasant
Souple	please
tanpri	please
Pliiz	please
kontan	pleased
plezi	pleasure
angajman	pledge
pwomès	pledge
Anpil	plenty
konplote	plot
trase	plot
ploge	plug
lòg	plug
prin	plum
Plum	plum
bòs plonbye	plumber
plonbye	plumber
pliryèl	plural
podcast	podcast
powèm	poem
pwezi	poetry
pwen	point
Point	point
pwazon	poison
npwazonnen	poison
lapolis	police
Polis	police
Politik	policy
politès	polite
polisyon	pollution
olisyon	pollution
letan	pond
Ma dlo	pond
pisin	pool
poop	poop
tata	poop
pòv	poor
pòp	pop
kola	pop
popilè	popular
popilasyon	population
vyann kochon	pork
kochon	pork
labouyl	porridge
Port	port
pò	port
Pozisyon	position
pozitif	positive
poses	possess
posede	possess
posesyon	possession
byen	possession
posesif	possessive
Posib	possible
Puos	post
pòs	post
poste	post
ranvwaye	postpone
pòmdetè	potato
potansyèl	potential
liv	pound
Pound	pound
povrete	poverty
pouvwa	power
pwisan	powerful
pratik	practical
pratik	practice
Praktis	practice
pratike	practice
lwanj	praise
louwe	praise
tour	prank
pran	prank
priye	pray
presye	precious
egzak	precise
jisteman	precisely
predi	predict
pi pitye	prefer
pito	prefer
preferans	preference
Ansent	pregnant
prejije	prejudice
premis	premises
lokal	premises
prim	premium
preparasyon	preparation
prepare	prepare
Pwepare	prepare
prepare	prepared
prepozisyon	preposition
prezans	presence
Pwezans	presence
prezan	present
prezantasyon	presentation
Prezève	preserve
Pwezidan	president
prezidan	president
Près	press
laprès	press
Pres	press
presyon	pressure
pretann	pretend
pran souse	pretend
Priti	pretty
bèl	pretty
Anpeche	prevent
Ansyen	previous
anvan	previous
bèl	prey
proie	prey
pri	price
lògèy	pride
fyète	pride
prèt	priest
Pwensipal	primary
prensipal	primary
Pwemye	prime
Princess	princess
prensès	princess
direktè	principal
anvan	prior
priyorite	priority
prizon	prison
sou zavi vwal	privacy
vi prive	privacy
Pwive	private
prive	private
privilèj	privilege
pwi	prize
prim	prize
Pwobableman	probably
pwoblèm	problem
pwosedi	procedure
kontinye	proceed
pwosesis	process
Proces	process
Pwodwi	produce
Pwodwi	product
pwodiksyon	production
pwofesyon	profession
pwofesyonèl	professional
pwofil	profile
wofil	profile
pwofi	profit
pwofon	profound
byen fon	profound
Progres	progress
Pwogrè	progress
pwojè	project
repanti	prominent
enpòtan	prominent
Promès	promise
pwomès	promise
Pramis	promise
ankouraje	promote
pwomosyon	promotion
pouse	prompt
Èd Memwa	prompt
gende	prone
tendans	prone
pwonon	pronouns
prononsyasyon	pronunciation
pwononsyasyon	pronunciation
prèv	proof
apwopriye	proper
byen	properly
pwopriyete yo	properties
pwopriyete	properties
Pwopriyete	property
Pwopozisyon	proposal
pwospè	prospect
Prospect	prospect
pwosperite	prosperity
gremesi	prosperous
Pwoteje	protect
fyè	proud
pwouve	prove
bay	provide
Pripier	provide
bay	provided
pwovens	province
dispozisyon	provision
Pwovizyon	provision
pibète	puberty
Pyuuberti	puberty
plim	puberty
Piblik	public
rale	pull
komèsyal	pumpkin
joumou	pumpkin
ponktualite	punctual
ponktyèl	punctual
elèv	pupil
grenn je	pupil
acha	purchase
achte	purchase
pure	pure
pi	pure
koulè wouj violèt	purple
vyòl	purple
Rezon	purpose
objektif	purpose
pouswiv	purse
valiz	purse
pouswiv	pursue
pouswit	pursuit
pouse	push
Mete	put
kalifikasyon	qualification
kalite	quality
kantite	quantity
Karantèn	quarantine
batay	quarrel
kont	quarrel
Kwaaril	quarrel
Sezon	quarter
trimès	quarter
Quechua	Quechua
rèn	queen
larenn	queen
queer	queer
rechèch	query
requête	query
Kesyon	question
keu	queue
kyuu	queue
rapid	quick
byen vit	quickly
Rapidman	quickly
Silans	quiet
trankil	quiet
lenn	quilt
kite	quit
Sispann	quit
Kwait	quite
Byen	quite
egzamen	quiz
sitasyon pi ba	quotation
sitasyon	quotation
quote	quote
site	quote
Kuot	quote
quotes	quotes
site	quotes
lapenn	rabbit
lapen	rabbit
ras	race
raj	rage
Lapli	rain
ogmante	raise
Riez	raise
Leve	raise
leve soti vivan	raised
leve	raised
kouri	ran
o aza	random
Pòte	range
ranje	range
taptap	rapid
rapid	rapid
Faas	rapidly
taptap	rapidly
rapidman	rapidly
ra	rare
Raman	rarely
gratèl	rash
Bouton	rash
rat	rat
Pousantaj	rate
olye	rather
pito	rather
achtyo	ratio
Pwopòsyon	ratio
rasyonèl	rational
.raw	raw
kri	raw
renonse	re
re	re
Jwenn	reach
rive	reach
rive	reached
te atend	reached
Did riich	reached
reyaksyon	reaction
Eyaksyon	reaction
Li	read
lekti	reading
Pare	ready
reyèl	real
reyalite	reality
reyalize	realize
reyalize	realized
Fi chuu	really
Vrèman	really
reyèlman	really
dèyè	rear
rezon	reason
Rezonab	reasonable
Rapèl	recall
sonje	recall
Resi	receipt
resevwa	receive
pran	receive
resevwa	received
Did risiiv	received
Dènye	recent
resan	recent
dènyèman	recently
resepsyon	reception
resèt	recipe
ensousyan	reckless
ensousib	reckless
rekonesans	recognition
Rekonèt	recognize
rekòmande	recommend
rekòmande	recommended
Rekaad	record
Dosye	record
refè	recover
erizon	recovery
rekiperasyon	recovery
rektang	rectangle
Rouj	red
wouj	red
rachte	redeem
redanmsyon	redemption
Redwi	reduce
diminye	reduce
redondants	redundant
Refere	refer
Referans	reference
reflete	reflect
reflechi	reflect
refleksyon	reflection
Refren	refrain
Frijidè	refrigerator
Rifrijarieta	refrigerator
ranbousman	refund
refize	refuse
refize	refused
te refize	refused
konsiderasyon	regard
konsènan	regard
konsènan	regarding
kèlkeswa	regardless
Salitasyon	regards
concerne	regards
rejyon	region
enskri	register
Anrejistre	register
regretman	regret
regrèt	regret
Regilye	regular
regilyèman	regularly
rejte	reject
relate	relate
rakonte	relate
rapò	related
Fanmi	related
relasyon	relationship
Relitiv	relative
relatif	relative
Fanmi	relative
fanmi	relatives
Lache	relax
detann	relax
Riliis	release
lage	release
liberasyon	release
lage	released
te pibliye	released
Did riliis	released
enpòtan	relevant
fyab	reliable
serye	reliable
soulajman	relief
soulaje	relieve
soulaje	relieved
relijyon	religion
relijye	religious
ezite	reluctant
repiyans	reluctant
konte	rely
depann sou	rely
Rete	remain
rete	remaining
remakab	remarkable
remèd	remedy
Renmèd	remedy
sonje	remember
fè sonje	remind
raple	remind
rapèl	reminder
adousi	remote
aleka	remote
Deplase	remove
retire	remove
rann	render
Lwe	rent
lwaye	rent
reparasyon	repair
repete	repeat
ranplase	replace
repons	reply
Riplai	reply
rapò	report
Ripuot	report
reprezante	represent
repitasyon	reputation
Rikwes	request
demann	request
Demand	request
egzije	require
mande	require
obligatwa	required
Sekou	rescue
rechèch	research
sanble	resemble
sanble ak	resemble
rankin	resentment
resantiman	resentment
rezèvasyon	reservation
rezève	reserve
Rezidan	resident
demisyonnen	resign
demisyon	resign
fleksibilite	resilience
detèminasyon	resilience
fleksib	resilient
Reziste	resist
Rezistans	resistance
rezolisyon	resolution
rezoud	resolve
resort	resort
resous	resources
Respè	respect
Rispek	respect
reponn	respond
repons	response
responsablite	responsibility
Responsab	responsible
rès	rest
Repoze	rest
rès nan lapè	rest in peace
repoze an pè	rest in peace
restoran	restaurant
retabli	restore
mete restriksyon sou	restrict
restrenn	restrict
Rezilta	result
Rezilta	results
rezime	resume
an detay	retail
kenbe	retain
retansyon	retention
retrete	retired
pran retrèt	retired
retrè	retreat
Retreat	retreat
rekipere	retrieve
rekisi	retrieve
Retounen	return
revele	reveal
revele	revealed
devwale	revealed
tire revanj	revenge
Revanj	revenge
Revni	revenue
ranvèse	reverse
Rivyuu	review
revize	review
revize	revise
revizyon	revision
Revolisyon	revolution
rekonpans	reward
ritm	rhythm
rit	rhythm
riban	rib
kòt	rib
diri	rice
rich	rich
debarase	rid
monte	ride
woulib	ride
Raid	ride
ridikil	ridiculous
dwa	right
Dwat	right
Rait	right
touswit	right now
kounye a	right now
rijid	rigid
bag	ring
rense	rinse
revòlt	riot
RIP	rip
dechire	rip
rèk	ripe
mi	ripe
monte	rise
leve kanpe	rise
Raiz	rise
Risk	risk
rival	rival
rival li	rival
larivyè	river
River	river
wout	road
boukannen	roast
wokan	roast
gaya	robust
Rock	rock
wòch	rock
baton	rod
bab	rod
wòl	role
woulo	roll
woule	roll
do-kay	roof
twati	roof
Sal	room
chanm	room
Rasin	root
kòd	rope
pouri	rotten
brit	rough
ki graj	rough
apeprè	roughly
wonn	round
Round	round
wout	route
woutin	routine
ranje	row
fwote	rub
kawòtchou	rubber
kawotchou	rubber
fatra	rubbish
fwote	rubbish
grosye	rude
grunde	rude
tapi	rug
gouvènen	rug
ruine	ruin
rinen	ruin
règ	rule
règ	ruler
chèf	ruler
Règleman	rules
règ	rules
Kouri	run
fonksyonman	running
kouri	running
seksyon riral	rural
Rural	rural
Rosh	rush
prese	rush
Rush	rush
Sak	sack
Sakre	sacred
sakrifis	sacrifice
sakrifye	sacrifice
Sekirite	safe
san danje	safe
vòl san danje	safe flight
Sekirite	safety
sage	sage
saje	sage
di	said
vwal	sail
Navige	sail
navige	sailing
navigasyon	sailing
dedaje	sake
dedomajman	sake
sale	salary
salè	salary
lavant	sale
vann	sale
somon	salmon
sèl	salt
menm	same
Menm isit la	Same here
Echantiyon	sample
sab	sand
Sand	sand
Sanskrit	Sanskrit
sarcastic	sarcastic
sarkastik	sarcastic
di	sassy
sassy	sassy
chita	sat
Did sidong	sat
satisfaksyon	satisfaction
satisfè	satisfied
satisfè	satisfy
satisfè	satisfying
Satide	Saturday
Samdi	Saturday
sosis	sausage
sovaj	savage
sove	save
wè	saw
di	say
echèl	scale
tronpe	scam
magazen	scam
mak	scar
ra	scarce
pè	scared
echap	scarf
pè	scary
Did skyata	scattered
gaye	scattered
Sèn	scene
peyizaj	scenery
sant	scent
odè	scent
Shedyul	schedule
pwojte	schedule
orè	schedule
Lekòl	school
Syans	science
doktè syantis	scientist
syantis	scientist
doktè syantis yo	scientists
syantis	scientists
sizo	scissors
reprimande	scold
dimansyon	scope
sijè ki abòde	scope
nòt	score
Perte	scrap
grate	scrap
grate	scratch
rèl	scream
kri	scream
twil	screen
ekran	screen
Plimen	screw
zepeng	screw
script	script
Lanmè	sea
sele	seal
rechèch	search
Fouye	search
sezon	season
Chèz	seat
dezyèm	second
sekrè	secret
seksyon	section
sekirite	secure
an sekirite	secure
Sekirite	security
wè	see
Si	see
na wè	see you
wè ou	see you
wè ou pita	see you later
N a wè pita	see you later
wè ou talè konsa	see you soon
na wè talè	see you soon
wè ou demen	see you tomorrow
na wè denmen	see you tomorrow
grenn	seed
Chèche	seek
parèt	seem
sanble	seem
Sanble	seems
wè	seen
arete	seize
sezi	seize
Kriz	seizure
kriz malkadi	seizure
abandone	seldom
raman	seldom
chwazi	select
pwòp tèt ou	self
Self	self
danje pwòp tèt ou	self healing
geri pwòp tèt ou	self healing
Self iiling	self healing
egoyis	selfish
Vann	sell
voye	send
voye ban mwen foto w	send me your picture
voye m 'foto ou	send me your picture
Senior	senior
granmomoyis	senior
sans	sense
sansib	sensible
Sansib	sensitive
voye	sent
fraz	sentence
fraz	sentences
fraz yo	sentences
degrennen	separate
separe	separate
Sepedi	Sepedi
septanm	september
sekans	sequence
Seri	series
Grav	serious
Grav	seriously
oserye	seriously
Sèvi	serve
Sèvis	service
Sesyon	session
mete	set
etabli	set
Set	set
mete kanpe	set up
anviwònman	setting
etabli	settle
rezoud	settle
sèt	seven
disèt	seventeen
Swasanndis	seventy
Plizyè	several
Grav	severe
Koud	sew
sh	sh
.sh	sh
Shade	shade
lonbraj	shade
lonbraj	shadow
souke	shake
va	shall
pwal	shall
fonn	shallow
fon	shallow
wont	shame
Fòm	shape
pataje	share
byen file	sharp
Fò	sharp
Li	she
Shii	she
li genyen	she has
li gen	she has
li se	she is
li ap	she is
koule	shed
mouton	sheep
Dra	sheet
fèy	sheet
etajè	shelf
koki	shell
abri	shelter
Ebèjman	shelter
plak pwotèj	shield
pwoteje	shield
chanje	shift
chanjman	shift
klere	shine
Bato	ship
anbake	shipping
Shert	shirt
Chemiz	shirt
soulye	shoes
tire	shoot
boutik	shop
komèsyal	shopping
fè makèt	shopping
rivaj	shore
Shore	shore
Kout	short
manke	shortage
Shaatij	shortage
mank	shortage
Shat	shot
Piki	shot
ta dwe	should
Fi	should
Dwe	should
zepòl	shoulder
rele	shout
rele fò	shout
montre	show
Shuo	show
montre m	show me
montre m '	show me
benyen	shower
douch	shower
chèvrèt	shrimp
kribich	shrimp
Swimz	shrimp
retresi	shrink
fèmen	shut
fèmen dyòl ou	shut up
fèmen	shut up
Shot op	shut up
timid	shy
frè ak sè	sibling
sibling	sibling
frè ak sè	siblings
malad	sick
Mwen malad	sick
bò	side
soupi	sigh
souse	sigh
je	sight
je klè	sight
touristik	sightseeing
wè	sightseeing
siy	sign
Siyen	sign
siyati	signature
siyifikatif	significant
silans	silence
silans	silent
swa	silk
komèsyal	silly
komik	silly
Ajan	silver
menm jan	similar
Similè	similar
tou senp	simp
simp	simp
senp	simple
ansanm	simultaneously
an menm tan	simultaneously
Depi	since
sensè	sincere
sensèman	sincerely
chante	sing
chantè	singer
sèl	single
lavabo	sink
Sink	sink
Mesye	Sir
Sir	Sir
Sè	sister
sè nan lalwa	sister in law
Bèlsè	sister in law
chita	sit
Chilta	sit
sit	site
anplasman	site
Sitiyasyon	situation
sis	six
sèz	sixteen
swasant	sixty
gwosè	size
Grandè	size
konpetans	skill
ladrès yo	skills
ladrès	skills
po	skin
Po a	skin
bagèt legba	skinny
mens	skinny
sote	skip
jip	skirt
syèl	sky
esklav	slave
Dòmi	sleep
Domi	sleeping
dòmi	sleeping
ndòmi	sleepy
dòmi	sleepy
manch	sleeve
Slais	slice
tranch	slice
glise	slide
yon ti kras	slightly
mens	slim
jipon	slip
glise	slip
pant	slope
plas	slot
fant	slot
lant	slow
ralanti	slow
dousman	slowly
piti	small
Ti	small
entelijan	smart
sant	smell
Smail	smile
souri	smile
lafimen	smoke
Fimen	smoke
lise	smooth
lis	smooth
goute	snack
Soloba	snack
kalmason	snail
koulèv	snake
Siniek	snake
sèpan	snake
elit	snap
menen	snap
Snow	snow
nèj	snow
konsa	so
alò	so
konsa bèl	so cute
bèl	so cute
jistan lwen	so far
byen lwen tèlman	so far
tranpe	soak
savon	soap
oze	sober
modere	sober
f lou fyab	soccer
foutbòl	soccer
sosyal	social
sosyete	society
Society	society
Chosèt	socks
Mou	soft
lojisyèl	software
tè	soil
sal	soil
vann	sold
vann deyò	sold out
vann	sold out
Sòlda	soldier
sèl	sole
solid	solid
olid	solid
solisyon	solution
rezoud	solve
kèk	some
yon moun	somebody
kanmenm	somehow
enpòt ki jan kanmenm	somehow
yon moun	someone
yon bagay	something
Bagay	something
pafwa	sometimes
Youn lè kon sa	sometimes
chante	song
Chan	song
Talè	soon
byento	soon
sofistike	sophisticated
Soranii	Sorani
Sorani	Sorani
Suor	sore
Blese	sore
fè mal	sore
Gòj fè mal	sore throat
chagren	sorrow
lapenn	sorrow
Osh	Sorry
Padon	Sorry
klase	sort
sòt	sort
te chèche	sought
t'ap chache	sought
nanm	soul
nanm	soulmate
soulmate	soulmate
Son	sound
soup	soup
ousoupannan	soup
rak	sour
Sour	sour
sous	source
Sid	south
espas	space
Plas	space
Spam	spam
èspanyòl	span
span	span
Èspanyòl	Spanish
Panyòl	Spanish
Panish	Spanish
Spier	spare
derechany	spare
rezèv	spare
pale	speak
espesyal	special
espès	species
espès yo	species
espesifik	specific
espektakilè	spectacular
diskou	speech
pawol	speech
mo	speechless
pale	speechless
vitès	speed
òtograf	spell
eple	spell
Pase	spend
depanse	spend
depanse	spent
Did spen	spent
Pike	spicy
Piquant	spicy
Spike	spike
vire	spin
epina	spinach
zenglendo	spinach
lespri	spirit
lespir	spirit
krache	spit
splandid	splendid
sipè	splendid
jwen	split
fann	split
Split	split
gate	spoil
gate	spoiled
espontane	spontaneous
kiyè	spoon
plas	spot
tach	spot
madanm	spouse
mari oswa madanm	spouse
Pred	spread
gaye	spread
Pwopagasyon	spread
Spring	spring
sezon prentan	spring
kare	square
peze	squeeze
kalma	squid
ekirèy	squirrel
st	st
Sen	st
pike (verb)	stab
Tab	stab
koud	stab
Estab	stable
pile	stack
chemine	stack
Anplwaye	staff
etap	stage
tach	stain
mach eskalye	stairs
eskalye	stairs
poto	stake
mennen	stake
awotvwa	stalk
pye ble	stalk
nòmal	stall
estab	stall
Tamp	stamp
tenbre	stamp
koupon pou	stamp
Kanpe	stand
Stan	stand
estanda	standard
Standard	standard
Star	star
zetwal	star
kòmanse	start
Did staat	started
Kòmanse	started
te kòmanse	started
mouri grangou	starving
grangou	starving
eta	state
Leta	state
Stiet	state
Deklarasyon	statement
estasyon	station
estati	statue
estati	status
Rete	stay
Stie	stay
rete an sekirite	stay safe
fiks	steady
Fèm	steady
poto	steak
stèk	steak
vòlè	steal
vapè	steam
asye	steel
apik	steep
apeprè	steep
tij	stem
etap	step
Pa	step
kole	stick
baton	stick
Tif	stiff
Rèd	stiff
Til	still
toujou	still
pike	sting
stingy	stingy
Miin	stingy
kras	stingy
brase	stir
stock	stock
Machandiz	stock
vòlè	stolen
yo vòlè li	stolen
Anbavant	stomach
Tumok	stomach
vant	stomach
Stone	stone
wòch	stone
Did stan/tan op	stood
kanpe	stood
oupou	stool
poupou	stool
Rete	stop
Tap	stop
sispann	stop
depo	storage
magazen	store
tanpèt	storm
istwa	story
Recho	stove
dwat	straight
Chriet	straight
devan dwat	straightforward
senp	straightforward
fòse	strain
souch	strain
etranj	strange
dròg	strange
Stranger	stranger
etranje	stranger
estrateji	strategy
Paille	straw
pay	straw
frèz	strawberry
tras	streak
kouran	stream
kouran dlo	stream
Lari	street
fòs	strength
estrès	stress
strès	stress
detire	stretch
mabyal	strict
strik	strict
grèv	strike
kòd	string
fisèl	string
teren	strip
kòden	strip
fè efò	strive
fè jefò	strive
kriz tansyon	stroke
konjesyon serebral	stroke
Gwo	strong
Chrang	strong
fò	strong
frape	struck
Èstrikti	structure
estrikti	structure
batay	struggle
lit	struggle
Strogl	struggle
difikilte	struggling
rèd	stubborn
fè tèt di	stubborn
kole	stuck
elèv	student
Etidye	study
etid	study
Stodi	study
etidyan	studying
etidye	studying
Bagay	stuff
sansasyonèl	stunning
estipid	stupid
style	style
sijè	subject
soumèt, soumèt	submission
Soumèt	submit
sibstans	substance
Sibstiti	substitute
ranplasan	substitute
sibtil	subtle
reyisi	succeed
siksè	success
siksè	successful
tankou	such
tèl	such
tankou	such as
tòtòt	suck
souse	suck
santredi	sudden
toudenkou	sudden
Sanzatann	suddenly
toudenkou	suddenly
soufri	suffer
soufrans	suffering
ase	sufficient
sifi	sufficient
Sugar	sugar
sik	sugar
sijere	suggest
Propozisyon	suggestion
sijesyon	suggestion
Suut	suit
kostim	suit
apwopriye	suitable
malèt	suitcase
valiz	suitcase
sòm	sum
rezime	summary
ete	summer
somè	summit
soumèt	summit
Solèy	sun
dimanch	sunday
Sunny	sunny
solèy	sunny
solèy kouche	sunset
Sunset	sunset
solèy	sunshine
soupe	super
super	super
Suuper	super
siperyè	superior
sipèvizè	supervisor
soupe	supper
Soplai	supply
rezèv	supply
Materyèl	supply
Sipò	support
Sopuot	support
sipoze	suppose
asipoze	suppose
sipoze	supposed
asire	sure
sèten	sure
Sifas	surface
vag	surge
ogmante	surge
Operasyon	surgery
siyati	surname
ti non	surname
sipriz	surprise
ete sezi	surprised
sezi	surprised
rann tèt	surrender
rann nou	surrender
antoure	surrounding
siveyans	surveillance
sondaj	survey
Servie	survey
chape	survive
siviv	survive
sispèk	suspect
Sospek	suspect
sispann	suspended
sispèk	suspicious
soutni	sustain
abreje	sustain
dirab	sustainability
dirabilite	sustainability
dirab	sustainable
swag	swag
balanse	swag
vale	swallow
magazen	swap
swap	swap
sèmante	swear
Swe	sweat
chanday	sweater
bale	sweep
dous	sweet
rèv dous	sweet dreams
Fè bèl rèv	sweet dreams
Renmen bagay dous	sweet tooth
dous dan	sweet tooth
amoure	sweetheart
sèmante	sweetheart
gwosi	swell
anfle	swell
Swel op	swell
anfle	swelling
nfleman	swelling
naje	swim
naje	swimming
Swing	swing
balanse	swing
switch	switch
Swich	switch
chanje	switch
Swolen	swollen
anfle	swollen
Enflé ou grò	swollen
nepe	sword
Senbòl	symbol
senpati	sympathy
konpasyon	sympathy
Sentòm	symptoms
Sistèm	system
tab	table
atake	tackle
tag	tag
etikèt	tag
ke	tail
keyi	tail
pran	take
pran	take away
retire	take away
Pran swem tèt ou	take care
pran swen	take care
wete	take off
retire	take off
pran	taken
Did tek	taken
Taak	talk
pale	talk
bavar	talkative
pale	talkative
wotè	tall
Tap	tap
tiyo	tap
wobinè	tap
Tep	tape
Sib	target
Taagit	target
Travay	task
goute	taste
gou	taste
Ties	taste
gou	tasty
savoureuse	tasty
anseye	taught
Did tiich	taught
esèpsyon	tea
Tea	tea
Anseye	teach
Pwofesè	teacher
Ekip	team
dlo je	tear
chire	tear
dlo je	tears
dlo nan je	tears
toumante	tease
anmède	tease
Teknoloji	technology
Dan	teeth
di	tell
ban m dim	tell me
di m '	tell me
tanperaman	temper
tanperati	temperature
tanp	temple
Temple	temple
tanporè	temporary
Dis	ten
dis mil	ten thousand
lokal	tenant
Lokatè	tenant
gen tandans	tend
tandans	tendency
Sansib	tender
tansyon	tense
ennève	tense
tansyon	tension
tant	tent
tantatif	tentative
konfimen	tentative
tèm	term
tèm	terms
Terib	terrible
Mayifik	terrific
formidable	terrific
Tèritwa	territory
teritwa	territory
tès	test
Test	test
Mesaj tèks	text
tèks	text
Pase	than
Remèsye	thank
mèsi	thank
Mèsi	thank you
Tangk yo	thank you
di ou mèsi	thank you
Tangk yu/yo fi yu/yo pieshens wail wi investigiet di shipment	Thank you for your patience while we investigate shipment
Mèsi pou pasyans ou pandan ke nou mennen ankèt sou chajman	Thank you for your patience while we investigate shipment
Mèsi pou pasyans ou pandan nou ap envestige chajman	Thank you for your patience while we investigate shipment
di ou mèsi anpil	thank you so much
Mèsi anpil	thank you so much
di ou mèsi anpil	thank you very much
mèsi anpil	thank you very much
Mèsi	thanks
Mèsi pou lè l sèvi avèk app nou an	Thanks for using our app
Mèsi pou itilize app nou an	Thanks for using our app
Sa	that
sa se	that is
sa bon	that's good
la	the
alèji	the
vòlè	theft
vòl	theft
yo	their
yo	them
tèm	theme
yomenm	themselves
tèt yo	themselves
Lè sa a	then
apre	then
Teori	theory
teyori	theory
gen	there
La	there
Dier	there
gen	there are
gen	there is
Se poutèt sa	therefore
Sa	these
sa yo	these
yo	they
yo ap	they are
yo	they are
pwès	thick
epè	thick
vòlè	thief
Kouis	thigh
kwis	thigh
chèch	thin
mens	thin
Bagay	thing
Bagay	things
Panse	think
Twazyèm	third
swaf	thirsty
Mwen souaf	thirsty
Trèz	thirteen
trant	thirty
Sa	this
sila se	this is
sa a se	this is
nkè	thorough
apwofondi	thorough
nètale	thoroughly
byen	thoroughly
Sa	those
sa yo	those
menm	though
menm si	though
Panse	thought
reflechi	thoughtful
panse yo	thoughts
panse	thoughts
mil	thousand
fil	thread
Menas	threat
menase	threaten
Twa	three
papòt	threshold
frisonen	thrilled
kontan	thrilled
boujonnen	thrive
gòj	throat
Goj	throat
atravè	through
pandan tout	throughout
nan tout	throughout
voye	throw
jete	throw
gwo pous	thumb
pous	thumb
loraj	thunder
tonè	thunder
Jedi	Thursday
konsa	thus
tik	tick
satouyèt	tick
mare	tide
djandjan	tidy
pwòp	tidy
Tai	tie
mare	tie
tig	tiger
ennen	tight
sere	tight
Tigrinya	Tigrinya
tan	time
timid	timid
kazwèl	timid
piti piti	tiny
ti	tiny
Pwent	tip
Konsèy	tips
Fatige	tire
kawotchou	tire
fatige	tired
Mwen fatigé	tired
Pap dong	tired
vyann	tissue
tisi	tissue
Tit	title
Pou	to
ale	to
fè egzèsis	to be
yo dwe	to be
pen griye	toast
.toast	toast
jodi	today
Tude	today
Jodi a	today
timoun piti	toddler
tikal	toddler
zòtèy	toes
ansanm	together
Twalèt	toilet
di	told
tolerans	tolerance
pèdi konesans	tolerate
tolere	tolerate
tomat	tomato
demen	tomorrow
Lang	tongue
aswè	tonight
Tunait	tonight
Twò	too
pran	took
Did tek	took
zouti	tool
zouti	tools
Dan	tooth
anwo nèt	top
Top	top
sijè	topic
tòn	torn
chire	torn
tòtire	torture
tòti	torture
total	total
manyen	touch
Touch	touch
difisil	tough
òklò	tough
vwayaj	tour
anvè	toward
direksyon	toward
nan direksyon pou	towards
anvè	towards
sèvyèt	towel
vil	town
toksik	toxic
oksik	toxic
tras	trace
tras	track
Chried	trade
komès	trade
tradisyon	tradition
tradisyonèl	traditional
Trafik	traffic
Trail	trail
tren	train
Antrènman	training
fòmasyon	training
trè	trait
karaktè	trait
karakteristik	traits
karaktè	traits
Transfè	transfer
tranzisyon	transition
Tradwi	translate
tradui	translate
transparan	transparent
transpò	transport
transpò	transportation
Transpòtasyon	transportation
pyèj	trap
pèlen	trap
fatra	trash
twomatis	trauma
chòk	trauma
vwayaje	travel
vwayaj	travel
Plato	tray
trezò	treasure
trete	treat
Tretman	treatment
pyebwa	tree
fòmidab	tremendous
tandans	trend
Esè	trial
jijman	trial
Trick	trick
ke trik nouvèl	trick
eseye	tried
te eseye	tried
deklanche	trigger
Chriga	trigger
bòdu	trim
taye	trim
vwayaj	trip
pwoblèm	trouble
pantalon yo	trousers
pantalon	trousers
Kamyon	truck
TRUE	true
kòf	trunk
Chros	trust
konfyans	trust
Verite	truth
eseye	try
Seye	try
Tsonga	Tsonga
tib	tube
Madi	Tuesday
ekolaj	tuition
lakou	tuition
Turkey	turkey
kodenn	turkey
timerik	turmeric
ameriken	turmeric
vire	turn
Turtle	turtle
tòti	turtle
leson patikilye	tutor
tutor	tutor
douz	twelve
Ven	twenty
ven-yon sèl	twenty-one
ven	twenty-one
dejis	Twi
Twi	Twi
de fwa	twice
defwa	twice
tòdye	twist
tòde	twist
De	two
kalite	type
Tip	type
tipik	typical
lèd	ugly
Ultim	ultimate
iltim	ultimate
parapli	umbrella
kapab	unable
enkapab	unable
tonton	uncle
monnonk	uncle
an konesans	unconscious
san konesans	unconscious
anba	under
anba	underneath
soufri	underrated
mekonu	underrated
Konprann	understand
Did andastan	understood
konprann	understood
malerezman	unfortunately
Inifòm	uniform
inik	unique
inite	unit
Inivèsite	university
enkoni	unknown
sof	unless
amwenske	unless
jiskaske	until
Jiska	until
etranj	unusual
anlè	up
moute	up
jiska ou	up to you
ou konnen	up to you
aktyalizasyon	update
ajou	update
Opdiet	update
amelyore	upgrade
ajou	upgrade
Opgried	upgrade
Sou	upon
fache	upset
Angri	upset
oulvèsan	upset
iben	urban
Erj	urge
ankouraje	urge
ijan	urgent
Dijans	urgent
nou	us
itilize	use
Yuuz	use
itilize	used
itil	useful
inonbrabl	useless
initil	useless
òdinè	usual
abityèl	usual
anjeneral	usually
Dabitid	usually
Itilite	utility
sèvis piblik	utility
vakans	vacation
Vaksen	vaccination
vaksinasyon	vaccination
Vaksen	vaccine
vakyòm	vacuum
vag	vague
valab	valid
Valley	valley
valab	valuable
valè	value
Valyu	value
varyete	variety
Plizyè	various
divès	various
varye	vary
vaz	vase
vas	vast
legim	vegetable
Legim	vegetables
Machin	vehicle
Veyikil	vehicle
machann	vendor
mèyè	vendor
venen	venom
Antrepriz	venture
pidevan	venue
verifye	verify
versatile	versatile
vèsyon	version
Vètikal	vertical
Trè	very
trè byen	very good
trè bon	very good
veso	vessel
vesèl	vessel
via	via
atravè	via
vibre	vibe
Ambians	vibe
vib	vibes
vib yo	vibes
fyab	vicious
visye	vicious
Viktim	victim
Videyo	video
View	view
Vil	village
vilaj	village
mechan	villain
mechan venn	villain
vinèg	vinegar
vintaj	vintage
Vyolans	violence
Vyolan	violent
viral	viral
jenn fi	virgin
vyèj	virgin
vityèl	virtual
vèti	virtue
Vizyon	vision
Vizit	visit
vizite	visit
Visit	visit
vizyèl	visual
vital	vital
esansyèl	vital
rete vivan	vivid
vokabilè	vocabulary
vwa	voice
anile	void
evite	void
Volim	volume
volontè	volunteer
vomi	vomit
vomit	vomit
Vamit	vomit
vilnerab	vulnerable
frajil	vulnerable
salè	wage
salè	wages
Tay	waist
ren	waist
tann	wait
gason	waiter
tann	waiting
ap tann	waiting
reveye	wake
reveye	wake up
Leve	wake up
mache	walk
Waak	walk
mache	walking
miray	wall
Wall	wall
bous	wallet
vapè	wallet
flannen	wander
moute desann	wander
vle	wanna
vle	want
vle	wanted
te vle	wanted
lagè	war
Gè	war
amwa	wardrobe
pandri	wardrobe
depo	warehouse
Cho	warm
Waam	warm
avèti	warn
avètisman	warning
Warrior	warrior
vanyan sòlda	warrior
te	was
lave	wash
fatra	waste
Wies	waste
gasèt	waste
gade	watch
Veye	watch
dlo	water
melon	watermelon
vag	wave
Fason	way
Nou	we
nou	we are
nou ap	we are
nou kapab	we can
fèb	weak
Mwen santi m féb	weak
feblès	weakness
Richès	wealth
rich	wealthy
Mete	wear
mete	wearing
pote	wearing
move tan	weather
Tan	weather
maryaj	wedding
Mèkredi	Wednesday
raje	weed
move zèb	weed
semèn	week
fen semenn	weekend
wikenn	weekend
Wiet	weight
Pwa	weight
etranj	weird
akeyi	welcome
Byenvini	welcome
Byennèt	welfare
Oke	Well
Byen	Well
byen fèt	well done
Al	went
ale	went
Did-a	were
te	were
lwès	west
Wès	west
mouye	wet
balèn	whale
Kisa	what
e ou menm	what about you
sa ki sou ou	what about you
Kisa w ap fè	what are you doing
We yo a du?	what are you doing
kisa wap fè kounye a	what are you doing now
kisa w ap fè kounye a	what are you doing now
We yu/yo de du?	what are you doing now
kisa w ap fè kounye a	what are you doing right now
kisa ou ap fè koulye a	what are you doing right now
kisa ou fè	what do you do
kisa w fè	what do you do
kisa ou fè pou yon k ap viv	what do you do for a living
kisa ou fè pou ou viv	what do you do for a living
kisa wap dim	what do you mean
kisa ou vle di	what do you mean
kisa ou vle	what do you want
Kisa ou vIe	what do you want
sa ki te pase	what happened
Kisa k te pase	what happened
Wat iz	what is
sa se	what is
ki sa ki se	what is
Kisa sa a ye	what is this
kisa sa ye	what is this
A wa dis?	what is this
ki sa ki travay ou	what is your job
ki travay ou	what is your job
ki sa ki non ou	what is your name
Uu yu/yo bi?	what is your name
Ki non w	what is your name
sa k'pase	what's up
sa ki moute	what's up
sa ki nan non ou	what's your name
Kijan ou rele	what's your name
kèlkeswa	whatever
ble	wheat
wou	wheel
lè	when
Kile	when
chak fwa	whenever
nenpòt lè	whenever
kote	where
kote ou ye	where are you
Ki bò w ye	where are you
We yo kom fram?	where are you from
Moun ki bò w ye	where are you from
kote ou soti	where are you from
kote w ye kounye a	where are you now
kote ou ye kounye a	where are you now
Ki bò w rete	where do you live
ki kote w ap viv	where do you live
ki kote	where is
kote se	where is
tandiske	whereas
alòske	whereas
si	whether
Kiles	which
kilès	which
pandan	while
chuichui	whisper
siflèt	whistle
blan	white
Kiyès	who
Ki moun	who
kiyès ou ye	who are you
ki moun ou ye	who are you
kiyès	who is
kimoun sa a ye	who is this
kiyès sa a	who is this
antye	whole
Ki	whom
moun	whom
ki	whose
kilès	whose
poukisa	why
poukisa pa	why not
pou kwapa	why not
mechan	wicked
lajè	wide
Laj	wide
vèv	widow
Lajè	width
Madanm	wife
sovaj	wild
Wil	will
pral	will
Pwal	will
vle	willing
Dispoze	willing
Genyen	win
van	wind
Fenèt	window
van	windy
diven	wine
sezon fredi	winter
Winter	winter
Siye	wipe
fil	wire
fil fè	wire
bon konprann	wisdom
sajès	wisdom
saj	wise
Wish	wish
Swete	wish
swete w tout pi bon an	wish you all the best
swete ou tout pi bon	wish you all the best
sòsyè	witch
Ak	with
retire	withdraw
retrè	withdrawal
anndan	within
nan	within
san	without
Witness	witness
temwen	witness
ki gen anpil	witty
éspirituèl	witty
Wolf	wolf
fanm	woman
Uman	woman
fanm	women
Uman dem	women
te genyen	won
pa pral	won't
Pa pwal	won't
eksepsyonèl	wonder
sezi	wonder
bèl	wonderful
Estrawòdinè	wonderful
bwa	wood
Lenn	wool
mo	word
mo	words
Wok	work
Travay	work
travay deyò	work out
fè espò	work out
Travay	working
mond	world
Mondyal	world
Vè	worm
chire	worn
meprize	worn
enkyete	worried
enkyete	worry
pi mal	worse
Sèvis	worship
adore	worship
i mal nèt/rèd	worst
pi move	worst
Wers	worst
Worth	worth
vo	worth
vo li	worth it
merite	worthy
ta	would
Blese	wound
blesi	wound
Wow	Wow
Oulala	Wow
vlope	wrap
kòlè	wrath
Ouayet	wrist
ponyèt	wrist
ekri	write
Ekri isit la	Write here
ekri	writing
ekri	written
mal	wrong
ekri	wrote
lakou	yard
aye	yawn
yawn	yawn
Yaan	yawn
Wi	Yeah
Yeah	Yeah
Ane	year
Ane	years
leven	yeast
ledven	yeast
rele	yell
Shout	yell
kri	yell
Jòn	yellow
Wi	Yes
Ya	Yes
wi ti bebe	yes baby
wi bebe	yes baby
wi, wi	yes dear
wi mwen renmen anpil	yes dear
wi siwo myèl	yes honey
wi cheri	yes my love
repons lan se wi renmen mwen	yes my love
men wi	yes of course
wi nan kou	yes of course
yè	yesterday
Yesterde	yesterday
epoutan	yet
ankò	yet
sede	yield
ou	you
Yo	you
ou ap	you are
ou	you are
ou se bèl	you are beautiful
Ou bèl anpil	you are beautiful
ou yo, se pou bèl	you are so beautiful
ou tèlman bèl	you are so beautiful
pa dekwa	you are welcome
ou akeyi	you are welcome
ou kapab	you can
Ou konnen	You know
ou men tou	you too
ou twò	you too
Merite	you're welcome
w ap akeyi	you're welcome
jèn	young
Yu	your
ou	your
akeyi ou	your welcome
tèt ou	yourself
Ou	yourself
jennès	youth
jèn	youth
Merite	you’re welcome
w ap akeyi	you’re welcome
imim	yummy
Apetisan	yummy
zewo	zero
