тӀэкӀу	a little
мащӀэу	a little
куэд	a lot
куэд	a lot of
бгынэн	abandon
хыфӀэдза	abandoned
хуэпщылӀын	abide
зэфӀэкӀ	ability
зыхузэфӀэкӀ	able
адыгъэбзэм хэткъым	about
и щхьэ	above
гъунапкъэм аткӀэ	abroad
щымыӀэныгъэ	absence
къэтыныгъэ	absence
щымыӀэ	absent
нэщӀыса	absolutely
зэщӀэшэн	absorb
зэщӀэфын	absorb
мынаӀуэ	abstract
мыхьэнэншэ	absurd
бэвыгъэ	abundance
пэрыхьэтыгъэ	abundance
куэд	abundant
къэгъэсэбэпын	abuse
къэгъэсэбэпыныгъэ	abuse
гулъытэ	accent
бзэм и щыщӀагъэ	accent
къэщтэн	accept
бгъэдыхьэпӀэ	access
насыпыншагъэ Ӏуэху	accident
щӀэгъэтӀысхьэн	accommodation
зыӀэрыгъыхьэн	accomplish
нэсащ	accomplished
арэзы	according
есэп	account
хуэфӀыпс	accuracy
хуэдэ	accuracy
техуэпс	accurate
пэж дыдэ	accurate
ещхьыпс	accurate
ягъэкъуаншэ	accused
уз	ache
узын	ache
пэлъэщын	achieve
къохъулӀэн	achieve
ехъулӀэныгъэ	achievement
къэцӀыхужын	acknowledge
зэгъэцӀыхуныгъэ	acquaintance
къызыӀэрыгъыхьэн	acquire
зэригъэпэщащ	acquired
зэгъэпэщыгэныгъэ	acquisition
кӀэ	across
ищӀэгъа	act
лэжьыгъэ	action
жыджэр	active
Ӏуэхугъуэ гуэрым теухуа екӀуэкӀ	activities
мероприятэ	activities
ӀэщӀагъэ	activity
актёр	actor
шэч зыхэмылъ	actual
зэрыщыт дыдэр	actually
сыр	acute
есэн	adapt
хэлъхьэн	add
хэгъэхъуэн	add
щхьэхуимыт	addicted
хэлъхьэныгъэ	addition
щӀыгъу	additional
зыхуэгъэзэн	address
зыщыпсэу щӀыпӀэ	address
здэщыӀэ	address
тэмэм	adequate
пэгъунэгъу	adjacent
плъыфэцӀэ	adjective
зэгъэпэщыжын	adjust
зэгъэзэхуэжын	adjust
гъэщӀэгъуэн щыхъун	admire
къиӀуэн	admit
къеӀыхын	adopt
дэн	adopt
дэзыхьэх	adorable
гъэкӀуэтэн	advance
кӀуэцӀырыгъэкӀын	advance
кӀуэта	advanced
ефӀэкӀыныгъэ	advantage
къэхъу-къащӀэ	adventure
наречэ	adverb
рекламэ	advertisement
рекламэ	advertising
чэнджэщ	advice
чэнджэщ	advise
щхьэщыж	advocate
щыхъумэн	advocate
дахэ	aesthetic
Ӏуэху	affair
зыгуэр хэщӀыхьын	affect
лъагъуныгъэ	affection
хуитыныгъэ зэптыжын	afford
бгъэдыхьэпӀэ зиӀэ	affordable
мэшынэ	afraid
нэужь	after
къыкӀэлъыкӀуэу	after
махуэ накъуэ	afternoon
иужьым	afterwards
аргуэру	again
пэщӀэуэныгъэ	against
ныбжь	age
агенствэ	agency
Ӏуэхузехьэ	agent
тэмакъкӀэщӀ	aggressive
ӀэкӀэулъакӀуэ	agile
щӀыбагъкӀэ	ago
дэн	agree
зэгурыӀуэныгъэ	agreement
мэкъумэш	agriculture
ипэмкӀэ	ahead
дэӀэпыкъуэгъу	aid
егъэпщэн	aim
хьэуа	air
аэропорт	airport
блэкӀыныгъэ	aisle
дэкӀыныгъэ	aisle
пӀейтеягъэ	alarm
фадэ	alcohol
пӀейтей	alert
жыджэр	alive
псэу	alive
псори	all
хъунщ	all right
нэхъыфӀ дыдэм ухуишэ	all the best
хуэдэн	allow
хуит ищӀащ	allowed
нэблагъэ	almost
зы	alone
Ӏуту	along
кӀэ	already
Хъунщ	Alright
апхуэдэу	also
альтернативэ	alternative
ауэ	although
дэпщэщи	always
сыщытщ	am
сыхэтщ	am
гъэщӀэгъуэн	amazing
удэзыхьэхын	amazing
зы мыхьэнэм щӀигъу иӀэныгъэ	ambiguous
зыкъыфӀэщӀыжыныгъэ	ambition
пагагъэ егъэлея	ambition
пагэныгъэ зыхэлъ	ambitious
епцӀыжын	amend
утыкум	amid
кум	amid
курыкум	amid
ящыщ	among
дэ тщыщ	among us
бжыгъэ	amount
узымыгъэзэш	amusing
дыхьэшхэн	amusing
зы Ӏуэхугъуэ гуэрыр Ӏыхьэ-Ӏыхьэурэ зэпкърахыурэ зэрадж щӀыкӀэ	analysis
нэхъыжьхэр	ancestors
хъурзэ	anchor
пасэрей	ancient
икӀи	and
уэ щэ	and you
мелыӀыч	angel
губжь	anger
къуапэ	angle
губжьа	angry
псэущхьэ	animal
лъэпкъынэ	ankle
илъэс бжыгъэ гуэр гъэлъэпӀэн	anniversary
хъыбарегъащӀэ	announcement
гъэбэпмпӀэн	annoy
къэгъэгубжьын	annoy
зэгуэпа	annoyed
узыгъэбампӀэ	annoying
илъэс къэс	annual
къызыбгъэдэкӀар мыбелджылы	anonymous
нэгъуэщӀ	another
жэуап	answer
жэуап етын	answer
къэщӀэн	anticipate
гузавэ	anxiety
гузэва	anxious
дапхуэдэри	any
нэхъыбэ	anymore
хэти	anyone
зыгуэр	anything
сыт къэмыхъуми	anyway
апхуэдэу е нэгъуэщӀу	anyways
зэпэщхьэхуэу	apart
фэтэр	apartment
къысхуэгъэгъу жыӀэн	apologize
шэч зыхэмылъ	apparent
нэрылъагъущ	apparently
удэзыхьэх	appeal
къэхутэн	appear
теплъэ	appearance
къэхутащ	appeared
шхэныгу	appetite
мыӀэрысэ	apple
къэгъэсэбэпын	application
къэгъэсэбэпын	apply
гъэувыныгъэ	appointment
гъэлъэпӀэн	appreciate
фӀыщӀэ	appreciation
пэгъунэгъу хъун	approach
бгъэдыхьэпӀэ	approach
къекӀу	appropriate
арэзы техъуэныгъэ	approval
дэн	approve
арэзы зытехъуа	approved
хууэгъэфэщауэ	approximately
мэлыжьыхь	april
хуит	arbitrary
щхьэрыутӀыпщ	arbitrary
архитектор	architect
ухуэныгъэ щӀыкӀэ	architecture
дэфтэр хъумапӀэ	archive
щытхэщ	are
уэ ущытщ	are you
Ӏуэху ухэт	are you busy
Уэ къэпша	are you married
щхьэгъусэ уиӀэ хьэмэрэ уимыӀэ	are you married or single
Уэ иджыри абы ущыӀэ?	Are you still there?
уэ абдеж ущыӀэ	are you there
куей	area
зэпеуэн	argue
зэдауэ	argument
къэхъун	arise
Ӏэ	arm
армэ	army
и хъуреягъкӀэ	around
зэхуэгъэхъун	arrange
къызэгъэпэщыныгъэ	arrangement
къэсыныгъэ	arrival
щыӀэн	arrive
къэсащ	arrived
зыкъызыфӀэщӀыжа	arrogant
шабзэ	arrow
гъуэзэджэ щӀэн	art
статья	article
нэпцӀ	artificial
псэ зыӀумыт	artificial
сурэтыщӀ	artist
дауэ	as
иджыкӀэ	as long as
апхуэдэу	as well
дыщӀыгъуу	as well as
сахуэ	ash
укӀытэ	ashamed
еупщӀын	ask
щӀэупщӀащ	asked
жей	asleep
Ӏуэхум зэреплъ щӀыкӀэ	aspect
Ассамскэ	Assamese
теуэныгъэ	assault
зэхуэс	assembly
ерыщ	assertive
къэлъытэн	assess
оценкэ	assessment
фӀыгъуэ	asset
фӀыгъуэ	assets
хэхын	assign
гъэувын	assign
лэжьыгъэ	assignment
дэӀэпыкъун	assist
дэӀэпыкъуэгъу	assistant
дэӀэпыкъуэгъу	associate
зэпха	associated
егъэщхьыныгъэ	association
ассоциацэ	association
хуэгъэфэщэн	assume
хуэгъэфэщэныгъэ	assumption
нэхъ мащӀэ дыдэу	at least
ишхащ	ate
спортсмен	athlete
дыщӀыгъун	attach
пыщӀэн	attach
кӀэрыщӀа	attached
есэныгъэ	attachment
теуэныгъэ	attack
екуныгъэ	attempt
зепщытыныгъэ	attempt
екӀуэлӀэн	attend
къэкӀуэкӀэ	attendance
гулъытэ	attention
зэхущытыкӀэ	attitude
зэӀэпышэн	attract
зыщӀэшэныгъэ	attraction
уплъэгъуафӀэ	attractive
щытыкӀэ щхьэхуэ	attribute
цӀыхубэ	audience
шыщхьэӀу	august
адэ шыпхъу	aunt
анэ шыпхъу	aunt
анэ е адэ шыпхъу	aunty
пэж	authentic
лэжьыгъэр зей	author
тепщэныгъэ	authority
бжыхьэ	autumn
гъуафӀэ	available
курыт	average
зыщӀэдзеин	avoid
мыжей	awake
тыгъэ	award
саугъэт	award
щыгъуазэныгъэ	aware
хэщӀыкӀыныгъэ	awareness
щыгъуазэныгъэ	awareness
лъэныкъуэ	away
егъэлеяуэ фӀы	awesome
гуӀэгъуэ	awful
мыӀэкӀуэлъакӀуэ	awkward
щытыкӀэ емыкӀу	awkward
Аймарэ	Aymara
сабий	baby
фызкъэмышэ	bachelor
гъэзэжын	back
плъыфэ	background
Ӏей	bad
сумкэ	bag
къэлътмакъ	bag
пылъхьэ	bait
гъэжьэн	bake
пэшхьэку	bake
щӀакхъуэ гъэжьапӀэ	bakery
шхын содэ	baking soda
баланс	balance
зыӀыгъын	balance
хъурей	ball
Бамбарэ	Bambara
Ӏэпэзэкъуэт	banana
гуп	band
теуӀуэн	bang
ахъшэ хъумапӀэ	bank
банк	bank
планкэ	bar
ерагъкӀэ	barely
зэгурыӀуэныгъэ	bargain
бэнэн	bark
пхъафэ	bark
ерагъкӀэ	barley
елъапӀэ	barrier
лъабжьэ	base
къэгъэщӀын	based
щӀыунэ	basement
нэхъапэ	basic
нэхъыбэу	basically
базилик	basil
напэншэ	bastard
гуп	batch
ваннэ	bath
ваннэ зыщӀэт пэш	bathroom
батэрейкэ	battery
зауэ	battle
псы дэлъэда	bay
щыӀэн	be
хуэсакъ	be careful
псы Ӏуфэ	beach
Бзий	beam
нур	beam
джэш	beans
джэрш	beans
къыщӀэхын	bear
мыщэ	bear
жьакӀэ	beard
подшиник	bearing
хьэкӀэкхъуэкӀэ	beast
укӀын	beat
еуэн	beat
дахэ	beautiful
дахагъэ	beauty
хъуащ	became
абы щхьа	because
хъун	become
пӀэ	bed
лагъунэ	bedroom
бжьэ	bee
былымыл	beef
щыӀащ	been
пивэ	beer
япэ	before
щӀидзащ	began
щӀэдзэн	begin
щӀэдзапӀэ	beginning
Na	behalf
зыщӀын	behave
щытыкӀэ	behavior
щытыкӀэ	behaviour
иужь	behind
псэущхьэ	being
фӀэщ хъуныгъэ	belief
фӀэщ щӀын	believe
ныбэ	belly
еин	belong
фӀыуэ слъагъу	beloved
и лъабжьэ	below
бгырыпх	belt
тетӀысхьэпӀэ	bench
лафкӀэ	bench
къэгъэшын	bend
лъабжьэ	beneath
ефӀэкӀыныгъэ	benefit
фейдэ къыхэхын	benefit
ефӀэкӀыныгъэхэр	benefits
гъусэу	beside
абы нэмыщӀ	besides
нэхъыфӀ	best
къыуигъэхъулӀэ	best of luck
пщӀэ хэлъу	best regards
нэхъыфӀ	better
я зэхуаку	between
зэфэ гуэр	beverage
химыубыдэу	beyond
Бхэджпурэ	Bhojpuri
хухэхауэ	bias
пцӀыуэ къыщӀэкӀа	biased
лъакъуэрыгъажэ	bicycle
заявкэ	bid
ин	big
лъакъуэрыгъажэ	bike
бжыгъэ	bill
зэпхын	bind
бзу	bird
къыщалъхуа махуэ	birthday
Ӏыхьэ цӀыкӀу	bit
едзэкъэн	bite
дзэкъапӀэ	bite
дыдж	bitter
фӀыцӀэ	black
дзэ	blade
къуэншагъэ	blame
гъэкъуэншэн	blame
нэщӀ	blank
тепхъуэ	blanket
къэуэныгъэ	blast
зэхэкъутэныгъэ	blast
хужь щӀын	bleach
зэхэкӀэн	blend
зэхэгъэзэрыхьын	blend
хуит щӀын	bless
хуэунэтӀын	bless
хуит щӀын	blessed
нэф	blind
тхъэгъуэ	bliss
гъэбыда	block
лъы	blood
гъэгъэн	bloom
еуэн	blow
щӀыху	blue
дзагуэ	blunt
доскэ	board
кхъуафэжьей	boat
пкъыгъуэ	body
Ӏэпкълъэпкъ	body
къэгъэкъуэлъэн	boil
Ӏэдэбыншэ	bold
зэпыщӀэныгъэ	bond
къупщхьэ	bone
зыгуэр хэхын	book
тхылъ	book
дэгъэкӀуэтеин	boost
хэгъэхъуэныгъэ	boost
гъэпсынщӀакӀуэ	booster
ботинкӀэ	boot
ботинкӀэ	boots
гъунапкъэ	border
угъуэнын	bore
зигу укъэкӀ	bored
узыгъэзэш	boring
къалъхуа	born
къыхэхын	borrow
унафэщӀ	boss
тӀури	both
гъэгузэвэн	bother
птулъкӀэ	bottle
щӀыгу	bottom
къищэхуащ	bought
дэлъеин	bounce
зэпха	bound
гъунапкъэ	boundaries
шабзэ	bow
шынакъ	bowl
фалъэ	bowl
коробкэ	box
щӀалэ цӀыкӀу	boy
щӀалэ	boyfriend
Ӏэпщэхъу	bracelet
щхьэкуцӀ	brain
къудамэ	branch
дамыгъэ тедзэн	brand
хахуэ	brave
пхыудын	breach
щӀакхъуэ	bread
къутэн	break
зэпыгъэуныгъэ	break
пщэдджьыжьышхэ	breakfast
бгъэ	breast
бауэкӀэ	breath
бэуэн	breathe
къэгъэпцӀэн	breed
зыблэгъэкӀын	breed
чырбыш	brick
нысэ	bride
лъэмыж	bridge
кӀэщӀ	brief
лыд	bright
цӀу	brilliant
къэхьын	bring
къуэш	bro
фабгъуэ	broad
нэтын	broadcast
икъутащ	broke
къута	broken
жыхапхъэ	broom
дэлъху	brother
щыкъ щӀалэ	brother in law
къихьащ	brought
морэ	brown
щеткэ	brush
пэгун	bucket
ӀупэфӀэгъу	buddy
бюджет	budget
цӀыв	bug
щӀын	build
унэ	building
щӀа	built
я нэхъыбэр	bulk
гуу	bull
къаугъэшы	bully
Ӏууэн	bump
ирихьэлӀэн	bump
жьэхэуэн	bump
куэд	bunch
Ӏэтэ	bunch
зэпызыщӀэ	bundle
зэпыщӀэныгъэ	bundle
тегъэхьэлъэн	burden
хьэлъэ	burden
гъея	buried
исын	burn
къэуэн	burst
щӀэлъхьэн	bury
автобус	bus
чыцэ	bush
гуэрэн	bush
Ӏуэху	business
щхьэмрэ дамэхэмрэ къызэщӀэзыубыдэ скульптурэ	bust
зыхущӀэмыхьэ	busy
ауэ	but
дагъэ	butter
хьэндырабгъуэ	butterfly
щӀыӀузэтегъапкӀэ	button
кнопкэ	button
къэщэхун	buy
и гъунэгъуу	by
къезэгъыу	by the way
узыншэу	bye
апщӀэндэху	bye
къэбыстэ	cabbage
шкӀаф цӀыкӀу	cabinet
лъэ	cage
джэдылъэ	cage
торт	cake
шкӀэ	calf
къыхуеджэн	call
маржэ	call
къысхуэщӀ	call me
укъызэджа	called
сабыр	calm
къэкӀуащ	came
кампание	campaign
щӀэн	can
банк	can
хуэщӀэнукъым	can't
пщӀэну щыткъым	can't
Мыдэн	Cancel
лышх	cancer
елыркъэш	cancer
гурыхуэ	capable
ихуэныгъэ	capacity
мылъку	capital
ахъшэ	capital
тет тхыгъэ	caption
къэубыдын	capture
дэхьэхын	capture
машинэ	car
цӀыхур зыпэрыт ӀэнатӀэ	career
сакъ	careful
хуэсакъыу	carefully
къызыфӀэмыӀуэху	careless
гулъытэ зиӀэ	caring
пхъащӀэ	carpenter
алэрыбгъу	carpet
пхъы	carrot
хьын	carry
пыщэн	carry on
гъэзэщӀэн	carry out
Ӏуэху	case
Ӏэрылъхьэ	cash
хыфӀэдзэн	cast
ӀункӀыбзэ	castle
быдапӀэ	castle
зэрыхабзэ	casual
джэду	cat
къэубыдын	catch
категорие	category
хьеуан	cattle
Ӏэщ	cattle
былым	cattle
къэзубыдащ	caught
щхьэусыгъуэ	cause
щхьэусыгъуэ щӀын	cause
сакъыныгъэ	caution
зыхуэсакъыж	cautious
бгъуэнщӀагъ	cave
щыгъэтын	cease
унащхьэ щӀэӀулӀа	ceiling
къигъыхьэн	celebrate
клеткэ	cell
курыкупсэ	center
лӀэужь	century
ӀэшкӀэ	cereal
хабзэ хэхам тет гуфӀэгъуэ пшыхь	ceremony
гушхуа	certain
пцӀы хэмылъуу	certainly
сертификат	certificate
гухэлъ	chain
джабэ сатыр	chain
мурад	chain
шэнт	chair
зэхуэгъэзэн	challenge
къеджэныгъэ	challenge
Ӏэмал	chance
епцӀыжын	change
зэхэзэрыхьыныгъэ	chaos
нэрыбгэ	character
характеристикэхэр	characteristics
Ӏэщэм шэ илъхьэн	charge
псапэ	charity
узыдихьэх	charming
дэгъуэ	charming
диаграммэ	chart
ехужьэн	chase
уэршэр	chat
уэршэрын	chat
пуд	cheap
бзаджагъэ зехьэн	cheat
пцӀы	cheating
гъэпцӀагъэ	cheating
кӀэлъыплъыжыныгъэ	check
кӀэлъыплъыжын	check
нэӀу	cheek
гъэнэжэгужэн	cheer
нэщхъыфӀэ	cheerful
фӀэхъус сэлам	cheers
фӀэхъус апщий	cheers
сэлам	cheers
кхъуей	cheese
химия	chemistry
гъэлъэпӀэн	cherish
шахмат	chess
бгъэ	chest
гъэныщкӀун	chew
джэд	chicken
нэхъыщхьэ	chief
Ӏэуа	child
сабий	child
сабиигъуэ	childhood
щӀэблэ	children
сабийхэр	children
щӏыӏэ	chill
гъэщӀыӀэн	chill
уэнжакъхэр	chimneys
жьэпкъ	chin
шоколад	chocolate
къыхэхыныгъэ	choice
къыхэхын	choose
къутэн	chop
унагъуэ Ӏуэху	chores
Ӏув	chubby
пӀырыпӀ	chubby
пшэр	chubby
чылисэ	church
корицэ	cinnamon
хъурей	circle
Ӏуэхугъуэ	circumstances
гражданин	citizen
цӀыху	citizen
къалэ	city
лъэӀу тхылъ тхын	claim
лъэӀу тхылъ	claim
къыгурыгъэӀуэн	clarify
класс	class
ятӀагъуэ	clay
къабзэ	clean
гъэкъэбзэн	clear
нэху	clear
къулыкъу зыщӀ	clerk
губзыгъэ	clever
клиент	client
зи Ӏуэху зырахьэ	client
къыр	cliff
дуней щытыкӀэ	climate
дэкӀуеин	climb
дэкӀын	climb
кӀэрыхъыжьэрей	clingy
сыхьэтхэр	clock
зэхуэщӀын	close
шкӀаф	closet
щэкӀ	cloth
щыгъын	clothes
пшэ	cloud
пшэ зытелъ	cloudy
уфа	cloudy
ажэгъафэ	clown
клоун	clown
фӀэгъэнапӀэ	clue
мыкӀуэмытэ	clumsy
зэхуэсынынгъэ	cluster
гъэсэн	coach
гъэсакӀуэ	coach
фӀамыщӀ	coal
Ӏуфэ	coast
пальто	coat
къэхьэуа	coffee
кофэ	coffee
когнитивнэ	cognitive
зэтехуэныгъэ	coincidence
щӀыӀэ	cold
кӀуэдыжыныгъэ	collapse
пщэхъу	collar
лэжьэгъу	colleague
лэжьэгъу	colleagues
зэхуэхьэсын	collect
къэщыпын	collect
зэхуэс	collection
хасэ	collection
еджапӀэ	college
плъыфэ	color
фэншэ удзыфэ идеяхэр губжьауэ жеящ	colorless green ideas slept furiously
фэ	colour
плъыфэ	colour
колонкэ	column
жьын	comb
зыкъому зэхэлъ	combination
зэхэлъхьэн	combine
къэкӀуэн	come
къакӀуэ мыдэ	come here
еуэ	come on
тыншыгъуэ	comfort
тынш	comfortable
къыпэщылъ	coming
куэд мыщӀэу къэхутэнущ	coming soon
унафэ щӀын	command
тепсэлъыхьыныгъэ	comment
щэн-къэщэхун Ӏуэху	commercial
заказ	commission
щӀэн	commit
телъхьэгъу хъун	commitment
ищӀащ	committed
хьэпшып	commodity
къызэрыгуэкӀ	common
зэрыщӀэн	communicate
зэрыщӀэныгъэ	communication
зэкъуэтыныгъэ	community
нэсын	commute
зэгъусэу лажьэхэр	companion
гуп	company
зэхуэгъэдэн	compare
зэгъэпщэн	compare
зэгъэпщэныгъэ	comparison
гущӀэгъу	compassion
гулъытэ зиӀэ	compassionate
гъусэ хуэхъу	compatible
зэпеуэн	compete
фӀыуэ щыгъуазэ	competent
зэпеуэ	competition
зыпеуэ	competitive
тхьэусыхэн	complain
тхьэусыхэныгъэ	complaint
дыщӀыгъун	complement
дыщӀыгъуныгъэ	complement
ухын	complete
зэрыщыту	completely
гугъу	complex
хуэдэныгъэ	compliance
гугъу	complicated
дыщӀыгъун	compliment
едэӀуэн	comply
хуэжыӀэщӀэн	comply
зэхэт	composition
зэпыщӀэныгъэ	compound
гурыӀуэныгъэ	comprehension
нэгъэса	comprehensive
зэхудэчыныгъэм тету зэгуурыӀуэныгъэ	compromise
зыхудэчыныгъэ	compromise
фӀэкӀыпӀэ зимыӀэ	compulsory
компьютер	computer
зэхуэхьэсын	concentrate
гулъытэ зыгуэрым теубыдэн	concentrate
гурыӀуэныгъэ	concept
хуэсакъыныгьэ	concern
гулъытэ хуэщӀыныгъэ	concern
гузэвэн	concern
гузавэ	concerned
концерт	concert
кӀэух псалъэ	conclusion
бетоным къыхэщӀыкӀа	concrete
бетон гъэжын	concrete
бетон	concrete
хэкӀыпӀэ	condition
хэкӀыпӀэ	conditions
щытыкӀэ	conditions
пхыкӀын	conduct
дэкӀуэтэн	conduct
конференц	conference
зыкъэумысыжын	confess
тегушхуэныгъэ	confidence
гушхуа	confident
щыхьэт техъуэн	confirm
зэпэщӀэуэныгъэ	conflict
хэгупсысыхь	confused
Ӏэнкуныгъэ	confusion
ехъуэхъуныгъэ	congrats
хъуэхъу	congratulation
хъуэхъу	congratulations
ехъуэхъуныгъэ	congratulations
зэпыщӀэныгъэ	conjunction
зэпыщӀэн	connect
къэхьэхун	conquer
зэхэзыщӀыкӀ	conscious
зэхэщӀыкӀ	consciousness
зыгуэрым арэзы дэхъун	consent
арэзы хъуныгъэ	consent
кърикӀуэнур	consequences
хъумэныгъэ	conservation
зымыхъуэжыныгъэм и телъхьэ	conservative
егупсысын	consider
добж	considered
хэтын	consist
зэкӀэлъыкӀуэныгъэ	consistency
зэкӀэлъыкӀуэу	consistent
сыт щыгъуи къэхъу	constant
зэпымыууэ	constantly
щӀыб имыкӀыфыныгъэ	constipation
бжэӀулъэ	constipation
ухуэныгъэ	construction
къэгъэсэбэпын	consume
зэхьэлӀэн	consumption
зэпыщӀэн	contact
зэнэс	contact
зэрыцӀалэ	contagious
пӀын	contain
хэтын	contain
хэтщ	contains
иджырей	contemporary
нэмыплъ	contempt
пӀыныгьэ	content
псалъащхьэ	content
зэпеуэ	contest
мыхьэнэ уха къызэрыкӀ псалъэ гуп	context
тенджызхэм къаухъуреихь щӀыналъэ ин	continent
пыщэн	continue
зэгурыӀуэныъэ	contract
зыкъузын	contract
емыщхьыныгъэ	contrast
зэхуэмыкӀуэныгъэ къэгъэлъэгъуэн	contrast
хэлъхьэныгъэ щӀын	contribute
хэлъхьэныгъэ	contribution
зехьэныгъэ	control
зегъэкӀуэныгъэ	control
зэдауэ къэзышэ	controversial
шэч зыхэлъ	controversial
фагъ иӀэныгъэ	convenience
тынш	convenience
тынш	convenient
зэпсэлъэн	conversation
зэхъуэкӀын	convert
зи дин зыхъуэжа	convert
етын	convey
и фӀэщ щӀын	convince
зи фӀэщ хъуа	convinced
пщэфӀэн	cook
пщафӀэ	cook
гъэхьэзырыныгъэ	cooking
лъэщ	cool
щӀыӀэтыӀэ	cool
зэдэлэжьэныгъэ	cooperation
пэлъэщын	cope
гъуаплъэ	copper
купщӀэ	core
нартыху	corn
къуапэ	corner
пэж	correct
иуэсэн	cost
уасэ	cost
фащэ	costume
коттедж	cottage
бжьэхуц	cotton
тахътэ	couch
псчэн	cough
хузэфӀэкӀынут	could
чэнджэщ	council
бжэн	count
увыкӀэ	counter
къэрал	country
къуажэ	countryside
тӀу	couple
зэгъусэ	couple
лӀыгъэ	courage
гъэзыпӀэ	course
хей	court
щэныфӀагъ	courtesy
зэбынхэм я къуэ	cousin
зэшхэм я къуэ	cousin
къытегъэувэн	cover
жэм	cow
шынэкъэрабгъэ	coward
гуӀэтыпӀэ	cozy
хы елыркъэш	crab
къэча	crack
къэгъэчэн	crack
ӀэкӀэ щӀа	craft
фӀеягъэ	crap
зэтекъутэныгъэ	crash
зыгуэр къутэн	crash
гукъыдэж	craving
пщын	crawl
делэ хъуа	crazy
щӀын	create
къэгъэщӀын	create
культурэм хэлэжьыхь цӀыху	creative
щӀыхуэ	credit
пщын	creep
шынагъуэ	creepy
гуп	crew
щӀэпхъаджагъэ	crime
емыкӀу	cringe
гугъугъуэ	crisis
пщалъэ	criteria
егъэлея	critical
нэкъусэныгъэхэм тепсэлъыхьыныгъэ	criticism
критикэ	criticism
гъавэ	crop
жлэхэр	crops
жор	cross
зэпыупщӀын	cross
къуалэжь	crow
вынд	crow
гуп	crowd
цӀыху куэд	crowded
таж	crown
мыхьэнэшхуэ зиӀэ	crucial
залым	cruel
еру	cruel
псым тету нэгу зегъэужьыныгъэ	cruise
пӀытӀын	crush
лъагъуныгъэ	crush
гъын	cry
нащэ	cucumber
ӀэплӀэ зэхуэщӀын	cuddle
щэнхабзэ	culture
бзаджэ	cunning
шынакъ	cup
шеибжьэ	cup
пщэфӀапӀэ шкӀаф	cupboard
гъуэгубгъу мывэ	curb
хущхъуэ	cure
гъэхъужын	cure
комендантскэ сыхьэт	curfew
псори къищӀэну щӀэкъуныгъэ	curiosity
упщӀэрей	curious
тӀэрэз	curly
дэжей	curly
валютэ	currency
екӀуэкӀыр	current
ит зэманым къриубыдэу	currently
гыбзэ	curse
Ӏупзъуэ	curtain
щхьэнтэ	cushion
хабзэ	custom
клиент	customer
таможнэ	customs
пыупщӀын	cut
уӀэгъэ	cut
лъагъугъуафӀэ	cute
зэрызэхэт Ӏыхьэ	cycle
пӀалъэ	cycle
лъакъуэрыгъажэкӀэ къэжыхьыныгъэ	cycling
адэ	dad
адэ	daddy
папэ цӀыкӀу	daddy
махуэ къэс	daily
гъэш	dairy
псыӀущӀэ	dam
зэран хъуа	damage
зэран хуэхъун	damage
ямылъэгъужын	damn
цӀынэ	damp
къэфэн	dance
шынагъуэ	danger
шынагъуэ	dangerous
кӀыфӀ	dark
фӀынкӀ	dark
лъапӀэ	darling
зичыныгъэ	dash
зыгуэрым теухуа къэгъэлъэгъуэныгъэ	data
махуэ хэха	date
зэхуэзэныгъэ	date
пхъу	daughter
махуэ	day
лӀа	dead
пӀалъэр щиух	deadline
дэгу	deaf
зэгурыӀуэныгъэ	deal
зэхэгъэкӀын	deal
лъапӀэ	dear
Ныбжьэгъу лъапӀэхэ	Dear All
ПщӀэ зыхуэтщӀ клиент	Dear Customer
Адэ-анэ лъапӀэхэ	Dear Parents
ЩӀыху зыхуэтщӀ зиусхьэн	Dear Sir
ЩӀыху зыхуэтщӀ студентхэ	Dear students
щӀыху зыхуэтщӀ гуп	Dear Team
лӀэныгъэ	death
зэдэуэныгъэ	debate
дебет	debit
къутахуэ	debris
щӀыхуэ	debt
илъэсипщӀ щрикъу пӀалъэ	decade
зэхэкӀыныгъэ	decay
лӀа	deceased
къжгъэпцӀэн	deceive
дыгъэгъазэ	december
къэзылэжь	decent
унафэ щӀын	decide
тезухуащ	decided
щӀыжыныгъэ	decision
унафэ	decision
кхъухьым хэт щӀыпӀэ	deck
мыдэн	decline
гъэмэщӀэн	decrease
хэгъэщӀын	decrease
ета	dedicated
хуэгъэфэщэныгъэ	dedication
ӀуэхущӀафэ	deed
куу	deep
щыхь	deer
щэхукӀэ	default
текӀуэн	defeat
темыкӀуэныгъэ	defeat
хъумэн	defend
къыхэгъэкӀын	define
зэрынаӀуэщи	definitely
гъэбелджылыныгъэ	definition
зэрыхъур	degree
здынэсыр	degree
зыӀэжьэныгъэ	delay
Ӏэжьэн	delay
убыда	delayed
игъэкӀыжын	delete
хищӀыкӀыу ищӀэ	deliberate
мурад щӀа зиӀэ	deliberate
гуакӀуэ	delicate
ӀэфӀ	delicious
гухэхъуэ	delight
хуабжьу гуфӀа	delighted
Ӏэрыгъыхьэн	deliver
нэшэса	delivered
хьыныгъэ	delivery
зыхущӀэкъу	demand
къигъэувыр	demand
зыхуейр	demand
ткӀий	demanding
демократие	democracy
жин фӀыцӀэ	demon
гъэлъэгъун	demonstrate
хуидакъым	denied
хуищӀакъым	denied
Ӏувагъ	density
куэдагъ	density
дзэм елэжь дохутыр	dentist
мыдэн	deny
отдел	department
ежьэжыныгъэ	departure
епхауэ щытын	depend
елъытауэ щытын	depend
зэкӀуэцӀыхын	deploy
хэлъхьэныгъэ	deposit
хэлъхьа	deposit
нэщхъей	depressed
ехуэхыныгъэ	depression
куууагъ	depth
тетхыхьын	describe
къэтхъыхьын	description
къум	desert
къэлэжьын	deserve
проектировэннэ	design
дизайн	design
дамыгъэ тещӀэныгъэ	designation
хъуэпсэныгъэ	desire
щӀэхъуэпсын	desire
стӀол	desk
гужьеигъуэ	despair
Ӏэмалыншэ	desperate
абы емыплъу	despite
шхыныгъуэ ӀэфӀ	dessert
здызэхуэзэн щӀыпӀэ	destination
ӀуэхузэхэлъыкӀэ	destiny
насып	destiny
гъэкӀуэдын	destroy
зэтекъутэныгъэ	destruction
пкъырыпкъ	detail
зэпкърыхауэ щытыныгъэ	details
къэгъуэтыжын	detect
тегушхуэныгъэ	determination
къыхэгъэкӀын	determine
хъыжьэ	determined
мылъкуншэ ящӀа	devastated
шэщӀын	develop
зызыужьа	developed
зегъэужьын	development
зэхэтыкӀэ	device
шейтӀан	devil
пэж	devoted
Дивехэ	Dhivehi
диабет	diabetes
фошыгъууз	diabetes
ныбажэ	diarrhea
махуэрытх	diary
дневник	diary
псалъалъэ	dictionary
ищӀащ	did
лӀэн	die
лӀащ	died
диетэ	diet
зэщхьэщыкӀыныгъэ	difference
нэгъуэщӀ	different
гугъу	difficult
къэтӀын	dig
фӀагъ	dignity
жыӀэдаӀуэ	diligent
пщыхьэщхьэ шхын	dinner
хэщӀэн	dip
щӀэгъэмбырыуэн	dip
захуэ	direct
гъэкӀуэныгъэ	direction
режиссер	director
фӀей	dirt
фӀей	dirty
гъэункӀыфӀын	disable
къичын	disable
Ӏучын	disable
ныкъуэдыкъуэ	disabled
кӀуэдын	disappear
зэщыгъэуа	disappointed
насыпыншагъэ	disaster
хыфӀэдзэн	discard
къыхэгъэщхьэхукӀын	discharge
къыхэгъэщын	discharge
дисциплинэ	discipline
кӀэрыгъэхуныгъэ	discount
техын	discover
зэхэгъэжыныгъэ	discrimination
тепсэлъыхьын	discuss
тепсэлъыхьыныгъэ	discussion
уз хэхын	disease
узхэр	diseases
зыщӀэхъумэныгъэ	disguise
гущыкӀыгъуэ	disgusting
шхыныгъуэ	dish
хьэкъущыкъу	dishes
мыдэн	dismiss
егъэхьыныгъэ	dispatch
къызытещын	display
етӀуанэу къэгъэсэбэпыныгъэ	disposal
дауэ	dispute
зэныкъуэкъу	dispute
зэхуаку	distance
ӀупщӀ	distinct
зэмыщхьу хэлъыр зыхэгъэкӀын	distinguish
къулейсызыгъэ хьэлъэ	distress
тегуэшэныгъэ	distribution
зэхэщӀыкӀыгъуафӀэ	district
гъэгузэвэн	disturb
зэран хъун	disturb
кӀэнауэ	ditch
зыщӀэгъэмбрыуэн	dive
зэмылӀэужьыгъуэ	diverse
зэмылӀэужьыгъуэ	diversity
зэкӀэщӀэхын	divide
тхьэпэлъытэ	divine
зэбгъэдэкӀыжыныгъэ	divorce
зэбгъэдэкӀыжын	divorce
щхьэр мэуназэ	dizzy
щӀэн	do
уэ	do you
уэ фӀыуэ сыплъагъурэ	do you love me
уэ фӀыуэ сыболъагъу	do you love me
дохутыр	doctor
щыхьэт тхылъ	document
ещӀэ	does
къым	doesn't
хьэ	dog
Догрэ	Dogri
ещӀэ	doing
гуащэ	doll
иӀэныгъэ	domain
унагъуэ	domestic
ебэкӀ	dominant
хуейкъым	don't
Умыгузавэ	Don't worry
тэн	donate
хьэзырщ	done
шыд	donkey
афиян	dope
зэтӀолъхуэныкъуэ	double
тӀукӀэ гъэбэгъуэн	double
шэч	doubt
шэч къытехьэн	doubt
хупцӀынэ	dough
тхьэв	dough
и лъабжьэ	down
илъхьэн	download
проект гъэхьэзырын	draft
пэрытх	draft
лъэфын	drag
ижыпӀэ	drain
драмэ	drama
сурэт щӀын	draw
ашык	drawer
сурэт	drawing
ӀэкӀэ щӀа сурэт	drawing
шынагъуэ	dread
хъуэпсапӀэ	dream
хъуэпсэн	dream
цӀыхубз щыгъын	dress
бостей	dress
щӀэныгъэ	drill
зэфэ гуэр	drink
ефэн	drink
шэн	drive
ткӀуэпс	drop
ӀэщӀэхун	drop
Ӏэпыхуащ	dropped
уэгъу	drought
чэф	drunk
гъущэ	dry
бабыщ	duck
цӀыху	dude
хуэфащэ	due
езэгъ	due
къыхэкӀкӀэ	due to
узыгъэзэш	dull
делэ	dumb
акъмыкъ	dumb
къедзыхын	dump
хыфӀэдзэн	dump
зэрекӀуэкӀыр	duration
а зэманым	during
сабэ	dust
къалэн	duty
щыпсэун	dwell
лӀэр	dying
зи псэ хэкӀыр	dying
дэтхэнэри	each
зыр зым	each other
зыхуэмышэч	eager
бгъэ	eagle
тхьэкӀумэ	ear
ипэӀуэкӀэ	earlier
жьыуэ	early
къэлэжьын	earn
тхьэкӀумэ	ears
щӀы	earth
щӀыхъеиныгъэ	earthquake
тыншыгъэ	ease
псынщӀагъэ	ease
Тынш	easily
къуэкӀыпӀэ	east
псынщӀэ	easy
тынш	easy
щыӀэщ	eat
шхэн	eat
шхыныгъуэ	eating
ерыскъы	eating
экономическэ	economic
экономикэ	economy
кӀапэ	edge
зэгъэзэхуэжын	edit
хэлэжьыжыхьын	edit
щӀэныгъэ	education
къыщыхъуныгъэ	effect
сэбэп хъу	effective
мыхьэнэуэ хэлъыр	efficiency
сэбэп хъу	efficient
гъэлъэщыныгъэ	effort
джэдыкӀэ	egg
и фэкӀэ морэу и щытыкӀэкӀэ нащэм ещхь хадэхэкӀ	eggplant
баклажан	eggplant
щхьэзыфӀэфӀыныгъэ	ego
и	eight
пщыкӀуий	eighteen
ищӀ	eighty
е	either
гугъу	elaborate
ӀэфракӀэ	elbow
нэхъыжь	elder
тӀорысэ	elderly
зи ныбжь хэкӀуэта	elderly
щӀыкӀафэ	elegant
Ӏыхьэ	element
пыл	elephant
пщыкӀуз	eleven
хуитыныгъэ зиӀэ	eligible
гъэкӀуэдын	eliminate
апхуэдэу	else
укӀыта	embarrassed
мыӀэкӀуэлъакӀуэ	embarrassing
къэщтэн	embrace
къэхутэн	emerge
къыкъуэкӀын	emerge
пӀащӀэгъуэ	emergency
зыхэзыщӀэ	emotional
щхьэрыжэ зыщӀ	emotional
цӀыхум и гурыгъу-гурыщӀэр дэӀыгъын	empathy
гулъытэ хэха зыгуэрым етын	emphasis
бзэм щыщӀагъэ хэлъу псэлъэныгъэ	emphasis
къыхэгъэщын	emphasize
къыхэгъэбелджылыкӀын	emphasize
лэжьакӀуэ	employee
лэжьакӀуэ	employees
лэжьапӀэт	employer
лэжьапӀэ уиӀэныгъэ	employment
нэщӀ	empty
щӀэгъэнэн	enable
хуэзэн	encounter
къегъэблагъэн	encounter
гъэгушхуэн	encourage
кӀэух	end
кӀэ	end
кӀуэд	endangered
бзэх	endangered
къару щӀэлъхьэныгъэ	endeavor
егугъуныгъэ	endeavor
бэшэчагъ	endurance
къыщӀэхын	endure
жагъуэгъу	enemy
къару	energy
хэшэн	engage
хущӀэмыхьэ	engaged
яубыда	engaged
хэтыныгъэ	engagement
зезыгъакӀуэ	engine
ухуакӀуэ	engineer
Иджылыбзэ	English
егъэфӀэкӀуэн	enhance
гур хэхъуэн	enjoy
инышхуэ	enormous
ирикъу	enough
зыхуейр хуэгъзэн	ensure
щӀыхьэн	enter
хыхьэн	enter
нэгузегъэужьыныгъэ	entertainment
гурэ псэкӀэ Ӏуэхум бгъэдэтын	enthusiasm
дихьэха	enthusiastic
псо	entire
хуитыныгъэ иӀэщ	entitled
купщӀэ	entity
щӀыхьэпӀэ	entrance
хьэрычэтыщӀэ	entrepreneur
письмоулъэ	envelope
къэзыухъуреихь дуней	environment
ефыгъуэн	envy
эпическэ	epic
сабыр	epic
уз зэрыцӀалэм зиубгъуныгъэ	epidemic
эпидемие	epidemic
хуэдэ	equal
къызэгъэпэщын	equipment
зэхуэдэныгъэ	equity
зэпэбж	equivalent
хьэфэтегъэкӀ	eraser
щыуагъэ	error
щӀэпхъуэжыныгъэ	escape
псом хуэмыдэу	especially
сочиненэ	essay
мыхьэнэ	essence
купщӀэ	essence
узыхуэныкъуэ	essential
тегъэувэн	establish
къэгъэхъуа	established
помещикым и ӀэмыщӀэ илъ щӀы	estate
къэлъытэн	estimate
бжа	estimated
нэгъу	etc
зэпымыу	eternal
мыкӀуэдыж	eternal
гъэсэныгъэ	ethics
пщӀэ хуэгъэувын	evaluate
уасэ хуэщӀын	evaluate
оценкэ	evaluation
уеблэмэ	even
пэтми	even though
пщыхьэщхьэ	evening
къэхъукъащӀэ	event
ипкъ иткӀэ	eventually
дапщэщи	ever
сыт щыгъуи	ever
дэтхэнэри	every
псори	everybody
псори	everyone
псори	everything
щыхьэт	evidence
Ӏей	evil
эволюцэ	evolution
зыужьын	evolve
Эвэ	Ewe
щыта	ex
техуэпс	exact
хуэдэпс	exact
хуэфӀыпс	exactly
хуэдэ	exactly
къэпщытэныгъэ	exam
экзамен	exam
еплъын	examine
щапхъэ	example
щӀегъэгъун	exceed
фӀы дыдэ	excellent
абы нэмыщӀ	except
къыхэдзыныгъэ	exception
лей	excess
егъэлея	excessive
хъуэжыныгъэ	exchange
гузавэ	excited
гузавэ	excitement
узэщӀэзыубыдэ	exciting
хэха	exclusive
хей щӀыныгъэ	excuse
щыхьэтлыкъ	excuse
къысхуэгъэгъу	excuse me
гъэзэщӀэн	execute
укӀ	execution
щхьэр пылъэныгъэ	execution
зыгъэзащӀэ	executive
зегъэужьын	exercise
зегъэужьыныгъэ	exercise
къарууншэ щӀын	exhaust
езэша	exhausted
музейм щӀэт хьэпшып	exhibit
гъэлъэгъуэныгъэ	exhibition
гъэлъэгъуапӀэ	exhibition
псэун	exist
щыӀэныгъэ	existence
щыӀэ	existing
щӀэкӀыпӀэ	exit
къыдэкӀыныгъэ	exit
убгъун	expand
ежьэн	expect
зэжьэ	expected
гъэкӀуэдыныгъэ	expenses
лъапӀэ	expensive
щыгъузэныгъэ	experience
зэхэщӀэн	experience
гъэунэхуныгъэ	experiment
эксперт	expert
Ӏуэхум хэзыщӀыкӀ	expert
зи пӀалъэ блэкӀа	expired
гурыгъэӀуэн	explain
гурыӀуэныгъэ	explanation
гъэпщылӀын	exploit
зыщӀэубыдэжын	exploit
къэпщытакӀуэ	explore
сату ӀуэхукӀэ къэралым ираш хьэпшыпхэр	export
экспорт	export
къызэщӀэгъэстын	expose
Ӏуха	exposed
зэӀуха	exposed
хэлэжьыхьын	exposure
къикӀын	express
жыӀэн	express
жыӀэкӀэ	expression
пыщэн	extend
убгъуа	extended
гъэӀэбэн	extension
зэрыхъур	extent
зыдынэсыр	extent
теплъэ	external
щымыӀэж	extinct
щӀыгъу	extra
къыхэхын	extract
зыми емыщхь	extraordinary
тегушхуэныгъэ егъэлея зыхэлъ	extreme
мыхьэнэшхуэ зиӀэ	extremely
нэ	eye
нэ	eyes
щэкӀ	fabric
гъуэзэджэ	fabulous
зэпэщӀэуэныгъэ	face
нэкӀу	face
сэбэп хъун	facilitate
объектхэр	facilities
щӀыпӀэхэр	facilities
зэхэтыныгъэ	facility
факт	fact
Ӏуэхугъуэ	factor
завод	factory
щыхьэтхэр	facts
ункӀыфӀын	fade
ужьыхын	fade
къемыхъулӀэныгъэ шэчын	fail
къемыхъулӀэныгъэ	fail
къемыхъулӀа	failed
кӀуэцӀрыхун	failure
къарууншэ	faint
пэж	fair
нэху	fair
куэд	fairly
арэзыуэ	fairly
тхьэӀухуд	fairy
фӀэщхъуныгъэ	faith
пэж	faithful
нэпцӀ	fake
ехуэныгъэ	fall
джэлэныгъэ	fall
джэлэн	fall
ПЦӀЫ	false
фӀыщӀэ	fame
цӀыхугъэ	familiar
унагъуэ	family
гъаблэ	famine
мэжэлӀэныгъэ	famine
цӀэрыӀуэ	famous
фӀыуэ къэзылъагъу	fan
жьыху	fan
къызэрымыгуэкӀ	fancy
хьэлэмэт	fantastic
жыжьэ	far
сэлам зэхыжыныгъэ	farewell
псэущхьэхэр щызэрахьэ щӀыпӀэ	farm
бэджэнду зыӀыгъ	farmer
гъэщӀэгъуэн	fascinating
щӀэуэ къежьа	fashion
псынщӀэ	fast
пшэр	fat
лӀэныгъэ зыхэлъ	fatal
тхьэм иухауэ щыт	fatal
натӀэм ит	fate
насып	fate
адэ	father
ешын	fatigue
къуаншагъэ	fault
фӀылъагъупӀэ	favorite
фӀыуэ ялъагъу	favorite
Ӏуэхутхьэбзэ	favour
щӀасэ	favourite
фӀыуэ ялъагъу	favourite
шынэ	fear
шынэн	fear
ефэ-ешхэ	feast
санэхуафэ	feast
къабзий	feather
къалэм	feather
щӀэгъэнэн	feature
гъунапкъэ	feature
къызэрыхэщхьэхукӀ	features
мазае	february
тэмакъым щызщ	fed up
пщӀэ	fee
гъэшхэн	feed
пэджэжыныгъэ	feedback
зэхэщӀыкӀын	feel
гухэлъ	feeling
лъэдакъэ	feet
джэлащ	fell
щӀалэ	fellow
цей	felt
шухьэ	felt
бзы	female
бжыхь	fence
гъавэ бэв къыщыкӀ	fertile
фестиваль	festival
къэхьын	fetch
техьэгъуэ	fever
тӀэкӀу	few
нэхъ мащӀэ	fewer
финансхэр	fiance
къэгупсыса	fiction
губгъуэ	field
губжьа	fierce
пщыкӀутху	fifteen
тхущӀ	fifty
зэзауэ	fight
зэуэн	fight
зауэм епха	fighting
лӀыгъэ зыхэлъ	fighting
пкъыгъуэ	figure
къыхэхын	figure
зэхэгъэкӀын	figure out
файл	file
итхэн	fill
итха	filled
щӀэз	filled
пленкэ	film
фэпс	film
фэ пӀащӀэ	film
фӀей	filthy
иджыкӀэ	finally
финанс	finance
финансэвэ	financial
къэгъуэтын	find
зэхэгъэкӀын	find out
фӀы	fine
тезыр	fine
Ӏэпэ	finger
Ӏэпхъуамбэ	finger
кӀэух	finish
уха	finished
кӀэ зэта	finished
мафӀэ	fire
быдэ	firm
фирмэ	firm
япэ	first
цӀэ	first name
бдзэжьей	fish
бгъэдыхьэн	fit
тху	five
зэгъэзэхуэжын	fix
мыхъей	fixed
нып	flag
къэлыдыныгъэ	flash
къэунэхуныгъэ	flash
захуэ	flat
фэтэр	flat
ныкъусаныгъэ	flaw
щыщӀагъэ	flaw
дагъуэншэ	flawless
щӀэпхъуэжын	flee
пкъы	flesh
лъэтат	flew
къэгъэшын	flex
лантӀэ	flexible
лъэтэныгъэ	flight
зэгъэзэнкӀын	flip
зыкъыпегъэхын	flirt
зыкъыпегъэхыныгъэ	flirting
есын	float
псыдзэ	flood
псыкъиу	flood
лъэгу	floor
хьэжыгъэ	flour
ежэхын	flow
псы уэр	flow
удз гъэгъа	flower
псчэ Ӏэпкълъэпкъ	flu
щӀэпхъуэжа	fluent
псынщӀэу	fluently
цы щабэ	fluffy
ткӀуаткӀуэ	fluid
лъэтэн	fly
зэхуэхьэсыныгъэ	focus
пшагъуэ	fog
пшагъуэ	foggy
зэгъэлъа	fold
цӀыхухэр	folks
цӀыхубэ	folks
кӀэлъыкӀуэн	follow
кӀэлъыплъын	follow up
къыкӀэлъыкӀуэр	following
шхын	food
делэ	fool
къэгъэпцӀэн	fool
делэ	foolish
лъапэ	foot
топджэгу	football
щхьэ	for
Псалъэм папщӀэ	For example
псалъэм папщӀэ	for instance
уэ щхьэ	for you
зыхуимыт	forbidden
къару	force
хуэгъэфэщэныгъэ	forecast
натӀэ	forehead
хамэ	foreign
мэз	forest
игъащӀэкӀэ	forever
зыщыгъэгъупщэн	forget
хуэгъэгъун	forgive
щыпщэжащ	forgot
гуахъуэ	fork
щытыкӀэ къегъэщтэн	form
щытыкӀэ	form
формальнэ	formal
щыӀа	former
щыта	former
насыпти	fortunately
щытыкӀэ	fortune
плӀыщӀ	forty
плӀыщӀрэ тӀу	forty-two
япэкӀэ	forward
дэгъэпсынщӀэн	foster
зэуащ	fought
къэзгъуэтащ	found
щӀэдзапӀэ	foundation
лъабжьэ	foundation
плӀы	four
пщыкӀуплӀ	fourteen
бажэ	fox
тӀасхъэ	fragile
къутэгъуафӀэ	fragile
гъунапкъэ	frame
лъабжьэ	framework
пцӀыӀуэпцӀышагъэ	fraud
Ӏуплъэгъуей	freak
хуит	free
хуитыныгъэ	freedom
пӀыщӀэн	freeze
щтын	freeze
къызэрытригъэзэж пӀалъэ	frequency
куэдрэ	frequent
Ней	frequent
куэдрэ	frequently
щӀэ	fresh
мэрем	friday
щӀыӀалъэ	fridge
ныбжьэгъу	friend
ныбжьэгъугъэ	friendly
ныбжьэгъу	friends
зэныбжьэгъуныгъэ	friendship
шына	frightened
зыгъащтэ	frightening
хьэндыркъуакъуэ	frog
и	from
ипэ	front
гъэщта	frozen
пхъэщхьэмыщхьэ	fruit
къытехьа	frustrated
гъэсыныпхъэ	fuel
Фулэ	Fulfulde
из	full
гуфӀэгъуэ	fun
лэжьэкӀэ	function
куу	fundamental
зэпэщ	fundamental
хьэдэщӀэлъхьэ	funeral
дыхьэшхэн	funny
псэущхьэц	fur
губжьа	furious
унэлъащӀэ	furniture
адэкӀэ	further
абы къыщынэмыщӀауэ	furthermore
къэкӀуэну	future
фейдэ	gain
къыӀэрыхьэн	gain
джэгукӀэ	game
щӀыпӀэ нэщӀ	gap
машинэхэр зыщӀэтыпӀэ	garage
пхъэнкӀий	garbage
жыг хадэ	garden
сад	garden
бжьыныху	garlic
дыхьэпӀэ	gate
куэбжэ	gate
зэщӀэкъуэн	gather
зэхуэс	gathering
хасэ	gathering
къэпщын	gauge
иритащ	gave
шесторкэшхуэ	gear
гендер	gender
зэдай	general
зэхуэдэ	general
къапщтэмэ	generally
къыдэгъэкӀын	generate
къэгупсысын	generate
щӀэблэ	generation
хьэлэл	generous
егъэлеяуэ акъылыфӀэ цӀыху	genius
жанр	genre
гуакӀуэ	gentle
зыми къытрамыщӀыкӀа	genuine
Ӏэ щӀыныгъэ	gesture
Ӏэрыхьэн	get
зыхуэпэн	get dressed
къэтэджын	get up
псынщӀэу зыгъэхъууж	get well soon
къеӀыхыныгъэ	getting
хьэдэджадэ	ghost
тӀуу хъуныгъэ	ghosting
тӀуащӀэ	ghosting
абрагъуэ	giant
саугъэт	gift
гъуаплъафэ	ginger
хъыджэбз цӀыкӀу	girl
хъыджэбз	girlfriend
етын	give
зытын	give up
мы	given
та	given
арэзы	glad
плъэкӀэ	glance
Ӏэбдж	glass
нэгъуджэ	glasses
плъэкӀэ	glimpse
дунейр къызыщӀэзыщтэ	global
кӀыфӀ	gloomy
нэщхъей	gloomy
Ӏэлъэ	gloves
нэху къыщхьэщихын	glow
нэху	glow
зэщӀэнэн	glow up
зыгъэлъэгъуэн	glow up
шхэпс	glue
кӀуэн	go
ипэ уиту кӀуэ	go ahead
ӀукӀ	go away
жеин кӀуэн	go to bed
нэщэнэ	goal
мурад	goal
нэщанэхэр	goals
мурадхэр	goals
бжэн	goat
Алыхь	god
алыхьым ифӀ къыпщыхуэ	god bless you
макӀуэ	goes
къокӀуэ	going
йокӀуэкӀ	going
зегъэхьэзыр	going to
дыщэ	gold
ӀукӀащ	gone
зегъэхьэзыр	gonna
цӀанлъагъэ	goo
фӀы	good
фӀыр	good
махуэ фӀыуэ	good afternoon
фӀыкӀэ дызэхузэ	good bye
махуэ фӀыуэ	good day
пщыхьэщхьэ фӀыуэ	good evening
лэжьыгъэфӀ	good job
дахэ	good looking
ехъулӀэныгъэ	good luck
уи пщэддыжь фӀыуэ	good morning
уи пщэдджыжь фӀыуэ, фӀыуэ слъагъу	good morning my love
нэхулъэфӀ укъикӀ	good night
фӀыкӀэ дызэхузэ	goodbye
нэхулъэфӀ укъикӀ	goodnight
хьэпшыпхэр	goods
Гугл	Google
Гугл зэдзэкӀакӀуэ	Google Translate
къаз	goose
гъуэзэджэ	gorgeous
бзэгу зехьэн	gossip
хъыбарыпцӀ Ӏуэтэн	gossip
къыӀэрыхьащ	got
къыгурыӀуащ	got it
правительствэ	government
къэубыдын	grab
уасэ хуэщӀын	grade
хуэм-хуэмурэ	gradually
къыдэгъэкӀын	graduate
къыщӀэкӀын	graduate
хьэдзэ	grain
етын	grant
етащ	granted
жызум	grapes
убыдыкӀэ	grasp
удз	grass
фӀыщӀэ зыщӀ	grateful
фӀыщӀэ хуэщӀын	gratitude
кхъэ	grave
щхъуэ	gray
дахэ дыдэ	great
нэпсеигъэ	greed
быдэныгъэ	greed
нэпсей	greedy
удзыфэ	green
къегъэблэгъэн	greet
къегъэблэгъэныгъэ	greeting
фӀэхъус	greeting
фӀэхъус сэлам	greetings
щхъуэ	grey
хъар	grid
нэщхъеягъуэ	grief
хьэжын	grind
убыдыныгъэ	grip
къэпхъуэтэныгъэ	grip
шхыныгъуэ здащэ тыкуэн	grocery
щауэ	groom
Ӏей	gross
цӀапӀэ	gross
щӀы	ground
гуп	group
хэхъуэн	grow
хэхъуэныгъэ	growth
лъэгагъ	growth
гъумэтӀымэрей	grumpy
Гуаранэ	Guarani
гъэгугъэн	guarantee
хъумакӀуэ	guard
плъыр	guard
къэщӀэн	guess
хьэщӀэ	guest
унафэ зыщӀ	guidance
нэхъыщхьэ	guidance
хуэгъэзэн	guide
гъэзэщӏапхъэ	guide
къуаншэ	guilty
щӀалэ	guy
ныбжьыщӀэхэ	guys
спортзал	gym
зэса	habit
щыпсэу щӀыпӀэ	habitat
иӀащ	had
уэ	hail
щхьэц	hair
ныкъуэ	half
пэшышхуэ	hall
зал	hall
Ӏэгу	hand
ручкэ	handle
дахэ	handsome
фӀэлъын	hang
къэхъун	happen
къэхъуащ	happened
насып	happiness
насыпыфӀэ	happy
укъыщалъхуа махуэмкӀэ сынохъуэхъу	happy birthday
къыщалъхуа махуэ	happy birthday
Укъыщалъхуа махуэмкӀэ	happy birthday to you
илъэсыщӀэ къихьамкӀэ сынохъуэхъу	happy new year
ткӀий	hard
ерагъкӀэ	hardly
къудей	hardly
тӀэкӀукӀэ	hardly
зэикӀ къанэ щымыӀэу	hardly ever
зэраныгъэ щӀэн	harm
зэраныгъэ	harm
зэраныщӀэ	harmful
зэкӀуныгъэ	harmony
ткӀий	harsh
зэхуэхьэсын	harvest
зэхуэгъэсын	harvest
иӀэщ	has
теплъэ мыхъуныгъэ	hate
диӀэн	have
иӀэн	have
махуэ фӀыуэ	have a good day
махуэ фӀыуэ	have a nice day
пщэдджьыжьышхэ щӀын	have breakfast
уи нэгу зегъэужь	have fun
уэ ушхащ	have you eaten
уэ ушха	have you eaten
зиӀэ	having
шынэ	hazard
гъуэз	haze
ар	he
абы иӀэщ	he has
ар щытщ	he is
ар хэтщ	he is
щхьэ	head
щхьэ уз	headache
гъэхъужын	heal
еӀэзэныгъэ	healing
узыншагъэ	health
узыншэ	healthy
зэхэхын	hear
зыхэсхащ	heard
гу	heart
кьэхуэбэн	heat
хуабащэ	heat
уафэ	heaven
хьэлэ	heavy
гужьея	hectic
лъэгагъ	height
щӀэинхьыж	heir
къэхъущӀэныгъэ	heist
игъын	held
жыхьэнэмэ	hell
ФӀэхъус апщий	Hello
уузыншэ, лъапӀэ	hello dear
фӀэхъупс апщи, уи Ӏуэхухэр дауэ щыт?	hello how are you
сэлам, дауэ ущыт	hello how are you doing
таж пыӀэ	helmet
дэӀэпыкъун	help
сэбэп	helpful
абы къыхэкӀкӀэ	hence
абы	her
хъушэ	herd
мыбдеж	here
щӀэин	heritage
сысын	hesitate
ечэнджэщын	hesitate
Ей	Hey
Сэлам	Hi
сэлам, дауэ ущыт	hi how are you
Сэлам	Hi there
гъэпщкӀуа	hidden
зыгъэпщкӀун	hide
тепщэныгъэ здэщыӀэ	hierarchy
лъагэ	high
щӀэтхъэн	highlight
къыхэгъэщын	highlight
зекӀуэ	hike
зекӀуэ кӀуэныгъэ	hiking
дыхьэшхэн	hilarious
Ӏуащхьэ	hill
ар	him
абы	him
еӀуэкӀын	hint
куэ	hip
куэхэр	hips
къэщтэн	hire
лэжьакӀуэщӀэ къэщтэныгъэ	hiring
и	his
ар	his
абы	his
хъыбар	history
тхыдэ	history
еууэн	hit
Хьм	Hmm
хобби	hobby
дихьэхыныгъэ	hobby
Ӏыгъын	hold
зыӀыгъын	hold on
гъуанэ	hole
махууэшхуэ	holiday
нэщӀ	hollow
унэ	home
унэ лэжьыгъэ	homework
цӀыху пэж	honest
пэжу	honestly
ЛъапӀэ	Honey
Фо	Honey
напэ	honor
капюшон	hood
къэрэкъэш	hook
дэлъеин	hop
гугъэ	hope
щыгугъын	hope
нэхъыфӀ	hopefully
гугъэпӀэншэ	hopeless
щылъу шэщӀа	horizontal
бжьакъуэ	horn
гуих	horrible
шынагъуэ	horror
шы	horse
сымаджэщ	hospital
хьэщӀэ хуэфӀыгъэ	hospitality
къегъэблэгъэн	host
зей	host
жэгъуэгъу зыхэлъ	hostile
пщтыр	hot
хьэщӀэщ	hotel
сыхьэт	hour
сыхьэт	hours
унэ	house
унэгъуэ Ӏуэху	household
дауэ	how
уэ-щэ	how about you
дауэ щыт	how are you
уи Ӏуэхухэр дауэ щыт	how are you doing
нобэ дауэ щыт уи Ӏуэхухэр	how are you doing today
дауэ ущыт нобэ	how are you today
дауэ упсэурэ	how do you do
дауэ	how is
дапщэ	how many
дапщэ	how much
дауэ щӀэх-щӀэхыу	how often
илъэс дапщэ ухъурэ	how old are you
дауэ кӀуа уи махуэр	how was your day
дауэ кӀуа уи пщыхьэщхьэр	how was your night
ауэ	however
ку	hub
лӀы	hubby
щхьэгъусэ	hubby
ӀэплӀэ	hug
ӀэплӀэ хуэщӀын	hug
инышхуэ	huge
цӀыху	human
нэмысыфӀэ	humble
псыӀэ	humid
псыӀагъ	humidity
ЩэкӀуэгъуэ	hundred
мэжалӀэ	hungry
ещэкӀуэн	hunt
щэкӀуэн	hunt
борэн	hurricane
пӀэщӀэн	hurry
зыгъэхъей	hurry up
сымэджэн	hurt
щхьэгъусэ	husband
сэбэпыншэ	hustle
зэхэзежэ	hustle
тэхъуанэ	hut
къабзагъэ	hygiene
Сэ	I
Сэ сыщытщ	I am
Сэ си Ӏуэхухэр тэмэмщ	I am fine
Сэ схуэщӀэнущ	I can
Сэ схузэфӀэкӀкъым	I can't
Сэ сощӀ	I do
Сэ сщӀэркъым	I do not know
Сэ къызгурыӀуэркъым	I do not understand
Сэракъым	I don't
Сэ сщӀэркъым	I don't know
Сэ къызгурыӀуэкъым	I don't understand
уэ зи гугъу пщӀыр	I don't understand what you mean
Сэ къызгурыӀуэкръым	I don't understand what you mean
Сэ уэ укъызгурыӀуэркъым	I don't understand you
Сэ сщӀэркъым	I don’t know
Сэ къызгурыӀуэркъым	I don’t understand
хъунщ	i guess
Сэ сиӀащ	I had
Сэ сиӀэщ	I have
Сэ сыщытащ	I have been
Сэ сыщыӀащ	I have been
Сэ согугъэ	I hope so
Сэ сощӀэ	I know
Сигу ирохь	I like
Сэ уэ сигу урохь	I like you
Сэ фӀыуэ солъагъу	I love
Сэ си дэлъху нэхъыжьыр фӀыуэ солъагъу	I love my big brother
Сэ си шыпхъу нэхъыжьыр фӀыуэ солъагъу	I love my big sister
Сэ си адэр фӀыуэ солъагъу	I love my father
Сэ си дэлъху нэхъыщӀэр фӀыуэ солъагъу	I love my little brother
Сэ си шыпхъу нэхъыщӀэр фӀыуэ солъагъу	I love my little sister
Сэ си анэр фӀыуэ солъагъу	I love my mother
Сэ уэ фӀыуэ узолъагъу	I love you
Сэ уэ зыкӀэ фӀыуэ узолъагъури	I love you so much
Сэри фӀыуэ узолъагъу	I love you too
Сэ жыхуэсӀар	I mean
Сэ уэ сигу укъокӀ	I miss you
Сэ зыкӀэ сигу укъэкӀащи	I miss you so much
Сэ солъагъу	I see
Сэ согупсыс	I think
Сэ къызгуроӀуэ	I understand
Сэ сыхуейщ	I want
Сэ уэ услъагъуну сыхуейщ	I want to see you
Сэ уэ сыпхуейщ	I want you
Сэ сыщыӀащ	I was
Сэ сыщыӀэнущ	I will
Сэ сыщытынут	I would be
Сэ сыщыӀэнут	I would be
Сэ сыщытщ	I'm
Сэ сыхъарзынэщ	I'm fine
Сэ сытэмэмщ	I'm good
Сымис	I'm here
Сэ си жагъуэщ	I'm sorry
мыл	ice
фоӀумыл	ice cream
морожнэ	ice cream
идея	idea
щапхъэ нэс	ideal
хущӀэкъуныгъэ лъагэ	ideal
зэщхь	identical
зэхэгъэкӀын	identify
гъэунэхун	identity
ахьмакъ	idiot
делэ	idiot
Ӏуэхуншэ	idle
мэ	if
Ӏумпэм щӀын	ignore
сымаджэ	ill
хабзэм темыт	illegal
узыфэ	illness
Илонскэ	Ilocano
сурэт	image
къэгъэлъэгъуэныгъэ	image
къызыщыгъэхъун	imagine
щӀэх	immediate
пӀалъэ зимыӀэ	immediate
икӀэщӀыпӀэкӀэ	immediately
абрагъуэ	immense
Ӏумэт	impact
пхырыкӀ зиӀэ	impact
шыӀэныгъэншэ	impatient
хэшэн	implement
импорт	import
импорт щӀын	import
мыхьэнэшхуэ зиӀэ	important
кӀэрыщӀэн	impose
хъункӀэ Ӏэмал зимыӀэ	impossible
гукъинэ щыхъун	impress
гукъинэ	impression
гукъинэ	impressive
нэхъыфӀ щӀын	improve
ефӀэкӀуэныгъэ	improvement
нэхъыфӀ хъуныгъэ	improvement
дыщӀыгъуу	in addition
ЗэрыщытымкӀэ	In fact
пащхьэ	in front of
деж	in front of
щхьэ	in order to
къемыкӀу	inappropriate
тезыгъэгушхуэ	incentive
мыхъумыщӀагъэ	incident
хэтхэн	include
хэгъыхьэн	include
хэгъэхьауэ	including
хэхъуэныгъэ	income
фейдэ	income
мытыншыгъэ	inconvenience
хэгъэхъуэныгъэ	increase
хэгъэхъуэн	increase
хэхъуп	increased
щхьэм къимытӀасэ	incredible
пэж дыдэу	indeed
зыми щымыгугъ	independent
Индие	India
гъэлъэгъуэн	indicate
къызэралъхурэ	indigenous
нэхъыщхьэ	indigenous
ипэм щыщӀэдзауэ	indigenous
цӀыху	individual
промышленность	industry
фӀэкӀ зимыӀэ	inevitable
сабий цӀынэ	infant
Ӏэуа	infant
зэрыцӀалэ уз	infection
мыухыж	infinity
къэпщыныгъэ	inflammation
бэгыныгъэ	inflammation
инфляцэ	inflation
хэлӀыфӀыхьыныгъэ	influence
лъэкӀыныгъэ	influence
хъыбар егъэщӀэн	inform
зэдащӀэ	information
информацэ	information
халъхьэхэр	ingredients
щӀэин	inheritance
пэублэ	initial
гукъыдэжыныгъэ	initiative
уӀэгъэ зиӀэ	injured
удын	injury
фэбжь	injury
къуаншэкъым	innocent
мыкъуаншэ	innocent
щӀэ гуэр дунейм къытехьэныгъэ	innovation
щӀэупщӀэныгъэ	inquiry
делэ хъуа	insane
хпщхупщ	insect
зигурэ зи щхьэрэ зэтемылъ	insecure
хэлъхьэн	insert
хэгъэувэн	insert
и кӀуэцӀым	inside
къэщӀэжыныгъэ	insight
къэунэхуныгъэ	insight
тегъэкӀыныхьын	insist
жеиншагъэ	insomnia
гухэхъуэгъуэ	inspiration
къыхуэгъэушын	inspire
тегъэувэн	install
къэхъуныгъэ	instance
напӀэзыпӀэ	instant
и пӀэкӀэ	instead
пӀэкӀэ	instead of
жыпхъэ	instructions
Ӏэмэпсымэ	instrument
икӀагъэ	insult
страховкэ	insurance
зэгурыӀуэныгъэ	insurance
хъумэнкӀэ зэгурыӀуэныгъэ	insurance
сэкъатыншэ	intact
псо	integrity
акъылыфӀэ	intellectual
акъыл	intelligence
губзыгъэ	intelligent
гугъэн	intend
хухэха	intended
гузэва	intense
мурад	intention
зэдэщӀэн	interact
зэдэщӀэныгъэ	interaction
гулъытэ	interest
зыфӀэгъэщӀэгъуэн	interested
гъэщӀэгъуэн	interesting
хэӀэбэн	interfere
зэхуаку зиӀэ	intermediate
кӀуэцӀ	internal
къэрал зэхуаку	international
лъэпкхъхэм зэдай	international
ӀэщӀагъэм щыхуагъасэ	internship
зэдзэкӀын	interpret
зэдзэкӀакӀуэ	interpreter
зэпыудын	interrupt
интервью	interview
гъунэгъу	intimate
къызыщыгъэхъун	introduce
хэзыгъэгъуазэ	introduction
и щхьэ хуэпсэуж цӀыху	introvert
къащӀэ	intuition
интуицэ	intuition
пцӀы	invalid
хъуэжыныгъэ	invent
Ӏэмэмсымэ	inventory
мылъкур предприятэ гуэрым хэлъхьэн	invest
зэхэгъэкӀын	investigate
егъэблэгъэныгъэ	invitation
къегъэблэгъэн	invite
есэп хуэгъувын	invoice
есэп	invoice
щӀэгъэнэн	involve
хэша	involved
ету	iron
ету тедзэн	iron
щытщ	is
хытӀыгу	island
закъуэ	isolated
щхьэхуэ	isolated
гугъуехь	issue
къыхэгъэкӀын	issue
проблемэ	issues
лажьэ	issues
ар	it
мыр зэрыщытыр	it is
щыӀащ	it was
ар щытщ	it's
псори тэмэмщ	it's ok
псори хъарзынэщ	it's ok
Псори тэмэмщ	It's okay
хьэпшып	item
хьэпшыпхэр	items
и	its
ар	its
абы	its
Сэ сыщытщ	I’m
кӀагуэ	jacket
лъэхъуэщ	jail
тутнакъ	jail
ЩӀышылэ	January
банкӀ	jar
жьэпкъ	jaw
езыфыгъулӀэ	jealous
хэлъэтын	jerk
цӀугъэнэ зралъхьэхэр	jewelry
лэжьыгъэ	job
лэжьапӀэ	job
хыхьэн	join
зэщӀыгъу	joint
зэгъусэ	joint
гушыӀэ	joke
журналист	journalist
дунеяплъэ	journey
гуфӀэгъуэ	joy
хеящӀэ	judge
хей щӀын	judge
пхъэщхьэмыщхьэпс	juice
псы	juice
бадзэуэгъуэ	july
дэпкӀеин	jump
мэкъуауэгъуэ	june
пхъэнкӀий	junk
пэж	just
ауэ	just
ауэ щӀэи ара	just do it
суд захуэ	justice
хей щӀын	justify
Къэбэрдей	Kabardian
Адыгэ	Kabardian
Калааллист	Kalaallisut
губзыгъэ	keen
Ӏущ	keen
Ӏыгъын	keep
апхуэдэ дыдэу пыщэ	keep it up
иӀыгъащ	kept
шеиныч	kettle
псынэ	key
ӀункӀыбзэӀух	key
лъакъуэкӀэ кӀэщӀэуэн	kick
еӀунщӀын	kick
сабий	kid
мэгушыӀэ	kidding
жьэжий	kidney
сабийхэр	kids
укӀын	kill
фӀы	kind
щытыкӀэ	kind
хуэдэ	kinda
кхъыӀэ	kindly
угъурлыгъэ	kindness
пащтыхь	king
ба хуэщӀын	kiss
пщэфӀапӀэ	kitchen
хьэуам ерс блэ	kite
джэду цӀыкӀу	kitten
лъэгуажьэ	knee
сщӀэт	knew
сэ	knife
рыцарь	knight
щӀэн	know
щӀэныгъэ	knowledge
цӀэрыӀуэ	known
Конканэ	Konkani
Криэ	Krio
дамыгъэ тедзэн	label
дамыгъэ	label
гуащӀэдэкӀ	labor
гугъуехь	labour
хуримыкъун	lack
пкӀэлъей	ladder
цӀыхубз	lady
фыз	lady
къэхухьын	laid
шэсыпӀэ илъхьэн	laid
гуэл	lake
щынэ	lamb
ещӀэкъуауэ	lame
уэздыгъэ	lamp
щӀы	land
щӀым деж къетӀысэхын	land
теплъэ	landscape
пейзаж	landscape
бзэ	language
лъэгуажьэхэр	lap
ин	large
икӀэ	last
иужь дыдэщ, ауэ нэхъ мыхьэнэншэкъым	last but not least
унэцӀэ	last name
гува	late
куэд мыщӀэу	lately
нэхъ гувауэ	later
и кӀэ	latest
и кӀэ	latter
иужь	latter
дыхьэшхын	laugh
дыхьэшх макъ	laughing
дыхьэшх	laughter
егъэжьэн	launch
жьыщӀэн	laundry
закон	law
хабзэ	law
удзыпӀэ щӀыпӀэ тӀэкӀу	lawn
хуей мыин	lawn
къэрал хабзэхэмкӀэ ӀэщӀагъэлӀ	lawyer
телъхьэн	lay
къат	layer
хэщӀапӀэ	layout
фӀыуэ хущытыныгъэ	layout
щхьэхынэ	lazy
егъэкӀуэкӀын	lead
пашэ	leader
тхьэмпэ	leaf
тхылъымпӀэ	leaf
ежэхын	leak
зегъэзыхын	lean
дэпкӀеин	leap
зэгъэщӀэн	learn
егъэджэн	learn
егъэджэныгъэ	learning
бэджэнд	lease
нэхъ мащӀу	least
фэ	leather
зыгъэпсэхугъуэ	leave
къэгъэнэн	leave
тхьэмпэ	leaves
ишэу щытащ	led
ишащ	led
сэмэгумкӀэ	left
лъакъуэ	leg
щӀэин	legacy
законым тет	legal
таурыхъ	legend
тхыдэ	legend
хабзэм тет	legit
зыгъэпсэхуныгъэ	leisure
къеӀыхын	lend
кӀыхьагъ	length
нэхъ мащӀэ	less
дерс	lesson
дэн	let
тхыгъэ	letter
письмо	letter
яшх къэкӀыгъэ	lettuce
здынэсыр	level
щӀыхь	leverage
жэуаптакӀуэу щытыныгъэ	liability
борш	liability
пщэдэкӏыж	liability
тхылъ унэ	library
ебзеин	lick
пцӀы	lie
къэгъэпцӀэн	lie
пцӀы	lies
гъащӀэ	life
къэӀэтын	lift
дэкӀуэтеипӀэ	lift
псынщӀэ	light
нэху	light
щӀэгъэнэн	light
щыблэ	lightning
кӀуэныгъэ	lightning
игу ирихьын	like
енэгуеигъуэ	likely
апхуэдэу	likewise
итхъа	line
Лингалэ	Lingala
зэпыщӀэныгъэ	link
аслъэн	lion
ткӀуаткӀуэ	liquid
псыӀэгъэ	liquid
спискэ	list
едэӀуэн	listen
едаӀуэр	listening
зэрыщыт	literally
литературэ	literature
уфӀеин	litter
цӀыкӀу	little
псэун	live
жыджэр	live
тхьэмщӀыгъу	liver
мэпсэу	lives
гъащӀэ	living
хьэщӀэщ	living room
шындырхъуо	lizard
къалэн	load
щӀакхъуэ	loaf
щӀыхуэ	loan
щӀыпӀэ	local
щӀыпӀэ хэхам щыпсэу	local
щӀыпӀэ	location
замок	lock
ӀункӀыбзэ	lock
щхьэхуэ щӀа	lockdown
ентӀыр	log
гуфӀэгъуэ макъ	lol
щхьэ закъуэ	lonely
кӀыхь	long
куэд щӀауэ дызэрылъэгъуакъым	long time no see
плъэкӀэ	look
плъэн	look
кӀапсэ зэрыдза	loop
хуит	loose
хуит къэщӀын	loose
тепщэ	lord
гъэкӀуэдын	lose
кӀуэдар	loss
кӀуэда	lost
ӀуэхузэхэлъыкӀэ	lot
насып	lot
ину	loud
зэӀущӀэ щрагъэкӀуэкӀ пэш	lounge
пэшышхуэ	lounge
лъагъуныгъэ хуэщӀын	love
лъагъуныгъэ	love
фӀыуэ узолъагъу	love you
и закъуэ	lovely
лъахъшэ	low
и лъабжьэ	lower
хуэпэж	loyal
хуэщыпкъэныгъэ	loyalty
ехъулӀэныгъэ	luck
къызэхъулӀэ	lucky
Лугандэ	Luganda
зыдахь хьэпшып	luggage
тыкъыр	lump
шэджэгуашхэ	lunch
тхьэмбыл	lungs
къулеиныгъэ	luxury
пцӀыӀуэпцӀышэ	lying
машинэ	machine
убыдыпӀэншэ	mad
гуащэ	madam
сщӀащ	made
журнал	magazine
гъуэзэджэ	magnificent
хамэ унэм щыӀэпыдзлъэпыдз цӀыхубз	maid
нэхъыжь	main
дыӀыгъын	maintain
гъэлэжьэн	maintenance
Майтхилэ	Maithili
пӀащэ	major
майор	major
нэхъыбэр	majority
щӀэн	make
зэхэгъэувэн	make up
хъу	male
сату щӀыпӀэшхуэ	mall
лӀы	man
цӀыхухъу	man
зегъэкӀуэн	manage
унафэщӀыпӀэ	management
ӀуэхущӀапӀэм и лэжьыгъэр унэтӀыныгъэмкӀэ ӀэщӀагъэлӀ	manager
фӀэкӀыпӀэ зимыӀэ	mandatory
манифест	manifest
хьэгъэщагъэ зехьэн	manipulate
щытыкӀэ	manner
ӀэкӀэ щӀа	manual
Ӏэпщэ	manual
куэд	many
укъыщалъхуа махуэр пхуэугъурлын	many many happy returns of the day
зекӀуэкӀэ зыщӀэгъэуӀуа	march
макъамэ укъызыщӀэзыӀэтэ	march
хэхъуэ	margin
бэзэр	market
дагъуэ	marriage
нэчыхь	marriage
фыз зиӀэ	married
нэкӀуӀулъхьэ	mask
массэ	mass
куэд	mass
хьэлъагъ	mass
ин	massive
хьэлъэ	massive
ӀэщӀагъэлӀ	master
зэтехуэн	match
зэтехуэныгъэ	match
хэгъэрей	mate
ныбжьэгъу	mate
материал	material
матиматикэ	math
мыхьэнэ зиӀэ	matter
щытыкӀэ	matter
балигъыпӀэ	maturity
хъугъуэ	maturity
щӀэн	may
лъэкӀын	may
накъыгъэ	may
щытынкӀэ хъунущ	maybe
сэ	me
сэри	me too
шхын	meal
ябгэ	mean
мыхьэнэ иӀэн	mean
мыхьэнэ	meaning
хэкӀыпӀэхэр	means
зыгуэр къзэрыкӀыу щыта	meant
а зэманым	meanwhile
къэпщын	measure
мардэ	measures
Ӏэмалхэр	measures
лы	meat
медицинскэ	medical
хущхъуэ	medicine
егупсысыныгъэ	meditation
курыт	medium
пежьэн	meet
зэхуэзэ	meeting
Мейтейлиуэн	Meiteilon
ткӀун	melt
гукъэкӀыж	memories
гукъэкӀыж	memory
гурыхуагъэ	memory
акъылкӀэ	mental
игу къэгъэкӀыжын	mention
къиӀуэн	mention
къыхэгъэща	mentioned
зи цӀэ къиӀуа	mentioned
гъэсакӀуэ	mentor
зыщэ	merchant
сатуущӀэ	merchant
гущӀэгъу	mercy
къудей	merely
хъуромэм насып къыдэкӀуэну	merry christmas
зэкӀэлъымыкӀуагъэ	mess
зэрызэрыщӀэ	message
хъыбарыщӀэ	message
фӀей	messy
гъущӀыкӀэ	metal
щӀыкӀэ	method
дзыгъуэхэр	mice
зэхуаку	middle
жэщ ныкъуэ	midnight
лъэш	might
псынщӀэ	mild
гъуэгу дамыгъэ	milestone
зауэ	military
шэ	milk
мелуан	million
едэуэн	mind
акъыл	mind
гупсысэкӀэ	mindset
сысей	mine
щӀыщӀагъ хъугъуэфӀыгъуэхэр къыщыщӀах щӀыпӀэ	mine
зэхэзэрыхьын	mingle
мыхьэнэншэ	minor
дакъикъэ	minute
дакъикъэхэр	minutes
хьэлэмэтыщэ	miracle
телъыджэлажьэ	miracle
гъуджэ	mirror
зэмылӀэужьыгъуэ	miscellaneous
къуейщӀей	mischievous
тхьэмыщкӀэ	miserable
гу зыщӀэгъу	miserable
насыпыншагъэ	misery
блэгъэкӀын	miss
сигу укъокӀ	miss you
иримыкъу	missing
къалэн	mission
пшагъуэ	mist
щыуагъэ	mistake
Мизэ	Mizo
мобильнэ	mobile
щыдыхьэшхын	mock
модель	model
зыгуэрым и щапхъэ	model
щабэ щӀын	moderate
зэпӀэзэрыт	moderate
иджырей	modern
нэмысыфӀэ	modest
псыӀэ	moist
псыӀэ	moisture
щытыкӀэ	mold
щытыкӀэ етын	mold
щӀыӀуб	mole
мамэ	mom
анэ	mom
напӀэзыпӀэ	moment
блыщхьэ	monday
ахъшэ	money
кӀэлъыплъын	monitor
номин	monkey
мазэ	month
нэжэгужэ	mood
цӀикъ	moody
мазэ	moon
хьэл-щэн мардэхэм епха	moral
нэхъыбэу	more
абы нэмыщӀ	moreover
пщэдджыдь	morning
ипотекэ	mortgage
нэхъыбэу	most
нэхъыбэу	mostly
анэ	mother
гъэхъеиныгъэ	motion
зэщӀэхъеенигъэ	motion
тегъэщӀэн	motivation
бгы	mountain
дзыгъуэ	mouse
жьэ	mouth
гъэхъеин	move
зегъэкӀуэныгъэ	movement
зэщӀэхъееныгъэ	movement
фильм	movie
инджылыбзэ къэралхэм цӀыхубзхэм я цӀэ-унэцӀэм пыту жаӀэ	mrs
куэд	much
ятӀэ	mud
фӀей	mud
кӀрушкӀэ	mug
лыпцӀэналъэ	muscle
музей	museum
Ӏэгъэбэгу	mushroom
уэрэд	music
хуэныкъуэныгъэ	must
ищӀэн хуейщ	must
бзагуэ	mute
зэдай	mutual
сысей	my
Си лъапӀэ	My dear
си ныбжьэгъу	my friend
Си кхъухь хьэуа щхьэнтэр блэм ещхь бдзэжьейхэмкӀэ гъэнщӀащ	My hovercraft is full of eels
си лъагъуныгъэ	my love
сэ къызэрызэджэр	my name is
кхъыӀэ	my pleasure
сэ езым	myself
мыгурыӀуэгъуэ	mysterious
къуажэхь	mystery
псысэ	myth
таурыхъыжь	myth
гъущӀӀунэ	nail
зэхэщӀыкӀыншэ	naive
цӀэ	name
къэӀуэтэжыныгъэ	narrative
зэв	narrow
гущыкӀыныгъэ	nasty
лъэпкъ	national
лъэпкъ	nationality
нэхъыщхьэ	native
зэрыщыт дыдэ	natural
щӀыуэпс	nature
гукъекӀуэныгъэ	nausea
гъунэгъуу	near
гъунэгъуу	nearby
нэблагъэу	nearly
хуэсакъ	neat
узыхуэныкъуэ	necessary
пщэ	neck
абдж щыгъэ	necklace
хуэныкъуэныгъэ	need
хуэныкъуэн	need
Ӏей	negative
гулъытэншэу къэгъэнэн	neglect
зэпсэлъэныгъэ егъэкӀуэкӀын	negotiate
гъунэгъу	neighbor
куей	neighborhood
зыри	neither
къуэш бын	nephew
дэлъху бын	nephew
шыпхъу бын	nephew
еджэн фӀэкӀа къызыфӀэмыӀуэху	nerd
губжьрей	nervous
абгъуэ	nest
сеть	net
хъы	net
Зэлъагъэ	network
хъы	network
аткӀи-мыткӀи хэмыхьэ	neutral
зэи	never
зей зыри зэтомыгъакӀуэ	never give up
укъимыкӀуэт	never give up
мыщӀагъуэ	never mind
мыщӀагъуэ	nevermind
дапхуэдэу щымытми	nevertheless
щӀэ	new
хъыбарыщӀэ	news
къыкӀэлъыкӀуэр	next
игъунэгъуу	next to
фӀы	nice
си гуапэщ укъызэрысцӀыхуар	nice to meet you
дэлъху шыпхъу бын	niece
жэщ	night
шынагъуэ	nightmare
гуӀэгъуэ	nightmare
бгъу	nine
пщыкӀубгъу	nineteen
бгъущӀ	ninety
Хьэуэ	No
проблемэ щыӀэкъым	no problem
зыуикӀ	no way
зыри	nobody
Ӏэуэлъауэ	noise
даущ	noise
Ӏэуэлъауэ	noisy
хьэуэ	none
махуэ ныкъуэ	noon
шэджагъуэ	noon
хьэуэ	nope
тэмэм	normal
ищхъэрэ	north
пэ	nose
гукъэкӀыж зыхэлъ	nostalgic
мы	not
къым	not
хьэуэ дыдэ	not at all
Ӏейкъым	not bad
Иджыпстукъым	Not now
иджыри хьэуэ	not yet
заметкэ	note
къыхэгъэща	noted
зыри	nothing
гу лъытэн	notice
гу лъитащ	noticed
щыӀэцӀэ	noun
щыӀэцӀэ	nouns
роман	novel
щэкӀуэгъуэ	november
иджыпсту	now
ди махуэхэм	nowadays
лъэпощхьэпо	nuisance
зэран хъу	nuisance
ныкъусаныгъэ	nuisance
нол	null
ундэрэбжьа	numb
номыр	number
медицинэ ӀэщӀагъэ курыт зиӀэ цӀыхубз	nurse
дэ	nut
мускатнэ дэ	nutmeg
пкъыгъуэ сэбэп зыхэлъ	nutrition
тхьэрыӀуэ	oath
пшэр хъуныгъэ	obesity
едэӀуэн	obey
объект	object
щӀыпӀэ	object
къалэн	objective
къалэн	obligation
мыцӀэрыӀуэ	obscure
кӀэлъыплъыныгъэ	observation
кӀэлъыплъын	observe
зэщӀиӀыгъэ	obsessed
зэщӀэӀыгъэныгъэ	obsession
жьы хъуа	obsolete
зэран хъу	obstacle
пэщӀэуэныгъэ	obstacle
къэлэжьын	obtain
къылъысащ	obtained
Ӏэрыхьащ	obtained
шэч зыхэмылъ	obvious
болагъуу	obviously
иныкъуэм деж	occasionally
ӀэщӀагъэ	occupation
зыхущӀэмыхьэ	occupied
къэхъунущ	occur
къэхъуащ	occurred
къохъу	occurs
хы	ocean
жэпуэгъуэ	october
гъэщӀэгъуэн	odd
телъыджэ	odd
гугъапӀэхэр	odds
и	of
дауи	of course
гъэуфӀынкӀа	off
гуауэ пщыхъу	offensive
хьэрычэт	offer
Ӏуэхугъуэ гуэр къыхэлъхьэн	offer
лэжьыгъэ гуэр щрагъэкӀуэкӀ пэш	office
официальнэ	official
куэдрэ	often
Уэху	Oh
гушыӀэншэу	oh really
тхъу	oil
хъарзынэ	ok
тэмэм	ok
хъунщ, тӀасэ	ok dear
хъунщ, тӀасэ	ok honey
хъунщ, фӀыуэ слъагъу	ok my love
хъарзынэ	okay
тэмэм	okay
тэмэмщ,псэм хуэдэ	okay baby
хъунщ, лъапӀэ	okay dear
хъунщ, тӀасэ	okay honey
хъунщ, си лъагъуныгъэ	okay my love
жьы	old
м	on
зэ	once
зы	one
Зы бзэ закъуэкӀэ зей урикъунукъым	one language is never enough
бжьын	onion
онлайн	online
дунейпсо бэджыхъым щис зэман	online
къудей	only
зэӀуха	open
операцэ	operation
еплъыкӀэ	opinion
Ӏэмал	opportunities
Ӏэмал	opportunity
зэпэщӀэуэ	opposite
нэжэгужэ	optimistic
лӀэужьыгъуэ	option
умыщӀэми хъуну	optional
е	or
тӀамы	orange
гъуэжь-плъыжьыфэ	orange
тэмэмагъ	order
унафэ щӀын	order
зэрыхабзэ	ordinary
къызэгъэпэщыныгъэ	organization
гъуазэ	orientation
хуэунэтӀыныгъэ	orientation
къызыхэкӀар	origin
къахэщхьэхукӀ	original
зыми къытрамыха	original
Оромэ	Oromo
зеиншэ	orphan
нэгъуэщӀ	other
нэгъуэщӀу	otherwise
хуейщ	ought
дыдей	our
Дэ ди къэлэныр: псоми дунейр зэхащӀыкӀыну, бзэ зэмылӀэужьыгъуэхэмкӀэ я гупсысэр къаӀуэтэну хуит щӀынырщ.	Our mission: to enable everyone, everywhere to understand the world and express themselves across languages.
Дэ ди къэлэныр: информацэр зэдгъэзахууэу ар дэндежи гъуэтыгъуафӀэ икӀи сэбэп щӀынырщ.	Our mission: to organize the world's information and make it universally accessible and useful.
и щӀыӀум	out
кӀэ зэригъуэта щӀыкӀэ	outcome
гуп	outfit
щыгъын	outfit
къыздикӀ	outgoing
иӀупӀэ	outlet
розеткэ	outlet
къэтхъыхьыныгъэ	outline
и щӀыӀум	outside
мыхьэнэшхуэ зыхэлъ	outstanding
духовкэ	oven
нэхъыбэу	over
абдеж	over there
псори	overall
къудейщ	overall
фӀэкӀын	overcome
щхьэдэхын	overcome
шыхьыныгъэ	overthinking
телъыджэ	overwhelmed
телъыджащэ	overwhelming
щытын хуейщ	owe
жьынду	owl
узыхуит	own
Ӏыгъын	own
къэгъэсэбэпын	own
зыбгъэдэлъ	owner
зей	owner
гуу	ox
мамыр	pace
зэкӀуэцӀыпхэн	pack
зэрызыкӀуэцӀалъхьэ	package
зыкӀуэцӀылъыр	package
уасэ щӀитащ	paid
уз	pain
лэч	paint
ӀэкӀэ щӀа сурэт	painting
зэгъусэ	pair
фагъуэ	pale
Ӏэгу	palm
тебэ	pan
пандемэ	pandemic
хьэрпхъэр	panic
гужьеигъуэ	panic
гъуэншэдж	pants
тхылъымпӀэ	paper
жэнэт	paradise
зэпэщӀэуэ	parallel
гъэкӀуэныгъэ	parcel
тезэрыр техыжыныгъэ	pardon
хуэгъэгъуныгъэ	pardon
адэ-анэ	parents
зыщагъэпсэху	park
дыдыкъуш	parrot
бгъэудзыфэ	parrot
къуэн	parsley
Ӏыхьэ	part
хэтын	participate
къыхэха	particular
псом хуэмыдэу	particularly
гъусэ	partner
пшыхьзэхэс	party
щӀэпщакӀуэ	party
къыщӀыхьэн	pass
кӀуэцӀрыкӀын	pass
кӀуэцӀрыкӀыпӀэ	passage
кӀуэцӀрыкӀащ	passed
дэзыхьэх	passion
фӀэфӀагъэ ин зыхэлъ	passionate
жэрдэмыншэ	passive
пароль	password
блэкӀа	past
Ӏыхьэ	patch
гъуэгу	path
гу зыщӀэгъу	pathetic
зышыӀэныгъэ	patience
шыӀэныгьэ зыхэлъ	patient
сымаджэ	patient
тхыпхъэщӀыпхъэ	pattern
зэпыугъуэ	pause
ЦӀыхухэр здызекӀуэ гъуэгу Ӏыхьэ	pavement
щӀэтын	pay
уасэр щӀэтыныгъэ	payment
дуней	peace
мамыр	peaceful
шэфтал	peach
нэӀу	peak
кхъужь	pear
гуузджэш	peas
джэшхъурей	peas
хэха	peculiar
щхьэхуэ	peculiar
тхэн	pee
гъутхьэпс	pee
фэ	peel
уи ныбжь	peer
ныбжьхэр	peers
къалэм	pen
къэрэндащ	pencil
ежьэн	pending
цӀыхухэр	people
шыбжий	pepper
бурш	pepper
къыгурыӀуэн	perceive
къэщӀэныгъэ	perception
къызэрыщыхъу	perception
къызыхуэтыншэ	perfect
щӀэн	perform
зэлэжьам мыхьэнэ зиӀэу къыхэкӀар	performance
производительность	performance
хъункӀэ хъунущ	perhaps
пӀалъэ	period
зэман	period
зэпымыу	permanent
хуитыныгъэ	permission
хуит щӀын	permit
дэн	permit
ерыщыгъэ	perseverance
ерыщ	persistent
цӀыху	person
и щхьэкӀэ	personal
цӀыху щхьэхуэ	personality
цӀыхум и Ӏуплъэ	personality
еплъыкӀэ	perspective
и фӀэщ гъэхъун	persuade
лейзехьэ	pervert
унэ псэущхьэ	pet
пӀалъэ хэха	phase
лъэхъэнэ	phase
къэхъу-къащӀэ	phenomenon
философие	philosophy
телефон	phone
сурэт	photo
теплъэ	phrase
плъэкӀэ	phrase
жыӀэкӀэ	phrase
Ӏэпщэ къару зыхь	physical
къыхухэхын	pick
къэщтэжын	pick up
къыхэхын	pick up
сурэт	picture
Ӏыхьэ	piece
Ӏыхьэхэр	pieces
кхъуэ	pig
тхьэрыкъуэ	pigeon
Ӏэтэ	pile
щхьэнтэ	pillow
кхъухьлъатэзехуэ	pilot
мастэкъуаншэ	pin
кӀэмастэ	pin
ананас	pineapple
тхьэмбылыфэ	pink
мащэ	pit
инагъ	pitch
гущӀэгъуныгъэ	pity
щӀэгъэзэгъэн	place
щӀыпӀэ	place
щӀыпӀэхэр	places
емынэ	plague
гурыӀуэгъуафӀэ	plain
план	plan
кхъухьлъатэ	plane
къэкӀыгъэ	plant
къэкӀыгъэхэр	plants
тепщэч	plate
платформэ	platform
пьесэ	play
джэгун	play
джэгу	playing
гуакӀуэ	pleasant
арэзы щӀын	please
кхъыӀэ	please
арэзы хъуа	pleased
гухэхъуэ	pleasure
тхьэрыӀуэ	pledge
куэд	plenty
художественнэ тхыгъэм щекӀуэкӀ Ӏуэхугъуэхэр	plot
гъэбыдэн	plug
къыпцӀэ	plum
псыщӀэшакӀуэ	plumber
куэду щыӀэ	plural
ютуб зэпсэлъэлӀыныгъэ	podcast
усэ	poem
усыгъэ	poetry
точкэ	point
щхъухь	poison
полицэ	police
политикэ	policy
щэныфӀэ	polite
уфӀеиныгъэ	pollution
псы ӀущӀа	pond
ӀэкӀэ щӀа псыхъурей	pool
бассейн	pool
зыщагъэпскӀ	pool
щӀыб икӀын	poop
тхьэмыщкӀэ	poor
къэуэн	pop
къэчэн	pop
цӀэрыӀуэ	popular
щӀыпӀэм щыпсэу цӀыхухэр	population
кхъуэл	pork
кашэ	porridge
кхъухьхэр здэщыт щӀыпӀэ	port
щӀыпӀэ	position
итыпӀэ	position
арэзыныгъэ	positive
ӀэщӀэлъын	possess
иӀэн	possess
мылъку	possession
езым и	possessive
Ӏэмал	possible
трегъэдзэн	post
пощт	post
гъэтӀылъын	postpone
кӀэртӀоф	potato
зэрыщытыр	potential
фунт	pound
тхьэмыскӀагъэ	poverty
къару	power
лъэщ	powerful
практическэ	practical
практикэ щӀыӀэн	practice
практикэ	practice
щытхъун	praise
дэгушыӀэныгъэ	prank
джэгукӀэ лӀэужьыгъуэ	prank
тхьэ елъэӀун	pray
лъапӀэ	precious
хуэфӀыпс	precise
хуэдэ	precise
пэжу	precisely
къэхъуныр жыӀэн	predict
нэхъ къэщтэн	prefer
нэхъ фӀэфӀыныгъэ	preference
лъэщыджэ	pregnant
уэндэхъу	pregnant
хабзэжь	prejudice
щӀыпӀэ	premises
саугъэт	premium
гъэхьэзырыныгъэ	preparation
гъэхьэзырын	prepare
хьэзыр	prepared
щхьэусыгъуэ	preposition
щыӀэныгъэ	presence
иджыпсту	present
иджырей	present
тыгъэ	present
презентацэ	presentation
зехьэн	preserve
Ӏэтащхьэ	president
прессэ	press
текъузэн	press
пӀытыныгъэ	pressure
зыщӀын	pretend
дыдэ	pretty
лъагъугъуафӀэ	pretty
къэгъэувыӀэн	prevent
ипэ ит	previous
хэкӀуадэ	prey
уасэ	price
пагагъэ	pride
чылисэ лэжьакӀуэ	priest
нэхъапэ	primary
нэхъыщхьэ	prime
пашэ	prime
пащтыхьыпхъу	princess
унэфэщӀ	principal
блэкӀа	prior
ипэ ит	prior
пэрытыныгъэ	priority
лъэхъуэщ	prison
тутнакъ	prison
щэху	privacy
хабзэу щымыт	private
хуитыныгъэ хэха	privilege
тыгъэ	prize
саугъэт	prize
къэхъун хъункӀэ	probably
нэкъусэныгъэ	problem
процедурэ	procedure
пыщэн	proceed
екӀуэкӀыныгъэ	process
елэжьын	process
къыдэгъэкӀын	produce
Ӏэужь	product
шхыныгъуэ	product
щӀыныгъэ	production
къыдэгъэкӀыныгъэ	production
ӀэщӀагъэ	profession
ӀэщӀагъэм хуэӀэзэ	professional
хьэпшыпыбгъу	profile
нэӀубгъу	profile
хэхъуэ	profit
куу	profound
хэкӀуэтэн	progress
зыузэщӀыныгъэ	progress
проект	project
мыхьэнэшхуэ зиӀэ	prominent
къэгъэгугъэн	promise
гъэгугъэныгъэ	promise
гъэкӀуэтэн	promote
хэгъэхъуэныгъэ	promotion
щэхуу жеӀэн	prompt
зыгуэрым хуэмахэ	prone
цӀэпапщӀэ	pronouns
къэпсэлъыкӀэ	pronunciation
щыхьэт	proof
зэрыщытын хуей	proper
пэж	properly
щытыкӀэ щхьэхуэ	properties
мылъку	property
хьэрычэт	proposal
псалъэуха	proposal
перспективэ	prospect
фӀыуэ зыужьыныгъэ	prosperity
къэгъэгъэныгъэ	prosperity
ефӀэкӀ	prosperous
гъагъэ	prosperous
хъумэн	protect
пагэныгъэ зыхэлъ	proud
гъэнэхуэн	prove
бгъэдэлъхьэн	provide
етын	provided
куей	province
зэгъэпэщыныгъэ	provision
пубертатнэ зэман	puberty
цӀыхубэм яцӀыху	public
лъэфын	pull
къэб	pumpkin
къыкӀэрымыху	punctual
нэджыдж	pupil
къэщэхун	purchase
къабзэ	pure
епэрыфэ	purple
шакъафэ	purple
гухэлъ	purpose
нэщэнэ	purpose
мурад	purpose
бохъшэ	purse
иужь итын	pursue
кӀэлъыплъыныгъэ	pursuit
щӀэрыӀэн	push
гъэтӀылъын	put
квалификацэ	qualification
фӀагъ	quality
бжыгъэ	quantity
щхьэхуэу Ӏыгъыныгъэ	quarantine
псалъэмакъ	quarrel
зэфӀэнэн	quarrel
плӀанэ	quarter
Кечуэ	Quechua
королым и фыз	queen
къэралхъан	queen
гъэщӀэгъуэн	queer
щӀэупщӀэныгъэ	query
упщӀэ	question
чэзум хэувэн	queue
чэзу	queue
псынщӀэ	quick
псынщӀэу	quickly
щэху	quiet
пычыхуаурэ зыпыда шхыӀэн	quilt
хыфӀэдзэн	quit
ирикъун	quite
зыуи	quite
викторинэ	quiz
цитатэ	quotation
цитатэ жыӀэн	quote
цитатэ	quote
жыӀэгъуэхэр	quotes
цитатэхэр	quotes
тхьэкӀумэкӀыхь ӀэрыпӀ	rabbit
пӀащӀэныгъэ	race
губжь ин	rage
уэшх	rain
дэгъэкӀуэтеин	raise
дэгъэкӀуеиныгъэ	raise
хэгъэхъуэныгъэ	raise
къиӀэтащ	raised
жащ	ran
зэрымыщӀэ	random
къриубыдэр	range
псынщӀэ	rapid
псынщӀэу	rapidly
цӀырхъ	rare
зэзэмызэ	rarely
къилъэлъыгъэ	rash
дзыгъуэ	rat
хуабжьагъ	rate
арэзы куэдщ	rather
зэхущытыкӀэ	ratio
мыхьэнэ зиӀэ	rational
щхьэпэ	rational
цӀынэ	raw
зыӀэрыгъыхьэн	reach
ехъулӀащ	reached
нэсащ	reached
реакцэ	reaction
зыкъегъэщӀэныгъэ	reaction
еджэн	read
къеджэныгъэ	reading
хьэзыр	ready
мы	real
иджы	real
щыӀэныгъэ	reality
зэхэщӀыкӀын	realize
къыгурыӀуэжащ	realized
пэж дыдэу	really
щӀыбагъ	rear
щхьэусыгъуэ	reason
акъылыфӀэ	reasonable
къэщӀэжын	recall
квитанцэ	receipt
къыпӀэрыхьэн	receive
къыӀэрыхьэн	received
куэд мыщӀа	recent
куэд щӀакъым	recently
къеӀыхыныгъэ	reception
хэгъыхьэныгъэ	reception
рецепт	recipe
гъэзэщӀапщхъэ	recipe
емыгупсыс	reckless
акъылыншэ	reckless
лъытэныгъэ	recognition
зыумысыжын	recognition
къэщӀэн	recognize
хущытхъун	recommend
зыхущытхъуа	recommended
трегъэтхэн	record
тетха	record
зэтегъэувэжын	recover
зэтеувэжыныгъэ	recovery
плӀанэпэ занщӀэ зиӀэ плӀимэ	rectangle
плъыжь	red
гъэпскӀын	redeem
гъэзэкӀуэжыныгъэ	redemption
гъэмэщӀэн	reduce
лей	redundant
тегъэщӀэн	refer
тезыр щрахьэкӀ щӀыпӀэ	reference
къищын	reflect
гъуджэм укъыызэрищ	reflection
зышыӀэн	refrain
зызэтеӀыгъэн	refrain
зыубыдын	refrain
щӀыӀалъэ	refrigerator
хэгъэхъуэжыныгъэ	refund
мыдэн	refuse
идакъым	refused
уасэ хуэгъэувын	regard
абы теухауэ	regarding
абы емыпха	regardless
сэлам	regards
куей	region
итхэн	register
егъэщӀылӀэн	register
щӀегъуэжын	regret
зэпымыууэ	regular
зэпымыуу	regularly
мыдэн	reject
хущытын	relate
зэпыщӀа	related
зэхущытыкӀэ	relationship
ехьэлӀа	relative
благъэ	relative
Ӏыхьлы	relatives
благъэ	relatives
зыгъэпсэхужын	relax
къэхуитыжыныгъэ	release
хуит къэщӀыжын	release
хуит хъужа	released
зэхуэдэ	relevant
дзыхь зыхуэпщӀ хъун	reliable
гъэпсынщӀэныгъэ	relief
гъэпсынщӀэн	relieve
тыншыгъуэ гъуэтыжауэ	relieved
дин	religion
диным тет	religious
хуэмейщэу зыщӀэ	reluctant
щыгугъын	rely
къэнэн	remain
къэна	remaining
мыхьэнэшхуэ зиӀэ	remarkable
хущхъуэ	remedy
щӀэжын	remember
игу къэгъэкӀыжын	remind
игу къэгъэкӀыжын	reminder
ӀугъэкӀуэта	remote
тегъэкӀыжын	remove
хуэщӀын	render
бэджэнд	rent
щӀыжын	repair
тегъэзэжын	repeat
зэхъуэкӀын	replace
жэуап	reply
жэуап етын	reply
хуэӀуэтэн	report
доклад	report
егъэцӀыхун	represent
гъэлъэгъуэн	represent
щӀыхь	reputation
щӀэлъэӀун	request
щӀэупщӀэныгъэ	request
пэубыдын	require
зыхуэныкъуэ	required
къегъэлын	rescue
къэхутэныгъэ	research
ещхьын	resemble
губгъэн	resentment
хэхын	reservation
резерв щӀын	reserve
щыпсэу цӀыху	resident
хуэмеин	resign
быдагъэ	resilience
зэпӀэзэрыт	resilient
быдэу щыт	resilient
еныкъуэкъун	resist
пэщӀэтыныгъэ	resistance
щӀыжыныгъэ	resolution
зэхэгъэкӀын	resolve
бгъэдэлъэдэн	resort
ресурс	resources
пщӀэ хуэщӀын	respect
пщӀэ	respect
жэуап етын	respond
ипщэ илъын	respond
жэуап	response
жэуап хьыныгъэ	responsibility
жэуаптакӀуэ	responsible
зыгъэпсэхуныгъэ	rest
ахърэт нэху къыуит	rest in peace
шхапӀэ	restaurant
зэтегъэувэжын	restore
гъэмэщӀэн	restrict
кърикӀуа	result
кърикӀуахэр	results
пыщэн	resume
зэрыз	retail
хъумэн	retain
хэгъэкӀыныгъэ	retention
пенсэм кӀуа	retired
икӀуэтыжын	retreat
етыжын	retrieve
етыжын	return
зэӀухын	reveal
наӀуэ щӀын	revealed
зэтехын	revealed
зэӀухын	revealed
мыгъэгъуныгъэ	revenge
хэхъуэ	revenue
къэзыгъэзэж	reverse
зэпыплъыхьыныгъэ	review
къызэхэплъыхьыныгъэ	review
зэпыплъыхьын	review
хэплъэжын	revise
еплъыжыныгъэ	revision
революцэ	revolution
тыгъэ	reward
жыпхъэ	rhythm
пкъы	rhythm
дзажэналъэ	rib
прунж	rice
къулей	rich
къыӀэщӀэкӀын	rid
кӀуэныгъэ	ride
къэжыхьын	ride
дыхьэшхэн	ridiculous
ижьымкӀэ	right
пэжыныгъэ	right
иджыпсту дыдэ	right now
пхъашэ	rigid
ткӀий	rigid
Ӏэлъын	ring
псы щӀэгъэжыныгъэ	rinse
жьэдэгъэжыхьыныгъэ	rinse
къызэрыӀэтыныгъэ	riot
зэпычыныгъэ	rip
зэпычын	rip
хъуа	ripe
дэкӀуэтеин	rise
дэгъэкӀуэтеиныгъэ	rise
таучэл	risk
тегушхуэн	risk
ныкъуакъуэгъу	rival
псыежэх	river
гъуэгу	road
гъэжьэн	roast
быдэ	robust
мывэ	rock
пкъы	rod
цӀыхум и къалэн хэха	role
гъэжэн	roll
унащхьэ	roof
пэш	room
лъабжьэ	root
кӀапсэ	rope
фа	rotten
пхъашэ	rough
хуэгъэфэщауэ	roughly
хъурей	round
гъуэгу хэха	route
зызымыхъуэж	routine
сатыр	row
тхъущӀын	rub
хьэфэ	rubber
пхъэнкӀий	rubbish
пхъашэ	rude
алэрыбгъу	rug
утэн	ruin
хабзэ	rule
унафэщӀ	ruler
зезыхьэ	ruler
хабзэ	rules
жэн	run
жэ	running
къуажэдэс	rural
зедзын	rush
псынщӀэу	rush
къэп	sack
лъапӀэ	sacred
щхьэузыхь	sacrifice
шынагъуэншэ	safe
шынагъуэншэу лъэтэныгъэ	safe flight
шынагъуэншагъэ	safety
цӀыху Ӏущ	sage
жиӀащ	said
чэтэн	sail
есыныгъэ	sailing
абы щхьа	sake
улахуэ	salary
зэкӀэ щэжыныгъэ	sale
псори щэжыныгъэ	sale
бдзэжьей лӀэужьыгъуэ	salmon
шыгьу	salt
ар дыдэр	same
Мыбдежи ар дыдэращ	Same here
щапхъэ	sample
пшахъуэ	sand
Санскрит	Sanskrit
щӀэнэкӀалъэ	sarcastic
Ӏэдэбыншэ	sassy
щысащ	sat
арэзы хъуныгъэ	satisfaction
арэзы хъуа	satisfied
арэзы щӀын	satisfy
гуакӀуэ	satisfying
Щэбэт	Saturday
нэкулъ	sausage
мыгъасэ	savage
хъумэн	save
слъэгъуащ	saw
псэлъэн	say
щапхъэ	scale
гъэпцӀагъэ	scam
дыркъуэ	scar
мыхьэнэншэ	scarce
мащӀэ	scarce
гъэшына	scared
пщэдэлъ	scarf
шынагъуэ	scary
зэбгрыдза	scattered
икъухьа	scattered
сценэ	scene
щӀыуэпс сурэт	scenery
мэ	scent
расписанэ	schedule
зэхэгъэувэн	schedule
школ	school
щӀэныгъэ	science
щӀэныгъэлӀ	scientist
щӀэныгъэлӀхэр	scientists
лэныстэ	scissors
шхыдэн	scold
къызэщӀэубыдэныгъэ	scope
есэп	score
къутахуэ	scrap
зэракъуутэ Ӏэмэпсымэ	scrap
къитхъа	scratch
кӀиин	scream
пэӀудз	screen
экран	screen
винт	screw
сценарий	script
хы	sea
тедзэныгъэ	seal
лъыхъуэн	search
чэзу	season
зэман	season
тӀысыпӀэ	seat
напӀэзыпэ	second
дэкъикъэ	second
щэху	secret
Ӏыхьэ	section
гуэшыныгъэ	section
шынагъуэншэ	secure
шынагъуэншагъэ	security
лъагъун	see
дызыхуэзэнщ	see you
нэхъ гувауэ дызэрылъагъунщ	see you later
икӀэщӀыпӀэкӀэ дызэрылъагъунущ	see you soon
пщэдей дызыхуэзэнщ	see you tomorrow
жылэ	seed
къэлъыхъуэн	seek
фӀэщӀын	seem
къызэрыпщыхъумкӀэ	seems
илъэгъуащ	seen
зэщӀэубыдэн	seize
техьэгъуэ	seizure
теуэныгъэ	seizure
зэзэмызэ	seldom
къыхэхын	select
езы	self
езым зыгъэхъужыныгъэ	self healing
щхьэзыфӀэфӀ	selfish
щэн	sell
хуегъэхьын	send
уи сурэт къысхуегъэхь	send me your picture
нэхъыжь	senior
зэхэщӀэныгъэ	sense
акъылыфӀэ	sensible
дзыхэ	sensitive
псынщӀэу зыхэзыщӀыкӀ	sensitive
иригъэхьащ	sent
хьэрычэт	sentence
псалъэуха	sentence
къыхэлъхьэныгъэ	sentences
псалъэуха	sentences
щхьэхуэ	separate
Сепедэ	Sepedi
фокӀадэ	september
зэкӀэлъыкӀуагъэ	sequence
сериал	series
зэпӀэзэрыт	serious
ифӀэщу	seriously
къулыкъу щӀэн	serve
къулыкъу	service
зэман хэхакӀэ ягъэзащӀэ Ӏуэхугъуэ	session
къэщтэныгъэ	set
гъэувын	set
зыфӀэгъэувэн	set up
гъэувын	set up
теухуэныгъэ	setting
щӀэтӀысхьэн	settle
блы	seven
пщыкӀубл	seventeen
блыщӀ	seventy
зыбжанэ	several
хьэлъэ	severe
дын	sew
ныбжь	shade
жьауэ	shade
ныбжь	shadow
зедзэн	shake
щыӀэнущ	shall
мыкууущэ	shallow
напэтех	shame
формэ	shape
щытыкӀэ	shape
гуэшэн	share
сыр	sharp
ар	she
абы иӀэщ	she has
ар щытщ	she is
гуэщ	shed
мэл	sheep
тхьэмпэ	sheet
дэлъхьэпӀэ	shelf
фампӀэ	shell
дафэ	shell
джэдыкӀампӀэ	shell
зэгъэпщкӀупӀэ	shelter
быдапӀэ	shelter
мэӀу	shield
зыхууэгъэкӀуэтэн	shift
цӀуун	shine
кхъухь	ship
хьыныгъэ	shipping
джанэ	shirt
вакъэ	shoes
гъэуэн	shoot
еуэн	shoot
лъэщапӀэ	shop
къэщэхуныгъэ	shopping
псы Ӏуфэ	shore
кӀэщӀ	short
иримыкъуныныгъэ	shortage
гъэуэн	shot
уэгъуэ	shot
щӀэн хуейщ	should
блыпкъ	shoulder
кӀийн	shout
гъэлъэгъуэныгъэ	show
егъэлъэгъун	show
сыгъэлъагъу сэ	show me
зыгъэпскӀыпӀэ	shower
креветкэ	shrimp
мащӀэ хъун	shrink
зэхуэщӀын	shut
зэтепӀэн	shut up
укӀытэ зыхэлъ	shy
дэлъху хьэмэрэ шыпхъу	sibling
зэдэлъху зэшыпхъу	siblings
сымаджэ	sick
лъэныкъуэ	side
жьы жьэдэшэныгъэ	sigh
плъагъэ	sight
нэ	sight
гу зылъытапхъэ щӀыпӀэхэр къэплъыхьын	sightseeing
дамыгъэ	sign
ӀэщӀэдз	signature
мыхьэнэ зиӀэ	significant
щым	silence
псалъэгъуей	silent
щэху	silent
шылэ	silk
делэ	silly
дыжьын	silver
зэщхь	similar
симп	simp
къызэрыгуэкӀ	simple
зэуэ	simultaneously
абы лъандэрэ	since
гу зэӀуха	sincere
гупцӀанэ	sincere
гузэӀухауэ	sincerely
уэрэд жыӀэн	sing
уэрэджыӀакӀуэ	singer
зызакъуэ	single
итхьэлэн	sink
блэтхьэкӀумэ блощхьэ	sink
зиусхьэн	Sir
шыпхъу	sister
нысащӀэ	sister in law
щысын	sit
щӀыпӀэ	site
щытыкӀэ	situation
хы	six
пщыкӀух	sixteen
хыщӀ	sixty
инагъ	size
есэныгъэ	skill
есэныгъэ	skills
фэ	skin
гъурыӀуэ	skinny
блэгъэкӀын	skip
кӀэ	skirt
уафэ	sky
пщылӀ	slave
жеин	sleep
жей	sleeping
пщӀыхь	sleepy
Ӏэщхьэ	sleeve
Ӏыхьэ	slice
упщӀэтэн	slice
цӀэнтхъуэн	slide
тецӀэнтхъун	slide
мащӀэу	slightly
пкъыфӀэ	slim
зэкӀуж	slim
цӀэнтхъуэн	slip
егъэзыхыпӀэ	slope
безынэ	slot
хуэм	slow
хуэму	slowly
цӀыкӀу	small
губзыгъэ	smart
мэ	smell
гуфӀэ	smile
пыгуфӀыкӀын	smile
Ӏугъуэ	smoke
зэтес	smooth
шхын псынщӀэ	snack
нэщӀэпкӀэ	snail
блэ	snake
теуӀуэн	snap
уэс	snow
аращи	so
сыту гуапэ	so cute
узыншэу	so far
апщӀэндэху	so far
зыщӀегъэфын	soak
сабын	soap
чэфыншэ	sober
топджэгу	soccer
къанэ щымыӀэу	soccer
жылэӀуэху	social
социальнэ	social
жылагъуэ	society
лъэпэд	socks
щабэ	soft
програмнэ обеспеченэ	software
щӀыгулъ	soil
яща	sold
зыбгыращыкӀащ	sold out
сэлэт	soldier
лъэгущӀыхь	sole
лъэгу	sole
быдэ	solid
щӀыжыныгъэ	solution
унафэ	solution
щӀыжын	solve
зыбжанэ	some
зыгуэр	somebody
зыгуэрурэ	somehow
зыгуэр	someone
зыгуэр	something
зэзэмызэ	sometimes
уэрэд	song
куэд мыщӀэу	soon
гъэщӀэрэщӀа	sophisticated
Соранэ	Sorani
цӀынагъэ	sore
сымаджэ	sore
тэмакъ уз	sore throat
нэщхъеиныгъэ	sorrow
Къысхуэгъэгъу	Sorry
зэхэдзын	sort
хущӀэкъут	sought
псэ	soul
зи дуней еплъыкӀэ зытехуэ	soulmate
псэкӀэ зэблагъэ	soulmate
макъ	sound
хьэнтхъупс	soup
гуащӀэ	sour
псыкъижыпӀэ	source
ипщэ	south
зэхуаку	space
мыхьэнэ зимыӀэ	spam
зэхуаку	span
Испанскэ	Spanish
лей	spare
щысхьын	spare
псэлъэн	speak
зыми хуэмыдэ	special
теплъэ	species
пыухыкӀа	specific
гъэщӀэгъуэныщэ	spectacular
псалъэкӀэ	speech
псалъэкӀэ зыфӀэкӀуэда	speechless
псынщӀагъ	speed
тебжэныгъэ	spell
тегъэкӀуэдэн	spend
гъэкӀуэда	spent
жан	spicy
папцӀэ	spicy
сыр	spicy
банэ	spike
гъэкӀэрэхъуэн	spin
джэдз	spinach
къуэтыр	spinach
жин	spirit
убжьынтхэн	spit
дэгъуэ	splendid
зэгуэгъэхун	split
къута	split
утэн	spoil
зэӀыхьа	spoiled
зэкӀуэкӀа	spoiled
езырезыру къэхъу	spontaneous
бжэмышх	spoon
бжьыгъэ	spot
щхьэгъусэ	spouse
хэӀущӀыӀу щӀын	spread
гъатхэ	spring
плъимэ	square
къыщӀэкъузыкӀын	squeeze
къыщӀытӀыкӀын	squeeze
кальмар	squid
кӀэпхъ	squirrel
лъапӀэ	st
фӀэбзын	stab
фӀэгъэжын	stab
зэпӀэзэрыт	stable
стэчан цӀыкӀу	stack
песонал	staff
утыку	stage
бжыгъэ	stain
дэкӀуэипӀэ	stairs
пкӀэлъей	stairs
Ӏыхьэ	stake
жэпкъ	stalk
кабинэ цӀыкӀу	stall
дамыгъэ	stamp
щытын	stand
увыкӀэ	stand
жыпхъэм ит	standard
вагъуэ	star
щӀэдзэн	start
щӀэдза	started
мэжалӀэ	starving
быдэу жыӀэн	state
щытыкӀэ	state
лъэӀу	statement
станц	station
статуе	statue
щытыкӀэ	status
щыӀэн	stay
къэнэн	stay
зыхуэсакъыж	stay safe
зэпӀэзэрыт	steady
быдэу щыт	steady
лышхуэ гъэжьа	steak
дыгъуэн	steal
бахъэ	steam
жыр	steel
лъэщ	steep
задэ	steep
жэпкъ	stem
лъэбакъуэ	step
баш	stick
гущӀэгъуншэ	stiff
пхъашэ	stiff
мыхъей	still
иджыри	still
уэн	sting
нэпсей	stingy
зэхэгъэзэрыхьын	stir
гъэтӀылъыгъэ	stock
къадыгъуа	stolen
ныбэ	stomach
мывэ	stone
щытащ	stood
шэнтщхьэгуэ	stool
къэувыӀэн	stop
гъэтӀылъыпӀэ	storage
зыкӀуэцӀылъхьэн	store
борэн	storm
тхыдэ	story
мывэ упса	stove
захуэ	straight
къехьэкӀ-нехьэкӀыншэ	straightforward
захуэу кӀуэ	straightforward
къару щӀэлъхьэныгъэ	strain
гъэщӀэгъуэн	strange
телъыджэ	strange
мынэӀуасэ	stranger
Ӏуэхугъуэ гуэрым узэрыхуэкӀуэ щӀыкӀэ	strategy
хьэуазэ	straw
шхий	straw
мэракӀуэ	strawberry
кусэ	streak
кърикӀуэ	stream
псы уэр	stream
уэрам	street
къару	strength
гупщӀэуз	stress
зыхэшын	stretch
бгэ	strict
ткӀий	strict
удын	strike
бзэпс	string
кусэ	strip
хущӀэкъун	strive
удын	stroke
къарууфӀэ	strong
зэуа	struck
зэхэлъыкӀэ	structure
зауэ	struggle
зэуэн	struggle
щӀэбэн	struggling
ерыщ	stubborn
хэна	stuck
ӀэщӀагъэ щрагъэгъуэт еджапӀэм щеджэ	student
зэхэгъэкӀын	study
зэхэгъэкӀыныгъэ	study
зэгъэщӀэныгъэ	studying
иукӀэн	stuff
гъуэзэджэ	stunning
делэ	stupid
стиль	style
зыщӀыкӀэ	style
зыхуэпэкӀэ	style
хьэпшып	subject
едэӀуэныгъэ	submission
едэӀуэн	submit
пкъахуэ	substance
хъуэжыныгъэ	substitute
ерагъыу гу зылъыптэ	subtle
хунэсын	succeed
хэхъуэныгъэ	success
ехъулӀэныгъэ зыхэлъ	successful
мыпхуэдэ	such
апхуэдэ	such
ещхь	such as
хуэдэ	such as
щӀэфын	suck
напӀэзыпӀэ	sudden
умыщӀэххэу	suddenly
гугъу ехьын	suffer
гукъеуэ	suffering
гузэвэгъуэ	suffering
ирикъу	sufficient
фошыгъу	sugar
хуэгъэлъэгъуэн	suggest
хуэгъэфэщэн	suggest
хьэрычэт	suggestion
къыхэлъхьэныгъэ	suggestion
псалъэуха	suggestion
къекӀу	suit
щыгъын	suit
екӀу	suitable
шумэдан	suitcase
пхъуантэ	suitcase
зэрыхъур	sum
суммэ	sum
купщӀэ кӀэщӀ	summary
гъэмахуэ	summer
лъагапӀэ дыдэ	summit
дыгъэ	sun
тхьэмахуэ	sunday
дыгъэ	sunny
къухьэпӀэ	sunset
дыгъэ бзий	sunshine
супер	super
гъуэзэджэ	superior
кӀэлъыплъакӀуэ	supervisor
пщыхьэщхьашхэ	supper
обеспеченэ	supply
зыхуейр хуэгъэзэн	supply
мылъку ахъшэ етын	supply
зыщӀэгъэкъуэн	support
зыщӀэгъэкъуэныгъэ	support
хуэгузэвэныгъэ	support
хуэгъэфэщэн	suppose
хуэгъэфэща	supposed
дауи	sure
щхьэфэ	surface
къэунэхуныгъэ	surge
операцэ	surgery
унэцӀэ	surname
гъэщӀэгъуэн щыщӀын	surprise
зыгъэщӀэгъуа	surprised
зытын	surrender
дыкъэзыухъуреихь	surrounding
кӀэлъыплъыныгъэ	surveillance
упщӀэ	survey
еупщӀын	survey
къелын	survive
шэч зыхуащӀ	suspect
шэч хуэщӀын	suspect
кӀэрыщӀа	suspended
шэч уэзыгъэщӀ	suspicious
дэӀыгъын	sustain
быдэу щытыныгъэ	sustainability
зэпӀэзэрытагъ	sustainability
зэпӀэзэрыт	sustainable
быдэу щыт	sustainable
щыхупӀэ	swag
егъэнэхын	swallow
хъуэжын	swap
тхьэ Ӏуэн	swear
пщӀэнтӀэпс	sweat
цыджанэ	sweater
пхъэнкӀэн	sweep
ӀэфӀ	sweet
ӀэфӀу ужеину	sweet dreams
ӀэфӀ зыфӀэфӀ	sweet tooth
фӀыуэ плъагъу	sweetheart
къэпщын	swell
къэпщыгъэ	swelling
есын	swim
есыныгъэ	swimming
сысын	swing
хъыринэ	swing
гъэпкӀэн	switch
зэрагъапкӀэ	switch
бэга	swollen
джатэ	sword
дамыгъэ	symbol
гущӀэгъу	sympathy
симптомхэр	symptoms
системэ	system
стӀол	table
зэхэгъэкӀын	tackle
дамыгъэ	tag
кӀапэ	tail
къэщтэн	take
къытехын	take away
зыхуэсакъыж	take care
щыхын	take off
техын	take off
къащта	taken
псалъэмакъ	talk
псалъэн	talk
псэлъэрей	talkative
кӀыхь	tall
етӀыркъын	tap
теуӀуэн	tap
лентӀ	tape
нэщэнэ	target
зыхуэунэтӀын	target
къалэн	task
еплъын	taste
ӀэфӀагъ	taste
ӀэфӀ	tasty
иригъэсащ	taught
шей	tea
зэгъэщӀэн	teach
егъэджэн	teach
егъэджакӀуэ	teacher
гуп зэкъуэт	team
командэ	team
нэпс	tear
нэпсхэр	tears
гъэбэмпӀэн	tease
щӀыкӀэ	technology
технологие	technology
дзэ	teeth
псэлъэн	tell
къызжеӀэ сэ	tell me
хьэл-щэн	temper
температурэ	temperature
чылисэ	temple
пӀалъэ зиӀэ	temporary
пщӀы	ten
минипщӀ	ten thousand
щыпсэу	tenant
хущӀэкъун	tend
хущӀэкъуныгъэ	tendency
гуакӀуэ	tender
къару куэд ехьэлӀэныгъэ	tense
къару куэд ирегъэхьэлӀэныгъэ	tension
шэтыр	tent
ипэ къихуэ	tentative
ехьэлӀа псалъэ	term
Ӏуэху щытыкӀэ	terms
Ӏей	terrible
гъуэзэджэ	terrific
щӀы Ӏыхьэ	territory
щӀыналъэ	territory
къызэрапщытэ лэжьыгъэ	test
къэпщытэн	test
тхыгъэ	text
сыткӀэ	than
фӀыщӀэ хуэщӀын	thank
упсэу	thank you
ФӀыщӀэ фхудощӀ фи тэмакъкӀыхьагъым щхьэ, гъэкӀуэныгъэм теухуауэ едгъэкӀуэкӀ Ӏуэхугъуэм папщӀэ	Thank you for your patience while we investigate shipment
упсэушхуэ	thank you so much
упсэушхуэ	thank you very much
упсэу	thanks
Упсэу ди приложенэр къызэрыбгъэсэбэпам щхьэ	Thanks for using our app
ар	that
ар щытщ	that is
ар тэмэмщ	that's good
дыгъун	theft
я	their
я	them
темэ	theme
зытеухар	theme
сэ	themselves
абы щыгъуэ	then
теорие	theory
абдеж	there
щытын	there are
щыӀэщ	there is
абы щхьа	therefore
мыхэр	these
ахэр	they
ахэр щытщ	they are
пшэр	thick
дыгъу	thief
дыгъуакӀуэ	thief
куэ	thigh
пӀащӀэ	thin
хьэпшып	thing
щыгъынхэр	things
егупсысын	think
ещанэ	third
псы зыхуэлӀэ	thirsty
пщыкӀущ	thirteen
щэщӀ	thirty
мыр	this
мыр щытщ	this is
зэгугъу	thorough
егугъуу	thoroughly
а	those
ауэ	though
гупсысэ	thought
егупсысын	thought
хэгупсысыхьа	thoughtful
гупсысэ	thoughts
мин	thousand
Ӏуданэ	thread
гъэгузэвэн	threat
гъэшынэн	threaten
щы	three
щӀыхьэпӀэ	threshold
гухэхъуэм зэщӀищтэныгъэ	thrilled
гъэгъэн	thrive
ефӀэкӀуэн	thrive
тэмакъ	throat
щхьэпры	through
дэкӀым	through
кӀэ	throughout
дзын	throw
Ӏэпхъуамбэшхуэ	thumb
уафэгъуагъуэ	thunder
Махуэку	Thursday
къызэрыщӀэкӀымкӀэ	thus
мэлхьэпӀацӀэ	tick
къыӀухьэныгъэ	tide
къабзэ	tidy
пщэдэлъ	tie
пхэн	tie
къаплъэн	tiger
зэв	tight
Тинринэ	Tigrinya
зэман	time
укӀытэх	timid
цӀыкӀунитӀэ	tiny
кӀапэ дыдэ	tip
шеибжьэ	tips
шинэ	tire
езэша	tired
салфеткэ	tissue
нэкӀур Ӏупэр зэралъэщӀыж платоку цӀыкӀу	tissue
цӀэ	title
щыӀэн	to be
хъуэхъу	toast
нобэ	today
сабий цӀынэ	toddler
лъэхъуамбэ	toes
зэгъусэу	together
псыунэ	toilet
жиӀащ	told
шыӀэныгъэ	tolerance
шэчын	tolerate
бэдрэжан	tomato
пщэдей	tomorrow
бзэгу	tongue
ныщхьэбэ	tonight
ари	too
къищтащ	took
Ӏэмэпсымэ	tool
Ӏэмэпсымэ	tools
дзэ	tooth
лъагапӀэ	top
темэ	topic
зытеухар	topic
зэфӀэтхъа	torn
бэлыхь	torture
хьэзаб	torture
зэдай	total
лъэӀусын	touch
хьэлъэ	tough
къекӀуэкӀыгъуэ	tour
тур	tour
гъэзауэ	toward
абыкӀэ гъэзауэ	towards
напэӀэлъэщӀ	towel
къалэ	town
ӀукӀейщӀыкӀей	toxic
лъэужь	trace
гъуэгу	track
сату щӀын	trade
сату	trade
хабзэ	tradition
хабзэ хъуа	traditional
зэса	traditional
зегъэкӀэныгъэ	traffic
лъэужь	trail
мафӀэгуу	train
егъэджэныгъэ	training
екъуа	trait
зэхэлъыкӀэ	traits
щытыкӀэ	traits
нэгъуэщӀым етын	transfer
щхьэпрыкӀыныгъэ	transition
зэпрыкӀыпӀэ	transition
гъэкӀуэдын	translate
зэдзэкӀын	translate
зэпырышын	translate
узыпхрыплъ	transparent
транспорт	transport
зэрызекӀуэ техникэ	transportation
къапхъэн	trap
пхъэнкӀий	trash
фэбжь	trauma
дунеяплъэ	travel
хьэкхъуафэ	tray
сату зэращӀ пхъуантэ	tray
фӀыгъуэ	treasure
зыхуэгъэзэн	treat
зыхуэгъэзэныгъэ	treatment
жыг	tree
абрагъуэ	tremendous
зэманым къекӀу	trend
гъэунэхуныгъэ	trial
хэтащ	tried
гъэтыр	trigger
зыщӀэгъэплъэн	trigger
къыхэгъэжын	trim
кӀуэныгъэ	trip
мыщхьэпагъэ	trouble
гъуэншэдж	trousers
хьэлъэзешэ машинэ	truck
ПЭЖЩ	true
хьэпшып илъхьэпӀэ	trunk
хьэпшып зыдахьыну е ирагъэшэнухэм я илъхьэпӀэ	trunk
дзыхь	trust
дзыхь хуэщӀын	trust
пэж	truth
пэтын	try
еплъын	try
Тсонгэ	Tsonga
мыштыку	tube
трубкэ	tube
бжьамий цӀыкӀу	tube
Гъубж	Tuesday
егъэджэныгъэ	tuition
гуэгуш	turkey
куркумэ	turmeric
ежэкӀыпӀэ	turn
шылъэгу	turtle
егъэджакӀуэ	tutor
пщыкӀутӀ	twelve
тӀощӀ	twenty
тӀощӀрэ зы	twenty-one
Чвэ	Twi
тӀэу	twice
къуэнтӀэн	twist
тӀу	two
теплъэ	type
ещхьыркъабзэ	typical
лъагъугъуей	ugly
и кӀэм нэгъэса	ultimate
жьауэ	umbrella
мыгурыхуэ	unable
егъэсэгъуей	unable
анэ дэлъху	uncle
адэ къуэш	uncle
къэмэхащ	unconscious
и лъабжьэм	under
лъабжьэ	underneath
щӀагъ	underneath
пщӀэ хуэфащэ хуэмыщӀын	underrated
къыбгурыӀуэн	understand
къызгурыӀуащ	understood
жагъуэ зэрыхъунщи	unfortunately
зэрылажьэ щыгъын	uniform
зым хуэмыдэ	unique
зы	unit
еджапӀэ нэхъыщхьэ	university
мыцӀыху	unknown
армырамэ	unless
япэ	until
гъэщӀэгъуэн	unusual
и щхьэ	up
уэращ унафэ зыщӀыр	up to you
къэгъэщӀэрэщӀэн	update
къэщӀэрэщӀэн	update
нэхъыфӀ щӀыныгъэ	upgrade
нэхъыфӀ щӀын	upgrade
нэщхъей	upset
къалэдэс	urban
гухэлъ	urge
къыхуеджэн	urge
щӀэх	urgent
дэ	us
къэгъэсэбэпын	use
къэгъэсэбэпыныгъэ	use
къигъэсэбэпащ	used
сэбэп	useful
мыхьэнэншэ	useless
къызэрыгуэкӀ	usual
куэдрэ	usually
сэбэп хъуныгъэ	utility
зыгъэпсэхугъуэ	vacation
вакцинацэ	vaccination
вакцинэ	vaccine
вакуум	vacuum
хэлъагъукӀыгъуей	vague
пэж дыдэу щыӀэ	valid
псыхъуэ	valley
лъапӀэ	valuable
гъэлъэпӀэн	value
лъапӀэныгъэ	value
зэмылӀэужьыгъуэ	variety
зэхуэмыдэ	various
зэщхьэщыкӏын	vary
вазэ	vase
бгъуэ	vast
хадэхэкӀ	vegetable
хадэхэкӀ	vegetables
зэрызекӀуэ	vehicle
сатуущӀэ	vendor
тыкуэнтет	vendor
щхъухь	venom
предприятэ	venture
ӀуэхущӀапӀэ	venture
ӀуэхущӀапӀэ	venue
лъэщапӀэ	venue
къэпщытэн	verify
куэд зылэжь	versatile
лӀэужьыгъуэ	version
занщӀэу дэкӀуей	vertical
икъукӀэ	very
сыту фӀыт	very good
щыкъу	vessel
зэрыхузэфӀэкӀ	via
атмосферэ	vibe
нэрымылъагъу къару	vibes
бзаджэ	vicious
текӀуэдэ	victim
видео	video
теплъэ	view
къуажэ	village
лейзехьэ	villain
бзаджащӀэ	villain
серчэ	vinegar
винтажнэ	vintage
залымыгъэ	violence
лъэщыгъэкӀэ къызэфӀэгъэкӀа хъу	violent
зыри зэмыӀуса	virgin
къыпщыхъу	virtual
фӀагъ	virtue
лъапӀагъ	virtue
лъагъуныгъэ	vision
къекӀуэлӀэн	visit
кӀуэн	visit
плъагъу	visual
гъащӀэм щиӀэ мыхьэнэ	vital
лыд	vivid
нур	vivid
псалъалъэ	vocabulary
макъ	voice
нэщӀ	void
пщалъэ	volume
объем	volume
мардэ	volume
езым и фӀэфӀыныгъэкӀэ Ӏуэху гуэр зыщӀэ	volunteer
къыхэчын	vomit
къэжьыныгъэ	vomit
тӀасхъапӀэ	vulnerable
лэжьапщӀэ	wage
улахуэ	wages
бгы	waist
ежьэн	wait
щхьэгъэрыт	waiter
ежьэ	waiting
пэплъэ	waiting
къэгъэушын	wake
къэушын	wake up
къэкӀухьын	walk
дэрэжэгъуэ	walk
къэкӀухьыныгъэ	walking
блын	wall
ахъшалъэ	wallet
гъуэщэн	wander
ухуей	wanna
хуеин	want
хуейт	wanted
зауэ	war
шкӀаф	wardrobe
гъэтӀылъыпӀэ	warehouse
хуабэ	warm
гъэхуэбэн	warm
хъыбар егъэщӀэн	warn
хъыбар егъэщӀэныгъэ	warning
зауэлӀ	warrior
щыӀащ	was
тхьэщӀын	wash
хьэулей щӀын	waste
къыдэхуахэр	waste
кӀэлъыплъын	watch
псы	water
хъарбыз	watermelon
толъкъун	wave
гъуэгу	way
дэ	we
дэ дыщытщ	we are
дэ тхуэщӀэнущ	we can
къарууншэ	weak
къарууншагъэ	weakness
къулеягъ	wealth
къулей	wealthy
щыгъэгъын	wear
хуэпа	wearing
щӀыуэпс	weather
хьэгъуэлӀыгъуэ	wedding
Бэрэжьей	Wednesday
удзыжь	weed
тхьэмахуэ	week
зыгъэпсэхугъуэ	weekend
щыдэс	weekend
хьэлъагъ	weight
тегъэхьэлъэн	weight
гъэщӀэгъуэн	weird
телъыджэ	weird
къеблагъэ	welcome
псэукӀэ зэпэщ	welfare
Тэмэм	Well
Хъарзынэ	Well
лэжьыгъэ фӀы дыдэ	well done
кӀуащ	went
щыӀахэщ	were
къухьэпӀэ	west
псыф	wet
джей	whale
сыт	what
уэ щэ	what about you
сыт уэ пщӀэр	what are you doing
сыт уэ иджыпсту пщӀэр	what are you doing now
сыт уэ иджыпсту дыдэ пщӀэр	what are you doing right now
сыт блэжьыр	what do you do
сыт уэ ахъшэ къызэрыблэжьыр упсэун щхьа	what do you do for a living
сыт жыпӀэм къибгъэкӀыр	what do you mean
сыт уэ узыхуейр	what do you want
сыт къэхъуар	what happened
сыту щыт	what is
сыт мыр	what is this
сыт уи лэжьыгъжм и мыхьэнэр	what is your job
сыт уи цӀэр	what is your name
дауэ ущыт	what's up
хэт уэ уицӀэр	what's your name
дэтхэнэрами	whatever
гуэдз	wheat
шэрхъ	wheel
дапщэщ	when
дапщэщ	whenever
даӀэ	where
дэнэ ущыӀэ	where are you
дэнэ ущыщ	where are you from
дэнэ ущыӀэ иджыпсту	where are you now
дэнэ ущыпсэур	where do you live
дэнэ щыӀэ	where is
абы щыгъуэ сыт	whereas
хьэмэрэ	whether
дэтхэнэр	which
узыншэу	while
апщӀэндэху	while
Ӏущащэ	whisper
фиин	whistle
хужь	white
хэт	who
ухэт уэ	who are you
хэт щыт	who is
хэт мыр	who is this
псо	whole
хэт	whom
хэт ей	whose
сыт щхьэкӀэ	why
сыт щӀэхьэуэр	why not
Ӏей	wicked
ябгэ	wicked
бгъуэ	wide
фызабэ	widow
бгъуагъ	width
щхьэгъусэ	wife
емылыджэ мыгъасэ	wild
къэхъунущ	will
щыӀэнущ	will
хуитыныгъэ	will
хуей	willing
текӀуэн	win
жьы	wind
щхьэгъубжэ	window
жьыкъепщэ	windy
шагъыр	wine
щӀымахуэ	winter
лъэщӀын	wipe
гъущӀ кӀапсэ	wire
Ӏущагъ	wisdom
акъылыфӀэ	wise
Ӏущ	wise
зыгуэрым хуеин	wish
хуеиныгъэ	wish
нэхъыфӀ дыдэкӀэ сыпхохъуахъуэ	wish you all the best
уд	witch
и гъусэу	with
къеджэжын	withdraw
кӏэух псальэ	withdrawal
ику	within
предлог	without
кӀэлъыплъын	witness
щыхьэт	witness
акъыл жан	witty
дыгъужь	wolf
цӀыхубз	woman
бзылъхугъэ	women
текӀуащ	won
щыӀэнукъым	won't
телъыджэлажьэ	wonder
телъыджэ	wonderful
жыг	wood
цы	wool
псалъэ	word
псалъэхэр	words
лэжьыгъэ	work
лэжьэн	work
зыгъэсэн	work out
лажьэ	working
дуней	world
хьэмбылу	worm
куэдрэ ящыгъа	worn
пӀейтӀея	worried
гузэвэн	worry
нэхъ Ӏей	worse
щхьэщэ щӀын	worship
Ӏей дыдэ	worst
уасэ	worth
абы и уасэ	worth it
зыхуэфащэ	worthy
уӀэгъэ	wound
Уа	Wow
зэгъэдзэкӀын	wrap
губжь	wrath
Ӏэпщэ	wrist
тхэн	write
Мыбдеж къитхэ	Write here
тхыгъэ	writing
ятха	written
пцӀы	wrong
мыпэж	wrong
пэжкъым	wrong
итхащ	wrote
пщӀантӀэ	yard
хущхьэн	yawn
хущхьэ	yawn
НтӀэ	Yeah
илъэс	year
илъэсхэр	years
щӀакхъуэгъэтэдж	yeast
кӀиин	yell
гъуэжь	yellow
НтӀэ	Yes
нтӀэ,псэм хуэдэ	yes baby
нтӀэ, лъапӀэ	yes dear
нтӀэ, лъапӀэ	yes honey
нтӀэ, си лъагъуныгъэ	yes my love
нтӀэ, дауикӀ	yes of course
дыгъуасэ	yesterday
иджыри	yet
етын	yield
уэ	you
уэ ущытщ	you are
уэ удахэщ	you are beautiful
уэ сыту удахэ	you are so beautiful
кхъыӀэ	you are welcome
уэ пхуэщӀэнущ	you can
Уэ бощӀэ	You know
уэри	you too
кхъа	you're welcome
кхъыӀэ	you're welcome
щӀалэ	young
ууей	your
кхъа	your welcome
кхъыӀэ	your welcome
езы	yourself
щӀалэгъуэ	youth
кхъыӀэ	you’re welcome
ӀэфӀ	yummy
нол	zero
зыри	zero
