i	a
khyndiat	a little
shibun	a lot
bun bha	a lot of
ieh	abandon
shah ieh	abandoned
iaineh	abide
jinglah	ability
lah	able
shaphang	about
halor	above
shabar ri	abroad
jingbym don	absence
bym don	absent
ka jingpyntikna	absolutely
kjit	absorb
kaba batai lyngkot	abstract
kaba sngew um kaba iohi	abstract
bakhyllah	absurd
jingpahuh	abundance
pahuh	abundant
jingpyndonkam bakla	abuse
kren sih	abuse
rukom kynnoh	accent
pdiang	accept
ka ba lah ban pyndonkam	access
aksiden	accident
jaka sah	accommodation
ioh jop	accomplish
la lah	accomplished
kat kum	according
akount	account
jingbeit	accuracy
ba biang thik	accurate
shah kynnoh	accused
jingktha	ache
iohjop	achieve
jinglah	achievement
kubur	acknowledge
ba shu ithuh	acquaintance
lum	acquire
ioh	acquired
jingioh	acquisition
na shilaing sha shilaing	across
leh	act
jingleh	action
ba shait	active
ba smat	active
ki jingleh	activities
ki jingpyn leh kai	activity
ki kam	activity
tyngshop	actor
da shisha	actual
ha ka jingshisha	actually
ba jur	acute
pyniabiang	adapt
bteng	add
kyrni	addicted
jingbteng	addition
ba bteng	additional
ka jaka sah	address
ka jingkren	address
biang	adequate
ba iasyndah	adjacent
kaba thew ia ka jinglong jingman	adjective
pyniabiang	adjust
iaroh	admire
phla	admit
pdiang	admit
kam	adopt
kaba itynnad	adorable
iaid shaphrang	advance
ba lah shai	advanced
jingmyntoi	advantage
ka jingjia ba phylla	adventure
adverb	adverb
jingpynbna	advertisement
jingpynbna	advertising
jingiasyllok	advice
iasyllok	advise
iasaid	advocate
nongiasaid	advocate
ka jingitynand	aesthetic
bha briew	aesthetic
ka jingjia	affair
ba klim	affair
ktah	affect
jingieid	affection
jingkotbor ban siew	afford
ba lah ioh	affordable
tieng	afraid
hadien	after
nohphai sngi	afternoon
hadien	afterwards
sa shi sien	again
pyrshah	against
yrta	age
u nongtalbi	agency
mynnong	agent
ba dukhi	aggressive
ba jem met	agile
mynshuwa	ago
mynjur	agree
jingiakut	agreement
ka rep ka riang	agriculture
sha khmat	ahead
jingiarap	aid
thew	aim
lyer	air
ka jaka hiar liengsuin	airport
lynti iaid	aisle
pyntieng	alarm
kyiad	alcohol
husiar	alert
ba dang im	alive
baroh-ar	all
biang lut	all right
donbok	all the best
shah	allow
la shah	allowed
lah jan	almost
marwei	alone
ryngkat lang	along
lah da dep	already
Hooid to	Alright
bat	also
da kawei ka lad	alternative
wat la	although
borabor	always
long	am
baphylla	amazing
ba bun jingmut	ambiguous
ba don jingthmu ne ka thong	ambition
kaba don ka jingthrang	ambitious
pynbeit	amend
hapdeng	amid
hapdeng	among
hapdeng jong ngi	among us
tyngka	amount
kan poi	amount
ba komik	amusing
u	an
ka	an
kaba wad ia ki jintip	analysis
kaba pule bniah	analysis
ki longshwa	ancestors
u nar ka lieng ban pynneh ia ka lieng	anchor
mynhyndai	ancient
barim	ancient
bad	and
bad ma phi	and you
angel	angel
jingbitar	anger
ka dong	angle
bitar	angry
mrad	animal
mat sohlah	ankle
lyngkhuh	anniversary
jingpynbna	announcement
pyndik	annoy
shrai	annoyed
bapynshrai	annoying
shi sien shi snem	annual
bym ithuh	anonymous
uwei pat	another
jubab	answer
ka jingiathuh lypa	anticipate
ka jingiashem	anticipate
ka jingkhmih lynti	anticipate
ka jing ia kynduh	anticipate
jingpisa	anxiety
khuslai jingmut	anxious
kano kano	any
don shuh	anymore
ym leh	anymore
wan	anymore
mano mano ruh	anyone
kaei kaei ruh	anything
da kumno kumno	anyway
niuma	anyways
la ka jong	apart
ka iing	apartment
pan map	apologize
ba paw shai	apparent
imat	apparently
jingkyntu	appeal
wan paw	appear
ka jingwan paw	appearance
wan paw	appeared
jingthngan	appetite
apul	apple
aplikeshon	application
ka jing thep	application
pynlong da kane	apply
jingiakut	appointment
sngewbha	appreciate
sngewnguh	appreciate
ka jingsngewnguh	appreciation
ka rukom leh	approach
wan shajan	approach
ba iadei	appropriate
jingmynjur	approval
mynjur	approve
ba la mynjur	approved
kumba	approximately
iaiong	april
thurmur	arbitrary
u nongsaiñ dur jong ka iing	architect
ka laiñ ba peit ia ka jingpynwandur ia ka iing	architecture
ka jingsaiñ dur ia ka iing	architecture
dulir barim	archive
ki long	are
phi dei	are you
phi bun kam	are you busy
phi lah shong kurim	are you married
phi dei iba lah iathoh ne ba dang marwei	are you married or single
Hato	Are you still there?
phi dang don hangto?	Are you still there?
phi don hangto	are you there
ka jaka	area
ia nia	argue
jingiania	argument
ieng	arise
ksan 'ti	arm
kynhun shipai	army
sawdong	around
pynbiang	arrange
jingpynbeit	arrangement
jingwan poi	arrival
poi	arrive
lah poi	arrived
sarong	arrogant
khnam	arrow
jingdro	art
ka artikl	article
ba shu buh	artificial
nongdro	artist
kum	as
katba dang	as long as
lang bad	as well
ryngkat bad	as well as
dpei	ash
lah lehrain	ashamed
kylli	ask
kylli	asked
ba iohthiah	asleep
kaba iadei	aspect
Assamese	Assamese
leh thombor	assault
jingialang	assembly
ba shlur	assertive
ba sngew skhem ha lade	assertive
thew	assess
kaba peit thuh bha	assessment
jingdon	asset
jingdon jingem	assets
bynshet	assign
ka jingai jingthoh	assignment
iarap	assist
nongiarap	assistant
pyniajan	associate
ba iadei	associated
jingiadei	association
mutdur	assume
kaba tharai	assumption
kaba mutdur	assumption
ha	at
lada kumno kumno	at least
lah bam	ate
nongmareh	athlete
pyndait	attach
lah suh lang	attached
ka jingpyndait lang	attachment
ka jinghiar thma	attack
pyrshang	attempt
jingpyrshang	attempt
ban leit	attend
jingwan briew	attendance
ka jingshah skhor	attention
ka jinglong	attitude
khring	attract
jingkhring	attraction
baiphuh	attractive
ka jinglong tynrai	attribute
nongpeitkai	audience
nailar	august
nia	aunt
nia	aunty
ba shisha	authentic
nongthoh	author
iktiar	authority
pyrem	autumn
don	available
ba shu malu mala	average
kiar	avoid
ba lah kyndit	awake
khusnam	award
tip	aware
jingtip	awareness
shawei	away
ka ba sngewtynnad eh	awesome
kaba sniew tikna	awful
ba sngew lehrain	awkward
Aymara	Aymara
khyllung	baby
uba shong samla	bachelor
sha dien	back
na dien	back
ka met	back
kaba long nadien	background
kaba nadien	background
basniew	bad
pla	bag
jingriam	bait
ban shet khlem umphniang	bake
jaka shet cake	bakery
u sada	baking soda
jingryntih	balance
boll	ball
Bambara	Bambara
ka kait	banana
ki kynhun tem	band
u jri teh shynnuih	band
kyndar	bang
ka bank	bank
ka jaka die kyiad	bar
krai	barely
dait dor	bargain
thalap dieng	bark
wiar	bark
krai	barley
jingker	barrier
nongrim	base
la shong nongrim ha	based
don ha	based
khrum	basement
kiba na sdang	basic
haba kumta	basically
kynbat	basil
khun pongka	bastard
u kynja medal	batch
kano kano ka jingthaw ba la pynlong shisien long	batch
ka kynhun	batch
sum	bath
kamra sum	bathroom
u bateri	battery
thma	battle
u latar pad	bay
ka kynja dam	bay
ki wah	bay
long	be
da husiar	be careful
rud duriaw	beach
ka jingthaba	beam
rymbai	beans
dngiem	bear
shah	bear
tmoh	beard
iaishah	bearing
mrad khlaw	beast
jingtied	beat
tied	beat
bhabriew	beautiful
jingbhabriew	beauty
kylla long	became
namar	because
kylla long	become
ka jingthiah	bed
kamra thiah	bedroom
u ngap	bee
doh masi	beef
la ju long	been
iad hiar	beer
shwa	before
lah sdang	began
sdang	begin
jingsdang	beginning
ha ha jaka jong	behalf
leh	behave
jingleh	behavior
jinglehshilaing	behaviour
shadien	behind
jinglong	being
jingngeit	belief
ngeit	believe
kpoh	belly
dei jong	belong
baieid	beloved
ha trai	below
panpoh	belt
ka ben	bench
pynkhun	bend
ha trai	beneath
jingmyntoi	benefit
pynmyntoi	benefit
ki jingmyntoi	benefits
ha syndah	beside
nalor kata	besides
bha tam	best
donbok	best of luck
da kaba burom	best regards
kham bha	better
hapdeng	between
ka jingdih	beverage
palat	beyond
Bhojpuri	Bhojpuri
jingleh shiliang	bias
leh shiliang	biased
ka saikil	bicycle
am dor	bid
ba heh	big
ka baik (bike)	bike
ka tuk tuk	bike
ka bill	bill
khum	bind
ka sim	bird
sngkha	birthday
khyndiat	bit
jingdait	bite
dait	bite
jingkthang	bitter
ba iong	black
syrti	blade
jingkynnoh	blame
kynnoh	blame
thylli	blank
ka nep	blanket
pynbthei	blast
pynlip rong	bleach
khleh	blend
kyrkhu	bless
ba la kyrkhu	blessed
matlah	blind
jingsngewhun	bliss
khang lad	block
ka snam	blood
phuh	bloom
pyrsad	blow
rong suin bneng	blue
loin	blunt
board	board
lieng	boat
ka met	body
pynthnam	boil
bashlur	bold
jingiateh	bond
shyieng	bone
phah buh lypa	book
ka kot pule	book
ba pynshlur	boost
ba ai mynsiem ne jingiarap	boost
ba ai bor	booster
but	boot
ki but	boots
u pud	border
ngiah	bore
ka bym sngewtynnad	bored
bym sngewtynnad	boring
ba la kha	born
pan kylliang	borrow
baheh	boss
baroh-ar	both
pyndik	bother
pynshitom	bother
bitor	bottle
ha trai	bottom
la thied	bought
kynthih	bounce
ba la teh	bound
ki pud	boundaries
nguh	bow
ka khuri	bowl
ka bol	bowl
synduk	box
khynnah shynrang	boy
u paralok shynrang	boyfriend
jingdeng kti	bracelet
jabieng	brain
tnat	branch
shon shap	brand
shlur	brave
ka jingkynkheiñ ain	breach
ruti	bread
pynkhein	break
ioh shong thait	break
ka jingbam step	breakfast
shadem	breast
jingring mynsien	breath
ring mynsiem	breathe
ki jait	breed
maw it	brick
ka nongleit kurim	bride
jingkieng	bridge
balyngkot	brief
shai	bright
ba proh jabieng	brilliant
ba stad	brilliant
ba thaba	brilliant
wanrah	bring
ka rukom khot ieit ia u paralok	bro
hynmen ne para shynrang	bro
baiar	broad
ba pyni ha TB ne ha radio	broadcast
ba lah khein	broke
ba lah khein	broken
synsar	broom
para shynrang	brother
kynum	brother in law
la wanrah	brought
rong ktieh	brown
u brut	brush
borti	bucket
paralok	buddy
jingmang tyngka	budget
khniang	bug
tei	build
jingtei	building
ba la tei	built
kham bun	bulk
masi dap	bull
leh heh	bully
tyngkhuh	bump
khum	bunch
song	bundle
jingkit	burden
pynkit	burden
ba la tep	buried
thang	burn
bthei	burst
tep	bury
bos	bus
lawbniap	bush
kam khaii pateng	business
kam lajong	business
ioh kem	bust
bun kam	busy
tangba	but
makhon	butter
thapbalieh	butterfly
budam	button
thied	buy
da	by
phi lah ban iathuh	by the way
batai	by the way
leit suk	bye
kubi	cabbage
duli	cabinet
ruh	cage
cake	cake
khun masi	calf
jingkhot	call
khot	call
khot ia nga	call me
la khot	called
jai jai	calm
la wan	came
ka kam ba la pynbeit ryntih	campaign
ka jingialang paidbah	campaign
jinglah	can
lah	can
ym	can't
pynduh	Cancel
Pyndam	Cancel
jingpang bampong	cancer
ba lah	capable
jinglah	capacity
nongbah	capital
ba la shon dak	caption
kem	capture
kali	car
ka jingtrei	career
phikir	careful
da ka jingphikir	carefully
bym phikir	careless
ba sngewlem	caring
mistri	carpenter
dari	carpet
kajor	carrot
rah	carry
iaid shaphrang	carry on
leh	carry out
kase	case
i pla ba thep it	case
pisa nokot	cash
ka jingkhih	cast
ka kut	castle
kaba shu long hateng	casual
miaw	cat
kem	catch
ka bynta	category
ka jingpynshong ter ter	category
jingri jingdup	cattle
shah kem	caught
ka daw	cause
pynjialong	cause
jingmaham	caution
ba husiar	cautious
krem	cave
sangeh	cease
sad	ceiling
khawai	celebrate
u battery	cell
ka phatok	cell
pdeng	center
spah snem	century
ki kynja jingbam kew	cereal
u jingbam	cereal
jingrakhe	ceremony
thikna	certain
kaba pyntikna	certainly
syrnod	certificate
kynjri	chain
shuki	chair
jingtynjuh	challenge
tynjuh	challenge
lad	chance
bujli	change
pher	change
jingkulmar	chaos
jinglong	character
ki jinglong	characteristics
shim peisa	charge
jingasbun	charity
ba i shoh biej	charming
ba i main	charming
ki dak khein	chart
beh	chase
jingiakrenkai	chat
krenkai	chat
tad dor	cheap
leh tuh	cheat
leh tuh	cheating
peit bha	check
ngap	cheek
risa	cheer
kmen	cheerful
kaba ia risa	cheers
ka kinja makhon	cheese
ka tnat pule ki stad science	chemistry
ñiewkor	cherish
kheiñkor	cherish
chess	chess
shadem	chest
ktha	chew
syiar	chicken
khlieh	chief
khynnah	child
jinglong khynnah	childhood
ki khun	children
bapjah	chill
pynpjah	chill
jingpjah	chill
ki atoskhana	chimneys
tmoh	chin
u shoklet	chocolate
jingjied	choice
jied	choose
pom	chop
ki kam ki jam	chores
basngaid	chubby
iingmane	church
u diengsisia	cinnamon
ka pyllun	circle
jinglong jingman	circumstances
traishnong	citizen
nongbah	city
kam	claim
jingkam	claim
pynshai	clarify
klass	class
dew byrtha	clay
khuid	clean
bashai	clear
pynkhuid	clear
babu	clerk
stad	clever
nongtheid	client
riat	cliff
jinglong ka suin bneng	climate
kiew	climb
ba khnap	clingy
ba snoh	clingy
baje	clock
jan	close
khang	close
duli	closet
jain	cloth
ki jain phong	clothes
lyoh	cloud
dum lyoh	cloudy
jokor	clown
jingai dak	clue
nuksa	clue
thurmur	clumsy
kaba tylli	cluster
nonghikai	coach
hikai	coach
dww iong	coal
rud duriaw	coast
ka koat	coat
kofi	coffee
kaba shemphang	cognitive
kaba sngewthuh	cognitive
jiaryngkhat	coincidence
khriat	cold
suh khriat	cold
khyllem	collapse
jingdeng ryndang	collar
ba iatrei lang	colleague
baiatrei lang	colleagues
lum	collect
jinglum	collection
kolej	college
rong	color
iohthiah bha	colorless green ideas slept furiously
rong	colour
u paia	column
snad	comb
khleh lang	combination
kynthup lang	combination
bteng lang	combine
ale	come
wan	come
ale hangne	come here
ale	come on
jingsuk	comfort
suk	comfortable
jingwan	coming
ban wan shen shen	coming soon
hukum	command
kynthoh	comment
ka jaka ia die ia thied	commercial
hukum	commission
aiti	commit
jingkular	commitment
ba la aiti	committed
mar	commodity
ba kynrei	common
ba long kumjuh	common
kaba ia kren ia khana	communicate
kaba ia kren	communication
jaitbynriew	community
ba leit ba wan	commute
paralok	companion
kompani	company
ianujor	compare
jingianujor	comparison
jingisnei	compassion
ba sngewlem	compassionate
baihap	compatible
bapura	compete
batbit	competent
jingiakob	competition
haba jur bha ka jingialeh	competitive
jingiakhun ne ka jingiakop	competitive
ujor	complain
jingujor	complaint
kaba pynbha shuh shuh	complement
pyndep	complete
pura	completely
bakyllain	complex
ka jingmynjur	compliance
bakyllain	complicated
iaroh	compliment
ba mynjur	comply
kaba shna	composition
kaba pynlong	composition
phyllaw	compound
jingsngewthuh	comprehension
kaba iar	comprehensive
ka jylliew	comprehensive
ka jingia mynjur	compromise
la jingiasuk	compromise
kaba kongsan	compulsory
komputar	computer
pynleit jingmut	concentrate
ka jingmut	concept
shaphang	concern
khuslai jingmut	concern
ba iadei	concerned
ka prokram ba rwai ba tem	concert
ka jingpynkut	conclusion
dew bilat	concrete
baskhem	concrete
pynskhem	concrete
kyndon	condition
ki kyndon	conditions
ka jinglong	conduct
pynlong	conduct
jingialang	conference
phla	confess
jingshlur	confidence
sngew shlur	confident
pynskhem	confirm
jingialeh pyrshah	conflict
kulmar jingmut	confused
jingkulmar	confusion
donbok	congrats
donbok	congratulation
donbok	congratulations
ka jingiasoh	conjunction
bteng	connect
ioh jop	conquer
tip briew	conscious
jingtipbriew	consciousness
mynjur	consent
jingmynjur	consent
ki jingjia babud	consequences
jingpynneh	conservation
ba pyrkhing	conservative
ba bat tynrai	conservative
pyrkhat lang	consider
pyrkhat	consider
pyrkhat	considered
kynthup	consist
ba iaineh	consistency
ba skhem	consistent
ba dei	consistent
ba iaineh	constant
khah khah	constantly
man la ka por	constantly
kaba eh kpoh	constipation
jingtei	construction
bam	consume
jingbam bathiang	consumption
ban ia kren	contact
ban ia tyngkhuh	contact
ba iabit	contagious
kynthup	contain
kynthup	contains
ba ha kajuh ka yrta	contemporary
jingibein	contempt
hun	content
jingiakob	contest
ki bynta kiba bud shuwa ka senten	context
dew bah	continent
bteng	continue
jingiakut	contract
jingpyniapher	contrast
pyniapher	contrast
ai lem	contribute
jingai	contribution
buh kabu	control
ka jingwanrah jingeh	controversial
ba suk	convenience
ka jingbit jingbiang	convenience
basuk	convenient
jingiakren	conversation
pynkylla	convert
kit	convey
rah	convey
lam	convey
ban pynkohnguh	convince
pynngeit	convinced
shet	cook
nongshet	cook
jingshet	cooking
bapjah	cool
ba i khain	cool
jingiatrei lang	cooperation
jinglah shah	cope
jingiaishah	cope
tama	copper
tynrai	core
rewhadem	corn
kyndong	corner
badei	correct
ka dor	cost
jingriam	costume
iing	cottage
rui	cotton
ka shuki shong kai	couch
jyrhoh	cough
lah ban	could
dorbar	council
niew	count
ka jaka lum pisa ha bank ne ha kino kino ki dukan ne ophis	counter
ri	country
shnong-kyndong	countryside
shijur	couple
jingshlur	courage
ka jingtuid	course
ka jingroi	course
ki rukom leit pule	course
ka jingiaid	course
iingshari	court
ka akor	courtesy
bakha	cousin
tap	cover
masi	cow
khawpyut	coward
sngewsuk	cozy
sngewaram	cozy
tham	crab
jingorpait	crack
pynpait	crack
ka jingshna ba na ka kti	craft
eit	crap
Ia tyngkhuh	crash
jingthrang	craving
par	crawl
khlehbieit	crazy
pynjialong	create
ba don ka sap ban shna ban thoh	creative
kaba ai shah	credit
par sor sor	creep
ba i kynsha	creepy
kynhun nongtrei	crew
kam beain	crime
ba sngewkynjing	cringe
jingeh	crisis
ki kyndon	criteria
bakongsan	critical
jingwad dong	criticism
jingmih	crop
ki jingthung	crops
diengphna	cross
tyngap	crow
paid	crowd
bun briew	crowded
pansngiat	crown
bakongsan	crucial
ba lehbein	cruel
ba shong lieng ha duriaw	cruise
nion	crush
khniot	crush
iam	cry
soh khia	cucumber
iakdup	cuddle
kolshor	culture
buit tuh	cunning
pela	cup
almari	cupboard
khang	curb
pynjem	cure
jingpynjem	cure
pakhang shnong	curfew
jingkwah tip	curiosity
jingkwah tip	curious
bakdor	curly
pisa	currency
bamynta	current
iamynta	current
bamynta	currently
jingtim	curse
pyrda	curtain
kushion	cushion
dustur	custom
nongtheid	customer
ki durtur	customs
ot	cut
jingot	cut
iskuin	cute
ka saikyl (cycle)	cycle
ba shong saikil	cycling
pa	dad
pa	daddy
man ka sngi	daily
jaka ri masi	dairy
den	dam
jingjulor	damage
pynjulor	damage
adee	damn
sngem	damp
shad	dance
jingma	danger
ba ma	dangerous
dum	dark
baieid	darling
ban mareh sted	dash
data	data
ka tarik	date
ka jingiakynduh	date
khun kynthei	daughter
Sngi Balang	day
lah iap	dead
ka por ba la buh	deadline
Ka por pyndep	deadline
kyllut	deaf
bate	deal
jingiakut	deal
Ba kordor	dear
ba ja	dear
Khublei Baroh	Dear All
Ko Nongthied	Dear Customer
Ki kmie ki kpa baieid	Dear Parents
Bah Badonburom	Dear Sir
Khynnah skul baieid	Dear students
Ki nongiatreilang baieid	Dear Team
jingiap	death
iatai nia	debate
khate	debit
kiba sah	debris
ram	debt
phew snem	decade
pyut	decay
ba la khlad	deceased
shukor	deceive
nohprah	december
don burom	decent
rai	decide
la rai	decided
ka rai	decision
pynkup	deck
jinghiar	decline
hiar	decrease
hok ia ka kam	dedicated
trei shitom	dedicated
jingminot	dedication
ka jingleh	deed
bajylliew	deep
skei	deer
kabym ia mynjur lang	default
pynrem	defeat
jingpynrem	defeat
iada	defend
ai jingmut	define
da kaba thikna	definitely
jingmut	definition
ka nam	degree
ka kyrdan	degree
jingpynslem	delay
pynslem	delay
ba lah slem	delayed
pyndam	delete
ba leh khnang	deliberate
ba jem doh	delicate
ba bang	delicious
jingkmen	delight
ka jingkmen	delighted
ai	deliver
la pynpoi	delivered
jingpynpoi	delivery
jingdawa	demand
dawa	demand
da dawa	demanding
synshar paidbah	democracy
ksuid	demon
pynin	demonstrate
la len	denied
ka jingrben	density
doktor bniat	dentist
len	deny
ka tnat	department
jingleit	departure
shaniah	depend
phah	deploy
jingthep	deposit
thep	deposit
kaba sngewsih	depressed
kaba lynga pisa	depressed
jingsngewsih khtang	depression
jingjylliew	depth
batai	describe
jingbatai	description
rikhlaw	desert
don hok	deserve
ka jingpynwandur	design
kyrdan	designation
kwah	desire
jingkwah	desire
meij	desk
duh jingkyrmen	despair
ba khlem don jingkyrmen	desperate
wat la katta ruh	despite
jingbam bathiang	dessert
ka thong	destination
nusip	destiny
pynjulor	destroy
jingjulor	destruction
kaba peit bniah	detail
ki jingtip ba bniah	details
shem	detect
jingmut jingmut	determination
khein	determine
kut jingmut	determine
kut jingmut	determined
julor	devastated
roi	develop
ba lah shai	developed
jingkiew shaphrang	development
ka tiar	device
soitan	devil
ba don ha syndah ha baroh ki liang	devoted
Dhivehi	Dhivehi
jingpang shini	diabetes
pynhiar kpoh	diarrhea
ka kot ba thoh ia ki jingshem ne jingkynmaw shimet	diary
ka dikshonari	dictionary
la leh	did
iap	die
lah iap	died
ka rukom bam rukom dih	diet
jingiapher	difference
pher	different
ba eh	difficult
tih	dig
burom	dignity
ba minot	diligent
ja miet	dinner
wieh	dip
beit beit	direct
jingkdew lynti	direction
nongpyniaid	director
jaboh	dirt
ba jaboh	dirty
ba la pynduh	disable
bym lah shuh	disable
ba duna ha ka dkhot met	disable
anna	disabled
jah noh	disappear
kaba sngewdiaw	disappointed
jingjulor	disaster
kyntait	discard
pynmih	discharge
ka jingpynbeit	discipline
pynduna dor	discount
shem	discover
jinglehshiliang	discrimination
iakren	discuss
jingiakren	discussion
jingpang	disease
ki jingpang	diseases
pynriam	disguise
kaba i kynroi	disgusting
khiew	dish
ki khiew	dishes
phah noh	dismiss
phah	dispatch
jingpyni	display
ba lah ban bred noh	disposal
jingiania	dispute
jingjngai	distance
bakyrpang	distinct
pyniakhlad	distinguish
pyniapher	distinguish
jingpisa	distress
jingsam	distribution
district	district
pynwit	disturb
kharai	ditch
suh khlieh	dive
bapher	diverse
jingiapher	diversity
phiah	divide
ba kynja blei	divine
jingiakhlad	divorce
pyniakhlad	divorce
king baiong	dizzy
leh	do
phi ju	do you
phi ieid ne em ia nga	do you love me
doktor	doctor
kot	document
leh	does
kam ju	doesn't
um	doesn't
ksew	dog
Dogri	Dogri
jingleh	doing
khunmynriew	doll
ka hima	domain
ka jaka jongno jongno	domain
ha iing	domestic
ba hakhmat	dominant
wat	don't
Wat khuslai	Don't worry
aisbun	donate
lah dep	done
la ngiah	done
kada	donkey
ka jingdih drok	dope
ka jingpyntip shaphang kaei kaei	dope
kaba bha eh	dope
u briew ba biej	dope
pynlong arshah	double
arshah	double
artatien	doubt
jingartatien	doubt
u atta ne moida ba la khniot	dough
sharum	down
download	download
ka jingthoh ba pynwandur	draft
ring	drag
nur	drain
drama	drama
dro	draw
almari	drawer
jingdro	drawing
sngewma	dread
jingphohsniew	dream
phohsniew	dream
sopti	dress
pynpeit thliew	drill
dih	drink
jingdih	drink
kaba pynshlur	drive
niah	drive
jingpynhap	drop
pynhap	drop
pynhap	dropped
nem sniew	drought
buaid	drunk
rkhiang	dry
ka han	duck
ba khot ieit parlok	dude
dei ban siew	due
dei namar	due
na ka daw jong	due to
ka bym i phuh ne thaba	dull
kabym da i tynnad	dull
bym lait kren	dumb
bret	dump
ka jingai por	duration
ka por	duration
ha ka por	during
lyngba	during
pui pui	dust
ka kam ram	duty
sah	dwell
ba lah jan iap	dying
iwei iwei	each
iwei ia iwei	each other
la khmih lynti	eager
u khlieng	eagle
shkor	ear
mynshwa	earlier
dang kloi	early
kamai	earn
ki shkor	ears
pyrthei	earth
jumai	earthquake
jingsuk	ease
da kaba suk	easily
Mihngi	east
basuk	easy
bam	eat
ba bam	eating
kaba iadei bad ka ioh ka kot	economic
ka ioh ka kot	economy
thmeid	edge
pynbha	edit
pynitynnad	edit
jingnang jingstad	education
kaba don ka jingktah	effect
ba treikam	effective
ka jingtbit	efficiency
ka jingbuh bha	efficiency
ba bit	efficient
jingpyrshang	effort
pylleng	egg
soh baingon	eggplant
ka hangamei	ego
phra	eight
khatphra	eighteen
phraphew	eighty
lane	either
batai bniah	elaborate
tymbuit	elbow
ba kham heh	elder
tymmen	elderly
ba i shongkhia	elegant
ka jaka tynrai	element
hati	elephant
khatwei	eleven
don hok	eligible
pyndam	eliminate
lymda	else
lehrain	embarrassed
jinglehrain	embarrassing
kdup	embrace
mih	emerge
jingdonkam bakyrkieh	emergency
ba ktah ia ka mynsiem	emotional
dohnud	emotional
jingsngewlem	empathy
ka jingbanjur	emphasis
ban jur	emphasize
nongtrei	employee
nongtrei	employees
nongai kam	employer
kam	employment
thylli	empty
pynlah	enable
jingiakynduh	encounter
ai mynsiem	encourage
pynshlur	encourage
Kaba kut	end
ba don ha ka jingma	endangered
jingpyrshang	endeavor
bor ban iaineh	endurance
iaishah	endure
nongshun	enemy
bor	energy
pyntreikam	engage
ba leh iatehktien	engaged
jingiatehktien	engagement
engine	engine
engineer	engineer
Phareng	English
pynkiew	enhance
sngewtynnad	enjoy
sngewmuja	enjoy
baheh	enormous
lah biang	enough
pynthikna	ensure
rung	enter
jingmyllen	entertainment
jingshitrhem	enthusiasm
shitrhem	enthusiastic
baroh kawei	entire
ba don hok	entitled
u jinglong	entity
jaka rung	entrance
nongsengkam	entrepreneur
ka jingsop	envelope
mariang	environment
jingbishni	envy
kaba phylla	epic
kaba bha eh	epic
kaba kyrpang	epic
khlam	epidemic
mar katjuh	equal
ki tiar ba pyndonkam	equipment
ka jingbymleh shiliang	equity
ka hok	equity
jinglong markatjuh	equivalent
u rubber ba pyndam ia ka jingthoh	eraser
jingbakla	error
ioh phet	escape
khamtam	especially
ka essay	essay
jor	essence
badonkam	essential
seng	establish
ba la seng	established
ka bri ka khyndew	estate
antad	estimate
la antad	estimated
ter ter	etc
ba neh junom	eternal
ai jingsneng	ethics
thew	evaluate
jingtynjuh	evaluation
wat	even
wat la	even though
janmiet	evening
jingjia	event
ha kaba khatduh	eventually
borabor	ever
man	every
baroh	everybody
baroh	everyone
baroh	everything
sabut	evidence
jingsniew	evil
ka jingpyllong	evolution
kaba pyllong	evolve
Ewe	Ewe
bamynshwa	ex
thik	exact
thik	exactly
ka eksam	exam
eksamin	examine
nuksa	example
tam	exceed
biang palat	excellent
lait noh	except
lait noh	exception
ba shu pdiang kyrpang	exception
ba buh kyrpang	exception
jingpalat	excess
ba palat	excessive
jingbujli	exchange
shongshit	excited
jingshongshit	excitement
ba sngew shongshit	exciting
kyrpang	exclusive
daw	excuse
map ia nga	excuse me
pyndep	execute
jingpyniap	execution
u briew lane la bor kaba pyniaid ia ka ain	executive
jingkilan met	exercise
kilan met	exercise
ba pynlut lut phar	exhaust
lah thait	exhausted
pyni	exhibit
ka jingpyni paidbah	exhibition
long	exist
don	exist
jinglong	existence
ba don	existing
lynti mih	exit
pyniar	expand
khmih lynti	expect
ba lah mut	expected
ki jinglut	expenses
remdor	expensive
jingshemphang	experience
shemphang	experience
jingpyrshang	experiment
u ba la pyntbit ialade	expert
ba tbit	expert
ba lah kut	expired
batai	explain
jingbatai	explanation
shim kabu	exploit
wad bniah	explore
shalan	export
pynpaw	expose
kaba pyni paidbah	exposed
kaba thad	exposed
kaba pyni ne ai jingtip	exposure
kaba thad	exposure
ba pynsngew	express
kaba pynsngew ia la ki jingmut	expression
pynjlan	extend
ba la pynjlan	extended
ka jingpud	extension
u pud	extent
ba shabar	external
bym don shuh	extinct
kham tam	extra
sei	extract
baphylla	extraordinary
ba palat	extreme
kaba jur	extremely
ka khmat peit	eye
ki khmat	eyes
jain	fabric
kaba i shongkun	fabulous
peit mar khmat	face
dur khmat	face
pynsuk	facilitate
jaka bad tiar trei kam	facilities
Ki tiar pyndonkam	facility
ka jingshisha	fact
ka daw	factor
karkhana	factory
ki jingshisha	facts
sdang dum	fade
khlem lah	fail
bym longkam	failed
jingbym lah	failure
iepler	faint
balieh	fair
bym leh shiliang	fair
shu biang	fairly
puri	fairy
jingngeit	faith
ba iaineh	faithful
ba shu thok	fake
hap	fall
ur	fall
BYM SHISHA	false
nam	fame
baithuh	familiar
long iing	family
nem sniew	famine
pawnam	famous
pangkha	fan
kaba i mon	fancy
ka jingsngewtynnad	fantastic
sngewtynnad eh	fantastic
jngai	far
leitsuk	farewell
jaka ri jingri	farm
nongrep	farmer
kaba pynshoh biej	fascinating
ka jaiñ	fashion
stet	fast
kshong	fat
sngaid	fat
kaba mynsaw jur	fatal
ka nusib	fate
u kpa	father
jingthait	fatigue
jingbakla	fault
ba ieid tam	favorite
ka jingiarap	favour
baieid tam	favourite
sheptieng	fear
jingsheptieng	fear
jingkhawai bah	feast
sner	feather
ka dak	feature
ka dur ka dar	features
rymphang	february
lah ngiah	fed up
ka dor	fee
pynbam	feed
ka jingai jingpyntip	feedback
sngew	feel
jingsngew	feeling
ki kjat	feet
la hap	fell
para	fellow
sngew	felt
kynthei	female
tynrah kper	fence
ba sboh	fertile
tamasa	festival
leit shim	fetch
jingshitmet	fever
khyndiat	few
kham duna	fewer
uba la iatehktien	fiance
khana tang	fiction
madan	field
pynthor	field
bashyrkhei	fierce
khatsan	fifteen
sanphew	fifty
iashoh	fight
jingiashoh	fight
jingiashoh	fighting
ka jingwandur ka met ka phad	figure
ka ban wad ki lad ki lynti	figure
pyrshang ban wad ban lap	figure out
ka jingsop ba buh ki kot ki sla	file
ka kot ka sla	file
ba	file
pyndap	fill
ba la dap	filled
phlim	film
jaboh	filthy
ha kaba khatduh	finally
ai peisa	finance
ba iadei bad ka pisa tyngka.	financial
shem	find
shem	find out
dain kuna	fine
biang	fine
shynpriah kti	finger
pyndep	finish
lah dep	finished
ka ding	fire
ba skhem	firm
nyngkong	first
kyrteng	first name
dohkha	fish
ngiam	fit
san	five
pyndait	fix
bym khih	fixed
lama	flag
thaba	flash
ba madan	flat
jingduna	flaw
khlem bakla	flawless
phet krad	flee
ka doh	flesh
la her	flew
basuk ban khun	flex
bajem	flexible
jingher	flight
kylla	flip
leh samla	flirt
jingleh samla	flirting
per	float
jingshlei um	flood
madan	floor
moida	flour
jingtuid	flow
tuid	flow
syntiew	flower
shitmet	flu
pnah ktien	fluent
shaid shaid	fluently
phop phop	fluffy
ba long um	fluid
her	fly
kaba buh jingthmu	focus
lyoh khyndew	fog
ba dum lyoh	foggy
khylliap	fold
ki briew	folks
bud	follow
bud dien	follow up
babud	following
ka bam	food
beij	fool
pynbeij	fool
beij	foolish
kjat	foot
phutbol	football
na ka bynta	for
Kum ka nuksa	For example
kum ka nuksa	for instance
na ka bynta jong phi	for you
ba la adong	forbidden
pynbor	force
iathuh lypa	forecast
shyllang mat	forehead
na shabar ri	foreign
khlaw	forest
junom	forever
klet	forget
map	forgive
lah klet	forgot
proh	fork
jingwandur	form
pynwandur	form
kat kum ka rukom	formal
kaba leh da ka burom	formal
ba mynshwa	former
donbok	fortunately
nusip	fortune
sawphew	forty
sawphew ar	forty-two
shaphrang	forward
shakhmat	forward
ba ri shipor	foster
iakhun	fought
la shem	found
nongrim	foundation
saw	four
khatsaw	fourteen
myrsiang	fox
ba shroin	fragile
Ka ringdur	frame
ka dur ka dar ban trei	framework
jingshukor	fraud
ba khyllah	freak
laitluid	free
jinglaitluid	freedom
pjah slam	freeze
ka jingjia ba bun sien	frequency
bun sien	frequent
borabor	frequently
dang jyrngam	fresh
sngew pyngngad	fresh
kaba thymmai	fresh
ba dang im	fresh
sngi thohdieng	friday
ka fridge	fridge
ka duli thah	fridge
paralok	friend
ba pariah	friendly
ki paralok	friends
jinglong paralok	friendship
sheptieng	frightened
ba pynsheptieng	frightening
jakoid	frog
naduh	from
sha khmat	front
ba lah kylla thah	frozen
soh	fruit
ngiah	frustrated
ba la jrem	frustrated
ka petrol	fuel
ka umphniang	fuel
Fulfulde	Fulfulde
dap	full
jingsngewbha	fun
kaba pyntreikam	function
kaba kongsan	fundamental
jingleit ontep	funeral
shutia	funny
komik	funny
snieh mrad	fur
bitar	furious
ki shuki ki meij	furniture
kham jngai	further
kham pajih	further
shuh shuh	furthermore
ka lawei	future
iohnong	gain
jingiohnong	gain
jingialehkai	game
kaba lait jaka	gap
jaka set kali	garage
jakhlia	garbage
kper	garden
rynsun	garlic
phalor	gate
lum	gather
jingialumlang	gathering
thew	gauge
la ai	gave
ki tiar	gear
ki jin kali	gear
jinglong kynthei ne shynrang	gender
ba kynthup lang	general
ba shim kyllum lang	generally
pynmih	generate
pateng	generation
sbun	generous
ka riewstad	genius
u	genius
ka bynta	genre
ki jait	genre
jemnud	gentle
bashisha	genuine
jingkdew	gesture
ioh	get
phong jain	get dressed
khie	get up
jem noh kloi	get well soon
ioh	getting
ksuid	ghost
ksuid	ghosting
ramhah	giant
jingaisngewbha	gift
sying	ginger
khynnah kynthei	girl
paralok kynthei	girlfriend
ai	give
ieh noh	give up
ba la ai	given
kmen	glad
peit	glance
ka iit	glass
iitkhmat	glasses
iohi tang shi phang	glimpse
salonsar	global
ba dum	gloomy
jingsopkti	gloves
jingshai	glow
pynshai	glow
phuh	glow up
ka kom	glue
leit	go
iaid shaphrang	go ahead
leit noh	go away
leit thiah noh	go to bed
ka thong	goal
ki thong	goals
blang	goat
blei	god
u blei un kyrkhu ia phi	god bless you
leit	goes
leit	going
leit sha	going to
ksiar	gold
lah leit	gone
yn sa	gonna
ktieh	goo
bha	good
babha	good
ka janmiet kaba suk	good afternoon
leit suk	good bye
khublei	good day
khublei	good evening
jingtrei bha	good job
bhabriew	good looking
kit bok	good luck
Ka step ba kmen	good morning
khublei ia phi baieid jong nga	good morning my love
thiah suk	good night
leit suk	goodbye
thiah suk	goodnight
ki mar	goods
ka Google	Google
ka Google Transalate	Google Translate
han	goose
itynnat bha	gorgeous
kren lorni	gossip
la ioh	got
lah ioh	got it
sorkar	government
knieh	grab
kyrdan	grade
suki suki	gradually
ba la ioh nam na ka skul bah	graduate
ba pass college	graduate
kew	grain
ai	grant
la ai	granted
soh grape	grapes
bat	grasp
u phlang	grass
ainguh	grateful
jingsngewnguh	gratitude
jingtep	grave
ka rong dpei	gray
khraw	great
jinglalot	greed
lalot	greedy
jyrngam	green
ai khublei	greet
jingai khublei	greeting
jingkhublei	greetings
ka rong dew bilat	grey
ki laiñ	grid
jingsngewsih	grief
tylliat	grind
jingbat skhem	grip
mar bam	grocery
u nongleit kurim	groom
ka jingmih kyllum	gross
madan	ground
kynhun	group
roi	grow
la nang heh	grow
jingsan	growth
ba dukhi	grumpy
Guarani	Guarani
kaba thikna	guarantee
ap pahara	guard
antad	guess
nongwankai	guest
jinglam lynti	guidance
kdew lynti	guide
nongkdew lynti	guide
barem bapop	guilty
u shynrang	guy
ki shynrang	guys
jaka kilan met	gym
jingmlien	habit
jaka sah	habitat
ju don	had
khot	hail
sniuh	hair
shiteng	half
kamra heh	hall
ka kti	hand
jingbat	handle
u ba i khain	handsome
bhabriew	handsome
u ba main	handsome
wah	hang
ban ia shongkai	hang out
jia	happen
la jia	happened
jingkmen	happiness
kmen	happy
sngikha basuk	happy birthday
sngikha basuk ia phi	happy birthday to you
snem thymmai basuk	happy new year
baeh	hard
ba jynjar	hard
kham niar	hardly
jingjar ban iohi than	hardly ever
pynmynsaw	harm
jingpynmynsaw	harm
ba pynmynsaw	harmful
jingiahap	harmony
kaba shyrkhei	harsh
haba la dep thung	harvest
ot	harvest
kheit	harvest
don	has
jingisih	hate
don	have
ka sngi ba suk ba kmen ia phi!	have a good day
ka sngi basuk ia phi	have a nice day
bam ja step	have breakfast
leh sngewbha	have fun
phi lah dep bam	have you eaten
ba don	having
jingma	hazard
jingkahdum	haze
u	he
u don	he has
u long	he is
khlieh	head
ktha khlieh	headache
pynkhiah	heal
jingpynkhiah	healing
ka koit ka khiah	health
ba koit ba khiah	healthy
iohsngew	hear
la iohsngew	heard
klongsnam	heart
jingkhluid	heat
pynkhluid	heat
bneng	heaven
bakhia	heavy
bakyrkieh	hectic
jingjrong	height
ba ioh pateng	heir
jinglute	heist
la bat	held
dujok	hell
Khublei	Hello
kumno baieit	hello dear
khublei, kumno phi long	hello how are you
khublei kumno phi long	hello how are you doing
ka jingsop khlieh	helmet
iarap	help
ba iarap	helpful
namar kata	hence
ma ka	her
kynhun mrad	herd
hangne	here
jingioh pateng	heritage
ba sangeh	hesitate
ba ran	hesitate
ei	Hey
hei	Hey
Kumno	Hi
khublei kumno phi long	hi how are you
khublei	Hi there
ba buhrieh	hidden
buhrieh	hide
ka rukom khein katkum ka kyrdan	hierarchy
jrong	high
pynshai	highlight
iaid kjat	hike
iaidkai	hiking
kaba pynsammut	hilarious
lum	hill
ma u	him
kaba bashat jingmut	hint
skhep	hip
skhep	hips
wai	hire
jingwai	hiring
jong u	his
histori	history
tied	hit
Hmm	Hmm
jingpynmyllen	hobby
bat	hold
iai shah	hold on
Ban ap	hold on
thliew	hole
shuti	holiday
thylli	hollow
iing	home
ka kam ba hap ban leh hi hadien	homework
ba hok	honest
ban iathuh hok	honestly
ka ngap	Honey
baieid	Honey
burom	honor
jingtap khlieh	hood
jingwoh	hook
sohtyngkoh	hop
kyrmen	hope
jingkyrmen	hope
kyrmen	hopefully
bym don jingkyrmen	hopeless
pyngkiang	horizontal
jingpynsawa	horn
ba sniew palat	horrible
ka jingshyrkhei	horror
kulai	horse
ka aspatal	hospital
ka jaka ai jingsumar	hospital
jingpdiang sngewbha	hospitality
ba pyniaid	host
pyrshah	hostile
bakhluit	hot
iing basa	hotel
kynta	hour
ki kynta	hours
iing	house
long iing	household
kumno	how
ma phi patde	how about you
kumno phi long	how are you
Phi long kumno?	how are you doing
kumno phi long mynta ka sngi?	how are you doing today
phi long kumno mynta ka sngi	how are you today
khublei	how do you do
kumno	how is
kato tylli	how many
katno	how much
katno sien	how often
phi don katno snem	how old are you
ka long kumno ka sngi jong phi	how was your day
ka long kumno ka miet jong phi	how was your night
hynrei	however
ka jaka ba ia kynduh baroh ki lad	hub
u lok	hubby
kdup	hug
jingkdup	hug
baheh bha	huge
u briew	human
leh rit	humble
lyhop	humid
jinglyhop	humidity
shispah	hundred
thngan	hungry
thud	hunt
eriong	hurricane
pynkloi	hurry
pynkloi	hurry up
pynmong	hurt
pynpang	hurt
u lok	husband
ba leh tyngeh	hustle
kaba trei bun ki kam ban ioh pisa	hustle
iing trep	hut
jingleh khuid	hygiene
Nga	I
Nga dei	I am
Nga long	I am
nga biang	I am fine
Nga lah	I can
Ngam lah	I can't
Nga mynjur	I do
Ngam tip	I do not know
Ngam sngewthuh	I do not understand
Ngam ju	I don't
Ngam tip	I don't know
Ngam sngewthuh	I don't understand
Ngam sngewthuh phi mut kumno	I don't understand what you mean
Ngam sngewthuh ia phi	I don't understand you
Ngam tip	I don’t know
Ngam sngewthuh	I don’t understand
nga antad	i guess
Nga ju don	I had
Nga don	I have
Nga lah ju long	I have been
Nga kyrmen	I hope so
Nga tip	I know
Nga sngewbha	I like
nga sngewtynnat ia phi	I like you
Nga ieid	I love
Nga ieid ia u hynmen	I love my big brother
Nga ieid ia ka hynmen	I love my big sister
Nga ieid ia u kpa	I love my father
Nga ieid ia u para	I love my little brother
nga ieid ia ka para	I love my little sister
Nga ieid ia ka kmie	I love my mother
Nga ieid ia phi	I love you
Nga ieid shikatdei ia phi	I love you so much
nga ruh nga ieid ia phi	I love you too
Nga mut	I mean
sngewkynjah khlem maphi	I miss you
Nga sngewtmang	I miss you
nga tmang bha ia phi	I miss you so much
O pleng	I see
Nga tharai	I think
Nga sngewthuh	I understand
Nga kwah	I want
Nga kwah iohi ia phi	I want to see you
Nga kwah ia phi	I want you
Nga ju	I was
Ngan sa	I will
Ngan jinda	I would be
Ngan	I'm
Nga biang	I'm fine
Nga biang	I'm good
Nga don hangne	I'm here
Map ia nga	I'm sorry
thah	ice
ice cream	ice cream
jingmut	idea
ba biang tam	ideal
ba kumjuh	identical
kdew	identify
jingithuh	identity
beij	idiot
bym don kam don jam	idle
lada	if
leh bym suidniew	ignore
pang	ill
beain	illegal
jingpang	illness
Ilocano	Ilocano
dur	image
mutdur	imagine
mardor	immediate
mardor	immediately
baheh bha	immense
ka jingdon dor	impact
ka jinglah ban pynkylla	impact
ba kyrkieh	impatient
tiar	implement
wanrah na shabar	import
bakongsan	important
pynjari	impose
bym lah long	impossible
shap	impress
ka jingshon	impression
jingpyn-iap-mat	impression
ba shoh mynsiem	impressive
ba shon khia	impressive
pynbha	improve
jingpynbha	improvement
hapoh	in
Nalor kata	in addition
Ha ka jingshisha	In fact
ha khmat jong	in front of
khnang ban	in order to
bym iahap	inappropriate
jingai halor ka tulop	incentive
jingjia	incident
kynthup lang	include
kynthup	including
tulop	income
ka jingioh	income
jingshitom jingmut	inconvenience
jingroi	increase
pynroi	increase
kham bun	increase
pynkiew	increased
ba phylla eh	incredible
shisha	indeed
ba laitluid	independent
ka India	India
kdew	indicate
pyni	indicate
trai shnong	indigenous
shimet	individual
Karkhana	industry
bym lah kiar	inevitable
khyllung	infant
jingpang	infection
bym ju kut	infinity
jingat	inflammation
jingkiew dor	inflation
ka bor halor	influence
pyntip	inform
jingtip	information
ki jinber jingtah	ingredients
jingioh pateng	inheritance
ba sdang	initial
kaba sdang	initiative
mynsaw	injured
mong	injured
jingmynsaw	injury
lui lui	innocent
jingpynmih bathymmai	innovation
jingtohkit	inquiry
khleh beij	insane
khniang	insect
bym sngewshngain	insecure
thep	insert
shapoh	inside
kaba ioh ne don ja jingtip kaba bniah	insight
banjur	insist
jingbym iohthiah	insomnia
jingai mynsiem	inspiration
pynshlur	inspire
buh	install
nuksa	instance
mar mar	instant
hangto hangto	instant
ha ka jaka	instead
ha ka jaka jong	instead of
jingbthah	instructions
ka tiar	instrument
jingkrenbein	insult
kaba la pyntikna	insurance
khlem julor	intact
jinglonghok	integrity
jinglongkhuid	integrity
riewstad	intellectual
jingstad	intelligence
jingstad	intelligent
mut	intend
la thmu	intended
bajur	intense
jingthmu	intention
ban iatai	interact
ka jingiakren	interaction
ka sut	interest
don jingmut	interested
kaba sngew phylla	interesting
pynwit	interfere
ba hapdeng	intermediate
ba shapoh	internal
shabar ri	international
internship	internship
pynkylla ktien	interpret
nongpynkylla ktien	interpreter
knieh ktien	interrupt
ka jingiashem	interview
ka jingkyli bniah	interview
ba iajan eh	intimate
shapoh	into
pynithuh	introduce
jingpynithuh	introduction
ki briew ki bym bun nia	introvert
kibym sngewtynnad ban ia khleh eh bad kiwei	introvert
ka jingsngew ma-ian	intuition
bym iaid kam shuh	invalid
bym long	invalid
shem	invent
ka lis	inventory
ban shna ka lis jong ki tiar baroh	inventory
bei peisa	invest
wad bniah	investigate
jingkhot sngewbha	invitation
khot sngewbha	invite
risit	invoice
jingdonkti	involve
don kti	involved
ka nar	iron
istri	iron
ka long	is
dew lynnong	island
ba pynjngai	isolated
ba pynkyrpang	isolated
ki jingpynwit	issue
pynmih	issue
ki daw	issues
lada	it
ka long	it is
ju long	it was
ka long	it's
ka biang	it's ok
Ka biang	It's okay
ki jingdonkam	item
ka tiar	item
ki tiar ki tar	items
jong	its
Nga	I’m
jaket	jacket
iing bindi	jail
Kyllalyngkot	January
u jok buh jingbuh	jar
tyngam	jaw
bishni	jealous
jynrat	jerk
jingdeng	jewelry
ka kam	job
mareh kai	jogging
iasnoh lang	join
jingbteng	joint
khana biria	joke
nongpathai khubor	journalist
jingiaidlynti	journey
jingkmen	joy
bishar	judge
nongbishar	judge
um soh	juice
naitung	july
kynthih	jump
jylliew	june
jakhlia	junk
tang	just
shu leih beit	just do it
jingbishar	justice
pynksan	justify
Kalaallisut	Kalaallisut
la iai khmih lynti	keen
buh	keep
iaileh	keep it up
ba la buh	kept
u ketli	kettle
shabi	key
khasi	Khasi
kynjat	kick
khynnah	kid
kren danda	kidding
khyllai	kidney
ki khynnah	kids
pyniap	kill
bha	kind
babha	kind
kynja	kind
kumta hi	kinda
sngewbha	kindly
jinglehisnei	kindness
syiem	king
doh	kiss
iing shet-ja	kitchen
kot kudi	kite
khun miaw	kitten
khohsiew	knee
lah tip	knew
tari	knife
u riewshlur	knight
tip	know
jingshemphang	knowledge
ba la tip	known
Konkani	Konkani
Krio	Krio
ka ba thoh kyrteng	label
jingtrei	labor
jingtrei	labour
jingduna	lack
jingkieng	ladder
kong	lady
ba la pyndem	laid
ba pynthiah	laid
ba la tep	laid
nan	lake
langbrot	lamb
dkoh	lame
sharak	lamp
jaka	land
hiar	land
ka dur ne ka maian kano kano ka khyndew ne ka jaka	landscape
jait ktien	language
jingthum	lap
ba heh	large
khadduh	last
kaba khatduh tangba kaba donkam	last but not least
jait	last name
slem	late
dang shen	lately
hadien	later
bathymmai tam	latest
ba kadien	latter
rkhie	laugh
rkhei	laughing
jingrkhie	laughter
pynmih	launch
jain jaboh	laundry
ain	law
madan phlang	lawn
muktiar	lawyer
thiah	lay
syrtap	layer
ka jingpynbeit	layout
ka rukom buh	layout
jingtei	layout
jingshna	layout
jaituh	lazy
ialam	lead
nongialam	leader
sla	leaf
pei	leak
shaniah	lean
rynsied	leap
nang	learn
jinghikai	learning
ai wai	lease
duna duh	least
snieh	leather
ieh	leave
shuti	leave
ki sla	leaves
la ialam	led
la leit	left
kadiang	left
ka kjat	leg
pateng	legacy
hapoh ka ain	legal
khana prurskam	legend
hapoh ka ain	legit
jingshongkai	leisure
ai kylliang	lend
jingjrong	length
duna	less
jinghikai	lesson
shah	let
shithi	letter
salad	lettuce
mala	level
kyrdan	level
kaba pynia ryngkat	leverage
ka jingkitkhia	liability
ka jaka ban pule ki kot	library
jliah	lick
shukor	lie
jingshukor	lie
jingshukor	lies
jingim	life
kyntiew	lift
rah	lift
jingshai	light
bashai	light
thang	light
leilieh	lightning
sngewtynnat	like
kaba lah ban long	likely
tharai	likely
kumjuh	likewise
u laiñ	line
Lingala	Lingala
jingbteng	link
u sing	lion
long um	liquid
ka lis ki tiar ki tar ne ka kam ban leh ne ka lis ki kyrteng	list
sngap	listen
sngap	listening
kaba mut shisha	literally
ki kot pule	literature
bret jakhlia	litter
khyndiat	little
im	live
baim	live
dohnud	liver
ki jingim	lives
baim	living
kamra shongkai	living room
niang bshiah	lizard
jingkit	load
u ruti	loaf
jingaikylliang	loan
ba na kato ka thain	local
ka jaka	location
tala	lock
khangdam	lockdown
dieng tylli	log
lol	lol
rangli	lonely
jrong	long
khlem iakynduh shuh lah slem	long time no see
peit	look
jingpeit	look
kyllain	loop
jingkylluid	loose
pynkylluid	loose
trai	lord
pynjah	lose
jingduh	loss
jah	lost
bun	lot
jam	loud
kamra shongkai	lounge
ieid	love
jingieid	love
nga ieid ia phi	love you
kaba itynnad	lovely
duna	low
ba kham harum	lower
ba iaineh	loyal
jingiaineh	loyalty
nusip	luck
bha nusib	lucky
Luganda	Luganda
ki tum ki tam	luggage
jingat	lump
ja sngi	lunch
ki tor	lungs
ka jingriewspah	luxury
ba thoh	lying
mashin	machine
khleh bieij	mad
kong	madam
ba la thaa	made
kot pule	magazine
ba donburom	magnificent
ba khraw	magnificent
nongtrei	maid
bakongsan tam	main
pynbit pynbiang	maintain
jingpynneh	maintenance
Maithili	Maithili
baheh	major
badonkam	major
bun balang	majority
shna	make
ngan	make
thaw hi	make up
shynrang	male
ka mall	mall
u briew	man
pyniaid	manage
ka jingpyniaid	management
nongpyniaid	manager
kaba kongsan	mandatory
kaba phi kwah ba kan urlong	manifest
pynshalai	manipulate
rukom long	manner
ba leh da ka kti	manual
bun ngut	many
ka sngikha ba suk ba kmen ia phi!	many many happy returns of the day
jam sha khmat	march
bnai lber	march
rud	margin
iew	market
jingshongkurim	marriage
ba lah shong kurim	married
jingtap khmat	mask
ka kynton	mass
ka jingleh niam	mass
ka jingialum paidbah	mass
baheh bha	massive
trai	master
pyniadei	match
jingiadei	match
paralok	mate
ka kynja met kaba la thaw ne pynlong	material
jingkhein	math
ka jingwit	matter
jingsan	maturity
jymmang	may
lehse	maybe
ia nga	me
nga ruh	me too
ka jingbam	meal
mut	mean
sniew jinglong	mean
ka jingmut	meaning
ki lad ki jingmyntoi	means
kaba mut	means
ba la mut	meant
katba	meanwhile
thew	measure
ki lad	measures
ka doh	meat
medikal	medical
ka lain jingkoit jingkhiah	medical
dawai	medicine
jingpuson	meditation
ba pdeng	medium
iakynduh	meet
jingialang	meeting
Meiteilon	Meiteilon
umphniang	melt
ki jingkynmaw	memories
jingkynmaw	memory
ka khlieh ka jabieng	mental
ong	mention
pynmih	mention
la ong	mentioned
nongpeit	mentor
nonghikai	mentor
nongkhaii	merchant
jingmap	mercy
tang	merely
khristmas basuk	merry christmas
kynrum kynram	mess
khubor	message
ba kynrum kynram	messy
ka nar	metal
rukom leh	method
ki khnai	mice
pdeng	middle
shiteng miet	midnight
lah ban	might
bajem	mild
mawmer	milestone
ka tnad shipai	military
dud	milk
million	million
sngew	mind
jingmut jingpyrkhat	mind
jingpyrkhat	mindset
jong nga	mine
tih	mine
iakhleh	mingle
barit baria	minor
minit	minute
ki minit	minutes
kam phylla	miracle
iit khmih	mirror
ba khleh	miscellaneous
ba bun jait	miscellaneous
shalak	mischievous
buit-tuh	mischievous
kaba sngew bym don jingsuk	miserable
jingsangsot	misery
sngew tmang	miss
duh ei	miss
ka nonghikai	miss
tmang ia phi	miss you
ba sngew kynjah	missing
ba la jah	missing
ka mission	mission
lyoh khyndew	mist
jingbakla	mistake
Mizo	Mizo
ka mobile	mobile
bein	mock
ka nuksa	model
Kat ban biang	moderate
hapdeng	moderate
ki por ba mynta	modern
ka juk ba mynta	modern
jingsngewrit	modest
lui lui	modest
barit	modest
don burom	modest
ka jingsngewthuh ia la ka bor	modest
khyndiat	modest
ba sngem	moist
jingsngem	moisture
ka jingsngiam bad kaba mih kiba iong ba iong ha kynroh ne ki tiar ki tar	mold
knai tynjit	mole
mei	mom
khyllipmat	moment
sngi nyngkong	monday
ka pisa	money
nongpeit	monitor
ka bynta jong ka kor kompiwtor	monitor
shrieh	monkey
bnai	month
jinglong	mood
musui	moody
u bnai	moon
ka jinglong	moral
ka rukom im	moral
shuh shuh	more
nalor kata	moreover
mynstep	morning
binda	mortgage
bun tam	most
kham bun	mostly
ka kmie	mother
jingiaid	motion
jingpynshlur	motivation
lum	mountain
khnai	mouse
shyntur	mouth
khih	move
jingkhih	movement
phlim	movie
kong	mrs
bun	much
ktieh	mud
mok	mug
ksah	muscle
ka museum	museum
tit	mushroom
ka put ka tem	music
hap ban	must
bym lait kren	mute
ba la iamynjur lang	mutual
jong nga	my
Ha i ba ieit	My dear
paralok jong nga	my friend
Ka 'hovercraft' jong nga ka dap da ki kha-priang.	My hovercraft is full of eels
baied jong nga	my love
ka kyrteng jong nga ka long	my name is
Nga sngewbha ban leh kumta	my pleasure
Ym lei lei	my pleasure
ma nga	myself
ba phylla	mysterious
ba pher	mysterious
phylla	mystery
kaba maian	mystery
khana puriskam	myth
prek	nail
shida	naive
kyrteng	name
ka jingiathuh ba bniah	narrative
khim	narrow
basniew	nasty
national	national
ka jinglong nongshong shong jong ka ri	nationality
trai shnong	native
ba iadei bad ka mariang	natural
meiramew	nature
kynroi prie	nausea
hajan	near
hajan	nearby
lah jan	nearly
ba kyntiak	neat
badonkam	necessary
ryndang	neck
kpieng	necklace
jingdonkam	need
donkam	need
kaba sniew ne kabym bha	negative
shah ieh	neglect
ia mir jingmut	negotiate
paramarjan	neighbor
dong	neighborhood
um kano kano ruh	neither
u pyrsa	nephew
niang bam kot	nerd
syier	nervous
skum	nest
jar	net
saphriang	network
bym iashah liang	neutral
ym ju	never
wat ju	never
wat ju khein duh	never give up
ym lei lei	never mind
ym lei lei	nevermind
wat la katta ruh	nevertheless
bathymmai	new
khubor	news
babud	next
hajan	next to
bha	nice
ka ba itynnad	nice
sngewtynnad ban iakynduh ia phi	nice to meet you
ka pyrsa	niece
meit	night
jingruma	nightmare
khyndai	nine
khatkhyndai	nineteen
khyndaiphew	ninety
Em	No
ym lei lei	no problem
ym don lad	no way
mano mano ruh em	nobody
jingsawa	noise
ba sawa	noisy
ym napdeng kine	none
shiteng sngi	noon
em	nope
lymne	nor
ba long ia baroh	normal
kaba ju jia	normal
shatei	north
khmut	nose
jingkynmaw batmang	nostalgic
ym	not
da lei lei ruh em	not at all
khyndiat ruh em	not at all
ka biang	not bad
Ym dei mynta	Not now
ym pat dei	not yet
ban buh jingthoh	note
ki kot jingthoh	note
buh jingmut	note
pawnam	noted
bym don eiei	nothing
jingpynbna	notice
ka jingpyntip	notice
iohi	noticed
ka kyrteng jong kaei kaei	noun
ka kyrteng jong kaei kaei	nouns
kot pule	novel
naiwieng	november
mynta	now
mynta ki por	nowadays
ba pynwit ia kiwei	nuisance
nout	null
ym don jingsngew	numb
nombor	number
nos	nurse
u kynja jingbam ba eh ba ju khot da phareng nut	nut
u jaiphol	nutmeg
jingbam ba tei	nutrition
jingsmai	oath
jingsngaid	obesity
ngeit	obey
who dong	object
thong	objective
ka jingkular	obligation
kah dum	obscure
jingpeit	observation
peit pyrman	observe
haba la shoh biej eh	obsessed
ka jingkyrni	obsession
bum don shuh	obsolete
diengpynkiang	obstacle
ioh	obtain
ba la ioh	obtained
kaba la tikna ban jia	obvious
kaba la tikna	obviously
tyngkhat	occasionally
jingtrei	occupation
ba don briew	occupied
jia	occur
ba la jia	occurred
jia	occurs
duriaw	ocean
risaw	october
phylla	odd
nusib	odds
jong	of
khlem pep	of course
lip	off
ikynsha	offensive
ba ishrai	offensive
tyrwa	offer
jingtyrwa	offer
ophis	office
kaba don jingthoh jingtar	official
man ka por	often
O	Oh
o shisha	oh really
umphniang	oil
to	ok
to, baieid	ok dear
to baieid	ok honey
to baieid jong nga	ok my love
to	okay
to, baieid	okay baby
to baieid	okay dear
to baieid	okay honey
hooid baieid jong nga	okay my love
barim	old
halor	on
shi sien	once
iwei	one
kawei ka jaitktien kan ym long kaba lah biang	one language is never enough
piat	onion
online	online
tang	only
plie	open
jingpuid	operation
jingmut	opinion
ki lad	opportunities
ka lad	opportunity
pyrshah	opposite
da khongpong	opposite
ba khmih lynti ia kaba bha	optimistic
ka jingjeid	option
ba lah ban jied	optional
lane	or
soh niamtra	orange
rong soh niamtra	orange
hukum	order
ka ju long	ordinary
kynrei	ordinary
seng	organization
jingphai	orientation
tynrai	origin
ba long tynrai	original
Oromo	Oromo
khun swet	orphan
kawei	other
lymda kumta	otherwise
lah dei ban	ought
jong ngi	our
Ka jingthmu jong ngi: ban pynlah ia baroh, ha baroh ki jaka ban sngewthuh ia ka pyrthei bad ban lah ban batai shaphang jong ki.	Our mission: to enable everyone, everywhere to understand the world and express themselves across languages.
Ka jingthmu jong ngi: ban pynbit pynbiang ka jingtip jong ka pyrthei bad ban pynlong ia ka kaba lah ban poi sha baroh bad kaba myntoi ia baroh	Our mission: to organize the world's information and make it universally accessible and useful.
shabar	out
jingmih	outcome
riam	outfit
pariah	outgoing
shabar	outlet
khapput	outline
shabar	outside
ba lamkhmat	outstanding
ka tyndur shet jingshe ba rit ba pyndonkam da ka bor ding (light)	oven
lah kut	over
hangtei	over there
kyllum	overall
ioh jop	overcome
pyrkhat than	overthinking
ka jingsngew ba la palat	overwhelmed
kaba pynshaiong	overwhelming
shah	owe
dkhoh	owl
long trai	own
trai	owner
masi lur	ox
jingstet	pace
shisong	pack
song	pack
jingsong	pack
ka jingsop	package
ba la siew	paid
jingpang	pain
niad rong	paint
jingdro	painting
shijur	pair
thangiong	pale
sla kti	palm
karai	pan
ka khlam	pandemic
huri hura	panic
patlun	pants
ka kot	paper
bneng	paradise
bym kynduh	parallel
kaba phah ia kino kino ki tiar sha kawei pat ka jaka kum ka jaka ba jngai	parcel
map	pardon
ki kmie ki kpa	parents
kper syntiew	park
ka kper	park
tuta	parrot
pudina	parsley
shibynta	part
shim bynta	participate
bakyrpang	particular
kyrpang ia kaei kaei	particularly
shijur	partner
parklok	partner
jingkhawai	party
lait	pass
lynti iaid	passage
lah lait	passed
jingieid	passion
rhem mysiem	passionate
ka jingailad ban leh ha ka mon	passive
ka password	password
ba la leit	past
syrdep	patch
ka lynti	path
isangsot	pathetic
jingiaishah	patience
nongpang	patient
baiaishah	patient
ka rukom long	pattern
ka jingthoh	pattern
sangeh shipor	pause
jaka iaid	pavement
siew	pay
jingsiew	payment
jingsuk	peace
basuk	peaceful
soh phareng	peach
kliar	peak
soh phoh	pear
mator	peas
bakhyllah	peculiar
pynjhieh	pee
ka jingpynjhieh	pee
khoh snem	peel
ba iadei kyrdan	peer
khmihshin	peers
peitshin	peers
khulom	pen
led	pencil
ba dang sah	pending
ki briew	people
soh marit	pepper
imat	perceive
jingpeit	perception
ba janai	perfect
leh	perform
ka jingak	performance
lehse	perhaps
ka por	period
ba iaineh	permanent
jingmynjur	permission
ai jingmynjur	permit
jingminot	perseverance
ba iai ban ban leh ia kaei kaei	persistent
ba iai pyneh	persistent
briew	person
shimet	personal
ka main	personality
ka rukom peit	perspective
khroh	persuade
pynwit	pervert
ialam bakla	pervert
pynkyllaiñ	pervert
jingri	pet
ka bynta	phase
jingjia	phenomenon
ka philosophi	philosophy
ka phone	phone
dur	photo
jingong	phrase
ka met ka phad	physical
jied	pick
shaw	pick up
ka dur	picture
dkhot	piece
ki lyngkhot	pieces
sniang	pig
paro	pigeon
kynton	pile
syngkhlieh	pillow
nongniah	pilot
pin	pin
soh trun	pineapple
babyrsaw	pink
thliew	pit
ka jingsawa	pitch
isnei	pity
jaka	place
buh	place
ki jaka	places
khlam	plague
ba madan	plain
plan	plan
liengsuin	plane
thung	plant
jingthung	plants
pliang	plate
rynsan	platform
lehkai	play
drama	play
ialehkai	playing
kaba sngew pyngngad	pleasant
sngewbha	please
pynsngewbha	please
sngewbha	pleased
jingsngewbha	pleasure
kular	pledge
pahuh	plenty
ka jingiasuhbuit	plot
ka lyngkhot khyndew	plot
set	plug
soh plom	plum
nongshna nar kor	plumber
babun	plural
podkas	podcast
poitri	poem
poitri	poetry
kdew	point
ka bih	poison
pulit	police
polisi	policy
don akor	polite
ka lyer bad kiwei	pollution
ka jingpynjaboh ia ka um	pollution
pung	pond
ka pung	pool
eit	poop
ba duk	poor
ba sawa pait	pop
paw khmat	popular
jingbunpaid	population
doh sniang	pork
u kew ba la shet	porridge
ka kad duriaw	port
ka rukom ieng ne shong	position
kyrdan	position
kaba don ka jingkyrmen ba bha	positive
don	possess
jingdon	possession
kaba leh baheh	possessive
kaba don ka jingtuklar	possessive
ka jingbishni	possessive
ka jingiada palat	possessive
ba lah	possible
ka kynja dak thoh	post
pud	postpone
phan	potato
kaba don ka jinglah	potential
ba bom	pound
ba shoh	pound
jingduk	poverty
ka bor	power
ba donbor	powerful
ka leh um tang da kaba shu iakren	practical
leh	practice
jinglehnohei	practice
iaroh	praise
ba siklai	prank
duwai	pray
kordor	precious
thik	precise
thik	precisely
iathuhlypa	predict
kham mon	prefer
jingmon	preference
ar met	pregnant
jingleh shiliang	prejudice
phyllai	premises
ba bha tam	premium
jingpynkhreh	preparation
pynkhreh	prepare
ba la pynkhreh	prepared
preposition	preposition
jingdon ryngkat	presence
jingai sngewbha	present
jingdon	present
kaba batai shai halor kano kano ka mat	presentation
kaba pyni	presentation
pynneh	preserve
u presiden	president
nion	press
jingnion	press
kaba khia	pressure
lehmynleh	pretend
bhabriew	pretty
iada	prevent
bamynshwa	previous
uba ngat ha ki jingma ne jingmynsaw	prey
dor	price
jingmeng	pride
lyngdoh	priest
ba hakhmat	primary
ba hakhmat duh	prime
ka khun syiem	princess
prinsipal	principal
shwa	prior
kaba buh shuwa hakhmat iano iano ruh	priority
patok	prison
jingbuhrieh	privacy
shimet	private
kiba donbok	privilege
khusnam	prize
ka lah ban long	probably
lehse	probably
jingeh	problem
rukom ban leh	procedure
iaid shaphrang	proceed
jing pyntreikam	process
ka jingpyniaid	process
pynmih	produce
jingmih	product
jingpynmih	production
ka jingtrei	profession
u ba la pyntriem bha ia lade ha kano kano ka kam	professional
ka jingpaw tang ka khmat	profile
jingiohnong	profit
ba khraw	profound
ba jylliew	profound
ba stad	profound
naduh ka dohnud	profound
kiew shaphrang	progress
jingkiew shaphrang	progress
projek	project
pawkhmat	prominent
kular	promise
jingkular	promise
pynkiew	promote
ban kyntiew	promotion
ka jingkiew kyrdan	promotion
bakloi	prompt
ba jemrngiew	prone
thiah pyllup	prone
pronoun	pronouns
rukom kynnoh ktien	pronunciation
sabut	proof
kaba i tikna	proper
ha ka rukom badei	properly
ki jaka puta	properties
jaka puta	property
ka jingtyrwa	proposal
kaba lah ban jia	prospect
jingroi	prosperity
ba roi	prosperous
iada	protect
meng	proud
pynshisha	prove
pynbiang	provide
lada	provided
lait noh	provided
hima	province
Ki kyndon	provision
Jingpynbiang	provision
ba la pynkhreh	provision
jingsdang samla	puberty
paidbah paidlang	public
tan	pull
pathaw	pumpkin
ba biang por	punctual
khynnah pule	pupil
thied	purchase
bakhuid	pure
saw bthuh	purple
jingthmu	purpose
pla	purse
beh thong	pursue
jingbehthong	pursuit
niat	push
buh	put
kyrdan pule	qualification
ka jinglong ka mar	quality
ka jingbha	quality
jingbun	quantity
set slung	quarantine
iamai	quarrel
jingiamai	quarrel
pawa	quarter
Quechua	Quechua
mahadei	queen
khyllah	queer
jingkylli	query
jingkylli	question
ka jingieng lain	queue
stet	quick
kloi kloi	quickly
jar jar	quiet
kynjah	quiet
rajai	quilt
ieh	quit
ka ban lah ban long	quite
jingkyntip	quiz
ki ktien ba la kyntiew na kiwei pat ki jingthoh ne jongong	quotation
ki ktien ba kren	quotation
ka jingiathuh ia ka dor	quotation
ka ba la shim	quote
ki jingong	quotes
rabbit	rabbit
jingiakob mareh	race
jingbitar	rage
u slap	rain
pynkiew	raise
kyntiew	raise
pynsan	raised
la mareh	ran
naphang	random
kaba kynthup	range
ba stet	rapid
stet stet	rapidly
niar	rare
kham niar	rarely
khaid	rash
khnai	rat
ka dor	rate
Lah	rather
dang lah	rather
ka jingianujor	ratio
ka jingiadei	ratio
ba shai jingmut jingpyrkhat	rational
ba khlem shet	raw
em	re
poi	reach
la poi	reached
jingleh markylliang	reaction
pule	read
pule	reading
ba la pynkhreh	ready
bashisha	real
ka jingshisha	reality
poi pyrkhat	realize
kyndit bynriew	realized
kaba shisha	really
shadien	rear
daw	reason
ba lah ban pdiang	reasonable
ba sngewthuh	reasonable
kynmaw	recall
jiingioh	receipt
ioh pdiang	receive
la ioh	received
dang shen	recent
dang shen	recently
jingpdiang sngewbha	reception
ki jingkdew ban shet	recipe
bym phikir	reckless
jingithuh	recognition
ithuh	recognize
ka jingpynithuh ne ai ktien	recommend
ba la rekomen	recommended
thoh	record
dulir	record
ioh biang	recover
jingioh biang	recovery
sawdong	rectangle
saw	red
pynkhie biang	redeem
jingpyllait im	redemption
jingpynim biang	redemption
pynduna	reduce
ym donkam shuh	redundant
ba la shim	refer
ba la pynshongnongrim	refer
ka jingshim jingmut	reference
tyngshaiñ	reflect
pyrkhat	reflect
ka jingphalang	reflection
kiar	refrain
ka fridge	refrigerator
pynphai	refund
len	refuse
len	refused
ka jingniewkor	regard
ka jingpyniadei	regard
shaphang	regarding
kam pher	regardless
jingai khublei	regards
thain	region
ba la ia soh	register
kaba pynrung kyrteng	register
babe	regret
tista	regular
tista	regularly
kyntait	reject
pyniadei	relate
iadei	related
ka jingiadei	relationship
ba haiing	relative
ba ha iing	relative
ba haiing	relatives
shongthait	relax
pyllait	release
jinglait	release
ba lah pyllait	released
kaba don ia ka jingia snoh	relevant
ba lah ban shaniah	reliable
jingtngen	relief
pyllait	relieve
sngew sting mynsiem	relieved
ym khuslai shuh	relieved
sngewsuk mynsiem	relieved
niam	religion
riewblei	religious
artatien	reluctant
shaniah	rely
sahkut	remain
ba sah	remaining
ba don nam	remarkable
ba phylla	remarkable
ba khraw	remarkable
ka dawai	remedy
kynmaw	remember
pynkynmaw	remind
jingpynkynmaw	reminder
bajngai	remote
weng	remove
aiwai	render
wai	rent
maramot	repair
ong biang	repeat
bujli	replace
jingjubab	reply
jubab	reply
pyntip	report
Kaiphod	report
mih khmat	represent
ka nam	reputation
kyrpad	request
jingkyrpad	request
donkam	require
badonkam	required
pyllait im	rescue
jingwad bniah	research
iasyriem	resemble
jingpihuin	resentment
jingbhah	reservation
bhah	reserve
nongsah	resident
resain	resign
jingsatar	resilience
ba eh	resilient
kyntait	resist
leh pyrshah	resist
iakhun	resist
jingpyneh	resistance
ka jingskhem jingmut	resolution
kut jingmut	resolve
ka jaka ba itynnad ban bam bad ban sah	resort
ki jingdon jingem	resources
burom	respect
jingburom	respect
jubab	respond
jubab	response
jingbahkhlieh	responsibility
kitkhlieh	responsible
shongthait	rest
bam kwai ha dwar U Blei	rest in peace
jaka bam	restaurant
pynbha biang	restore
buh pud	restrict
ka resul	result
ki resul	results
sdang biang	resume
jingdie nokot	retail
buh	retain
jingbuh	retention
ba lah shongthait	retired
kylla dien	retreat
wanrah biang	retrieve
wan phai	return
pynpaw	reveal
ba la pynpaw	revealed
jingleh markylliang	revenge
jingioh	revenue
kylla dien	reverse
peit biang	review
jingpeit biang	review
peit biang	revise
pynthymmai	revise
jingpule biang	revision
ka jingiakhih pyrshah	revolution
khusnam	reward
ka tara	rhythm
shyieng krung	rib
u khaw	rice
riewspah	rich
bret	rid
shong kulai	ride
ka ba um lah ban long	ridiculous
kaba la sngew kamkai	ridiculous
badei	right
kamon	right
mynta hi	right now
eh tnen	rigid
sati	ring
phler	rinse
jingkulmar	riot
jingtar	rip
tar	rip
ba lah ih	ripe
kiew	rise
jingkiew	rise
ban pha	risk
nongialeh pyrshah	rival
ka wah	river
surok	road
ka rukom shet jingtah da kaba shu roast	roast
khlain	robust
maw siang	rock
rod	rod
ka bynta	role
tyllun	roll
tnum	roof
kamra	room
tynrai	root
tyllai	rope
ba la pyut	rotten
ba khain	rough
bakhain eh	roughly
pyllun	round
lynti	route
ka por ba buh ryntih	routine
ka jingmlien	routine
lain	row
jingshong ryntih ter	row
pinbeit ryntih	row
kyrjaw	rub
jri	rubber
jaboh jabain	rubbish
khlem akor	rude
dari	rug
pynjulor	ruin
synshar	rule
skale	ruler
ki rul	rules
mareh	run
jingmareh	running
thain nongkyndong	rural
jingkyrkieh	rush
pynkyrkieh	rush
borni	sack
bakyntang	sacred
len lade	sacrifice
shngain	safe
sa leit suk	safe flight
Sa her suk	safe flight
jinglongshngain	safety
phukir	sage
la ong	said
ka jañ jong ka lieng	sail
ka rukom iaid ka lieng ha wah ne duriaw	sail
ba shong lieng	sailing
jhad	sailing
namar	sake
tulop	salary
jingdie	sale
dohkha duriaw	salmon
ka mluh	salt
kajuh	same
kumjuh	same
Kumjuh hangne	Same here
nuksa	sample
khyndiat kaei kaei	sample
shyiap	sand
Sanskrit	Sanskrit
kren pharshi	sarcastic
kynshlein	sassy
shong	sat
jinghun	satisfaction
lah hun	satisfied
pynhun	satisfy
ba pynhun	satisfying
Sngi Saitjain	Saturday
dohsnam	sausage
kaikhlaw	savage
kynshew	save
la iohi	saw
ong	say
tarajur	scale
jyrsieh	scam
dak mong	scar
kyrduh	scarce
sheptieng	scared
tapmoh	scarf
itieng	scary
saphret	scattered
Ka jingjia	scene
ki jingdro ba ki khynnah ki ia sngewtynnad ban dro	scenery
ka jingpaw ki lum ki wah	scenery
jingew	scent
ka jingpyniaid ia ki kam	schedule
skul	school
ka saian	science
riewstad siens	scientist
ki riewstad saians	scientists
ki khanshi	scissors
kynheid	scold
ki lad	scope
jingkhein	score
buh dak	score
ba ioh thep	score
i lyngkhot ba sah	scrap
trud	scratch
lynniar	scream
ka tb ne mobile phone	screen
u khir	screw
ka tiar ba pyndonkam haba pynskhem ia u khir	screw
khyrwait	screw
ki dak thoh	script
duriaw	sea
muhor	seal
wad	search
aiom	season
jaka shong	seat
ba-ar	second
ba buhrieh	secret
bynta	section
shngain	secure
jinglongshngain	security
iohi	see
sa iakynduh pat	see you
ngin sa iakynduh shibit	see you later
sa iakynduh kloi	see you soon
sa iakynduh lashai	see you tomorrow
symbai	seed
wad	seek
imat	seem
long kumba	seem
I kum	seems
ba iohi	seen
kurup	seize
khiering	seizure
tyngkhat	seldom
niar	seldom
jied	select
ma nga	self
jingsumar da lade	self healing
khapnap	selfish
die	sell
phah	send
phah ka dur jong phi sha nga	send me your picture
ba kham rangbah	senior
ka bor ba ngi lah ban sngewthuh ia ka mariang sawdong jong ngi	sense
beit jingmut	sensible
kaba long thut shen	sensitive
la phah	sent
senten	sentence
ki sentens	sentences
pyniakhlad	separate
Sepedi	Sepedi
nailur	september
ka jingai ter ter	sequence
ka jingbud	sequence
ba bud ter ter	series
kabym long ban shim sting	serious
ba don ka jingthmu ba shisha	seriously
ba tikna	seriously
shisha	seriously
shakri	serve
ka jingpyntreikam	service
ka jingialang	session
ka jingiashong dorbar	session
lah long	set
pynbiang	set up
ba sep	setting
buhai shnong	settle
hynniew	seven
khathynniew	seventeen
hynniewphew	seventy
bun tylli	several
ba jur	severe
suh	sew
sngap jar	sh
shush	sh
haba da sngi	shade
syrngiew	shadow
pynkhih	shake
yn sa	shall
ba jyndong	shallow
jinglehrain	shame
dur	shape
sam	share
ba nep	sharp
ma ka	she
ka don	she has
ka long	she is
sem	shed
langbrot	sheep
ka jingsiang	sheet
ka almira	shelf
ka jingsop	shell
ki sbai	shell
jaka rieh	shelter
stieh	shield
pynkynriah	shift
phyrnai	shine
jhad	ship
ka lieng	shipping
sopti	shirt
juti	shoes
siat	shoot
dukan	shop
jingleit iew	shopping
rud duriaw	shore
lyngkot	short
jingduna	shortage
jingsiat	shot
siat	shot
dei ban	should
tyrpeng	shoulder
hylla	shout
pyni	show
ka tamasa	show
pyni ia nga	show me
slap	shower
shymprong	shrimp
rit	shrink
khang	shut
sngap jar	shut up
lehrain	shy
ba shipara	sibling
hynmen para	siblings
ngiah	sick
pang	sick
ka kiar	side
ka jingpynhiar mynsiem	sigh
jingimat	sight
jingleit jngohkai	sightseeing
soi	sign
jingsoi	signature
ba bun	significant
jingjar-jar	silence
jar jar	silent
ryndia	silk
kiba leh biej	silly
rupa	silver
iasyriem	similar
ubym don jingmut hok	simp
uba biej	simp
basuk	simple
ha kajuh ka por	simultaneously
naduh	since
ba long tikna	sincere
ba pynleh jingmut	sincere
jingmut shisha	sincerely
rwai	sing
nongrwai	singer
marwei	single
ka jaka khliengtiar	sink
ba ngam	sink
Bah	Sir
para kynthei	sister
ka parakynsi	sister in law
shong	sit
jaka	site
ka jinglong	situation
hynriew	six
khathynriew	sixteen
hynriewphew	sixty
jingheh	size
jingtbit	skill
jingtbit	skills
sniehdoh	skin
raikhoh	skinny
kynthih	skip
skad	skirt
suin bneng	sky
mraw	slave
thiah	sleep
ba ioh thiah	sleeping
sam thiah	sleepy
kti sopti	sleeve
ba ot stang	slice
syntuid	slide
malu mala	slightly
raikhoh	slim
btuit	slip
ranad	slope
ka bynta ne jaka ba lah buh kyrpang	slot
suki	slow
suki suki	slowly
barit	small
shai ka jingmut jingpyrkhat	smart
stad	smart
jingew	smell
jingphuh samrkhie	smile
phuh samrkhie	smile
tdem	smoke
jlih	smooth
jingbam kai	snack
mattah	snail
bsein	snake
bthat	snap
ior	snow
te	so
iskuin sat	so cute
haduh mynta	so far
pdem	soak
sabon	soap
pyngngad	sober
phutbol	soccer
ba iadei bad ka imlang sahlang	social
jaitbynriew	society
ki muja	socks
bajem	soft
software	software
khyndew	soil
lah die	sold
lah dei lut	sold out
shipai	soldier
ba marwei	sole
baskhem	solid
ka lad	solution
pynshai	solve
batai	solve
pynpaw	solve
katto katne	some
mano re mano	somebody
kumno re kumno	somehow
mano re mano	someone
kaei re kaei	something
tyngkhat	sometimes
jingrwai	song
shen shen	soon
kaba i kynsai	sophisticated
Sorani	Sorani
ka prum	sore
pang	sore
set rundang	sore throat
jingsngewsih	sorrow
Map	Sorry
pynsaphrinag	sort
ba la wad	sought
kynja mynsiem	soul
ba iaieit thepmynsiem	soulmate
jingsawa	sound
syrwa	soup
jew	sour
tyllong	source
Shathie	south
jaka bathylli	space
shah thok	spam
jingiar	span
ka ktien Spain	Spanish
pyllait im	spare
pyllait	spare
kren	speak
bakyrpang	special
ki jait	species
kaba long beit thik	specific
kaba iap biej	spectacular
kaba itynnad eh	spectacular
jingkren	speech
bym lait kren	speechless
jingstet	speed
kaba pule	spell
pynlut	spend
la pynlut	spent
ba don musli musla	spicy
u tiar ba nep	spike
pynshad pyllun	spin
palong	spinach
mynsiem	spirit
bynthiew	spit
kaba bha eh	splendid
ba phiah	split
phiah	split
pynsniew	spoil
ba lah sniew	spoiled
hangto hi	spontaneous
shamoit	spoon
thoh dak pyllun barit	spot
lok	spouse
pynsaphriang	spread
rynsied	spring
sawdong ryntih	square
khniot	squeeze
squid	squid
risang	squirrel
ki jaka ba pyniaid da ka niam catholic	st
dung	stab
sem kulai	stable
kynton	stack
nongtrei	staff
rynsan	stage
jingthoh dak	stain
mawkyndon	stairs
mawpud	stake
ba ap thap	stalk
ba bud	stalk
dukan	stall
iuh	stamp
jaka ieng	stand
ieng	stand
ka jingthew	standard
kyrdan	standard
khlur	star
sdang	start
ba la sdang	started
ba thngan	starving
ong	state
jinglong	state
ka jingthoh	statement
ka jaka ieng kali	station
rel	station
mot	statue
kyrdan	status
shong	stay
sah	stay
long shngain	stay safe
ba long skhem	steady
ba tikna	steady
ka doh masi	steak
tuh	steal
jynhaw	steam
ka nar	steel
ba thiep	steep
shylluit	stem
ba mih na	stem
symbud	stem
mawkyndon	step
dieng lyngkhot	stick
ba pynsyndait	stick
ba eh	stiff
wat la katta ruh	still
kynthtah	sting
khapnap	stingy
king	stir
ka jingmang lypa ia kaba lashai	stock
ba shu tuh	stolen
kpoh	stomach
maw	stone
la ieng	stood
ben	stool
sangeh	stop
jaka buh	storage
dukan	store
eriong	storm
jingiathuh khana	story
stove	stove
babeit	straight
beit beit	straight
shi sur shi dur	straightforward
jiar	strain
ka jingpynshitom	strain
phylla	strange
nongwei	stranger
ka rukom leh	strategy
stai	straw
skum	straw
u soh strawberry	strawberry
kaba sah na kaba ruid-dak	streak
wah duid	stream
surok	street
bor	strength
jingshitom jingmut	stress
pynjlan	stretch
pyrkhing	strict
tied	strike
tyllai	string
loit	strip
pyrshang tyngeh	strive
jyllud	stroke
ba khlain	strong
ba la tied	struck
jingtei	structure
iakhih	struggle
jingiakhih	struggle
ba iakhuh	struggling
mynthi	stubborn
dambit	stuck
sahkut	stuck
khynnah pule	student
pule	study
jingpule	study
jingpule	studying
thngian	stuff
ba iap beij	stunning
beij	stupid
stai	style
sobjek	subject
jingai khublei	submission
ai	submit
ka kynja kaba donkam	substance
ka mar	substance
ka met	substance
bujli	substitute
ba don buit	subtle
ba nep	subtle
ioh jingjop	succeed
jingjop	success
bajop	successful
kum kita	such
kum	such as
kjit	suck
kynsan	sudden
kynsan kynsan	suddenly
shem shitom	suffer
jingshem shitom	suffering
dap biang	sufficient
shini	sugar
ai jingmut	suggest
jingai jingmut	suggestion
iahap	suit
ba iahap	suitable
synduk	suitcase
jingkhein	sum
jingbatai lyngkot	summary
lyiur	summer
ka kliar	summit
ka sngi	sun
sngi u trai	sunday
shai sngi	sunny
sep sngi	sunset
jingshai ka sngi	sunshine
ba kham halor	super
ba kham bha	super
ba long heh	superior
nongpeit	supervisor
ja meit	supper
pynbiang	supply
jingkyrshan	support
kyrshan	support
tharai	suppose
tharai	supposed
thikna	sure
bynta ba shalor	surface
jingkiew kynsan	surge
jingpuid	surgery
jait	surname
jingkyndit	surprise
kyndit	surprised
aiti	surrender
ba ker sawdong	surrounding
jingwad bniah	surveillance
ka jingpeit	surveillance
survey	survey
lait im	survive
jingsuba	suspect
suba	suspect
ba la shah pynsangeh	suspended
ba la sdien	suspended
ban pynsangeh shuwa	suspended
suba	suspicious
iaineh	sustain
jinglah pynneh	sustainability
ba lah ban pynneh	sustainable
ba pynkhih u tdong	swag
nguid	swallow
iakylliang	swap
kren sih	swear
syep	sweat
swetar	sweater
sar	sweep
bathiang	sweet
Sa phohsniew bha	sweet dreams
bathiang bniat	sweet tooth
baieid	sweetheart
ba sieb	swell
jingsiep	swelling
jngi	swim
ba jngi	swimming
ka sohpadoi	swing
kaba pynkylla	switch
siep	swollen
waitlam	sword
shin	symbol
jingsngewlem	sympathy
ki dak jingpang	symptoms
ka rukom pyniaid	system
ka miej	table
kumno ban pynbeit ne iarap	tackle
buh kyrteng	tag
tdong	tail
shim	take
shim noh	take away
da sumar	take care
her	take off
lah shim	taken
jingkren	talk
kren	talk
bun ktien	talkative
ba jrong	tall
nar kor	tap
pita	tape
ka thong	target
ban thew	target
ka kam	task
mad	taste
jingmad	taste
ba bang	tasty
la hikai	taught
sha	tea
hikai	teach
nonghikai	teacher
kynhun	team
tar	tear
ummat	tears
pyndomkai	tease
ka technology	technology
bniat	teeth
iathuh	tell
iathuh ia nga	tell me
jingdomriang	temper
ka jinglong kaba shit ne khriat	temperature
jaka mane blei	temple
ba shipor	temporary
shiphew	ten
shiphew hajar	ten thousand
nongshongwai	tenant
ka sheit long	tend
lah ban long	tend
jingmlien	tendency
bajem	tender
ka jingtyrwa	tender
khuslai	tense
jingshitom jingmut	tension
iing jar	tent
bym thikna	tentative
kynhun	term
ki kyndon	terms
kaba sngew shyrkhei	terrible
shyrkhei	terrific
thain	territory
jingtynjuh	test
tynjuh	test
jingthoh	text
ban ia	than
ai khublei	thank
khublei	thank you
Khublei ia ka jingiaishah jong phi katba ngi dang wad jingtip ia ka shipment jong phi	Thank you for your patience while we investigate shipment
khublei shibun	thank you so much
khublei shibun eh	thank you very much
khublei	thanks
Khublei ba phi pyndonkam ka app jong ngi	Thanks for using our app
utei	that
katei	that
itei	that
kata ka long	that is
ka bha	that's good
Ka	the
U	the
jingtuh	theft
jong ki	their
ma ki	them
phang pdeng	theme
ma ki	themselves
nangta	then
thiori	theory
hangtei	there
kine ki long	there are
ka don	there is
namar kata	therefore
kine	these
ki	they
ki long	they are
rben	thick
nongtuh	thief
lbong	thigh
stang	thin
kaei kaei	thing
ki tiar ki tar	things
pyrkhat	think
ba lai	third
sliang	thirsty
khatlai	thirteen
laiphew	thirty
une	this
ine	this
kane	this
kane ka long	this is
babniah	thorough
ba la long tikna	thoroughly
ba la pule bha	thoroughly
kitei	those
hynrei	though
jingpyrkhat	thought
pyrkhat	thought
ba pyrkhat na ka bynta kiwei	thoughtful
ki jingpyrkhat	thoughts
shi hajar	thousand
ksai	thread
ka jingbyrngem	threat
byrngem	threaten
lai	three
khyrdop	threshold
shongshit	thrilled
roi	thrive
pdot	throat
lyngba	through
baroh shi lynter	throughout
bret	throw
kti kmie	thumb
pyrthat	thunder
Sngi palei	Thursday
kumta	thus
pruid dak	tick
jingsieb jong ka um duriaw	tide
pynbeit	tidy
ka jingteh	tie
the	tie
khla	tiger
pyrkhing	tight
Tigrinya	Tigrinya
ka por	time
tieng pyut	timid
barit	tiny
kaba aisbun ia ka pisa	tip
jingaisbun	tips
man thait	tire
thait	tired
ki bynta ka dkhot met	tissue
ka kot ba jem	tissue
kyrdan	title
ha	to
sha	to
ban long	to be
syang tyrkhong	toast
mynta ka sngi	today
khynnah rit	toddler
shympriah kjat	toes
ryngkat	together
jaka leit bar	toilet
la ong	told
jiingiaishah	tolerance
shah	tolerate
sohsaw	tomato
lashai	tomorrow
thylliej	tongue
mynta ka meit	tonight
ruh	too
la shim	took
tiar	tool
ki tiar	tools
bniat	tooth
hajrong	top
phang	topic
ba lah jot	torn
pynshitom	torture
kyllum	total
ktah	touch
jwat	tough
ba eh	tough
tour	tour
shaphang	toward
shaphang	towards
jain niad	towel
nongrit	town
ba long bih	toxic
Ban bud dien	trace
ba iohi lyngba	trace
kaba buddien	track
jingkhaii	trade
khaii	trade
dustur	tradition
bahiar pateng	traditional
Ka jingdheng kali	traffic
ka block	traffic
ka lynti bud dien	trail
hikai	train
jinghikai kyrpang	training
jinglong khynnah	trait
ki jinglong pher	traits
pynkynriah	transfer
ka jingkylla kat kum ka por	transition
pynkylla ktien	translate
ba iohi lyngba	transparent
ka rukom leit rukom wan	transport
ka rukom leit rukom wan	transportation
jingriam	trap
jaboh	trash
jingmynsaw	trauma
leit jingleit	travel
tray	tray
spah ba buhrieh	treasure
leh	treat
jingsumar	treatment
dieng	tree
shibun	tremendous
ba i tieng	tremendous
ba i shyrkhei	tremendous
kaba khraw	tremendous
kaba heh	tremendous
kaba ia leh lang da kiba bun	trend
jingpyrshang	trial
buit	trick
la pyrshang	tried
kaba pynkhih jingmut	trigger
khap ryntih	trim
ka jingleit kai	trip
jynthut	trip
jingeh	trouble
patlun	trousers
trok	truck
ba shisha	true
luta	trunk
jingshaniah	trust
shaniah	trust
ka hok	truth
pyrshang	try
Tsonga	Tsonga
tyndong	tube
Sngi Baar	Tuesday
jinghikai	tuition
han shoina	turkey
shynrai	turmeric
phai	turn
dkar	turtle
nonghikai	tutor
khatar	twelve
arphew	twenty
arphew wei	twenty-one
Twi	Twi
arsien	twice
kyllain	twist
ar	two
ka jait	type
ba long mlien	typical
sniewdur	ugly
bakhatduh	ultimate
shatri	umbrella
ym lah	unable
mama	uncle
bym tip briew	unconscious
ha trai	under
ha trai	underneath
bym khein dor	underrated
sngewthuh	understand
ba la sngewthuh	understood
sngewsih	unfortunately
ryntih	uniform
bakyrpang	unique
kawei	unit
katno tylli	unit
skul bah	university
bym ithuh	unknown
lymda	unless
haduh	until
phylla	unusual
shajrong	up
ka shong ha phi	up to you
jingpynthymmai	update
pynthymmai	update
pynkiew kyrdan	upgrade
jingpynkiew kyrdan	upgrade
halor	upon
diaw	upset
thain sor	urban
kyntu	urge
jingkwah	urge
bakyrkieh	urgent
ma ngi	us
pyndonkam	use
jingpyndonkam	use
ba la pyndonkam	used
bamyntoi	useful
bym lerkam	useless
kaba ju long	usual
bunsien	usually
jingmyntoi	utility
jingleit shuti	vacation
tika	vaccination
tika	vaccine
bathylli	vacuum
bym shai	vague
kaba lah ban pyntreikam haduh	valid
them	valley
bashongdor	valuable
pynshongdor	value
ka jingshongdor	value
bun jait	variety
bun jait	various
pher	vary
khiew synriew	vase
ba iar	vast
u jhur	vegetable
ki khur	vegetables
ka kali	vehicle
nongdie	vendor
bih	venom
poi sha ka jingma	venture
jaka	venue
pynshisha	verify
ba lah ban kylla	versatile
ba lah ban leh shibun ki kam	versatile
jingiathuh	version
da pynieng	vertical
shisha	very
ka ba paka	very good
khiew	vessel
lyngba	via
ka jinglong ne jingsngew shimet	vibe
ki jingsngew shimet	vibes
dusmon	vicious
ba ngat ha kino kino ki kam ba shah pyni bor	victim
ba shah pynjynjar	victim
ka video	video
ka jingsngew	view
jingiohi	view
nongkyndong	village
riewsniew	villain
syrka	vinegar
ba lah rim	vintage
jingleh jubor	violence
jingiashoh	violence
jingiaumsnam	violence
bashyrkhei	violent
ka jingsaphriang	viral
sotti	virgin
ba don ka bor	virtual
ka jingbha	virtue
jingiohi	vision
leit jngoh	visit
jingleit jngoh	visit
iohibha	visual
bakongsan	vital
bashai	vivid
ki ktien	vocabulary
ka sur	voice
liewlong	void
jingsawa	volume
uba leh ia kano ka kam da ka mon sngewbha	volunteer
prie	vomit
ka prie	vomit
kiba don ha ka jaka ba pynlong tlot ia u ne ka briew	vulnerable
ba don ha ka jingma	vulnerable
bainong	wage
bainong	wages
syngkai	waist
ap	wait
nongsam bam	waiter
dang ap	waiting
kyndit bynriew	wake
khie noh	wake up
jingiaid	walk
iaid	walk
iaid	walking
kynroh	wall
pdok	wallet
shang	wander
kwah	wanna
kwah	want
ba la kwah	wanted
thma	war
ki jain ki nep	wardrobe
kudam	warehouse
jingsyaid	warm
pynsyaid	warm
maham	warn
jingmaham	warning
shipai	warrior
la long	was
sait	wash
pynlehnohei	waste
jinglehnohei	waste
baje	watch
peit	watch
ka um	water
watermelon	watermelon
kaweh	wave
lad	way
ngi	we
ngi long	we are
ngi lah	we can
ba tlot	weak
jingtlot bor	weakness
spah	wealth
riewspah	wealthy
phong	wear
ba phong	wearing
suin bneng	weather
jingshong kurim	wedding
Sngi Balang	Wednesday
nuit	weed
taiew	week
kut taiew	weekend
jingkhia	weight
khyllah	weird
ba i pher	weird
pdiang sngewbha	welcome
jingbha	welfare
Khiah	Well
kaba la leh paka	well done
la leit	went
lah juh	were
sepngi	west
jhieh	wet
U dohkha bah u Wiel (Whale)	whale
kaei	what
phi pat kummo	what about you
phi leh aiu	what are you doing
phi leh aiu mynta	what are you doing now
phi leh aiu ha kane ka por?	what are you doing right now
phi leh aiu mynta?	what are you doing right now
phi trei kam aiu	what do you do
phi trei kam aiu	what do you do for a living
phi im ja kpoh da kaei	what do you do for a living
phi mut kumno	what do you mean
phi kwa aiu	what do you want
jia aiu	what happened
kaei ka	what is
kaei kane	what is this
phi trei ka kam aiu	what is your job
phi kyrteng kumno	what is your name
kumno kiei kiei baroh	what's up
phi kyrteng kumno	what's your name
katba	whatever
kew	wheat
shaka	wheel
lano	when
Ha kano kano ka por	whenever
man la ka por	whenever
shano	where
nangno	where
hangno	where
hangno phi don	where are you
phi dei naei	where are you from
phi don haei mynta	where are you now
phi sah hangno	where do you live
hangno don	where is
katba	whereas
lada	whether
kano	which
kaba	which
kaei	which
katba	while
pasiaw	whisper
siaw	whistle
lieh	white
mano	who
phi dei mano	who are you
mano ba	who is
mano ine	who is this
baroh kawei	whole
mano	whom
jongno	whose
balei	why
balei em	why not
sniew jinglong	wicked
iar	wide
riew kynthei	widow
jingiar	width
ka lok	wife
riewkhlaw	wild
ka mon	will
bamynjur	willing
jop	win
lyer	wind
jingkhang iit	window
ba beh lyer	windy
kyiad	wine
tlang	winter
niad	wipe
sainar	wire
jingshemphang	wisdom
bastad	wise
kwah	wish
kitbok kit rwiang	wish you all the best
ka nongaisniew	witch
bad	with
kynran dien	withdraw
jingrandien	withdrawal
hapoh	within
khlem	without
nongsakhi	witness
sakhi	witness
ba biria	witty
suri	wolf
ka kynthei	woman
ki kynthei	women
lah jop	won
nym	won't
jinglyngngoh	wonder
kaba sngewtynnad	wonderful
ka dieng	wood
sai wool	wool
ktien	word
ki ktien	words
trei	work
jingtrei	work
jingkilan met	work out
ba treikam	working
ka pyrthei	world
wieh	worm
ba lah jot	worn
khuslai	worried
khuslai	worry
kham sniew	worse
mane	worship
ba sniew tam	worst
ka dor	worth
ba shongdor	worth it
ba don dor	worthy
phin	would
yn sa	would
jingmong	wound
Wow	Wow
sop	wrap
jingbitar	wrath
ka ryndang kti	wrist
thoh	write
Thoh hangne	Write here
jingthoh	writing
ba la thoh	written
ba bakla	wrong
la thoh	wrote
pruh	yard
jingsaham	yawn
saham	yawn
Hooid	Yeah
snem	year
ki snem	years
thit	yeast
hylla	yell
ba stem	yellow
Hooid	Yes
to, baieid!	yes baby
Oi baieid	yes dear
hooid baieid	yes honey
hooid baieid jong nga	yes my love
hooid khlem pep	yes of course
mynnin	yesterday
haduh mynta	yet
pyndem	yield
phi	you
phi long	you are
phi bhabriew	you are beautiful
phi bhabriew bha	you are so beautiful
ym lei lei	you are welcome
phi lah	you can
Phi tip	You know
phi ruh	you too
ym lei lei	you're welcome
dang khynnah	young
dang lung	young
jong phi	your
ym lei lei	your welcome
ma phi	yourself
ka jinglong samla	youth
ym lei lei	you’re welcome
babang	yummy
nout	zero
