ا	a
کینٛہہ	a little
واریاہ	a lot
واریاہ کینٛہہ	a lot of
ترٛاوٗن	abandon
ترک کردین	abandoned
روزٕ	abide
اہلیت	ability
قٲبل	able
اتھ متعلق	about
ہیرٕ	above
بیرون ملک	abroad
غٲر موجودگی	absence
غٲر موجود	absent
بالکل	absolutely
جذب کرنا	absorb
تجریدی	abstract
مضحکہ خیز	absurd
کثرت	abundance
واریاہ زیادٕ	abundant
غلط استعمال	abuse
فنہ تعمیٖرات	accent
قبول کر	accept
رسٲئی	access
حٲدثہٕ	accident
رہائش	accommodation
پورٕ کر	accomplish
کامیاب	accomplished
مطٲبق	according
اکاونٹ	account
درستگی	accuracy
درست	accurate
الزام تراشی	accused
ژھایہ	ache
حٲصل کر	achieve
کامیٲبی	achievement
تسلیم کر	acknowledge
واقفیت	acquaintance
حٲصل کر	acquire
حٲصل کرکھ	acquired
خریدٲری	acquisition
أنٛد پٔکھۍ	across
ایکٹ	act
کاروٲیی	action
فعال	active
سرگرمیہٕ	activities
سرگرمی	activity
اداکار	actor
اصلی	actual
اصلس منز	actually
تیز	acute
ایڈاپٹ	adapt
ایڈ کر	add
نشٲنی	addicted
اضافہٕ	addition
اضٲفی	additional
پتہ	address
کٲفی	adequate
نزدیکی	adjacent
صفت	adjective
ایڈجسٹ کر	adjust
تعریف کر	admire
تسلیم کر	admit
اپناو	adopt
پریٚتھ	adorable
پیشگی	advance
ایڈوانسڈ	advanced
فأئدٕ	advantage
ایڈونچر	adventure
ایڈورب	adverb
اشتہار	advertisement
اشتہار بازی	advertising
مشورٕ	advice
مشورٕ	advise
ایڈوکیٹ	advocate
آرکیٹیکچرل	aesthetic
معملہٕ	affair
متٲثر کرن	affect
محبت	affection
فراہم کر	afford
سستہٕ	affordable
ڈرو	afraid
امہ پتہٕ	after
دوپہر	afternoon
پتہٕ	afterwards
دوبارٕ	again
خلاف	against
عمر	age
ایجنسی	agency
ایجنٹ	agent
جارحانہ	aggressive
اگل	agile
برونٹھ	ago
اتفاق کر	agree
معاہدٕ	agreement
زراعت	agriculture
برٛونٛہہ کن	ahead
امداد	aid
مقصد	aim
ہوا	air
ہوائی اڈے	airport
ہہہہہہہہہ	aisle
الارم	alarm
شراب	alcohol
الرٹ	alert
زندٕ	alive
سٲری	all
ٹھیک چھ	all right
تمام بہترین	all the best
اجازت دیو	allow
اجازت	allowed
تقریبا	almost
اکیلا	alone
سۭتۍ سۭتۍ	along
گۄڈٕ پیٚٹھٕ	already
ٹھیک چھ	Alright
تہ تہ	also
متبادل	alternative
حالانٛکہ	although
ہمیشہٕ	always
آیم	am
حیرت انگیز	amazing
مبہم	ambiguous
عزائم	ambition
مہتواکانکشی	ambitious
بدلاو	amend
درمیان	amid
یمن منز	among
اسہ درمیان	among us
رقم	amount
مزٕ دار	amusing
ا	an
تجزیہ	analysis
جد	ancestors
اینکر	anchor
پرٲنۍ	ancient
تہٕ	and
تہٕ توہہہ	and you
فرشتہ	angel
شرارت	anger
زاویہ	angle
ناراضگی	angry
جانور	animal
ٲٹھۍ ٲٹھۍ	ankle
سالانہٕ تقریبات	anniversary
اعلان	announcement
ناراضگی	annoy
ناراضگی	annoyed
پریشان کن	annoying
پریتھ وأری	annual
ناواقف	anonymous
بیاکھ اکھ	another
جواب	answer
پیشین گوئی کر	anticipate
اضطراب	anxiety
پریشان	anxious
کانٛہہ تہ	any
بیٚیہ	anymore
کانہہ تہ	anyone
کانٛہہ تہ	anything
وونہ گو٘	anyway
وونہ گو٘	anyways
الگ الگ	apart
اپارٹمنٹ	apartment
درخاست کر	apologize
واضح	apparent
واضح طور پٲٹھۍ	apparently
اپیل	appeal
وچھنہٕ چھ یوان	appear
شکٕل	appearance
آو ؤچھنہٕ	appeared
بھوک	appetite
ایپل	apple
ایپلیکیشن	application
لاگو کر	apply
اپائنٹمنٹ	appointment
تعریف کر	appreciate
تعریف	appreciation
نقطہ نظر	approach
موزوں	appropriate
منظوری	approval
منظوٗری	approve
منظور شدٕ	approved
لگ بگ	approximately
اپریل	april
صوابدیدی	arbitrary
آرکیٹیکٹ	architect
فن تعمیر	architecture
آرکائیو	archive
چھ	are
کیا تہۍ چھو ؟	are you
کیا تہۍ چھو مصروف	are you busy
کیا تہۍ چھو خانٛدر کٔرتھ	are you married
کیا تہۍ چھو خانٛدر کٔرتھ یا وٲحد	are you married or single
کیا تہۍ چھوٕ ونہٕ تہٕ ییٚتہ ؟	Are you still there?
کیا تہۍ چھو ییٚتہ ؟	are you there
علاقہٕ	area
بحث کر	argue
دلیل	argument
وٮ۪تُھن	arise
بانہٕ	arm
فوج	army
أنٛد پٔکھۍ	around
انتظام کر	arrange
انتظام	arrangement
آمدٕ	arrival
ووت	arrive
آو	arrived
حٲران	arrogant
تیر	arrow
آرٹ	art
مضمون	article
مصنوعی	artificial
فنکار	artist
یتھ کٕنہ	as
یوتتھ تام ز	as long as
تہ تہ	as well
تہ تہ	as well as
ایش	ash
شرمسار	ashamed
پرژھ	ask
پرٛژھ	asked
سونٛچھ	asleep
پہلو	aspect
آسامیہ	Assamese
حملہ	assault
اسمبلی	assembly
زور دار	assertive
تشخیص	assess
تشخیص	assessment
اثاثہ جات	asset
اثاثہ جات	assets
تفویض کر	assign
تفویض	assignment
مدد کر	assist
معاونین	assistant
ایسوسی ایٹ	associate
وابستہٕ	associated
ایسوسی ایشن	association
فرض کر	assume
مفروضہٕ	assumption
پیٹھ	at
کم از کم	at least
کھٮ۪وان	ate
ایتھلیٹ	athlete
اٹیچ کر	attach
منسلک	attached
اٹیچمنٹ	attachment
حملہٕ	attack
کوشش کر	attempt
حاضر	attend
حاضری	attendance
توجہ	attention
رویہٕ	attitude
کشش کرن	attract
کشش	attraction
پرکشش	attractive
خصوصیت	attribute
سامعیٖن	audience
اگست	august
آنٹی	aunt
آنٹی	aunty
اصلی	authentic
مصنف	author
اتھارٹی	authority
موسم خزاں	autumn
دستیاب	available
اوسط	average
بچاو	avoid
جاگایہ	awake
ایوارڈ	award
جان	aware
آگہی	awareness
دور	away
بہت خوب	awesome
خوفناک	awful
ناگوار	awkward
امیری	Aymara
بچہٕ	baby
باسلر	bachelor
واپس	back
پس منظر	background
خراب	bad
بیگ	bag
باٹ	bait
پکاو	bake
بیکری	bakery
بیکنگ سوڈا	baking soda
توازن	balance
بال	ball
بمبرا	Bambara
کیلہٕ	banana
بینٛڈ	band
بنگ	bang
بینک	bank
بار	bar
بمشکل	barely
سودا	bargain
چھلکہ	bark
بارلی	barley
رکاوٹ	barrier
بنیاد	base
پیٹھ مبنی	based
تہہ خانہ	basement
بنیٲدی	basic
بنیٲدی طور پٲٹھۍ	basically
ببر	basil
بیسیل	basil
بکارڈ	bastard
بیچ	batch
باتھ روم	bath
باتھ روم باتھ روم	bathroom
بیٹری	battery
لڑایہ	battle
باے	bay
آسن	be
احتیاط کریو	be careful
بیچ	beach
بیم	beam
بینہٕ	beans
بیور	bear
ژھاڑٕ	beard
بارنہٕ	bearing
جانور	beast
بیٹ	beat
خوبرو	beautiful
خوبصورتی	beauty
بنییہ	became
کیازٕکہ	because
بنیوو	become
بیڈ	bed
بیڈروم	bedroom
بی بی	bee
گاڑٕ	beef
اوس	been
بیئر	beer
امہ برٛونٛہہ	before
شروٗع کٔر	began
شروٗع کر	begin
شروعات	beginning
طرفہٕ	behalf
برتاو کر	behave
طرز عمل	behavior
برتاو	behaviour
پتہٕ	behind
آسن	being
عقیدٕ	belief
یقین	believe
پیٹ	belly
تعلق چھ	belong
محبوب	beloved
بۄن چھ	below
بیلٹ	belt
بنچ	bench
بانٛڑ	bend
بۄن	beneath
فأئدٕ	benefit
فائدٕ	benefits
بغٲر	beside
امہ علاوٕ	besides
بہتٔریٖن	best
بہت خوش قسمت	best of luck
بہت بہت نیک خواہشات	best regards
بہتر	better
درمیان	between
مشروبات	beverage
امہ نیبر	beyond
بھوجپوری	Bhojpuri
پاگل پن	bias
متعصبانہ	biased
سایکل	bicycle
بولی	bid
بجہ	big
سایکل	bike
بل	bill
بانڈ	bind
پردٕ	bird
زینہٕ دوہ	birthday
تھوڑا سا	bit
ژوپ	bite
کریر	bitter
کالا	black
بلیڈ	blade
الزام تراو	blame
خالی	blank
کمبل	blanket
دھماکہٕ	blast
بلیچ	bleach
ملاو	blend
آشیرواد	bless
آشیرواد	blessed
اندٕ	blind
مزیٖد	bliss
بلاک	block
خون	blood
بلوم	bloom
بلہ	blow
نیلا	blue
چپ چاپ	blunt
بورڈ	board
ناو	boat
جسمہٕ	body
بولاو	boil
بولڈ	bold
بانڈ	bond
ہڈی	bone
کتاب	book
بڑاو	boost
بوسٹر	booster
بوٹ	boot
بوٹس	boots
سرحدٕ	border
بورو	bore
بورٕ	bored
بورنگ	boring
پیدٲیش	born
ادھار	borrow
باس	boss
دۄشوٕے	both
پریشان کرن	bother
بوتل	bottle
بوم	bottom
کنن	bought
اچھن	bounce
بانڈ	bound
حدود	boundaries
کمان	bow
باول	bowl
ڈبہ	box
لڑکا	boy
بوائے فرینڈ	boyfriend
قؤر	bracelet
دماغ	brain
شاخہ	branch
برانڈ	brand
بہادر	brave
خلاف ورزی	breach
روٹی	bread
پھٹراو	break
ناشتہ	breakfast
چھاتی	breast
سان	breath
شاہ کھیو	breathe
نسل	breed
بریک	brick
مہرنہ	bride
پل	bridge
مختصر	brief
روشن	bright
شاندار	brilliant
انۍ	bring
برو	bro
وسیع تر	broad
نشریہ	broadcast
پھٹکھ	broke
ژٹتھ ژٹتھ	broken
جھاڑو	broom
بوے بوے	brother
دُری	brother in law
انۍ	brought
برۄنۍ	brown
بروس	brush
بالٹن	bucket
یار	buddy
بجٹ	budget
بگ	bug
بناو	build
عمارت تعمیر	building
بناوتھ	built
تھوک	bulk
بلہ	bull
بٗللی	bully
بمپ	bump
بنچ	bunch
بنڈل	bundle
بوجھ	burden
دفن کردین	buried
جلاو	burn
پھٹراو	burst
دفن کر	bury
بس	bus
بش	bush
کاربار	business
بسٹ	bust
مصروف	busy
مگر	but
مکھن	butter
چمگادڑ	butterfly
بٹن	button
کن	buy
ذریعہ	by
وونہ گو٘	by the way
الوداع	bye
کبوتر کبوتر	cabbage
کابینہ	cabinet
کیج	cage
کیک	cake
کاپھ	calf
کال کر	call
مےٚ کر کال	call me
کال کر	called
پرسکون	calm
آو	came
مہم	campaign
ہٮ۪کہٕ کٔرتھ	can
بہٕ ہیٚکہٕ نہٕ کٔرتھ	can't
رد کر	Cancel
کینسر	cancer
قٲبل	capable
صلاحیت	capacity
کیپٹل	capital
کیپشن	caption
رٹن	capture
کار	car
پیشور	career
احتیاط	careful
احتیاط سان	carefully
لاپرواہ	careless
دیکھ بھال	caring
کارپینٹر	carpenter
کارپیٹ	carpet
کریٹ	carrot
ننننن	carry
جٲری تھوو	carry on
چلاو	carry out
کیس	case
نقد رقم	cash
کاسٹ	cast
قلعہ	castle
معموٗلی	casual
کیت	cat
رٹن	catch
زمرہ جات	category
مویشی	cattle
پکٔمتھ	caught
وجہ	cause
احتیاط	caution
احتیاط	cautious
غار	cave
رکاو	cease
چھت	ceiling
جشن مناو	celebrate
سیل	cell
مرکز	center
صدی	century
اناج	cereal
تقریب	ceremony
یقینی	certain
یقینی طور	certainly
سرٹیفکیٹ	certificate
چین	chain
کرسی	chair
چیلنج	challenge
موقعہ	chance
بدلاو	change
افراتفری	chaos
کردار	character
خصوصیات	characteristics
چارج کر	charge
خیراتی کام	charity
دلکش	charming
چارٹ	chart
پیچھا کر	chase
چیٹ کر	chat
سستہٕ	cheap
دھوکہ دہی	cheat
دھوکہ دہی	cheating
چیک کر	check
چیخ	cheek
چایٔر	cheer
مزٕ دار	cheerful
چایٔر	cheers
چیز چیز	cheese
کیمسٹری	chemistry
مزیٖد کر	cherish
شطرنج	chess
چھاتی	chest
چبانہٕ	chew
چکن چکن	chicken
چیف	chief
بچہٕ	child
بچپن	childhood
بچہٕ	children
ٹھنڈا	chill
چمنی	chimneys
چن	chin
چاکلیٹ	chocolate
چن	choice
ژارنہٕ	choose
نِکراوُن	chop
کٲم	chores
چبوتر	chubby
گرجہ گھر	church
دالچٮ۪ن	cinnamon
دائرٕ	circle
حالات	circumstances
شہری	citizen
شہر	city
داواہ	claim
وضاحت کر	clarify
کلاس	class
میژ	clay
صاف	clean
صاف	clear
کلرک	clerk
چالاک	clever
کلائنٹ	client
کلف	cliff
آب و ہوا	climate
چڑھو	climb
کلنگ	clingy
گھنٛٹہٕ	clock
بند کر	close
کوٹھ	closet
پوشاک	cloth
پلو	clothes
کلاؤڈ	cloud
کلاؤڈی	cloudy
جوکُر	clown
کٗلو	clue
کلیمسی	clumsy
کلسٹر	cluster
کوچ	coach
کول	coal
ساحلی علاقہٕ	coast
کوٹ	coat
کافی کافی	coffee
نفسیٲتی	cognitive
اتفاقن	coincidence
سرد	cold
ژٹتھ	collapse
کالر	collar
سٲتھی	colleague
سٲتھی کارکنان	colleagues
جمع کر	collect
مجموعہٕ	collection
کالج	college
رنگ	color
بے رنگ سبز خیالات سوے غصہٕ سان	colorless green ideas slept furiously
رنگ	colour
کالم	column
کمب	comb
امتزاج	combination
یکجا کر	combine
آو	come
ٮ۪ٮ۪ور ٮ۪ۍ	come here
آو	come on
آرام	comfort
آرام دہ	comfortable
پیشین گوئی کر	coming
جلدی ینۍ	coming soon
کمانڈ	command
تبصرٕ	comment
تجٲرتی	commercial
کمیشن	commission
کر	commit
وابستگی	commitment
عہد بند	committed
سامان	commodity
عام	common
کتھ باتھ کر	communicate
کمیونیکیشن	communication
کمیونٹی	community
آمد و رفت کر	commute
سٲتھی	companion
کمپنی	company
موازنہ کر	compare
موازنہ	comparison
ہمدردی	compassion
رحم دل	compassionate
ہم آہنگ	compatible
مقابلہٕ کر	compete
قٲبل	competent
مقابلہٕ	competition
مسابقتی	competitive
شکایت کر	complain
شکایت	complaint
تکمیلی	complement
پوٗرٕ	complete
مکمل طور پر	completely
کمپلیکس	complex
تعمیل	compliance
پیچیدٕ	complicated
تعریفیں	compliment
تعمیل کر	comply
کمپوزیشن	composition
کمپاؤنڈ	compound
تفہیم	comprehension
مکمل طور پر	comprehensive
سمجھوتہٕ	compromise
ضٔروٗری	compulsory
کمپیوٹر	computer
توجہ مرکوز کرنا	concentrate
تصور	concept
فکر	concern
فکر مند	concerned
کنسرٹ	concert
نتیجہٕ	conclusion
کنکریٹ	concrete
حالت	condition
حالات	conditions
طرز عمل	conduct
کانفرنس	conference
اعتراف	confess
ٹرٛنٹیشن	confidence
بھروسہ	confident
تصدیق کر	confirm
تنازعہ	conflict
الجھنس منز	confused
الجھن	confusion
مبارک باد	congrats
مبارک باد	congratulation
مبارک باد	congratulations
کنجکشن	conjunction
کنیکٹ کر	connect
فتح کر	conquer
آگہی	conscious
شعور خیٲلی	consciousness
قبولیت	consent
نتیجہٕ	consequences
بچاو	conservation
کنزرویٹو	conservative
غور کریو	consider
غور کرتھ	considered
شٲمل	consist
مستقل مزاجی	consistency
مستقل	consistent
مستقل	constant
لگاتار	constantly
قبضہٕ	constipation
تعمیر	construction
کھیوان	consume
کھپت	consumption
رٲبطہٕ	contact
متعدی	contagious
اتھ منٛز چھ شٲمل	contain
اتھ منٛز چھ شٲمل	contains
معاصر	contemporary
بے عزتی	contempt
مواد	content
مقابلہٕ	contest
تناظرس منز	context
براعظم	continent
جٲری تھوو	continue
معاہدٕ	contract
تضاد	contrast
تعاون کریو	contribute
حصہٕ	contribution
کنٹرول	control
تنازعہ	controversial
سہولت	convenience
آرام دہ	convenient
کتھ باتھ	conversation
بدلاو	convert
بٲگراو	convey
یقین دہانی	convince
یقین دہانی	convinced
پکاو	cook
کھین پکاون	cooking
ٹھنڈا	cool
باہمی تعاون	cooperation
سمبھالتھ	cope
کاپر	copper
کور	core
مرغی	corn
کٗنن	corner
ٹھیک چھ	correct
قۭمت	cost
پوشاک	costume
کاٹیج	cottage
کپاس	cotton
سوٚپھ	couch
ژاس	cough
ہیکہ ٲستۍ	could
کونسل	council
شمار کر	count
کاؤنٹر	counter
ملک	country
دیہی علاقہٕ	countryside
جوٗرۍ	couple
ہمت	courage
کورس	course
عدالت	court
شائستگی	courtesy
کزن	cousin
کور	cover
گاؤ	cow
کاورڈ	coward
کوزی	cozy
کریب	crab
کریک	crack
کرافٹ	craft
بکواس	crap
کریش	crash
درٛاوٗن	craving
کرال	crawl
پاگل پن	crazy
بناو	create
تخلیقی	creative
کریڈیٹ	credit
کریپ	creep
کریٚپ	creepy
منیجر	crew
جرم	crime
کرنٛگہ	cringe
کراس	crisis
معیارات	criteria
تنقیدی	critical
تنقیٖد	criticism
فصل	crop
فصلہٕ	crops
کراس	cross
کووا	crow
ہجوم	crowd
بھڈ	crowded
تاج	crown
اہم	crucial
کرول	cruel
کروز	cruise
کرش	crush
رٮ۪وان	cry
ککڑی	cucumber
نالہ مُت کرُن	cuddle
ثقافت	culture
چنک	cunning
کپ	cup
چمچہ	cupboard
کرب	curb
علاج	cure
کرفیو	curfew
تجسس	curiosity
تجسس	curious
کرلی	curly
کرنسی	currency
موجودٕ	current
ونکینس	currently
لعنت	curse
پردٕ	curtain
کوٹھ	cushion
کسٹم	custom
کسٹمر	customer
رسم و رواج	customs
ژٹتھ	cut
خوبرو	cute
سایکل	cycle
سایکل چلاو	cycling
مٲلۍ	dad
مٲلہ	daddy
پرٛٮ۪تھ دۄہ	daily
ڈایری	dairy
ڈیم	dam
نقصان	damage
لعنتی	damn
نم	damp
ڈانس	dance
خطرٕ	danger
خطرناک	dangerous
تاریک	dark
مہربٲنی	darling
ڈیش	dash
ڈیٹا	data
تٲریخ	date
کوٗر	daughter
دۄہہ	day
مٔرتھ	dead
ڈیڈ لائن	deadline
بوٕڑ	deaf
سودا	deal
مہربٲنی	dear
پریٚے سٲری	Dear All
ٹوٹھ کسٹمر	Dear Customer
پیارے مول موج	Dear Parents
مہربٲنی سر	Dear Sir
پرآرہو طٲلبہ علمو	Dear students
مہربٲنی ٹیم	Dear Team
موت	death
بحث	debate
ڈبٹ	debit
کھنڈرات	debris
قرضہ	debt
دہ ورھے	decade
ڈیک	decay
مٔرتھ	deceased
دھوکہ دیو	deceive
دسمبر	december
شانٛدار	decent
فٲصلہٕ کر	decide
فٲصلہٕ	decided
فٲصلہٕ	decision
ڈیک	deck
کم کرن	decline
کم کر	decrease
وقف	dedicated
وقف	dedication
عمل	deed
سرٛن	deep
مرغی	deer
ڈیفالٹ	default
شکست	defeat
بچاو	defend
وضاحت کر	define
یقینی طور	definitely
تعریف	definition
ڈگری	degree
تاخیر	delay
تاخیر	delayed
ڈیلیٹ کر	delete
ارادٕ سان	deliberate
حٔقیقت	delicate
مزٕ دار	delicious
مزیٖد	delight
مزیٖد	delighted
ڈلیور کر	deliver
ڈلیور	delivered
ڈلیوری	delivery
منٛگ	demand
منٛگ کرن	demanding
جمہوریت	democracy
ڈیمن	demon
نمٲئش کر	demonstrate
انکار	denied
ڈینسٹی	density
تجاویز	dentist
انکار	deny
محکمہٕ	department
نیرٗن	departure
انحصار	depend
تعینات کر	deploy
ڈپازٹ	deposit
ڈپریشن	depressed
ڈپریشن	depression
سرٛن	depth
بیان کر	describe
وضاحتیں	description
صحرا	desert
قابل	deserve
ڈزاین	design
نامزدگیاں	designation
چاہت	desire
میز	desk
مایوسی	despair
مایوس	desperate
امہ باوجود	despite
ڈیسرٹ	dessert
منزل	destination
تقدیر	destiny
تباہ کر	destroy
تباہ کن	destruction
تفصیل	detail
تفصیلات	details
پتہ لگاو	detect
ارادٕ	determination
طے کر	determine
طے شدہ	determined
تباہ کن	devastated
ترقی	develop
تیار کرکھ	developed
ترقی	development
ڈیوائس	device
شیطانن	devil
وقف	devoted
دھیوی	Dhivehi
ذیابطیس	diabetes
ڈایریا	diarrhea
ڈایری	diary
ڈکشنری	dictionary
کرکھ	did
مران	die
مٔرتھ	died
غذا	diet
فرق	difference
مختٔلف	different
مشکل	difficult
حھنُن	dig
وقار	dignity
مستعد	diligent
ڈنر	dinner
ڈب	dip
براہ راست	direct
ڈایریکشن	direction
ڈائریکٹر	director
میژ	dirt
گندھک	dirty
غیر فعال کر	disable
غیر فعال	disabled
غٲئب	disappear
مایوس	disappointed
آفات	disaster
تراوکھ	discard
ڈسچارج	discharge
نظم و ضبط	discipline
رعایت	discount
دریافت کر	discover
تفریق	discrimination
کتھ باتھ کر	discuss
بحث	discussion
کم	disease
بٮ۪مار	diseases
بھٮ۪س بدلاوُن	disguise
ناگوار	disgusting
ڈش	dish
پکوان	dishes
رد کریو	dismiss
سوز	dispatch
ڈسپلے کر	display
تخفیف	disposal
تنازعہ	dispute
فاصلہٕ	distance
الگ الگ	distinct
فرق کر	distinguish
تکلیف	distress
تقسیم کرنا	distribution
ضلعہٕ	district
پریشان کرن	disturb
ڈچ	ditch
ڈائیونگ	dive
مختٔلف	diverse
تنوع	diversity
تقسیٖم کر	divide
دیوی	divine
طلاق	divorce
چکرٕ	dizzy
کر	do
کیا تہۍ چھوٕ	do you
کیٛاہ ژٕ چُکھ مےٚ پیار کران	do you love me
ڈاکٹر	doctor
دستاویز	document
چھ کران	does
چھنہٕ کران	doesn't
کٗنہ	dog
ڈوگری	Dogri
کران	doing
ڈول	doll
ڈومین	domain
گھریلو	domestic
غلبہٕ دار	dominant
کر نہٕ	don't
فکر کریو مت	Don't worry
ڈونیٹ کر	donate
کرکھ	done
گاڑٕ	donkey
ڈوپ	dope
دۄگنہٕ	double
شک	doubt
ڈول	dough
بۄن	down
ڈاؤن لوڈ	download
ڈرافٹ	draft
ڈریگ	drag
ڈرین	drain
ڈراما	drama
تراو	draw
ڈراور	drawer
مصوری	drawing
ڈراو	dread
خواب	dream
پلو	dress
ڈرل	drill
پیوٗن	drink
ڈرائیو کر	drive
ڈراپ	drop
ترٲوتھ	dropped
خشک سالی	drought
شراب پیتھ	drunk
خشک	dry
ڈک	duck
یار	dude
واجب الادا	due
امہ کہ وجہ سۭتۍ	due to
دمٲغی	dull
گونٛب	dumb
ڈمپ	dump
دورانیہ	duration
دوران	during
دھول	dust
ڈیوٹی	duty
ڈول	dwell
مران چھ	dying
پرٛٮ۪تھ کانٛہہ	each
اکھ اکس خٲطرٕ	each other
حٲران	eager
عقاب	eagle
کان	ear
گۄڈے	earlier
جلدی	early
کماو	earn
کَن	ears
زمین	earth
زلزلہ	earthquake
آرام	ease
آسان	easily
مشرق کہ طرفہٕ	east
سہل	easy
کھٮ۪ن	eat
کھٮ۪وان	eating
معٲشی	economic
اکانومی	economy
کنارٕ	edge
ترمیم کر	edit
تدریس خصوصی	education
اثر	effect
اثر دار	effective
کارکردگی	efficiency
کارآمد	efficient
کوشش	effort
انڈٕ	egg
بینکن	eggplant
اگو	ego
ٲٹھ	eight
ارداہ	eighteen
شٮ۪تھ	eighty
یا تہ	either
تفصیل	elaborate
ہہہہہہہہہ	elbow
بوڑ	elder
بوڑٕ	elderly
شانٛدار	elegant
عنصر	element
ہاتھی	elephant
ژوٗرۍ	eleven
اہل	eligible
ہٹاو	eliminate
بیٚیہ	else
شرمسار	embarrassed
شرمناک	embarrassing
گلے لگاو	embrace
ابھرن	emerge
ایمرجنسی	emergency
جذبٲتی	emotional
ہمدردی	empathy
زور	emphasis
زور	emphasize
کارکنان	employee
کارکنان	employees
ملٲزم	employer
نوکریاں	employment
خالی	empty
چالو کر	enable
ملاقات	encounter
حوصلہٕ افضٲیی	encourage
ٲخٕری	end
خطرس منز	endangered
کوشش کر	endeavor
تحمل برداشت	endurance
برداشت کر	endure
دشمن	enemy
توانٲئی محفوظ	energy
شٲمل کر	engage
مصروف	engaged
منگنی	engagement
انجن	engine
انجینئر چھ	engineer
انگریز	English
بڑاو	enhance
مزٕ کر	enjoy
بجہ	enormous
کٲفی	enough
یقینی بناو	ensure
دٲخل کر	enter
تفریح	entertainment
جوش	enthusiasm
پرجوش	enthusiastic
پوٗرٕ	entire
عموٗمن	entitled
ہستی	entity
اژھو اندر اژنچ جاے	entrance
کارٕبٲرۍ	entrepreneur
لفافہ	envelope
بہتری	environment
شرارت	envy
مہاکاوی	epic
مہاماری	epidemic
برابر	equal
سازوسامان	equipment
اکویٹی	equity
مساوی	equivalent
ایراسر	eraser
غلطی	error
ژلن	escape
خاص طور پٲٹھۍ	especially
تجربہٕ	essay
معموٗل	essence
ضروری	essential
قٲیم کر	establish
قٲئم کر	established
جائیداد	estate
تخمینہ	estimate
اندازٕ	estimated
وغیرہ	etc
ابدی	eternal
اخلاقیات	ethics
اندازٕ لگاو	evaluate
تشخیص	evaluation
یوتتھ تام ز	even
حالانٛکہ	even though
شام	evening
واقعہٕ	event
ٲخر کار	eventually
زانٛہہ تہ	ever
پرٛٮ۪تھ کانٛہہ	every
پرٛٮ۪تھ کانٛہہ	everybody
پرٛٮ۪تھ کانٛہہ	everyone
تمام چیز	everything
ثبوت	evidence
شر	evil
ارتقاء	evolution
ارتقا	evolve
گب	Ewe
سابقہ	ex
صحیح	exact
بالکل	exactly
امتحان	exam
جٲیزٕ	examine
مثال	example
زیادٕ	exceed
بہت خوب	excellent
بجز	except
مستثنی	exception
اضٲفی	excess
حد کھوتہٕ زیادٕ	excessive
تبادلہٕ	exchange
پرجوش	excited
جوش	excitement
پرجوش	exciting
خصوصی	exclusive
معاف کر	excuse
معاف کر	excuse me
چلاو	execute
ادایگی	execution
ایگزیکٹو	executive
ورزش	exercise
تھکُن	exhaust
تھکاوٹ	exhausted
نمٲئش	exhibit
نمٲئش	exhibition
موجود	exist
وجود	existence
موجودٕ	existing
نٮ۪بر	exit
بڑاو	expand
توقع	expect
توقعات	expected
اخراجات	expenses
قۭمتی	expensive
تجربہٕ	experience
تجربہٕ	experiment
تجربہٕ کار	expert
میعاد ختم	expired
وضاحت کر	explain
وضاحت	explanation
استحصال کرن	exploit
ژھار	explore
برآمدات	export
افشا کر	expose
ہاونہٕ آمت	exposed
نمائش	exposure
ایکسپریس	express
اظہار	expression
بڑاو	extend
بڑھوو	extended
ایکسٹینشن	extension
حدٕ	extent
بیرونی	external
معدوم	extinct
اضٲفی	extra
کڑن	extract
غیر معمولی	extraordinary
انتہٲئی	extreme
انتہٲئی	extremely
ٲچھ	eye
ٲچھ	eyes
کپڑا	fabric
شاندار	fabulous
مو٘کھ	face
سہولت فراہم کر	facilitate
سہولیات	facilities
سہولت	facility
حقیقت	fact
فیکٹر	factor
فیکٹری	factory
حقائق	facts
چکراو	fade
ناکام	fail
ناکام	failed
ناکٲمی	failure
دمٲغی	faint
معموٗلی	fair
معموٗلی	fairly
پری	fairy
عقیدٕ	faith
وفادار	faithful
فرضی	fake
ژلن	fall
وٮ۪س پٮ۪ون	fall
فایل	FALSE
شہرت	fame
واقف	familiar
خاندان	family
قحط	famine
مشہور	famous
فین	fan
فینسی	fancy
شاندار	fantastic
دور	far
الوداع	farewell
فارم	farm
کاشتکار	farmer
دلچسپ	fascinating
فیشن	fashion
تیز	fast
چربی	fat
مہلک	fatal
قسمت	fate
مٲلۍ	father
تھکاوٹ	fatigue
غلطی	fault
پسندیدٕ	favorite
فیور	favour
پسندیدٕ	favourite
خوف	fear
ضیافت	feast
پنکھ	feather
خصوصیت	feature
خصوصیات	features
فروری	february
تھکاوٹ	fed up
فیس	fee
کھٮ۪ن	feed
فیڈ بیک	feedback
محسوس کر	feel
احساس	feeling
پاٹھۍ	feet
درٛاو	fell
سٲتھی	fellow
آو محسوس کرنہٕ	felt
زنانہٕ	female
فنہ تعمیٖرات	fence
زرخیزی	fertile
تہوار	festival
حٲصل کر	fetch
بخار	fever
کینٛہہ	few
کم	fewer
منگیتر	fiance
فکشن	fiction
مٲدان	field
سخت	fierce
پنٛدہ	fifteen
پنژاہ	fifty
لڑو	fight
لڑایہ	fighting
فگر	figure
ژھانٛڑو	figure out
فایل	file
بھرتھ	fill
بھرتھ	filled
فلم	film
گندھک	filthy
ٲخر کار	finally
مالیات	finance
مٲلی	financial
ژھار	find
ژھانٛڑو	find out
ٹھیک چھ	fine
اُنگج	finger
ٲخٕری	finish
ختم کرکھ	finished
نار	fire
فرم	firm
گۄڈے	first
اصلی ناو	first name
گاڈٕ	fish
فٹ	fit
پانژھ	five
ٹھیک کر	fix
فکسڈ	fixed
جھنڈٕ	flag
فلیش	flash
فلیٹ	flat
غلطی	flaw
بے عیب	flawless
ژلن	flee
ژاس	flesh
اڑان	flew
فلیکس	flex
لچکدار	flexible
پرواز	flight
پلٹاو	flip
فلرٹ	flirt
چھیڑ چھاڑ	flirting
فلوٹ	float
سیلاب	flood
فرش	floor
آٹا	flour
بہاؤ	flow
پوش	flower
فلو	flu
چاپلوسی	fluent
چاپلوسی	fluently
فلفی	fluffy
فلیوڈ	fluid
اڑان	fly
توجہ مرکوز	focus
وُنل	fog
دھند	foggy
تہہ کر	fold
لوک	folks
پلے کر	follow
فالو اپ کر	follow up
امہ پتہٕ	following
کھٮ۪ن	food
بے وقوف	fool
بے وقوف	foolish
پاٹھ	foot
فٹ بال	football
باپتھ	for
مثلا	For example
مثالہٕ پٲٹھۍ	for instance
تۄہہ باپتھ	for you
ممنوع	forbidden
طاقت	force
پیشن گویی	forecast
کھوپٕر	forehead
ڈیک	forehead
غٲر ملکی	foreign
جنگل	forest
ہمیشہٕ خٲطرٕ	forever
بھولیو	forget
معاف کر	forgive
بھولیو مت	forgot
فورک	fork
فارم	form
رسمی	formal
پرٲنۍ	former
خوش قسمتی سان	fortunately
بدقسمت	fortune
ژتجی	forty
دٮ۪تآچی	forty-two
برٛونٛہہ کن	forward
پھراو	foster
لڑایہ	fought
ملٮ۪وٚو	found
فاؤنڈیشن	foundation
ژور	four
ژوٛدہ	fourteen
فاکس	fox
کمزور	fragile
فریم	frame
فریم ورک	framework
فراڈ	fraud
پریک	freak
مفت	free
آزادی	freedom
فریز	freeze
تعدد	frequency
اکثر	frequent
اکثر	frequently
نوٚو	fresh
جمعہ دۄہ	friday
فریج	fridge
دوست	friend
دوستانہٕ	friendly
دوستین	friends
دوستی	friendship
خوفزدہ	frightened
خوفزدہ	frightening
مینڈک	frog
پیٹھہٕ	from
برٛونٛہہ کن	front
فریزر	frozen
پھل	fruit
ناراضگی	frustrated
ایندھن	fuel
مکمل طور پر	Fulfulde
پوٗرٕ	full
مزٕ	fun
فنکشن	function
بنیادی	fundamental
آخری رسومات	funeral
مزٕ دار	funny
سورٕ	fur
غصہٕ دار	furious
فنہ تعمیٖرات	furniture
امہ علاوٕ	further
امہ علاوٕ	furthermore
مستقبل	future
نفع	gain
گیم	game
فرق	gap
گیراج	garage
کچھر	garbage
باغ	garden
لہسن	garlic
دروازٕ	gate
جمع کر	gather
جمح کرن	gathering
گیج	gauge
دیوٗت	gave
گیٔر	gear
جنسہٕ	gender
جنرل	general
عام طور پر	generally
بناو	generate
جنریشن	generation
فراخ دل	generous
جینیئس	genius
جینر	genre
نرم	gentle
اصلی	genuine
حرکتہٕ	gesture
حٲصل کر	get
پلو لٮ۪گٮ۪و	get dressed
وٮ۪تھٮ۪و	get up
جلدی ٹھیک گژھ	get well soon
ملٮ۪وٚو	getting
بھوت	ghost
گھوسٹنگ	ghosting
بوڈ	giant
تحفہٕ	gift
ادرک	ginger
کور	girl
گرل فرینڈ	girlfriend
دیو	give
ترٛاو	give up
دنہٕ آمت	given
خوش	glad
نظرٕ	glance
گلاس	glass
شیشہٕ	glasses
جھلک	glimpse
عالمگیریت	global
دمٲغی	gloomy
دستانٕ	gloves
چمک	glow
چمکاو	glow up
گوند	glue
گژھ	go
برٛۄنٛہہ گژھ	go ahead
چلاو دور	go away
بسترس پٮ۪ٹھ گژھ	go to bed
مقصد	goal
اہداف	goals
گوٹھ	goat
بھگوان	god
خدا کرنۓ رحم	god bless you
گژھان چھ	goes
گژھان چھ	going
یوان	going to
سونہٕ	gold
چلاو	gone
کرٗن	gonna
گو	goo
اصل	good
گڈ افٹر نون	good afternoon
الوداع	good bye
اصل دۄہ	good day
گڈ نائٹ	good evening
اصل کٲم	good job
اصل نظر	good looking
خوش قسمت	good luck
گُڈ مارننگ	good morning
صُبح بخٮ۪ر	good morning
گڈ مارننگ ماے لو	good morning my love
گڈ نائٹ	good night
الوداع	goodbye
گڈ نائٹ	goodnight
سامان	goods
گوگل	Google
گوگل ترجمہٕ	Google Translate
گوس	goose
خوبرو	gorgeous
چیخ چیخ	gossip
ملٮ۪وٚو	got
ملٮ۪وٚو	got it
حکومت	government
پکڑو	grab
درجہٕ بندی	grade
بتدریج	gradually
گریجویٹ	graduate
دانہ	grain
گرانٹ	grant
عطا کرکھ	granted
ادرک	grapes
سمجنہٕ	grasp
گھاس	grass
شکر گزار	grateful
تشکر زیاد	gratitude
قبر	grave
گرے	gray
زبردست	great
شرارت	greed
لالچی	greedy
سبز رنگ	green
سلام	greet
سلام	greeting
سلام	greetings
گرے	grey
گرڈ	grid
غم	grief
کریو پیسو	grind
گرپ	grip
گروسری	grocery
دولہا	groom
ہچکچاو	gross
مٲدان	ground
گروپ	group
بڑھو	grow
بڑھو	growth
کرومبی	grumpy
گوارانی	Guarani
گارنٹی	guarantee
گارڈ	guard
اندازٕ لگاو	guess
مہمان	guest
ہدایت	guidance
گائیڈ	guide
مجرم	guilty
یار	guy
یاران	guys
جم	gym
عادت	habit
رہائش گاہ	habitat
اوس	had
ہیلہ	hail
مس	hair
نصف	half
ہال	hall
اتھہ	hand
ہینڈل	handle
خوبرو	handsome
ٹھٲرو	hang
ہینگ آوٹ	hang out
چھ گژھان	happen
گوٚو	happened
خوشی	happiness
خوش	happy
ہیپی برتھ ڈے	happy birthday
تۄہہ چھ برتھ ڈے مبارک	happy birthday to you
ہیپی نیو یئر	happy new year
سخت	hard
مشکل سان	hardly
بمشکل کنہ ساتہٕ	hardly ever
نقصان	harm
نقصان دہ	harmful
ہم آہنگی	harmony
سخت	harsh
فصلچ کٹائی	harvest
چھ	has
نفرتہٕ	hate
آسہٕ	have
اکھ اصل دۄہ	have a good day
اکھ اصل دۄہ	have a nice day
ناشتہ کر	have breakfast
مزٕ کر	have fun
کیٛاہ تۄہہ چھو کھٲومت	have you eaten
آسن	having
خطرٕ	hazard
چپات	haze
سہ	he
أمس چھ	he has
یہ چھ	he is
ہیڈ	head
سردرد	headache
شفا	heal
شفا یابی	healing
صحت	health
صحت مند	healthy
بوزن	hear
بوزن	heard
دل چھ	heart
گرمی	heat
آسمان	heaven
ہیور	heavy
حٲران	hectic
اونچٲئی	height
مٲلس ماجہٕ	heir
ہیسٹ	heist
منعقد کرنہٕ آمت	held
جہنم	hell
ہیلو	Hello
ہیلو مہربٲنی	hello dear
ہیلو ، ژٕ کیتھ چھ ؟	hello how are you
ہیلو ، توہہ کیتھ چھو	hello how are you doing
ہیلمٹ	helmet
مدد کر	help
مددگار	helpful
لحاذا	hence
تس	her
ریوڑ	herd
یتہٕ	here
وراثت	heritage
ہچکچاو	hesitate
ہیلو	Hey
ہیلو	Hi
ہیلو ، ژٕ کیتھ چھ ؟	hi how are you
ہیلو تتہٕ	Hi there
چھپاو	hidden
چھپاو	hide
ہائرارکی	hierarchy
اونچی	high
نمایاں کر	highlight
پیدل پکن	hike
پیدل سفر	hiking
مزٕ دار	hilarious
پہاڑ	hill
أمس	him
ہینڈ	hint
ہپ	hip
چھٹھ	hips
کرایہ	hire
کرایہ دٲری	hiring
تمہ سند	his
تٲریخ	history
ہٹ	hit
اممم	Hmm
شوق	hobby
تھٲیو	hold
ٹھہرو	hold on
کھوکھلہٕ	hole
چھٹی	holiday
کھوکھلہٕ	hollow
گرٕ	home
ہوم ورک	homework
ایماندار	honest
دیانت سان	honestly
مہربٲنی	Honey
عزت	honor
ہوڈ	hood
ہک	hook
ہاپ	hop
امیدٕ	hope
آسہٕ	hopefully
نا امید	hopeless
افقی	horizontal
ہارن	horn
خوفناک	horrible
خوفناک	horror
گرٕ	horse
ہسپتال	hospital
مہمان نواز	hospitality
میزبان	host
دشمن	hostile
گرم	hot
ہوٹٕل	hotel
گھنٹہٕ	hour
گھنٹہٕ	hours
گھر	house
گھرٕ	household
کتھ کٔنہ چھ	how
تۄہہ کیٛاہ چھ	how about you
ژۭ چُکھ ٹھٮ۪ک؟	how are you
ژٕ کیٛاہ چُکھ کران	how are you doing
از کیتھ چھو توہہ ؟	how are you doing today
از کیتھ چھو ژٕ ؟	how are you today
ژٕ کتھ کٔنہ چھی پٮ۪ۍ	how do you do
کیتھ چھ ؟	how is
کۭتیہ چھ	how many
کۭتیہ چھ	how much
کۭتیہ چھ یوان	how often
توہہ کۭتیہ وہر چھو ؟	how old are you
تہنٛد دۄہ کیتھ اوس ؟	how was your day
تہنز راتھ کیتھ ٲس ؟	how was your night
وونہ گو٘	however
ہب	hub
خاندار	hubby
گلے لگاو	hug
بجہ	huge
انسان	human
معموٗلی	humble
مرطوب	humid
نمی	humidity
ہتھ	hundred
بھوکھ	hungry
شکار	hunt
ہریکین	hurricane
جلدی کر	hurry
جلدی کریو	hurry up
زخم	hurt
خانٛدار	husband
ہسٹل	hustle
کوٹھ	hut
حفظان صحت	hygiene
بہٕ	I
بہٕ چَۭھس	I am
بہٕ چھس ٹھیک	I am fine
بہٕ ہیٚکہٕ کٔرتھ	I can
بہٕ ہیٚکہٕ نہٕ یہ کٔرتھ	I can't
بہٕ چھس کَران	I do
مہ چھن پائی	I do not know
سمجھہ نہٕ آمژٕ	I do not understand
بہٕ ہیٚکہٕ نہٕ یہ کٔرتھ	I don't
مٮے چھنٕہ پتٕہ	I don't know
سمجھہ نہٕ آمژٕ	I don't understand
بہٕ چھس نہٕ سمجان ز تہنٛد مطلب کیا چھ	I don't understand what you mean
مےٚ اوس نہٕ زانٛہہ سوٗنٛچمت	I don't understand you
مہ چھون پاے	I don’t know
سمجھہ نہٕ آمژٕ	I don’t understand
بہٕ چھس سونٛچان	i guess
مےٚ اوس	I had
مےٚ چھ	I have
بہٕ آسہٕ	I have been
بہٕ چھس امید کران ز	I hope so
مےٚ چھ خبر	I know
مےٚ چھ پسند	I like
بہٕ چھس یژھان تۄہہ پسند کران	I like you
مے چھ محبت	I love
بہٕ چھس پننس بڑس بٲیس سۭتۍ محبت کران	I love my big brother
مےٚ چھےٚ پنٛنہ بٔڑ بینہ سۭتۍ محبت	I love my big sister
بہٕ چھس پننس مٲلس سۭتۍ محبت کران	I love my father
بہٕ چھس پننس لۄکٹس بٲیس پیار کران	I love my little brother
بہٕ چھس پننس لۄکٹس بینس پیار کران	I love my little sister
بہٕ چَۭھس پَنٛنہِ مَاجہِ سۭتۍ محبت کَران	I love my mother
بٮے چُھسٮٮۍ ژٕ محبت کران مہ چٌھ چون موحبت	I love you
جاننننننننننن	I love you so much
بہ تہ چھسی ژی محبت کران	I love you too
بہٕ چھس مطلب	I mean
بہٕ چھس تۄہہ مس کران	I miss you
بہٕ چھس تۄہہ واریاہ یاد کران	I miss you so much
بہٕ چھس ؤچھان	I see
بہٕ چھس سونٛچان	I think
بہٕ چھس سمجان	I understand
بہٕ چھس یژھان	I want
بہٕ چھس یژھان تۄہہ وچھنہٕ	I want to see you
بہٕ چھس یژھان ژٕ	I want you
اوس بہٕ	I was
بہٕ گژھہٕ	I will
بہٕ آسہا	I would be
بہٕ چَھس	I'm
بہٕ چھس ٹھیک	I'm fine
بہٕ چھس اصل	I'm good
بہٕ چَۭھس یٔیتٛۍ	I'm here
بہٕ چھس افسوس کران	I'm sorry
آیسک	ice
آئس کریم	ice cream
خیال	idea
آئیڈیل	ideal
یکساں	identical
شناخت کر	identify
شناخت	identity
بے وقوف	idiot
بیکار	idle
اگر	if
نظر انداز کر	ignore
بیمار	ill
غٲر قونوٗنی	illegal
بیمار	illness
ایلوکانو	Ilocano
تصویرٕ	image
تصور کریو	imagine
فورا	immediate
فورا	immediately
بڑٕ	immense
اثر	impact
بے صبری	impatient
لاگو کر	implement
امپورٹ	import
اہم	important
لگاو	impose
ناممکن	impossible
متٲثر کرن	impress
تاثرات	impression
متاثر کن	impressive
بہتر بناو	improve
بہتری	improvement
اتھ منز	in
امہ علاوٕ	in addition
در حقیقت	In fact
برونٹھ	in front of
اتھ خٲطرٕہ	in order to
نامناسب	inappropriate
ترغیب	incentive
واقعہٕ	incident
شٲمل	include
یمن منز زن	including
آمدٲنی	income
تکلیف	inconvenience
بڑاو	increase
بڈھاوُن	increased
ناقابل یقین	incredible
حٔقیقت	indeed
آزاد	independent
ہندوستان	India
ظٲہر کر	indicate
مقٲمی	indigenous
انفرادی	individual
صنعت	industry
ناگزیر	inevitable
بچہٕ	infant
انفیکشن	infection
لامحدود	infinity
سوجن	inflammation
ورم	inflammation
افراط زر	inflation
اثر و رسوخ	influence
اطلاع دیو	inform
معلومات	information
اجزاء	ingredients
وراثت	inheritance
ابتدٲئی	initial
پہل	initiative
زخمی	injured
زخم	injury
بے قصور	innocent
اختراعات	innovation
جٲیزٕ	inquiry
پاگل پن	insane
کیٚمۍ	insect
غیر محفوظ	insecure
دٲخل کر	insert
اندٕ اندٕ	inside
تفہیم	insight
اصرار	insist
انسومنیا	insomnia
ترغیب	inspiration
متٲثر کرن	inspire
انسٹال کر	install
مثالہٕ	instance
فوری	instant
امہ بجایہ	instead
امہ بجایہ	instead of
ہدایت	instructions
سازوسامان	instrument
بے عزتی	insult
انشورنس	insurance
غیر محفوظ	intact
عموٗلیت	integrity
فکری	intellectual
ذہانت	intelligence
ذہین	intelligent
ارادٕ	intend
ارادٕ	intended
شدید	intense
ارادٕ	intention
رٲبطہٕ	interact
تعامل	interaction
دلچسپی	interest
دلچسپی	interested
دلچسپ	interesting
مداخلت کر	interfere
انٹرمیڈیٹ	intermediate
اندرونی حصص	internal
بین الاقوٲمی	international
انٹرن شپ	internship
تشریح کر	interpret
ترجمہٕ کار	interpreter
رکاو	interrupt
انٹرویو	interview
نزدیکی	intimate
اتھ منز	into
تعارف	introduce
تعارف	introduction
انٹروورٹ	introvert
وجدان	intuition
ناکارٕہ	invalid
ایجاد کر	invent
انوینٹری	inventory
سرمایہ کٲری کر	invest
تحقیق کر	investigate
مشٲہدٕ	invitation
مدعو کر	invite
انوائس	invoice
شٲمل کر	involve
شٲمل	involved
آیٔرن	iron
چھ	is
جزیرٕ	island
الگ تھلگ	isolated
مسلہٕ	issue
مسٲئل	issues
یہ	it
یہ چھ	it is
اوس یہ	it was
یہ چھ	it's
یہ چھ ٹھیک	it's ok
یہ چھ ٹھیک	It's okay
چیز	item
اشیاء	items
امکہ	its
بہٕ چَھس	I’m
جیکٹ	jacket
جیل	jail
جنوری	January
جوار	jar
دنٛدِ ووٹ	jaw
شرارت	jealous
کرک	jerk
زیورات	jewelry
کٲم	job
جاگنگ	jogging
شٲمل گژھن	join
مشترکہٕ	joint
جوک	joke
صحافی	journalist
سفر	journey
خوشی	joy
جج	judge
رس	juice
جولائی	july
جمپ	jump
جون	june
جنک	junk
صرف	just
بس کر یہ	just do it
انصاف	justice
جواز پیش کرن	justify
کالایلسوٹ	Kalaallisut
کشمیری	Kashmiri
خوشۍ	keen
تھوو	keep
یہ تھٲیو تھوو تھوو	keep it up
تھاونہٕ آمت	kept
کیٹل	kettle
چابی	key
کک	kick
شُر	kid
مزٕ کران	kidding
گردٕ	kidney
بچہٕ	kids
مارنہٕ	kill
قٕسم	kind
کینڈا	kinda
مہربٲنی سان	kindly
رحمدلی	kindness
بادشاہ	king
بوسہ	kiss
کچن	kitchen
پتنگ	kite
بٮ۪ار بچہٕ	kitten
کوٹھۍ	knee
جان ٲس	knew
چھری	knife
نائٹ	knight
جان	know
علم	knowledge
زاننہٕ چھ یوان	known
کونکنی	Konkani
کریو	Krio
لیبل	label
کٲم	labor
لیبر	labour
کمی	lack
لیڑٕ	ladder
زنانہ	lady
تراوکھ	laid
جھیل	lake
لمبٕ	lamb
لنگہٕ	lame
لیمپ	lamp
زمین	land
زمینک تزئین	landscape
زبان زبان	language
کوٹھ	lap
بجہ	large
ٲخٕری	last
ٲخٕری مگر کم کھوتہٕ کم	last but not least
ٲخری ناو چھ	last name
ژیر	late
حال حالٕے	lately
پتہٕ	later
ٲخٕری	latest
مؤخر الذکر	latter
ہنس	laugh
ہنسان	laughing
ہنس	laughter
لانچ کر	launch
لانڈری	laundry
زٕ	law
لارن	lawn
وکیل	lawyer
لاے	lay
تہہ	layer
ترتیب	layout
سست	lazy
لیڈ	lead
رہنما	leader
پتہٕ	leaf
لٮ۪کھ	leak
زیٹھ	lean
چھلانگ	leap
ہیٚچھو	learn
ہیچھان	learning
کرایہ	lease
کم از کم	least
چمچہ	leather
تر٘او	leave
پتے	leaves
لیڈ	led
دٔچھنہ	left
ٹانگ	leg
میراث	legacy
قونوٗنی	legal
لیجنڈ	legend
قانونی	legit
فرصت	leisure
ادھار	lend
زیچھر	length
کم	less
سبق	lesson
چٕھ	let
لیٹر	letter
لیٹوس	lettuce
سطح	level
لیوریج	leverage
ذمہٕ دٲری	liability
کتب خانہٕ	library
چاٹ	lick
جھوٹھ	lie
جھوٹھ	lies
زندگی	life
لفٹ	lift
روشنی	light
بجلی	lightning
یتھ کٔنۍ	like
امکان چھ	likely
اتھۍ پٲٹھۍ	likewise
لٲنہ	line
لنگالا	Lingala
ربط	link
شیر	lion
مائع	liquid
فہرست	list
بوزن	listen
بوزن	listening
لفظی طور پر	literally
ادبیات	literature
لیٹر	litter
لٹل	little
زندٕ	live
لور	liver
زندگی	lives
زندٕ	living
روزنک کمرہ	living room
چھپکلۍ	lizard
لوڈ کر	load
ژوٹ	loaf
قرضہ	loan
مقٲمی	local
مقام	location
لاک	lock
لاک ڈاؤن	lockdown
لاگ	log
لول	lol
اکیلا	lonely
زیٹھ	long
واریاہ کال چھنہٕ وچھنہٕ آمت	long time no see
وچھیو	look
لوپ	loop
ڈھیلا	loose
مٮ۪لک	lord
ہارنہٕ	lose
نقصان	loss
ہارنہٕ آمٕژ	lost
واریاہ	lot
زور	loud
لاؤنج	lounge
محبت	love
مےٚ چُھ چۄن لۄ ل(محبت)	love you
مہربٲنی	lovely
کم	low
کم کر	lower
وفادار	loyal
وفادار	loyalty
قسمت	luck
خوش قسمت	lucky
لوگنڈا	Luganda
سامان	luggage
گانٹھ	lump
لنچ	lunch
شوش	lungs
لگژری	luxury
جھوٹ بوزن	lying
مشین	machine
پاگل	mad
میڈم	madam
بنٲوۍ	made
میگزین	magazine
شاندار	magnificent
نوکرانی	maid
اہم	main
برقرار تھونہٕ	maintain
دیکھ بھال	maintenance
میتھلی	Maithili
میجر	major
اکثریت	majority
بناو	make
بناو	make up
مرد	male
مال	mall
انسان	man
انتظام کر	manage
انتظام	management
منیجر	manager
ضروری	mandatory
ظٔہر کر	manifest
جوڑ توڑ کر	manipulate
طریقہٕ	manner
دستی	manual
واریاہ	many
دۄہہ ہنٛد واریاہ زیادٕ خوشگوار واپسی	many many happy returns of the day
مارچ	march
مارجن	margin
بازر	market
ازدواجیہ	marriage
خانٛدر کٔرتھ	married
ماسک	mask
ماس	mass
بٔڑس پیمانس پٮ۪ٹھ	massive
ماسٹر	master
میچ	match
یار	mate
مواد	material
ریاضی	math
چیز	matter
پختگی	maturity
ہیکہ ٲستۍ	may
شاید	maybe
مے	me
مےٚ تہ	me too
کھٮ۪ن	meal
مطلب	mean
معنی	meaning
مطلب چھ	means
مطلب	meant
اتھ دوران	meanwhile
پیمٲیش	measure
اقدامات	measures
مرغی	meat
طبی	medical
دوا	medicine
مراقبہ	meditation
میڈیم	medium
ملن	meet
میٹنگ	meeting
مایتیلاون	Meiteilon
پلن	melt
یادداشتہٕ	memories
یاد داشت	memory
ذہنی	mental
ذکر کر	mention
ذکر کرنہٕ آمت	mentioned
سرپرست	mentor
سوداگر	merchant
رحم کر	mercy
صرف	merely
میری کرسمس	merry christmas
میس	mess
میسج	message
میزی	messy
دھات	metal
طریقہٕ	method
ماؤس	mice
وسط	middle
آدھی رات	midnight
ہیکہ گژھتھ	might
ہلکہٕ	mild
سنگ میل	milestone
فوٗجی	military
دودھ پلاو	milk
دہ لچھ	million
ذہن	mind
ذہنیت	mindset
میٲنۍ	mine
منگلا	mingle
نابالغ	minor
منٹ	minute
منٹ	minutes
معجزات	miracle
شیشہ	mirror
متفرق	miscellaneous
شرارتی	mischievous
دکھی	miserable
شرارت	misery
مس	miss
تۄہہ چھوٕ یاد یوان	miss you
لاپتہ	missing
مشن	mission
دھند	mist
غلطی	mistake
میزو	Mizo
موبل	mobile
موک	mock
ماڈل	model
اعتدال پسند	moderate
ماڈرن	modern
معموٗلی	modest
مرطوب	moist
نمی	moisture
مولڈ	mold
مول	mole
ماما	mom
مومنٹ	moment
سوموار	monday
پونٛسہٕ	money
نگرٲنی کر	monitor
مرغی	monkey
رٮ۪تہٕ	month
موڈ	mood
موڈی	moody
زوون	moon
مورکل	moral
زیادٕ	more
امہ علاوٕ	moreover
صبح	morning
گروی رکھ	mortgage
زیٛادٕ تر	most
زیادٕ تر	mostly
ماما	mother
حرکت	motion
محرکات	motivation
پہاڑ	mountain
ماؤس	mouse
بوتھ	mouth
چلاو	move
نقل و حرکت	movement
فلم	movie
مس	mrs
واریاہ	much
مڈ	mud
مگن	mug
مژھ	muscle
میوزیم	museum
ہٮ۪ڈر	mushroom
مشروم	mushroom
موسیقی	music
پزنۍ	must
خاموش کر	mute
بٲہمی	mutual
میٲنۍ	my
مہربٲنی	My dear
میٚون دوست	my friend
میٚٲنۍ ہوور کرافٹ چھ ایلن سۭتۍ بھرتھ	My hovercraft is full of eels
میٲنۍ محبت	my love
میٚون ناو چھ	my name is
میٲنۍ خوشی	my pleasure
بہٕ چھس پانۍ	myself
رازدارانہ	mysterious
راز	mystery
فرضٮی داستان	myth
کیل	nail
بے حیائی	naive
ناو	name
بیانیہ	narrative
تنگ	narrow
بدصورت	nasty
قومی	national
قومیت	nationality
مقٲمی	native
بہٕ چھس یژھان	natural
فطرت	nature
دمٲغی	nausea
نزدیک	near
نزدیک	nearby
لگ بگ	nearly
صاف	neat
ضروری	necessary
گردن	neck
ہار ہار	necklace
ضرورت	need
منفی	negative
نظر انداز کرنا	neglect
کتھ باتھ	negotiate
ہمسایہ	neighbor
ہمسایہٕ	neighborhood
نہ تہ	neither
بٲیس	nephew
نیرڈ	nerd
نروس	nervous
نیسٹ	nest
نیٹ	net
نیٹ ورک	network
غیر جانبدار	neutral
زانٛہہ تہ	never
زانٛہہ تھٲیو مت	never give up
کانٛہہ تہ خیال	never mind
چھنہٕ کران	nevermind
تاہم	nevertheless
نوٚو	new
خبرٕ	news
پتہٕ	next
امہ پتہٕ	next to
اچھ	nice
تۄہہ ملتھ گوٚو خوشی	nice to meet you
نننننن	niece
راتھ	night
ڈراؤنا خواب	nightmare
نو	nine
کنوہ	nineteen
نمت	ninety
نہ	No
کانٛہہ مسلہٕ	no problem
کانٛہہ طریقہٕ	no way
کانٛہہ تہ نہٕ	nobody
شور	noise
شور	noisy
کانٛہہ تہ نہٕ	none
دپہر	noon
ناے	nope
نہ تہ	nor
نارمل	normal
شمال مشرق	north
ناکہٕ	nose
نوسٹالجک	nostalgic
نہٕ	not
بالکل نہ	not at all
خراب چھنہٕ	not bad
وینکینس چھنہٕ	Not now
وونہ گو٘	not yet
نوٹ	note
نوٹ کرکھ	noted
کانٛہہ تہ نہٕ	nothing
اطلاع	notice
مشٲہدٕ	noticed
اسم ناو	noun
ناو	nouns
ناول	novel
نومبر	november
وۄنۍ	now
از کل	nowadays
پریشان کن	nuisance
نلہ	null
ننن	numb
نمبر	number
نرسیں	nurse
نٹ	nut
نٹمیگ	nutmeg
غذائیت	nutrition
حلف	oath
موٹاپا	obesity
اطاعت کر	obey
چیز	object
مقصد	objective
ذمہٕ دٲری	obligation
غٲر واضح	obscure
مشٲہدٕ	observation
مشٲہدٕ کر	observe
حٲران	obsessed
جنونی	obsession
معدوم	obsolete
رکاوٹ	obstacle
حٲصل کر	obtain
حٲصل کٔرۍ	obtained
واضح	obvious
واضح طور پٲٹھۍ	obviously
کنہ ساتہٕ	occasionally
پیشے	occupation
قبضہٕ	occupied
چھ گژھان	occur
گوٚو	occurred
چھ گژھان	occurs
سمندر	ocean
اکتوبر	october
عجیب	odd
اوڈس	odds
کس کس	of
بلکل	of course
بنٛد	off
اشتعال انگیز	offensive
پیشکش	offer
دفتر	office
سرکٲری افسر	official
اکثر	often
اوہہ	Oh
او واقعی	oh really
تیل	oil
اوکے	ok
اوکے مہربٲنی	ok dear
اوکے مایہ	ok honey
اوکے میٲنۍ محبت	ok my love
ٹھیک چھ	okay
اوکے بیبی	okay baby
ٹھیک چھ مہربٲنی	okay dear
اوکے مایہ	okay honey
ٹھٮ۪ک چھو زُوا	okay my love
پرٛانہ	old
اتھ پیٹھ	on
اکہ لٹہ	once
اکھ	one
اکھ زبان چھ نہٕ کٲفی کینٛہہ	one language is never enough
پیاز	onion
آن لائن	online
صرف	only
کھول	open
آپریشن	operation
رائے	opinion
مواقع	opportunities
موقعہ	opportunity
برعکس	opposite
پرامید	optimistic
انتخاب	option
اختیاری	optional
یا	or
نارنجی	orange
آرڈر	order
ناقابل یقین	ordinary
تنظیم تنظیم	organization
سمت بندی	orientation
اصل	origin
اصلی	original
ارومو	Oromo
یتیم	orphan
باقی	other
بصورت دیگر	otherwise
آسن	ought
اسہ	our
سٲنۍ مشن: پرٛٮ۪تھ کٲنٛسہ ، پرٛٮ۪تھ جایہ دنیا سمجنس تہٕ زبانن منٛز پنن اظہار کرنس قٲبل بناون	Our mission: to enable everyone, everywhere to understand the world and express themselves across languages.
سانہ مشن چھ دنیاہچ معلومات منظم کرٕن تہٕ اتھ عالمی سطحس پیٹھ دستیاب تہٕ کارآمد بناون	Our mission: to organize the world's information and make it universally accessible and useful.
نیبرٕ	out
نتیجہٕ	outcome
پوشاک	outfit
نٮ۪بر گژھان	outgoing
آؤٹ لیٹ	outlet
خاکہ	outline
نیبرم	outside
نمایاں	outstanding
اوون	oven
اتھ پٮ۪ٹھ	over
اتھہ پیٹھ	over there
مجموعی طور پر	overall
قابو کٔرن	overcome
حدٕ کھوتہٕ زیادٕ سوچ	overthinking
مغلوب	overwhelmed
زبردست	overwhelming
واجب الادا	owe
اوول	owl
پنن پان	own
مٲلکہٕ	owner
داند	ox
رفتارٕ	pace
پیک	pack
پیکج	package
ادا	paid
دگ	pain
پینٹ	paint
پینٹنگ	painting
جورٕ	pair
پایہ رنگ	pale
پام	palm
پین	pan
پانڈیمک	pandemic
گھبراو	panic
پینٹ	pants
کاغذ	paper
جنت	paradise
متوازی	parallel
پارسل	parcel
معاف کر	pardon
مٲلس ماجہٕ	parents
پارک	park
طوطا	parrot
مرسیدس بنز	parsley
حصہٕ	part
شرکت کر	participate
خاص پٲٹھۍ	particular
خاص پٲٹھۍ	particularly
پارٹنر	partner
پارٹی	party
پاس کر	pass
گزرگاہ	passage
گزری	passed
شوق	passion
پرجوش	passionate
غیر فعال	passive
پاس ورڈ	password
پٔتمہ	past
پیچ	patch
وتھ	path
شرمناک	pathetic
تحمل	patience
مریضہ	patient
نمونہٕ	pattern
رک	pause
پاتھ پاتھ	pavement
پے کر	pay
ادایگی	payment
امن	peace
پر امن	peaceful
پیور	peach
پیک	peak
پایہ	pear
مٹر	peas
خاص	peculiar
ژھایہ	pee
ژول	peel
پیر	peer
پیئرز	peers
پین	pen
پینسل	pencil
زیر التوا	pending
لوک	people
کالی مرچ	pepper
سمجھن	perceive
تصورات	perception
کامل	perfect
اداکٲری کر	perform
کارکردگی	performance
شاید	perhaps
مدت	period
مستقل	permanent
اجازت	permission
اجازت نامہٕ	permit
تحمل	perseverance
مستقل	persistent
شخص	person
ذٲتی	personal
شخصیت	personality
نقطہ نظر	perspective
قائل کرنا	persuade
بدکردار	pervert
پاٹھ	pet
مرحلہٕ	phase
واقعہ	phenomenon
فلسفیانہٕ عمل	philosophy
فون	phone
فوٹو	photo
فقرہ	phrase
فزیکل	physical
چن	pick
پک اپ کر	pick up
تصویر	picture
ٹکرٕ	piece
ٹکڑٕ	pieces
سور	pig
کبوتر	pigeon
پیپل	pile
کھوپٕر	pillow
پائلٹ	pilot
پن	pin
وایرل	pineapple
گلابی رنگ	pink
پاٹھ	pit
پچ	pitch
افسوس	pity
جاے	place
جائے	places
پلےگ	plague
سادٕہ	plain
منصوبہٕ	plan
ہوٲئی جہاز	plane
کل	plant
پودٕ	plant
قؤل	plants
پودٕ	plants
پائیدار	plate
پلیٹ فارم	platform
پلے کر	play
گنٛدن	playing
مزٕ دار	pleasant
مہربٲنی کٔرتھ	please
خوش	pleased
مزیٖد	pleasure
وعدٕ	pledge
واریاہ	plenty
پلاٹ	plot
پلاگ	plug
پلم	plum
پلمبر	plumber
کثرت	plural
پوڈ کاسٹ	podcast
نظم	poem
شاعری	poetry
پوائنٹ	point
زہر	poison
پلیس	police
پالیسی	policy
شائستہ	polite
آلودگی	pollution
تالاب	pond
تالاب	pool
پوپ	poop
غریب	poor
پاپ	pop
مقبول	popular
آبٲدی	population
سورک سور	pork
چنہٕ چنہٕ	porridge
پورٹ	port
پوزیشن	position
پوزیٹیو	positive
ملکیت	possess
ملکیت	possession
ملکیت	possessive
ممکن	possible
پوسٹ	post
موخر کر	postpone
پوٹلو	potato
ممکن	potential
پاؤنڈ	pound
غربت	poverty
پاور	power
طاقتور	powerful
پریکٹیکل	practical
پریکٹس	practice
تعریفیں	praise
شرارت	prank
دعا کر	pray
قۭمتی	precious
عین مطابق	precise
بالکل ٹھیک	precisely
پیشن گویی	predict
ترجیٖح	prefer
ترجیٖح	preference
حاملہ	pregnant
تعصب	prejudice
احاطہ	premises
پریمیم	premium
تیار کرن	preparation
تیار کر	prepare
تیار	prepared
پریپوزیشن	preposition
موجودگی	presence
موجود	present
پیشکش	presentation
بچاو	preserve
صدر	president
پریس کر	press
دباو	pressure
دکھاوا کر	pretend
خوبرو	pretty
رکاو	prevent
پٔتمہ	previous
پرے	prey
قۭمت	price
فخریہ	pride
پادرین	priest
بنیٲدی	primary
پرٛایم	prime
راجکماری	princess
پرنسپل	principal
برٛونٛہہ کنہ	prior
ترجیحی	priority
جیل	prison
پرائیویسی	privacy
پرائیویٹ	private
استحقاق	privilege
انعام	prize
شاید	probably
مسلہ	problem
طریقہ کار	procedure
برٛۄنٛہہ پکۍ	proceed
عمل	process
پروڈکشن	produce
پروڈکٹ	product
پروڈکشن	production
پیشے	profession
پیشورانہٕ	professional
پروفائل	profile
نفع	profit
سرٛن	profound
پیش رفت	progress
پروجیکٹ	project
نمایاں	prominent
وعدٕ کر	promise
فروغ دین	promote
پروموشن	promotion
پرامپٹ	prompt
پراونٹ	prone
ضمٮ۪ر	pronouns
ترجمہٕ	pronunciation
ثبوت	proof
اصل	proper
اصل پٲٹھۍ	properly
خصوصیات	properties
ملکیت	property
تجاویز	proposal
امکان	prospect
خوشحالی	prosperity
خوشبٲنی	prosperous
بچاو	protect
فخر	proud
ثٲبت کر	prove
فراہم کر	provide
فراہم کردہ	provided
صوبہٕ	province
پروویژن	provision
بلوغت	puberty
عوٲمی	public
پل	pull
کبوتر کبوتر	pumpkin
وقتا فوقتا	punctual
شاگرد	pupil
خرید	purchase
خالص	pure
جامنی رنگ	purple
مقصد	purpose
پرس	purse
پیچھا کر	pursue
تعاقب	pursuit
پش کر	push
تھوو	put
اہلیت	qualification
کوالٹی	quality
مقدار	quantity
قرنطینہ	quarantine
لڑایہ	quarrel
ژوٗرم حصہٕ	quarter
کیوا کیوا	Quechua
ملکہ	queen
کویر	queer
سوال	query
سوال	question
لٲنہ	queue
جلدی	quick
جلدی	quickly
چپ	quiet
لٮ۪نف	quilt
بنٛد کر	quit
کٲفی	quite
کوئز	quiz
اقتباس	quotation
اقتباس	quote
تبصرٕ	quotes
خرگوش	rabbit
ریسہ	race
شرارت	rage
رود	rain
بڑاو	raise
بڑھوو	raised
بھگوان	ran
بے ترتیب	random
رینج	range
تیز	rapid
جلدی	rapidly
نایاب	rare
شاذ و نادر	rarely
ژاس	rash
راٹ	rat
شرح	rate
امہ بجایہ	rather
تناسب	ratio
عقلی	rational
راے	raw
ری	re
واتہ	reach
واتہ	reached
رد عمل	reaction
پڑھو	read
پرن	reading
تیار	ready
اصلی	real
حقیقت	reality
احساس	realize
احساس	realized
اصلس منز	really
پٔتمہ طرفہٕ	rear
وجہ	reason
معقول	reasonable
یاد کرن	recall
رسید	receipt
وصول کر	receive
موصول	received
حالٕے	recent
حالٕے	recently
استقبالیہ	reception
ریسیپی	recipe
آشیرواد	reckless
شناخت	recognition
پہچان	recognize
تجویز کریو	recommend
تجویز کردہ	recommended
رکارڈ	record
بازیافت	recover
بازیافت	recovery
مستطیل	rectangle
وزل	red
بچاو	redeem
چھٹکارا	redemption
کم کر	reduce
لاحاصل	redundant
ریفر کر	refer
حوالہ جات	reference
عکاس کر	reflect
عکاس	reflection
رٗکاو	refrain
ریفریجریٹر	refrigerator
واپسی	refund
انکار کر	refuse
انکار	refused
خیال	regard
متعلقہٕ	regarding
قطع نظر	regardless
احترام	regards
علاقہٕ	region
رجسٹر کر	register
افسوس	regret
باقٲعدٕ	regular
باقٲعدگی سان	regularly
رد کر	reject
متعلقہٕ	relate
متعلقہٕ	related
رٲبطہٕ	relationship
رشتہ دار	relative
رشتہ دار	relatives
آرام کر	relax
رہا کر	release
آو جٲری کرنہٕ	released
متعلقہٕ	relevant
بھروسہ مند	reliable
راحت	relief
آرام	relieve
آرام دہ	relieved
مذہب	religion
مذہبی	religious
ہچکچاہٹ	reluctant
بھروسہ کر	rely
روزٕ	remain
باقٕی	remaining
قابل ذکر	remarkable
علاج	remedy
یاد تھٲیو	remember
یاد کراو	remind
یاد دہانی	reminder
دور دراز	remote
ہٹاو	remove
پیش کر	render
کرایہ	rent
مرمت	repair
دہراو	repeat
بدلاو	replace
جواب دیو	reply
رپوٹ	report
نمایندگی	represent
شہرت	reputation
درخاست	request
ضرورت	require
ضرورت	required
بچاو	rescue
تحقیق	research
ہیوے	resemble
ناراضگی	resentment
ریزرویشن	reservation
ریزرو	reserve
بسکیٖن	resident
مستعفی گژھن	resign
لچکدار	resilience
لچکدار	resilient
مزاحمت کر	resist
مزاحمت	resistance
حل	resolution
حل کر	resolve
ریزورٹ	resort
وایسیل	resources
احترام	respect
جواب دیو	respond
جواب	response
ذمہٕ دٲری	responsibility
ذمہٕ دار	responsible
آرام کر	rest
آرام کریو امنس منز	rest in peace
ریسٹورانٹ	restaurant
بحال کر	restore
محدوٗد	restrict
نتیجہٕ	result
نتیجہٕ	results
کرکھ شروع	resume
خردہ فروش	retail
رٹن	retain
رکھن	retention
رٹایٔرٹ	retired
پتھ کھسن	retreat
بازیافت	retrieve
واپس	return
ظٲہر کر	reveal
ظٲہر کرکھ	revealed
بدلہ	revenge
آمدنی	revenue
ریورس	reverse
جٲیزٕ	review
نظر ثانی کر	revise
نظر ثانی	revision
انقلاب	revolution
انعام	reward
رتھ	rhythm
اٮ۪ڈج	rib
چاول	rice
امیر	rich
ہٹاو	rid
سوار	ride
مضحکہ خیز	ridiculous
دٔچھنہ	right
وینکینس	right now
سخت	rigid
رنٛگ	ring
کلۍ کٔٹۍ	rinse
ہنگامہ	riot
رپی	rip
پکۍ	ripe
بڑھو	rise
خطرٕ	risk
حریف	rival
ژاسہٕ	river
روڈ	road
روسٹ	roast
مضبوط	robust
کئن	rock
راک	rock
راڈ	rod
کردار	role
رول	roll
چھت	roof
کمرہ	room
روٹ	root
راگ	rope
سڈٮ۪مت	rotten
سخت	rough
تقریبا	roughly
راونڈ	round
وتھ	route
معموٗل	routine
لٲنہ	row
رگڑ	rub
ربڑ	rubber
کچھر	rubbish
بدکردار	rude
راگ	rug
تباہ کرن	ruin
اصول	rule
حکمران	ruler
قواعد	rules
چلاو	run
چلٲوتھ	running
دیہی علاقہٕ	rural
جلدی کر	rush
چوک	sack
مقدس	sacred
قربانی	sacrifice
محفوظ	safe
محفوظ پرواز	safe flight
حفاظت	safety
سیج	sage
وون	said
بحری جہاز	sail
جہاز رانی	sailing
باپتھ	sake
تنخواہ	salary
کٕنن	sale
سامن	salmon
نمکین	salt
ہیوے	same
یتہٕ تہ چھ یژھ	Same here
نمونہٕ	sample
سیٚکہ	sand
سنسکرت	Sanskrit
شرارتی	sarcastic
ساسی	sassy
سیٹ	sat
تسکین	satisfaction
مطمئن	satisfied
مطمئن کرن	satisfy
اطمینان بخش	satisfying
ہفتہٕ وار	Saturday
ساسیج	sausage
وحشی	savage
سیو کر	save
وچھ	saw
ونۍ	say
پیمانہٕ	scale
سکام	scam
داغ	scar
کم چھ	scarce
ڈراوان	scared
سکارف	scarf
ڈراوان	scary
بکھرنہٕ آمت	scattered
منظر	scene
منظر کشی	scenery
بوٕ	scent
شیڈول	schedule
سکول	school
سائنس	science
سائنس دان	scientist
ساینس دان	scientists
قینچی	scissors
رُوب	scold
سکوپ	scope
سکور	score
کڑن	scrap
خرگوش	scratch
چیخ	scream
سکرین	screen
سکرو	screw
سکرپٹ	script
سمندر	sea
مہرٕ	seal
ژھار	search
سیزن	season
نشٲنی	seat
دویم	second
راز	secret
سیکشن	section
محفوظ	secure
سیکیورٹی	security
وچھیو	see
توہہ وچھو	see you
پتہٕ وچھو	see you later
جلدی وچھو	see you soon
پلے ملو	see you tomorrow
بیج	seed
ژھار	seek
باسان چھ	seem
باسان چھ	seems
وچھتھ	seen
قبضہٕ کر	seize
ضبطی	seizure
شاذ و نادر	seldom
ژارنہٕ	select
پانہٕ	self
سیلف ہیلنگ	self healing
خو٘د خو٘د	selfish
کٕنن	sell
سوز	send
مےٚ سوز پنٕنۍ فوٹو	send me your picture
سینئر	senior
احساس	sense
سمجھدار	sensible
حساسیت	sensitive
سوز	sent
جملہٕ	sentence
جملہٕ	sentences
الگ الگ	separate
زیٹھۍ	Sepedi
ستمبر	september
ترتیب	sequence
سیریز	series
سخٕت	serious
سخٕت	seriously
خدمت کر	serve
خدمت	service
اجلاس	session
سیٹ کر	set
سیٹ اپ کر	set up
سیٹنگ	setting
طے کر	settle
ستھ	seven
سداہ	seventeen
ستتھ	seventy
واریاہ	several
شدید	severe
سلائی کر	sew
ش	sh
سایڈ	shade
سایہٕ	shadow
شیک کر	shake
کر	shall
کھوکھلہٕ	shallow
شرمسار	shame
شکل	shape
شییر	share
تیز	sharp
سۄ چھےٚ	she
أمس چھ	she has
سۄ چھےٚ	she is
پنڈال	shed
شٮ۪ڈ	shed
گاڑٕ	sheep
شیٹ	sheet
شیلف	shelf
شیل	shell
پناہ گاہ	shelter
ڈھال	shield
شفٹ	shift
چمک	shine
جہاز	ship
شپنگ	shipping
شرٹ	shirt
جوتے	shoes
شوٹ کر	shoot
دکان	shop
خریدٲری	shopping
سمنٛدری	shore
مختصر	short
کمی	shortage
شوٹ	shot
کرٕنہ	should
فٮُ۪ک	shoulder
راون	shout
ہاو	show
مےٚ ہاو	show me
شاور	shower
شیٚمپ	shrimp
ژٹتھ	shrink
بنٛد	shut
چپ تھوو	shut up
شرمسار	shy
بٲیس	sibling
بوے بوے	siblings
بیمار	sick
طرف	side
شاہ	sigh
نظرٕ	sight
سیر و سیاحت	sightseeing
نشان	sign
دستخط	signature
اہم	significant
ژھپ	silence
چپ	silent
سلک	silk
بے وقوف	silly
سلور	silver
یتھیہ	similar
سمپ	simp
سہل	simple
اکی وقتہٕ	simultaneously
امہ پیٹھہٕ	since
دیانتدار	sincere
جان سان	sincerely
گٮ۪ون	sing
گلوکارہ	singer
اکیلا	single
سنک	sink
سر	Sir
بینہ	sister
زام	sister in law
بیٹھیہ	sit
سایٹہ	site
حالت	situation
شیہہ	six
شراہ	sixteen
شیٹھ	sixty
سایز	size
ہنر	skill
ہنر	skills
چمچہ	skin
چکن چکن	skinny
سکیپ کر	skip
سکرٹ	skirt
آسمان	sky
غلام	slave
سونٛچھ	sleep
شگھت	sleeping
سونٛگہ	sleepy
نٕر	sleeve
سلائس	slice
سلائڈ	slide
ہلکہٕ	slightly
زیٹھ	slim
سلپ	slip
سلوپ	slope
سلاٹ	slot
سست	slow
وارٕ وار	slowly
لکٹہ	small
ہوشیار	smart
بوٕ	smell
مسکراو	smile
دوہ	smoke
ہموار	smooth
ناشتہ	snack
سنیل	snail
صرف	snake
سرٛپھ	snake
سنیپ	snap
شین	snow
یتھ کٔنۍ	so
تیوٗت مہربٲنی	so cute
تانہ تام	so far
وَزناوُن	soak
صابن	soap
سوبر	sober
فٹ بال	soccer
سمٲجی	social
سماج	society
موزے	socks
نرم	soft
سافٹ ویئر	software
میژ	soil
کٕنن	sold
کٕننہٕ آو	sold out
سپاہی	soldier
وٲحد	sole
سخٕت	solid
حل	solution
حل کر	solve
کینٛہہ	some
کٲنہہ	somebody
کنہ کنہ طریقہٕ	somehow
کٲنہہ	someone
کینٛہہ	something
کنہ ساتہٕ	sometimes
بٲتھ	song
جلدی	soon
نفیس	sophisticated
سورانی	Sorani
ژاس	sore
ژھایہ منٛز زخم	sore throat
غم	sorrow
افسوس	Sorry
قٕسم	sort
ژھانٛڑ	sought
روح چھ	soul
ساؤتھ میٹ	soulmate
آواز	sound
سوپ	soup
سورٕ	sour
ماخذ	source
جنوب مشرق	south
سپیس	space
سپیم	spam
سپان	span
ہسپانوی	Spanish
بچاو	spare
بوزن	speak
خاص	special
انواع چھ	species
مخصوص	specific
شاندار	spectacular
تقریر	speech
بے کلام	speechless
رفتار	speed
سپیل	spell
خرٕچ کر	spend
خرٕچ	spent
مسالے دار	spicy
سپیک	spike
سپن	spin
سپناچ	spinach
روح چھ	spirit
تھوٚتھ	spit
بہت خوب	splendid
تقسیٖم	split
خراب کرٕنہ	spoil
ژلنہٕ آمت	spoiled
اتپریرک	spontaneous
چمچہ	spoon
سپاٹ	spot
زوجہ	spouse
پھیلاو	spread
بہار	spring
مربع	square
ژٹتھ	squeeze
سکویڈ	squid
مرسیدس بنز	squirrel
سینٹ	st
شُر	stab
مستحکم	stable
سٹیک	stack
عملہ	staff
سٹیج	stage
سٹین	stain
ھرے	stairs
سٹاک	stake
سٹانک	stalk
سٹال	stall
ڈاک ٹکٹ	stamp
کھڑا	stand
معیار	standard
سٹار	star
شروٗع کر	start
شروع کر	started
فاقہ کشی	starving
ریاست	state
بیان	statement
سٹیشن	station
مجسمہٕ	statue
حالت	status
روزن	stay
محفوظ روزن	stay safe
مستحکم	steady
سٹیک	steak
چوری کر	steal
سٹیم	steam
سٹیل	steel
سٮ۪ٹھ	steep
گؤڈ	stem
سٹیم	stem
قدم	step
ٹھٹھۍ	stick
سخت	stiff
وۄنہ تہ	still
سٹینگ	sting
سنگی	stingy
ہلٲیو	stir
سٹاک	stock
ژوٗر	stolen
پیٹ	stomach
سٹون	stone
کھڑا	stood
سٹول	stool
رکاو	stop
ذخیرٕ	storage
دکان	store
طوفان	storm
دٔلیٖل	story
چولہا	stove
سیود	straight
سیدھا	straightforward
سٹرین	strain
عجیب	strange
اجنبی	stranger
حکمت عملی	strategy
گھاسہِ	straw
سٹرابیری	strawberry
سٹرائیک	streak
سٹریم	stream
سٹریٹ	street
طاقت	strength
تناو	stress
سٹریچ	stretch
سخت	strict
ہملہٕ کر	strike
سٹرنگ	string
سٹرپ	strip
کوشش کر	strive
سٹروک	stroke
مضبوٗط	strong
لگٲوۍ	struck
ساخت	structure
جدوجہد	struggle
جدوجہد کرنا	struggling
مضطرب	stubborn
چپچپا	stuck
طٲلبہ علم	student
مطٲلعہٕ	study
مطٲلعہٕ	studying
چیز	stuff
حیرت انگیز	stunning
بے وقوف	stupid
سٹائل	style
موضوع: موضوع	subject
پیش کرنا , جمع کروں	submission
جمع کراو	submit
مواد	substance
متبادل	substitute
سٮ۪ٹھا	subtle
کامیاب	succeed
کامیٲبی	success
کامیاب	successful
یتھ کٔنۍ	such
یتھ کٔنۍ ز	such as
چوس	suck
اچانک	sudden
اچانک	suddenly
تکلیف	suffer
تکلیف	suffering
کٲفی	sufficient
شکر	sugar
تجویز کریو	suggest
تجویٖز	suggestion
سوٹ	suit
موزوں	suitable
سوٹ کیس	suitcase
جمح	sum
خلاصہٕ	summary
رٮ۪تہٕ رٮ۪تہٕ	summer
سمٹ	summit
آفتاب	sun
ریتہٕ وار	sunday
دھوپ	sunny
غروب آفتاب	sunset
دھوپ	sunshine
سپر	super
بہتر	superior
سپروائزر	supervisor
ڈنر	supper
سپلائی	supply
سپورٹ	support
مانٛچو	suppose
مانٛنہٕ آمت	supposed
یقینی	sure
سطح	surface
بڑھو	surge
آپریشن	surgery
کنی ناو	surname
حٲران	surprise
حٲران	surprised
ہتھیار ڈالنا	surrender
اوند پوکھ	surrounding
نگرٲنی	surveillance
سروے	survey
زِندٕ	survive
ہہہہہ	suspect
معطل	suspended
مشکوک	suspicious
برقرار تھونہٕ	sustain
بقایا پن	sustainability
پائیدار	sustainable
سویگ	swag
نژن	swallow
سویپ	swap
قسم کھیو	swear
پسینہٕ	sweat
سویٹر	sweater
سویپ	sweep
میٹھا	sweet
رُت خآب	sweet dreams
میٹھا دانت	sweet tooth
مہربٲنی	sweetheart
ورم	swell
سوجن	swelling
ترٲیو	swim
سمنٛدٔری	swimming
جھولان	swing
بدلاو	switch
سوجہ	swollen
تلوار	sword
علامت	symbol
ہمدردی	sympathy
علامتہٕ	symptoms
نظام	system
ٹیبل	table
ٹیکل کر	tackle
ٹیگ	tag
ٹائل	tail
تل	take
نیہ کڑتھ	take away
خیال تھٲیو	take care
نٮ۪بر کڑ	take off
تلتھ	taken
کتھ کر	talk
کتھ باتھ	talkative
تھو٘ڈ	tall
ٹیپ کر	tap
ٹیپ	tape
ٹارگیٹ	target
ٹاسک	task
ذائقہ	taste
مزٕ دار	tasty
ہیٚچھناوٕنۍ	taught
چائے	tea
ہیٚچھناو	teach
ٹیچر	teacher
ٹیم	team
ژوٗر	tear
اوٚش	tears
چڑھاؤ	tease
ٹیکنالوجی	technology
دانت	teeth
ونۍ	tell
مےٚ ون	tell me
مزاج	temper
درجہ حرارت	temperature
مندر	temple
عارضی	temporary
دہہ	ten
دہ ساس	ten thousand
کرایہ دار	tenant
ٹینڈ	tend
رجحان	tendency
ٹینڈر	tender
تناؤ	tense
تناؤ	tension
خیمہ	tent
عارضی	tentative
ٹرم	term
اصطلاحات	terms
خوفناک	terrible
خصوصیات یک مدل	terrific
علاقہٕ	territory
ٹیسٹ	test
متن	text
امہ کھوتہٕ	than
شکریہ	thank
شکرٮ۪ہ	thank you
ییٚلہ أسۍ سامانٕچ چھان بین کران چھو ، تہنٛد صبرک شکریہ	Thank you for your patience while we investigate shipment
تشکر زیاد	thank you so much
تشکر زیاد	thank you very much
تشکر زیاد	thanks
سانہ ایپ استعمال کرنہٕ خٲطرٕ چھ شکریہ	Thanks for using our app
یہ چھ	that
یہ چھ	that is
یہ چھ اصل	that's good
خاص	the
ژوٗر	theft
تہنز	their
تمن	them
تھیم	theme
پانہٕ	themselves
پتہٕ	then
تھیوری	theory
تتہٕ	there
اتھہ چھ	there are
چھ	there is
لحاذا	therefore
یم چھ	these
تم چھ	they
تم چھ	they are
گاڑٕ	thick
چور	thief
مندُل	thigh
پتلا	thin
چیز	thing
چیزٕ	things
سونٛچو	think
ترٛیٚیم	third
پیاسہ	thirsty
ترواہ	thirteen
تر٘ہہ	thirty
یہ چھ	this
یہ چھ	this is
مکمل طور پر	thorough
پوٗرٕ پٲٹھۍ	thoroughly
یم چھ	those
حالانٛکہ	though
سونٛچ	thought
فکر مند	thoughtful
خیالات	thoughts
ساس	thousand
تھریڈ	thread
خطرٕ	threat
خطرٕ	threaten
ترٛیٚیہ	three
حد بندی	threshold
پرجوش	thrilled
ترقی کر	thrive
گرٕ	throat
ذریعہ	through
پوٗرٕ جایہ	throughout
ترٛاو	throw
تھمب	thumb
تھنڈر	thunder
بوہرس وار	Thursday
یتھ کٔنۍ	thus
ٹکہٕ	tick
ٹایڈ	tide
صفٲیی	tidy
ٹایٔی	tie
ٹائیگر	tiger
تنگ	tight
تگرینیا	Tigrinya
ٹایم	time
شرمسار	timid
زیٹھ	tiny
ٹپ	tip
تجاویز	tips
ٹایٔر	tire
تھکن	tired
ٹشو	tissue
ٹایٹل	title
تام	to
بنن	to be
ٹاس	toast
از چھ	today
بچہٕ	toddler
ٹٲٹھۍ	toes
اکوٹے	together
باتھ روم باتھ روم	toilet
وونمٗت	told
تحمل	tolerance
برداشت کر	tolerate
ٹماٹر	tomato
صُبن	tomorrow
زبان زبان	tongue
آز شامس	tonight
تہ تہ	too
تل	took
ٹول	tool
آلات	tools
دانت	tooth
ٹاپ	top
موضوع	topic
ژٹتھ	torn
تشددٕ	torture
کل	total
ٹچ	touch
سخت	tough
ٹور	tour
طرفہٕ	toward
طرفہٕ	towards
ٹاور	towel
شہر	town
زہریلی	toxic
ٹریس	trace
ٹریک	track
تجٲرتی	trade
رٮ۪وایت	tradition
روایتی	traditional
ٹریفک	traffic
ٹرٛیل	trail
ٹرین	train
ٹریننگ	training
خصوصیت	trait
خصوصیات	traits
ٹرانسفر	transfer
ٹرانزیشن	transition
ترجمہٕ کر	translate
صاف ستھرا	transparent
نقل و حمل	transport
نقل و حمل	transportation
ٹرٛاپ	trap
کچھر	trash
صدمہٕ	trauma
سفر	travel
ٹرٛے	tray
خزانہٕ	treasure
علاج کر	treat
علاج	treatment
کلۍ	tree
زبردست	tremendous
رجحان	trend
ٹرائل	trial
چال	trick
آزماو	tried
ٹرگر	trigger
ٹرٛیم	trim
سفر	trip
دقتہٕ	trouble
ٹراؤزر	trousers
ٹرک ٹرک	truck
سہی	TRUE
ٹرٛانک	trunk
ٹرسٹ	trust
حٔقیقت	truth
آزمٲیو	try
سونگا	Tsonga
ٹیوب	tube
بوموار دۄہ	Tuesday
ٹیوشن	tuition
ترکیہ	turkey
لٮ۪در	turmeric
موڑ	turn
کچھوٕ	turtle
ٹیچر	tutor
باہ	twelve
ویژاہ	twenty
اکوُہ	twenty-one
تیوی	Twi
دۄیہ لٹہ	twice
طرفہٕ	twist
زٕ	two
قٕسم	type
عام	typical
بدصورت	ugly
ٲخر کار	ultimate
چھتری	umbrella
بہٕ ہیٚکہٕ نہٕ یہ کٔرتھ	unable
انکل	uncle
لاعلمی	unconscious
اتھ تحت	under
بۄن چھ	underneath
تخفیف شدہ	underrated
سمجن	understand
سمجنہٕ	understood
بدقسمت	unfortunately
وردی	uniform
منفرد	unique
اکٲیی	unit
یونیورسٹی پریس	university
ناواقف	unknown
اگر نہٕ	unless
یوتتھ تام	until
غٲر معموٗلی	unusual
اپ	up
تو٘ہہ تام	up to you
اپڈیٹ کر	update
اپگریڈ	upgrade
پٮ۪ٹھ	upon
پریشان	upset
شہری	urban
درخاست	urge
فوری	urgent
اسہ	us
استعمال کر	use
استعمال شدہ	used
کارآمد	useful
ناکارٕ	useless
معموٗلی	usual
عموٗمن	usually
یوٹیلٹی	utility
چھٹی	vacation
ویکسنیشن	vaccination
ویکسیٖن	vaccine
ویکیوم	vacuum
مبہم	vague
درست	valid
وادی	valley
دور دراز	valuable
قدر	value
مختٔلف قٕسم	variety
مختٔلف	various
مختٔلف	vary
گلدستہٕ	vase
وصیح	vast
سبزی	vegetable
سبزیاں	vegetables
گاڑٕ	vehicle
فروخت کنندگان	vendor
ونوم	venom
وینچر	venture
مقام	venue
تصدیٖق کر	verify
ورسٹائل	versatile
ورژن	version
ورٹیکل	vertical
وارٮ۪اہ	very
واریاہ اصل	very good
جہاز	vessel
وتہ	via
وائب	vibe
وبس	vibes
بدکردار	vicious
شکار	victim
ویڈیو	video
وٕچھو	view
گام	village
ولن	villain
سرکہ	vinegar
ونٹیج	vintage
تشدد	violence
پرتشدد	violent
وایرل	viral
ورجن	virgin
ورچوئل	virtual
حیکمت	virtue
وجن	vision
وزٹ کر	visit
بصری	visual
اہم	vital
وایڈ	vivid
کیپٹل	vocabulary
آواز	voice
وایڈ	void
حجم	volume
رضاکار	volunteer
اُلٹی	vomit
کمزور	vulnerable
تنخواہ	wage
ٹرٛیم	wages
کمر	waist
ٹھہرو	wait
ویٹر	waiter
انتظار کرن	waiting
وٮ۪تُھن	wake
وتھو	wake up
پکن	walk
پیدل پکن	walking
دیوار	wall
ویلٹ	wallet
پھیرن	wander
یژھان چھو	wanna
یژھان چھو	want
چاہان ٲس	wanted
جنگ	war
الماری	wardrobe
گودام	warehouse
گرم	warm
خبردار کر	warn
انتباہ	warning
جنگجو	warrior
اوس	was
دھوٕنہ	wash
فضلہ	waste
وٕچھو	watch
آب	water
تربوز	watermelon
لہر	wave
وتہ	way
اسہ	we
اسہ چھ	we are
بہٕ ہیٚکہٕ کٔرتھ	we can
کمزور	weak
کمزوری	weakness
دولت	wealth
دولت مند	wealthy
لاگن	wear
پلوتھ	wearing
موسم	weather
خانٛدرٕ	wedding
بود وار دۄہ	Wednesday
دٔریاو	weed
ہفتہٕ	week
ہفتہٕ ٲخرس	weekend
وزن	weight
عجیب	weird
خوش آمدید	welcome
فلاح و بہبود	welfare
ٹھیک چھ	Well
بہت خوب	well done
گوٚو	went
آسہٕ	were
مغرب	west
اوٚتھ	wet
وہیل	whale
کیٛاہ	what
تۄہہ کیٛاہ چھ	what about you
ژٕ کیٛاہ چُکھ کران	what are you doing
ژٕ کیٛاہ چھ کران وۄنۍ	what are you doing now
ژٕ کیٛاہ چھو وینکینس کران	what are you doing right now
ژٕ کیٛاہ چھو کران	what do you do
تو٘ہہہ کیٛاہ چھو روزنہٕ خٲطرٕ کران	what do you do for a living
تۄہہ کیا مطلب چھ ؟	what do you mean
تۄہہ کیٛاہ چھ یژھان	what do you want
کیٛاہ گوٚو	what happened
کیٛاہ چھ	what is
یہ کیٛاہ چھ	what is this
تہنٛد کٲم کیٛاہ چھ	what is your job
تہنٛد ناو کیٛاہ چھ	what is your name
کیٛاہ چھ	what's up
تہنٛد ناو کیٛاہ چھ	what's your name
کانٛہہ تہ آسہ	whatever
گندھک	wheat
وہیل	wheel
کۭتیہ	when
ییلہ کنہ ساتہٕ	whenever
کتہ چھ	where
تہۍ کتہ چھو ؟	where are you
ژٕ کتہ چُکھ ؟	where are you from
وۄنہ کتہ چھو تہۍ	where are you now
تہۍ کتہ چھو روزان	where do you live
کتہ چھ ؟	where is
ییٚلہ زن	whereas
کیٛاہ	whether
کمہ	which
ییٚلہ زن	while
چیخ چیخ	whisper
وایسٹل	whistle
سفید	white
کُس چھ	who
ژٕ کس چھ ؟	who are you
کس چھ ؟	who is
یہ کس چھ ؟	who is this
پوٗرٕ	whole
کس کس	whom
کس کس	whose
کیٛاز چھو	why
کیٛاز چھنہٕ	why not
بدکردار	wicked
وسیع	wide
بیواہ	widow
چوڑائی	width
زنانہ	wife
وایلڈ	wild
کر	will
تیار	willing
زینہٕ	win
ہوہٕ	wind
کھڑکی	window
ہوا دار	windy
شراب	wine
ونٛدس منٛز	winter
پوٚپ کر	wipe
تار	wire
وایر	wire
دانشمندی	wisdom
عقلمند	wise
یژھ	wish
تۄہہ چھوٕ بہتٔریٖن دعا	wish you all the best
ڈچ	witch
اتھ سۭتۍ	with
پتھ کڑ	withdraw
تخفیف	withdrawal
اندٕ اندٕ	within
بغٲر	without
گواہن	witness
وٹٹی	witty
ولف	wolf
زنانہ	woman
زنانہٕ	women
زیوٗن	won
کر نہٕ	won't
تعجب	wonder
بہت خوب	wonderful
ووڈس	wood
وول	wool
لفظ	word
الفاظ	words
کٲم	work
کٲم کر	work out
کٲم کران	working
ورلڈ	world
ورم	worm
لٲگتھ	worn
پریشان	worried
فکر	worry
بدتر	worse
عبادت کر	worship
بدتر	worst
قدر	worth
یہ چھ قابل قدر	worth it
قابل	worthy
کرہا	would
زخم	wound
واوو	Wow
راپ	wrap
شرارت	wrath
گرٕ	wrist
لکھو	write
یتہٕ لیکھو	Write here
لیکھتھ	writing
لیکھتھ	written
غلط	wrong
لیوٗکھ	wrote
یارڈ	yard
یاون	yawn
آہا	Yeah
ؤری	year
ؤری وادن	years
خمیر	yeast
چیٚنۍ	yell
یلو	yellow
جی ہاں	Yes
ہا بیبی	yes baby
ہا مہربٲنی	yes dear
ہا ماے	yes honey
ہا میٲنۍ محبت	yes my love
ہا چھ بلکل	yes of course
راتھ	yesterday
وونہ گو٘	yet
پٲداوار	yield
تو٘ہہ	you
توہہ چھو	you are
تہۍ چھو خوبصورت	you are beautiful
تو٘ہہ چھو واریاہ خوبصورت	you are so beautiful
تۄہہ چھو استقبال	you are welcome
ژٕ ہٮ۪کہٕ کٔرتھ	you can
تۄہہ چھو خبر	You know
توہہ تہ	you too
تۄہہ چھو استقبال	you're welcome
پوٗرٕ	young
تہنز	your
خوش آمدید	your welcome
پانہٕ	yourself
جوان	youth
تۄہہ چھو استقبال	you’re welcome
یمی	yummy
صفر	zero
