неуна	a little
уна	a lot
уна	a lot of
эновтны	abandon
эновтӧм	abandoned
кутчысьны	abide
сям	ability
вермысь	able
кужысь	able
йылысь	about
весьтын	above
вылын	above
суйӧр сайын	abroad
абутӧм	absence
абутӧм	absent
дзик	absolutely
босьтны ас пытшкӧ	absorb
вежӧрын кутан	abstract
лӧсявтӧм	absurd
озырлун	abundance
озыр	abundant
лёктор вӧчӧм	abuse
лёктор вӧчны	abuse
акцент	accent
примитны	accept
пырны позянлун босьтны	access
пырӧм	access
сибавны	access
неминуча	accident
овмӧдӧм	accommodation
збыльмӧдны	accomplish
помасис	accomplished
воис помӧдз	accomplished
серти	according
тшӧт	account
стӧчлун	accuracy
стӧч	accurate
мыждӧм	accused
висьны	ache
дой	ache
воӧдчыны	achieve
шедӧдны	achieve
шедӧдӧмтор	achievement
пыдди пуктыны	acknowledge
тӧдмасьӧм	acquaintance
шедӧдны	acquire
босьтіс	acquired
босьтӧма	acquired
босьтӧм	acquisition
вомӧн	across
пыр	across
мысти	across
вӧчӧмтор	act
петкӧдчӧм	action
активнӧй	active
водзмӧстчысь	active
занятиеяс	activities
удж	activity
керӧм	activity
актёр	actor
збыльвывса	actual
збыльысь	actually
ёсь	acute
лӧсьӧдны	adapt
содтыны	add
ас вӧлятӧм	addicted
содтӧм	addition
содтӧд	additional
инпас	address
шыӧдчыны	address
лӧсялана	adequate
орчча	adjacent
кывберд	adjective
стӧчмӧдны	adjust
нимкодясьны	admire
пыдди пуктыны	admit
босьтны	adopt
примитны	adopt
сибӧдны	adopt
мусаник	adorable
водзӧ мунӧм	advance
водзӧ мунны	advance
водзын мунысь	advanced
буртор	advantage
приключенньӧ	adventure
урчитан	adverb
реклама	advertisement
реклама сетӧм	advertising
сӧвет	advice
сӧвет	advise
дорйысь	advocate
дорйыны	advocate
эстетика	aesthetic
делӧ	affair
тӧдчыны	affect
радейтчӧм	affection
лэдзны аслыд	afford
сетны аслыд	afford
позяна	affordable
полӧ	afraid
бӧрын	after
ӧбед бӧр	afternoon
сы бӧрын	afterwards
бара	again
паныд	against
арлыд	age
агентство	agency
агент	agent
воана	aggressive
пельк	agile
сайын	ago
сӧглас лоны	agree
сёрнитчӧм	agreement
видз-му овмӧс	agriculture
водзын	ahead
отсӧг	aid
метитчыны	aim
сынӧд	air
аэропорт	airport
прӧйдитанін	aisle
тревога	alarm
коддзӧдантор	alcohol
тревога	alert
ловъя	alive
ставӧн	all
быдӧн	all
дзик сідз	all right
став бурсӧ	all the best
сетны	allow
лэдзны	allow
лэдзис	allowed
муртса	almost
ӧткӧн	alone
ӧти	alone
пӧлӧн	along
нин	already
Ладнӧ	Alright
Мед	Alright
сідзжӧ	also
бӧръяна	alternative
кӧть	although
пыр	always
век	always
лоа	am
чуймӧдана	amazing
абу ӧтнога донъялан	ambiguous
зільлун	ambition
зіль	ambitious
бурмӧдны	amend
шӧрын	amid
пӧвстын	among
миян пӧвстын	among us
лыд	amount
тешкодь	amusing
анализ	analysis
пӧль-пӧчьяс	ancestors
кутӧд	anchor
якӧр	anchor
важдырся	ancient
важся	ancient
важ	ancient
да	and
а тэ	and you
а ті	and you
андел	angel
лӧг	anger
пельӧс	angle
скӧр	angry
пемӧс	animal
шег	ankle
тшупӧда пас	anniversary
юӧртӧм	announcement
дӧзмӧдны	annoy
дӧзмӧм	annoyed
дӧзмӧдысь	annoying
быдвося	annual
ним пасйытӧм	anonymous
мӧд	another
вочакыв	answer
вочавидзны	answer
водзвыв тӧдны	anticipate
виччысьны	anticipate
майшӧг	anxiety
шызьӧм	anxious
быд	any
сэсся	anymore
кӧть коді	anyone
мыйкӧ	anything
быд ногӧн	anyway
сідз и тадз	anyways
торйӧн	apart
патера	apartment
прӧща корны	apologize
ясыд	apparent
тыдалӧ	apparently
ас дорӧ кысканлун	appeal
лӧсьыдлун	appeal
мичлун	appeal
петкӧдчыны	appear
мыгӧр	appearance
мыччысис	appeared
аппетит	appetite
яблӧг	apple
вӧдитчӧм	application
вӧдитчыны	apply
индӧм	appointment
донъявны	appreciate
аттьӧалӧм	appreciation
матыстчыны	approach
матыстчӧм	approach
лӧсялысь	appropriate
ошкӧм	approval
ошкыны	approve
вынсьӧдӧм	approved
ылӧсас	approximately
гӧгӧр	approximately
кос му	april
водзвыв лӧсьӧдтӧм	arbitrary
архитектор	architect
архитектура	architecture
архив	archive
лоӧны	are
ті лоанныд	are you
тэ лоан	are you
эштанныд	are you busy
эштан	are you busy
он	are you busy
онӧ	are you busy
тэ гӧтыра	are you married
тэ верӧс сайын али абу	are you married or single
тэ гӧтыра али абу	are you married or single
Ті сэнӧсь на?	Are you still there?
Тэ сэні на?	Are you still there?
тэ сэні	are you there
ті сэнӧсь	are you there
обласьт	area
вензьыны	argue
вензьӧм	argument
подулалӧм	argument
петны	arise
сой	arm
армия	army
гӧгӧр	around
котыртны	arrange
лӧсьӧдны	arrange
котыртӧм	arrangement
лӧсьӧдӧм	arrangement
воӧм	arrival
воны	arrive
воис	arrived
тшап	arrogant
ньӧв	arrow
искусство	art
статья	article
мортӧн вӧчӧм	artificial
серпасасьысь	artist
кыдзи	as
кытчӧдз	as long as
сідзжӧ	as well
а сідзжӧ	as well as
пӧим	ash
яндысьысь	ashamed
юавны	ask
юаліс	asked
узьысь	asleep
аспект	aspect
Ассамскӧй	Assamese
уськӧдчӧм	assault
чукӧртчӧм	assembly
асныра	assertive
донъявны	assess
донъялӧм	assessment
буртор	asset
фондъяс	assets
индыны	assign
удж	assignment
мог	assignment
отсавны	assist
отсасьысь	assistant
отсасьысь	associate
йитчӧм	associated
ассоциация	association
котыр	association
чайтны	assume
чайтӧм	assumption
этша вылӧ	at least
сёйис	ate
спортсмен	athlete
содтыны	attach
пысалӧм	attached
содтӧд	attachment
сьӧлӧм сетӧм	attachment
уськӧдчыны	attack
уськӧдчӧм	attack
видлӧм	attempt
видлыны	attempt
волывлыны	attend
пыравлӧм	attendance
волывлӧм	attendance
чуйдӧм	attention
вниманньӧ	attention
пельсадь	attention
йитчӧм	attitude
видзӧдлас	attitude
кыскыны	attract
кыскӧм	attraction
веж петкӧдлана	attractive
аслыспӧлӧслун	attribute
йӧз	audience
моз	august
чожинь	aunt
тьӧт	aunt
тьӧт	aunty
збыль	authentic
автор	author
власьт	authority
ар	autumn
восьса	available
гӧгӧрвоана	available
лӧсялан	available
шӧр	average
шӧркодь	average
видзчысьны	avoid
олысь	awake
награда	award
тӧдны	aware
тӧдӧм	awareness
бокын	away
вывті лӧсьыд	awesome
зэв омӧль	awful
зэв лёк	awful
зэв мисьтӧм	awful
укшаль	awkward
лӧсьыдтӧм	awkward
Аймара	Aymara
кага	baby
гӧтыртӧм	bachelor
бӧр	back
бӧрӧ	back
бӧрлань	back
фон	background
лёк	bad
сумка	bag
сам	bait
пӧжасьны	bake
пӧжавны	bake
пӧжасянін	bakery
сёян сода	baking soda
кутны ӧтвесьталун	balance
ӧтвесьталун	balance
мач	ball
Бамбара	Bambara
банан	banana
котыр	band
крапкыны	bang
банк	bank
нуръясянін	bar
муртса	barely
сёрнитчӧм	bargain
увтны	bark
кырсь	bark
ид	barley
мытшӧд	barrier
база	base
подув	base
подулалӧм	based
гӧбӧч	basement
подув	basic
ёнджыкасӧ	basically
базилик	basil
неморт	bastard
чурка	bastard
чукӧр	batch
ванна	bath
ваннӧй	bathroom
батарея	battery
тыш	battle
куръя	bay
лоны	be
видзчысьӧй	be careful
видзчысь	be careful
гожйӧдчанін	beach
югӧр	beam
фасоль	beans
петкӧдны	bear
ош	bear
тош	beard
подшипник	bearing
вайӧм	bearing
пемӧс	beast
вартны	beat
такт	beat
кучкавны	beat
мича	beautiful
мич	beauty
лоис	became
сы вӧсна мый	because
лоны	become
крӧвать	bed
узянін	bedroom
мазі	bee
мӧс яй	beef
вӧлі	been
сур	beer
водзын	before
заводитіс	began
заводитны	begin
заводитчӧм	beginning
вӧсна	behalf
асьтӧ кутны	behave
морттуй	behavior
оласног	behaviour
бӧрын	behind
сайын	behind
ловъя лов	being
эскӧм	belief
эскыны	believe
кынӧм	belly
муса	beloved
улын	below
тасма	belt
лабич	bench
нюкыльтны	bend
улын	beneath
буртор вайны	benefit
буртор	benefit
бурторъяс	benefits
орччӧн	beside
та кындзи	besides
медбур	best
мед мойвиас	best of luck
пыдди пуктӧмӧн	best regards
бурджык	better
костын	between
юантор	beverage
сайын	beyond
Бходжпури	Bhojpuri
ас ног гӧгӧрвоӧм	bias
подувтӧм	biased
велосипед	bicycle
дон вӧзйӧм	bid
ыджыд	big
велосипед	bike
тшӧт	bill
кӧртавны	bind
лэбач	bird
чужан лун	birthday
тор	bit
курччавны	bite
курччӧм	bite
курыд	bitter
сьӧд	black
дорыш	blade
мыж	blame
мыждыны	blame
куш	blank
эшкын	blanket
грымӧб	blast
едждӧдны	bleach
сорлавны	blend
бурсины	bless
бурсиӧм	blessed
синтӧм	blind
шуд	bliss
блокируйтны	block
блок	block
вир	blood
дзордзавны	bloom
вачкӧм	blow
кучкӧм	blow
вартӧм	blow
лӧз	blue
бӧб	blunt
пӧв	board
пыж	boat
вир-яй	body
пузьӧдны	boil
повтӧм	bold
збой	bold
кӧсйысьӧм	bond
облигация	bond
лы	bone
небӧг	book
бронируйтны	book
паськалӧм	boost
паськӧдны	boost
ӧддзӧдысь	booster
ботинки	boot
ботинки	boots
дор	border
писькӧдны	bore
гажтӧмтчысь	bored
гажтӧм	boring
чужӧм	born
удждыны	borrow
веськӧдлысь	boss
кыкнанныс	both
дӧзмӧдны	bother
сулея	bottle
пыдӧс	bottom
ньӧбис	bought
чеччыштавны	bounce
кӧрталӧм	bound
мудоръяс	boundaries
ньӧввуж	bow
тасьті	bowl
куд	box
зонка	boy
зонъёрт	boyfriend
сойпос	bracelet
вем	brain
вож	branch
марка	brand
повтӧм	brave
збой	brave
пазӧдны	breach
орӧдны	breach
нянь	bread
пазӧдны	break
кост	break
жугӧдны	break
завтрак	breakfast
морӧс	breast
лолалӧм	breath
лолавны	breathe
рӧдмӧдны	breed
кирпич	brick
гӧтырпу	bride
пос	bridge
дженьыд	brief
яръюгыд	bright
югъялан	brilliant
вайны	bring
вок	bro
паськыд	broad
юӧртӧм	broadcast
транслируйтӧм	broadcast
жугӧдіс	broke
жугалӧм	broken
рос	broom
вок	brother
гӧтырлӧн вок	brother in law
пивер	brother in law
вайис	brought
рудовгӧрд	brown
сынан	brush
щӧтка	brush
ведра	bucket
ёрт	buddy
бюджет	budget
гаг	bug
кыпӧдны	build
стрӧйба	building
кыпӧдӧм	built
ыджда	bulk
ӧш	bull
зыртчыны	bully
люкасьны	bump
чукӧр	bunch
чукӧр	bundle
сьӧктӧдны	burden
сьӧктӧд	burden
гуалӧм	buried
сотчыны	burn
потны	burst
гуавны	bury
автобус	bus
куст	bush
удж	business
бюст	bust
занят	busy
сӧмын	but
но	but
вый	butter
бобув	butterfly
кизь	button
кнопка	button
ньӧбны	buy
дорын	by
ӧти сайын	by the way
на	bye
кӧчан	cabbage
ичӧт шкап	cabinet
садӧк	cage
торт	cake
кукань	calf
корны	call
чукӧстны	call
чукӧстӧм	call
звӧнитлӧй меным	call me
звӧнитлы меным	call me
корис	called
рам	calm
лӧнь	calm
локтіс	came
кампания	campaign
банка	can
вермыны	can
оз вермы	can't
Киритӧм	Cancel
рак	cancer
сюсь	capable
йӧрыш	capacity
юркар	capital
гижӧд	caption
пленӧ босьтны	capture
машина	car
карьера	career
видзчысьысь	careful
видзчысьӧмӧн	carefully
майшасьтӧм	careless
тӧждысьысь	caring
тшупсьысь	carpenter
джодждӧра	carpet
морков	carrot
нуны	carry
водзӧ вӧчны	carry on
збыльмӧдны	carry out
делӧ	case
кивывса сьӧм	cash
шыбитны	cast
замок	castle
быдлунся	casual
кань	cat
кыйны	catch
категория	category
скӧт	cattle
кутіс	caught
кыйис	caught
помка	cause
корны	cause
чужтыны	cause
видзчысьӧм	caution
видзчысьысь	cautious
изъя горс	cave
дугӧдны	cease
пӧтӧлӧк	ceiling
пасйыны	celebrate
клетка	cell
шӧрин	center
шӧр	center
нэм	century
изӧм тусьяс	cereal
церемония	ceremony
падъявтӧм	certain
дзик стӧч	certainly
сертификат	certificate
чеп	chain
улӧс	chair
пуктыны зэв ыджыд мог	challenge
мытшӧд	challenge
позянлун	chance
вежлавны	change
хаос	chaos
персонаж	character
аслыспӧлӧслунъяс	characteristics
зарадитны	charge
благотворительносьт	charity
мусаник	charming
диаграмма	chart
вӧтчыны	chase
вӧтчӧм	chase
сёрнитны	chat
сёрни	chat
абу дона	cheap
донтӧм	cheap
пӧрйӧдлыны	cheat
ылӧдлӧм	cheating
видлалӧм	check
видлавны	check
бан бок	cheek
ышӧдны	cheer
кыпыд	cheerful
ошкӧм	cheers
сыр	cheese
химия	chemistry
вылӧ пуктыны	cherish
шахмат	chess
нёнь	chest
морӧс	chest
курччавны	chew
курӧг	chicken
ыджыд	chief
кага	child
челядьдыр	childhood
челядь	children
кӧдзыд	chill
тшын петан трубаяс	chimneys
тшӧка	chin
шоколад	chocolate
бӧрйӧм	choice
бӧрйыны	choose
керавны	chop
гортгӧгӧрса удж	chores
кызіник	chubby
вичко	church
корича	cinnamon
кытш	circle
обстоятельствояс	circumstances
гражданин	citizen
кар	city
шыӧдчӧм	claim
шыӧдчыны	claim
гӧгӧрвоӧдны	clarify
класс	class
сёй	clay
сӧстӧм	clean
сэзь	clear
весавны	clear
служащӧй	clerk
сюсь	clever
клиент	client
кыр	cliff
климат	climate
кайны	climb
кӧвъясьысь	clingy
часі	clock
сиптыны	close
пӧдлавны	close
шкап	closet
дӧра	cloth
паськӧм	clothes
кымӧр	cloud
кымӧра	cloudy
серам петкӧдлысь	clown
тупыль	clue
укшаль	clumsy
роз	cluster
тренер	coach
тренируйтны	coach
из шом	coal
вадор	coast
пальто	coat
кофе	coffee
когнитивнӧй	cognitive
лӧсялӧм	coincidence
кӧдзыд	cold
пусь-пасьмунӧм	collapse
дом	collar
воротник	collar
уджъёрт	colleague
уджъёртъяс	colleagues
чукӧртны	collect
чукӧр	collection
колледж	college
рӧм	color
быгалӧм турунвиж мӧвпъяс яра узисны	colorless green ideas slept furiously
рӧм	colour
колонка	column
шыльӧдны	comb
ӧтлаалӧм	combination
йитлыны	combine
локны	come
лок татчӧ	come here
локтӧй татчӧ	come here
дугды	come on
комфорт	comfort
лӧсьыдлун	comfort
йӧмкӧа	comfortable
локтысь	coming
регыд лоас	coming soon
тшӧктыны	command
комментарий	comment
коммерческӧй	commercial
тшӧктӧм, тшӧктыны	commission
вӧчны	commit
сетчӧм	commitment
вӧчис	committed
вӧчӧма	committed
йӧзлы колана тӧвар	commodity
быд лунся	common
кутны йитӧд	communicate
йитӧд	communication
ӧткотыр	community
ӧтарӧ-мӧдарӧ ветлӧм	commute
ёрт	companion
котыр	company
ӧткодявны	compare
орччӧдӧм	comparison
жалитӧм	compassion
небыд сьӧлӧма	compassionate
лӧсялана	compatible
ордйысьны	compete
тӧдысь	competent
кужысь	competent
ордйысьӧм	competition
панласян	competitive
ордйысян	competitive
норасьны	complain
норасьӧм	complaint
содтӧд	complement
содтыны	complement
эштӧдны	complete
помавны	complete
тырвыйӧ	completely
тэчаса	complex
бура лӧсялӧм	compliance
тэчаса	complicated
ошкыштан кыв	compliment
кывзысьны	comply
тэчӧм	composition
ӧтлаӧдны	compound
гӧгӧрвоӧм	comprehension
тырвыйӧ	comprehensive
ӧти кывйӧ воӧдчӧм	compromise
ӧти кывйӧ воӧдчыны	compromise
быть колана	compulsory
компьютер	computer
чукӧртны	concentrate
гӧгӧрвоӧм	concept
тӧжд	concern
тӧждысьны	concern
майшасьысь	concerned
шызьӧм	concerned
тӧждӧ усьӧм	concerned
концерт	concert
кывкӧртӧд	conclusion
бетонысь	concrete
бетон	concrete
урчитӧмтор	condition
условиеяс	conditions
колльӧдны	conduct
нуӧдны	conduct
конференция	conference
висьтасьны	confess
зумыд эскӧм	confidence
падъявтӧм	confident
эскӧдны	confirm
зык-вен	conflict
шӧйӧвошӧм	confused
шай-паймунӧм	confusion
чолӧмалӧмъяс	congrats
чолӧмалӧм	congratulation
чолӧмалӧм	congratulations
йитӧм	conjunction
йитны	connect
босьтны	conquer
шедӧдны	conquer
вежӧра	conscious
садь	consciousness
лоны сӧглас	consent
ӧти кывйӧ воӧм	consent
кольӧмторъяс	consequences
видзӧм	conservation
важас кутчысьысь	conservative
мӧвпавны	consider
лыддьыссьӧ	considered
артмыны	consist
шыбласьтӧмлун	consistency
шыбласьтӧм	consistent
вежласьтӧм	constant
пыр	constantly
гырк йӧрмӧм	constipation
стрӧитчӧм	construction
видзны	consume
видзӧм	consumption
йитӧд	contact
йитчыны	contact
кӧвъясьысь	contagious
кутны	contain
артмӧ	contains
талунъя	contemporary
зывӧктӧм	contempt
сюрӧс	content
пытшкӧс	content
юриндалысь	content
ордйысьӧм	contest
контекст	context
континент	continent
водзӧ нуӧдны	continue
контракт	contract
топавны	contract
ёна торъявны	contrast
ёна торъялӧм	contrast
пуктыны пай	contribute
пай	contribution
видзӧдӧм	control
вензяна	controversial
лӧсьыдлун	convenience
лӧсялана	convenient
сёрни	conversation
выльӧн пыртӧм	convert
выльмӧдны	convert
новлӧдлыны	convey
эскӧдны	convince
эскысь	convinced
пусьысь	cook
пуны	cook
пусьыны	cook
пуӧм	cooking
пусьӧм	cooking
ыркыд	cool
зэв бур	cool
ӧтвылысь уджалӧм	cooperation
венны	cope
ыргӧн	copper
сьӧмӧс	core
кукуруза	corn
пельӧс	corner
веськыд	correct
сулавны	cost
дон	cost
костюм	costume
коттедж	cottage
туруншӧрт	cotton
диван	couch
кызны	cough
вермис	could
сӧвет	council
артавны	count
стойка	counter
страна	country
му	country
сикт-грезд	countryside
гоз	couple
повтӧмлун	courage
курс	course
ёрд	court
авъялун	courtesy
воча вок	cousin
вевттьыны	cover
мӧс	cow
полысь	coward
лӧсьыд	cozy
краб	crab
потас	crack
поткӧдны	crack
киподтуй	craft
сіт	crap
жугавны	crash
жугалӧм	crash
кӧсйӧм	craving
кыссьыны	crawl
йӧй	crazy
вӧчны	create
творческӧй	creative
кредит	credit
кыссьыны	creep
шуштӧм	creepy
команда	crew
мыж вӧчӧм	crime
дӧзмысь	cringe
куткыртчыны	cringe
кризис	crisis
муртӧсъяс	criteria
дивитана	critical
вежсян	critical
критика	criticism
урожай	crop
пуктас	crops
крест	cross
вомӧнавны	cross
кырныш	crow
рака	crow
йӧз чукӧр	crowd
уна йӧза	crowded
корона	crown
медтӧдчана	crucial
жаль тӧдтӧм	cruel
круиз	cruise
лямӧдны	crush
муслун	crush
лязӧдны	crush
бӧрдны	cry
горзыны	cry
ӧгуреч	cucumber
кутлысьны	cuddle
культура	culture
мудер	cunning
чашка	cup
сервант	cupboard
дор	curb
бурдӧдны	cure
бурдӧдчантор	cure
бурдӧм	cure
комендантскӧй час	curfew
тӧдны окотитӧм	curiosity
быдтор тӧдны кӧсйысь	curious
чикыль	curly
валюта	currency
визувтысь	current
тайӧ кадся	current
ӧнія	current
ӧнія здукӧ	currently
ӧнія кадӧ	currently
ёрӧм	curse
ёрны	curse
занавес	curtain
юрлӧс	cushion
оласног	custom
вӧдитчысь	customer
таможня ӧктас	customs
вундӧм	cut
вундыны	cut
муса	cute
кытш	cycle
велосипедӧн ветлӧм	cycling
пап	dad
батьӧ	daddy
быдлунся	daily
йӧв-вый	dairy
помӧд	dam
дойдны	damage
жугӧдӧм	damage
жугӧдны	damage
ёрӧм	damn
ва	damp
уль	damp
йӧктыны	dance
грӧз	danger
ӧпаснӧй	dangerous
пемыд	dark
дона	darling
чепӧсйӧм	dash
чепӧсйыны	dash
даннӧйяс	data
кадпас	date
аддзысьӧм	date
ныв	daughter
лун	day
кулӧм	dead
бӧръя кад	deadline
пельтӧм	deaf
артмӧдчыны	deal
артмӧдчӧм	deal
дона	dear
Дона ёртъяс	Dear All
Пыдди пуктана клиент	Dear Customer
Дона бать-мам	Dear Parents
Пыдди пуктана господин	Dear Sir
Пыдди пуктана студентъяс	Dear students
Пыдди пуктана команда	Dear Team
кулӧм	death
вензьӧм	debate
дебет	debit
коляс	debris
уджйӧз	debt
дас во	decade
сісьмӧм	decay
тшыксьӧм	decay
кувсьӧм	deceased
ылӧдлыны	deceive
ӧшым	december
вежавидзысь	decent
решитны	decide
решитіс	decided
решитӧм	decision
помшуӧм	decision
палуба	deck
вештыны	decline
чинтыны	decrease
чинны	decrease
сьӧлӧмсянь сетчӧм	dedicated
сиӧм	dedication
вӧчӧм	deed
джуджыд	deep
кӧр	deer
водзвыв индӧм	default
водзвыв пуктӧм	default
пасьвартӧм	defeat
вермыны	defeat
дорйыны	defend
урчитны	define
стӧча	definitely
гӧгӧрвоӧдӧм	definition
тшупӧд	degree
сёрмӧм	delay
сёрмӧдны	delay
сёрмӧм	delayed
киритны	delete
чышкыны	delete
водзвыв артыштӧм	deliberate
мелі	delicate
чӧскыд	delicious
нимкодясьӧм	delight
нимкодь	delighted
вайны	deliver
вайӧм	delivered
вайӧм	delivery
тшӧктӧм	demand
тшӧктыны	demand
требуйтан	demanding
требуйтысь	demanding
демократия	democracy
мути	demon
пеж лов	demon
мыччӧдны	demonstrate
ӧткажитіс	denied
тшӧкыдлун	density
пинь бурдӧдысь	dentist
соссьыны	deny
юкӧн	department
мунӧм	departure
зависитны	depend
паськӧдны	deploy
пай	deposit
пуктыны	deposit
дзугыль	depressed
депрессия	depression
джуджда	depth
серпасавны	describe
опишитны	describe
серпасалӧм	description
опишитӧм	description
висьталӧм	description
овтӧмин	desert
пустыня	desert
сулавны	deserve
дизайн	design
проектируйтны	design
индӧм	designation
кӧсйӧм	desire
кӧсйыны	desire
пызан	desk
шогӧ усьӧм	despair
повтӧм	desperate
видзӧдтӧг	despite
юмовтор	dessert
воанін	destination
олантуй	destiny
бырӧдны	destroy
жугалӧм	destruction
деталь	detail
поснитор	detail
посниторъяс	details
казявны	detect
повтӧмлун	determination
гӧгӧрвоӧдны	determine
зумыд	determined
повтӧм	determined
рӧзӧритӧм	devastated
сӧвмӧдны	develop
сӧвмӧм	developed
сӧвмӧм	development
сӧвмӧдӧм	development
устройство	device
омӧль	devil
дявӧл	devil
сьӧлӧмӧн сетчӧм	devoted
Дивехи	Dhivehi
диабет	diabetes
мыт	diarrhea
луннебӧг	diary
кывкуд	dictionary
вӧчис	did
кувны	die
куліс	died
диета	diet
торъялӧм	difference
мӧд	different
сьӧкыд	difficult
кодйыны	dig
дон	dignity
зіль	diligent
ужын	dinner
рытъя сёйӧм	dinner
сунгыны	dip
веськыд	direct
нырвизь	direction
директор	director
няйт	dirt
няйт	dirty
кусӧдны	disable
вермытӧм	disabled
вошны	disappear
лача воштӧм	disappointed
неминуча	disaster
шыбитны	discard
пуксьӧдны	discharge
дисциплина	discipline
дон лэдзӧм	discount
восьтыны	discover
дзескӧдӧм	discrimination
видлавны	discuss
видлалӧм	discussion
висьӧм	disease
висьӧмъяс	diseases
маскируйтчыны	disguise
маскировка	disguise
зывӧк	disgusting
тасьті	dish
сёян	dish
тасьті-пань	dishes
вештыны	dismiss
ыстыны	dispatch
ыстӧм	dispatch
тыдӧдны	display
иналӧм	disposal
вензьӧм	dispute
кост	distance
ясыд	distinct
торъя	distinct
торйӧдны	distinguish
шог	distress
юклӧм	distribution
ясыд	district
дӧзмӧдны	disturb
ва кыскӧд	ditch
канава	ditch
сунавны	dive
уна сикаса	diverse
унасикаслун	diversity
юкны	divide
еннога	divine
юксьыны	divorce
юксьӧм	divorce
юр бергӧдчана	dizzy
керны	do
вӧчны	do
тэ	do you
ті	do you
тэ менӧ радейтан	do you love me
ті менӧ радейтанныд	do you love me
бурдӧдчысь	doctor
документ	document
вӧчӧ	does
оз	doesn't
пон	dog
Догри	Dogri
вӧчан	doing
вӧчысь	doing
акань	doll
кутантор	domain
гортса	domestic
вевтыртысь	dominant
оз ков	don't
Эн майшасьӧй	Don't worry
Эн майшась	Don't worry
сетны	donate
дась	done
осёл	donkey
употребляйтны наркотик	dope
сетны наркотик	dope
наркотик	dope
дзик ӧткодь морт	double
кыкпӧвставны	double
падъялӧм	doubt
падъявны	doubt
няньшом	dough
улӧ	down
грузитны	download
бала	draft
вӧчны бала	draft
кыскыны	drag
визувтӧм	drain
драма	drama
серпасавны	draw
ящик	drawer
серпас	drawing
повны	dread
полӧм	dread
кӧсйӧм	dream
кӧсйыны	dream
пасьтавны	dress
пасьтӧдны	dress
платтьӧ	dress
писькӧдны	drill
юантор	drink
юны	drink
шоперавны	drive
войт	drop
уськӧдны	drop
уськӧдіс	dropped
кос	drought
код	drunk
кос	dry
чӧж	duck
зон	dude
колана	due
вӧсна	due to
гажтӧм	dull
кывтӧм	dumb
шыблавны	dump
дыр	duration
дырйи	during
бус	dust
уджмог	duty
овны	dwell
кулысь	dying
быд	each
ӧта-мӧдӧс	each other
терпитны вермытӧм	eager
ляб	eager
кутш	eagle
пель	ear
водзджык	earlier
водз	early
нажӧвитны	earn
пельяс	ears
му	earth
му вӧрзьылӧм	earthquake
кокнилун	ease
кокньыда	easily
асыввыв	east
кокньыд	easy
сёйны	eat
сёйӧм	eating
экономика	economic
экономика	economy
дор	edge
бурмӧдны	edit
тӧдӧмлун босьтӧм	education
велӧдчӧм	education
эффект	effect
окталуна	effective
бура уджалӧм	efficiency
окталуна	efficient
выныштчӧм	effort
кольк	egg
баклажан	eggplant
ме	ego
кӧкъямыс	eight
дас кӧкъямыс	eighteen
кӧкъямысдас	eighty
либӧ	either
быд боксянь думыштны	elaborate
быд боксянь думыштӧм	elaborate
гырддза	elbow
ыджыдджык	elder
олӧма	elderly
пелькиник	elegant
элемент	element
слӧн	elephant
дас ӧти	eleven
инӧда	eligible
бырӧдны	eliminate
мӧд ногӧн	else
мӧд ног	else
родысь	embarrassed
шӧйӧвоштана	embarrassing
примитны	embrace
мыччысьны	emerge
видзчысьтӧм лоӧмтор	emergency
сьӧлӧм вӧрзьӧдан	emotional
эмпатия	empathy
тӧдчӧдӧм	emphasis
тӧдчӧдны	emphasize
уджалысь	employee
уджалысьяс	employees
удж сетысь	employer
удж вылӧ пырӧм	employment
куш	empty
тыртӧм	empty
пыртны	enable
зурасьӧм	encounter
зурасьны	encounter
ошкыны	encourage
ышӧдны	encourage
пом	end
грӧз улын	endangered
зіля уджалӧм	endeavor
винёвлун	endurance
терпитны	endure
враг	enemy
энергия	energy
вын	energy
пыртны	engage
кикутны	engage
кикутӧм	engaged
пырӧдчӧм	engagement
корӧм	engagement
кикутӧм	engagement
двигатель	engine
инженер	engineer
Англия	English
бурмӧдны	enhance
сьӧлӧм бурмӧдны	enjoy
нимкодясьны	enjoy
зэв ыджыд	enormous
тырмымӧн	enough
могмӧдны	ensure
пырны	enter
гажӧдчӧм	entertainment
водзмӧстчӧм	enthusiasm
сьӧлӧмсянь	enthusiastic
дзонь	entire
сетӧма инӧд	entitled
сюрӧс	entity
пыранін	entrance
ас вылӧ уджалысь	entrepreneur
конверт	envelope
ывла выв гӧгӧртас	environment
вежалӧм	envy
вежавны	envy
эпическӧй	epic
пӧрӧс	epidemic
ӧткодь	equal
оборудуйтӧм	equipment
оборудованньӧ	equipment
ӧткодьлун	equity
эквивалент	equivalent
вуштысян	eraser
шыбӧль	error
пышйыны	escape
пышйӧм	escape
торйӧн	especially
эссе	essay
сюрӧс	essence
колана	essential
лӧсьӧдны	establish
подулалӧм	established
овмӧс	estate
донъявны	estimate
чайтана	estimated
арталан	estimated
да с. в.	etc
помасьлытӧм	eternal
этика	ethics
донъявны	evaluate
дон	evaluation
весиг	even
кӧть	even though
рыт	evening
лоӧмтор	event
бӧръяпомас	eventually
пыр	ever
век	ever
быд	every
быдӧн	everybody
быдӧн	everyone
ставӧн	everyone
ставыс	everything
докажитӧм	evidence
эскӧдӧм	evidence
лёктор	evil
лёк	evil
эволюция	evolution
сӧвмыны	evolve
Эве	Ewe
вӧвлӧм	ex
буретш	exact
стӧча	exactly
экзамен	exam
видлавны	examine
видлӧг	example
вевтыртны	exceed
зэв бур	excellent
кындзи	except
исключенньӧ	exception
лишнӧйтор	excess
вывті	excessive
вежӧм	exchange
шӧйӧвошӧм	excited
шызьӧм	excited
гызьӧм	excited
ыззьӧм	excitement
ышӧдана	exciting
торъя	exclusive
помка	excuse
прӧща корӧм	excuse
кора прӧща	excuse me
вӧчны	execute
казнитӧм	execution
олӧмӧ пӧртан	executive
удж	exercise
вӧчны	exercise
вынтӧммӧдны	exhaust
вынтӧммӧм	exhausted
мыччӧдантор	exhibit
выставка	exhibition
овны	exist
эм	exist
олӧм-вылӧм	existence
мый эмӧсь	existing
мый эм	existing
петанін	exit
паськӧдны	expand
виччысьны	expect
виччысяна	expected
рӧскод	expenses
дона	expensive
кывны	experience
опыт	experience
эксперимент	experiment
эксперт	expert
кадысь кольӧм	expired
гӧгӧрвоӧдны	explain
гӧгӧрвоӧдӧм	explanation
уджӧдны	exploit
туявны	explore
экспорт	export
пуктыны	expose
лэдзны	expose
восьса	exposed
сетчӧм	exposure
висьтавны	express
петкӧдлӧм	expression
нюжӧдны	extend
паськӧдӧм	extended
нюжӧдӧм	extension
тшупӧд	extent
ортсыса	external
бырӧм	extinct
содтӧд	extra
перйыны	extract
босьтны	extract
аслыспӧлӧс	extraordinary
вывті сьӧкыд	extreme
вывті	extremely
син	eye
синъяс	eyes
роч дӧра	fabric
чуймӧдана	fabulous
паныдавны	face
чужӧм	face
отсавны	facilitate
удобствояс	facilities
удобство	facility
збыльтор	fact
помка	factor
фабрика	factory
збыльторъяс	facts
кусны	fade
эз артмы	fail
артмытӧм	failed
эз артмы	failure
омӧль	faint
садьтӧг усьны	faint
веськыд	fair
югыд	fair
тырмымӧн	fairly
фея	fairy
эскӧм	faith
эскысь	faithful
пӧрйӧг	fake
усьны	fall
усьӧм	fall
абу збыль	FALSE
нималӧм	fame
тӧдса	familiar
котыр	family
тшыгъялӧм	famine
нималана	famous
радейтысь	fan
веер	fan
тешкодь	fancy
шемӧсмӧдана	fancy
шензьӧдана	fancy
вӧвлытӧм	fantastic
ылыс	far
янсӧдчӧм	farewell
ферма	farm
видз-му кутысь	farmer
чуймӧдана	fascinating
мода	fashion
тэрыб	fast
кыз	fat
кулан	fatal
быть лоан	fatal
олантуй	fate
бать	father
мудз	fatigue
мудзӧм	fatigue
мыж	fault
медрадейтана	favorite
отсӧг	favour
радейтана	favourite
повны	fear
полӧм	fear
пир	feast
гӧн	feather
пыртны	feature
торъяланлун	feature
аслыспӧлӧслун	feature
аслыспӧлӧслунъяс	features
пертасъяс	features
урасьӧм	february
юрвывтыр	fed up
мынтысьӧм	fee
вердны	feed
донъяланкыв	feedback
кывны	feel
сьӧлӧмкылӧм	feeling
кок лапаяс	feet
уси	fell
зон	fellow
гын	felt
энь	female
потшӧс	fence
вына	fertile
фестиваль	festival
вайны	fetch
биа висьӧм	fever
неуна	few
этшаджык	fewer
сьӧм	fiance
мӧвпыштӧмтор	fiction
ыб	field
му	field
яр	fierce
дас вит	fifteen
ветымын	fifty
тышкасьны	fight
тыш	fight
тышкасьӧм	fighting
мыгӧр	figure
артавны	figure
гӧгӧрвоны	figure out
файл	file
тыртны	fill
тырӧм	filled
тыртӧм	filled
фильм	film
плёнка	film
няйт	filthy
бӧръяпомас	finally
финансъяс	finance
сьӧма	financial
аддзыны	find
тӧдмавны	find out
штрап	fine
бур	fine
чунь	finger
помавны	finish
эштӧдӧм	finished
помалӧм	finished
би	fire
топыд	firm
фирма	firm
медводдза	first
ним	first name
чери	fish
лӧсявны	fit
вит	five
дзоньтавны	fix
зумыд	fixed
дӧрапас	flag
вспышка	flash
патера	flat
алькӧс	flat
плавкӧс	flat
тырмытӧмтор	flaw
зэв бур	flawless
пышйыны	flee
яй	flesh
лэбис	flew
кусыньтны	flex
нюдз	flexible
лэбалӧм	flight
бергӧдны	flip
ворсӧдчыны	flirt
ворсӧдчӧм	flirting
кывтны	float
ытва	flood
джодж	floor
пызь	flour
визувтны	flow
визув	flow
дзоридз	flower
грипп	flu
торксьывтӧм	fluent
ӧдйӧ	fluent
шыльыда	fluently
ӧдйӧ	fluently
пушыд	fluffy
кизьӧр	fluid
лэбавны	fly
медшӧртор видлавны	focus
медшӧртор	focus
ру	fog
руа	foggy
кусыньтны	fold
йӧз	folks
войтыр	folks
мунны	follow
видзӧдны	follow up
мӧд	following
сёян	food
йӧй	fool
йӧйтӧдлыны	fool
йӧй	foolish
кок лапа	foot
футбол	football
Шуам	For example
шуам	for instance
тэныд	for you
позьтӧм	forbidden
вын	force
прогноз	forecast
кымӧс	forehead
суйӧрсайса	foreign
вӧр	forest
нэм кежлӧ	forever
вунӧдны	forget
прӧститны	forgive
вунӧдіс	forgot
вилки	fork
бала	form
лӧсьӧдны	form
формальнӧй	formal
вӧвлӧм	former
шуд вылӧ	fortunately
озырлун	fortune
нелямын	forty
нелямын кык	forty-two
водзӧ	forward
лелькуйтны	foster
тышкасис	fought
аддзис	found
подув	foundation
нёль	four
дас нёль	fourteen
руч	fox
тӧр	fragile
рамка	frame
подув	framework
пӧрйӧдлӧм	fraud
йӧй нисьӧ прӧсуж	freak
мездлуна	free
вӧльнӧй	free
мездлун	freedom
кынмыны	freeze
кынтыны	freeze
тшӧкыдлун	frequency
тшӧкыд	frequent
тшӧкыда	frequently
свеж	fresh
пекнича	friday
холодильник	fridge
кӧзӧд	fridge
ёрт	friend
восьса сьӧлӧма	friendly
ёртъяс	friends
ёртасьӧм	friendship
повзьӧм	frightened
повзьӧдчысь	frightening
лягуша	frog
водз	front
кынтӧм	frozen
фрукт	fruit
падмӧм	frustrated
ломтас	fuel
Фула	Fulfulde
тыр	full
гажӧдчӧм	fun
функция	function
подув	fundamental
гуасьӧм	funeral
тешкодь	funny
гӧн	fur
ярскӧб	furious
пызан-улӧс	furniture
водзӧ	further
та кындзи	furthermore
аскиа лун	future
чуктӧс	gain
босьтны	gain
ворсӧм	game
кост	gap
гараж	garage
лӧп-ёг	garbage
сад	garden
чеснӧк	garlic
вӧрӧта	gate
чукӧртны	gather
чукӧртчӧм	gathering
муртавны	gauge
сетіс	gave
пиньяса гӧгыль	gear
рӧд	gender
ӧтувъя	general
ставнас	generally
чужтыны	generate
кӧлена	generation
лышкыд	generous
гений	genius
жанр	genre
мелі	gentle
збыльвывса	genuine
жест	gesture
босьтны	get
пасьтасьны	get dressed
чеччыны	get up
ӧдйӧджык бурд	get well soon
ӧдйӧджык бурдӧй	get well soon
босьтӧм	getting
орт	ghost
кодкӧ пыдди уджалӧм	ghosting
зэв ыджыд	giant
козин	gift
имбир	ginger
нывка	girl
ныв	girl
нывъёрт	girlfriend
сетны	give
сетчыны	give up
сетӧм	given
дӧвӧлен	glad
син пыр нуӧдӧм	glance
син пыр нуӧдны	glance
стӧкан	glass
стеклӧ	glass
ӧчки	glasses
видзӧдлас	glimpse
став мувывса	global
букыш	gloomy
чуня кепысь	gloves
югъялӧм	glow
югъявны	glow
донӧдны	glow up
лем	glue
мунны	go
водзӧ висьталӧй	go ahead
водзӧ висьтав	go ahead
мун	go away
мунӧй	go away
водны узьны	go to bed
медшӧр мог	goal
могъяс	goals
кӧза	goat
ен	god
мед енмыс бурсиас	god bless you
мунӧ	goes
мунан	going
мунысь	going
лӧсьӧдчыны	going to
зарни	gold
мунӧма	gone
муніс	gone
дась	gonna
нильӧг	goo
бур	good
бур лун	good afternoon
аддзысьлытӧдз	good bye
бур лун	good day
бур рыт	good evening
бур удж	good job
мича	good looking
мед артмас	good luck
бур асыв	good morning
бур асыв, мусаӧй	good morning my love
бур вой	good night
аддзысьлытӧдз	goodbye
бурвоясьӧм	goodnight
вузӧсъяс	goods
Google	Google
Google Вуджӧдчысь	Google Translate
дзодзӧг	goose
зэв бур	gorgeous
суклясьны	gossip
босьтіс	got
ме гӧгӧрвои	got it
веськӧдлан котыр	government
кватитны	grab
сикасавны	grade
сикас	grade
вочасӧн	gradually
помавны	graduate
тусь	grain
грант	grant
вичмӧдны	grant
сетӧма	granted
виноград	grapes
шамыр	grasp
шамыртны	grasp
турун	grass
аттьӧалысь	grateful
аттьӧалӧм	gratitude
гу	grave
руд	gray
дзор	gray
тӧдчана	great
горшлун	greed
горш	greedy
турунвиж	green
чолӧмавны	greet
видзаавны	greet
чолӧмалӧм	greeting
чолӧмалӧмъяс	greetings
руд	grey
сетка	grid
шог	grief
изны	grind
шамыр	grip
шамыртны	grip
сёян-юан лавка	grocery
верӧспу	groom
кыз	gross
му	ground
котыр	group
чукӧр	group
быдмыны	grow
быдмӧм-сӧвмӧм	growth
ропкысь	grumpy
Гуарани	Guarani
сетны гарантия	guarantee
видзысь	guard
тӧдмавны	guess
гӧсьт	guest
веськӧдлӧм	guidance
нуӧдысь	guide
нуӧдны	guide
мыжа	guilty
зон	guy
ёртъяс	guys
спортзал	gym
ӧбича	habit
оланін	habitat
шер	hail
юрси	hair
джын	half
посводз	hall
ки	hand
вуг	handle
вороп	handle
мича	handsome
ӧшавны	hang
кадсӧ коллявны	hang out
лоны	happen
лоис	happened
шуд	happiness
шуда	happy
чужан лунӧн	happy birthday
чужан лунӧн тэнӧ	happy birthday to you
чужан лунӧн тіянӧс	happy birthday to you
выль воӧн	happy new year
чорыд	hard
ӧдва	hardly
пӧшти некор оз	hardly ever
лёктор	harm
лёктор вӧчны	harm
лёктор ваян	harmful
лӧсялӧм	harmony
ёсь	harsh
урожай	harvest
мустӧмтны	hate
NА	have
лунтӧ бура коллявны	have a good day
бура коллявны лунсӧ	have a nice day
завтракайтны	have breakfast
гажӧдчыштӧй	have fun
гажӧдчышт	have fun
ті сёйӧмаӧсь	have you eaten
тэ сёйӧмыд	have you eaten
кодлӧн эм	having
ӧпаснӧйтор	hazard
ру	haze
сійӧ	he
сылӧн эм	he has
сійӧ лоӧ	he is
юр	head
юр висьӧм	headache
бурдӧдны	heal
бурдӧдӧм	healing
дзоньвидзалун	health
дзоньвидза	healthy
кывны	hear
кывліс	heard
сьӧлӧм	heart
пӧсявны	heat
пӧсь	heat
пымавны	heat
енэж	heaven
сьӧкыд	heavy
шызьӧм	hectic
вылна	height
судта	height
наследник	heir
гусясьӧм	heist
кутны	held
ад	hell
Видза оланныд	Hello
чолӧм, донаӧй	hello dear
чолӧм, кыдзи олан	hello how are you
чолӧм, кыдзи оланныд	hello how are you
чолӧм, кыдзи оланныд-выланныд	hello how are you doing
чолӧм, кыдзи олан-вылан	hello how are you doing
шлем	helmet
отсӧг	help
колана	helpful
сідзкӧ	hence
сійӧс	her
стада	herd
тані	here
кольӧмтор	heritage
падъявны	hesitate
Эй	Hey
Чолӧм	Hi
чолӧм, кыдзи олан	hi how are you
чолӧм, кыдзи оланныд	hi how are you
Чолӧм	Hi there
дзебӧм	hidden
дзебсьыны	hide
дзебсясьны	hide
иерархия	hierarchy
джуджыд	high
кузь	high
тӧдчӧдны	highlight
походӧ ветлыны	hike
походъясӧ ветлӧм	hiking
гажа	hilarious
керӧс	hill
сійӧс	him
сылӧн	him
гаравны	hint
лядьвей	hip
лядьвейяс	hips
медавны	hire
медалӧм	hiring
сійӧс	his
сылӧн	his
история	history
вартны	hit
нӧйтны	hit
кучкыны	hit
Хм	Hmm
хобби	hobby
видзны	hold
кутны	hold
кутчысьны	hold on
розь	hole
гаж	holiday
тӧщӧ	hollow
тыртӧм	hollow
керка	home
горт	home
гортса удж	homework
веськыд	honest
веськыда	honestly
Ма	Honey
Дона	Honey
чесьт	honor
юркыш	hood
вугыр	hook
чеччыштавны	hop
лача кутны	hope
лача	hope
ме надейтча	hopefully
тӧлктӧм	hopeless
водса	horizontal
сюр	horn
весьӧпӧртана	horrible
полӧм	horror
вӧв	horse
бурдӧдчанін	hospital
гӧсьтъяслы восьсалун	hospitality
кӧзяин	host
примитны	host
лӧг кутысь	hostile
пӧсь	hot
пым	hot
туйморт керка	hotel
час	hour
часъяс	hours
керка	house
горт	house
гортсаяс	household
овмӧс	household
кыдзи	how
а тэ	how about you
а ті	how about you
кыдзи тэ	how are you
кыдзи олан-вылан	how are you doing
кыдзи талун олан-вылан	how are you doing today
кыдзи ті талун	how are you today
кыдзи тэ талун	how are you today
видза оланныд	how do you do
кыдзи	how is
кымын	how many
кымын	how much
ёна-ӧ тшӧкыда	how often
кымын тэныд арӧс	how old are you
кыдзи колис тэнад луныд	how was your day
кыдзи колис тіян лунныд	how was your day
кыдзи колис тіян рытныд	how was your night
кыдзи колис тэнад рытыд	how was your night
сӧмын	however
но	however
шӧрин	hub
кӧзяинӧй	hubby
кутлыны	hug
сыв	hug
сывъявны	hug
зэв ыджыд	huge
морт	human
рам	humble
уль	humid
васӧдлун	humidity
сё	hundred
тшыг	hungry
вӧравны	hunt
бушков	hurricane
тэрмасьны	hurry
тэрмасьышт	hurry up
тэрмасьыштӧй	hurry up
висьны	hurt
доймыны	hurt
верӧс	husband
тойласьны	hustle
тойласьӧм	hustle
чом	hut
гигиена	hygiene
Ме	I
Ме лоа	I am
Менам ставыс бур	I am fine
Ме кужа	I can
Ме верма	I can
Ме ог вермы	I can't
Ме вӧча	I do
Ме ог тӧд	I do not know
Ме ог гӧгӧрво	I do not understand
Ме ог	I don't
Ме ог тӧд	I don't know
Ме ог гӧгӧрво	I don't understand
мый тэ шуан	I don't understand what you mean
мый ті шуанныд	I don't understand what you mean
Ме ог гӧгӧрво	I don't understand what you mean
Ме тіянӧс ог гӧгӧрво	I don't understand you
Ме тэнӧ ог гӧгӧрво	I don't understand you
Ме ог тӧд	I don’t know
Ме ог гӧгӧрво	I don’t understand
колӧкӧ	i guess
Менам вӧлі	I had
Менам эм	I have
Ме вӧлі	I have been
Ме надейтча	I hope so
Ме тӧда	I know
Меным кажитчӧ	I like
Ті меным кажитчанныд	I like you
Тэ меным кажитчан	I like you
Ме радейта	I love
Ме радейта ыджыдджык вокӧс	I love my big brother
Ме радейта ыджыдджык чойӧс	I love my big sister
Ме радейта батьӧс	I love my father
Ме радейта ичӧтджык вокӧс	I love my little brother
Ме радейта ичӧтджык чойӧс	I love my little sister
Ме радейта мамӧс	I love my mother
Ме радейта тэнӧ	I love you
Ме тэнӧ сэтшӧма радейта	I love you so much
Ме тэнӧ сэтшӧм ёна радейта	I love you so much
Ме тшӧтш тэнӧ радейта	I love you too
Ме тшӧтш тіянӧс радейта	I love you too
Ме ног	I mean
Ме гажтӧмтча тэысь	I miss you
Ме сэтшӧма тэысь гажтӧмтча	I miss you so much
Ме сэтшӧма тіянысь гажтӧмтча	I miss you so much
Ме аддза	I see
Ме чайта	I think
Ме гӧгӧрвоа	I understand
Ме кӧсъя	I want
Ме кӧсъя тэнӧ аддзывны	I want to see you
Ме кӧсъя тіянӧс аддзывны	I want to see you
Ме тэнӧ кӧсъя	I want you
Ме вӧлі	I was
Ме лоа	I will
Ме кута	I will
Ме эськӧ	I would be
Ме лоа	I'm
Менам ставыс бур	I'm fine
Менам ставыс бур	I'm good
Ме тані	I'm here
Меным жаль	I'm sorry
йи	ice
мороженӧй	ice cream
мӧвп	idea
идеал	ideal
ӧткодь	identical
индыны	identify
аслыспӧлӧслун	identity
мӧмӧт	idiot
весь олысь	idle
кӧ	if
ӧтдортны	ignore
висьысь	ill
оланпас торкысь	illegal
висьӧм	illness
Илоканскӧй	Ilocano
пертас	image
думыштлыны	imagine
пырысь-пыр	immediate
пырысь пыр	immediately
дзик пыр	immediately
зэв ыджыд	immense
тӧдчӧм	impact
тӧдчыны	impact
терпенньӧтӧм	impatient
збыльмӧдны	implement
вайны	import
вайӧм	import
тӧдчана	important
кӧвъявны	impose
позьтӧм	impossible
шензьӧдны	impress
сьӧлӧмӧ кольӧм	impression
мӧрччан	impressive
бурмӧдны	improve
бурмӧдӧм	improvement
пытшкын	in
содтӧд	in addition
Збыльвылас	In fact
водзын	in front of
медым	in order to
позьтӧм	inappropriate
ышӧдантор	incentive
лоӧмтор	incident
пыртны	include
пыртӧмӧн	including
доход	income
лӧсьыдтӧмлун	inconvenience
содтыны	increase
содӧм	increase
кыпӧдӧм	increased
кыптӧм	increased
вӧвлытӧм	incredible
збыльысь	indeed
асшӧр	independent
асшӧрлуна	independent
Индия	India
индыны	indicate
вуж	indigenous
морт	individual
промышленносьт	industry
бытьӧн лоана	inevitable
пузчужӧм кага	infant
инфекция	infection
помтӧмлун	infinity
ӧдӧм	inflammation
инфляция	inflation
тӧдчӧм	influence
тӧдчыны	influence
юӧртны	inform
юӧр	information
артмӧданторъяс	ingredients
наследство	inheritance
панас	initial
водзмӧстчӧм	initiative
доймалӧм	injured
доймӧм	injury
мыжтӧм	innocent
выльтор	innovation
запрос	inquiry
йӧймӧм	insane
гут-гаг	insect
дорйытӧм	insecure
пыртны	insert
пуктыны	insert
пытшкын	inside
пыдісянь гӧгӧрвоӧм	insight
сьӧлӧмӧн кылӧм	insight
сулавны	insist
узьтӧм	insomnia
ловби	inspiration
ышӧдны	inspire
сувтӧдны	install
пуктыны	install
вӧвлӧмтор	instance
здук	instant
пырысь-пыр	instant
пыдди	instead
пыдди	instead of
индӧдъяс	instructions
инструмент	instrument
дӧзмӧдны	insult
дӧзмӧдӧм	insult
страховка	insurance
вӧрзьӧдлытӧм	intact
зумыдлун	integrity
ӧтторъялун	integrity
дзоньлун	integrity
сюсь	intellectual
вежӧр	intelligence
велӧдчӧм	intelligent
кӧсйыны	intend
сиӧм	intended
зіль	intense
кӧсйӧм	intention
ӧтув уджавны	interact
ӧта-мӧдкӧд йитӧд	interaction
гаж петӧм	interest
интерес	interest
ыштӧм	interest
кӧсйысь	interested
интереснӧй	interesting
лӧсьыд	interesting
сюйсьыны	interfere
костса	intermediate
пытшкӧс	internal
войтыркостса	international
стажируйтчӧм	internship
вуджӧдны	interpret
вуджӧдчысь	interpreter
торкны	interrupt
интервью	interview
матысса	intimate
тӧдмӧдны	introduce
водзкыв	introduction
интроверт	introvert
сьӧлӧмӧн кылӧм	intuition
абу вына	invalid
думыштны	invent
уджаланторъяс	inventory
инвестируйтны	invest
туявны	investigate
корӧм	invitation
корны	invite
тшӧт сетны	invoice
тшӧт	invoice
пыртны	involve
корӧм	involved
гладитны	iron
утюг	iron
лоӧ	is
ді	island
торйӧдӧм	isolated
сетны	issue
мытшӧд	issue
мытшӧдъяс	issues
сійӧ	it
тайӧ лоӧ	it is
тайӧ вӧлі	it was
тайӧ лоӧ	it's
ставыс бур	it's ok
Ставыс бур	It's okay
тор	item
торъяс	items
сылӧн	its
Ме лоа	I’m
куртка	jacket
дзескыдін	jail
Тӧвшӧр	January
доз	jar
черлы	jaw
вежӧгтысь	jealous
дергайтны	jerk
ювелирнӧй мичмӧдчанторъяс	jewelry
удж	job
котӧртӧм	jogging
пырӧдчыны	join
ӧтувъя	joint
шмонь	joke
журналист	journalist
ветлӧм-мунӧм	journey
долыдлун	joy
ёрдны	judge
ёрдысь	judge
сок	juice
сора	july
чеччавны	jump
лӧддза-номъя	june
лӧп-ёг	junk
веськыд	just
прӧста	just
прӧста вӧчӧй тайӧс	just do it
прӧста вӧч тайӧс	just do it
ёрдӧм	justice
правдайтны	justify
Калааллисут	Kalaallisut
ёсь	keen
кутны	keep
эн личӧдчы	keep it up
энӧ личӧдчӧй	keep it up
кутіс	kept
кутӧм	kept
чайник	kettle
восьтан	key
чужъявны	kick
кага	kid
шмонитысь	kidding
вӧрк	kidney
челядь	kids
вины	kill
шань	kind
сикас	kind
быттьӧ	kinda
шаня	kindly
шаньлун	kindness
король	king
окавны	kiss
кухня	kitchen
лэбалысь змей	kite
каньпи	kitten
пидзӧс	knee
тӧдіс	knew
пурт	knife
рыцар	knight
тӧдны	know
тӧдӧмлун	knowledge
тӧдса	known
Коми	Komi
Конкани	Konkani
Крио	Krio
пас	label
пасъявны	label
удж	labor
удж	labour
тырмытӧмтор	lack
пос	ladder
ань	lady
пуктіс	laid
пуктӧма	laid
ты	lake
баля	lamb
чотысь	lame
лампа	lamp
пуксьыны	land
му	land
вӧр-ва	landscape
кыв	language
пидзӧс	lap
ыджыд	large
гырысь	large
бӧръя	last
бӧръя, но сэтшӧм жӧ тӧдчана	last but not least
ов	last name
сёр	late
неважӧн	lately
сёрӧнджык	later
медбӧръя	latest
бӧръя	latter
серавны	laugh
сералӧм	laughing
серам	laughter
вӧрзьӧдны	launch
лэдзны	launch
песласьӧм	laundry
оланпас	law
луд	lawn
юрист	lawyer
пуктыны	lay
пӧвст	layer
чертёж	layout
дыш	lazy
нуӧдны	lead
юрнуӧдысь	leader
кор	leaf
виялӧм	leak
виявны	leak
мыджсьыны	lean
чеччыштӧм	leap
чеччавны	leap
велӧдны	learn
велӧдӧм	learning
кӧртым	lease
медічӧт	least
медэтша	least
меддзоля	least
кучик	leather
шойччӧм	leave
кольны	leave
коръяс	leaves
нуӧдіс	led
нуӧдӧма	led
шуйгавыв	left
кок	leg
кольӧмтор	legacy
оланпас серти	legal
легенда	legend
оланпас серти	legit
прӧст кад	leisure
удждывны	lend
кузьта	length
этшаджык	less
урок	lesson
лэдзны	let
письмӧ	letter
салат-латук	lettuce
тшупӧд	level
вороп	leverage
кывкутӧм	liability
небӧгаин	library
нювны	lick
ылӧдчыны	lie
пӧръясьны	lie
ылӧдчӧм	lie
ылӧдлӧ	lies
олӧм	life
катӧдӧм	lift
катӧдны	lift
кокни	light
югыд	light
чард	lightning
кажитчыны	like
тыдалӧ	likely
сэтшӧм жӧ ногӧн	likewise
визь	line
Лингала	Lingala
йитӧд	link
лев	lion
кизьӧртор	liquid
лыддьӧг	list
кывзыны	listen
кывзысь	listening
кывйысь кывйӧ	literally
литература	literature
ёгӧсьтны	litter
ёг	litter
ичӧт	little
дзоля	little
ловъя	live
овны	live
мус	liver
олӧ	lives
олӧм	living
олан жыр	living room
дзодзув	lizard
сьӧкта	load
сӧвтны	load
тупӧсь	loaf
удждӧм	loan
татчӧс	local
меставывса	local
ин	location
иган	lock
изоляция	lockdown
кер	log
ваксьыны	lol
ӧтка	lonely
кузь	long
важӧн эг аддзысьлӧй	long time no see
видзӧдны	look
видзӧдлас	look
гартов	loop
личӧдны	loose
личыд	loose
ыджыд	lord
кутысь	lord
воштыны	lose
воштӧм	loss
вошӧм	lost
пай	lot
гора	loud
гӧстинӧй	lounge
муслун	love
радейтны	love
радейта тіянӧс	love you
радейта тэнӧ	love you
ӧтка	lovely
ляпкыд	low
улыс	lower
вернӧй	loyal
сьӧлӧм сетӧм	loyalty
мойвиӧм	luck
майбыр	lucky
Луганда	Luganda
кӧлуй	luggage
ёкмыль	lump
пажын	lunch
тыяс	lungs
син ёран мича	luxury
син ёран мич	luxury
ылӧдлана	lying
машина	machine
йӧй	mad
сямтӧм	mad
вежӧртӧм	mad
госпожа	madam
вӧчис	made
журнал	magazine
зэв мича	magnificent
пелькӧдчысь	maid
медшӧр	main
пыкны	maintain
кутны	maintain
отсавны	maintain
могмӧдӧм	maintenance
Майтхили	Maithili
майор	major
гырысь	major
кызвын	majority
керны	make
вӧчны	make
лӧсьӧдны	make up
вӧчны	make up
ай	male
вузасян шӧрин	mall
мужичӧй	man
айлов	man
веськӧдлыны	manage
веськӧдлӧм	management
менеджер	manager
быть колана	mandatory
манифест	manifest
асланьӧдны	manipulate
ног	manner
киӧн вӧчӧм	manual
кийыв	manual
уна	many
праздникӧн	many many happy returns of the day
марш	march
дор	margin
рынок	market
гӧтрасьӧм	marriage
верӧс сайын	married
гӧтыра	married
маска	mask
сьӧкта	mass
ыджыд	massive
кӧзяин	master
лӧсявны	match
лӧсялӧм	match
ёрт	mate
материал	material
математика	math
эмтор	matter
лоны тӧдчанаӧн	matter
кутны вежӧртас	matter
кисьмӧм	maturity
вермыны	may
ода-кора тӧлысь	may
вермас лоны	maybe
гашкӧ	maybe
менӧ	me
ме тшӧтш	me too
сёян	meal
петкӧдлыны	mean
скӧр	mean
вежӧртас	meaning
средствояс	means
кутіс вежӧртас	meant
кутіс тӧд вылын	meant
сэк кості	meanwhile
мерайтны	measure
муртавны	measure
мераяс	measures
яй	meat
медицина	medical
бурдӧдчантор	medicine
пыдісянь мӧвпалӧм	meditation
шӧркост	medium
паныдавны	meet
аддзысьлӧм	meeting
Мейтейлион	Meiteilon
сывны	melt
казьтылӧмъяс	memories
паметь	memory
мӧвпалана	mental
гаравны	mention
гаралӧм	mentioned
туйдысь-велӧдысь	mentor
вузасьысь	merchant
жалитӧм	mercy
сӧмын	merely
шуда рӧштво	merry christmas
гудыр-гадыр	mess
дзуг	mess
юӧр	message
няйт	messy
металл	metal
метод	method
шыръяс	mice
шӧр	middle
вой шӧр	midnight
вынйӧр	might
вын	might
ёнлун	might
кокньыд	mild
вежтас	milestone
военнӧй	military
йӧв	milk
лысьтны	milk
миллион	million
паныд шуны	mind
мывкыд	mind
мӧвпалан сям	mindset
шахта	mine
менам	mine
соравны	mingle
сорасьны	mingle
абуджык тӧдчана	minor
минут	minute
минутъяс	minutes
шензьӧдантор	miracle
дивӧ	miracle
рӧмпӧштан	mirror
быд сикас	miscellaneous
вильыш	mischievous
коньӧр	miserable
коньӧралӧм	misery
кольны	miss
гажтӧмтча тіянысь	miss you
гажтӧмтча тэысь	miss you
тырмытӧм	missing
мог, миссия	mission
ру	mist
шыбӧль	mistake
Мизо	Mizo
мобильнӧй	mobile
тешитчыны	mock
модель	model
небзьӧдны	moderate
шӧркодь	moderate
ӧнія	modern
вежавидзысь	modest
васӧд	moist
ва	moisture
улис	moisture
бала	mold
бала серти лӧсьӧдны	mold
лу	mold
вурдысь	mole
мам	mom
здук	moment
выльлун	monday
сьӧм	money
видзӧдны	monitor
ӧблезяна	monkey
тӧлысь	month
аскылӧм	mood
ловру	mood
лёк руа	moody
тӧлысь	moon
моральнӧй	moral
этш тӧдысь	moral
унджык	more
ыджыдджык	more
та кындзи	moreover
асыв	morning
ипотека	mortgage
медся	most
ёнджыкасӧ	mostly
мам	mother
вӧрзьӧм	motion
ышӧдӧм	motivation
гӧра	mountain
шыр	mouse
вом	mouth
мунны	move
легӧдны	move
вештыны	move
вӧрӧм	movement
ӧтмунӧм	movement
кино	movie
миссис	mrs
уна	much
няйт	mud
кружка	mug
мускул	muscle
музей	museum
тшак	mushroom
шылад	music
колӧ	must
коланлун	must
кывтӧм	mute
ӧтувъя	mutual
менам	my
Менам донаӧй	My dear
менам ёрт	my friend
Менам сынӧда пӧдушкаа пыжын тырыс змей чери	My hovercraft is full of eels
менам муслунӧй	my love
менам радейтӧмӧй	my love
менӧ шуӧны	my name is
пӧжалуйста	my pleasure
ачым	myself
гӧгӧрвотӧм	mysterious
гусятор	mystery
миф	myth
тув	nail
челядь руа	naive
ним	name
висьталӧм	narrative
векньыд	narrow
пеж	nasty
зывӧк	nasty
вӧк петкӧдана	nasty
канму	national
национальнӧй	national
войтырсикас	nationality
чужан	native
вӧр-ваӧн вӧчӧм	natural
вӧр-ва	nature
вукйӧдлӧм	nausea
орччӧн	near
дорын	near
орччӧн	nearby
муртса	nearly
пельк	neat
идӧра	neat
колана	necessary
сьылі	neck
сикӧтш	necklace
гӧля овны	need
коланлун	need
ковны	need
соссяна	negative
лёк	negative
ӧтдортны	neglect
нуӧдны сёрнитчӧмъяс	negotiate
орччӧн олысь	neighbor
гӧгӧрбок	neighborhood
ни ӧти	neither
племянник	nephew
воча пи	nephew
быдтор тӧдысь	nerd
нервнӧй	nervous
поз	nest
тыв	net
вез	network
нейтральнӧй	neutral
некор	never
некор энӧ сетчӧй	never give up
некор эн сетчы	never give up
веськодь	never mind
веськодь	nevermind
сы вылӧ видзӧдтӧг	nevertheless
выль	new
выльторъяс	news
мӧд	next
орччӧн	next to
шань	nice
нимкодь тӧдмасьны	nice to meet you
племяннича	niece
воча ныв	niece
вой	night
лёк вӧт	nightmare
ӧкмыс	nine
дас ӧкмыс	nineteen
ӧкмысдас	ninety
Абу	No
дерт	no problem
нинӧм понда	no way
некод	nobody
шум	noise
шума	noisy
ни ӧти	none
лун шӧр	noon
абу	nope
ни	nor
нормальнӧй	normal
войвыв	north
ныр	nose
кольӧмасьыс гажтӧмтчана	nostalgic
абу	not
он	not
оз	not
ньӧти	not at all
абу лёк	not bad
Оз ӧні	Not now
абу на	not yet
пасйӧд	note
пасйӧм	noted
нинӧм	nothing
казявны	notice
казяліс	noticed
казялӧма	noticed
эмакыв	noun
эмакывъяс	nouns
роман	novel
вӧльгым	november
ӧні	now
ӧні	nowadays
падмӧг	nuisance
ноль	null
гегдӧм	numb
позялӧм	numb
номер	number
медсестра	nurse
ӧрек	nut
мускат ӧрек	nutmeg
вердӧм	nutrition
кыв сетӧм	oath
тшӧгӧм	obesity
кывзысьны	obey
объект	object
мог	objective
уджмог	obligation
гудыр	obscure
видзӧдӧм	observation
видзӧдны	observe
сетчӧм	obsession
важмӧм	obsolete
мытшӧд	obstacle
босьтны	obtain
босьтіс	obtained
тыдалана	obvious
тыдалӧ	obviously
буракӧ	obviously
кадысь кадӧ	occasionally
уджсикас	occupation
занят	occupied
вӧвны	occur
лоны	occur
лоис	occurred
вӧчсьӧ	occurs
океан	ocean
йирым	october
тешкодь	odd
позянлунъяс	odds
дерт	of course
кусӧдӧм	off
увтыртана	offensive
вӧзйыны	offer
вӧзйӧм	offer
кабинет	office
официальнӧй	official
сука	often
тшӧкыда	often
О	Oh
збыльысь	oh really
вый	oil
ладнӧ	ok
бур, донаӧй	ok dear
бур, донаӧй	ok honey
бур, мусаӧй	ok my love
бура	okay
бур	okay
бур, мусаӧй	okay baby
бур, донаӧй	okay dear
дона	okay honey
бур, муса	okay honey
бур, менам муслунӧй	okay my love
пӧрысь	old
важ	old
важся	old
вылын	on
ӧтчыд	once
ӧти	one
ӧти кывйыд некор абу тырмымӧн	one language is never enough
лук	onion
онлайн	online
сӧмын	only
восьса	open
операция	operation
видзӧдлас	opinion
позянлунъяс	opportunities
позянлун	opportunity
паныд	opposite
бурӧ эскысь	optimistic
ног	option
позянлун	option
лоны вермана	optional
абу быть	optional
либӧ	or
апельсин	orange
вижовгӧрд	orange
тшӧктыны	order
арт	order
прӧстӧй	ordinary
котыр	organization
нырвизь	orientation
лоӧм	origin
аслыспӧлӧс	original
Оромо	Oromo
батьтӧм-мамтӧм	orphan
мӧд	other
мӧд ног	otherwise
колӧ	ought
миян	our
Миян мог: сетны позянлун быдлаын да быдӧнлы гӧгӧрвоны мирсӧ да петкӧдлыны асьнысӧ ас кывйӧн.	Our mission: to enable everyone, everywhere to understand the world and express themselves across languages.
Миян мог: лӧсьӧдны мир йылысь тӧдӧмлунъяс да вӧчны найӧс быдӧнлы восьсаӧн да коланаӧн.	Our mission: to organize the world's information and make it universally accessible and useful.
ортсысяньыс	out
бӧртас	outcome
снаряженньӧ	outfit
петысь	outgoing
розетка	outlet
мыгӧр	outline
ортсын	outside
нималана	outstanding
пач	oven
вывті	over
кӧнкӧ сэні	over there
комбинезон	overall
венны	overcome
юрын гартлӧм	overthinking
пикӧ воӧм	overwhelmed
весьӧпӧртана	overwhelming
лоны уджйӧза	owe
сюзь	owl
ас	own
кутны	own
кутысь	owner
ӧш	ox
ӧд	pace
гартны	pack
упаковка	package
мынтӧма	paid
мынтіс	paid
дой	pain
серпасавны	paint
краска	paint
серпас	painting
серпасасьӧм	painting
гоз	pair
блед	pale
ки пыдӧс	palm
рач	pan
пандемия	pandemic
шӧйӧвошӧм	panic
гач	pants
кабала	paper
рай	paradise
параллельнӧй	parallel
ыстӧмтор	parcel
прӧститӧм	pardon
бать-мам	parents
парк	park
попугай	parrot
петрушка	parsley
юкӧн	part
пырӧдчыны	participate
торъялана	particular
торйӧн	particularly
ёрт	partner
рытпук	party
ветлӧдлыны	pass
кольны	pass
вуджанін	passage
колис	passed
сьӧлӧмсянь сетчӧм	passion
биа	passionate
водзмӧстчытӧм	passive
гусякыв	password
кольӧм	past
йӧр	patch
юкӧн	patch
ордым	path
коньӧр	pathetic
терпенньӧ	patience
висьысь	patient
дӧзмытӧм	patient
сер	pattern
коставлӧм	pause
пода туй	pavement
мынтыны	pay
мынтысьӧм	payment
мир	peace
лӧнь	peaceful
персик	peach
йыв	peak
груша	pear
анькытш	peas
аслыспӧлӧс	peculiar
кудзасьны	pee
кудз	pee
кор	peel
кыш	peel
тшӧтшъя	peer
тшӧтшъяяс	peers
ручка	pen
карандаш	pencil
виччысиг	pending
йӧз	people
гормӧг	pepper
гӧгӧрвоны	perceive
гӧгӧрвоӧм	perception
тыр-бур	perfect
вӧчны	perform
вӧчны верманлун	performance
вермас лоны	perhaps
кадколаст	period
вежласьтӧм	permanent
лэдзӧм	permission
лэдзны	permit
личлэдзлытӧмлун	perseverance
сетчытӧм	persistent
морт	person
ас	personal
морт	personality
видзӧдлас	perspective
эскӧдны	persuade
пеж морт	pervert
гортса пемӧс	pet
фаза	phase
петкӧдчӧм	phenomenon
философия	philosophy
телепон	phone
фото	photo
кывйитлӧс	phrase
физическӧй	physical
ӧктыны	pick
босьтны	pick up
лэптыны	pick up
серпас	picture
тор	piece
торъяс	pieces
порсь	pig
гулю	pigeon
чукӧр	pile
юрлӧс	pillow
пилот	pilot
булавка	pin
ананас	pineapple
кельыдгӧрд	pink
гӧп	pit
медджуджыдін	pitch
джуджда	pitch
жалитӧм	pity
ин	place
инавны	place
инъяс	places
чума	plague
ясыд	plain
план	plan
самолёт	plane
быдмӧг	plant
быдмӧгъяс	plants
тасьті	plate
платформа	platform
пьеса	play
ворсны	play
ворсысь	playing
лӧсьыд	pleasant
пӧжалуйста	please
бур вылӧ	please
могмӧдны	please
дӧвӧль	pleased
сьӧлӧм бурмӧдантор	pleasure
кыв сетӧм	pledge
уна	plenty
сюрӧс	plot
тупкыны	plug
слива	plum
ва нюжӧдысь	plumber
уна лыда	plural
подкаст	podcast
кывбур	poem
поэзия	poetry
чут	point
яд	poison
полиция	police
политика	policy
вежавидзысь	polite
няйтчӧдӧм	pollution
пруд	pond
варччанін	pool
сітасьны	poop
коньӧр	poor
гӧль	poor
потны	pop
нималана	popular
олысьяс	population
порсь яй	pork
рок	porridge
порт	port
ин	position
прамӧй	positive
кутны	possess
кутӧм	possession
асалан	possessive
лоны вермана	possible
пошта	post
йӧзӧдны	post
водзӧ вылӧ пуктыны	postpone
картупель	potato
позяна	potential
лоны вермана	potential
пунт	pound
гӧльлун	poverty
власьт	power
вын	power
вына	powerful
практическӧй	practical
практика	practice
практикуйтчыны	practice
ошкыны	praise
вильшалӧм	prank
кевмысьны	pray
дона	precious
буретш	precise
стӧча	precisely
водзвыв висьтавны	predict
ёнджыка радейтны	prefer
ёнджыка радейтӧм	preference
нӧбасьысь	pregnant
подувтӧм видзӧдлас	prejudice
мутас	premises
вылыс тшупӧда	premium
дасьтысьӧм	preparation
дасьтыны	prepare
дась	prepared
предлог	preposition
эм	presence
ӧнія	present
козин	present
петкӧдлӧм	presentation
кольны	preserve
президент	president
личкыны	press
газет-журнал	press
личкӧм	pressure
давленньӧ	pressure
лэдзчысьны	pretend
вель	pretty
мичаник	pretty
видзчысьны	prevent
воддза	previous
кыйдӧс	prey
дон	price
асьтӧ пыдди пуктӧм	pride
вичкоын служитысь	priest
медтӧдчана	primary
медшӧр	prime
принцесса	princess
веськӧдлысь	principal
воддза	prior
медтӧдчанатор	priority
дзескыдін	prison
йӧзӧдтӧмлун	privacy
аспом	private
торъя инӧд	privilege
приз	prize
вермас лоны	probably
мытшӧд	problem
процедура	procedure
водзӧ вӧчны	proceed
вӧдитны	process
вӧчны	process
вӧчӧм	process
вӧчны	produce
вӧчӧмтор	product
производство	production
уджсикас	profession
профессионал	professional
профиль	profile
чӧжӧс	profit
пыді	profound
сӧвмӧм	progress
сӧвмыны	progress
проект	project
нималана	prominent
кӧсйысьӧм	promise
кӧсйысьны	promise
сӧвмӧдны	promote
кыпӧдӧм	promotion
тэрыб	prompt
кымыньӧн куйлысь	prone
нимвежтасъяс	pronouns
шуанног	pronunciation
докажитӧм	proof
колана	proper
колана ногӧн	properly
аслыспӧлӧслунъяс	properties
ас эмбур	property
вӧзйӧм	proposal
аскиа лун	prospect
дзордзалӧм	prosperity
дзоридзалан	prosperous
дорйыны	protect
тшап	proud
эскӧдны	prove
сетны	provide
могмӧдны	provide
могмӧдӧм	provided
обласьт	province
могмӧдӧм	provision
тыр вир-яйӧ воӧм	puberty
восьса	public
кыскыны	pull
тыква	pumpkin
чочкӧм	punctual
велӧдчысь	pupil
ньӧбны	purchase
сӧстӧм	pure
гӧрдовлӧз	purple
мог	purpose
кӧшель	purse
вӧтчыны	pursue
вӧтлысьны	pursuit
вӧтлысьӧм	pursuit
йӧткыны	push
пуктыны	put
кужанлун	qualification
квалификация	qualification
качество	quality
мында	quantity
карантин	quarantine
пинясьны	quarrel
пинясьӧм	quarrel
нёльӧд пай	quarter
Кечуа	Quechua
королева	queen
ӧксань	queen
аслыссяма	queer
корӧм	query
юалӧм	question
ӧчередь	queue
сувтны ӧчередьӧ	queue
тэрыб	quick
ӧдйӧ	quickly
лӧнь	quiet
лестукъясысь вурӧм эшкын	quilt
эновтны	quit
шыблавны	quit
вель	quite
дзик	quite
юасьӧм	quiz
цитата	quotation
цитата	quote
ыстысьны	quote
цитатаяс	quotes
кӧч	rabbit
кролик	rabbit
панласьӧм	race
ярлун	rage
зэр	rain
зэрны	rain
кыпӧдны	raise
кыпӧдчӧм	raise
лэптіс	raised
лэптӧм	raised
котраліс	ran
водзвыв лӧсьӧдтӧм	random
рад	range
тэрыб	rapid
ӧдйӧ	rapidly
гежӧд	rare
шоч	rare
гежӧда	rarely
кисьталӧм	rash
крыса	rat
ӧд	rate
вель	rather
йитчӧм	ratio
ӧта-мӧд вылӧ тӧдчӧм	ratio
вежӧртана	rational
уль	raw
воны	reach
судзны	reach
шедӧдӧма	reached
шедӧдіс	reached
вочавидзӧм	reaction
лыддьыны	read
лыддьысьӧм	reading
дась	ready
збыльвывса	real
збыль	reality
гӧгӧрвоны	realize
гӧгӧрвоис	realized
гӧгӧрвоӧма	realized
збыльысь	really
бӧр	rear
помка	reason
тӧлка	reasonable
тӧд вылӧ вайӧдны	recall
квитанция	receipt
босьтны	receive
пӧлучитіс	received
неважӧнся	recent
неважӧн	recently
примитӧм	reception
вочаалӧм	reception
рецепт	recipe
вежӧртӧм	reckless
пыдди пуктӧм	recognition
тӧдмавны	recognize
вӧзйыны	recommend
вӧзйӧм	recommended
гижны	record
гижӧд	record
бурдны	recover
бурдӧм	recovery
веськыдсэрӧг	rectangle
гӧрд	red
вештыны	redeem
вештӧм	redemption
этшаммӧдны	reduce
чинтыны	reduce
ичӧтмӧдны	reduce
вывті ыджыд	redundant
ыстысьны	refer
ыстӧг	reference
петкӧдлыны	reflect
петкӧдчӧм	reflection
кутчысьны	refrain
кӧзӧд	refrigerator
вештыны	refund
вештӧм	refund
ӧткажитчыны	refuse
ӧткажитіс	refused
пыдди пуктыны	regard
кузя	regarding
видзӧдтӧг	regardless
чолӧм	regards
регион	region
пасйыны	register
каитчыны	regret
жалитны	regret
коставтӧм	regular
пыр	regularly
ӧтдортны	reject
йитчыны	relate
йитчӧм	related
йитӧдъяс	relationship
мыетшкӧ	relative
рӧдвуж	relative
рӧдвуж	relatives
шойччыштны	relax
мездмӧм	release
мездыны	release
мездмӧм	released
лӧсялана	relevant
зумыд	reliable
эскыны позяна	reliable
кокньӧдӧм	relief
кокньӧдны	relieve
кокнипырысь	relieved
эскӧм	religion
эскысь	religious
дышкодь	reluctant
мыджсьыны	rely
кольны	remain
кольӧм	remaining
тӧдчана	remarkable
бурдӧдчантор	remedy
тӧд вылын кутны	remember
тӧд вылӧ уськӧдны	remind
тӧд вылӧ уськӧдӧм	reminder
ылысса	remote
бырӧдны	remove
чышкыны	remove
сетны	render
кӧртымалӧм	rent
дзоньтавны	repair
мӧдысь вӧчны	repeat
вежны	replace
вочакыв	reply
вочавидзны	reply
юӧртны	report
доклад	report
петкӧдлыны	represent
ним	reputation
корны	request
корӧм	request
корны	require
корана	required
мездыны	rescue
туялӧм	research
мунны	resemble
лӧг кутӧм	resentment
бронируйтӧм	reservation
кольӧдны	reserve
олысь	resident
ӧткажитчыны	resign
зумыдлун	resilience
зумыд	resilient
водзсасьны	resist
водзсасьӧм	resistance
кывкӧртӧд	resolution
решитны	resolve
курорт	resort
ресурсъяс	resources
озырлун	resources
пыдди пуктыны	respect
пыдди пуктӧм	respect
вочавидзны	respond
вочакыв	response
кывкутӧм	responsibility
кывкутысь	responsible
шойччӧм	rest
югыдін да шоныдін	rest in peace
ресторан	restaurant
выль пӧв лӧсьӧдны	restore
дзескӧдны	restrict
бӧртас	result
бӧртасъяс	results
водзӧ вӧчны	resume
розничнӧй	retail
кольны	retain
кутӧм	retention
пенсия вылын	retired
бӧрыньтчыны	retreat
бӧр босьтны	retrieve
бӧр сетны	return
бӧр локны	return
восьтыны	reveal
восьтіс	revealed
водзӧс	revenge
чӧжӧс	revenue
бӧр	reverse
дженьыда висьталӧм	review
видлавны	review
прӧверитны	revise
выльысь видлалӧм	revision
революция	revolution
награда	reward
ритм	rhythm
ордлы	rib
рис	rice
озыр	rich
мынтӧдчыны	rid
ветлыны	ride
ветлӧм	ride
серам петкӧдлан	ridiculous
веськыдвыв	right
правлун	right
дзик ӧні	right now
чорыд	rigid
чунькытш	ring
кытш	ring
пожъявны	rinse
кыпӧдчӧм	riot
косявны	rip
косяссьӧм	rip
кисьмӧм	ripe
кыпӧдчыны	rise
кыпӧдчӧм	rise
риск	risk
рискуйтны	risk
конкурент	rival
ю	river
туй	road
пражитны	roast
ён	robust
из	rock
кырта	rock
ньӧр	rod
роль	role
гӧгыльтны	roll
вевт	roof
жыр	room
вуж	root
гез	rope
сісь	rotten
вежавидзтӧм	rough
чорыд	rough
гӧгӧр	roughly
кымын	roughly
гӧгрӧс	round
мунан туй	route
быдлунся	routine
рад	row
вуштыны	rub
зыртны	rub
резина	rubber
лӧп-ёг	rubbish
мывкыдтӧм	rude
вежавидзтӧм	rude
ковёр	rug
жугӧдны	ruin
правилӧ	rule
веськӧдлысь	ruler
правилӧяс	rules
индӧдъяс	rules
котӧртны	run
пышйыны	run
гӧнитны	run
котӧртысь	running
сиктса	rural
чепӧсйыны	rush
тэрмасьӧм	rush
сепыс	sack
вежа	sacred
жертва	sacrifice
абу ӧпаснӧй	safe
бура лэбны	safe flight
лёк суӧмысь видзӧм	safety
мывкыд морт	sage
шуис	said
плавайтны	sail
тӧвдӧра	sail
плавайтысь	sailing
плавайтӧм	sailing
понда	sake
удждон	salary
вузасьӧм	sale
чими	salmon
сов	salt
дзик жӧ сійӧ	same
Тані дзик жӧ сійӧ	Same here
видлӧг	sample
лыа	sand
Санскрит	Sanskrit
ёся тешитчан	sarcastic
збой	sassy
пукалі	sat
пукаліс	sat
сьӧлӧм бурмӧм	satisfaction
дӧвӧль	satisfied
могмӧдны	satisfy
сьӧлӧм бурмӧдысь	satisfying
Субӧта	Saturday
калбас	sausage
велӧдтӧм	savage
вӧй	savage
кид	savage
видзны	save
аддзыліс	saw
сёрнитны	say
масштаб	scale
ылӧдлӧм	scam
вурыс	scar
этшаӧн овлан	scarce
повзьӧдӧм	scared
шарп	scarf
повзьӧдчана	scary
разі-пели	scattered
сцена	scene
серпас	scenery
кӧр	scent
планируйтны	schedule
расписанньӧ	schedule
школа	school
наука	science
учёнӧй	scientist
туялысьяс	scientists
ножич	scissors
пинявны	scold
шымыртӧм	scope
тшӧт	score
курас-карас	scrap
сарпалӧм	scratch
сарпавны	scratch
горзыны	scream
экран	screen
винт	screw
сценарий	script
саридз	sea
печать	seal
корсьны	search
вогӧгӧрся кад	season
пуклӧс	seat
мӧд	second
секунд	second
гусятор	secret
юкӧн	section
лӧнь	secure
лёк суӧмысь видзӧм	security
аддзыны	see
аддзысьлам	see you
аддзысям сёрӧнджык	see you later
аддзысьлытӧдз	see you soon
регыд аддзысям	see you soon
аскиӧдз	see you tomorrow
кӧйдыс	seed
корсьны	seek
кажитчыны	seem
чайтсьӧ	seems
аддзылӧма	seen
кутны	seize
босьтӧм	seizure
асалӧм	seizure
корсюрӧ	seldom
бӧрйыны	select
ачыс	self
аснаукӧн бурдӧдчӧм	self healing
асьсӧ радейтысь	selfish
вузавны	sell
ыстыны	send
мӧдӧдны	send
ысты меным ассьыд фототӧ	send me your picture
ыстӧй меным ассьыныд фотонытӧ	send me your picture
ыджыд	senior
кылӧм	sense
тӧлка	sensible
ляб	sensitive
ыстіс	sent
ыстӧма	sent
сёрникузя	sentence
сёрникузяяс	sentences
торъя	separate
Сепеди	Sepedi
кӧч	september
сьӧрсьӧн-бӧрсьӧн мунӧм	sequence
сериал	series
авъя	serious
тӧлка	serious
серьёзнӧй	serious
збыльысь	seriously
служитны	serve
служба	service
сессия	session
лӧсьӧдны	set
набор	set
пуктыны	set
лӧсьӧдны	set up
ладмӧдӧм	setting
овмӧдчыны	settle
сизим	seven
дас сизим	seventeen
сизимдас	seventy
некымын	several
сьӧкыд	severe
вурны	sew
вурсьыны	sew
тс-с	sh
вуджӧр	shade
вуджӧр	shadow
таркӧдны	shake
колӧ	shall
ляпкыд	shallow
яндзим	shame
бала	shape
юксьыны	share
ёсь	sharp
сійӧ	she
сылӧн эм	she has
сійӧ лоӧ	she is
лэбув	shed
ыж	sheep
кабала тор	sheet
джадж	shelf
кыш	shell
юр сюянін	shelter
сайӧд пӧв	shield
вешйыны	shift
югъявны	shine
караб	ship
вайӧм	shipping
дӧрӧм	shirt
кӧм	shoes
лыйны	shoot
лыйсьыны	shoot
лавка	shop
ньӧбасьӧм	shopping
ва дор	shore
берег	shore
дженьыд	short
тырмытӧм	shortage
лыйны	shot
лыйӧм	shot
должен	should
пельпом	shoulder
горзыны	shout
петкӧдчӧм	show
петкӧдлыны	show
петкӧдлы меным	show me
петкӧдлӧй меным	show me
душ	shower
креветка	shrimp
пуксьыны	shrink
пӧдлавны	shut
вом пӧдлавны	shut up
яндысьысь	shy
вок али чой	sibling
чой-вок	siblings
висьысь	sick
дор	side
ышловзьӧм	sigh
аддзан	sight
нималанаторъяс видзӧдалӧм	sightseeing
пас	sign
кырымпас	signature
тӧдчана	significant
чӧв олӧм	silence
чӧв олысь	silent
чӧв	silent
шӧвк	silk
йӧй	silly
бӧб	silly
эзысь	silver
ӧткодь	similar
мӧмӧт	simp
прӧстӧй	simple
ӧттшӧтш	simultaneously
сьӧлӧмсянь	sincere
сьӧлӧмсянь	sincerely
сьывны	sing
сьылысь	singer
ӧтка	single
дзик ӧти	single
раковина	sink
вӧйны	sink
Ӧксай	Sir
чой	sister
монь	sister in law
пукавны	sit
ин	site
ситуация	situation
квайт	six
дас квайт	sixteen
квайтымын	sixty
ыджда	size
кужанлун	skill
сям	skills
кучик	skin
вӧсни	skinny
чеччавны	skip
юбка	skirt
енэж	sky
раб	slave
узьны	sleep
узьысь	sleeping
унзіль	sleepy
сос	sleeve
шӧрӧм	slice
шӧравны	slice
исковтны	slide
муртса	slightly
статя	slim
исковтны	slip
ньывк	slope
розь	slot
ньӧжмыд	slow
ньӧжйӧ	slowly
ичӧтик	small
дзоля	small
сюсь	smart
кӧр	smell
нюм	smile
нюмъявны	smile
куритчыны	smoke
тшын	smoke
мольыд	smooth
шыльыд	smooth
нуръясянтор	snack
лёльӧ	snail
змей	snake
колскӧдны	snap
лым	snow
лымъявны	snow
и сідз	so
сэтшӧм мусаник	so cute
ӧнӧдз	so far
сэтчӧдз	so far
йиджтыны	soak
майтӧг	soap
садь	sober
футбол	soccer
социальнӧй	social
котыр	society
йӧзкотыр	society
носки	socks
небыд	soft
уджтасулов	software
мусин	soil
вузалӧм	sold
вузаліс	sold
вузалӧма	sold out
салдат	soldier
под	sole
куш ӧти	sole
топыд	solid
кывкӧртӧд	solution
решитны	solve
некымын	some
мыйтакӧ	some
кодкӧ	somebody
кыдзкӧ	somehow
кодкӧ	someone
мыйкӧ	something
мукӧддырйи	sometimes
корсюрӧ	sometimes
сьыланкыв	song
регыд	soon
дзуг	sophisticated
Сорани	Sorani
доймӧм	sore
дой	sore
висьысь горш	sore throat
шог	sorrow
Прӧща кора	Sorry
сикасавны	sort
нырччис	sought
лов	soul
ас морт	soulmate
шы	sound
шыд	soup
шома	sour
ӧшмӧс	source
лунвыв	south
гӧгӧртас	space
спам	spam
коласт	span
Испания	Spanish
видзтыны	spare
запаснӧй	spare
сёрнитны	speak
аслыс сикас	special
торъялан	special
сикас	species
стӧч	specific
торъя	specific
синмӧ шыбитчан	spectacular
сёрни	speech
кыввортӧм	speechless
ӧд	speed
нимкыв	spell
лотны	spend
видзӧм	spent
ёсь кӧра	spicy
ёсь	spike
шеп	spike
бергӧдлыны	spin
шпинат	spinach
лов	spirit
сьӧлавны	spit
торъя бур	splendid
торъялӧм	split
торйӧдны	split
тшыкӧдны	spoil
тшыкӧм	spoiled
виччысьтӧм	spontaneous
пань	spoon
чут	spot
верӧс	spouse
паськӧдны	spread
тулыс	spring
квадрат	square
пычкыны	squeeze
кальмар	squid
ур	squirrel
вежа	st
начкыны	stab
зумыд	stable
сабри	stack
уджалысьяс	staff
сцена	stage
ляк	stain
пос	stairs
ставка	stake
за	stalk
лавка	stall
печать	stamp
сулавны	stand
стандартнӧй	standard
кодзув	star
заводитны	start
заводитӧм	started
тшыгъялысь	starving
аскылӧм	state
эскӧдны	state
шыӧдчӧм	statement
станция	station
статуя	statue
статус	status
кольччыны	stay
олӧм-вӧлӧм	stay
видз асьтӧ	stay safe
видзӧй асьнытӧ	stay safe
зумыд	steady
бифштекс	steak
гусясьны	steal
ру	steam
емдон	steel
крут	steep
за	stem
воськов	step
бедь	stick
чорыд	stiff
на	still
вӧрзьывтӧм	still
чушкыны	sting
скуп	stingy
гудравны	stir
запас	stock
гусялӧм	stolen
кынӧм	stomach
из	stone
сулаліс	stood
джек	stool
сувтлыны	stop
видзанін	storage
лӧдны	store
бушков	storm
висьт	story
плита	stove
веськыд	straight
веськыд	straightforward
напряженньӧ	strain
тешкодь	strange
тӧдтӧм	stranger
нуӧданног	strategy
идзас	straw
оз	strawberry
визь	streak
визув	stream
улич	street
эбӧс	strength
вынйӧр	strength
вын	strength
стресс	stress
нюжӧдны	stretch
стрӧг	strict
кучкӧм	strike
кучкысьны	strike
кучкыны	strike
струна	string
визь	strip
зільны	strive
кучкӧм	stroke
вына	strong
ён	strong
вартіс	struck
вартӧма	struck
тэчас	structure
тышкасьны	struggle
тыш	struggle
тышкасьысь	struggling
асныра	stubborn
сибдӧм	stuck
студент	student
туялӧм	study
туявны	study
туялӧм	studying
сюйны	stuff
чуймӧдана	stunning
йӧй	stupid
стиль	style
тор	subject
эмтор	subject
кывзысьӧм	submission
кывзысьны	submit
вещество	substance
вежантор	substitute
вежысь	substitute
вежны	substitute
ӧдва аддзана	subtle
артмыны	succeed
вермӧм	success
бура олысь	successful
бура уджалысь	successful
татшӧм	such
сэтшӧм	such as
кыдзи	such as
нёнявны	suck
виччысьтӧм	sudden
виччысьтӧг	suddenly
сьӧкыд нуны	suffer
страдайтӧм	suffering
тырмана	sufficient
сакар	sugar
вӧзйыны	suggest
вӧзйӧм	suggestion
костюм	suit
лӧсявны	suit
шогмана	suitable
чемодан	suitcase
ӧтувъя лыд	sum
сюрӧс	summary
гожӧм	summer
йыв	summit
шонді	sun
вежалун	sunday
шондіа	sunny
шонді пуксьӧм	sunset
шонді югыд	sunshine
зэв бур	super
медвылыс	superior
супервайзер	supervisor
ужын	supper
могмӧдны	supply
могмӧдӧм	supply
отсӧг	support
отсавны	support
чайтны	suppose
чайтана	supposed
дерт	sure
веркӧс	surface
кыпавны	surge
хирургия	surgery
ов	surname
чуймӧдны	surprise
чуймӧм	surprised
сетчыны	surrender
гӧгӧрса	surrounding
видзӧдӧм	surveillance
юасьӧм	survey
юасьны	survey
ловйӧн кольны	survive
чайтны мыжаӧн	suspect
мыжаӧн чайтана	suspect
ӧшӧдӧм	suspended
тӧдтӧм	suspicious
сетны отсӧг	sustain
зумыдлун	sustainability
зумыд	sustainable
лайкъявны	swag
ньылавны	swallow
вежласьны	swap
кыв сетны	swear
ёрччыны	swear
ньылӧм	sweat
свитер	sweater
чышкыны	sweep
юмов	sweet
юмов вӧтъяс	sweet dreams
юмов радейтысь	sweet tooth
сьӧлӧмшӧр	sweetheart
туктыны	swell
пыкӧс	swelling
варччыны	swim
варччӧм	swimming
качайтчыны	swing
гытсан	swing
переключайтны	switch
переключатель	switch
пыктӧм	swollen
шыпурт	sword
пас	symbol
сьӧлӧмсянь гӧгӧрвоӧм	sympathy
симптомъяс	symptoms
система	system
тэчас	system
пызан	table
решитавны	tackle
пас	tag
бӧж	tail
босьтны	take
мырддьыны	take away
видз асьтӧ	take care
пӧрччыны	take off
босьтӧм	taken
сёрнитны	talk
сёрни	talk
варов	talkative
джуджыд	tall
кузь	tall
кран	tap
кучкавны	tap
лента	tape
пуктыны мог	target
мишень	target
мог	task
видлыны	taste
кӧр	taste
чӧскыд	tasty
велӧдіс	taught
тшай	tea
велӧдны	teach
велӧдысь	teacher
команда	team
синва	tear
синва	tears
дэльӧдны	tease
вӧчанног	technology
пиньяс	teeth
сёрнитны	tell
висьтавны	tell
висьталӧй меным	tell me
висьтав меным	tell me
сям	temper
температура	temperature
вичко	temple
недыр кадся	temporary
дас	ten
дас сюрс	ten thousand
олысь	tenant
зільны	tend
нырвизь	tendency
мелі	tender
зэлалӧм	tense
зэлалӧм	tension
вон	tent
ылӧсас вӧчӧм	tentative
термин	term
условиеяс	terms
весьӧпӧртана	terrible
шензьӧдана	terrific
мутас	territory
прӧверяйтны	test
тест	test
гижӧд	text
текст	text
дорысь	than
аттьӧавны	thank
аттьӧ	thank you
Аттьӧ виччысьӧмсьыныд, сэк кості ми тӧдмалам, кӧні ыстӧмторйыс	Thank you for your patience while we investigate shipment
ыджыд аттьӧ	thank you so much
ыджыд аттьӧ	thank you very much
аттьӧ	thanks
Аттьӧ миян приложенньӧӧн вӧдитчӧмысь	Thanks for using our app
сійӧ	that
тайӧ лоӧ	that is
тайӧ бур	that's good
гусясьӧм	theft
налӧн	their
найӧс	them
тема	theme
асьнысӧ	themselves
сэк	then
теория	theory
сэні	there
эмӧсь	there are
эм	there is
сы вӧсна	therefore
тайӧяс	these
найӧ	they
найӧ лоӧны	they are
кыз	thick
гусясьысь	thief
лядьвей	thigh
вӧсни	thin
тор	thing
кӧлуй	things
мӧвпавны	think
коймӧд	third
косьмӧм горша	thirsty
дас куим	thirteen
комын	thirty
тайӧ	this
тайӧ лоӧ	this is
быд боксянь	thorough
пыдісянь	thorough
тырвыйӧ	thoroughly
найӧ	those
кӧть	though
мӧвпаліс	thought
мӧвп	thought
мӧвпалысь	thoughtful
мӧвпъяс	thoughts
сюрс	thousand
сунис	thread
грӧз	threat
повзьӧдлыны	threaten
куим	three
тагӧс	threshold
нимкодь	thrilled
дзоридзавны	thrive
горш	throat
пыр	through
мысти	through
быдлаті	throughout
шыблавны	throw
пев	thumb
гым	thunder
Четверг	Thursday
татшӧм ногӧн	thus
вӧрса лудік	tick
туӧм-ямӧм	tide
пельк	tidy
галстук	tie
кӧртавны	tie
тигр	tiger
дзескыд	tight
Тигринья	Tigrinya
кад	time
рам	timid
зэв ичӧтик	tiny
пом	tip
чай вылӧ	tips
шына	tire
мудз	tired
мудзӧм	tired
салфетка	tissue
ним	title
вӧвны	to be
лоны	to be
пӧжалӧм нянь шӧрӧм	toast
талун	today
кысъясысь кага	toddler
кок чунь	toes
ӧтлаын	together
ӧтвыв	together
асмогасянін	toilet
шуис	told
шуӧма	told
пыдди пуктӧм	tolerance
терпитны	tolerate
помидор	tomato
аски	tomorrow
кыв	tongue
тарыт	tonight
тшӧтш	too
босьтіс	took
инструмент	tool
инструментъяс	tools
пинь	tooth
медвылыс	top
йыв	top
сёрнитантор	topic
косялӧм	torn
мучитны	torture
мучитӧм	torture
ӧтувъя	total
инмӧдчыны	touch
сьӧкыд	tough
тур	tour
ки чышкӧд	towel
кар	town
пагӧдан	toxic
туй	trace
туй	track
вузасьны	trade
вузасьӧм	trade
оласног	tradition
нэмӧвӧйся	traditional
ветлӧм-мунӧм	traffic
туй	trail
поезд	train
велӧдӧм	training
визь	trait
сер	trait
серъяс	traits
водзӧ сетны	transfer
вуджӧм	transition
вуджӧдны	translate
пырыс тыдалана	transparent
транспорт	transport
нуӧм-вайӧм	transportation
нальк	trap
лӧп-ёг	trash
дой	trauma
путешествуйтны	travel
поднос	tray
озырлун	treasure
вӧдитчыны	treat
шыӧдчыны	treat
вӧдитчӧм	treatment
пу	tree
зэв ыджыд	tremendous
нырвизь	trend
видлӧм	trial
видлана	trial
трюк	trick
видліс	tried
курӧк	trigger
пезьдӧдны	trigger
тойыштны	trigger
вундыны	trim
ветлӧм	trip
лёкторъяс	trouble
лӧсьыдтӧмторъяс	trouble
мытшӧдъяс	trouble
гач	trousers
грузӧвик	truck
збыль	TRUE
багажник	trunk
дӧверитӧм	trust
дӧверитны	trust
эскыны	trust
збыль	truth
видлыны	try
Тсонга	Tsonga
труба	tube
Воторник	Tuesday
велӧдӧм	tuition
индюк яй	turkey
индюк	turkey
куркума	turmeric
бергӧдӧм	turn
кежӧм	turn
чукыль	turn
черепаха	turtle
велӧдысь	tutor
дас кык	twelve
кызь	twenty
кызь ӧти	twenty-one
Чви	Twi
кыкысь	twice
гартлыны	twist
кык	two
сикас	type
тшӧкыда паныдасьлысь	typical
урӧс	ugly
медбӧръя	ultimate
зонтик	umbrella
оз вермы	unable
чож	uncle
дядь	uncle
садьтӧм	unconscious
улын	under
улын	underneath
абу тырвыйӧ донъялӧм	underrated
гӧгӧрвоны	understand
гӧгӧрвоис	understood
гӧгӧрвоӧма	understood
зэв жаль	unfortunately
форма	uniform
аслыспӧлӧс	unique
вӧвлытӧм	unique
муртӧг	unit
единица	unit
университет	university
тӧдтӧм	unknown
абу кӧ	unless
оз кӧ	unless
аслыспӧлӧс	unusual
вылӧ	up
тіян сайын	up to you
тэ сайын	up to you
ӧнъяӧдӧм	update
ӧнъяӧдны	update
бурмӧдӧм	upgrade
бурмӧдны	upgrade
вылын	upon
шогӧ усьӧм	upset
жугыль	upset
карса	urban
кыскыны	urge
кыскӧм	urge
эновтны позьтӧм	urgent
миянлы	us
вӧдитчыны	use
вӧдитчӧм	use
вӧдитчӧм	used
буртор ваян	useful
колана	useful
ковтӧм	useless
быдлунся	usual
векджык	usually
пырджык	usually
оланін да коммунальнӧй овмӧс	utility
шойччан кад	vacation
отпуск	vacation
вакцинируйтӧм	vaccination
вакцина	vaccine
вакуум	vacuum
дзуг	vague
вына	valid
ковтыс	valley
дона	valuable
донъявны	value
дон	value
унасикаслун	variety
торъялан	various
уна нога	various
уна пӧлӧс	various
торъявны	vary
ваза	vase
паськыд	vast
град выв пуктас	vegetable
градвыв пуктас	vegetables
транспорт средство	vehicle
ваялысь	vendor
яд	venom
предприятие	venture
нуӧданін	venue
прӧверитны	verify
уна мога	versatile
уна нога	versatile
версия	version
сувтса	vertical
зэв	very
зэв бур	very good
доз	vessel
пыр	via
ру	vibe
сьӧлӧмӧн кылӧм	vibes
лёк	vicious
жертва	victim
видео	video
видзӧдлас	view
сикт	village
лёк морт	villain
уксус	vinegar
сулӧдӧм	vintage
мырдӧналӧм	violence
мырдӧна	violent
вируснӧй	viral
вӧрзьӧдлытӧм	virgin
ветлытӧм-мунтӧм ныв	virgin
виртуальнӧй	virtual
дон	virtue
гӧгӧрвоӧм	vision
волыны	visit
волӧм	visit
синмӧн аддзана	visual
зэв колана	vital
яръюгыд	vivid
кывкуд	vocabulary
гӧлӧс	voice
куш	void
кушин	void
йӧрыш	volume
ас кӧсйӧм серти вӧзйысьысь	volunteer
восны	vomit
вос	vomit
слаб	vulnerable
пуков	vulnerable
кокниа дӧзмысь	vulnerable
нажӧтка	wage
удждон	wages
кос	waist
виччысьны	wait
официант	waiter
виччысьысь	waiting
садьмӧдны	wake
садьмыны	wake up
ветлӧдлыны	walk
ветлӧдлӧм	walk
подӧн ветлӧм	walking
стен	wall
кӧшель	wallet
кытшлавны	wander
кӧсъян	wanna
окотитны	want
кӧсйыны	want
кӧсйис	wanted
война	war
шкап	wardrobe
видзанін	warehouse
шонтыны	warm
шоныд	warm
водзвыв ӧлӧдны	warn
ӧлӧдӧм	warning
воин	warrior
вӧлі	was
мыськыны	wash
видзны	waste
шыблас	waste
видзӧдны	watch
ва	water
арбуз	watermelon
гы	wave
туй	way
ми	we
ми лоам	we are
ми вермам	we can
омӧль	weak
слаб	weak
слаблун	weakness
озырлун	wealth
озыр	wealthy
новлыны	wear
новлысь	wearing
поводдя	weather
кӧлысь	wedding
Середа	Wednesday
ёг турун	weed
вежон	week
шойччан лунъяс	weekend
сьӧктӧдны	weight
сьӧкта	weight
тешкодь	weird
видза корам	welcome
бур олӧм	welfare
Бура	Well
молодеч	well done
муніс	went
вӧліны	were
рытыввыв	west
лапыд	wet
уль	wet
васӧд	wet
кит	whale
мый	what
а тэ	what about you
мый тэ вӧчан	what are you doing
мый тэ ӧні вӧчан	what are you doing now
мый тэ ӧні вӧчан	what are you doing right now
мый ті ӧні вӧчанныд	what are you doing right now
мый вӧчан	what do you do
мый вӧчанныд	what do you do
мыйӧн ті уджаланныд	what do you do for a living
мыйӧн тэ уджалан	what do you do for a living
мый йылысь тэ шуан	what do you mean
мый ті кӧсъянныд	what do you want
мый тэ кӧсъян	what do you want
мый лоис	what happened
мый лоӧ	what is
мый тайӧ	what is this
мыйсяма удж ті вӧчанныд	what is your job
мыйсяма удж тэ вӧчан	what is your job
кыдзи тэнӧ нимтӧны	what is your name
кыдзи тэнӧ шуӧны	what is your name
мый нӧ	what's up
кыдзи тіянӧс шуӧны	what's your name
кыдзи тэнӧ шуӧны	what's your name
быд	whatever
шобді	wheat
гӧгыль	wheel
кор	when
кор	whenever
кӧні	where
кӧні тэ	where are you
кытысь тэ	where are you from
ӧні ті кӧнӧсь	where are you now
ӧні тэ кӧні	where are you now
кӧні тэ олан	where do you live
кӧні ті оланныд	where do you live
кӧні	where is
кор	whereas
сэк	whereas
ли	whether
коді	which
кор	while
сэк кості	while
вашкӧдчӧм	whisper
вашкӧдны	whisper
шутьлявны	whistle
еджыд	white
коді	who
коді тэ	who are you
коді ті	who are you
коді лоӧ	who is
коді тайӧ	who is this
дзонь	whole
кодӧс	whom
кодлӧн	whose
мыйла	why
мыйла ог	why not
мыйла оз	why not
скӧр	wicked
паськыд	wide
дӧва	widow
пасьта	width
гӧтыр	wife
вӧрса	wild
кӧсйӧм	will
лоӧ	will
окотитысь	willing
вермыны	win
тӧв	wind
ӧшинь	window
тӧла	windy
вина	wine
тӧв	winter
чышкыны	wipe
сутуга	wire
мывкыдлун	wisdom
сюсь	wise
мывкыд	wise
кӧсйӧм	wish
сины	wish
сиа тіянлы став бурсӧ	wish you all the best
сиа тэныд став бурсӧ	wish you all the best
ёма	witch
корны	withdraw
вештыны	withdraw
бергӧдны	withdraw
кывкӧртӧд	withdrawal
пытшкын	within
аддзылысь	witness
висьтавны	witness
шмоньлив	witty
кӧин	wolf
ань	woman
аньяс	women
вермис	won
вермӧма	won
оз	won't
дивӧ	wonder
шемӧс	wonder
дивӧ кодь	wonderful
шемӧсмӧдана	wonderful
пу	wood
вурун	wool
кыв	word
кывъяс	words
удж	work
уджавны	work
тренируйтчыны	work out
уджалысь	working
мир	world
нидзув	worm
киссьӧм	worn
майшасьӧм	worried
майшасьны	worry
лёкджыка	worse
лёкджык	worse
копрасьны	worship
медлёк	worst
дон	worth
сулалӧ	worth it
сулалана	worthy
дой	wound
Ого	Wow
гартны	wrap
лӧглун	wrath
килутш	wrist
гижны	write
Гиж татчӧ	Write here
Гижӧй татчӧ	Write here
гижӧм	writing
гижӧм	written
лӧсявтӧм	wrong
абу веськыд	wrong
гижис	wrote
йӧр	yard
очсавны	yawn
очсыштӧм	yawn
Да	Yeah
во	year
вояс	years
шомӧс	yeast
горзыны	yell
кольквиж	yellow
Да	Yes
да, мусаӧй	yes baby
да, донаӧй	yes dear
да, донаӧй	yes honey
да, менам муслунӧй	yes my love
да, дерт	yes of course
тӧрыт	yesterday
нӧшта	yet
на	yet
сетчыны	yield
тэ	you
ті лоанныд	you are
тэ лоан	you are
тэ мича	you are beautiful
ті мичаӧсь	you are beautiful
ті сэтшӧм мичаӧсь	you are so beautiful
тэ сэтшӧм мича	you are so beautiful
бур вылӧ	you are welcome
нинӧмысь	you are welcome
тэ верман	you can
Тэ тӧдан	You know
Ті тӧданныд	You know
тэ тшӧтш	you too
бур вылӧ	you're welcome
том	young
тэнад	your
тіян бура гӧститӧдӧм	your welcome
асьнытӧ	yourself
асьтӧ	yourself
томлун	youth
томулов	youth
бур вылӧ	you’re welcome
чӧскыд	yummy
ноль	zero
