un	a
een bietje	a little
veul	a lot
veul	a lot of
veul van	a lot of
verloate	abandon
verloate	abandoned
gewjerzaame	abide
in sjoat zin	ability
meugelikheid	ability
capabel	able
euver	about
boave	above
boetelands	abroad
afwezigheid	absence
aafwezig	absent
absoluut	absolutely
absorbere	absorb
abstràk	abstract
absurd	absurd
euvervlood	abundance
euvervloedig	abundant
misbroek make	abuse
misbroek	abuse
aksènt	accent
acceptere	accept
toegank	access
ongeluk	accident
akkomodatie	accommodation
bereike	accomplish
behoald	accomplished
volgens	according
rekening	account
akkuraat	accuracy
akkuraat	accurate
besjuldigd	accused
pien	ache
bereike	achieve
prestaasie	achievement
bevestige	acknowledge
erkinne	acknowledge
kinnis	acquaintance
verwerve	acquire
kriege	acquire
verkreege	acquired
aakwieziesie	acquisition
euver	across
wit	act
akteere	act
doon	act
aksie	action
aktief	active
aktiviteite	activities
aktievieteit	activity
akteur	actor
konkreet	actual
wirkelik	actual
feitelik	actual
eigelik	actually
akuut	acute
aanpasse	adapt
aanvulle	add
versjlaaf	addicted
aanvulling	addition
aanvullende	additional
adrès	address
behuurlik	adequate
aadekwaat	adequate
aansjluutend	adjacent
derneve	adjacent
bievooglijk naamwoord	adjective
biesjtille	adjust
bewongere	admire
toegeve	admit
adoptere	adopt
leeflijk	adorable
veuroetgank	advance
veuroetgoon	advance
geavanceerd	advanced
veurdeil	advantage
avontuur	adventure
biewoord	adverb
reklaam	advertisement
advertensie	advertising
advies	advice
advies	advise
advokaat	advocate
èsteeties	aesthetic
zaak	affair
beïnvloede	affect
affektie	affection
permittere	afford
veurdeilig	affordable
betaalbaar	affordable
bang	afraid
noa	after
middig	afternoon
dernoa	afterwards
weer	again
tege	against
lèftied	age
buroo	agency
agènt	agent
àgrèssief	aggressive
behendig	agile
geleeje	ago
toesjtumme	agree
euvereinsjtumming	agreement
kontràk	agreement
landboew	agriculture
veuroet	ahead
ondersjteuning	aid
mikke	aim
doel	aim
loch	air
vleegveld	airport
rie	aisle
àlarm	alarm
alkoohol	alcohol
alèrt	alert
levend	alive
àlle	all
kump good	all right
al het biste	all the best
toesjtoon	allow
toegesjtange	allowed
bienoa	almost
allein	alone
langs	along
mit	along
al	already
Perfek	Alright
auch	also
alternatief	alternative
ondanks	although
altied	always
bin	am
fantastisch	amazing
ambiesjeus	ambiguous
ambietie	ambition
ambiesjeus	ambitious
aanpasse	amend
te midde van	amid
onger	among
onger os	among us
bedraag	amount
aantal	amount
amuzant	amusing
unne	an
analieze	analysis
veurouwersj	ancestors
anker	anchor
hiejel aud	ancient
en	and
en dich	and you
ingel	angel
kwadheid	anger
hook	angle
koad	angry
deer	animal
inkel	ankle
verjoardaag	anniversary
aankondiging	announcement
lestig valle	annoy
verveeld	annoyed
vervêlend	annoying
joarlijks	annual
ánoniem	anonymous
nog eine	another
antwoord	answer
antiesiepére	anticipate
geshpanne	anxiety
bang	anxious
einige	any
neet meer	anymore
weh dan auch	anyone
wat dan auch	anything
wie dan auch	anyway
wie dan auch	anyways
apaart	apart
appartemint	apartment
verontsjuldige	apologize
sjienbaar	apparent
bliekbaar	apparently
verzeuk	appeal
veurkome	appear
versjiening	appearance
versjene	appeared
appetiet	appetite
appel	apple
aanvroag	application
applicatie	application
inshrieve	apply
toepasse	apply
aafsproak	appointment
waardere	appreciate
waardering	appreciation
aanpak	approach
geshikte	appropriate
toesjtumming	approval
goodkeure	approve
toesjtoon	approve
goodgekeurd	approved
toegesjtoon	approved
òngeviër	approximately
april	april
willekeurig	arbitrary
arsjietèk	architect
arsjitektuur	architecture
archief	archive
zin	are
bis dich	are you
bis se druk	are you busy
bis se bezig	are you busy
bis se getrouwd	are you married
bis se getrouwd of alleinstoand	are you married or single
Bis se der nog?	Are you still there?
bis se doa	are you there
gebeed	area
diskussjere	argue
kawwele	argue
argumint	argument
ontsjtoon	arise
erm	arm
leeger	army
ongeveer	around
reigele	arrange
euvereinkoms	arrangement
arransjemint	arrangement
aankoms	arrival
aankome	arrive
aagekome	arrived
àrrogant	arrogant
piel	arrow
kuns	art
artiekel	article
kunsmaatig	artificial
arties	artist
wie	as
zwalang	as long as
auch	as well
en auch	as well as
esh	ash
besjaamp	ashamed
vroage	ask
gevroag	asked
sjloape	asleep
aspèk	aspect
Àssaméés	Assamese
áánvàl	assault
montaasj	assembly
assertief	assertive
beoordeile	assess
beoordeile	assessment
troef	asset
vermooge	assets
verzittinge	assets
toekinne	assign
opdrach	assignment
ondersjteune	assist
assistent	assistant
aangesjlote	associate
betrokke	associated
vereiniging	association
aannumme	assume
aanneumming	assumption
in	at
op	at
ten minste	at least
oat	ate
atleet	athlete
bievooge	attach
biegesjlote	attached
bielaag	attachment
aanvalle	attack
poging	attempt
biewone	attend
aanwezigheid	attendance
aandach	attention
opgelit	attention
hauwding	attitude
aantrikke	attract
attraksie	attraction
aantrikkelik	attractive
toebedeile	attribute
pebliek	audience
augustus	august
tant	aunt
tant	aunty
ootentiek	authentic
sjriever	author
autorieteite	authority
herfs	autumn
beshikbaar	available
gemiddeld	average
vermeide	avoid
wakker	awake
pries	award
bewus	aware
bewuszin	awareness
wèg	away
gewèldig	awesome
versjrikkelijk	awful
vrèm	awkward
Aimárá	Aymara
baby	baby
vriegezèl	bachelor
teruuk	back
achtergrond	background
shlèch	bad
tesj	bag
oas	bait
bàkke	bake
bekker	bakery
bàksodá	baking soda
balans	balance
bàl	ball
Bàmbárá	Bambara
bànáán	banana
bent	band
knàl	bang
bank	bank
bàr	bar
bienoa neet	barely
onderhandele	bargain
blàf	bark
blàffe	bark
gèrs	barley
barriejêre	barrier
basis	base
gebaseerd	based
kelder	basement
basis	basic
hoofzakelik	basically
básieliekum	basil
rotzak	bastard
serie	batch
bad	bath
badkamer	bathroom
batterie	battery
sjlaag	battle
sjtried	battle
baai	bay
zin	be
bis veurzichtig	be careful
sjtrand	beach
sjtroal	beam
boeëne	beans
bêr	bear
baard	beard
lager	bearing
invlood	bearing
bieës	beast
versjloon	beat
sjloon	beat
sjoeën	beautiful
sjwanheid	beauty
woort	became
omdat	because
were	become
bid	bed
sjloapkamer	bedroom
bie	bee
rundvleisj	beef
gewès	been
béér	beer
veur	before
begonne	began
beginne	begin
begin	begin
begin	beginning
ten bate van	behalf
gedraage	behave
gedrag	behavior
gedrag	behaviour
achter	behind
zin	being
geluif	belief
geluive	believe
boek	belly
thoeshuure	belong
geleefde	beloved
onder	below
reem	belt
bank	bench
buige	bend
onger	beneath
beveurdeile	benefit
veurdeil	benefit
veurdeile	benefits
doaneeve	beside
trouwes	besides
biste	best
veul suksès	best of luck
biste wunshe	best regards
beeter	better
tusje	between
drank	beverage
veurbie	beyond
Bójpoerie	Bhojpuri
sjtandpunt	bias
oardeil	bias
veurkeur	bias
veuringenome	biased
fietse	bicycle
fiets	bicycle
bod	bid
groewet	big
fiets	bike
rêkening	bill
in rêkening bringe	bill
binge	bind
voogel	bird
verjoardaag	birthday
bitje	bit
biete	bite
bitter	bitter
zsjwart	black
mes	blade
blaad	blade
besjuldige	blame
blanco	blank
deeke	blanket
knàlle	blast
knàl	blast
bleik	bleach
menge	blend
zegening	bless
gezegend	blessed
blind	blind
geluk	bliss
zalig	bliss
blok	block
blokkere	block
blood	blood
bleui	bloom
blooze	blow
blauw	blue
plàt	blunt
groof	blunt
raod	board
boot	boat
lief	body
koke	boil
vit	bold
band	bond
verbondj	bond
knook	bone
book	book
sjtimulans	boost
sjtimulans	booster
opsjtarte	boot
laarze	boots
grens	border
boorgaat	bore
vervele	bore
vervêld	bored
saai	boring
geboore	born
liejene	borrow
sjèf	boss
allebei	both
lestigvalle	bother
flèsj	bottle
onderkant	bottom
gekoch	bought
sjpringe	bounce
binge	bound
grenze	boundaries
buige	bow
komp	bowl
dwas	box
jong	boy
vrund	boyfriend
ermband	bracelet
hershenne	brain
tak	branch
aafdeiling	branch
merrik	brand
dapper	brave
dóórbraak	breach
broewed	bread
pauze	break
breke	break
doorbreke	break
oontbijt	breakfast
boorsj	breast
oaseme	breath
oaseme	breathe
ràs	breed
brik	brick
broed	bride
bruk	bridge
kort	brief
helder	bright
briljant	brilliant
mitnumme	bring
jong	bro
breit	broad
oetzinde	broadcast
platzak	broke
gebroke	broken
bezem	broom
broor	brother
sjzwoager	brother in law
gebrach	brought
broen	brown
kwàs	brush
ummer	bucket
vrund	buddy
budsjit	budget
insék	bug
boewe	build
boewe	building
geboew	building
geboet	built
bullik	bulk
sjtier	bull
pèskop	bully
bobbel	bump
houp	bunch
bundel	bundle
las	burden
begrave	buried
brenne	burn
bàrsjte	burst
knàl	burst
begrave	bury
bus	bus
sjtroek	bush
zaak	business
buuste	bust
druk	busy
mèr	but
boter	butter
vlinder	butterfly
knop	button
koupe	buy
bie	by
trouwens	by the way
daag	bye
koeël	cabbage
kabbinit	cabinet
keske	cabinet
kwai	cage
keek	cake
kauf	calf
belle	call
bel mich	call me
gebeld	called
benump	called
kalm	calm
gekomme	came
kampanje	campaign
kin	can
kin neet	can't
Annulere	Cancel
kanker	cancer
kapaabel	capable
vermooge	capacity
kapitaal	capital
hoofsjtad	capital
tietel	caption
gevànge	capture
vàsgelàg	capture
auto	car
karriêre	career
veurzichtig	careful
veurzichtig	carefully
achteloos	careless
zurgeloos	careless
verzurgend	caring
tummerman	carpenter
kerpit	carpet
wortel	carrot
draage	carry
doorgoon	carry on
oetveure	carry out
koffer	case
zaak	case
kontante	cash
werrepe	cast
veursjpelle	cast
kesjtieël	castle
gewoon	casual
kat	cat
vange	catch
kàttegorie	category
vieë	cattle
gevange	caught
veroorzaake	cause
reije	cause
veurzichtig	caution
waarsjuwing	caution
bedachzaam	cautious
grot	cave
ophoute	cease
plafon	ceiling
viere	celebrate
sèl	cell
sentrum	center
midden	center
eeuw	century
ontbijtgrane	cereal
seremonie	ceremony
zeekere	certain
zeker	certainly
sertifiekaat	certificate
kitting	chain
sjtool	chair
oetdaaging	challenge
prebleem	challenge
kans	chance
veràngere	change
cháòs	chaos
karakter	character
kenmirreke	characteristics
in rekening bringe	charge
leefdaadigheid	charity
leeflik	charming
grafiek	chart
jage	chase
achtervollige	chase
chèt	chat
goodkoup	cheap
valssjpele	cheat
valsj sjpele	cheating
vrêmgoon	cheating
kontroleer	check
wang	cheek
juiche	cheer
sjpas	cheerful
gezondheid	cheers
kieës	cheese
sjeikunde	chemistry
géémie	chemistry
koestere	cherish
sjake	chess
boorsjkas	chest
kauwe	chew
kip	chicken
sjèf	chief
kind	child
jeug	childhood
kinger	children
rilling	chill
sjoorsjtein	chimneys
kin	chin
sjokoláát	chocolate
keus	choice
keeze	choose
kappe	chop
taake	chores
dik	chubby
kirk	church
kannieël	cinnamon
sirkel	circle
omsirkele	circle
omsjandighede	circumstances
burger	citizen
sjtad	city
aansproak	claim
opheldere	clarify
verduudelijke	clarify
klas	class
klei	clay
zuuver	clean
helder	clear
lêgmaake	clear
bedeende	clerk
sjlum	clever
klant	client
klif	cliff
klimaat	climate
klum	climb
klumme	climb
plekkerig	clingy
klòk	clock
sjleete	close
kàs	closet
kleijding	cloth
kleijer	clothes
wollik	cloud
bewolk	cloudy
klauwn	clown
hint	clue
idee	clue
onhandig	clumsy
kluster	cluster
kootsj	coach
koeël	coal
kus	coast
jas	coat
kòffie	coffee
kognitief	cognitive
toevàl	coincidence
koud	cold
ineinsjtorte	collapse
kraag	collar
kòlleega	colleague
kòlléégaas	colleagues
kollèkteere	collect
verzaameling	collection
kolleesj	college
kleur	color
Kleurloze greun ideeje sjloape woedend	colorless green ideas slept furiously
kleur	colour
kolom	column
kamp	comb
kombienaasie	combination
combinere	combine
kom	come
kom hie	come here
kòm òp	come on
komfôr	comfort
comfortabel	comfortable
kome	coming
kump binnekort	coming soon
beveel	command
kommentaar	comment
kommersjeel	commercial
kommissie	commission
toeweije	commit
toewieding	commitment
toegewijd	committed
artiekel	commodity
normaal	common
kommuuniesere	communicate
kommuniekasie	communication
gemeinsjap	community
forense	commute
kompanjon	companion
mitgezel	companion
bedrief	company
vergelieke	compare
vergeliek	comparison
kompassie	compassion
mededogend	compassionate
gesjik	compatible
konkurrere	compete
kompetent	competent
kompetitie	competition
kompétitief	competitive
beklage	complain
klàg	complaint
aanvulling	complement
kompleet	complete
aafmake	complete
gans	completely
komplèks	complex
mitwirking	compliance
gehuurzame	compliance
noakomme	compliance
gecomplieseerd	complicated
komplieminteere	compliment
kompliemint	compliment
toesjtumme	comply
komposietie	composition
samesjtilling	composition
samestèlling	compound
begrip	comprehension
omvangriek	comprehensive
volledig	comprehensive
komproomie	compromise
verplich	compulsory
kompjoeter	computer
konsentraat	concentrate
konsep	concept
zurrig	concern
bezörg	concerned
konsèrt	concert
konkluusie	conclusion
konkreet	concrete
veurwaarde	condition
veurwaarde	conditions
gedrag	conduct
konferensie	conference
bekinne	confess
vertroewe	confidence
zeker	confident
bevestige	confirm
konflik	conflict
verward	confused
verwarring	confusion
profiesiejat	congrats
feliesietasie	congratulation
profisiat	congratulations
samevoogsel	conjunction
verbinge	connect
verovere	conquer
bewus	conscious
bewustzin	consciousness
toesjtumming	consent
gevollige	consequences
conversasie	conservation
konservatief	conservative
in ach numme	consider
euverwooge	considered
besjtoon	consist
konsiestensie	consistency
konsiestent	consistent
konsjtant	constant
konstant	constantly
konstiepasie	constipation
konsjtruksie	construction
konsumeere	consume
konsumptie	consumption
kontak	contact
besjmittelik	contagious
bevatte	contain
bevàt	contains
hededaags	contemporary
verachting	contempt
inhawd	content
wedsjtrijd	contest
konteks	context
kontinent	continent
doorgoon	continue
kontrak	contract
kontràs	contrast
biedrage	contribute
kontribuutie	contribution
besjture	control
behere	control
kontroversjeel	controversial
gemaak	convenience
handig	convenient
gesjprek	conversation
omzitte	convert
konvertere	convert
euverbringe	convey
euvertuuge	convince
euvertuug	convinced
kok	cook
koke	cook
koke	cooking
ruig	cool
samewirking	cooperation
omgoon	cope
verdrage	cope
kooper	copper
kern	core
maïs	corn
hook	corner
korrek	correct
koste	cost
kostuum	costume
huuske	cottage
hut	cottage
katoen	cotton
bank	couch
hoos	cough
kinne	could
road	council
tille	count
baalie	counter
tegesjtand	counter
land	country
platteland	countryside
koppel	couple
koeraasj	courage
baan	course
kursus	course
baan	court
gerech	court
belêfheid	courtesy
nêf	cousin
besjloon	cover
omsjlaag	cover
koow	cow
sjwaakeling	coward
gezellig	cozy
kràp	crab
bàrsj	crack
bàrsjte	crack
vaardigheid	craft
vàk	craft
rotzooi	crap
sjtront	crap
kreshe	crash
kresh	crash
zuch	craving
kroepe	crawl
gek	crazy
creëre	create
kreatief	creative
kredeet	credit
ingerd	creep
aakelig	creepy
sjtaf	crew
misdrief	crime
beshaamp	cringe
kriesis	crisis
krieteeria	criteria
krities	critical
gewichtig	critical
kritiek	criticism
gewàs	crop
gewasse	crops
kruus	cross
kruuze	cross
kreij	crow
meinigte	crowd
meinigte	crowded
kroeën	crown
kruusjaal	crucial
vreed	cruel
onmiensjelik	cruel
kroes	cruise
verbrijzele	crush
verleef	crush
huule	cry
sjrieëve	cry
komkommer	cucumber
knoevele	cuddle
kultuur	culture
sjluuw	cunning
tàs	cup
kas	cupboard
trottwaar	curb
genezing	cure
oavendklok	curfew
nuujsjierigheid	curiosity
benuujd	curious
gekrold	curly
valuuta	currency
huidige	current
op dit momènt	currently
vlook	curse
gerdien	curtain
kusse	cushion
op moat	custom
klant	customer
doewaan	customs
sjnieje	cut
knap	cute
sieklus	cycle
fietse	cycle
fiets	cycle
fietse	cycling
pap	dad
pap	daddy
daagelijks	daily
zuuvel	dairy
dam	dam
sjaa	damage
verdomd	damn
vochtig	damp
dans	dance
danse	dance
gevoar	danger
gevoarlik	dangerous
donker	dark
sjat	darling
besjprinkele	dash
sjpooje	dash
gegeves	data
aafsproak	date
datum	date
dochter	daughter
daag	day
dwad	dead
termien	deadline
dauf	deaf
omgoon	deal
deal	deal
biste	dear
Biste Allemoal	Dear All
Biste Klant	Dear Customer
Biste Ouwersj	Dear Parents
Biste Menieër	Dear Sir
Biste sjtudente	Dear students
Biste Tiem	Dear Team
dwad	death
deebàteere	debate
debet	debit
aafval	debris
sjuld	debt
désènium	decade
rotte	decay
euverleeje	deceased
misleide	deceive
bedreege	deceive
desember	december
gedege	decent
besjlisse	decide
besjlote	decided
besjlissing	decision
dik	deck
aafsjloon	decline
vermindere	decrease
toegewijd	dedicated
toewijding	dedication
akte	deed
doad	deed
deep	deep
hert	deer
sjtandaard	default
versjloon	defeat
verdedige	defend
vassjtille	define
àbsoluut	definitely
definiesie	definition
groad	degree
siefer	degree
vertroaging	delay
vertroag	delayed
verwijdere	delete
wisse	delete
bewus	deliberate
delikaat	delicate
overheerlijk	delicious
vreugd	delight
verheug	delighted
leevere	deliver
geleverd	delivered
levering	delivery
vroag	demand
gevroag	demanding
demokrasie	democracy
duuvel	demon
demonstrere	demonstrate
loate zeen	demonstrate
aafgesjlage	denied
dichtheid	density
tandarts	dentist
aafwieze	deny
aafdeiling	department
vertrik	departure
aafhange	depend
neerzitte	deploy
ontplooie	deploy
sjtorting	deposit
aanbetaling	deposit
déprèssief	depressed
depressie	depression
deepte	depth
omsjrieve	describe
besjrieving	description
woestijn	desert
verdeene	deserve
ontwerp	design
toekinning	designation
verlange	desire
buuro	desk
hopeloos	despair
wanhoopig	desperate
ondanks	despite
toetje	dessert
besjtumming	destination
loot	destiny
vernietige	destroy
vernieling	destruction
detai	detail
detaïs	details
detèktere	detect
vàsberoajeheid	determination
vas sjtille	determine
vasbesjlote	determined
der kapot van zeen	devastated
ontwikkele	develop
ontwikkeld	developed
ontwikkeling	development
apparaat	device
duuvel	devil
toegewijd	devoted
Dievéhie	Dhivehi
diabeetes	diabetes
diarréé	diarrhea
dàgbook	diary
woordebook	dictionary
deeg	did
sjterve	die
gesjtorve	died
diejeet	diet
versjil	difference
angesj	different
meuilijk	difficult
grave	dig
wêrdigheid	dignity
ieverig	diligent
oavendete	dinner
oetholling	dip
dip	dip
dirèk	direct
direksie	direction
dierekteur	director
drek	dirt
vies	dirty
oetsjakele	disable
oetgesjakeld	disabled
invalied	disabled
verdwiene	disappear
teleurgesjtild	disappointed
ramp	disaster
wegsjmiete	discard
aafgeve	discharge
vrieloate	discharge
dissiepliene	discipline
korting	discount
ontdikke	discover
diskriemienasie	discrimination
besjpreke	discuss
diskusjere	discuss
diskusjeere	discussion
krankheid	disease
ziektes	diseases
vermomme	disguise
afsjuuwelik	disgusting
sjootel	dish
bord	dish
gerechte	dishes
borde	dishes
aafwieze	dismiss
wegsjture	dispatch
sjerm	display
tentoewensjtille	display
weggwaje	disposal
oneinigheid	dispute
aafsjtand	distance
bepaald	distinct
ondersjieje	distinguish
noeëd	distress
verdeile	distribution
gebeed	district
sjtuure	disturb
sjloot	ditch
duuke	dive
divèrs	diverse
dieversieteit	diversity
verdeile	divide
goddelik	divine
sjeijing	divorce
duuzelig	dizzy
dooch	do
deis dich	do you
hil se van mich	do you love me
dokter	doctor
dokumint	document
deit	does
deit neet	doesn't
hond	dog
Doogrie	Dogri
doon	doing
pop	doll
domein	domain
hoeshouwelik	domestic
dominant	dominant
neet	don't
Maak dich neet druk	Don't worry
donere	donate
gedoan	done
ezel	donkey
vit	dope
dubbel	double
twiefel	doubt
deig	dough
onder	down
douwnlood	download
konsep	draft
sjleipe	drag
lêgloate	drain
dramaa	drama
trik	draw
láá	drawer
teikening	drawing
sjrik	dread
druime	dream
druim	dream
jurk	dress
aandoon	dress
boor	drill
bore	drill
drinke	drink
drank	drink
rieje	drive
vàl	drop
loate valle	dropped
druuwegte	drought
zaat	drunk
druuwig	dry
bukke	duck
eend	duck
gas	dude
tegood	due
door	due
door toedoon van	due to
bot	dull
dom	dumb
dumpe	dump
doer	duration
onderwieles	during
sjtof	dust
plich	duty
verblieve	dwell
dwad goon	dying
ellike	each
ein	each other
gretig	eager
adelêr	eagle
oeër	ear
ierder	earlier
vreug	early
verdeene	earn
oeëre	ears
êrd	earth
aardbeving	earthquake
gemaak	ease
gemekkelik	easily
oeëste	east
gemekkelik	easy
ete	eat
ete	eating
economies	economic
eekonomie	economy
rand	edge
bewirke	edit
onderwies	education
effek	effect
effektief	effective
effiesjensie	efficiency
effisjent	efficient
meuite	effort
ei	egg
obersjien	eggplant
éégo	ego
àch	eight
achttieën	eighteen
tachetig	eighty
of waal	either
oetwijde	elaborate
ellebwag	elbow
ouwer	elder
ouwere	elder
ouwer luuj	elderly
eelegant	elegant
elemint	element
olifant	elephant
ilf	eleven
in aanmerking komme	eligible
gesjik	eligible
eliminere	eliminate
andersj	else
beshaamp	embarrassed
besjamend	embarrassing
omsjloon	embrace
opkomme	emerge
sjpoodgeval	emergency
emosjoneel	emotional
empaatie	empathy
noadruk	emphasis
benoadrukke	emphasize
medewirker	employee
personeel	employees
werkgever	employer
werk	employment
lêg	empty
aktivere	enable
meugelijk make	enable
tegekomme	encounter
mood	encourage
eind	end
bedreigd	endangered
sjtreve	endeavor
insjpanning	endeavor
oethouwingsvermoge	endurance
verdoere	endure
vijand	enemy
éénerzjie	energy
in wirking sjtille	engage
betrokke	engaged
bezig	engaged
verloving	engagement
betrokkenheid	engagement
mooter	engine
inshenjeur	engineer
Ingelsj	English
vergroewete	enhance
geniete	enjoy
enorm	enormous
genog	enough
verzekere	ensure
bevestige	enter
toegank	enter
amuusemint	entertainment
enthoesjasme	enthusiasm
entoesjas	enthusiastic
ganz	entire
rech op	entitled
aansproak make op	entitled
entieteit	entity
ingank	entrance
ondernummer	entrepreneur
envellop	envelope
omgeeving	environment
sjaloezie	envy
épies	epic
epidemies	epidemic
geliek	equal
materiaal	equipment
rechvaardigheid	equity
gelieke	equivalent
gum	eraser
fout	error
ontsjnappe	escape
mit name	especially
proofsjtuk	essay
essensie	essence
veurnaamste	essential
vestige	establish
opgerich	established
veuraanstoande	established
landgood	estate
sjatting	estimate
insjatte	estimate
gesjat	estimated
en zoë wiejer	etc
ieëwig	eternal
etiek	ethics
beoërdeile	evaluate
evaluasie	evaluation
eve	even
geliek	even
hoewaal	even though
oavend	evening
evenemint	event
oeteindelik	eventually
ooit	ever
eedere	every
eederein	everybody
eederein	everyone
alles	everything
bewies	evidence
koad	evil
ontwikkeling	evolution
evoluutie	evolution
ontwikkele	evolve
Éwe	Ewe
ex	ex
presies	exact
presies	exactly
exame	exam
besjtudére	examine
veurbeeld	example
euvertreffe	exceed
oetsjtekend	excellent
behalleve	except
oetzondering	exception
teveul	excess
euvervlood	excess
errig veul	excessive
oetwisseling	exchange
oetwissele	exchange
gesjpanne	excited
sjpanning	excitement
sjpannend	exciting
allein	exclusive
ekslusief	exclusive
ekskuus	excuse
sorrie	excuse me
het sjpiet mich	excuse me
oetveure	execute
eksekuusie	execution
oetveure	execution
leidinggevende	executive
oefening	exercise
oetloat	exhaust
oetgeput	exhausted
vertoeëne	exhibit
tentoeënsjtille	exhibit
tentoeënsjtilling	exhibition
besjtoon	exist
besjtoon	existence
besjtoand	existing
oetgank	exit
oetbreije	expand
verwach	expect
verwach	expected
oetgaves	expenses
deur	expensive
ervaaring	experience
ekspérimint	experiment
ekspérimintere	experiment
ekspêr	expert
verloupe	expired
oetligge	explain
verkloaring	explanation
oetbuite	exploit
verkinne	explore
eksport	export
eksportere	export
blwatsjtille	expose
ontdik	exposed
blwatsjtilling	exposure
oetdrukke	express
oetdrukking	expression
oetdrukke	expression
verlenge	extend
oetbreije	extend
oetgebreid	extended
verlengd	extended
oetsjtil	extension
umvank	extent
van boetenaaf	external
oetgesjtorve	extinct
èxtraa	extra
aafleie	extract
oettriksel	extract
biezonder	extraordinary
ekstréém	extreme
hieël erg	extremely
ekstreem	extremely
aug	eye
auge	eyes
sjtof	fabric
fantasties	fabulous
gezich	face
tegemoet treije	face
fasielietere	facilitate
fasielieteite	facilities
insjtilling	facility
feit	fact
fàktor	factor
fabrik	factory
feite	facts
vervleege	fade
mislukking	fail
mislukke	fail
misluk	failed
mislukking	failure
sjwaak	faint
einigzins	faint
ierlijk	fair
joarmerret	fair
fêr	fairly
fee	fairy
geluif	faith
trouw	faithful
nep	fake
valle	fall
herfs	fall
vàlsj	FALSE
beroemdheid	fame
bekind	familiar
familie	family
hongersnwad	famine
bekind	famous
fèn	fan
sjiek	fancy
fantasties	fantastic
wied	far
daag	farewell
boerderie	farm
boer	farmer
fassienerend	fascinating
mode	fashion
sjnèl	fast
vit	fat
fàtáál	fatal
lot	fate
vader	father
pap	father
vermeuid	fatigue
sjuld	fault
favoriet	favorite
guns	favour
favooriet	favourite
angs	fear
viere	feast
vêr	feather
kinmerk	feature
kenmirreke	features
februaarie	february
meug zin	fed up
pries	fee
koste	fee
voor	feed
trökkoppeling	feedback
veul	feel
geveul	feeling
veut	feet
veele	fell
gevalle	fell
meede	fellow
voolt	felt
vrouwelik	female
hikwerk	fence
vruchbaar	fertile
festieval	festival
hoole	fetch
koorts	fever
wiejenig	few
paar	few
wiënigger	fewer
verlaufde	fiance
fiksie	fiction
vèld	field
fèl	fierce
vieftieën	fifteen
vieftig	fifty
vechte	fight
vèchte	fighting
getal	figure
figuur	figure
oetvogele	figure out
besjtand	file
aanmake	file
vulle	fill
invulle	fill
ingevuld	filled
fillem	film
vies	filthy
eindelik	finally
finansieën	finance
finansjeel	financial
vinge	find
oetvinge	find out
boete	fine
good	fine
vinger	finger
aafmake	finish
eindsjtreep	finish
geëindig	finished
aafgeloupe	finished
fik	fire
vuur	fire
vas	firm
ieërsjte	first
veurnaam	first name
vusj	fish
fit	fit
passe	fit
vief	five
make	fix
oplossing	fix
vàs	fixed
vlag	flag
flits	flash
vlak	flat
flèt	flat
fout	flaw
foutloos	flawless
vloo	flee
vleisj	flesh
vloog	flew
buige	flex
flexiebel	flexible
vlug	flight
omkjerre	flip
flirte	flirt
flirte	flirting
drieve	float
euversjtruiming	flood
vlood	flood
vloer	floor
verdeeping	floor
mêl	flour
vloei	flow
bloom	flower
bloeie	flower
griep	flu
vloeiend	fluent
vloeiend	fluently
pluuzig	fluffy
vloeibaar	fluid
vleege	fly
vleeg	fly
noadruk	focus
mis	fog
mistig	foggy
vouwe	fold
luuj	folks
vollige	follow
opvolge	follow up
vollige	following
ete	food
misleide	fool
flap	fool
sjtommigheid	foolish
voot	foot
voetbal	football
veur	for
Bieveurbeeld	For example
beveurbeeld	for instance
veur dich	for you
verbooje	forbidden
forcere	force
krach	force
veursjpelling	forecast
veurkop	forehead
boetelands	foreign
boesh	forest
veur altied	forever
vergête	forget
vergeve	forgive
vergete	forgot
vork	fork
vurme	form
formulier	form
formeel	formal
auwd	former
gelukkig	fortunately
fortuin	fortune
vieërtig	forty
twieënvieërtig	forty-two
veuroet	forward
doorsjture	forward
verzörge	foster
gevochte	fought
gevonge	found
fundaasie	foundation
veer	four
veertieën	fourteen
vos	fox
fragiel	fragile
betietele	frame
lies	frame
raamwerk	framework
fraude	fraud
màfkees	freak
vrie	free
gratis	free
vrieheid	freedom
bevreeze	freeze
frekwensie	frequency
frekwènt	frequent
diks	frequently
frish	fresh
vriedig	friday
keulkas	fridge
vrund	friend
vruntelik	friendly
vrung	friends
vrundsjap	friendship
bang	frightened
beangstigend	frightening
kikker	frog
van	from
veurkant	front
bevroore	frozen
fruit	fruit
gefrustreerd	frustrated
brandsjtof	fuel
Foelfèlde	Fulfulde
vol	full
plezeer	fun
funksie	function
functionere	function
fundamenteel	fundamental
begraafenis	funeral
grappig	funny
vàch	fur
fuurieus	furious
meubel	furniture
wiejer	further
wiejer	furthermore
toekomstig	future
toenumme	gain
sjpèl	game
gaat	gap
graasj	garage
aafval	garbage
tuin	garden
knoflook	garlic
poort	gate
verzamele	gather
samekoms	gathering
meete	gauge
gegeve	gave
sjaakele	gear
verzit	gear
gesjlach	gender
algemein	general
normaalgesjproke	generally
sjenereere	generate
generasie	generation
vriegevig	generous
sjûnie	genius
jônre	genre
sjtiel	genre
zachaardig	gentle
ech	genuine
gebaar	gesture
kriege	get
aandoon	get dressed
opsjtoon	get up
bétersjàp	get well soon
kriege	getting
geis	ghost
sjpoeëke	ghosting
hieël groet	giant
kadoo	gift
gember	ginger
mêdje	girl
vriendin	girlfriend
geve	give
opgeve	give up
gegeve	given
blie	glad
blik werpe	glance
glaas	glass
bril	glasses
glimp	glimpse
globaal	global
duuster	gloomy
handsjeun	gloves
gloei	glow
oplichte	glow up
liem	glue
goon	go
doog mèr	go ahead
gànk wèg	go away
noa bid goon	go to bed
goon sloape	go to bed
doel	goal
gool	goal
doele	goals
doelpunte	goals
geit	goat
god	god
god zegene dich	god bless you
geit	goes
goon	going
noatoe goon	going to
goud	gold
wèg	gone
goon	gonna
plèkboel	goo
good	good
gooie noamiddig	good afternoon
hoïe	good bye
gooie daag	good day
gooie oavend	good evening
good gedoon	good job
gooi baan	good job
good oetzeen	good looking
veul sukses	good luck
gooie murrige	good morning
gooie murrige mien leefste	good morning my love
gooie nach	good night
hoïje	goodbye
gooi nach	goodnight
goedere	goods
Google	Google
Google Translate	Google Translate
gans	goose
prachtig	gorgeous
roddele	gossip
roddel	gossip
kriege	got
gekrege	got it
begrepe	got it
hub het	got it
euverheid	government
regering	government
griepe	grab
diplooma	grade
siefer	grade
geleidelik	gradually
aafgesjtudeerde	graduate
graan	grain
toekinne	grant
toegekind	granted
droeve	grapes
pàkke	grasp
graas	grass
graaze	grass
erkintelik	grateful
dankbaar	grateful
erkintelikheid	gratitude
dankbaarheid	gratitude
graaf	grave
gries	gray
grwat	great
geweldig	great
hèbzuch	greed
gretig	greedy
greun	green
groete	greet
groet	greeting
groete	greetings
gries	grey
raster	grid
rouw	grief
vermaale	grind
griepe	grip
grip	grip
boodsjappe	grocery
brujegom	groom
onsjmakelik	gross
bruuto	gross
grond	ground
groep	group
greui	grow
greui	growth
sjlechgezind	grumpy
Goearánie	Guarani
garansie	guarantee
bewaker	guard
bewake	guard
roaje	guess
gàs	guest
begeleiding	guidance
gids	guide
begeleide	guide
shuldig	guilty
jong	guy
jonges	guys
sjim	gym
trêne	gym
eigesjap	habit
lêfomgeving	habitat
hauw	had
haagel	hail
hoare	hair
halvere	half
hauf	half
hàl	hall
hand	hand
handele	handle
knap	handsome
hange	hang
rielekse	hang out
gebeure	happen
gebeurd	happened
bliedsjap	happiness
blie	happy
gefeliciteerd mit diene verjeurdaag	happy birthday
fijne verjoardaag	happy birthday to you
zaalig nuuj joar	happy new year
moejelik	hard
hèl	hard
bienoa neet	hardly
bienoa noeëts	hardly ever
sjaa toebringe	harm
pien	harm
sjaadelik	harmful
harmonie	harmony
fèl	harsh
oeëgste	harvest
hêt	has
haat	hate
hubbe	have
fijne daag	have a good day
fijne daag	have a nice day
ontbijte	have breakfast
sjpas hubbe	have fun
hubse gegete	have you eaten
hubbe	having
gevoar	hazard
waas	haze
nevel	haze
heë	he
hê hêt	he has
hê is	he is
kop	head
koppien	headache
geneze	heal
geneezing	healing
gezondheid	health
gezond	healthy
huuwere	hear
gehuurd	heard
hart	heart
wermte	heat
hemel	heaven
zsjwoar	heavy
hekties	hectic
huuwegte	height
erfgenaam	heir
inbraak	heist
gehoute	held
hèl	hell
Hallo	Hello
hallo leefste	hello dear
hallo wie geit het mit dich	hello how are you
hoi wie geit het mit dich	hello how are you doing
hèlm	helmet
hellepe	help
behulpzaam	helpful
doadoor	hence
heur	her
kudde	herd
hie	here
erfsjap	heritage
erfenis	heritage
aarzele	hesitate
Hèj	Hey
Hoi	Hi
hoi wie geit het mit dich	hi how are you
Hoi	Hi there
verborrige	hidden
verberrige	hide
hierargie	hierarchy
hoeëg	high
markere	highlight
wandele	hike
klumme	hike
wandele	hiking
hielaries	hilarious
heuvel	hill
heum	him
hint	hint
heup	hip
hip	hip
heupe	hips
inhure	hire
hure	hire
inhure	hiring
ziene	his
histoorie	history
sjloon	hit
Hmm	Hmm
hobbie	hobby
houte	hold
eve wachte	hold on
gaat	hole
vakansie	holiday
vrieje daag	holiday
hòl	hollow
thoeës	home
hoeswerk	homework
ierlik	honest
eerlijk	honestly
Leefste	Honey
Honing	Honey
ier	honor
kàp	hood
inhoake	hook
hoak	hook
huppele	hop
hoop	hope
hopelik	hopefully
hopeloos	hopeless
plat	horizontal
horisontaal	horizontal
toeter	horn
hoorn	horn
versjrikkelik	horrible
horror	horror
peerd	horse
ziekenoes	hospital
gasvrieheid	hospitality
gasvrouw	host
gasheer	host
vijandelik	hostile
werrem	hot
hotèl	hotel
oer	hour
oere	hours
hoes	house
hoeshouwe	household
wie	how
en dich	how about you
wie geit het	how are you
wie geit het mit dich	how are you doing
wie geit het mit dich vandaag	how are you doing today
wie geit het mit dich vandaag	how are you today
wie geit het mit dich	how do you do
wie is	how is
wie veul	how many
wie veul	how much
wie diks	how often
wie awd bis se	how old are you
wie woar diene daag	how was your day
wie woar dien nach	how was your night
echter	however
knauppunt	hub
middelpunt	hub
séntrum	hub
menneke	hubby
knuffel	hug
giganties	huge
miensjelijk	human
besjeie	humble
vochtig	humid
vochtigheid	humidity
honderd	hundred
honger	hungry
jach	hunt
orkaan	hurricane
sjpeuje	hurry
sjeet op	hurry up
pien	hurt
man	husband
aanpakke	hustle
sjravele	hustle
hut	hut
hiegiên	hygiene
Ich	I
Ich bin	I am
Mit mich geit het good	I am fine
Ich kin	I can
Ich kin neet	I can't
Dat doon ich	I do
Ich doon	I do
Ich weit het neet	I do not know
Ich begriep het neet	I do not understand
Ich neet	I don't
Ich weit het neet	I don't know
Ich begriep het neet	I don't understand
Ich begriep neet wat se bedoels	I don't understand what you mean
Ich begriep dich neet	I don't understand you
Weit ich neet	I don’t know
Ich begriep het neet	I don’t understand
ich dink het	i guess
Ich houw	I had
Ich hub	I have
Ich bin gewês	I have been
Ich woar	I have been
Ich hoop het	I hope so
Ich weit	I know
Ich houd van	I like
Ich ving dich leuk	I like you
Ich houd	I love
Ich houd van miene broor	I love my big brother
Ich houd van mien zuster	I love my big sister
Ich houd van miene pap	I love my father
Ich houd van mien klein breurke	I love my little brother
Ich houd van mien klein zusterke	I love my little sister
Ich houd van mien mam	I love my mother
Ich houd van dich	I love you
Ich houd zoeë veul van dich	I love you so much
Ich houd auch van dich	I love you too
Ich bedoel	I mean
Ich mis dich	I miss you
Ich mis dich zoeë erg	I miss you so much
Ich begriep het	I see
Ich zeen	I see
Ich dink	I think
Ich begriep het	I understand
Ich wil	I want
Ich wil dich zeen	I want to see you
Ich wil dich	I want you
Ich woar	I was
Ich zal	I will
Ich zou zeen	I would be
Ich bin	I'm
Het geit good mit mich	I'm fine
Ich bin good	I'm good
Mit mich is alles good	I'm good
Ich bin hie	I'm here
Het sjpiet mich	I'm sorry
ies	ice
ies	ice cream
idee	idea
ideaal	ideal
identiek	identical
identificere	identify
aanwieze	identify
identiteit	identity
idioot	idiot
sjtilsjtand	idle
es	if
negere	ignore
krank	ill
ielégáál	illegal
krankheid	illness
Iloocanoo	Ilocano
aafbeelding	image
veursjtille	imagine
akkuut	immediate
onmiddelik	immediately
immèns	immense
impekt	impact
ongeduldig	impatient
insjtille	implement
inveure	import
ingeveurd	import
belangriek	important
opligge	impose
onmeugelik	impossible
indruk make	impress
índruk	impression
indrukwikkend	impressive
verbetere	improve
verbetering	improvement
in	in
in aanvulling	in addition
In feite	In fact
veur	in front of
in sjtoat te zin	in order to
ongesjik	inappropriate
insèntief	incentive
òngeval	incident
opnumme	include
insjlete	include
wo onder	including
inkòmme	income
ongemàk	inconvenience
toenumme	increase
toegenomme	increased
ongeluifelik	incredible
inderdaad	indeed
onafhankelijk	independent
India	India
aanwieze	indicate
inheems	indigenous
inkeling	individual
industrie	industry
onvermijdelik	inevitable
jonk kind	infant
infeksie	infection
oneindigheid	infinity
ontsjtoake	inflammation
inflasie	inflation
invlood	influence
informere	inform
informatie	information
ingrediejente	ingredients
erfenis	inheritance
aafkorting	initial
begin	initial
inietsjale	initial
inietsjiatief	initiative
gewond	injured
wond	injury
onsjuldig	innocent
innovasie	innovation
aanvroag	inquiry
absurd	insane
insèk	insect
onzeker	insecure
inveure	insert
inbringe	insert
ingooie	insert
binne	inside
inzich	insight
drop sjtoon	insist
sjloapeloosheid	insomnia
inspiraasie	inspiration
inspirere	inspire
insjtallere	install
instansie	instance
metein	instant
in plaats doavan	instead
in plaats doa van	instead of
insjtruksies	instructions
insjtrumint	instrument
beleedige	insult
beleediging	insult
verzeekering	insurance
intàk	intact
integriteit	integrity
intellèctueel	intellectual
intelligensie	intelligence
sjlum	intelligent
intensie	intend
besjtumd	intended
intens	intense
intensie	intention
op ein inwirke	interact
onderhoud	interaction
interaksie	interaction
interesse	interest
geïnteresseerd	interested
interessant	interesting
tushekomme	interfere
tusje	intermediate
intern	internal
internasjonaal	international
sjtaash	internship
interpretere	interpret
tollike	interpret
tollik	interpreter
in de rêije valle	interrupt
onderbreke	interrupt
intervjoe	interview
intiem	intimate
in	into
introduseere	introduce
introduksie	introduction
introvert	introvert
intuïsie	intuition
invalied	invalid
oetvinge	invent
inventaaris	inventory
investere	invest
onderzeuke	investigate
oetnuuwediging	invitation
oetnuuwedige	invite
faktuur	invoice
betrokke	involve
betrokke	involved
iezer	iron
is	is
eiland	island
geïsoleerd	isolated
probleem	issue
oetgaave	issue
probleme	issues
toekinne	issues
het	it
het is	it is
het woar	it was
het is	it's
het is good	it's ok
Het is good	It's okay
artiekel	item
artiekele	items
doavan	its
Ich bin	I’m
jas	jacket
gevangenis	jail
Januarie	January
pot	jar
kaak	jaw
sjloes	jealous
klojo	jerk
juweele	jewelry
baan	job
hardloupe	jogging
deilnumme	join
gezamelik	joint
gràp	joke
sjoernalis	journalist
reis	journey
sjpas	joy
rechter	judge
saap	juice
juulie	july
springe	jump
sjpronk	jump
juunie	june
versjlaafde	junk
nèt	just
sjus	just
doog het gewoon	just do it
gerechtigheid	justice
rechvaardige	justify
Kalálisuut	Kalaallisut
geïnteresseerd	keen
entoesjas	keen
houte	keep
haud vol	keep it up
gehoute	kept
ketel	kettle
sjleutel	key
kik	kick
trap	kick
trappe	kick
kind	kid
grappe	kidding
neer	kidney
kinger	kids
dwad make	kill
vermoare	kill
aardig	kind
soort	kind
nògàl	kinda
estebleef	kindly
vruntelikheid	kindness
keuning	king
puuën	kiss
keuke	kitchen
vleeger	kite
kitten	kitten
kneej	knee
wis	knew
mès	knife
ridder	knight
weite	know
kinnes	knowledge
bekinde	known
bekind	known
Konkáni	Konkani
Krioo	Krio
etiekit	label
wirrik	labor
arbeid	labour
gebrèk	lack
ludder	ladder
juffrouw	lady
geleege	laid
loog	laid
méér	lake
lam	lamb
mank	lame
lamp	lamp
lande	land
land	land
landsjap	landscape
taal	language
runde	lap
sjwat	lap
groewet	large
litste	last
tensjlotte	last but not least
neet te vergête	last but not least
achternoam	last name
laat	late
de litste tied	lately
laater	later
litste	latest
litste	latter
lach	laugh
lache	laughing
gelach	laughter
lancere	launch
wèsh	laundry
wit	law
graasveld	lawn
advokaat	lawyer
ligge	lay
loag	layer
opmaak	layout
ontwèrp	layout
lui	lazy
leide	lead
leider	leader
blaad	leaf
lèk	leak
leune	lean
veuroetsjpringe	leap
liejere	learn
lieëre	learning
lies	lease
minste	least
lêr	leather
weggoon	leave
loate	leave
blaar	leaves
weggoon	leaves
geleid	led
weggegoon	left
links	left
bein	leg
erfenis	legacy
juriedies	legal
legende	legend
legitiem	legit
vriejetiedsbesjteding	leisure
ljènne	lend
lengte	length
wiejenig	less
lis	lesson
loat	let
breef	letter
sjlaa	lettuce
nivoo	level
opleevering	leverage
aansjproakelijkheid	liability
biebliotéék	library
lik	lick
leege	lie
ligge	lie
leuges	lies
leeve	life
lifte	lift
optille	lift
lif	lift
leeg	light
lich	light
bliksem	lightning
leuk	like
wie	like
warsjienlik	likely
van hetzelfde	likewise
Limburgs	Limburgan
lijn	line
Lingálaa	Lingala
link	link
lieëuw	lion
vloeibaar	liquid
opsomme	list
lies	list
loestere	listen
luustere	listening
litterlik	literally
lieteratuur	literature
aafval	litter
klein	little
leve	live
laif	live
leever	liver
leves	lives
leeve	living
woonkamer	living room
hagedis	lizard
laaje	load
làs	load
oplaaje	load
brwad	loaf
lieëning	loan
lokaal	local
lokasie	location
sjloot	lock
lok dauwn	lockdown
sjtàm	log
lol	lol
einzaam	lonely
lank	long
lang neet gezeen	long time no see
kiek	look
lus	loop
verleeze	loose
hieër	lord
verleeze	lose
verlees	loss
verloore	lost
veul	lot
hèl	loud
lounsj	lounge
leefde	love
ich houd van dich	love you
sjattig	lovely
liejeg	low
verlieëge	lower
trouw	loyal
trouw	loyalty
geluk	luck
geluk	lucky
Loegandaa	Luganda
bàgaasj	luggage
klontere	lump
brok	lump
middigete	lunch
longe	lungs
luuks	luxury
luuksieus	luxury
ligge	lying
masjien	machine
kwad	mad
gèk	mad
mevrouw	madam
gemaak	made
tiedsjrif	magazine
manjefiek	magnificent
mêdje	maid
grotste	main
vashoute	maintain
onderhoud	maintenance
Maithilie	Maithili
groewete	major
meerderheid	majority
maake	make
sjmienk	make up
mannelik	male
winkelsentrum	mall
man	man
behere	manage
behier	management
mènnasjer	manager
verplich	mandatory
maniefès	manifest
manipulere	manipulate
meneer	manner
handmaatig	manual
veul	many
en nog veule joare	many many happy returns of the day
maart	march
marge	margin
merret	market
huwelijk	marriage
getrouwd	married
maskeere	mask
masker	mask
deens	mass
massaal	mass
eenorm	massive
massief	massive
meister	master
wedsjtried	match
euvereinkomme	match
paare	mate
moat	mate
materiejaal	material
rêkene	math
wiskunde	math
kwestie	matter
volwassenheid	maturity
zou kinne	may
mei	may
misshien	maybe
mich	me
ich auch	me too
moaltied	meal
beteikene	mean
gemein	mean
beteikenis	meaning
beteikent	means
middele	means
bedoeld	meant
onderwieles	meanwhile
mete	measure
moatreigele	measures
vleisj	meat
medisch	medical
médiesien	medicine
meditasie	meditation
méédium	medium
ontmoete	meet
vergaadering	meeting
ontmoeting	meeting
Meiteilón	Meiteilon
sjmilte	melt
herinneringe	memories
geheuge	memory
mentaal	mental
benumme	mention
benumme	mentioned
mentor	mentor
handelêr	merchant
genade	mercy
slechs	merely
enkel	merely
zaalige keershmus	merry christmas
rommel	mess
berich	message
rommelig	messy
métaal	metal
métoode	method
moeze	mice
middesjtuk	middle
middel	middle
middernach	midnight
zouw kinne	might
mild	mild
mijlpoal	milestone
militêr	military
millik	milk
miljoeën	million
geis	mind
geestestoesjtand	mindset
miene	mine
bemeuije	mingle
kleine	minor
minuut	minute
minuute	minutes
wonder	miracle
sjpeegele	mirror
divèrs	miscellaneous
versjillende	miscellaneous
ondeugend	mischievous
mieserabel	miserable
miseerie	misery
misse	miss
mis dich	miss you
vermis	missing
missie	mission
mis	mist
fout	mistake
Mizó	Mizo
mobiel	mobile
oetlache	mock
modèl	model
matig	moderate
moodèrn	modern
besjeije	modest
vochtig	moist
vochtigheid	moisture
sjummel	mold
mol	mole
mam	mom
momint	moment
moandig	monday
geld	money
in de gate houte	monitor
biehoute	monitor
aap	monkey
moand	month
shtumming	mood
gehumeurd	moody
moan	moon
moraal	moral
miejer	more
doaneve	moreover
murrige	morning
hiepotheek	mortgage
meiste	most
veulal	mostly
mooder	mother
mam	mother
mósie	motion
bewêging	motion
motivaatie	motivation
berg	mountain
moes	mouse
mond	mouth
bewêge	move
verhoeze	move
bewêging	movement
film	movie
mevrouw	mrs
veul	much
drek	mud
mok	mug
sjpiere	muscle
muusééüm	museum
sjampiejon	mushroom
muuziek	music
mot	must
sjtil	mute
wederzijds	mutual
mien	my
Mien leefste	My dear
miene vrund	my friend
Mien hovercraft zit vol mit palinge	My hovercraft is full of eels
mien leefde	my love
miene naam is	my name is
gèr gedoon	my pleasure
michzelf	myself
misterieus	mysterious
mistéérie	mystery
miete	myth
nagel	nail
naaïef	naive
benumme	name
naam	name
narratief	narrative
sjmaal	narrow
vies	nasty
nasjonaal	national
naasjonaalieteit	nationality
oorsjpronkelik	native
natuurlijk	natural
natuur	nature
misselik	nausea
bienoa	near
vlakbie	near
kortbie	nearby
bienoa	nearly
netjes	neat
noewedzakelijk	necessary
nek	neck
kitting	necklace
nuuwedig hubbe	need
negatief	negative
negeere	neglect
onderhandele	negotiate
buur	neighbor
buurt	neighborhood
gein	neither
nêf	nephew
sjtuud	nerd
nerveus	nervous
nis	nest
net	net
netwerk	network
neutraal	neutral
noewets	never
nooit opgeve	never give up
loat mer zitte	never mind
loat mer zitte	nevermind
ondanks	nevertheless
nuuj	new
nuuts	news
volgende	next
neeve	next
neve	next to
fijn	nice
leuk om dich te ontmoete	nice to meet you
nisjekke	niece
nach	night
nachmerrie	nightmare
neuge	nine
neugetiën	nineteen
neugetig	ninety
Nei	No
gein probleem	no problem
meinse neet	no way
neemes	nobody
lawaai	noise
lawaaierig	noisy
gein	none
middig	noon
nei	nope
noch	nor
normaal	normal
noorde	north
naas	nose
nostalgies	nostalgic
neet	not
helemoal neet	not at all
neet sjlech	not bad
Neet noe	Not now
nog neet	not yet
noeët	note
nootiesie	note
genoteerd	noted
niks	nothing
mèlding	notice
opgemirk	noticed
zelfsjtandig naamwoord	noun
zelfsjtandige naamwoorde	nouns
roman	novel
verhoal	novel
november	november
noe	now
tegewoordig	nowadays
ergernis	nuisance
ongèldig	null
nul	null
verdauf	numb
nummer	number
zuster	nurse
zurrige	nurse
noot	nut
nootmuskaat	nutmeg
voeding	nutrition
eed	oath
obesietas	obesity
gehuurzame	obey
objek	object
doel	objective
verplichting	obligation
duuster	obscure
verdoezele	obscure
observaasie	observation
bekieke	observe
observeere	observe
geobsedeerd	obsessed
obsessie	obsession
euverboodig	obsolete
obsjtakel	obstacle
verkriege	obtain
verkrege	obtained
vanzelfsjprekend	obvious
vanzelfsjprekend	obviously
van tied tot tied	occasionally
beroep	occupation
bezat	occupied
gebeure	occur
gebeurd	occurred
kump veur	occurs
oséaan	ocean
oktober	october
vrèm	odd
kanse	odds
van	of
natuurlijk	of course
oet	off
offensief	offensive
aanbod	offer
aanbeeje	offer
kantwar	office
offiesjeel	official
vaak	often
Oah	Oh
oah ech	oh really
olie	oil
ok	ok
okéé leefste	ok dear
okéé leefste	ok honey
okee mien leefste	ok my love
okéé	okay
okéé sjat	okay baby
okee leefste	okay dear
okéé leefste	okay honey
okee mien leefste	okay my love
aud	old
op	on
einmoalig	once
unne	one
ein taal is noeëts genog	one language is never enough
ui	onion
online	online
allein	only
opene	open
ope	open
operasie	operation
meining	opinion
meugelikhede	opportunities
meugelijkheid	opportunity
tegeneuvergestild	opposite
optiemisties	optimistic
meugelikheid	option
opsie	option
opsjoneel	optional
of	or
appelsien	orange
oranje	orange
bestèlling	order
sortere	order
normaal	ordinary
organisasie	organization
oriejenteere	orientation
oeërsjpronk	origin
oriesjieneel	original
Oromoo	Oromo
wees	orphan
angere	other
angesj	otherwise
zou motte	ought
ozze	our
Oos missie: om eederein, wo dan auch, in sjtoat te sjtille om de wêreld te begriepe en zich zonder taalbarriêres te kinne oetdrukke.	Our mission: to enable everyone, everywhere to understand the world and express themselves across languages.
Oos missie: om alle informasie ter wêreld te organisere en het veur eederein toegankelik en broekbaar te make.	Our mission: to organize the world's information and make it universally accessible and useful.
oet	out
oetkomst	outcome
kleiding	outfit
oetfit	outfit
oetrusting	outfit
oetgoand	outgoing
outlit	outlet
oetloat	outlet
sjetse	outline
neve	outside
boete	outside
manjefiek	outstanding
oove	oven
euver	over
doa achter	over there
algemeine	overall
euverheerkòmme	overcome
euverkòmme	overcome
euverdinke	overthinking
euverweldigd	overwhelmed
euverdonderend	overwhelming
sjuldig zin	owe
uul	owl
eigelik	own
eigenaar	owner
os	ox
tempo	pace
moat	pace
pàk	pack
pakkit	package
betaald	paid
pien	pain
verf	paint
verve	paint
sjilderie	painting
kombienere	pair
paar	pair
bleik	pale
pallem	palm
pan	pan
pandemìe	pandemic
paniek	panic
brook	pants
papier	paper
paradies	paradise
párálèl	parallel
pàkkit	parcel
pardon	pardon
ouwersj	parents
parrik	park
pàppegaai	parrot
peterselie	parsley
deil	part
deilnumme	participate
bepaalde	particular
mit naame	particularly
partner	partner
fieës	party
euvershloon	pass
passaash	passage
versjtreke	passed
passie	passion
gepàsjoneerd	passionate
passief	passive
wàgwoord	password
verleede	past
sjtuk	patch
paad	path
zielig	pathetic
geduld	patience
pashjènt	patient
geduldig	patient
patroewen	pattern
pauze	pause
besjtroating	pavement
betale	pay
betaling	payment
vreij	peace
vrêjig	peaceful
perzik	peach
piek	peak
peer	pear
erte	peas
vrêm	peculiar
plas	pee
plasse	pee
plukke	peel
sjtare	peer
lêftiedsgenote	peers
pèn	pen
pòtlwàd	pencil
in aafwachting	pending
luuj	people
pééper	pepper
versjtoon	perceive
persepsie	perception
perfek	perfect
prestere	perform
oetveure	perform
optrêije	perform
prestatie	performance
misshien	perhaps
periode	period
permanent	permanent
toesjtumming	permission
permittere	permit
doorzittingsvermoge	perseverance
volhouwend	persistent
miensh	person
persoeënlijk	personal
persoeënlijkheid	personality
perspektief	perspective
euvertuuge	persuade
perveersjeling	pervert
hoesdeer	pet
faas	phase
fénoméén	phenomenon
filoosoofie	philosophy
teelefoon	phone
fóto	photo
zin	phrase
fiesiek	physical
keeze	pick
oppikke	pick up
foto	picture
veursjtille	picture
sjtuk	piece
sjtukker	pieces
verrike	pig
doef	pigeon
opsjtapele	pile
sjtapel	pile
kusse	pillow
pieloot	pilot
sjpeldje	pin
pin	pin
ànànàs	pineapple
rôs	pink
gaat	pit
put	pit
sjmiete	pitch
toeënhuuwigte	pitch
sjpiet	pity
mitlieje	pity
plaatse	place
plaats	place
plaatse	places
ploag	plague
vlakte	plain
duudelik	plain
sumpel	plain
plenne	plan
plan	plan
vleegtuug	plane
febrik	plant
plant	plant
plante	plant
plante	plants
bord	plate
platform	platform
sjpele	play
sjpele	playing
plezant	pleasant
estebleef	please
tevreije	pleased
plezeer	pleasure
beloave	pledge
genòg	plenty
veld	plot
intriesj	plot
plug	plug
proem	plum
loeëdgeeter	plumber
meervoudig	plural
podkàs	podcast
gedich	poem
poëzie	poetry
punt	point
aanwieze	point
gif	poison
polisie	police
beleid	policy
belêf	polite
verontreiniging	pollution
viever	pond
sjwumbad	pool
poep	poop
errem	poor
breke	pop
knettere	pop
populêr	popular
popuulasie	population
verrike	pork
pap	porridge
poort	port
positie	position
positief	positive
bezitte	possess
eigedom	possession
bezitterig	possessive
meugelik	possible
pos	post
versjikke	post
oetsjtille	postpone
eerappel	potato
potensjeel	potential
pond	pound
ermeuj	poverty
mach	power
krach	power
krachtig	powerful
machtig	powerful
prakties	practical
oefene	practice
prieze	praise
lof	praise
grap	prank
bêije	pray
wêrdevol	precious
presies	precise
presies	precisely
veursjpille	predict
leever	prefer
veurkeur	preference
sjwanger	pregnant
veuroerdeil	prejudice
terrein	premises
biste	premium
premie	premium
veurbereiding	preparation
veurbereide	prepare
veurbereid	prepared
veursjtil	preposition
aanwezigheid	presence
op het momint	present
kadoo	present
presentaasie	presentation
behoute	preserve
presiedint	president
duuje	press
pers	press
druk	pressure
doon es of	pretend
sjoeën	pretty
veurkòmme	prevent
veurige	previous
bêije	prey
prieze	price
pries	price
trots	pride
preester	priest
primêre	primary
priemêr	prime
biste	prime
prinses	princess
hoofzakelik	principal
iersh	prior
veurrang	priority
gevangenis	prison
privaasie	privacy
prievéé	private
eige	private
prievieleesj	privilege
veurrank	privilege
pries	prize
wàrsjienlik	probably
prebleem	problem
proseduure	procedure
doorgoon	proceed
procès	process
produseere	produce
produk	product
produksie	production
beroep	profession
profesjoneel	professional
profiel	profile
wins	profit
oprèg	profound
veuroetgank	progress
veuroetgoon	progress
projèk	project
prommenint	prominent
belofte	promise
beloave	promise
promoote	promote
promoosie	promotion
op sjlaag	prompt
geneig	prone
veurnaamwoorde	pronouns
oetsjproak	pronunciation
bewies	proof
bewieze	proof
netjes	proper
good	proper
fatsoenlijk	properly
eigensjappe	properties
eigendom	property
veursjtil	proposal
veuroetzich	prospect
veursjpood	prosperity
veursjpoedig	prosperous
welvarend	prosperous
besjerme	protect
trots	proud
bewieze	prove
veurzeen	provide
gegeeve	provided
provinsie	province
proviesie	provision
puberteit	puberty
publiek	public
trikke	pull
pompoen	pumpkin
punktueel	punctual
ljerling	pupil
koupe	purchase
onversjneeje	pure
puur	pure
poarsj	purple
doel	purpose
beursh	purse
noavollige	pursue
achtervollige	pursue
achtervolging	pursuit
duuje	push
zitte	put
kwaliefiekaasie	qualification
kwaliteit	quality
aantal	quantity
hoeveulheid	quantity
karantên	quarantine
vreigele	quarrel
kwart	quarter
kètsja	Quechua
keuningin	queen
apaart	queer
raar	queer
vroag	query
vroag	question
riej	queue
sjnèl	quick
sjnèl	quickly
shtil	quiet
sjprei	quilt
aafsjleete	quit
weggoon	quit
nogàl	quite
kwis	quiz
offèrte	quotation
sietere	quote
offèrte make	quote
citate	quotes
knien	rabbit
rees	race
sjpöje	race
woede	rage
razernie	rage
rege	rain
inzamele	raise
opkomme	raise
gereeze	raised
rende	ran
willekeurig	random
beriek	range
sjnèl	rapid
sjnel	rapidly
zeldzaam	rare
bienoa nooit	rarely
oetsjlaag	rash
ràt	rat
tempo	rate
tarief	rate
leever	rather
verhouding	ratio
rasjoneel	rational
roew	raw
bereike	reach
bereik	reached
reaksie	reaction
leze	read
leezing	reading
leze	reading
kloar	ready
ech	real
realiteit	reality
realisere	realize
gerealiseerd	realized
realiseerde	realized
ech	really
achterkant	rear
reije	reason
rêdelik	reasonable
herinnere	recall
bewies	receipt
kwitansie	receipt
ontvange	receipt
kriege	receive
ontvange	received
resènt	recent
onlangs	recently
resepsie	reception
resèp	recipe
roekeloos	reckless
erkinning	recognition
erkinne	recognize
aanbevele	recommend
aanbevole	recommended
opnumme	record
rekòrd	record
hersjtille	recover
hèrsjtil	recovery
veerkant	rectangle
roeëd	red
verzilvere	redeem
verlossing	redemption
vermindere	reduce
euvervlood	redundant
refereere	refer
referens	reference
reflèkteere	reflect
refleksie	reflection
onthoute van	refrain
keulkàs	refrigerator
teruukgaaf	refund
weigere	refuse
weigerde	refused
zeen	regard
mit betrikking tot	regarding
euver	regarding
aafgezeen	regardless
groete	regards
regio	region
register	register
sjpiet	regret
gewoeën	regular
vaker	regularly
aafwieze	reject
aafsjloon	reject
relaatere	relate
geliejeerd	related
verwant	related
relatie	relationship
relatief	relative
familieleede	relatives
ontsjpanne	relax
vriegeve	release
vriegegeve	released
relevant	relevant
betroebaar	reliable
opluchting	relief
opluchting	relieve
opgeluch	relieved
geluif	religion
reliegieus	religious
weigerend	reluctant
vertroewe	rely
blieve	remain
euverblievende	remaining
opmirkelik	remarkable
reméedie	remedy
onthoute	remember
herinnere	remind
herinnering	reminder
op aafsjtand	remote
weghoole	remove
geleverd	render
geve	render
huure	rent
repaarére	repair
herhoale	repeat
vervànge	replace
beantwoorde	reply
rapport	report
verteegewoordige	represent
repuutasie	reputation
aanvroage	request
vereise	require
vereis	required
rèdde	rescue
rèdding	rescue
onderzeuk	research
lieke op	resemble
vrok	resentment
reservering	reservation
resèrf	reserve
bewoner	resident
opgeve	resign
neerligge	resign
weersjtand	resilience
wêrbaar	resilient
weersjtoon	resist
verzit	resistance
resoluusie	resolution
oplossing	resolution
oplosse	resolve
verblief	resort
vakantiepark	resort
bronne	resources
respèk	respect
beantwoorde	respond
antwoord	response
verantwoordelijkheid	responsibility
verantwoordelik	responsible
res	rest
rus zach	rest in peace
restorant	restaurant
hersjtille	restore
bepèrke	restrict
resultaat	result
oetsjlaag	result
resultere	result
resultate	results
hervatte	resume
winkelverkaup	retail
behoute	retain
vàshoute	retention
bewaring	retention
gepensjoneerd	retired
teruuktrikke	retreat
teruukhoole	retrieve
teruuk	return
teruukkome	return
omdreije	return
onthulle	reveal
onthuld	revealed
vraak	revenge
opbrings	revenue
omdreije	reverse
noakieke	review
beoordeiling	review
reeviezeere	revise
reviesie	revision
revoluusie	revolution
beloeëning	reward
ritme	rhythm
rub	rib
ries	rice
riek	rich
veul	rich
kwietraake	rid
aafsjtand doon	rid
rieje	ride
belachelik	ridiculous
rechts	right
sjus	right
noe	right now
op dit moment	right now
vàs	rigid
sirkel	ring
rink	ring
aafwèshe	rinse
rèl	riot
sjeure	rip
riep	ripe
verhuuweging	rise
risiko	risk
risiko laupe	risk
rivaal	rival
rievier	river
wêg	road
roeëstere	roast
robuus	robust
sjtein	rock
hengel	rod
ròl	role
ròl	roll
daak	roof
kamer	room
plaats	room
wortel	root
touw	rope
rot	rotten
roe	rough
roewèg	roughly
rond	round
roete	route
roetien	routine
riej	row
vrieve	rub
rubber	rubber
rommel	rubbish
groof	rude
tapiet	rug
verruuwieneere	ruin
reigels	rule
lienéaal	ruler
reigels	rules
rènne	run
rennentêre	running
renne	running
plattelands	rural
hoas	rush
ontsjloon	sack
túút	sack
heilig	sacred
opoffere	sacrifice
veilig	safe
gooi vluch	safe flight
veiligheid	safety
versjtèndige	sage
wieze	sage
zag	said
zeil	sail
zeile	sailing
rêje	sake
salaris	salary
verkoup	sale
zalm	salmon
zaut	salt
hetzelfde	same
Hie auch	Same here
veurbeeld	sample
zand	sand
sjoere	sand
Sanskriet	Sanskrit
sarkasties	sarcastic
onbesjaamp	sassy
zoot	sat
tevreijenheid	satisfaction
tevreije	satisfied
bevrêjige	satisfy
bevrêjigend	satisfying
Zoaterdig	Saturday
woorsj	sausage
wild	savage
opsjloon	save
besjpare	save
zoog	saw
zigge	say
sjoal	scale
bedroch	scam
litteike	scar
sjaars	scarce
bienoa neet	scarce
bang	scared
sjaal	scarf
èng	scary
versjpreid	scattered
sên	scene
landsjap	scenery
geur	scent
kàlènder	schedule
sjoal	school
onderwieze	school
weetensjap	science
wetensjapper	scientist
wetensjappers	scientists
sjieër	scissors
sjèlle	scold
omvank	scope
skoore	score
droethole	scrap
sjtukske	scrap
krats	scratch
kratse	scratch
sjrieëve	scream
sjerm	screen
sjroef	screw
skrip	script
gesjreve stuk	script
zieë	sea
verzegeling	seal
zeuke	search
sezoen	season
sjtool	seat
twieëde	second
geheim	secret
deil	section
veilig	secure
beveiliging	security
zeen	see
hoïe	see you
zeen dich	see you
tot sjtraks	see you later
zeen dich sjnel	see you soon
tot murrige	see you tomorrow
zoad	seed
zeuke	seek
liek	seem
noad	seem
lieke	seems
gezeen	seen
griepe	seize
besjlaag	seizure
toeval	seizure
zelde	seldom
selectere	select
zèlf	self
zelfgenezing	self healing
egoïsties	selfish
verkoupe	sell
sjture	send
sjtuur mich dien foto	send me your picture
seenior	senior
mirrike	sense
aanveule	sense
geveulig	sensible
geveulig	sensitive
gesjtuurd	sent
zin	sentence
veroerdeiling	sentence
zinne	sentences
apaart	separate
Sépédie	Sepedi
september	september
volgorde	sequence
reeks	series
serieus	serious
serieus	seriously
serveere	serve
deens	service
onderhoute	service
sessie	session
sjtille	set
zitte	set
opzitte	set up
insjtilling	setting
umgeeving	setting
neersjloon	settle
euvereinkomme	settle
zeve	seven
zeventieën	seventeen
zeventig	seventy
versheiene	several
ernstig	severe
neie	sew
sjieëm	shade
shaduw	shadow
sjudde	shake
zal	shall
ondeep	shallow
sjaamte	shame
vurm	shape
deile	share
sjerp	sharp
zie	she
zie het	she has
zie is	she is
werrepe	shed
sjöap	sheep
blaad	sheet
plank	shelf
sjèlp	shell
besjutting	shelter
onderkomme	shelter
besjerming	shield
sjild	shield
verangere	shift
deens	shift
sjien	shine
versjeepe	ship
sjeep	ship
versjture	ship
versjeepe	shipping
versjture	shipping
humme	shirt
sjeun	shoes
sjeete	shoot
winkel	shop
winkele	shopping
kus	shore
kort	short
tekort	shortage
sjoot	shot
sjete	shot
zouw	should
sjouwer	shoulder
sjrieëf	shout
sjow	show
loat mich zeen	show me
doesj	shower
garnaal	shrimp
krumpe	shrink
toedoon	shut
toe	shut
moel toe	shut up
verlège	shy
broor en zuster	sibling
breur en zuster	siblings
krank	sick
kant	side
zug	sigh
zich	sight
bezeenswaardigheid	sightseeing
onderteikene	sign
handteikening	signature
aanzienlik	significant
sjtilte	silence
sjtil	silent
zie	silk
sjtom	silly
zilver	silver
vergeliekbare	similar
sump	simp
sumpel	simple
geliektiejig	simultaneously
sins	since
oprèg	sincere
oprèg	sincerely
hoeëgachtend	sincerely
zinge	sing
zanger	singer
eine	single
singel	single
zinke	sink
Menieër	Sir
zuster	sister
sjoeënzuster	sister in law
zitte	sit
plaats	site
situasie	situation
zus	six
zestieën	sixteen
sestig	sixty
groeëte	size
talènt	skill
tàllènte	skills
vaardighede	skills
huid	skin
maager	skinny
euversjloon	skip
rok	skirt
lòg	sky
sjlaaf	slave
sjloap	sleep
sjloape	sleeping
sjloaperig	sleepy
moe	sleeve
sjnieje	slice
sjuuvele	slide
einigzins	slightly
sjmaal	slim
gesjlip	slip
hilling	slope
sjleuf	slot
troag	slow
troag	slowly
klein	small
fien	small
sjlum	smart
reuk	smell
ruuke	smell
lache	smile
lach	smile
rauk	smoke
glad	smooth
snèk	snack
snèkke	snack
sjlèk	snail
sjlang	snake
breke	snap
sjnieë	snow
dus	so
zoë leuk	so cute
tot zoeë wiet	so far
opsoeke	soak
zeip	soap
nuchter	sober
voetbal	soccer
sosjaal	social
gemeinsjap	society
zukke	socks
zach	soft
sofwêr	software
drek	soil
boojem	soil
verkoch	sold
oetverkoch	sold out
soldoat	soldier
allein	sole
inkel	sole
vàs	solid
oplossing	solution
oplosse	solve
vershiejene	some
eemes	somebody
op einige meneer	somehow
eemes	someone
gèt	something
soms	sometimes
leed	song
binnekort	soon
gedétàjeerd	sophisticated
verfiend	sophisticated
Sooraanie	Sorani
pien	sore
kêlpien	sore throat
zurrig	sorrow
Het schpiet mich	Sorry
sorteere	sort
gezòch	sought
ziejel	soul
zielsverwant	soulmate
geluid	sound
huure	sound
soep	soup
zoer	sour
bron	source
zuud	south
ruimte	space
plaats	space
sjpam	spam
besjtrieke	span
Sjpaans	Spanish
oetsjpare	spare
reserf	spare
sjpreke	speak
biezonder	special
soorte	species
spesifiek	specific
sjpèktaakulêr	spectacular
sjpietsj	speech
sjprakeloos	speechless
sjnelheid	speed
sjpelle	spell
vlook	spell
sjpendere	spend
gesjpendeerd	spent
kruidig	spicy
piek	spike
dreije	spin
sjpinazie	spinach
zieël	spirit
geis	spirit
sjpuuge	spit
fantastisch	splendid
verdeile	split
sjpliete	split
versjpille	spoil
verwind	spoiled
versjpild	spoiled
sjpontaan	spontaneous
leepel	spoon
sjpot	spot
plaats	spot
echgenoot	spouse
spreije	spread
lente	spring
plein	square
duuje	squeeze
vringe	squeeze
inkvush	squid
eekhoorn	squirrel
st	st
sjteke	stab
sjtabiel	stable
sjtapel	stack
personeel	staff
punt	stage
nivoo	stage
vlèk	stain
trappe	stairs
inzat	stake
sjtalke	stalk
vasloupe	stall
kroam	stall
sjtempel	stamp
sjtempele	stamp
sjtoon	stand
sjtand	stand
sjtandaard	standard
sjtèr	star
sjtart	start
beginne	start
gesjtart	started
hongerig	starving
sjtoat	state
verkloaring	statement
sjtasie	station
sjtandbeeld	statue
sjtatus	status
blieve	stay
houd dich good	stay safe
vàs	steady
biefsjtuk	steak
sjtele	steal
sjtaum	steam
sjtoal	steel
sjtiel	steep
sjtèngel	stem
sjtap	step
vasplekke	stick
vashoute	stick
sjtief	stiff
nog altied	still
stil	still
sjteek	sting
sjtekelig	stingy
reure	stir
veurroad	stock
gesjtole	stolen
verdrage	stomach
maag	stomach
sjtein	stone
sjting	stood
sjtool	stool
sjtop	stop
opsjlaag	storage
opsjloon	store
winkel	store
sjturm	storm
verhoal	story
ove	stove
rech	straight
duudelik	straightforward
gemeekelik	straightforward
las	strain
druk	strain
vrèm	strange
vrême	stranger
sjtrategie	strategy
rietje	straw
aardbei	strawberry
sjtreep	streak
stroam	stream
sjtruime	stream
sjtroat	street
krach	strength
benoadrukke	stress
sjtress	stress
oetrekke	stretch
sjtrik	strict
treffe	strike
sjtake	strike
sjloon	strike
koord	string
sjtrip	strip
sjtrippe	strip
noasjtreve	strive
sjlaag	stroke
besjlaag	stroke
sjtèrk	strong
gesjlage	struck
sjtruktuur	structure
sjtrieje	struggle
worstele	struggling
koppig	stubborn
vas	stuck
sjtudent	student
sjtudie	study
sjtudere	studying
sjpulle	stuff
euverweldigend	stunning
sjtom	stupid
sjtiel	style
ongerwerp	subject
versjturing	submission
versjture	submit
sjtof	substance
vervange	substitute
subtiel	subtle
sjlaage	succeed
succès	success
suksesvol	successful
zowie	such
zowie	such as
zuuge	suck
opins	sudden
opins	suddenly
lieje	suffer
lieje	suffering
genog	sufficient
sokker	sugar
veursjtille	suggest
suggèstie	suggestion
pak	suit
gesjik	suitable
koffer	suitcase
som	sum
samenvatting	summary
zomer	summer
top	summit
zon	sun
zondig	sunday
zonnig	sunny
zonsondergank	sunset
zonnesjien	sunshine
suuper	super
beter	superior
euvertriffend	superior
opzichter	supervisor
oavendete	supper
aanbod	supply
ondersjteuning	support
verondersjtille	suppose
verondersjtild	supposed
zeker	sure
oppervlak	surface
opsjpringe	surge
sjierurgie	surgery
achternoam	surname
verrasse	surprise
verras	surprised
euvergaaf	surrender
omgeeving	surrounding
toezich	surveillance
onderzeuk	survey
enquête	survey
euverleve	survive
verdachte	suspect
opgesjort	suspended
verdach	suspicious
onderhoute	sustain
vashoute	sustain
duurzaamheid	sustainability
duurzaam	sustainable
buit	swag
gesjtoole good	swag
doorsjlikke	swallow
wissele	swap
vlooke	swear
sjwere	swear
sjzweit	sweat
trui	sweater
vêge	sweep
zeut	sweet
sjloap good	sweet dreams
zeutekauw	sweet tooth
leefste	sweetheart
opsjzwelle	swell
szjwelle	swelling
sjwumme	swim
sjwumme	swimming
dreije	swing
verangere	switch
sjakele	switch
gesjzwolle	swollen
sjwaard	sword
simbool	symbol
simpatie	sympathy
simtome	symptoms
siesteem	system
toafel	table
tèkkele	tackle
leebel	tag
sjtart	tail
numme	take
weghoale	take away
hout dich good	take care
vertrik	take off
genomme	taken
sjprêke	talk
sjproakzaam	talkative
hoewig	tall
kraan	tap
insjudde	tap
plekband	tape
doel	target
taak	task
opdrach geve	task
sjmaak	taste
sjmakelijk	tasty
liejerde	taught
tee	tea
lieëre	teach
liejeraar	teacher
ploog	team
tiem	team
sjeure	tear
troane	tears
ploage	tease
technologie	technology
tan	teeth
vertil	tell
vertil mich	tell me
humeur	temper
tempere	temper
températuur	temperature
tempel	temple
tiejelik	temporary
tieën	ten
tieëndoezend	ten thousand
huurder	tenant
neige	tend
neiging	tendency
mals	tender
aanbesjteding	tender
gesjpanne	tense
sjpanning	tension
tent	tent
veurzichtig	tentative
termien	term
veurwaarde	terms
vreselik	terrible
fantastisch	terrific
terrietorium	territory
tès	test
teks	text
dan	than
dank	thank
bedanke	thank
danke	thank you
Bedank veur euch geduld onderwieles dat ver de zending noakieke	Thank you for your patience while we investigate shipment
hiejel erg bedank	thank you so much
hieël erg bedànk	thank you very much
bedank	thanks
Bedank das se osse app gebruuks	Thanks for using our app
dat	that
dat is	that is
dat is good	that's good
de	the
deefsjtal	theft
hunne	their
zie	them
teema	theme
hunzelf	themselves
dan	then
teorie	theory
doa	there
der zin	there are
der is	there is
doarom	therefore
dees	these
zie	they
zie zin	they are
dik	thick
deef	thief
diej	thigh
dun	thin
dink	thing
dinger	things
dink	think
derde	third
deurshtig	thirsty
dertieën	thirteen
dertig	thirty
dees	this
dit is	this is
grondig	thorough
grondig	thoroughly
die	those
allich	though
gedachte	thought
dach	thought
bedachzaam	thoughtful
gedachte	thoughts
doezend	thousand
drödje	thread
bedreiging	threat
bedreige	threaten
drie	three
drèmpel	threshold
enthoesjas	thrilled
bleuje	thrive
good doon	thrive
kêl	throat
door	through
aldoor	throughout
goeweje	throw
doem	thumb
donder	thunder
Donderdig	Thursday
dus	thus
aafvinke	tick
teek	tick
getij	tide
netjes	tidy
binge	tie
tieger	tiger
krap	tight
Tiegrienja	Tigrinya
tied	time
verleege	timid
hiël klein	tiny
tip	tip
fooi geve	tip
tips	tips
meug	tire
meug	tired
weefsel	tissue
titel	title
noa	to
om te zin	to be
ruuwestere	toast
sjneej wik	toast
vandaag	today
kleuter	toddler
tieëne	toes
same	together
wéécéé	toilet
vertild	told
toleransie	tolerance
tolereere	tolerate
tomaat	tomato
murrige	tomorrow
tong	tongue
venoavend	tonight
auch	too
noam	took
gereidsjap	tool
gereidsjap	tools
tand	tooth
top	top
onderwerp	topic
versjeurd	torn
martele	torture
totaal	total
aanraaking	touch
sjtèrk	tough
toer	tour
richting	toward
noa	towards
handdook	towel
durp	town
giftig	toxic
sjpoor	trace
sjpoor	track
paad	track
vollige	track
handele	trade
handel	trade
tradiesie	tradition
tradiesjoneel	traditional
verkieër	traffic
sjpoor	trail
paad	trail
trein	train
trêning	training
eigesjap	trait
eigensjappe	traits
doorzitte	transfer
euverzitte	transfer
euvergank	transition
vertaal	translate
vertale	translate
doorzichtig	transparent
transportere	transport
transportere	transportation
vàl	trap
voelnis	trash
trauma	trauma
reize	travel
trêj	tray
sjat	treasure
behandele	treat
behandeling	treatment
baum	tree
énorm	tremendous
trent	trend
zitting	trial
poging	trial
proof	trial
truuk	trick
geprobeerd	tried
oetlokke	trigger
oprope	trigger
bieknippe	trim
reiske	trip
probleme	trouble
brook	trousers
vrachwage	truck
woar	TRUE
kofferbak	trunk
vertroewe	trust
woarheid	truth
probere	try
Tsonga	Tsonga
buus	tube
Dinsdig	Tuesday
ljiergeld	tuition
kalkoen	turkey
turkije	turkey
koerkoema	turmeric
dreije	turn
sjildpad	turtle
lieërmeister	tutor
onderwieze	tutor
twelf	twelve
twintig	twenty
einentwintig	twenty-one
Twie	Twi
twieë kier	twice
omsjakeling	twist
twieë	two
tiepe	type
soort	type
tiepies	typical
liejelik	ugly
ultieme	ultimate
paraaplu	umbrella
neet in sjtoat	unable
onmeugelik	unable
nonk	uncle
neet bie bewuszin	unconscious
onder	under
dronder	underneath
ondergewaardeerd	underrated
begriepe	understand
begrepe	understood
helaas	unfortunately
geliek	uniform
uniek	unique
einheid	unit
universiteit	university
onbekind	unknown
tenzij	unless
tot	until
ongebruukelik	unusual
op	up
is aan dich	up to you
update	update
biewirke	update
opwaardering	upgrade
opwaardere	upgrade
op	upon
koad	upset
sjtedelik	urban
aandringe	urge
sjpoed	urgent
os	us
gebroeke	use
gebroek	used
nuttig	useful
nutteloos	useless
gewoone	usual
geweunlijk	usually
behulpzaamheid	utility
vakansie	vacation
vaksienasie	vaccination
vaksienere	vaccine
vaacuüm	vacuum
vaag	vague
geldig	valid
dàl	valley
waardevòl	valuable
wêrt	value
versheienheit	variety
vershillende	various
variëre	vary
vaas	vase
oetgesjtrek	vast
greunte	vegetable
greuntes	vegetables
voortuug	vehicle
verkauper	vendor
gif	venom
avontuur	venture
ondernumming	venture
plaats	venue
verifiëre	verify
veulzijdig	versatile
versie	version
vertikaal	vertical
erg	very
hieël good	very good
sjeep	vessel
via	via
sfeer	vibe
sfeer	vibes
verdorve	vicious
sjlachoffer	victim
viedeo	video
oetzich	view
meining	view
bekieke	view
durp	village
deef	villain
azien	vinegar
vàn weleer	vintage
gewèld	violence
geweldadig	violent
versjpreid	viral
maag	virgin
virtueel	virtual
deug	virtue
goodheid	virtue
viesie	vision
bezeuk	visit
bezeuke	visit
viezueele	visual
vitaal	vital
levendig	vivid
vookabulêr	vocabulary
sjtum	voice
lêgte	void
voluume	volume
vriewilliger	volunteer
sjpie	vomit
kwetsbaar	vulnerable
lwan	wage
lwan	wages
middel	waist
wach	wait
ober	waiter
wàchte	waiting
wakker	wake
wakker were	wake up
loupe	walk
loupe	walking
moer	wall
beursh	wallet
ronddwale	wander
wandele	wander
wille	wanna
wil	want
wool	wanted
gewild	wanted
oorlog	war
kleijerkas	wardrobe
magazien	warehouse
werrem	warm
waarsjuwe	warn
waarsjuwing	warning
krieger	warrior
woar	was
wesh	wash
aafval	waste
kieke	watch
water	water
watermeloen	watermelon
golf	wave
weeg	way
meneer	way
veer	we
veer zeen	we are
veer kinne	we can
zsjwaak	weak
sjwaakte	weakness
riekdom	wealth
rieke	wealthy
drage	wear
shlietaasj	wear
draage	wearing
versjliete	wearing
wèr	weather
broelof	wedding
Woonsdig	Wednesday
onkroed	weed
wêk	week
wiekènd	weekend
gewich	weight
gek	weird
welkom	welcome
weldoad	welfare
Nou	Well
good gedoon	well done
gegoon	went
woare	were
wès	west
naat	wet
walvush	whale
wat	what
wat dich	what about you
wat bisse aan het doon	what are you doing
wat bis se noe aan het doon	what are you doing now
wat bis se noe aan het doon	what are you doing right now
wat deis dich	what do you do
wat deis dich es beroep	what do you do for a living
wat bedoel se	what do you mean
wat wil se	what do you want
wat is der gebeurd	what happened
wat is	what is
wat is dit	what is this
wat is dien beroep	what is your job
wie hits dich	what is your name
alles good	what's up
wie hits dich	what's your name
wat dan auch	whatever
koore	wheat
wiel	wheel
wenniëh	when
wiennië dan auch	whenever
wo	where
wò bis se	where are you
wo kumse vandaan	where are you from
wo bis dich noe	where are you now
wo woon se	where do you live
wo is	where is
terwiel	whereas
of	whether
welleke	which
terwiel	while
onderwieles	while
fluustere	whisper
fluit	whistle
wit	white
wae	who
wêh bis dich	who are you
wêh is	who is
weh is dit	who is this
gans	whole
van weh	whom
van weh	whose
worom	why
worom neet	why not
verdreijd	wicked
wied	wide
weduwe	widow
breite	width
vrouw	wife
wild	wild
testament	will
wil	will
wille	willing
winne	win
wind	wind
vinster	window
weierig	windy
wieën	wine
winter	winter
wegvage	wipe
vêge	wipe
droad	wire
wiesheid	wisdom
wieës	wise
wunsh	wish
wunsh euch allenei het biste	wish you all the best
hèks	witch
mit	with
teruuktrikke	withdraw
teruuktrikke	withdrawal
derbinne	within
zonger	without
getuuge	witness
geistig	witty
wollef	wolf
vrouw	woman
vrouwluuj	women
gewonne	won
zal neet	won't
aafvroage	wonder
wonder	wonder
gewèldig	wonderful
hout	wood
wòl	wool
woord	word
weurt	words
wirreke	work
oetwirke	work out
trêne	work out
wirrike	working
wêreld	world
wurm	worm
verweerd	worn
bezurg	worried
zurg	worry
zurg make	worry
sjlechter	worse
veraafgooding	worship
slechste	worst
wêrde	worth
weert zin	worth it
verdeenstelik	worthy
zouw	would
wond	wound
Wòw	Wow
omwikkele	wrap
hieël koad	wrath
pols	wrist
sjrieve	write
Hie sjrieve	Write here
sjrieve	writing
gesjreve	written
verkierd	wrong
gesjreve	wrote
gaard	yard
gaap	yawn
gape	yawn
Joa	Yeah
joar	year
joare	years
gis	yeast
sjrieëve	yell
geel	yellow
Joa	Yes
joa sjat	yes baby
joa leefste	yes dear
joa leefste	yes honey
joa mien leefste	yes my love
joa natuurlijk	yes of course
gistere	yesterday
nog	yet
opbrings	yield
doe	you
dich	you
dich bis	you are
dich bis sjoeën	you are beautiful
dich bis zoeë sjoeën	you are so beautiful
gèr gedoon	you are welcome
doe kins	you can
Wit se	You know
dich auch	you too
gêr gedoon	you're welcome
jonk	young
diene	your
gèr gedoon	your welcome
dichzelf	yourself
jeugdig	youth
gêr gedoon	you’re welcome
lekker	yummy
gein	zero
nul	zero
