muntu	a
tshintu	a
kakese	a little
bia bungi	a lot
bintu bia bungi bia	a lot of
kusundula	abandon
kusundula	abandoned
kulekela	abandoned
kufuanangana	abide
bukola	ability
udi mua	able
bua	about
pa mutu pa	above
ku babenda	abroad
kubenga kwikala ku	absence
kumbuka	absent
amu nanku	absolutely
kunua	absorb
malu adi kaayi umvuika	abstract
kabiena biunvuika	absurd
bungi	abundance
biabungi	abundant
kunyanga	abuse
kutamba kuakwila	accent
kwitaba	accept
kubuela	access
njiwu	accident
kusombesha mu nzubu	accommodation
bilondeshila	accommodation
kuenza	accomplish
bienza	accomplished
bilondeshila	according
mushinga	account
kubala	account
lungenyi	accuracy
mijalame	accurate
kufunda	accused
bubi	ache
kujikija	achieve
dienza	achievement
kumanya	acknowledge
dimanya	acquaintance
kupeta	acquire
bipeta	acquired
kupeta	acquisition
kuangata	acquisition
ku pitshila	across
mukenji	act
kuenza	action
wenza mudimu	active
midimu	activities
mudimu	activity
muenji wa filime	actor
mpindieu	actual
mu bulelela	actually
lelu	actually
musongeka	acute
kushintulula	adapt
kukumbaja	add
misuikibua	addicted
kukumbaja	addition
bikuabu	additional
adrese	address
mwimpa	adequate
mukumbana	adequate
kutuangana	adjacent
tshilejelu	adjective
kululamija	adjust
kusanka ne	admire
kwitaba	admit
kuangata	adopt
bilenga bilaya	adorable
kuya kumpala	advance
kuya kumpala	advanced
diakalenga	advantage
malu a njiwu	adventure
tshiambilu	adverb
piblisite	advertisement
mikenji	advertising
mubelu	advice
mubedi	advise
Mulumbuluidi	advocate
bilengejelu	aesthetic
bualu	affair
kubungama	affect
dinanga	affection
kuanyisha	afford
kusomba ni bantu	affordable
buôwa	afraid
panyima	after
sendamu wa diba	afternoon
pashishe	afterwards
kabidi	again
kubenga	against
bidimu	age
tshibambalu	agency
bena mudimu	agent
mwena lonji	aggressive
kunyungakana	agile
kukadi	ago
kwitaba	agree
diunvuangana	agreement
mianda ya kudima	agriculture
kumpala	ahead
diambuluisha	aid
tshipatshila	aim
lupepa	air
tshipalu	airport
kajila	aisle
lubila	alarm
maluvu makole	alcohol
alcool	alcohol
kwikale mutabale	alert
mudimuka	alert
kwikala ni moyi	alive
bonso	all
bidi nangu	all right
nnujingila anu disanka	all the best
dianyisha	allow
dianyisha	allowed
pabuipi	almost
nkaya	alone
mubula bua	along
ukadi	already
Bimpe menemene	Alright
kabidi	also
awu	also
tshiakuenza tshikuabu	alternative
nansha mudi	although
tshiendelele	always
ndi	am
bualu bua dikema	amazing
mabuelakane	ambiguous
tshipatshila	ambition
manjingu	ambitious
kushintulula	amend
mu nkatshi mua	amid
mu nkatshi	among
mu nkatshi muetu	among us
bunyi bua makuta	amount
kusekesha	amusing
tshintu	an
kutangidila	analysis
bankambwa	ancestors
longo lua mazuwa	anchor
tshia kala	ancient
ne	and
anu wewa	and you
muanjelu	angel
tshinji	anger
lubadi	angle
tshinji	angry
nyama	animal
tupombo	ankle
dituku dia diledibua	anniversary
ngumu	announcement
kutondesha	annoy
kufika munda	annoyed
kutonda	annoying
ku tshidimu	annual
kusokoka dina	anonymous
mukuabu	another
diandamuna	answer
ka-diosha	anticipate
kanyinganyinga	anxiety
kunvua kabuôwa	anxious
nansha tshintu kayi	any
bungi bupita	anymore
eu yonsu	anyone
tshintu tshionsu	anything
nansha nanku	anyway
nansha nanku	anyways
kumbusha	apart
nzubu	apartment
kulomba lusa	apologize
bidi bimueneka	apparent
mbimueneka ni	apparently
dibila	appeal
kupatuka	appear
kumanyika	appear
mpala	appearance
kupatuka	appeared
nzala	appetite
tshimuma tshia pome	apple
kulomba	application
kulomba	apply
muangate tshipungidi	appointment
kunanga	appreciate
kutua mushinga	appreciate
kusanka	appreciation
kusemena pepi	approach
kuakanyine	appropriate
kwanyisha	approval
kuitaba	approve
kuitabijibua	approved
mitua ku	approximately
ngondu wa dikumi	april
amu nunku	arbitrary
mwuibaki	architect
luibaku	architecture
mikanda ya kala	archive
badi	are
utu	are you
udi wenza mudimu	are you busy
ukadi musela	are you married
ukadi musela anyi utshiena mujika	are you married or single
Utshidi pu anyi?	Are you still there?
udi popu anyi	are you there
muaba	area
kuakwila	argue
malu a kwamba	argument
kujuka	arise
diboku	arm
masalayi	army
kumibangabanga	around
kulongolola	arrange
diunvuangana	arrangement
difika	arrival
kufika	arrive
kufika	arrived
kudisua	arrogant
muketa	arrow
mudimu wa bienza	art
tshiena bualu	article
tshia kubianza bia bantu	artificial
muenji wa mudimu wa bianza	artist
bu mudi	as
patshidi	as long as
kabidi	as well
tetela kabidi	as well as
butu	ash
bia bundu	ashamed
kukonga	ask
lukonku	asked
kulala	asleep
mmuenenu	aspect
Assamese	Assamese
kupenda	assault
mpungilu	assembly
udi wakwisha	assertive
kukonkonona	assess
kukonkonona	assessment
tshienza	asset
wenza mudimu	assets
kufila mudimu	assign
mudimu	assignment
kuambuluisha	assist
muambuluishi	assistant
kusangisha	associate
mulunda	associated
nsangilu	association
kufuanyikija	assume
lungenyi lua bualu	assumption
mu	at
kudi	at
kadi	at least
nansha nanku	at least
uvua mudia	ate
muena manaya a ditembangana	athlete
kulamakaja	attach
mu tshisakidila	attached
aa	attached
kulamata	attachment
kubangisha	attack
diteta	attempt
kwuikala mu	attend
kwuikala	attendance
ntema	attention
mmuenenu	attitude
lungenyi	attitude
kukoka	attract
kukoka ntema	attraction
kukoka ntema	attractive
kusankisha	attractive
ngikadilu	attribute
bantu	audience
ngondu wa muanda mukulu	august
tatu mukaji	aunt
tatu mukaji	aunty
mulelela	authentic
mufundi	author
bukokeshi	authority
muvu wa luya	autumn
kwikala ku	available
bungi	average
kuepuka	avoid
mutabala	awake
kupesha	award
udi ne dimanya	aware
kuondo ka muoyo	awareness
kulepa	away
bimpe bikole	awesome
bienza buôwa	awful
mukonyangala	awkward
Aymala	Aymara
muana mutoka	baby
dipolome	bachelor
kunyima	back
mmunyima	background
ku luseka	background
bubi	bad
tshibuta	bag
buteyi	bait
kubobesha	bake
tshiapu tshia mampa	bakery
shota	baking soda
tshipiminu	balance
ndundu	ball
Bambala	Bambara
tshibota	banana
tshisumbu	band
kuseka	bang
kwabisha	bang
banke	bank
binuinu bia maluvu	bar
anu mpindieu	barely
diunvuangana	bargain
kudila bu mbua	bark
orje	barley
tshipumbishi	barrier
mpwilu	base
tshia mushinga	base
mwashila	based
mutekela	based
muinshi mwa maloba	basement
bia mbangilu	basic
nanga nanga	basically
musenga	basil
muana wa ndumda	bastard
kusangisha mi bisumbu	batch
kowa mayi	bath
tshiowedi	bathroom
bateri	battery
nvita	battle
tumuma tua muitu	bay
kuikala	be
dilama bimpe	be careful
kumpenga kwa musulu	beach
dintanfu	beam
nkunda	beans
tshisumpa-ntambue	bear
muedi	beard
kujikija	bearing
nyama	beast
kutshimuna	beat
kututa	beat
buimpa	beautiful
buimpa	beauty
kulua	became
bualu	because
kulua	become
bulalu	bed
nzubu wa kuladila	bedroom
lubulubulu	bee
ngombe	beef
kujikija	been
maluvu	beer
kumpala	before
mubangisha	began
kubanga	begin
mbangilu	beginning
mu dina dia	behalf
kuikala ne ngikadilu	behave
ngikadilu	behavior
ngikadilu	behaviour
panyima	behind
kwikale	being
malu audi muitabuja	belief
kutekela moyi	believe
difu	belly
kubuela mu	belong
munangibua-musuibue	beloved
kwinshi	below
mukaba	belt
tshibasa	bench
kubunya	bend
muinshi	beneath
masanka	benefit
masanga	benefits
ku luseka lua	beside
pambelu pa	besides
bimpe	best
nkujingila diakalenga	best of luck
ushala bimpa	best regards
bimpe menemene	better
mu nkatshi mua	between
maluvu	beverage
diamomua	beyond
Bhojpuli	Bhojpuri
kupitshila ku	bias
tshia kansungansunga	biased
dikalu	bicycle
dipa	bid
bunena	big
dikalu	bike
kakanda ka difuta	bill
kusuika	bind
kanyunyi	bird
mufikilu wa dituku dia mbotema	birthday
ndambu	bit
kusuma	bite
bululu	bitter
mufika	black
dipaya	blade
kufila tshilema	blame
mutoke	blank
bulanketa	blanket
kubutula	blast
mayi ya javel	bleach
kusambakaja	blend
kubenesha	bless
mutapika	blessed
nfofu	blind
disanka	bliss
tshibambalu	block
mashi	blood
kuela bilongu	bloom
kupudila	blow
bule	blue
kukonyangala	blunt
mubelu	board
buatu	boat
mibidi	body
kusabisha	boil
munena	bold
kusuika	bond
mufuba	bone
mukanda	book
kukolesha	boost
kukolesha	booster
bikumba	boot
bikumba	boots
mikalu	border
disosu	bore
kutonda	bored
tshitondesha	boring
kuledibua	born
kusomba	borrow
mukalenge	boss
bonsu babidi	both
kunyanga	bother
mulangi	bottle
muinshi	bottom
tshisumba	bought
kujukulula	bounce
kutumpika	bound
mikalu	boundaries
buta	bow
tshibakudi	bowl
kasheta	box
muana wa balume	boy
mulunda wa balume	boyfriend
kakanu ka kudiboku	bracelet
kabongoshi	brain
ditamba	branch
tshimanyinu	brand
muena dikima	brave
kutupakana	breach
diampa	bread
dikisha	break
kutshibula	break
biakudia bia mudinda	breakfast
dibela	breast
Mupuya wa mu diulu	breath
kupuyakana	breathe
dikoba	breed
didiotu	brick
misedibua	bride
tshilamba	bridge
tshipi	brief
udi ukenka	bright
kukengesha	brilliant
kufila	bring
di	bro
bunene	broad
dikuma dia meyi mu kapepa	broadcast
kukoseka	broke
kutshibula	broken
lukombu	broom
muanetu wa balume	brother
bukonda	brother in law
kufila	brought
kulua nabi	brought
mufikuluka	brown
bulosu	brush
kambumba	bucket
mulunda	buddy
makuta	budget
koshia ka bogue	bug
kwibaka	build
nzubu munene	building
mibaka	built
mu bunene	bulk
ngombe	bull
mujima	bully
tshiuja	bump
kasumbu ka tshilongo	bunch
kusuika tubuki	bundle
bujitu	burden
mmujikibwe	buried
koshia	burn
kutayika	burst
kujîka	bury
mashinyi	bus
ka mutshi	bush
kompani	business
kunyanga	bust
kwikala ne mudimu	busy
kadi	but
manteka	butter
tshibeyibeyi	butterfly
lubota	button
kusumba	buy
kudi	by
kupitshila	by
nansha nanku	by the way
kulayangane	bye
chou	cabbage
nzubu wa mudimu	cabinet
musasa	cage
kato	cake
ngombe	calf
kubikila	call
mbikila	call me
mubikila	called
dipuwa	calm
ditalala	calm
kulua	came
kampanye	campaign
udi mua	can
kuena mua	can't
kwimanyika	Cancel
kumbusha	Cancel
disama dia kansere	cancer
makanda a	capable
bukola	capacity
musoko munene	capital
mmianu	caption
kukwata	capture
mashinyi	car
moyi	career
kuenza malu bimpa	careful
bimpa	carefully
kupanga budimu	careless
bulenga	caring
muenji wa mabaya	carpenter
muakulu wa karpe	carpet
tshimuma tshia karote	carrot
kwambula	carry
kutungunuka	carry on
kuenza	carry out
bualu	case
mabeji	cash
kuimansha	cast
nzubu wa bakalenga	castle
bua mpuka mpuka	casual
mpusu	cat
kukwata	catch
mishindu	category
mikoku	cattle
ku kuata	caught
tshidi tshifikisha	cause
tshibawu	caution
didimuja	cautious
tshisokomenu	cave
kulekela	cease
tshisasa	ceiling
kusekelela	celebrate
shambre	cell
mu nkatshi	center
bidimu lukama	century
ntete	cereal
musekelelu	ceremony
kushindika	certain
kakuyi mpata	certainly
mukanda	certificate
nkanu	chain
nkwasa	chair
lutatu	challenge
diakalenga	chance
kushintuluka	change
tshinyangu	chaos
bumuntu	character
ngikadilu	characteristics
bujitu	charge
dinanga	charity
kufila kapalusa	charity
mulenga	charming
karte	chart
kuipata	chase
kuyikila	chat
kupanyibua bimpa	cheap
kwiba	cheat
kwuibila	cheat
kwuiba	cheating
kukenketa	check
kutangila	check
ditama	cheek
kututa bikashi	cheer
ne disanka	cheerful
kututa bikashi	cheers
fromaje	cheese
chimi	chemistry
kunanga	cherish
mulisangu yonsu ya kubula	chess
tshiadi	chest
kuboza ku menu	chew
nzolu	chicken
nfumu	chief
muana	child
buana	childhood
bana	children
mashika	chill
kajila	chimneys
tshibanga	chin
nsukadi	chocolate
shokola	chocolate
kusungula	choice
kusungula	choose
kuzaza	chop
mudimu mukole	chores
matama manene	chubby
tshitendelelu	church
kinamona	cinnamon
tshijengu	circle
bikondu	circumstances
muena kalaba	citizen
musoku	city
kulomba	claim
kutokesha	clarify
kalasa	class
malaba	clay
kumbusha dinyanu	clean
biunvuika	clear
mufundi	clerk
mwena meji	clever
kiliya	client
mukuna	cliff
kapepa	climate
kubanda	climb
kuja	clingy
dîba	clock
kukanga	close
kabadi	closet
mukusu wa tshilamba	cloth
bilamba	clothes
matutu	cloud
mubuikila kudi matutu	cloudy
ka mmuntu	clown
tshijadiki	clue
mukonyangala	clumsy
tshishishi	cluster
mulongeshi	coach
makala	coal
lubadi	coast
ku muelelu	coast
tshizaku	coat
kafe	coffee
mu lungenyi	cognitive
mpukapuka	coincidence
mashika	cold
dikuluka	collapse
mabue a busanga	collar
mulanda wa ku mudimu	colleague
bena mudimu netu	colleagues
kusangisha	collect
kusangisha	collection
kasumbu	college
mubidi	color
malu a mâyi a matamba adi kaayi ne mekala adi alala ne tshiji tshikole	colorless green ideas slept furiously
mubidi	colour
dikunji	column
tshisaku	comb
nsangilu	combination
kusangisha	combine
luaku	come
luaku apa	come here
tuyayi	come on
muaba wa bukubi	comfort
tshidi tshisankisha	comfortable
kulua	coming
bidi bilua	coming soon
kutuma diyi	command
diandamuna	comment
kuenda mushinga	commercial
kasumbu	commission
kuenza	commit
kudifila	commitment
mudifila	committed
bintu bia mushinga mukole	commodity
bonsu	common
difuanangana	common
kuyikila	communicate
kuyikila	communication
tshisumbu	community
kubanga kupweka	commute
munanga	companion
kumpanyi	company
kuteta	compare
kufuanyikija ku	comparison
kunvua lusa	compassion
kunvua luse	compassionate
kunvuangana	compatible
kuluangana	compete
ni dimanya	competent
kufwila	competition
kuluila	competitive
kudilakana	complain
kudilakana	complaint
nsakidilu	complement
kabujima	complete
tshionsu tshijima	completely
lutatu	complex
bia momumue	compliance
bualu bukola	complicated
tuasakidila	compliment
ku divuija bu	comply
bulongolodi	composition
bidi ne	compound
ngunvuilu	comprehension
udi ne diunvua	comprehensive
kunyanguka	compromise
kuenzejibua	compulsory
ordinatere	computer
kutuishile mêsu pa	concentrate
ngunvuilu	concept
kwelangana meji	concern
kanyinganyinga	concern
muena bualu	concerned
konsere	concert
kushikija	conclusion
dibua	concrete
tshi udi ni tshia kuenza	condition
bia kuenza	conditions
kuendesha	conduct
tshisangilu	conference
kutonda	confess
sekele	confidence
muntu wa kutekela moyo	confident
kujadika	confirm
makokianganyi	conflict
kujimina	confused
dibungakana	confusion
kututshila bikashi	congrats
tuasakidila	congratulation
tuasakidila	congratulations
kalamakaji	conjunction
kutuangaja	connect
kutshimuna	conquer
dimanya	conscious
didimanya	consciousness
kuitaba	consent
bipeta	consequences
mamuma	consequences
kulama tshintu	conservation
muntu udi mulamata ku bilele bia kala	conservative
mulami wa bintu	conservative
kuelangana meji	consider
kutua mushinga	consider
kumona	consider
kutangidila	considered
kuleja	consist
dilondangana	consistency
diunvuangana	consistent
kupanga nshikilu	constant
matuku onsu	constantly
constipatio	constipation
kwibaka	construction
kudia	consume
kudia	consumption
kutuilangana	contact
kutampakana	contagious
kulama	contain
kukanga	contain
bidi ne	contains
ba mu tshikondu tshietu	contemporary
kupepeja	contempt
bia munda	content
dinaya	contest
mishindu	context
kontinent	continent
tungunuka	continue
kunvuangana	contract
diunvuangana	contrast
kufila	contribute
kwambuluisha	contribute
kupa	contribution
kudikanda	control
makokianganyi	controversial
bintu bia mushinga	convenience
kuteka mu tshienzedi	convenient
muyuki	conversation
kukudimuna	convert
kutumina	convey
kutuisha	convince
mutuishibua	convinced
kulamba	cook
munkatshi mua kulamba	cooking
bimpe	cool
diunvuangana	cooperation
ku dienzela malu	cope
kuivre	copper
moyi	core
matala	corn
ditumba	corner
bia bushuwa	correct
mushinga	cost
bilela	costume
shenete	cottage
ndanda	cotton
nkwasa wa bulalu	couch
lukosu	cough
udi mua	could
mibelu	council
kubala	count
kabadi ka dibadila makuta	counter
ditunga	country
kampanye	countryside
bena dibaka	couple
makanda	courage
malongesha	course
kukeba	court
kalolo	courtesy
mwana wa tatwende	cousin
tshibuikidiji	cover
ngombe	cow
mupungila	coward
bimpa	cozy
krabe	crab
mutanta	crack
mudimu wa bianza	craft
tunvi	crap
njiwu	crash
majinga	craving
ukalaba	crawl
ditomboka	crazy
kufuka	create
dienza malu	creative
kusomba	credit
kufinunuka	creep
wenza bowa	creepy
tshisumbu	crew
malu mabi	crime
kunvuija buôwa	cringe
kusama	crisis
malu malomba	criteria
bibi bikola	critical
kujana	criticism
bilela	crop
nsombelu	crops
nkulusa	cross
tshikololu	crow
tshisumbu	crowd
muula	crowded
tshifulu tshia butumbi	crown
ditamba bunena	crucial
tshikisu	cruel
luendu	cruise
kuzaza	crush
muadi	cry
konkombre	cucumber
kuakidila	cuddle
nsombelu	culture
budimu	cunning
dikopu	cup
kabadi	cupboard
kutonyama	curb
kondopa	cure
kuvrefe	curfew
lukuka	curiosity
lungenyi lua kumanya malu	curious
miongu miongu	curly
folanga	currency
pindieu	current
eu	current
lelu	current
mpindieu	currently
mulawu	curse
tshilamba tshia kukosolola natshi	curtain
kuse	cushion
tshilele	custom
kiliya	customer
tshitadi tshia douane	customs
kukosa	cut
mulenga	cute
luendu	cycle
dikalu	cycling
tatu	dad
tatu	daddy
dituku dionsu	daily
tshifidi tshia mabela	dairy
tshilamba	dam
bia dibungama	damage
kufila tshilema	damn
mutalela	damp
maja	dance
njiwu	danger
njiwu	dangerous
mîdima	dark
munanga	darling
kuya lukasalukasa	dash
malu	data
dituku	date
mwana mukaji	daughter
dituka	day
lufu	dead
dituku dia ndekelu	deadline
mpudi matshi	deaf
diunvuangana	deal
munanga	dear
Banangibua Bonsu	Dear All
Musumbi musuibwe	Dear Customer
Baledi Baswibue	Dear Parents
Mukalenga Muswibue	Dear Sir
Balongi baswibue	Dear students
Tshisumbu Tshiswibwe	Dear Team
lufu	death
nkonku ne mandamuna	debate
kukosa	debit
bukoya	debris
dibanza	debt
bidimu dikumi	decade
menu mabola	decay
mufua	deceased
kushima	deceive
ngondu wa dikumi ne muidibi	december
bikumbana	decent
kupangadika	decide
kupangadika	decided
dipangadika	decision
tshilamba	deck
dikuluka	decline
kupuekesha	decrease
bia	dedicated
kudipesha	dedication
tshienzedi	deed
mondoka	deep
ngulungu	deer
tshilema	default
kubula	defeat
kuluila	defend
kujingulula	define
bulelela	definitely
diumvuija	definition
bunyi	degree
mushindu	degree
kujingakana	delay
kunenga	delay
kujingakaja	delayed
kumbusha	delete
midifidi	deliberate
ntshiteketa	delicate
muenya	delicious
disanka	delight
musanka	delighted
kupesha	deliver
kufikisha	delivered
kufikisha	delivery
kulomba	demand
kulomba ku makanda	demanding
mungalata	democracy
demona	demon
demon	demon
lejayi patoka	demonstrate
kubenga	denied
bungi	density
mondopu wa mênu	dentist
kubenga	deny
tshibambalu	department
diya	departure
bidi bifuma ku	depend
kutuma	deploy
tshibutshilu	deposit
kuelangana meji	depressed
kuelangana meji	depression
buondokudoku	depth
kunvuija	describe
diumvuija	description
dîtu	desert
kukumbane	deserve
kufuka	design
dina	designation
dijinga	desire
biro	desk
kujimija ditekemena	despair
mushikila	desperate
nansha	despite
biakudia bia bipepele	dessert
kufika	destination
njila	destiny
kobumbula	destroy
kabutu	destruction
malu a makese	detail
malu a makese	details
kupeta	detect
lukunukunu	determination
kumanya	determine
kupangadika	determined
kubutula	devastated
kukolesha	develop
tshienza	developed
kukolesha	development
tshiamu	device
diabulu	devil
kudifila	devoted
Dhivehi	Dhivehi
disama dianyama	diabetes
mmunda mpulumuku	diarrhea
ajenda	diary
dictionnere	dictionary
uvua muenza	did
kufua	die
mufua	died
ndilu	diet
dishilangana	difference
kushilangana	different
lutatu	difficult
kumbula	dig
kannemu	dignity
udi ne tshisumi	diligent
kudia	dinner
kuina	dip
munkatshi mua kuenzeka	direct
buludiki	direction
muludiki	director
dinyanu	dirt
bukoya	dirt
ni manyanu	dirty
kumbusha	disable
kukanga	disabled
kujimina	disappear
kuteketa mu mikole	disappointed
tshipupu	disaster
kuimansha	discard
kupanga midilu	discharge
dinyoka	discipline
dipuekesha	discount
kumona	discover
kansungansunga	discrimination
kuyikila	discuss
diyuki	discussion
disama	disease
masama	diseases
bavuale bu	disguise
tshia manyanu	disgusting
dilongu	dish
dilongu	dishes
kubenga	dismiss
kutuma	dispatch
lumuenu	display
mapangadika	disposal
matandu	dispute
kula	distance
kushilangana	distinct
kusunguluja	distinguish
dikenga	distress
kuabanya	distribution
distrike	district
kunyanga	disturb
dishilangana dinene	ditch
kudîna	dive
bia bungi	diverse
bia bungi	diversity
kutapulula	divide
tshia nzambi	divine
kutapuluka	divorce
tshinyungannyunga	dizzy
kuenza	do
wewa udi	do you
udi munanga anyi	do you love me
munganga	doctor
mikanda	document
kuenza	does
kena ni	doesn't
mbua	dog
Dogli	Dogri
kuenza	doing
popi	doll
mianda ya	domain
muena mudimu	domestic
kutuma diyi	dominant
tshiena	don't
kusamishi mutu to	Don't worry
kunvu bowa to	Don't worry
kufila	donate
kujikija	done
mpunda	donkey
diamba	dope
bibidi	double
kuelakana	doubt
pate	dough
kuinshi	down
kuela mu tshiamu	download
dibeji	draft
kufinunuka	drag
kubueja	drain
kwakidila	drain
dikenga	drama
kuzola	draw
tirware	drawer
tshinfuanyi	drawing
buôwa	dread
tshilota	dream
nkanzu	dress
kutubula	drill
kunua	drink
kwendesha	drive
dimata	drop
kulekela	dropped
mushipu	drought
diuma	drought
kukwatshika	drunk
tshiuma	dry
dibata	duck
di	dude
tshidi tshilombibua	due
bua bualu bua	due to
bifikuluka	dull
mutatakana	dumb
tshilaminyi tshia bukoya	dump
bula	duration
munkatshi mua	during
lupuishi	dust
mudimu	duty
kushala	dwell
munkatshi mua difua	dying
tshintu tshionsu	each
umue ne mukuabu	each other
ni dijinga	eager
nyunyi wa mukanku	eagle
ditshi	ear
pa tshiatshia	earlier
pa tshiatshia	early
kutshimuna	earn
matshi	ears
buloba	earth
kunyungakane kwa buloba	earthquake
bipepela	ease
bipepele	easily
este	east
bualu buteketa	easy
kudia	eat
munkatshi mua kudia	eating
mianda ya kuenzela makuta	economic
malu a kulama makuta	economy
mibangabanga	edge
kushintulula	edit
kalasa	education
bipeta	effect
kumona bipeta	effective
bipeta biakane	efficiency
bipeta	efficient
madikolela	effort
diyi	egg
bijilujilu	eggplant
Njilu	eggplant
lumu	ego
muanda mukulu	eight
dikumi ne muanda mukulu	eighteen
makumi muanda mukulu	eighty
ikala	either
anyi	either
kuenza	elaborate
lukenyibwa	elbow
mukulu	elder
muntu mukole	elderly
mwimpa	elegant
malu	element
nzevu	elephant
dikumi ni umue	eleven
mwanyishibua	eligible
kumbushibua	eliminate
mukwabu	else
kunvua bundu	embarrassed
bundu	embarrassing
kuakidila	embrace
kupatula mpala	emerge
malu a lukasa	emergency
mutudi tu diunvua	emotional
kwikala ne luse	empathy
ngakwilu	emphasis
kwela mushongi	emphasize
bena mudimu	employee
bena mudimu	employees
patron	employer
mudimu	employment
mutupu	empty
kubangisha	enable
tshisangilu	encounter
kukolesha mu mikolo	encourage
kushikila	end
munkatshi mua dijimina	endangered
madikolesha	endeavor
kutantamena	endurance
kutantamana	endure
muena lukuna	enemy
makanda	energy
kuangata	engage
kudifila	engaged
kudifila	engagement
motere	engine
mumanyi wa malu	engineer
anglais	English
kulongolola	enhance
kuanyisha	enjoy
tshinena bikola	enormous
dikumbana	enough
kujadika	ensure
kubuela	enter
dinaya	entertainment
disanka dikole	enthusiasm
ne disanka	enthusiastic
mujima	entire
tshiena bualu	entitled
tshiapu	entity
kubuela	entrance
mudienzedi wa mudimu	entrepreneur
amvelope	envelope
mwaba	environment
dijinga	envy
mule	epic
tshipupu tshia masama	epidemic
momumue	equal
biamu bia mudimu	equipment
bululame	equity
bumudi	equivalent
kukupula	eraser
tshilema	error
kunyema	escape
nanga nanga	especially
diteta	essay
kasolonyi	essence
tshia mushinga mukole	essential
kujadika	establish
muitabijibua	established
bidi bitangila muanda wa	estate
kutshintshika	estimate
kutshinka	estimated
ni bintu bikwabu	etc
tshiendelele	eternal
ngenzelu wa malu	ethics
kukonkonona	evaluate
kukonkonona	evaluation
kabidi	even
nansha	even
nansha biobi bikala	even though
dilolo	evening
bualu	event
ku ndekelu	eventually
nansha kakese	ever
bionsu	every
bantu bonsu	everybody
bonsu	everyone
bionso	everything
bijadiki	evidence
bubi	evil
kukola	evolution
kukola	evolve
Ewe	Ewe
kale	ex
bulelela	exact
anu nanku	exactly
kukonkonona	exam
kukonkonona	examine
tshilejelu	example
kupita	exceed
bimpa be	excellent
kumbusha anu	except
kumbusha	exception
bungi bupita	excess
kupitshisha	excessive
kushintula	exchange
disanka	excited
disanka	excitement
bisankisha	exciting
anu	exclusive
lusa	excuse
nfuila lusa	excuse me
kwenza	execute
ngenzelu	execution
muenji wa midimu	executive
kuditatshisha	exercise
kuditeta	exercise
kunyema	exhaust
kupungila	exhausted
kuleja bantu	exhibit
kupatula kubantu	exhibit
kupatula patoka	exhibition
kwuikala	exist
kwikala ku	existence
ukatu pu	existing
kumbuka	exit
kukolesha	expand
kwindila	expect
mwadila	expected
kutulu makuta	expenses
mushinga mukole	expensive
dimonamona dia malu	experience
malu mamonamona	experiment
muena menji	expert
ntshijika	expired
kwakwila	explain
kulumbulula	explanation
kuenzela	exploit
kutangila	explore
kutuma	export
kupatula	expose
kuleja	exposed
kupatula patoka	exposure
kwamba	express
tshiambilu	expression
kutantshisha	extend
kulepesha	extended
ditamba	extension
kutanganaka	extent
pambelu	external
ntshijima	extinct
tshia nsakididi	extra
tshitupa	extract
biadikema	extraordinary
bikola	extreme
bikola	extremely
dîsu	eye
mêsu	eyes
tshilamba	fabric
bimpa be	fabulous
mpala	face
kupepejila	facilitate
kuasa	facilities
kupepeja	facility
malu	fact
mufundi wa mikanda	factor
tshiapu	factory
mianda	facts
kujimina	fade
kubula	fail
kubula	failed
kubula	failure
mutshioku	faint
buakane	fair
bia kumbanyi	fairly
tshikena kumuana	fairy
ditabuja	faith
muena lulamatu	faithful
mafi	fake
kukuluka	fall
mafi	FALSE
butumbi	fame
mulunda	familiar
dîku	family
nzala	famine
mumanyika bikola	famous
tshiamu tshia lupepele	fan
meji a patupu	fancy
bilenga	fantastic
kulepa	far
nushala biakana	farewell
kudima	farm
tshidima	farmer
tshikemesha	fascinating
nvuadilu	fashion
lukasa	fast
mafuta	fat
kujiwula	fatal
dilongolola	fate
tatu	father
mutshioku	fatigue
ditshioka	fatigue
tshilema	fault
munangibua	favorite
mudimu	favour
tshintu munanga	favourite
kutshina	fear
difesto	feast
disala	feather
ngenzelu	feature
ngikadilu	features
ngondu mwibidi	february
ku tshioka	fed up
makuta	fee
biakudia	feed
lumu	feedback
ku diunvua	feel
majiya	feeling
makasa	feet
kushipa	fell
muinetu	fellow
krayon	felt
mukaji	female
tshibuelelu	fence
udi ni diminu	fertile
tshibilu	festival
kuya kukeba	fetch
mubidi kapia	fever
tshikesa	few
kumbushila	fewer
bikesa	fewer
mubanfila	fiance
bintu bifuanyikija	fiction
budimi	field
lonji	fierce
dikumi ni itanu	fifteen
makumi atanu	fifty
nvita	fight
nvita	fighting
kuisu	figure
kupangadika	figure out
kuteka	file
kuuja	fill
muula ntenta	filled
filime	film
ni mafuta	filthy
ku ndekelu	finally
makuta	finance
nfranga	financial
makuta	financial
kupeta	find
kupeta	find out
kumanya	find out
bimpa	fine
minu	finger
kujikija	finish
kujikija	finished
mudilu	fire
kumpanyi	firm
tshia kumpala	first
dîna dia kumpala	first name
tshikela	fish
kushintulula	fit
itanu	five
kulongolola	fix
kumanyika	fixed
dibendele	flag
mupenya	flash
tshialabala	flat
tshilema	flaw
kakuyi kalema	flawless
kunyema	flee
dikoba	flesh
uvua mubuuka	flew
kuzakala	flex
kutunya	flex
dinyunga	flexible
dibuka	flight
kupingana	flip
kusaka mananga ne muntu udi kayi muena dibaka nebe	flirt
diambishangana	flirt
ku naya ni majinga a muineba	flirting
kulenga	float
kuula kwa misulu	flood
malaba	floor
bukula	flour
kupwekesha	flow
tshilongu	flower
gripe	flu
bimpa	fluent
misangu ya bungi	fluent
bimpa	fluently
kupanga buondoka	fluffy
malu adiluila kakuyi lutatu	fluid
kubuka	fly
kutuija mêsu	focus
dibungi	fog
mabungi	foggy
kutunya	fold
bantu	folks
kulonda	follow
kulongesha	follow up
tshidi tshilonda	following
biakudia	food
mubula lungenyi	fool
mubula lungenyi	foolish
dikasa	foot
ndundu wa makasa	football
bua	for
Tshilejelu	For example
bu tshilejelu	for instance
bueba wewa	for you
bikandikibua	forbidden
bukola	force
dimanya dia malu	forecast
mpala	forehead
muenyi	foreign
metu	forest
bua kashidi	forever
kupua moyi	forget
kufua lusa	forgive
kupwa moyi	forgot
lusomu	fork
kulongesha	form
tshimanyike	formal
kulongesha	former
bia diakalenga	fortunately
bubanji	fortune
makumi anayi	forty
makumi anayi ni ibidi	forty-two
kumpala	forward
kupitshisha	foster
muluangesha	fought
tshipeta	found
tshibumba	foundation
inayi	four
dikumi ni inayi	fourteen
kabundi	fox
tshiteketangana	fragile
muaba	frame
tshia kumpala	framework
kwibila	fraud
muntu wa tshidika	freak
tshia tshianana	free
budikadidi	freedom
kukanga dibua	freeze
musangu	frequency
misangu ya bungi	frequent
pa tshibidilu	frequently
matalala	fresh
ditanu	friday
tshiamu tshia mashika	fridge
mulunda	friend
bulunda	friendly
balunda	friends
bulunda	friendship
ni bowa	frightened
utu wenza buôwa	frightening
ludimba	frog
katshia	from
kumpala	front
mukuata dibwa	frozen
tshimuma	fruit
mufika tshinji	frustrated
kasalonyi	fuel
Fulfulde	Fulfulde
muula	full
kusekesha	fun
mudimu	function
tshia nshindamenu	fundamental
madilu	funeral
kuela bilela	funny
nsuki	fur
ni tshinji	furious
bia mu nzubu	furniture
kulepa	further
kadi	furthermore
matuku adi kumpala	future
kupeta	gain
kutshimuna	gain
dinaya	game
bula	gap
nzubu wa kulongolola mashinyi	garage
manyanu	garbage
budimi	garden
ayila	garlic
tshibi	gate
kusangisha	gather
kusangila	gathering
bukelu	gauge
wa kafila	gave
kubuelakana	gear
bumuntu	gender
mushindu	gender
mu kabujima	general
pa tshibidilu	generally
kukebeshe	generate
bantu ba tshikondu tshimua	generation
tshipapayi	generous
muena menji mavule	genius
bumuntu	genre
bupole	gentle
bulelela	genuine
jeste	gesture
kupeta	get
ku vuala bilamba	get dressed
kujuka	get up
unvua bimpa lukasa	get well soon
kupeta	getting
mukishi	ghost
mukishi	ghosting
mulepa	giant
dipa	gift
gingimbre	ginger
muana wa bakaji	girl
mulunda mukaji anyi mulume	girlfriend
kupesha	give
kulekela	give up
kufila	given
musanka	glad
kutapa dîsu	glance
mmuenu	glass
luneta	glasses
malu makese	glimpse
mu kabujima	global
tshijimajima	gloomy
ga	gloves
kukenka	glow
kukenka	glow up
kole	glue
kuya	go
kutungunuka	go ahead
kuya	go away
kubanda kubulalu	go to bed
tshipatshila	goal
bipitshila	goals
mbuji	goat
nzambi	god
zambi aku benesha	god bless you
ndaku	goes
mu diya	going
ndaku	going to
olu	gold
tshijimina	gone
ndaku	gonna
kushala dibwa dia mashika	goo
bilenga	good
dilolo dilenga	good afternoon
nushale biakana	good bye
dituku dilenga	good day
dilolo dilenga	good evening
mudimu mulenga	good job
luidi luakana	good looking
kututa diakalenga	good luck
dinda dilenga	good morning
dinda dilenga munanga wanyi	good morning my love
butuku bulenga	good night
nushale biakana	goodbye
butuku bulenga	goodnight
bintu bia kupana	goods
google	Google
Tshikudimuinyi tshia muakulu tshia Google	Google Translate
nyama wa oie	goose
mulenga	gorgeous
bijanu	gossip
uvua mupeta	got
ngunvu	got it
mbula matadi	government
kukuata	grab
kunvua	grab
muanzu	grade
kakesa kakesa	gradually
muangatshi wa diploma	graduate
luteta	grain
kupesha	grant
kufila	granted
bishishi	grapes
kukuata	grasp
tshisonsa	grass
tuasakidila	grateful
kuela tuasakidila	gratitude
bikola	grave
mutokoloka	gray
bimpa be	great
lukuka	greed
muntu wa lukuka	greedy
mayi a matamba	green
kuela batu moyo	greet
betuabu	greeting
myoyo yenu	greetings
mutokoloka	grey
kukanga	grid
madilu	grief
kupela	grind
dintanfu	grip
tshianza	grip
biakudia	grocery
muluma musedi	groom
tshijima	gross
buloba	ground
tshisumbu	group
kukola	grow
dikola	growth
muntu wa malu makole	grumpy
Gualani	Guarani
tshijadikilu	guarantee
mukubi	guard
kubuka	guess
muenyi	guest
mibelu	guidance
muludiki	guide
kukumbanyina dinyoka	guilty
muena tshibau	guilty
nsongalume	guy
songalume	guys
nzubu wa koluela mubidi	gym
bienzelu	habit
ndaku	habitat
uvua ni	had
mabue a mvula	hail
nsuki	hair
tshitupa	half
mbuelelu	hall
tshianza	hand
kulombola	handle
kulama	handle
muimpa	handsome
kukanga	hang
muaba wa kusangila	hang out
kufikila	happen
kufika	happened
disanka	happiness
disanka	happy
diledibua dilenga	happy birthday
diledibua dilenga	happy birthday to you
tshidimu tshipiatshipia tshilenga	happy new year
bikole	hard
anu pinapu	hardly
ku musangu ni ku musangu	hardly ever
bubi	harm
bibi	harmful
diunvuangana	harmony
bikola	harsh
mamuma	harvest
udi ne	has
kukina	hate
kuikale ne	have
ndi nkujingila dituku dilenga	have a good day
dituku dilenga	have a nice day
kudia biakudia bia pa du dinda	have breakfast
nayayi	have fun
uvua mudia anyi	have you eaten
Bualu bua tua	having
njiwu	hazard
dibungi	haze
udi	he
udi ne	he has
udi	he is
kulombola	head
mutu	head
disama dia mutu	headache
kupeta londopu	heal
kondopibua	healing
bukola bua mubidi	health
ni makanda a mubidi	healthy
kunvua	hear
kunvua	heard
tshiunvuika	heard
moyi	heart
kadilu	heat
paradizu	heaven
diulu	heaven
bujitu	heavy
lukasa lukasa	hectic
bula	height
mupianyi	heir
buivi	heist
mukangibwa	held
iferno	hell
Wetuawu	Hello
betuabu munanga	hello dear
wetuau bishi wewa	hello how are you
wetwau udi munyi	hello how are you doing
ecoutere	helmet
tshifulu	helmet
diambuluisha	help
tshia mushinga	helpful
nunku	hence
tshienda	her
mikoku	herd
apa	here
bumpianyi	heritage
kuelakana	hesitate
Eh	Hey
Betuabu	Hi
moyi weba au bishi wewa	hi how are you
moyi wenu bonsu	Hi there
kusokoma	hidden
kusokoka	hide
bulongolodi	hierarchy
tshile	high
kuakwila	highlight
kuela kashongi	highlight
kuendakana ku mikuna	hike
kuendakana	hiking
tshisekesha	hilarious
mukuna	hill
yeya	him
tshimanyishilu	hint
tshimonu	hip
bimonu	hips
kunvua	hire
kuangata ku mudimu	hiring
tshiende	his
muanu	history
kututa	hit
tshipitshidi tshia dîba	hobby
kwambula	hold
indilayi	hold on
disosu	hole
dikisha	holiday
tshibuashabuasha	hollow
nzubu	home
mudimu wa kumbelu	homework
muena malu malulame	honest
bua bushuwa	honestly
Buitshi	Honey
lumu	honor
tshibwikidi thia ku mashinyi	hood
kusuikila	hook
tshi'tupi	hop
kutekemena	hope
mututa dikasa dilenga	hopefully
wa shikidi	hopeless
mu butshiama	horizontal
lusengu	horn
malu mabi	horrible
bia buôwa	horror
mpunda	horse
tshiondopelu	hospital
lupitadi	hospital
kuakidila benyi	hospitality
muakididi	host
kubenga	hostile
tshia mudilu	hot
nzubu wa tshilala benyi	hotel
dîba	hour
meba	hours
kusombela	house
nzubu	house
dîku	household
bishi	how
munyi	how
kadi wewa	how about you
bishi wewa	how are you
bishi wewa	how are you doing
malu kayi lelu	how are you doing today
udi bishi bua lelu	how are you doing today
udi munyi bua lelu	how are you today
nudi nuenza munyi	how do you do
mmunyi mudi	how is
mushinga kayi	how many
bunyi munyi	how much
misangu bungi munyi	how often
udi ni bidimu bungi munyi	how old are you
dituku dieba ndipita munyi	how was your day
butuku bueba mbupita munyi	how was your night
kadi	however
nansha nanku	however
moye	hub
mulume	hubby
kwakidila	hug
bunene	huge
muntu	human
kudipwekesha	humble
tshitelela	humid
tshitelela	humidity
lukama	hundred
nzala	hungry
kuipata	hunt
tshipepele tshikole	hurricane
kuindile ne muoyo kuulu kuulu	hurry
enza lukasa	hurry up
kutapa	hurt
mulume	husband
kusalakana	hustle
mutanda	hut
mankenda	hygiene
Ndi	I
Mema	I
Ndi	I am
Ndi bimpa	I am fine
Ndi mua	I can
Ndi mua	I can't
Ndi ngenza	I do
Tshiena mumanya to	I do not know
tshiena munvue bimpe to	I do not understand
Tshiena mua	I don't
tshiena mumanya to	I don't know
Tshiena munvue to	I don't understand
tshiena munvue tshinudi nbasue kuamba to	I don't understand what you mean
Tshiena mukunvua to	I don't understand you
Tshiena mumanya buala	I don’t know
Tshiena munvue to	I don’t understand
ndi ngela meji	i guess
nvua ne	I had
Ndi ne	I have
Nga kadi	I have been
Ndi mutekemena	I hope so
Ndi mumanya	I know
Ndi musue	I like
Ndi nsanka neba be	I like you
Ndi munanga	I love
Ndi munanga tutu wanyi	I love my big brother
Ndi munanga yaya wanyi	I love my big sister
Ndi munanga tatwanyi	I love my father
Ndi munanga muanetu wa balume wa mutekete	I love my little brother
Ndi munanga muanetu wa bakaji wa mutekete	I love my little sister
Ndi munanga mamwanyi	I love my mother
Ndi mukunanga	I love you
Ndi mukunanga bikola	I love you so much
Ndi mukunanga panyi	I love you too
Ndi musua kuamba ne	I mean
udi mu nsamina moyi be	I miss you
Ndi ni dijinga dikole be dia kukumona	I miss you so much
Ndi mona	I see
Ndi ngela meji	I think
Ndi munvua	I understand
Ndi musua	I want
Ndi musua kukumona	I want to see you
Ndi mukusue	I want you
Nvua	I was
ni ngenza	I will
Ni ngikala	I would be
Ndi	I'm
Ndi bimpa	I'm fine
Ndi bimpa	I'm good
Mmema eu	I'm here
Nfuila lusa	I'm sorry
dibua dia mashika	ice
singlase	ice cream
lungenyi	idea
bimpa be	ideal
difuanangana	identical
kufila dîna	identify
dina	identity
mubula lungenyi	idiot
kupanga mudimu	idle
biobi	if
kupanga kumanya	ignore
ni ngeza	ill
kunyanga mikenji	illegal
disama	illness
Ilocano	Ilocano
tshinfuanyi	image
kuela meji	imagine
mpindieu mpindieu	immediate
mpindieu	immediately
bunene butamba	immense
tshipeta	impact
kushintulula	impact
kwindila ni moyi onsu	impatient
kuteka mu tshienzedi	implement
kusumba pambelu pa misoko	import
tshia mushinga	important
kuenzeja ku makanda	impose
kabiena mua kuenzeka to	impossible
kukemesha	impress
kupatula mukanda	impression
tshiudi umona	impression
kukemesha	impressive
kulongolola	improve
diakana	improvement
munda mua	in
kadi	in addition
tuamba ne	In fact
kumpala	in front of
bua	in order to
kabiyi bikumbana	inappropriate
kusaka	incentive
bualu	incident
kuela munkatshi	include
munkatshi mua	including
makuta	income
bipeta bia bibi	inconvenience
kuvudija	increase
kuvudija	increased
kupanga kunvuika	incredible
bushuwa	indeed
budikadidi	independent
Inde	India
kuleja	indicate
bena ditunga	indigenous
tshia muntu nime muntu	individual
kompany	industry
tshidi ne tshia bua kuenzeka	inevitable
muana motoka	infant
disama	infection
mipangila nshikidilu	infinity
kuula	inflammation
dijimina dia makuta	inflation
kusaka	influence
kwambila	inform
ngumu	information
biakudia	ingredients
bu mpianyi	inheritance
wa mbangilu	initial
dienza dia malu	initiative
mutapika	injured
mputa	injury
muntu udi kayi mumanya bualu	innocent
kufuka	innovation
dilomba	inquiry
mubuluka	insane
tshishi	insect
kupanga bukubi	insecure
kubueja	insert
munda	inside
mmuenenu	insight
kutungunuka	insist
tshitabela	insomnia
diambuluisha	inspiration
kuenzeja	inspiration
kufila lungenyi	inspire
kufila nyuma	inspire
kulongolola	install
tshilejelu	instance
musangu umua	instant
pamutu	instead
pamutu pa	instead of
mikenji	instructions
tshiamu tshia mudimu	instrument
tshipendu	insult
bujadiki	insurance
kabiyi binyanguke	intact
lulamatu	integrity
mwedi wa meji	intellectual
mayele	intelligence
mayele	intelligent
dijinga	intend
muaba wau	intended
bikola	intense
dijinga	intention
kuyukila	interact
kuyikila	interaction
kukudimuka	interaction
kusanka ni	interest
kusanka ne	interested
bimpa bitamba	interesting
kupambula	interfere
kudibuejakaja	interfere
kupitshila ku	intermediate
muunda	internal
bia matunga onsu	international
kudibidija	internship
kunvuija	interpret
kukudimuna	interpret
mukudimunyi	interpreter
kwimanyika	interrupt
nkonku ne mandamuna	interview
kakese	intimate
mu	into
kubangisha	introduce
mbangilu	introduction
mmuntu tu kayi wakalu bikola	introvert
lungenyi	intuition
kena wenza	invalid
kufuke	invent
dibala dia bintu	inventory
kuela makuta	invest
kulondolola	investigate
dibikila	invitation
benyi	invite
kakanda ka difuta	invoice
kubueja	involve
kubueja	involved
tshiamu	iron
udi	is
tshidiila	island
kushala nkaya	isolated
bualu	issue
konku	issues
yeye	it
tshidi	it is
tshivua	it was
nyoi	it's
udi	it's
mbimpa	it's ok
bidi bimpa	It's okay
biena bualu	item
mikanda	items
eu ki	its
Ndi	I’m
tshizaku	jacket
buloku	jail
ngondu wa ku mpala	January
mulondu	jar
mbanga	jaw
mukawu	jealous
mupote	jerk
bilengejilu	jewelry
mudimu	job
kunyema lubilu	jogging
kusangila	join
kusangila	joint
bilela	joke
kamona kamba	journalist
dituku	journey
disanka	joy
nzuji	judge
mayi ya sukali	juice
ngondu wa muanda mutekete	july
kutumpika	jump
ngondu mwisambombo	june
kudia kubi	junk
bwakane	just
tshienza anu	just do it
buakane	justice
kulumbulula	justify
Kalaallisuta	Kalaallisut
lukunukunu	keen
tshibumba	keep
tungunuka nanku	keep it up
kulama	kept
tshisabishilu tshia mayi	kettle
lusepi	key
dikofi	kick
museba	kick
mwana	kid
bilela	kidding
tuonyi	kidney
bana	kids
kushipa	kill
mushema	kind
mushindu	kind
tuamba ne	kinda
muntu muimpa	kindly
kalolo	kindness
mukalenga	king
kutua mishiku	kiss
tshikuku	kitchen
kulengama	kite
kana ka mpusu	kitten
tshinu	knee
mumanya	knew
kela	knife
muendeshi	knight
dimanya	know
dimanya	knowledge
mumanya	known
Konkanyi	Konkani
Krio	Krio
kabeji kadi kaleja dîna	label
mudimu	labor
mudimu	labour
dipangila	lack
tshibandilu	ladder
mukalenga mukaji	lady
kuteka	laid
kuasa	laid
dijiba	lake
mukoku	lamb
tshilemenda	lame
mwinda	lamp
kwuikala	land
mitshi	landscape
muakulu	language
tshinu	lap
bunena	large
tshia ndekelu	last
ah ne nangananga	last but not least
dîna dibidi	last name
kunyima kua diba	late
musangu mushala	lately
kunyima	later
wa ndekelu	latest
wa ndekelu	latter
kuseka	laugh
mu nkatshi mua kuseka	laughing
tuseku	laughter
mbangilu	launch
tshitokeshedi	laundry
mukenji	law
mashinda	lawn
mulumbuluidi	lawyer
kuteka	lay
drap	layer
dilongolola dia dibeji	layout
muena lulengu	lazy
kulombola	lead
mulombodi	leader
dibeji	leaf
kunyema	leak
kunyana	lean
kutumpika	leap
kulonga	learn
kulongesha	learning
kufutshila	lease
mushadila	least
tshiseba	leather
kumbuka	leave
kushiya	leave
kuya	leave
mabeji	leaves
kukamba	led
ku dia bakaji	left
mukolu	leg
bumpianyi	legacy
kulonda mikenji	legal
nsumuinu	legend
tshidi tshikengela	legit
manaya	leisure
kusombesha	lend
bula	length
bishadila	less
dilongesha	lesson
lekela	let
mukanda	letter
leti	lettuce
nivo	level
mushindu wa dikombu	leverage
majitu	liability
tshitekelu tshia mikanda	library
kulaka	lick
mafi	lie
mafi	lies
moyi	life
asenser	lift
tshibandilu	lift
bukenka	light
butoke	light
dikubakuba	lightning
mushindu umue	like
bu mudi	like
bidi mua	likely
bia momumue	likewise
kusambuka	line
Dingala	Lingala
malanda	link
tambwa	lion
mayi	liquid
liste	list
kuteleja	listen
kunvua	listening
mu tshiambilu	literally
mifundu	literature
tshia kulala	litter
kakese	little
munkatshi mua dienzeka	live
kusombela	live
tuonyi	liver
myoyi	lives
moyi	living
tshisombedi	living room
musodia	lizard
kubueja	load
ndambu ya mampa	loaf
kudiakaja	loan
ya musoko	local
kufutshila	location
tshikangidi	lock
kushala mu nzubu	lockdown
kufunda dina	log
kufua ni tuseku	lol
nkaya	lonely
mulepa	long
matuku apitshi bungi atudi katuyi tu muanangana	long time no see
kutangila	look
kakanu	loop
mukutakana	loose
mukalenga	lord
kujimija	lose
kujimija	loss
mujimina	lost
lupangu	lot
mukola	loud
tshisombelu	lounge
dinanga	love
ndi mu kunanga	love you
mulenga	lovely
muteketangana	low
mushadile	lower
muntu wa lulamatu	loyal
lulamatu	loyalty
Tshiluba	Luba
diakalenga	luck
diakalenga	lucky
Luganda	Luganda
bujitu	luggage
tshikata	lump
biakudia	lunch
pumo	lungs
bintu bia mushinga mukole	luxury
kulala	lying
mashinyi	machine
mutomboka	mad
mukalenga mukaji	madam
kuenza	made
zulunale	magazine
bilenga	magnificent
mukaji mueji wa midimu ya nzubu	maid
tshia mushinga	main
kulama	maintain
mushindu wa kulama	maintenance
Maithili	Maithili
tshia kumpala	major
musumba	majority
kwenza	make
kudilengeja ku mesu	make up
mulume	male
muaba wa kuenda mushinga	mall
mulume	man
kulama	manage
dilama	management
mulombodi	manager
kuenzeja ku bukole	mandatory
kumueneka	manifest
kunaya ni	manipulate
mushindu	manner
ya kubianza	manual
bia bungi	many
tudi ni ngumu ya mimpa bua dituku lelu	many many happy returns of the day
ngondu muisatu	march
mushongi	margin
tshisalu	market
dibaka	marriage
misedibua	married
tshifuebe	mask
musumba	mass
ya bunyi	massive
mukokeshi	master
mulongeshi	master
kuyikila	match
kufundilangana	match
mulunda	mate
biamu	material
Matematike	math
malu	matter
dikola	maturity
udi mua	may
imua misangu	maybe
mema	me
mema panyi	me too
tshiakudia	meal
bungi	mean
diunvuinja	meaning
bintu	means
kwikala ne bua	meant
pinapu	meanwhile
tshipimu	measure
bipimu	measures
musunyi	meat
luondopu	medical
luondapu	medicine
kuela meji	meditation
mishindu	medium
kutwilangana	meet
tshisangilu	meeting
Meiteilon	Meiteilon
kushala mayi	melt
malu a kuvuluka	memories
lungenyi	memory
meji	mental
kwakwila	mention
kutela	mentioned
mulongeshi	mentor
mupanyi	merchant
luse	mercy
bipepela	merely
noel mulenga	merry christmas
dikutakana dia bintu	mess
mukenji	message
kauyi ne bulongame	messy
mulonda	metal
mushindu	method
mpuku	mice
nkatshi nkatshi	middle
munda nkulu	midnight
udi mua	might
kakese	mild
tshia mushinga mukole	milestone
masalayi	military
mabele	milk
millio	million
meji	mind
lungenyi	mind
lungenyi luimpa	mindset
kwenzela	mine
kudibuekaja	mingle
mukese	minor
minite	minute
minite	minutes
tshishima	miracle
lumuenu	mirror
bishila shilangana	miscellaneous
kubunya kwa dîsu	mischievous
muena dikenga	miserable
dikenga	misery
kupanga	miss
ndi ni dijinga dia kukumona	miss you
tshipanga	missing
mudimu	mission
dibungi	mist
kutupakana	mistake
Mizo	Mizo
udi unyugakana	mobile
mafi	mock
tshilejelu	model
nkatshi nkatshi	moderate
ya lelu	modern
bupuekele	modest
ne tshitalela	moist
tshitalela	moisture
musheta wa madiotu	mold
muntu mwibile	mole
mamu	mom
tshikondu	moment
dimua	monday
makuta	money
mutangidi	monitor
nsoku	monkey
ngondu	month
luidi	mood
muena tshikadilu tshibi	moody
ngondu	moon
tshikadilu	moral
bia bungi	more
kabidi	moreover
dinda	morning
kupana	mortgage
ba bungi	most
bamue	most
nanga nanga	mostly
mamu	mother
kunyungakana	motion
kusaka	motivation
mukuna	mountain
mpuku	mouse
mukana	mouth
kumbusha	move
kunyungakana	movement
filime	movie
mukalenga mukaji	mrs
bia bungi	much
bitotshi	mud
dikopu	mug
musunyi	muscle
nzubu wa dilamina bintu bia kale	museum
bowa	mushroom
musambu	music
tshiakuenza	must
kupuwa	mute
tetu bonsu	mutual
tshianyi	my
munanga wanyi	My dear
mulunda wanyi	my friend
tshiamu tshianyi tshia bufinu tshiula ne tuishi	My hovercraft is full of eels
dinanga dianyi	my love
dîna dianyi	my name is
ne disanka	my pleasure
mema nkayanyi	myself
kabiye biunvuika	mysterious
tshikena kuunvua	mystery
nsumuinu	myth
musonsu	nail
tshitaba nvinyongu	naive
dina	name
muanu	narrative
kakese kakese	narrow
muntu mubi	nasty
ya ditunga	national
tshisamba	nationality
tshia kutshileledu	native
dia kutshifukilu	natural
bumuntu	nature
dijinga dia kuluka	nausea
pabuipi	near
ku luseka	near
pabuipi	nearby
pabuipi ne	nearly
kwakaja	neat
tshia mushinga mukole	necessary
nshingu	neck
mabua a busangu	necklace
dijinga	need
bubi	negative
kupepeja malu	neglect
kunvuangana	negotiate
bena mutumba	neighbor
kartye	neighborhood
anyi	neither
muana wa balume kua mukuluanyi	nephew
menji mabole luseka	nerd
udi ne buôwa	nervous
disua	nest
bukondu	net
enternete	network
kubenga kubuelakana mu	neutral
nansha kakese	never
kutshioki to	never give up
ki mbualu to	never mind
kakwena bualu	nevermind
kadi	nevertheless
mapia mapia	new
mapia mapia	news
bidi bilonda	next
pabuipi ne	next to
bimpa	nice
ndi ne disanka dia diakutuilangane nebe	nice to meet you
muana wa mukuluanyi	niece
butuku	night
tshilota tshibi	nightmare
tshitema	nine
dikumi ne tshitema	nineteen
makumi tshitema	ninety
To	No
kakwena bualu to	no problem
buala buala	no way
muntu nansha umue	nobody
mutoyi	noise
lubila	noisy
tshintu nansha tshimua	none
mujalamu	noon
topu	nope
anyi	nor
bia tshibidilu	normal
nord	north
diulu	nose
majiya bua bintu bia kala	nostalgic
to	not
topu nansha kakese	not at all
bimpa ndambu	not bad
mpindieu to	Not now
to	not yet
mukanda	note
kukanga	noted
tshintu nansha tshimue	nothing
dimanyisha	notice
mutangila	noticed
dina	noun
mena	nouns
mukanda	novel
ngondu wa dikumi ne umue	november
mpindieu	now
lelu	nowadays
kunyanga	nuisance
kubi	null
kukwatshika buôwa	numb
bungi	number
munganga	nurse
lungaji	nut
muskade	nutmeg
biakudia	nutrition
mutshipu	oath
kudiundakana bibi	obesity
kutumikila	obey
tshintu	object
tshipatshila	objective
bujitu	obligation
muidima	obscure
kutangila	observation
tangila	observe
kunanga bikola	obsessed
kutuma meji anu ku	obsession
binyanguka	obsolete
bipumbishi	obstacle
kupeta	obtain
kupeta	obtained
bulelela	obvious
bulelela	obviously
misangu ku musangu	occasionally
mudimu	occupation
muangata	occupied
kuenzeka	occur
tshienzeka	occurred
kuenzeka	occurs
mbu	ocean
ngondu wa dikumi	october
kabiyi mu mulongu	odd
diakalenga	odds
a	of
bushuwa	of course
kujima	off
kubanga	offensive
dipa	offer
biro	office
tshimanyika	official
misangu mivule	often
Kah	Oh
oh bis bushuwa	oh really
mafuta	oil
eyowa	ok
eyowa munanga	ok dear
eyowa munanga	ok honey
eyowa munanga wanyi	ok my love
kakwena bualu	okay
eyowa bebe	okay baby
eyowa munanga	okay dear
eyowa munanga	okay honey
eyowa dinanga dianyi	okay my love
tshia kala	old
pa	on
musangu	once
umue	one
muakulu umua kautu ukumbana	one language is never enough
ditungulu	onion
ku enternete	online
anu	only
kukangula	open
bualu	operation
mudimu	operation
lungenyi	opinion
mpunga	opportunities
tshikondo	opportunity
kushilangana	opposite
kulama lungenyi luimpe	optimistic
tshiakuenza	option
lungenyi	option
udi mua kusungula kuenze anyi to	optional
anyi	or
tshimuma tshia oranje	orange
mubidi wa oranje	orange
kuludika	order
tshianana	ordinary
bulongolodi	organization
buludiki	orientation
mbangilu	origin
ntuadijilu	original
Olomo	Oromo
muna wa nshiya	orphan
mukwabu	other
patupu	otherwise
bikengela	ought
tshietu	our
Mudimu wetu : kuenza mushindu onsu bua ne muntu yonsu, muaba onsu wikala ye, amanye mudi malu enda pa buloba ne aakula kupitshila ku muakulu.	Our mission: to enable everyone, everywhere to understand the world and express themselves across languages.
Mudimu wetu: kulongolola ngumu ya pa boloba bijima ne kuyipesha bantu bonsu ne ku itua mushinga.	Our mission: to organize the world's information and make it universally accessible and useful.
kopatuka	out
bipeta	outcome
iniforme	outfit
bilamba	outfit
mupatuki	outgoing
kupatule	outlet
mibangabanga	outline
pambelu	outside
munene menemene	outstanding
ditshuwa	oven
pa	over
kokanaka	over there
kabujima	overall
kutantamana	overcome
kupita kuela meji	overthinking
bipitshila matuku	overwhelmed
kubungamija	overwhelming
kufila	owe
nyunyi wa tshipungulu	owl
kwikala ne	own
muena tshintu	owner
ngombe	ox
ngendelu	pace
dibuki	pack
kuswika	package
kufuta	paid
diampa	pain
kulaba mukubu	paint
mukubu	painting
bibidi	pair
mutokoloka	pale
dibua	palm
mpanu	pan
tshipupu	pandemic
kupampakana	panic
mupanu	pants
dibeji	paper
paradizu	paradise
diulu	paradise
kunvuangana	parallel
dibuki	parcel
kufwa luse	pardon
baledi	parents
budimi	park
nkusu	parrot
seleri	parsley
tshitupa	part
kufila	participate
tshia pabuatshi	particular
tshia kumpala	particularly
mulunda	partner
kusekelela	party
kupita	pass
dipita	passage
kupita	passed
lukunukunu	passion
mudilu	passion
banangi ba mudimu	passionate
kayi ne tshiakuenza	passive
tshikemu	password
kala	past
kulongolola	patch
njila	path
disama	pathetic
lutulu	patience
mubedi	patient
muntu wa lutulu	patient
tshilejelu	pattern
kwikisha	pause
njila	pavement
kufuta	pay
difutu	payment
ditalala	peace
wa ditalala	peaceful
kuloba	peach
kutumbuka	peak
tshibota	pear
nkunda	peas
nanga nanga	peculiar
tshia mushinga	peculiar
menyi	pee
kuela tshikasu	peel
bintu bibidi bibidi	peer
bibidi	peers
bik	pen
kreyon	pencil
mu nkatshi mua kwindila	pending
bantu	people
ndunga	pepper
kufutshisha	perceive
kujingulula	perception
bipuangana	perfect
kuenza	perform
buimpa	performance
imua misangu	perhaps
tshikondu	period
kashidi	permanent
dianyisha	permission
kwanyisha	permit
kutantamana	perseverance
kutungunuka	persistent
muntu	person
tshia nkaya	personal
bu mmuntu	personality
ditekemena	perspective
kunvuija	persuade
muenzavi	pervert
nyama wa kwenda nende	pet
tshitupa	phase
tshikondu	phase
bualu	phenomenon
nkindi	philosophy
tshiamu thia alo alo	phone
foto	photo
tshiambilu	phrase
mubidi	physical
kuangata	pick
kuangula	pick up
tshimfuanyi	picture
shambre	piece
tshintu	piece
tshiamu	pieces
nguluba	pig
kankudimba	pigeon
dibue	pile
tshitekedi tshia mutu	pillow
muendeshi wa ndeka	pilot
tukanu tua kulengeja natu pa bilamba	pin
tshikaka	pineapple
tshinkonya	pink
tshina	pit
tshipapu	pitch
lusa	pity
mwaba	place
miaba	places
tshipupu	plague
tshibandabanda	plain
njila	plan
ndeka	plane
tshiapu	plant
bisonsa	plants
tshitata	plate
tshisasa	platform
muaba	platform
kunaya	play
mu dinaya	playing
bushema	pleasant
bua lusa	please
disanka	pleased
disanka	pleasure
kudilambula	pledge
bunyi	plenty
lupangu	plot
kutua	plug
tumuma twa prune	plum
mulami wa mayi	plumber
bia bungi	plural
bande	podcast
kasala	poem
kuenza tusala	poetry
kuleja	point
mmulungu	poison
mpulushi	police
tshididi	policy
tshididi	polite
kunyanga	pollution
dijiba	pond
dijiba	pool
tunvi	poop
bulanda	poor
bienda lumu	pop
kumanyika	popular
bantu	population
nguluba	pork
musabu	porridge
tshitudilu tshia mazuwa	port
mushindu wa kuimana	position
buimpe	positive
kwikala ne bintu	possess
kwikala ne bintu	possession
kwikala ne bintu	possessive
tshidi mua	possible
mudimu	post
kupusa	postpone
tshilunga	potato
tshipedi	potential
kuboza	pound
bulanda	poverty
makanda	power
mu tu wa makanda	powerful
kulomba	practical
kuteka mu tshienzedi	practice
kutumbisha	praise
bilela	prank
kusambila	pray
tshia mushinga	precious
kutela mena	precise
pakaba kampanda	precisely
mulayi	predict
kunanga bikola	prefer
kunanga nangananga	preference
difu	pregnant
ntatu	prejudice
bia muditunga	premises
ya mushinga mukole	premium
kudilongolola	preparation
kulongolola	prepare
kulongolola	prepared
kumpala kwa	preposition
kwikala	presence
dipa	present
didimanyisha	presentation
kulama	preserve
mukalenge	president
tudiomba	press
tshiamu tshia kupatuila mikanda	press
kusaka	pressure
ntatu	pressure
kutekemena	pretend
mulenga	pretty
kudianza kuleja	prevent
mushala	previous
disambila	prey
mushinga	price
madiunda	pride
muakuidi	priest
tshia kumpala	primary
bungi bua kumpala	prime
mwana mukaji wa nfumu	princess
tshia tshinena	principal
kumpala	prior
tshia mushinga	priority
buloko	prison
sekele	privacy
tshia muntu	private
diakalenga	privilege
mushinga	prize
pamua apa	probably
bualu	problem
mushindu wa	procedure
tshilumbu	procedure
mushindu wa kuenza	proceed
njila wa kulonda	process
kupatula	produce
kuenza	produce
tshimuma	product
kuenza	production
mudimu	profession
tshia mudimu	professional
tshinfuanyi	profile
bipeta	profit
buondoka	profound
kukola	progress
mudimu	project
nfumu munene	prominent
mulayi	promise
kwakwila	promote
kutumbisha	promotion
lukasa	prompt
mutekete	prone
mupinganyi	pronouns
kwakula	pronunciation
kushindimuna	pronunciation
bijadiki	proof
mukumbane	proper
mudibi bikengela	properly
nzubu	properties
nzubu	property
dipa	proposal
kuteta	proposal
ditekemena	prospect
kutanta ne bubanji	prosperity
mubanji	prosperous
kukuba	protect
lumu	proud
kuleja patoka	prove
kufila	provide
mbipeshibwa	provided
polovelinse	province
kwikala	provision
bu nsonga	puberty
bantu	public
kukoka	pull
tshimuma tshia sitruiye	pumpkin
kufika pa diba	punctual
mulongi	pupil
kusumba	purchase
mutoke	pure
tshikunzubile	purple
tshipatshila	purpose
tshibutshilu	purse
kutungunuka	pursue
kukwata	pursuit
kulonda	pursuit
kusaka	push
kuteka	put
dina	qualification
buimpa	quality
bunyi	quantity
makumi anayi	quarantine
matandu	quarrel
ngondu isatu	quarter
Kuechua	Quechua
mukalenga mukaji	queen
bia kukemesha	queer
kukonkonona	query
lukonku	question
mukila	queue
lukasa	quick
lukasa	quickly
ditalala	quiet
tshilamba tshia pa bulalu	quilt
kuimanyika	quit
bikumbana	quite
nkonku	quiz
tshiambilu	quotation
tshiambilu	quote
biakusumba	quotes
kalulu	rabbit
dikoba	race
tshilunji	rage
nvula	rain
kuvudija	raise
kujula	raised
lubilu	ran
bia pamutu pamutu	random
mulongu	range
lubilu	rapid
lukasa	rapidly
tshitu katshiyi tshimueka matuku onsu	rare
kabitu bienzeka misangu ya bungi to	rarely
diluka dia kadilu	rash
mpuku	rat
mushinga	rate
pamutu pa	rather
lapolu	ratio
ne meji	rational
tshianana	raw
bua tshidi tshitangila	re
kupeta	reach
kufika	reach
kufika	reached
diandamuna	reaction
kubala	read
kubala	reading
mudiakaja	ready
bia bulelela	real
bulelela	reality
kukumbaja	realize
tshikumbana	realized
bulelela anyi	really
kunfundu	rear
lungenyi	reason
muedi wa meji	reasonable
kuvuluija	recall
kupeta	receipt
kupeta	receive
kwangata	received
bipiabipia	recent
matuku adi panshi aa	recently
tshiakididi tshia benyi	reception
tshiakuidi	recipe
kuenza malu kumpala kwa kuela meji	reckless
kumanya	recognition
tuasakidila	recognition
kumanya	recognize
kuitaba	recognize
kuanyishila	recommend
kuakwila	recommended
kufunda mena	record
kupetulula	recover
kuangatulula	recovery
kazubu ka matumba anayi	rectangle
mukunza	red
kusumbulula	redeem
kusungila	redemption
kukepesha	reduce
kabidi	redundant
bia bungi	redundant
kulonda	refer
kwakwila	reference
kuleja	reflect
kuela meji	reflection
kwepuka	refrain
tshiamu tshia mashika	refrigerator
kupingaja	refund
kubenga	refuse
bibengibua	refused
kanêmu	regard
bidi bitangila	regarding
mu dipanga kunvuangana ni	regardless
moto wenu awu	regards
muaba	region
kufunda mena	register
kanyinganyinga	regret
misangu yonsu	regular
misangu yonsu	regularly
kubenga	reject
kulonda bualu	relate
mu diunvuangana	related
nsombelu	relationship
tshidi tshiakwuila	relative
baledi	relatives
kupitshisha kapepa	relax
kupatule	release
kupatula	released
ya mushinga	relevant
tshia kweyemena	reliable
tshimfuanyi	relief
kufila disulakana	relieve
disulakana	relieved
tshitendelelu	religion
muntu musambidi	religious
kubenga	reluctant
kutekela mutshima	rely
kushala	remain
kushala	remaining
bia dikema	remarkable
bua kujikija	remedy
kuvuluka	remember
kuvuluka	remind
kuvuluka	reminder
wa kubula	remote
kumbusha	remove
kupingaja	render
kufutshila	rent
kulongolola	repair
kubangishila	repeat
kuangata pa muaba wa	replace
kwandamuna	reply
lapolu	report
kuleja	represent
kuakula kabidi	represent
lumu	reputation
malu malombibwa	request
kuenzeja	require
bidi bikengela	required
kusungila	rescue
tshikebelu	research
dikeba	research
bifuanangana	resemble
kanyinganyinga	resentment
kusumba	reservation
kulama	reserve
mwena kalaba	resident
kulekela mudimu	resign
kuitaba nsombelu utudi nende	resilience
kutantamena	resilient
kutantamana	resist
kudikolesha	resistance
kwimanyîna	resistance
tshia kuenza	resolution
kujikija	resolve
statio	resort
biuma	resources
kunemeka	respect
kanemu	respect
kuandamuna	respond
diandamuna	response
bujitu	responsibility
muntu mukola	responsible
muena bi	responsible
dikisha	rest
ikisha mu ditalala	rest in peace
restoran	restaurant
kuibakulula	restore
kulongolola	restore
kwela mikalu	restrict
bipeta	result
bipeta	results
cv	resume
malu a makese	retail
kulama	retain
tshilumbu	retention
pansio	retired
pansio	retreat
kuangata	retrieve
kupingana	return
kusokolola	reveal
mulejibua	revealed
kudisombuela	revenge
bintu	revenue
makuta	revenue
kubaluluka	reverse
kukonkonona	review
kushintulula	revise
diambulula	revision
dishintuluka dia balombodi	revolution
bipeta	reward
lubilu	rhythm
luendu	rhythm
mbadi	rib
losa	rice
mubanji	rich
kuimansha	rid
kwendesha	ride
kudipwekesha milongu	ridiculous
ku dia balume	right
mpindieu mpindieu	right now
bukola	rigid
mpeta	ring
kusampulula	rinse
tshinvundu	riot
kupanda	rip
kupandakaja	ripe
kuvudija	rise
njiwu	risk
muluishi	rival
musulu	river
njila	road
koshia	roast
muntu wa makanda	robust
dibua	rock
ndobu	rod
mudimu	role
muvungu	roll
musonga	roof
nzubu wa kuladila	room
miji	root
muonji	rope
bibola	rotten
tshikonyangala	rough
pabuipi ne	roughly
tshijengu	round
njila wa kulonda	route
tshilele	routine
nshinga	row
kufita	rub
caoutchouc	rubber
bukoya	rubbish
biakulakula	rude
tapi	rug
kujimija	ruin
mukenji	rule
mikenji	ruler
mikenji	rules
kunyema lubilu	run
munkatshi mua	running
musoko	rural
kulubakana	rush
tshibuta	sack
tshibombi	sack
tshinsantu	sacred
milambu	sacrifice
kukuba	safe
ndeka wa bukubi	safe flight
bukubi	safety
muena meji	sage
uvua muamba	said
kowela	sail
tshilamba	sailing
maluvu	sake
difutu	salary
kupana	sale
mpiodi	salmon
mukela	salt
bia momumue	same
biamomumue apa	Same here
kulabula	sample
lusenga	sand
Sanskrit	Sanskrit
kuseka	sarcastic
muena luonji	sassy
kusomba	sat
kusankisha	satisfaction
musankishibua	satisfied
kusankisha	satisfy
ya disanka	satisfying
disambombo	Saturday
sosisa	sausage
lonji	savage
kupandisha	save
nsele	saw
kwamba	say
kubanda	scale
kwiba	scam
tshibangi	scar
kabiyi bimueka bikola to	scarce
ni bowa	scared
tshitambala	scarf
kuvuinja bowa	scary
kusapuluka	scattered
bualu ebu	scene
bifukibua	scenery
kumvua mupuya	scent
kalandriye	schedule
kabala matuku	schedule
kalasa	school
siansi	science
mianda ya siansi	scientist
bantu ya siansi	scientists
lushole	scissors
kutandisha	scold
kuambula	scope
kuluata	scope
bunyi	score
kulekela	scrap
kukonya	scratch
kuela mbila	scream
kutata	screen
vise	screw
mifundu ya manaya	script
mbu	sea
kusangisha	seal
tshikebelu	search
tshikondu	season
nkwasa	seat
tshibidi	second
musokoku	secret
katupa	section
kulamibua	secure
bukubi	security
tangila	see
ni tumuanangana	see you
ni tumonangana pashishe	see you later
ni tumonangana	see you soon
ni tumonangane makelela	see you tomorrow
luteta	seed
kukeba	seek
mbimueneka	seem
mumueneka bu	seems
kumueneka	seen
kukwata	seize
disama dia tshiseki	seizure
kupanga kumueka	seldom
kusungula	select
ngaya	self
kudiondopa	self healing
mudinangi	selfish
kupana	sell
kutuma	send
ntumina tshinfuanyi tshiebe	send me your picture
mukulu	senior
diumvuija	sense
mushindu	sense
unvua lusa	sensible
kulengibua	sensitive
kutuma	sent
tshiambilu	sentence
biambilu	sentences
kutapuluka	separate
Sepedi	Sepedi
ngondu wa tshitema	september
kakosu	sequence
filime	series
kutua mushinga	serious
bushuwa	seriously
kuenza mudimu	serve
mudimu	service
tshisangilu	session
bonsu buabu	set
kulongolola bintu	set up
muaba wa kulongolola	setting
kulongolola	settle
muanda muteketa	seven
dikumi ne muanda muteketa	seventeen
makumi muanda muteketa	seventy
bia bungi	several
bikola	severe
kutela	sew
dileji	shade
ditalaja	shadow
kunyukula	shake
bikengela	shall
mondoka kakese	shallow
bundu	shame
mubidi	shape
kwabanya	share
musungoloka	sharp
yeya	she
udi ne	she has
yeya udi	she is
kazubu	shed
mukoku	sheep
dibeji	sheet
kabadi	shelf
tshizubuzubu	shell
tshisokomenu	shelter
ngabu	shield
nshitukilu	shift
kukenka	shine
buatu	ship
kutuma	shipping
nzumiji	shirt
bisabata	shoes
kukoka	shoot
magazen	shop
kusumba	shopping
ku muelelu kua mâyi	shore
ka katupa	short
kupanga	shortage
tire	shot
udi ne tshia bua	should
dikaya	shoulder
kuela lubila	shout
kuleja	show
ndeja	show me
tshiowedi	shower
krevete	shrimp
kunyanyisha	shrink
kukanga	shut
buikila mukana	shut up
muena bundu	shy
muanetu wa balume ne muanetu wa bakaji	sibling
bana betu babaluma ne babakaji	siblings
kusama	sick
luseka	side
mukemu	sigh
lumonu	sight
mianda ya kuendeshi kwa benyi	sightseeing
tshimanyinu	sign
sinyatile	signature
bia bungi	significant
kupuwa	silence
kubenga kwenza mitoyi	silent
ndanda	silk
nyama	silly
makuta	silver
biamomumue	similar
kutendelela mpingu	simp
bipepela	simple
musangu umue	simultaneously
katshia	since
wa moyi mujima	sincere
ne moyi mujima	sincerely
kuimba	sing
kangimba	singer
mujika	single
kupwekesha	sink
mukalenga	Sir
mwanetu wa bakaji	sister
bayanyi tshina	sister in law
kusomba	sit
kuteka	site
nsombelu	situation
isambombo	six
dikumi ni isambombu	sixteen
makumi asambombu	sixty
bula	size
mayele	skill
dimanya dia midimu	skills
ngenyi	skills
dikoba	skin
munyana	skinny
kutumpika	skip
jipa	skirt
diulu	sky
mupika	slave
kulala	sleep
munkatshi mua kulala	sleeping
kubungila	sleepy
tshikuatshidi	sleeve
tshipesa	slice
kufinunuka	slide
kakese	slightly
kunyana	slim
kufinunuka	slip
mpulumuku	slope
mutanta	slot
bitulu bitulu	slow
bitulubituli	slowly
kakese	small
mayele	smart
mupuya	smell
mimuenmua	smile
nfuanka	smoke
mushema	smooth
mufinuka	smooth
nyoka	snack
nyonga	snail
nyoka	snake
mu tshitantshi tshikese	snap
neije	snow
mpindieu	so
tshilema bikola	so cute
ti mpindieu	so far
kuina	soak
nsabanga	soap
makana	sober
ndundu wa makasa	soccer
nsombelu	social
kumpanyi	society
nshesheta	socks
tshishema	soft
ditadi dia ordinatere dia	software
buloba	soil
kupana	sold
kufuta	sold out
musalayi	soldier
nkaya	sole
tshikola	solid
kujikija	solution
kujikija	solve
bamue	some
muntu kampanda	somebody
mumishindu yonsu	somehow
muntu kampanda	someone
tshintu kampanda	something
misangu mikwabu	sometimes
musambu	song
mu matuku makese	soon
mupiluka	sophisticated
Solani	Sorani
bisama	sore
kaminuminu kasama	sore throat
kanyinganyinga	sorrow
Nfuila lusa	Sorry
kusungula	sort
kukeba	sought
anyima	soul
muoyo	soulmate
dîyi	sound
nsupu	soup
buanji	sour
mbangilu	source
sudi	south
muaba	space
mikenji itudi katuyi bananga	spam
kuambuibwa	span
Espagne	Spanish
tshia kushintuluila	spare
kuakula	speak
tshia pa buapu	special
tshifukibua	species
mushindu kampanda	specific
bia dikema	spectacular
muyuki	speech
kakuyi diyi	speechless
lubilu	speed
mulawu	spell
kujimija	spend
kutula	spend
kutula	spent
kwela bilengejelu	spicy
kututa muinu	spike
kunyunguluka	spin
bitekuteku	spinach
nyuma	spirit
kuela makodi	spit
bilenga bitamba	splendid
kutapulula	split
kunyanga	spoil
kuengeleka	spoiled
musangu umue	spontaneous
lukutu	spoon
muaba	spot
muena dibaka	spouse
kutampakaja	spread
tshidia	spring
kutumpika	spring
karé	square
kufina	squeeze
tshilema tshia kalmar	squid
kanyama ka ecureuil	squirrel
kutua kela	stab
tshikumbi	stable
kusangisha	stack
tshia muntu	staff
kulongolola	stage
ditoba	stain
bibandilu	stairs
kutangidila	stake
mutshi	stalk
kulekela	stall
tembre	stamp
kwimana	stand
kushala	stand
tshilele	standard
mutotu	star
kubangisha	start
kubangisha	started
muntu ni nzala	starving
mushindu uudi	state
muyuki	statement
tshitudilu	station
lupingu	statue
mushindu	status
kushala	stay
ikalayi ni budimu	stay safe
kololoka	steady
musunya	steak
kubuka	steal
kunua nfuanka	steam
mulonda	steel
mupwekelela	steep
ka mutshi	stem
tshidia	step
kuenda	step
munyansu	stick
mupapa	stiff
kashidi	still
misangu yonsu	still
kusuma	sting
utu kayi utuka dikuyi	stingy
kuvundula	stir
tshibombelu	stock
kwiba	stolen
munda	stomach
tshifu	stomach
kubala	stone
kuvu kupeteka	stood
kabasa	stool
kwimanyika	stop
tshibombelu	storage
magazen	store
nvula wa tshipepa	storm
nsumuinu	story
mpanu	stove
mululame	straight
musangu umue	straightforward
muja	strain
wa pabuenda	strange
muenyi	stranger
mayele	strategy
kasonsa	straw
tumuma twa fraise	strawberry
bimanyinu	streak
kasulu	stream
njila	street
bukola	strength
kuela meji	stress
kanyinganyinga	stress
muaba mukuabu	stretch
kulondesha malu	strict
kututa	strike
lukanu	string
bande	strip
kwipatshila	strive
disama dia avc	stroke
bukola	strong
kututa	struck
ndongoluelu	structure
nvita	struggle
kulua mvita	struggling
tshitunu	stubborn
tshintu	stuck
mulongi	student
kulonga	study
munkatshi mua dilonga	studying
tshintu kampanda	stuff
bimpa bikola	stunning
mutshimbakane	stupid
mushindu	style
biena bualu	subject
kutuma	submission
kufila	submit
kutuma	submit
tshintu	substance
mupinganyi	substitute
muinshi muinshi	subtle
kutshimuna	succeed
kutshimuna	success
kututa dikasa dimpe	successful
anu bu	such
bu mudi	such as
kufuba	suck
musangu umue	sudden
kabiyi bielela meji	suddenly
musangu umue	suddenly
kukenga	suffer
dikenga	suffering
mukumbana	sufficient
nsukadi	sugar
kufila lungenyi	suggest
ngenyi	suggestion
kazaku	suit
muenzala bua	suitable
tshibuta tshia bilamba	suitcase
bungi	sum
kusuikakaja	summary
luya	summer
musonga	summit
munya	sun
dia lumingu	sunday
tshibuela munya	sunny
kulala kwa dîba	sunset
munya	sunshine
bimpa be	super
kulu	superior
mulombodi	supervisor
bimpa be	supper
kufila	supply
diambuluisha	support
kuela meji	suppose
uvua na tshia bua	supposed
bushuwa	sure
pa mpala	surface
kubanda	surge
kupanda bantu	surgery
dîna dia kumpala	surname
kukemesha	surprise
kukema	surprised
ku difila	surrender
kuya	surrender
bidi bitujingila	surrounding
njinganjinga	surrounding
kutangila	surveillance
kulondolola	survey
kupanduka	survive
udi umueneka ne meji mabi kapanda	suspect
mukudika	suspended
udi bu belela meji	suspicious
kukuatshisha	sustain
kunenga	sustainability
tshidi muakunenga	sustainable
bilengejelu bienze bu bijengu bikosa	swag
kumina	swallow
ku shintulula	swap
kuditshipa	swear
tshisululu	sweat
mupila	sweater
kukomba	sweep
tshishema	sweet
ndotu milenga	sweet dreams
mmuntu mudiavi	sweet tooth
dinanga	sweetheart
kuula	swell
kuula	swelling
kowela	swim
kowela	swimming
mionji ya kudikupa nayi	swing
kushintulula	switch
kuula	swollen
muela wa nvita	sword
tshimanyinu	symbol
luse	sympathy
bimanyishilu	symptoms
bulongolodi	system
mesa	table
kubanga	tackle
funda dina	tag
mukila	tail
kwangata	take
biakudia bia kuya nabi	take away
dilama biakane	take care
kutulu luendu	take off
kuangatshibwa	taken
muyuki	talk
mwenji wa mitoyi	talkative
munena	tall
mulonda	tap
kufunda mena	tape
tshipatshila	target
mudimu	task
kuanyisha	taste
dijinga	taste
muenya	tasty
mulongi	taught
tshiayi	tea
mulongeshi	teach
mulongeshi	teacher
tshisumbu	team
tshisonji	tear
binsonji	tears
kuyobola	tease
malu a biamu	technology
mênu	teeth
kwamba	tell
ngambila	tell me
bumuntu	temper
luya	temperature
tempelu	temple
tshitantshi tshikese	temporary
dikumi	ten
binunu dikumi	ten thousand
mufutshidi	tenant
kondopa	tend
lungenyi	tendency
dipa	tender
kualabala	tense
tensio	tension
ntenta	tent
tshia lukasalukasa	tentative
mwaku	term
malu adibu balomba	terms
bibi bikole	terrible
bilenga bitamba	terrific
teritware	territory
diteta	test
mifundu	text
ne	than
kusakidila	thank
tuasakidila	thank you
Tuasakidila bua kuindila patudi mu nkatshi mua kulondesha bintu bituma	Thank you for your patience while we investigate shipment
tuasakidila wa bunyi	thank you so much
tuasakidila wa bungi	thank you very much
tuasakidila	thanks
Tuasakidila bua kuenzela applicatio wetu	Thanks for using our app
ewu	that
tshidi	that
tshidi	that is
mbimpa	that's good
tshintu	the
buinvi	theft
biabu	their
bobu	them
tshiena bualu	theme
bobu ngayabu	themselves
pashishe	then
mmianu	theory
mwaba	there
kukadi	there are
kukadi	there is
nunku	therefore
ababa	these
bobu	they
badi	they are
munene be	thick
mwinvi	thief
bibelu	thigh
kakese	thin
tshintu	thing
bintu	things
kuelangana meji	think
mwisatu	third
ni nyota	thirsty
dikumi ni isatu	thirteen
makumi asatu	thirty
ewu	this
etshi	this
bidi	this is
kabujima	thorough
ne budimu bonsu	thoroughly
bobu	those
kadi	though
meji	thought
muntu udi wela meji a bungi	thoughtful
meji	thoughts
tshinunu	thousand
nshinga	thread
kufuna	threat
kifuna	threaten
isatu	three
kumpenga	threshold
kusanka	thrilled
kutanta	thrive
muminu	throat
kupitshila	through
mu nkatshi mua	throughout
kubanga	throw
kukupa	throw
tshiala	thumb
dikubakuba	thunder
dinayi	Thursday
nanku	thus
kusungula	tick
musumba	tide
kulongolola	tidy
kalavanda	tie
tigre	tiger
kukangibwa	tight
Tiglinya	Tigrinya
diba	time
bundu	timid
kakese be	tiny
mubelu	tip
mibelu	tips
nkata	tire
kutshioka	tired
tshilamba	tissue
tshiena bualu	title
bua	to
kwikala	to be
kukanga	toast
lelu	today
bana bakese	toddler
minu ya makasa	toes
tetu bonsu	together
nkumba	toilet
kowa mayi	toilet
amba	told
kuitaba	tolerance
kwitaba	tolerate
kamata	tomato
malaba	tomorrow
ludimi	tongue
butuku ebu	tonight
penda	too
muangata	took
biamu bia mudimu	tool
biamu bia mudimu	tools
dînu	tooth
kuulu	top
tshiena bualu	topic
kupanda	torn
kukengesha	torture
ka bujima	total
kulenga	touch
lutatu	tough
kumonangana	tour
kuya ku	toward
kuya ku	towards
bilamba bia kudikupula nabi mâyi	towel
tshimenga	town
mulungu	toxic
tshimanyinu	trace
njila	track
kuenda mushinga	trade
bilele	tradition
ya kala	traditional
luendu	traffic
njila	trail
kulongesha	train
dilongesha	training
bumuntu	trait
bikadilu	traits
kutuma	transfer
dishintuluka	transition
kukudimuna	translate
tshimuenesha dia momua	transparent
kuendakana mu mashinyi	transport
kwambula	transportation
buteyi	trap
musaka	trash
ntatu	trauma
luendu	travel
dilongu	tray
biuma	treasure
kwakwila	treat
kondopa	treat
londopu	treatment
mutshi	tree
bimpa bikola	tremendous
kudiludika	trend
tshilumbu	trial
lungenyi lua kuenza	trick
kuteta	tried
kubangisha	trigger
kuyobola	trigger
biakudia	trim
luendu	trip
tshinvundu	trouble
mupanu	trousers
kamion	truck
bulela	TRUE
kasheta	trunk
kutekela moyi	trust
bulelela	truth
kuteta	try
Tsonga	Tsonga
mulonda	tube
disatu	Tuesday
makuta a kufuta mu kalasa	tuition
turquie	turkey
kirikuma	turmeric
kukudimuna	turn
nkuvu	turtle
mulongeshi	tutor
dikumi ne ibidi	twelve
makumi abidi	twenty
makumi abidi ni umue	twenty-one
Twui	Twi
misangu ibidi	twice
kukobame	twist
ibidi	two
kututa	type
tshilele	typical
mubi	ugly
ndekelu	ultimate
dikumbi	umbrella
kena mua	unable
manseba	uncle
kayi mumanya to	unconscious
muinshi	under
kuinshi	underneath
kupepeja mushinga	underrated
kunvua	understand
kunvua	understood
bia dibungama	unfortunately
iniforme	uniform
anu umuepele	unique
bobumue	unit
tulasa tutumbuka	university
kayiyi mimanyika	unknown
anu biobi	unless
too ne	until
bunutu kanuyi banji kumona	unusual
kuulu	up
wewa kiudi umuana	up to you
diakaja dia tshiunvuidi	update
mapia mapia	upgrade
pamutu pa	upon
kunyingalala	upset
kunyanga	upset
bia mutshimenga	urban
dijinga	urge
lukasalukasa	urgent
tuetu	us
kwenzela	use
kuenzela	used
ni mishinga	useful
kupanga mishinga	useless
misangu yonsu	usual
misangu yonsu	usually
bia mushinga	utility
dikisha	vacation
kuangata bisalu	vaccination
kusadidwa	vaccination
tshisalu	vaccine
tshianana	vacuum
divuala	vague
kuanyisha	valid
tshibandabanda	valley
bia mushinga	valuable
mushinga	value
mishindu	variety
bis bungi	various
kushintuluka	vary
mulondu	vase
tshinena	vast
bisekiseki	vegetable
bisonsa	vegetable
bisekiseki	vegetables
mashinyi	vehicle
kupana	vendor
lulengu	venom
kumpanyi	venture
muaba	venue
kuteta	verify
mukenji wa bionsu	versatile
tshibadi	version
dilulame	vertical
menemene	very
bimpa be	very good
buatu	vessel
kupitshila	via
nsombelu	vibe
muadi	vibes
kuzakala	vibes
muntu mubi	vicious
buteyi	vicious
bakengi	victim
tshindidimbi	video
kumona	view
musoko	village
muenji wa malu mabi	villain
vinegre	vinegar
wa kala	vintage
tshikisu	violence
tshikisu	violent
kutampakana	viral
virgo	virgin
bia ku enternete	virtual
buimpe	virtue
tshikena-kumona	vision
mmuenenu	vision
kuendakana	visit
tshia kumona	visual
tshifidi tshia moyi	vital
ya mikola	vivid
biambilu	vocabulary
diyi	voice
kukupula	void
kumbusha	void
dîyi	volume
badifidi	volunteer
kuluka	vomit
kupanga bukubi	vulnerable
difutu	wage
difutu	wages
bula	waist
kuindila	wait
muena mudimu	waiter
mu ndindila	waiting
kutabala	wake
tabalayi	wake up
kwenda	walk
luendu	walking
tshimanu	wall
kabuta ka kulama makuta	wallet
kutambakana	wander
disua	wanna
kujinga	want
udibu bakeba	wanted
mvita	war
tshilaminyi thia nkanzu	wardrobe
bibombelu	warehouse
luya	warm
kudimuja	warn
didimuija	warning
bena mvita	warrior
pavua	was
kusukula	wash
bukoya	waste
diba	watch
mayi	water
tshimuma tshia pasteke	watermelon
mavuala	wave
njila	way
tudi	we
tudi	we are
tudi mua	we can
muntu mutshioka	weak
bilema	weakness
bubanji	wealth
mubanji	wealthy
kuambula	wear
mutantamenyi	wearing
dîba	weather
dibaka	wedding
disatu	Wednesday
tshisonsa	weed
lumingu	week
nshikilu wa lumingu	weekend
kutumpika	weight
bualu bua pabuapu	weird
difika dilenga	welcome
makanda a mubidi	welfare
bimpa	Well
bimpa bikola	well done
muya	went
bavua	were
ouest	west
mubola	wet
mushipa wa balene	whale
tshinyi	what
bishi wewa	what about you
udi wenza tshinyi	what are you doing
Ntshinyi tshiudi wenza mpindieu	what are you doing now
tshinyi tshi udi wenza mu tshitantshi etshi	what are you doing right now
udi wenza tshinyi	what do you do
utu wenza mudimu kayi	what do you do for a living
udi musua kuamba tshinyi	what do you mean
udi ukeba tshinyi	what do you want
tshivu tshienzeka	what happened
ntshinyi	what is
tshinyi atshi	what is this
utu wenza mudimu kayi	what is your job
dina dieba nganyi	what is your name
mapiamapia kayi	what's up
dina dieba nganyi	what's your name
nansha nanku	whatever
ntete ya blé	wheat
nkata	wheel
diiba kayi	when
misangu yonsu intu	whenever
kuepi	where
udi kwepi	where are you
udi ufumina kuepi	where are you from
udi kuepi mpindieu	where are you now
utu usombela kwepi	where do you live
tuyaya kwepi	where is
pina pu	whereas
anyi	whether
tshidi	which
udi	which
nansha	while
kunungana	whisper
kuela kashiba	whistle
mutoka	white
nganyi	who
wewa udi nganyi	who are you
nganyi eu	who is
nganyi	who is this
pamue	whole
nganyi	whom
udibu	whose
buatshinyi	why
bua tshinyi kabiena nanku	why not
muntu mubi	wicked
munene	wide
mukaji mukamba	widow
butshiama	width
mukaji	wife
lonji	wild
neikala	will
mudiakaje	willing
kutshimuna	win
tshipepela	wind
fenetre	window
kudileja	windy
nvinyo	wine
tshikondu tshia mashika	winter
tulamba tua kukupula natu	wipe
nshinga	wire
meji	wisdom
muena meji	wise
kujingila	wish
ndi nujingila bonsu masanka	wish you all the best
mwena buloji	witch
ne	with
kumbusha	withdraw
kupatula	withdrawal
mu	within
kupanga	without
ntemu	witness
bia mu nyuma	witty
mbua wa ditu	wolf
mukaji	woman
mukaji	women
kutshimuna	won
ka ku buenza to	won't
tshia kukema	wonder
bimpa bikola	wonderful
dibaya	wood
miosa ya mikoko	wool
muaku	word
miaku	words
mudimu	work
kudibidija	work out
dienza dia mudimu	working
buloba	world
lumuenu	worm
kuluata	worn
kubungama	worried
kuelangana meji	worry
bibi bikola	worse
kusambila	worship
kutendelela	worship
bibi bitamba	worst
mushinga	worth
tshidi ni mushinga mukole	worth it
mukumanyina	worthy
uvua	would
kutapika	wound
Eh	Wow
kuswikila	wrap
tshinji	wrath
tshianza	wrist
kufunda	write
Funda apa	Write here
mu nkatshi mua difunda	writing
kufunda	written
bia mafi	wrong
mifundu	wrote
lupangu	yard
kwela mwau	yawn
Eyowa	Yeah
tshidimu	year
bidimu	years
levire	yeast
kuela lubila	yell
manyimanyi	yellow
Eyowa	Yes
eyowa bebe	yes baby
eyowa munanga	yes dear
eyowa munanga	yes honey
eyowa dinanga dianyi	yes my love
eyowa mbulelela	yes of course
malaba mushala	yesterday
kabidi	yet
bipeta	yield
wewa	you
udi	you are
udi muimpa be	you are beautiful
udi muimpa be	you are so beautiful
ndi nnulomba	you are welcome
udi mua	you can
Udi mumanya	You know
wewa peba	you too
ki mbualu to	you're welcome
bu wewa Mua kusua	you're welcome
nsonga	young
tshieba	your
tshienu	your
tuasakidila	your welcome
wewa nkayeba	yourself
bu nsonga	youth
kakwena bualu to	you’re welcome
tuasakidila	you’re welcome
muenya wa katshia	yummy
tshijengu	zero
