Jun	a
chi'n	a little
nintz'	a lot
ch´uq	a lot of
k´loj	a lot of
oqb´il	abandon
k´olil	abandon
kolil	abandon
ko´lin	abandoned
ma b´nchet	abide
junpaqx	ability
kab´ale	able
naqaku tkitz	about
jawl	above
mya toj q-tx´otx´	abroad
nti'	absence
mixti	absent
iktzen	absolutely
tz'ub'il	absorb
abstracto	abstract
xnak	absurd
nimxix	abundance
nimxix	abundant
ma tz'ok il	abuse
yol	accent
k´amol	accept
oktzil	access
okx	access
k´ixb´len	accident
ja taye q-ja	accommodation
t´un tpon b´aj	accomplish
ma b'ent	accomplished
tzenku ló	according
tjlala tuj k'upwaq	account
tajlal k'u'npwaq	account
tzeʼnx	accuracy
axexje	accurate
ma kux b'ajsan	accused
ky´ixk´oj	ache
ky´ixk´aj	ache
k'anb'et	achieve
ma b´ent	achievement
niky'tzil	acknowledge
tzqi´n	acquaintance
t-tzyet	acquire
etzil	acquired
adquisicion	acquisition
tuj	across
tu	across
n-b´ajte	act
n-b´ant	action
itz'	active
aq'untl	activities
aju at toklen	activity
jun xjal in netz toj televisión	actor
jaala	actual
jane	actually
netz'	acute
naq'et	adapt
tz'aqsil	add
naqʼete tiʼj	addicted
tzuyet	addition
yoq'ol	addition
slapat	addition
junjutl	additional
tja q´amal b´e	address
janejenel	address
b´ant tun txiye	adequate
alojxa	adjacent
ka´yinb´ib´aj	adjective
tz´aqol	adjust
tz´aqet	adjust
tz´aqtzil	adjust
n-xi q-kayen wen	admire
tziyet	admit
ponex t-kayb´ajtz	adorable
ja ma qo kanen	advance
ma nej	advanced
a b´a´n	advantage
niky´b´ajil	adventure
K´tzpyol	adverb
qmal t-pakb´al	advertisement
chik'b'al	advertising
nab´l	advice
nab´il	advice
nab'il	advise
k'olil	advocate
ponex kayen	aesthetic
ajpaj	affair
q´on mal	affect
laq'il	affection
tzaqpaj	afford
asequble	affordable
xob´el	afraid
Texlena	after
q'ale	afternoon
yajxa	afterwards
yajxtil	afterwards
ju majt	again
ti´j	against
jte tanq´ib´la	age
ja qʼol tqanil	agency
jun xjal	agent
tx´uj	aggressive
ojqel	agile
tijxi	ago
kuyil	agree
k´uyil	agree
k´amol	agree
ik tzeʼn otoq	agreement
naqʼunan tiʼj txʼotxʼ	agriculture
tnejil	ahead
nejil	ahead
nejne	ahead
onil	aid
tz´ib´il	aim
xolte	aim
kyq´iq´	air
twitz ja	aisle
k'asb'il	alarm
q´en	alcohol
xqʼuqink tibʼa	alert
chwiqlal	alive
tkyaqil	all
b´a´n	all right
ky'iwb'il	all the best
kuyil	allow
a xq´mante	allowed
noq ch´intl	almost
tjunilx	alone
tib´ajxe lu´n	along
matxi	already
b´an	Alright
ikx	also
juntl lu´n	alternative
q'unpitz'un	although
axju	always
ayine	am
ponex wen	amazing
nya axixtok	ambiguous
tajbʼil tuʼn tbʼant tuʼn	ambition
xjal taj txqan puaq	ambitious
saman	amend
kyxol	amid
kyxol	among
kyxol	among us
jte tq´anil	amount
tze'	amusing
jun	an
chikʼbʼabʼil	analysis
qcham	ancestors
tzyubʼil bar	anchor
ojtxax	ancient
ex	and
yaj tzun ta	and you
talsanjil	angel
sanjil	angel
tx'ujil	anger
xky'ch jiqin	angle
jawna	angry
xk´oy	angry
xkyaq	angry
tx´kup	animal
n-a	ankle
q´ijlal	anniversary
qm'al	announcement
tx´u´jil	annoy
q´oj	annoy
tx'ujin	annoyed
shch´il	annoying
junjun ab´q´i	annual
ewitib´	anonymous
juntl	another
tzaq´wel	answer
tz´aq´wel	answer
qmaxpina	anticipate
lipen qanb´el	anxiety
lipel	anxious
a´lchaqxtz	any
tichaqx	any
q'otz	anymore
el qex	anyone
ti xku	anything
tzenculaj	anyway
maske ikju	anyways
junxitl	apart
nimtnam	apartment
chin tnajsama	apologize
ikytaqjo	apparent
t-kayb´ajtz	apparently
n-tza t-b´isen	appeal
kanetil	appear
t-kayb´ajtz	appearance
ma knet	appeared
q'q'in	appetite
tz´ib´q´ob´	apple
q'anilte	application
b´inchil	apply
amb´el te kayel	appointment
toklen	appreciate
la´qil	appreciation
txi lipey	approach
wen	appropriate
tzaq'wel	approval
tzaq´wel	approve
ma kutzb'il	approved
ch´ime	approximately
tkyaxjaw	april
mya tzʼaqlxix	arbitrary
ajtzqilximb´inch	architect
tzqib´ximb´inch	architecture
xk´u´b´il	archive
Eye	are
aya	are you
tla amb´il ti ja	are you busy
mejeb'niya	are you married
mejeb´niya maqa nya	are you married or single
a tixa atzu	Are you still there?
atz´ taya	are you there
jun pedaz tx´otx´	area
q-yol	argue
q-yol	argument
itz'jin	arise
q´ab´aj	arm
k'loj xjal	army
tijxe	around
b'nchet	arrange
b'inchal	arrange
tziyb'il	arrangement
ma ul	arrival
e´li	arrive
e´lil	arrive
pol	arrive
chin pone	arrived
jun xjal kuj yolen	arrogant
smaj	arrow
ilb'ilal	art
jun lu´n	article
mya atumel	artificial
ajkye´x	artist
s´e´n	as
toj chʼin ambʼil	as long as
ikx	as well
s'en tzun	as well as
tza´j	ash
tx'ixow'	ashamed
xjelil	ask
ma tzaj xjelin	asked
wtan	asleep
t-kayb´ajtz	aspect
Assamese	Assamese
b'uchil	assault
ch'uqxjal	assembly
niky´xjelil	assess
xjelb´il	assessment
niky´xjel	assessment
itz'	asset
at	assets
jask'ul	assign
taq´in	assignment
aq´untl	assignment
xel	assist
ajtz'ib'	assistant
junjun	associated
k'loj	association
tun txi q-b´isen	assume
kubʼ kyximen	assumption
toj	at
extzen	at least
ma wa'na	ate
jun xja'l	athlete
b'uyil	attach
tok ti´j	attached
b'uyil	attachment
yoqpet	attack
b'inchaxtla	attempt
kayinxa	attend
at	attendance
nak´b´il	attention
t-kayb´ajtze	attitude
juk'il	attract
nga'ne	attraction
ponex	attractive
jun bʼaʼn	attribute
jun audiencia	audience
twaxjaw	august
kyan	aunt
ixman	aunty
a b´inchelte	author
oklen	authority
q'ulq'ijil	autumn
amb´il	available
kyxol	average
nanxitb´inchana	avoid
i'tz'	awake
chojb'al	award
n-xi b´iset	aware
tanb´ele	awareness
chaq	away
ponex	awesome
qo tza xob´x	awful
alkayela	awkward
Aymara	Aymara
nex	baby
bachiller	bachelor
tijxi	back
txe	background
taq´wix	bad
ch'u'x	bag
ch'ux	bag
seb´	bait
tz'i'lsb'il	bake
womsb'il	bake
wonsb'il	bake
k´ayb´il xb´ukwa	bakery
jte´	balance
xpotz	ball
xpo´tz	ball
xtul	ball
Bambara	Bambara
lob'aj	banana
b'yuj	band
ky´ixb´aj	bang
k'ulb'il pwaq	bank
k'a'yb'il	bar
penex	barely
suqb´in	bargain
ch´iyin tx´wan	bark
sapalut	barley
maqb´il	barrier
tyajil	base
ttzaj	based
kub'ni	basement
basico	basic
oik'o'l	bastard
iky'	batch
tz´alb´il	bath
tz'alb'il	bathroom
bateriy	battery
nya bʼaʼn.	battle
kytzi aʼ	bay
xilen	be
a	be
kayix tumila	be careful
Tziya´	beach
b'inchal	beam
chenaq´	beans
nikx	bear
xmatz´ib´aj	beard
chej	beast
ma b´aj tq´ij	beat
ponix	beautiful
achb´ajil	beauty
qjal b'ian	became
Q´un	because
tu´nj	because
ma ja byan	become
koxb´il	bed
kuxb´il	bed
wuatb'l	bedroom
onin	bee
chib'j te wakx	beef
s'e'n tz'un taya	been
k´wab´aj tzeky´	beer
ojxi´	before
na´mxtaq	before
ma txi' qe	began
qetsal	begin
qeb´il	beginning
qe´	beginning
laqet	beginning
tb'anel jaku	behalf
qximbʼetz	behave
tzen n-oke tu´n kywutz xjal	behavior
tbʼanel qmod	behaviour
Ttza´ltij	behind
ti´jxa	behind
ti´jxi	behind
xilen	being
a	being
okslal	belief
okslal	believe
t-tz'on	belly
ja n-xi q-b´isen ja otoye	belong
xb'oj	beloved
kub´l	below
k'uj	belt
k´ulb´il pwaq	bench
pajtzul	bend
tjaq´	beneath
n-tza on qe tzen n-xi q-b´inchen jun lu´n	benefit
onb'il	benefits
tx-laj	beside
tok t-k´atz	besides
b´antyil	best
tb'anel junju	best of luck
k´olb´el	best regards
b´antyil	better
xol	between
kyxol	between
k'wab'aj	beverage
mastz´u´n ch´ix	beyond
Bhojpuri	Bhojpuri
tze´n n-xi txalene	bias
laqil	biased
chejqanb'il	bicycle
nimin	big
nmaq	big
ma´	big
chejqanb'il	bike
lu´n tun tokx q-chjon	bill
mojb'al	bind
pich	bird
ab'qi	birthday
ch'i'n	bit
xjak'al	bite
tx'a'l	bite
xjak'il	bite
k´a´	bitter
q'aq	black
q'eq	black
qesb'il	blade
tpaja	blame
pajb'al	blame
saq´	blank
q-chamar	blanket
poq'j	blast
simol	blend
smol	blend
k´i´wil	bless
ky´iwlal	blessed
ky´i´wlal	blessed
k´i´wil	blessed
mox	blind
k'iwlab'il	bliss
jpul	block
chiky´	blood
chik´el	blood
b´echil	bloom
n-el poq´le	blow
xq'ilin	blue
jun lu´n desafilado	blunt
mujb´el	board
mak´ox	boat
xmilalb'aj	body
loq'lol	boil
q´aq	bold
tkʼujlabʼil	bond
b'aq	bone
uj	book
matijset	boost
mojel	booster
chunxjab´	boot
chunxjab´	boots
tx´an b´e	border
uljil	bore
q-watl	bored
ky´aj	boring
altwinqal	boring
itz´jil	born
qmajin	borrow
nejenil	boss
k´ab´íl	both
iplaj	bother
lmet	bottle
kub´il	bottom
tjaq´	bottom
ma loq´in	bought
lipel	bounce
tzyu´n	bound
tiʼchaq mitiʼ	boundaries
tokixpo'tz	bow
tk´wel	bowl
kax	box
q´a	boy
xmoxil	boyfriend
ti q'ob'aj	bracelet
xoqxi´n	brain
jolin	brain
jolon	brain
jun t-q´ob´	branch
techel	brand
tx´u´jil	brave
mi xpon b'aj	breach
twamo´s	bread
xb´ukwa	bread
tx´i´l	bread
laqil	break
wa'l	breakfast
mix	breast
xew	breath
xewaj	breathe
xewb'aj	breathe
ch´iysal	breed
a´lal	breed
xkyaqloq´	brick
xmoxb'il	bride
q´a´jan	bridge
q´anjin	bridge
q´a´j	bridge
ch'inin	brief
qopb'l	bright
qoqb'il	brilliant
q´intza	bring
tx'ibin	bro
nim toj	broad
yek'il	broadcast
q'olte	broadcast
ma laq	broke
xlaq	broken
tz´isb´il	broom
itz´inb´aj	brother
atzikyb´aj	brother
xib´aj	brother
b´alak	brother in law
b´aluk	brother in law
aq´untl	brought
aq´un	brought
tx'ajil b'aq'	brush
tb'el	bucket
tuk´il	buddy
xkomp´it	buddy
t-xb´oj	buddy
jte t-wi´	budget
ma chi qe tzaqje	bug
txakb´et	build
b´inchil	build
nimja	building
wa´linja	building
ma b'inchet	built
iqtz	bulk
wakx	bull
b'iyol xjal	bully
iqtz	bump
ktxij	bunch
b'laq'	bundle
Iqal	burden
isq'ul	burden
iqil	burden
mq'un	buried
patil	burn
ma tzel poq´j	burst
maqul	bury
muqil	bury
k'uxb'il	bus
txu'l	bush
k´ax	business
t-jaq´ t-qule	bust
tla amb´il	busy
me	but
txamanil	butter
pak'il	butterfly
natob'	button
loq´al	buy
laq´ol	buy
loq´il	buy
ch´ine	by
ch´ini	by
ch´inrtz´	by
naq' sik'wal	by the way
wexa	bye
kolx	cabbage
kulix	cabbage
kax	cabinet
tja txkup	cage
pastel	cake
notz'	calf
yolb´ilte	call
ch´in tyolb´tza	call me
k'alil	called
txokil	called
txakol	called
chewsil	calm
ul	came
ma tzul	came
jaku	can
ja	can
b´antel	can
lay b´ent	can't
layt	Cancel
okxju	Cancel
q'ayab'il	cancer
b´an	capable
b´an tu´n	capacity
nim yol	caption
ma tz'yet	capture
carro	car
oqe´lan	career
oqelb´aj	career
oqelbp´il	career
cheb´e taj	careful
chab'a	carefully
xi k'ayin	careless
tk'ujlab'il	caring
ajtze´	carpenter
b'etb'il	carpet
maman	carrot
q'anitzaj	carrot
q'anjil	carrot
q´inxa	carry
lejet	carry on
b'inchal	carry out
ja n-chi ku´xe lu´n	case
pwaq	cash
aye elenco kye xjal	cast
ja	castle
junjen q´ij	casual
wix	cat
tzuyil	catch
tzyul	catch
ch'uq	category
alimil	cattle
ma tz´yet	caught
tu´n	cause
k´ayinxa	caution
kayil tumil	cautious
jul	cave
okx	cease
yek´b´itz	ceiling
iky´sab´itz	celebrate
iky´saj q´ij	celebrate
tnitx'il k'ul	cell
tmij	center
niky´aj	center
jok'al ab'qe	century
wabʼj	cereal
yuxhil	ceremony
junjen	certain
ex iktzen wen	certainly
uʼj	certificate
aq'il	chain
q'uqb'il	chair
q'a'jtz	chair
anb´il	chance
tx´exb´il	change
i´l	chaos
t-kayb´ajtz	character
kymod	characteristics
iqatz	charge
mojel	charity
tzalaje	charming
techel	chart
lajol	chase
lajil	chat
miya´wi´yal	cheap
sb´ul	cheat
yolin t-xuʼjil tukʼil junt	cheating
xq´uqil	check
txaq'tzi'	cheek
tzalajb´il	cheer
tzalajsb'il	cheerful
ntzalaj	cheerful
b´a´n	cheers
chwiqlal	cheers
kyes	cheese
b´inchel q´anb´el	chemistry
laq´il	cherish
qanb´el	chest
tx'a'l	chew
k'xul	chew
b'e'l	chew
eky'	chicken
txuxu'l	chicken
tejil	chief
kw´al	child
k'walil	childhood
k'wal	children
chew	chill
ob'aq	chimneys
xpetz	chin
tz´ub´aj kyikyiw	chocolate
sk´ob´il	choice
sk´ol	choose
ch´yon	chop
tun tku q-b´inchen	chores
q'es	chubby
tja manb´aj	church
canel	cinnamon
se´w	circle
aye lu´n n-chi b´ajte	circumstances
ajchojil	citizen
tnam	city
qanixa	claim
xjelinxa	claim
spiky'eb'il	clarify
t-clase	class
ch'ax tx'o'tx'	clay
saq	clean
sjanin	clean
xnul	clean
b´a´n	clear
ajtz'ib'	clerk
b´a´n b´isen wen	clever
loq'il	client
xaq	cliff
na´ltx´otx´	climate
q-jay	climb
q'lak'	clingy
ch'aq'	clingy
ajlab´il amb´il	clock
miltz´ul	close
jpul	close
lamol	close
k´ub´b´il	closet
b´u´x	cloth
ijb´aj	clothes
muj	cloud
at muj	cloudy
payas	clown
kol	clue
mib´e tu´n	clumsy
chmoj xjal	cluster
xjal yek´el	coach
txan q'a'l	coal
mlaj	coast
q-sueter	coat
k´ape	coffee
cognitivo	cognitive
kanet	coincidence
chew	cold
ma ku yutx´j	collapse
qul	collar
tuk´il	colleague
xkomp´it	colleague
t-xb´oj	colleague
t-xb'oj	colleagues
b´uyil	collect
b'uyil	collection
xkomp´it	college
tk'wa'	color
chin laqe tin txuye	colorless green ideas slept furiously
tk´wa´	colour
tb'aqil ttzal i'jb'aj	column
xweb'	comb
mojb'al	combination
junx	combine
tzaja	come
we tzaja	come
tzaja tzala	come here
q'oya	come on
pon tkʼuʼj	comfort
b´a´n	comfortable
juntl	coming
chixtil	coming soon
chq'ol	command
xim yol	comment
k´ayb´il	commercial
taqʼun	commission
comprometerse	commit
jtoj tun tu´le	commitment
comprometido	committed
k´ax	commodity
axu	common
q´umol	communicate
yolil	communication
tnam	community
kal	commute
txkompi't	companion
loq´al	compare
loq´il	compare
mojb'et	comparison
qʼaqʼbʼil qkʼuʼj	compassion
qʼaqʼin tkʼuʼj	compassionate
ikq´ex	compatible
kbʼantel tten	competent
b'a'nxnaq'tz	competition
mas bʼaʼn	competitive
b´ajsal	complain
tyol tiʼj juntl	complaint
tmoj	complement
Tz´aqali	complete
Tz´aqli	complete
akax	completely
cuest	complex
tze'l twitz	compliance
ch´u´x	complicated
tz´el twitz	compliment
el twitz	comply
tbʼinchbʼen	composition
at toj	compound
keleltnik'	comprehension
mojb'ab'il	comprehensive
tun txi b´inchet	compromise
sq´uin	compulsory
ajnab´il	computer
ximele	concentrate
t-kayb´ajtz	concept
ti tzulo	concern
melj	concerned
ch'uq xjaal	concert
iktzentzje	conclusion
axexje	condition
junjun tiʼchaq	conditions
t-kayb´ajtz kywutz xjal	conduct
atlu	conference
q'mal	confess
q'uqb'il k'u'j	confidence
ax	confident
q'mal tq'anil	confirm
q´oj	conflict
ma qe tzak'j	confused
najil	confusion
tzalajsal	congrats
tzalajsal	congratulation
tzalajsb´il	congratulations
ch'uq	conjunction
mojb'al	connect
tkubʼ tiʼj	conquer
tenab'il	conscious
qnab'il	consciousness
chuch´i´	consent
ti kb´ajel	consequences
laj	conservation
ku tz´ulo ku tx´imina	consider
klo'n	considered
techel	consist
majx	consistency
jun lu´n n-xi b´inchet junjen q´ij	consistent
q´achq´al	constant
at ju	constantly
b´inkab´il ja	construction
b'ajsal	consume
b´ajsal	consumption
molj	consumption
b´ajsil	consumption
tzyul	contact
b'ajo'k	contagious
at toj	contain
tten	contains
ja'lin	contemporary
ik´al	contempt
ik´il	contempt
b´ixnaq´tz	content
conrus	contest
aju yol	context
a iq´in tun	continent
lojonxa	continue
twi´ aq´untl	contract
junxitl	contrast
chojil	contribute
chjol	contribute
onb'il	contribution
tkawbʼil	control
wul	controversial
tu´n b´a´n	convenient
tx'olb'al	conversation
lajiñ	conversation
kjalb'iyan	convert
chik´il	convey
kub´ tuj twitz	convince
mikb'el ti'j	convinced
b'nchal wab'j	cook
b´inchal wabj	cooking
xbajin	cool
mojil	cooperation
weʼ kywitz	cope
kob'r	copper
tq´anal	core
xin	corn
b'utx'	corner
tb'anil	correct
twi'	cost
xnb´alamb´alil	costume
ja	cottage
noq'	cotton
q'uqb'il	couch
qulb´aj	cough
sjol	cough
tzjo´l	cough
ku tz´ulo	could
chemb'il	council
ajlall	count
ojla´n	count
yek´il k´ax	counter
tnam	country
k´ul	countryside
junjen	couple
tx'ujil	courage
xnaq´ta	course
jol	court
amj	court
tbʼanel xjal	courtesy
chojb´al	cousin
kotzalalb´il	cousin
maqsil	cover
wakx	cow
ma ja x'ob'	coward
chap	crab
chop	crab
laqin	crack
yaq	crap
punil	crash
tk'ok'jal	craving
k´ol txakal	crawl
k´e´b´il	crawl
txakil	crawl
xo'j	crazy
Swat	crazy
nab'lilte	create
b'nchalte	create
t-b´anex b´isen	creative
q-k´as	credit
ob'il	creep
klelin	creepy
nimxix	crew
il in bʼant	crime
ch´ixil	cringe
ch´ixwel	cringe
mintiʼxix kypwaq	crisis
t-ximbʼetz	criteria
ilx ti´j	critical
yolintoq nya bʼaʼn kyiʼj txqantl	criticism
awaj	crop
awal	crops
iky´ix	cross
ikyi´t	cross
ikk´xil	cross
joj	crow
txqan xjal	crowd
jun xjal atestado	crowded
coron	crown
cruacial	crucial
xkyaqk'u'j	cruel
bark	cruise
yuq´el	crush
oq'il	cry
tz'ul	cuddle
abrazos	culture
tzeʼn jaku bʼant	cunning
k'wab'il	cup
k´ub´b´il	cupboard
wa'b'il	curb
q´anil	cure
tyeja tjaya	curfew
tuʼn tel mas nnikʼe tiʼj.	curiosity
b´isel	curious
coloch	curly
se´pwaq	currency
ak´a´j	current
a jalin	currently
q'anil toj twi'	curse
txab'alaninja	curtain
q´awej	cushion
xkanob'il	custom
tzejxb'alin	custom
loq´el	customer
aduanas	customs
qesil	cut
tb´abil	cute
amb'al	cycle
tata	dad
tat	dad
mamb´aj	dad
tat	daddy
junjun q'ij	daily
ta'l imaj	dairy
tzyu'n	dam
yajil	damage
yajilte	damage
q'anil toj twi'	damn
xb'umb'uj	damp
b'ixil	dance
tzaj jun nya bʼaʼn	danger
taq'wix	dangerous
qlolj	dark
qtakin	dark
qlolaj	dark
n-xujele waje ti´j	darling
tzok'	dash
nim toklen	data
tajlal	date
tajlalq´ij	date
alib´aj	daughter
q´ij	day
kyimna	dead
kyimni	dead
tmakb´il q´ij	deadline
chk´in	deaf
xi q-b´inchen	deal
tal	dear
xb'oj	Dear All
Samel Xjal	Dear Customer
eyeq´iye manb´aj	Dear Parents
xb'oj	Dear Sir
eyeq´iye k´uxun	Dear students
eyeq´iye wuk´il	Dear Team
kyimni	death
yolin tiʼj	debate
tz'el q'in	debit
tz'is	debris
k´as	debt
laj ab'qi	decade
ma b'aj	decay
ma kyim	deceased
sb'ul	deceive
tkalaxxjaw	december
b´a´n	decent
n-xi t-b´isen	decide
txi b´iset	decided
b´isel	decision
maqsil	deck
ik'il	decline
qelil	decrease
xonk'u'j	dedicated
aq'unal tij	dedication
tz'b'b'en	deed
nim t-xe'	deep
jun-venado	deer
estzen tu´n	default
ma k´ub´	defeat
kolil	defend
ikja	define
iktzen	definitely
tzen kxele	definition
ab'q'i xnaq'tz kol	degree
ma q'et	delay
yaj	delayed
siky'il	delete
ma kut b'isen	deliberate
k´uw	delicate
k´o´kj	delicious
oquinil	delight
k´ujlal	delighted
q´ot	deliver
q´ol	deliver
q'olte	delivered
ma chin tza je q'olte	delivery
b´ajsal	demand
amlil	demanding
tiptnam ex numb´il	democracy
nak´b´il	democracy
txub´txaj anq´ib´il	democracy
ju'o	demon
yek´b´il	demonstrate
ma ju ewin	denied
ch'uxh	density
q-anil eyb'aj	dentist
lay	deny
te tnam	department
ma txi´	departure
k'okel	depend
loch´il	deploy
n-okx	deposit
bisin	depressed
bis	depression
txe´	depth
q´mantza s´en	describe
t-kayb´ajtz	description
n-ti´ at toj	desert
leq´	deserve
b´inchel	design
tqʼoʼn	designation
ajb´il	desire
mex	desk
tz'ib'b'il	desk
también	desk
toj kʼixkʼoj	despair
tunx n-b´isenx	desperate
t´un pitzun	despite
n-ti´ at toj	dessert
tun q-kanen	destination
kpon	destiny
ch´uqal	destroy
q´uchil	destroy
yuch´il	destroy
tx'uyil	destruction
junjun tiʼchaq	detail
jun tiʼ	details
tel naj qnikʼ	detect
jte´ qaj ti´j	determination
ma pon b´aj	determine
tajxex	determined
chunil	devastated
b´inchel	develop
bʼinchaʼn	developed
ch'isb'il	development
kxb´il	device
taj wil il	devil
tililxix	devoted
Dhivehi	Dhivehi
diabetes	diabetes
k´uj	diarrhea
chijtl	diary
pujb´ilyol	dictionary
ma ku tbinchan	did
kimni	die
kim	die
kyimni	died
kyyoʼn xjal weʼyaj	diet
junxitl	difference
ju´nxil	different
junxil	different
kyuw	difficult
ch´ux	difficult
lukal	dig
t-dignidad	dignity
xhtij	diligent
w'al	dinner
jk'om	dip
qʼanchaʼl	direct
janejenel	direction
nejenel	director
tz´il	dirt
tz'i'l	dirty
q'ux	dirty
anmi	disable
anmi	disabled
najsil	disappear
q-k´e tun q-kayen ti´j	disappointed
i´l	disaster
xol	discard
iqal	discharge
q´lte	discharge
nak´b´il	discipline
jolil	discover
jalol	discover
iq'il	discrimination
yolil	discuss
wul	discussion
yasil	discussion
ch´otjil	discussion
yab´	disease
yab'il	diseases
ewil	disguise
nya´txu´txjal	disgusting
le'wlaq	dish
le'wlaq	dishes
k'awil	dismiss
k'ayil	dispatch
yek'al yek'il	display
tz'is	disposal
txi tiret	dispute
jte´ q-xol	distance
junxit	distinct
q´inchil	distinguish
b'is	distress
le´l	distribution
sipil	distribution
distrito	district
ky´elet	disturb
yekil	disturb
jul	ditch
jilil	dive
tixch'aq'	diverse
chukchaq anq´ib´il	diversity
sipil	divide
palte	divide
ponix	divine
ma ku p'an	divorce
yupaj	dizzy
witzb´aj	dizzy
jaku	do
ay	do you
in laqa wije	do you love me
q´anel	doctor
q´anil	doctor
u'jil	document
ma´y	does
may	does
mi'n	doesn't
tz´yan	dog
Dogri	Dogri
b´inchal	doing
la's	doll
b'antil	domain
q-jay	domestic
kyuw	dominant
lay	don't
mixti	don't
tla	don't
nan tzaj txima	Don't worry
oyil	donate
b´a´nmaj	done
bur	donkey
k´ab´e	double
xjel	doubt
xka´mil	doubt
q´uq´il	doubt
q'otj	dough
kub´l	down
kub'sil	download
q´uchb´il	draft
jk'ul	drag
jutzx	drain
jutzl	drain
iltzeb'	drama
tilb´ilal	draw
kyajb'utx'an	drawer
kax	drawer
ilb'ilal	drawing
xtalb´il	dread
witziky´	dream
chuy	dress
laq'il	drill
k´wab´aj	drink
manejarel kxbil	drive
txat	drop
t´un t	drop
ma ku tzaq'	dropped
tzqij	drought
tx´ojtenil	drunk
tzqi	dry
txajan	dry
patz	duck
xjel	dude
xk'amil	dude
q'uq'il	dude
toj	due
t´un tpaj	due to
tzaj q-watl tu´n	dull
men	dumb
sma'k	dumb
me	dumb
axtok	dump
ax	dump
jteʼ amb'il	duration
tze´n	during
quq	dust
qupj	dust
puj	dust
k'as	duty
najal	dwell
kyimni	dying
kim	dying
jun jun	each
tz'oka	each other
n-lipen xjal	eager
t´iw	eagle
xkyimb´aj	ear
q'ontz amb'il	earlier
qlax mo qlixje	early
kanb'il	earn
xkyimb´aj	ears
tx´o´tx´	earth
kyaqnab´	earthquake
q-facilidad	ease
nya kuj	easily
a la	east
tu´nxtib´	easy
wa´l	eat
wal	eat
wa´l	eating
pwaq	economic
pwaq	economy
ja n-el b´aj	edge
b'nchu'j	edit
xnaq´tzb´il	education
n-b´aj ti´jxe	effect
tbʼanel	effective
bʼant tuʼn	efficiency
b´an b´inchen	efficient
ipal	effort
jos	egg
xpenitzaj	eggplant
nimsan tibʼ	ego
wajxaq	eight
wajxaqlaj	eighteen
kyajk´al	eighty
maqo	either
b´inchal	elaborate
tch'eq' q'ob'aj	elbow
ni min xjoq´	elder
nimin	elderly
q´tik´	elegant
tz'aqsb'il	element
elefant	elephant
b´elaj	eleven
jun lu´n kab´ale token	eligible
tkubʼ naj	eliminate
nimx	else
q´otzl	else
tx'ixwil	embarrassed
ch'ixil	embarrassed
ch'ixwel	embarrassed
chʼixwi	embarrassing
Tz´ulil	embrace
chlel	embrace
ma ja b´ian	emerge
nya bʼaʼn	emergency
tuʼn ttzalaja	emotional
ximana	empathy
enfasis	emphasis
yekʼinxa	emphasize
majin	employee
majin	employees
majin	employer
aq'untl	employment
mishti toj	empty
amil	empty
miti toj	empty
kuyil	enable
jyo´n	encounter
ma tzel yal	encounter
txi q-mojen	encourage
ma b´aj	end
toj taq'wix	endangered
kyuw	endeavor
kuj	endurance
tipa	endure
ajq´oj	enemy
tipumala	energy
kxel b´inchet	engage
taj tun tok	engaged
jun compromis	engagement
rum	engine
juk'ul	engine
ajtzqilb´inch	engineer
me'x yol	English
b´antyil	enhance
taje	enjoy
nintzk'u	enormous
okxu	enough
axix	ensure
okx	enter
q-kayb´etz	entertainment
tzalajb´il	enthusiasm
tzalajsb'il	enthusiastic
ntzalaj	enthusiastic
junka	entire
tuk´il toklen	entitled
ch'uq xjaal	entity
oktzil	entrance
okx	entrance
xjal n-b´inchen jun lu´n saq	entrepreneur
tib'aj	envelope
tb'el	envelope
twitz tx´o´x	environment
yaqil	envy
xkyaqtze'l	envy
xjiq'al	envy
mintiʼ tzaj xobʼ	epic
yab'il	epidemic
iikx	equal
ky-lu´n	equipment
junx	equity
junx	equivalent
xqechb'il	eraser
nya bʼaʼn	error
oqil	escape
oqel	escape
extzen axexje	especially
xnik'chal	essay
k'ok'jil	essence
ilx	essential
tun tok	establish
kxel o´n	established
q'ina	estate
nxi q-b´isen	estimate
t-xb'oj	estimated
lay b'aj	eternal
tb'anel	ethics
niky'xjelil	evaluate
xjelb'il	evaluation
ex	even
extzen	even though
aq´b´il	evening
qoniky´an	evening
qniky´in	evening
jun lun n-b´aj	event
ex junjen maj	eventually
ju majku	ever
junjun	every
tkyaqil	everybody
tyaqilx	everyone
tkyaqil	everything
tech'il	evidence
tajaw il	evil
tajwil il	evil
tzajni qoʼ	evolution
tx´ixpul	evolve
Ewe	Ewe
o tz´ik´	ex
ikja	exact
iktzen	exactly
ka'yib'il	exam
ka'yib'il	examine
techel	example
tel qbʼis	exceed
ponex	excellent
me mi´ne	except
okxa	exception
nimxix	excess
nimxix	excessive
tx´exb´il	exchange
n-lipen qanb´el	excited
n-qo tzejen tu´n	exciting
naq oʼkx	exclusive
najsama	excuse
najsama	excuse me
b´inchalte	execute
tkubʼ bʼiyoʼn	execution
jun ejecutivo	executive
aq´net	exercise
oqil	exhaust
siktel	exhausted
mujle	exhibit
yekb´il	exhibition
i'tz'	exist
at	existence
atixix	existing
tzexa tzala	exit
lemtz'il	expand
yol	expect
ayo´n	expected
ayo´nmaj	expected
ayon	expected
kub' tb'ajsan	expenses
wi´yal	expensive
ojtzq´b´il	experience
ojtz'q'il	expert
kub'	expired
tx'olb'al	explain
chik'b'l	explain
chik'b'al	explain
chik'b'al	explanation
yajil	exploit
qo kayen	explore
exk´ay	export
chik'il	expose
tyek'in	exposed
chik´il	exposure
tx'olb'al	express
chik'b'al	express
chik'b'il	express
yek´kye´xix sa´b´ix	expression
q´onxa	extend
yekin	extended
yoli'	extended
extension	extension
echil	extent
jumajx	external
ma k'ubaj	extinct
juntl	extra
toj chʼin yol	extract
nim tbʼanel	extraordinary
kuj	extreme
junti´j	extremely
witzj	eye
witz´j	eyes
chem	fabric
tbʼanelxix	fabulous
twitz	face
nya kwest	facilitate
q-facilidad	facilities
ma b´nchet	fact
b'a'nmaj	fact
nim toklen	factor
b'inchb'il	factory
b´inchaj	facts
ma Kim	fade
ma txi'	fade
ma tz´akj	fail
ma tzakj	failed
ma tzá qj	failure
xb unin nya kuj	faint
numj	faint
naqchaj	fair
junx	fairly
q´uqlalk´u´j	faith
wen	faithful
nya ax	fake
tz´aq	fall
chaj yol	FALSE
ploj	FALSE
taq´ux	FALSE
nimxix toklen	fame
jaxjal	familiar
najayal	familiar
jaxjal	family
najayal	family
q´aq´in	famine
jotx wutzqilte	famous
xjal taj qi´j	fan
witz´ik´ixim	fancy
chaq	far
mankasab´il	farewell
attoq nim awal	farm
ajkojol	farmer
n-qo ja ka´yen ti´j	fascinating
tbʼanel	fashion
ojqelx	fast
xb´ok	fat
xtob´	fat
chu´s	fat
nach	fatal
ja ma qoxe	fate
xnuq	father
tata	father
tat	father
siktel	fatigue
ma q´etzakj	fault
a mas qaj ti´j	favorite
xtalb´il	favour
mas ngane	favourite
xob´ajil	fear
chewil	fear
chi	fear
nim chib'j	feast
xiky'b'aj	feather
t-kayb´ajtz	feature
kyok ti´j	features
tkab´jaw	february
xtx'ujin	fed up
chjol	fee
k´achil	feed
k´a´chil	feed
yol	feedback
n'alte	feel
na'l	feeling
qamb'aj	feet
q'anab'aj	feet
ma k'u tz'aq'	fell
wuk´il	fellow
ma ku tnana	felt
ttxu	female
naq´aku	fence
b´a´n tz´alen	fertile
nintz q'ij	festival
jyol	fetch
kyeq´ kyaq	fever
ch´in	few
noq ch´inxix	few
ch'in	fewer
kyajlaj	fiance
k´ul	field
juntij lamidx	fierce
jwelaj	fifteen
ka´k´al laj	fifty
jya'tz	fight
la'jan k'axjel	fight
la'jan	fighting
t-kayb´ajtz	figure
jyol	figure out
k'u'l	file
nojsantzan	fill
ma tzq´et	filled
txumakib´	film
q´ux	filthy
tz´il	filthy
tuntzentzje	finally
pwaq	finance
pwaq	financial
ma knet	find
ma tze'el yal	find out
b´a´n	fine
tal qob´aj	finger
b´aj	finish
ma b'ent	finished
q'aq'	fire
tok	firm
tnejil	first
tnejel	first
tjil tb´i	first name
katz	fish
kyix	fish
naq´l	fit
naq´et	fit
naqle	fit
jwe´	five
b'inchalte	fix
junx	fixed
tsu't tnam	flag
tzaj	flash
chq´alaj	flat
chq´ajlaj	flat
tzkaj	flaw
tx'u'jwi	flaw
saq	flawless
oq´il	flee
ch´ib´aj	flesh
ma lipan	flew
paqtzul	flex
koxpil	flexible
kylipan twitz kyaʼj	flight
miltz´ul	flip
paq´tzull	flip
chunil	flirting
ma k´uj b´aj	flood
ma k´uj lob´j	flood
twi´tx´otx´	floor
ky´aj	flour
n-tza t-b´inchen tib´aj	flow
b´ech	flower
yolok toj twi	flu
a'	fluent
nya kuj	fluently
chab´a	fluffy
ta'l	fluid
lipal	fly
kxel kayet	focus
muj	fog
muj q´witz	foggy
q´aqmujil	foggy
paqtzul	fold
wukile	folks
lipeb'il	follow
ljonxa	follow up
juntl	following
niky´b´eb´il	food
xnak	fool
xkonk	fool
qejil	fool
mib'in	foolish
tx'u'j	foolish
qamab'aj	foot
q'anb'aj	foot
xpo´tzil	football
tu´n	for
te	for
techel	For example
jun kyxol	for instance
teya	for you
mya b´an	forbidden
ipumal	force
tzen tzule	forecast
twitz	forehead
mya te tzaló	foreign
tze´	forest
k´ul	forest
te jotx q´ij	forever
el naj	forget
najsimil	forget
najsal	forgive
ma tz'ik' tnal	forgot
tza'n tiene	form
b´a´n	formal
formal	former
b´a´namaj)	fortunately
tq'inimal	fortune
kab´k´al	forty
kab´k´al kab´	forty-two
twitz	forward
tbʼanel tten	foster
ma la'jan k'axjel	fought
ma knet	found
kab'.tlok'	foundation
kyaje	four
kyaj	four
kyajlaj	fourteen
chux	fox
kab´ale taq´e	fragile
tilbʼilal	frame
alkye tten	framework
laq´e tib´il	fraud
ttxu	freak
tz´pin	free
tzaqpin	freedom
qwak´sal	freeze
wak´sil	freeze
che´wsil	freeze
atl	frequency
ch´qalx	frequent
kukx	frequent
ch´qalx	frequently
kukx	frequently
xba´jin	fresh
joq'ij	friday
chewsb´il	fridge
quk´ila	friend
xb´oj	friend
xjal b´an yolen	friendly
quk´ila	friends
tamiw	friendship
x´ob´ajil	frightened
lab'il	frightening
xulma	frog
xal	frog
maxtz'u	from
plaj	front
tplaj	front
wak´sin	frozen
che´wsin	frozen
qwak´	frozen
lob´j	fruit
tzaj tbʼis	frustrated
gasolin	fuel
Fulfulde	Fulfulde
nojsantza	full
tzalb´ajil	fun
tachaxil	fun
tajb'en sqit	function
ka'yb'il	function
kib'il	function
iqin tnam	fundamental
muquʼn	funeral
tzalb´ajil	funny
txa ab´aj	fur
tz´umil	fur
tx'u'jin	furious
toj tja'	furniture
q´ontz	further
extzen	furthermore
tzul	future
kanb´il	gain
saqchal	game
netz´ b´e	gap
tja b'och	garage
tz´is	garbage
ja te b'ech	garden
anx	garlic
anjs	garlic
tjpel ja	gate
mojb'ab'il	gather
chmob´il	gathering
ch´uqil	gathering
echil	gauge
ma tzaj q'on	gave
jun tuerca	gear
xe´chil	gender
tqab´	gender
jotx	general
majx	generally
b'inchal	generate
toj ambʼil	generation
b´a´xjal	generous
twi´xim	genius
xe´chil	genre
tqab´	genre
tb´anilxjal	gentle
twutx té	genuine
kotx'il	gesture
kanetsil	get
xb´alamet	get dressed
q´on tija	get dressed
wektza	get up
qa tz'el b'a'na	get well soon
kanetsil	getting
ju'õ	ghost
Ma wile jun anmi´	ghosting
nintz'ku'	giant
o´yb´itz	gift
xanxiw	ginger
kuxin	girl
tukʼil	girlfriend
q´olte	give
oqb´il	give up
kolil	give up
ko´lil	give up
dado	given
tzalaj	glad
oquinil	glance
lemet	glass
tjomel witzb´aj	glasses
k'ayil	glimpse
nya we'n	gloomy
qoqb´il	glow
xtilin	glow up
xtilan	glow up
lak´ib´il	glue
q´oxel	go
nejli	go ahead
tx´iya´	go away
wtal	go to bed
q´oya tal	go to bed
ktal	go to bed
tikb´antel	goal
a wajb´ile	goals
Ttxu chib´	goat
chip	goat
ajaw	god
ky'iwb'il ajaw	god bless you
n-ipan	goes
nipan	goes
ma chinxe	going
q´oya atz	going to
q'anpwaq	gold
ma txi	gone
ma q'ox atz'	gonna
oeri	goo
b´a´n	good
q´alte	good afternoon
chinq´olb´ene	good afternoon
wexa	good bye
chab´iya	good bye
b´a´ntz q´ij	good day
talte	good evening
qalte	good evening
b´an aq´na´n	good job
aq´unb´en	good job
aq´namaj	good job
ponix	good looking
b´ax kayen tib´e	good luck
B´a´tz q´ij	good morning
chinqolbéne	good morning
b´an q´ij	good morning my love
ta´lt	good night
qalte	good night
wexa	goodbye
qalte	goodnight
at jun	goods
google	Google
gans	goose
ponex wen	gorgeous
slak'	gossip
kenetsil	got
kanetsal	got
chi k'aneye tij	got it
wi´xin	government
tzuyil	grab
tzyul	grab
ab´q´i xnaq´tz	grade
kol	grade
cheb'a	gradually
xnaqʼtzbʼil	graduate
twi'tz	grain
q'onxa	grant
xjitz	grapes
kaneyil	grasp
itzaj	grass
q´oj chionte	grateful
q´ol chjonte	gratitude
jul	grave
sib'	gray
b´a´nxix	great
achb'il	greed
tuk´a avidez	greedy
txa'x	green
q'olb'eb'l	greet
q´olb´eb´il	greeting
q'olb'el	greetings
sib'	grey
pa' xwub'	grid
n-cho´n	grief
ch´el	grind
tzyuma	grip
matij	gross
tajq' xjab'	ground
chmoj	group
ch´iy	grow
ch´iyil	grow
ch'iy	growth
lo'ch	grumpy
guaraní	Guarani
qkʼuʼj tiʼj	guarantee
xq'uqil	guard
ponil	guess
txokb´il	guest
nejil	guidance
yek´ul b´e	guide
tpaj	guilty
pajb´al	guilty
q'a	guy
q'a	guys
kuxin	guys
ax b´inchet junjun q´ij	habit
jaa	habitat
ma ja tz'aq'	had
saqb'aqaj	hail
saqb'aqin	hail
xyen	hair
tzmalwi	hair
nik´jan	half
q'uqb'il	hall
q´ob´aj	hand
yukal	handle
yukchil	handle
q´tik´	handsome
yob´ink´a	hang
kyten jun rat	hang out
qa ma b'aj	happen
ma b´aj	happened
tzalajsb´il	happiness
tzalaj	happy
Tzalajsb´il q´ij teya	happy birthday
tzaljsb´il q´ij teya	happy birthday to you
Tzajasb´il ak´aj abq´i	happy new year
ch´ux	hard
kyuw	hardly
bajxa	hardly ever
yajil	harm
q'on taq'wix	harmful
ttxu´txajil chnab´	harmony
ch´ux	harsh
aw'al	harvest
a ti te	has
xkymb'aj	hate
a tita	have
Iq´in	have
b'atz qij teya	have a good day
b´a´nx q´ij teya	have a nice day
wa´l	have breakfast
wal	have breakfast
tachxil	have fun
tzalb'ajil	have fun
ma wana	have you eaten
a tita	having
aq´in	having
xob'ajil	hazard
yaq'	haze
a	he
a ti te	he has
a	he is
wib´aj	head
wi	head
nchon wi'	headache
q´anil	heal
b'a'n	health
b´an t-chwinqel	healthy
b´il	hear
b'ilte	heard
anma	heart
anmi	heart
q´exa	heat
q´aq´il	heat
kya´j	heaven
al	heavy
yekil	hectic
twe'	height
etzb´il	heir
elq'in	heist
eleq	heist
txtokal	held
xtokal	held
xib'alb'a	hell
najan	hell
tenb'ilq'aq'	hell
Je´ky	Hello
tze´n tayey	hello dear
je´ky s´e´n taya	hello how are you
je'ky s'en taya	hello how are you doing
t-xk'omil wib'aj	helmet
onil	help
ajb´ebíl	helpful
ajb´alan	helpful
chi	helpful
tuntzen	hence
teya	her
k'loj rit	herd
tzalu´	here
n-ki o´n qe	heritage
xtz´mil	hesitate
Tze´n	Hey
Je´ky	Hi
je´ky s´e´n ta´ya	hi how are you
je´ky	Hi there
ewin	hidden
ewil	hide
ajb'ech	hierarchy
nimin twe	high
xtilil	highlight
b´etil	hike
bʼetil	hiking
q-tzeb´el	hilarious
witz	hill
a	him
tb'anel b'e	hint
twi'kuxb'aj	hip
xixb'aj	hip
xixb'aj	hips
tzyul	hire
teya	his
t-xilen	history
b´ujil	hit
ky´ixb´il	hit
jun rat	hobby
tzuyil	hold
tzuyb´il	hold
tzyul	hold
nyon	hold on
yol	hold on
xlaq´	hole
ojlal	holiday
jul	hollow
ja	home
aq'unab'il toj ja	homework
axix	honest
axix	honestly
T- al kab	Honey
ta´l kab´	Honey
nimxix chjonte	honor
tz'itk'uj	hood
xok	hook
yo'b'il	hook
t'ik´pul	hop
toj q´ij	hope
ch'in tb'anel tu'nju	hopefully
b'is	hopeless
tq´e´lil	horizontal
q'ajtzb'il	horn
taq'wix	horrible
xob'il	horror
kej	horse
tja q'anb'il	hospital
b'antulena	hospitality
xjal yolel toj chnab´	host
nya bʼaʼn	hostile
kyeq´	hot
ponix ja	hotel
kolq'ij	hour
kolq'ij	hours
ja	house
ja	household
se´n tzun	how
Tza´n	how
yajtzun ta	how about you
s´ent a´ya	how are you
se´n ta´ya	how are you doing
s´e´n ta´ya jalin	how are you doing today
s´e´n taya jalin	how are you today
s´e´n ta´ya	how do you do
s'e'n	how is
jte'qe	how many
jte	how much
jt´en	how much
niy pun	how much
kukxjo	how often
jte tanq´ib´la´	how old are you
sen sexa tq´ija	how was your day
s´e´n sok´iya´ te q´onik´in	how was your night
Noq tze´n taye	however
niky'aj	hub
qe ka´yil	hubby
tz´ulil	hug
nimin	huge
xjal	human
b´unlatten	humble
b´uninxjal	humble
xb´u´l	humid
xb´umb´uj	humidity
wayij	hungry
wa´yij	hungry
q´aq´in	hungry
kanb´at	hunt
nim jb'al	hurricane
qelxa	hurry
q´elxa	hurry up
q´lana	hurry up
ky´ixb´e	hurt
chmilb'aj	husband
n-chi rinen jotx	hustle
ja	hut
xnul	hygiene
Ayine	I
ayine	I am
b´an chjonte	I am fine
ja'ku	I can
ja'na	I can
ja'ka	I can
lay b´entwune	I can't
oky	I do
s´e´n lo	I do not know
mixti k´ane	I do not understand
lay´	I don't
s´e´n lo	I don't know
mixti	I don't understand
minti	I don't understand
jon	I don't understand
mixti in chin kaneye tiju toka qmalte	I don't understand what you mean
xi kane	I don't understand you
s´en lo	I don’t know
xti K'ane	I don’t understand
axlo	i guess
tenwe	I had
a tiwe´	I have
ntene	I have been
a tz´n yonjiye	I hope so
b´in	I know
kanli	I know
in chin laqe tija	I like
chi laqe tija	I like you
tk'ujlab'il	I love
chin laqe tij tziqe ni min	I love my big brother
chin laqe tij tziqe ni min	I love my big sister
chin laqe tij nmane	I love my father
chin laqe tij witzine	I love my little brother
chin laqe tij witzine	I love my little sister
tx´uye	I love my mother
in chin laqe tij naniye	I love my mother
In chin laqe tija	I love you
in chin laqe tija	I love you so much
ikxwe in chin laqe tija	I love you too
a kxel nmane	I mean
inchin bisine tija	I miss you
chin bisine nim tija	I miss you so much
txi k´ayine	I see
ximil	I think
chin ximine	I think
ma chin qaneye	I understand
ajb´il	I want
waje t´un tw´ila´	I want to see you
ky'iwb'il	I want you
ma chin tene	I was
k-txel b´inchane	I will
axna	I would be
ayine	I'm
b´an tiniye	I'm fine
b´an ti niye	I'm good
a tine tzala	I'm here
najsama	I'm sorry
txa'chew'	ice
leq'che'w	ice cream
xim	idea
tbʼanel onbʼil	ideal
ikxixju	identical
tun txi t-jyone	identify
techel	identity
mib´e b´isen	idiot
xi yuk´ch	idle
oky	if
mi txi t-kayen	ignore
yab´	ill
yab´il	ill
nya we'n	illegal
yab'	illness
Ilocano	Ilocano
tilb´ilal	image
ximb´aj	imagine
jalinxix	immediate
jalinxix	immediately
nintzk´u	immense
kuj te qe	impact
loch'il	impatient
tun tok	implement
iltij	import
iltij	important
chq'ol	impose
la'yx b'ent	impossible
tuʼn kyjaw labʼin	impress
t-xaq uʼj toj kʼuxbʼil	impression
qo ja ka´yen ti´j	impressive
b´antyil	improve
wen	improvement
tuj	in
Tu	in
axna	in addition
axpe ikx	In fact
twi'tz	in front of
el qe	in order to
nach	inappropriate
qmojbʼabʼil	incentive
nya bʼaʼn	incident
tun tokx	include
tukʼex	including
nya bʼaʼn	inconvenience
nimsal	increase
ma jaw	increased
mi n-xi q-ni´men	incredible
tuntzen	indeed
t-junalx	independent
India	India
q´maxa	indicate
wqnaqil	indigenous
jun	individual
tjunix	individual
poq´sal ti´chaq	industry
la b´ant t´el	inevitable
kwal qa	infant
tilal yab´il	infection
nimxix	infinity
tq'anil	inflammation
xhupin	inflation
yolelqe	influence
q'malte	inform
tqanil	information
t-k'ujil	ingredients
etzb'iñ	inheritance
el q´un xi qeya	initial
tnejil	initial
tun txi xke	initiative
ma q'ixb'i	injured
ky'ilxb'en	injury
mya at t-paj	innocent
ak'aj	innovation
jyoʼnktza	inquiry
tx´u´j	insane
q´kup	insect
mlay bʼant jun tiʼ	insecure
q´onxa	insert
toj	inside
umel tuʼn	insight
wexa	insist
txunwi´	insomnia
tz'ilte	inspiration
ambʼil te	inspire
q'ol	install
tqanin onbʼil	instance
jalinxix	instant
tuj - tx´ixpub´il	instead
te txel	instead of
qmal txolil	instructions
wakb'il	instrument
yasil	insult
b´a´ntten	insurance
jun wen xjal	integrity
mas bʼaʼn	intellectual
mas bʼaʼn	intelligence
b´an b´isen	intelligent
qanil	intend
jatumel	intended
n-lipen	intense
taj	intention
yolil	interact
yolil	interaction
tal pwaq	interest
ta´l pwaq	interest
tal pwaq	interested
qaj ti´j	interesting
xyol	interfere
niky'jen	intermediate
tojxi	internal
tukxa	internal
ti´jxix tnam	international
iky'il	internship
nelpuna	interpret
yaqpul	interrupt
xjelb´il	interview
tamiw.	intimate
toj	into
xuqan	introduce
xuq	introduce
tuk tel q-nik´	introduction
xjal mib´e yolen	introvert
n´al	intuition
jachmob´il	intuition
attoq jun tyabʼ toj	invalid
xkansil	invent
nab´il	invent
tel qpaʼn	invest
jyol	investigate
x´okb´il	invitation
txok´il	invite
u´j tun txi chjet	invoice
tun tokj	involve
tun tokxe toj	involved
k'uxb'il	iron
a ju	is
plowti'j	island
a'ti'j	island
tjunalx	isolated
b´i´yol	issue
q´oj	issues
a	it
a	it is
ma b'aj	it was
aju	it's
b´an	it's ok
b'a'n	It's okay
xnaqʼtzbʼil	item
tz´aqsb´il	items
teya	its
ayine	I’m
t´ij kamixj	jacket
chojb´il il	jail
tnexjaw	January
xar	jar
qtzi	jaw
xk´aqlin	jealous
ajxky´aqil	jealous
nya bʼaʼn xjal	jerk
pwaqab´aj	jewelry
a´qan	job
rinel	jogging
mojb'alte	join
txol b'a'q	joint
yaq	joke
chik´qanil	journalist
xob´lyol	journalist
b´etil	journey
b éyat	journey
tzalaj	joy
xjal q´malte	judge
ta'l	juice
twuxjaw	july
lipul	jump
tqaxjaw	june
tz'is	junk
noq	just
b´inchanxa	just do it
xtis	justice
xtulb'il-il	justice
teylixil	justice
ikyjo	justify
Kalaallisut	Kalaallisut
laqil	keen
kanq´ila	keep
nejk'uya	keep it up
jaku ten	kept
txikyb'il	kettle
tal ja´	key
xajol	kick
k´awl	kid
yaq´il	kidding
chjab'	kidney
k´wal	kids
bíyil	kill
tichaq'x	kind
ch'in netz'	kinda
b'a'nxix	kindly
b'a'nxix	kindness
nim tipumal	king
tz´ub´	kiss
ma´tz	kiss
b´inchb´il wab´j	kitchen
q'manxa'	kite
wix	kitten
ch´ekyb´aj	knee
ch´eky	knee
b'intaq	knew
q'esil	knife
ponix ichan	knight
ojtzqil	know
nab´il	knowledge
ojtzqib´il	knowledge
tzqi'n	known
Konkani	Konkani
Krio	Krio
tu´jal pa	label
aq´untl	labor
aq´qntz	labor
aq'anal	labour
chi´ixpatzan	lack
ch´inx	lack
ch´ix b´aj	lack
yotx	ladder
q'apoj	lady
kubʼ bʼinchaʼn	laid
najab´	lake
talnajab´	lake
alwun	lake
rit	lamb
q´ewjne	lame
kandil	lamp
tx´otx´	land
tbʼanel keʼyin	landscape
yol	language
twi tqan	lap
xqin	large
xji´l	large
qini´ch	large
b´ajsb´il	last
mankb´il	last
nya iltij	last but not least
tmakb´il jela	last but not least
k´olil	last name
yaj	late
kʼitzqeku	lately
nejxi	later
a ju tmakb'il	latest
tmakb'il	latter
tzet	laugh
tze´l	laugh
tz´el	laughing
tzet	laughter
tze´l	laughter
txi q-xo´n	launch
tx´ajb´l	laundry
q-ley	law
xpatzb´an	lawn
q'olte	lay
txow	layer
qajbʼil	layout
q´il	lazy
yek´il	lead
q´ol tumel	lead
nejinil	leader
a'witz	leaf
ma tz'ex	leak
nel	leak
k´ekuya	lean
xmejek´uya	lean
mok´ekaya	lean
t'ikpajil	leap
kanol	learn
xnaq´tzil	learn
xnaqtzb'il	learning
majil	lease
naq ch'in	least
tz´u´m	leather
tz´u´n	leather
le´b´il kolil	leave
t-xaqtze´	leaves
txaq tze	leaves
qʼiʼn tuʼn	led
nayaj	left
xnayj	left
kuxb'sj	leg
n-ki o´n qe	legacy
kywitz aj kawil	legal
tzqib'k'lojyol	legend
kyiʼj xuʼj	legit
amb'il	leisure
txol	lend
ch'exyol	lend
tnuq	length
tnuqil	length
naq´ch´in	less
chi´n	less
xnaqʼtzbʼil	lesson
chi nexe tk´tza	let
samu'j	letter
q-lechuga	lettuce
chik'ob'ilja	level
txi q-aprovecharen	leverage
matoklen	liability
maju´jb´il	library
leq´il	lick
leq´al	lick
chal yol	lie
chajyol	lies
chwiqlal	life
q'inktza	lift
xtilin	light
xtilin	lightning
nwane	like
jakulo bʼan	likely
ax ikx	likewise
sqit	line
Lingala	Lingala
enlace	link
q'eq ti'witzb'aj	lion
t´al	liquid
b´in	listen
b´il	listening
ikjxexje	literally
u´j	literature
tz'is	litter
b´otz´	little
chwinqlal	live
saseb´	liver
chwiqlal	lives
chwiqlala	living
jaa	living room
ayin	lizard
a'yin	lizard
Iqatz	load
twamo´s	loaf
xb´ukwa	loaf
tx´i´l	loaf
tx´ex	loan
ch´exb´aj	loan
ch´ex	loan
tembʼil	local
jatumel	location
jpul	lock
jpun	lock
oʼkx tiʼj jun	lockdown
qtzʼibʼinkux tqanil	log
tzeb´el	lol
tjunix	lonely
xji'l	long
xqin	long
qini'ch	long
tzma xq´iltla	long time no see
kayil	look
bucle	loop
jaw	loose
tza'qil	loose
tza'q	loose
iichin	lord
tz´aqil	lose
ma qe tz'aq'	loss
ma tzaj	lost
xol	lost
nintz´	lot
nim twe'	loud
matij twe'	loud
nimtwe'	loud
nim ja	lounge
laq´jil	love
in chin laqe tija	love you
qaj ti´j	lovely
ch'in	low
chi'n ta'l	lower
jun xjal leal	loyal
qʼuqbʼil kykʼuʼj.	loyalty
tb'anel tunju	luck
b´a´namaj	lucky
Luganda	Luganda
tiq´ina	luggage
tanaj	lump
iqtz	lump
w'al	lunch
tbʼanel	luxury
mib´e yolen tuk´e twutx	lying
kxb'il	machine
tzkaj	mad
tx´u´jwi´	mad
qtxu	madam
b'a'nmaj	made
chik´xim	magazine
b'anxex	magnificent
xjal misol tz´is	maid
winaq	main
k'ayilte	maintain
kayb´etz	maintenance
Maithili	Maithili
winaq	major
chʼixmi tkyaqil	majority
b´inchal	make
tok te	make up
tman	male
nimin k´ax	mall
toj qyol	Mam
ichin	man
chan	man
akja´yil xnaq´tzb´il	manage
b´inchel	management
xjal yekel jotx	manager
aq´un	mandatory
q'amanxe	manifest
chq'ol	manipulate
tumel	manner
uʼj	manual
nim	many
toxjaw	march
margen	margin
k'ayb'il	market
mjeb'in	marriage
mejeb´li	married
potzb'il wutz	mask
q´otj	mass
txqan	massive
xnaq´atzon	master
nejenel aq´untl	master
xnaq´tzal	master
saqchal	match
tuk´il	mate
aq´unb´il	material
ajlab´ilxix	math
Iltij	matter
ma q´qnix	maturity
kb´entil tuna	may
qapa	maybe
qaj	maybe
weye	me
ikyx we	me too
wab´aj	meal
tzelpuna	mean
ti tz´elpuna	meaning
ti tz'elpuna	means
a taq´ xi tman	meant
extzen	meanwhile
mlol	measure
malil	measure
échat	measure
malb´il	measures
chib´j	meat
q´anil	medical
q'anb'il	medicine
b'isil	meditation
xol	medium
chmolte	meet
ch´uqil	meet
mujb´el xjal	meeting
Meiteilon	Meiteilon
yulj	melt
niwjsal	melt
n´al	memories
nab´b´il	memory
txubʼtxaj	mental
q´malte	mention
q´manxa	mention
ma tzaj q'man	mentioned
xnaqʼtzbʼil	mentor
k´ayil	merchant
uʼn tjapun	mercy
tuʼntzunju	merely
mya b´a´n taye	mess
q-yol	message
nya txolb´i´n	messy
xitli	messy
sputin	messy
kxb'il	metal
txilnen	method
ich'	mice
niky´aj	middle
niky´jin	middle
tkuj aq´b´il	midnight
ku tz´u lo	might
cheb´e	mild
amb'il	milestone
txa'x xjal	military
ta'l imaj	milk
millon	million
nab´l	mind
b'is	mindset
weye´	mine
smol	mingle
b´otz	minor
minut	minute
minut	minutes
bʼaʼn kyuʼn	miracle
ka´witz	mirror
xpejs	mirror
kayb´iwitzb´aj	mirror
k'loj	miscellaneous
tiptaj	mischievous
mya b´an t-chwinqel	miserable
mebʼayil	misery
b´isil	miss
chin bisine tija	miss you
ma qe tzaq´	missing
tiʼ in bʼant kyuʼn	mission
q'aqmujil	mist
q-paj	mistake
Mizo	Mizo
celular	mobile
xniky´b´il	mock
knol	mock
yekʼbʼil tiʼj	model
kawil	moderate
ja'lin	modern
me's	modest
Ak´l	moist
ob´ob´j	moist
xb´umb´uj	moisture
poj	mold
q´eq´al	mole
nan	mom
amb'il	moment
xjaw	monday
pwaq	money
max	monkey
xjaw	month
ipumalj teya	mood
lo'chil	moody
txu xjaw	moon
b'is	moral
q´otzl	more
ikx tz´unj	moreover
ch´ubil	morning
nchi´j	morning
najchi´j	morning
k'as	mortgage
nintz'	most
te tnejil	mostly
txub'l	mother
txub'aj	mother
yukchil	motion
sak'sil	motivation
pink'ul	mountain
chik'ul	mountain
k'ul	mountain
ich´	mouse
tzib'aj	mouth
yukchuil	move
yekil	move
yekil	movement
txumakb'	movie
xu'j	mrs
nim	much
xoq'l	mud
jar	mug
ch´ib´aj	muscle
xul	mushroom
tx´yol	mushroom
xwich´	mushroom
chnab´	music
twi´chnab´	music
b'inchanxa	must
q'ol nakb'il	mute
ikxje te junjen	mutual
weye	my
a ju quk'ila xb'oj	my friend
a waje	my love
awe nb´i	my name is
ayiin	myself
chal yol	mysterious
nik´al yol	mysterious
ewan	mystery
noqxyol	myth
xky´aqb´aj te´sb´il	nail
xnak	naive
b´ib´aj	name
tx´olb´il	narrative
jutz´	narrow
twitz	narrow
much´	narrow
juntij tzu´j	nasty
tnam	national
tanmiyil	nationality
te jaxex	native
ttenkuxjo	natural
qtxu' tx'otx'	nature
twitz tx'otx'	nature
xab'	nausea
naqa	near
naqayin	near
naqa´yin	near
naq'ak'u	nearby
junilni	nearly
tb´anel	neat
iltij	necessary
qul	neck
q´ub´aj	neck
uyj	necklace
qaj	need
ch'u'xil	negative
ewin	negative
xi xik'ayin	neglect
k'ayil	negotiate
xjal ajlaj	neighbor
kojb'il	neighborhood
mi´ne	neither
witzine	nephew
mas bʼaʼn	nerd
xob´ajil	nervous
tchwil	nervous
paqb'il	nest
q'u'	nest
saq	net
xyub´	network
pa	network
junx	neutral
layx	never
mixi qe tzaqpina	never give up
xlek'uj	never mind
nya´ iltij	nevermind
extzen	nevertheless
ak´aj	new
ab'ax	news
juntl	next
junx tuk´il	next to
Tb´anil	nice
tzen tayey	nice to meet you
witz´ine	niece
qoniky'an	night
aq'b'il	night
xob'sil qwatl	nightmare
b'elaj	nine
b´elajlaj	nineteen
kyjk´al laj	ninety
Lay	No
mi´ b´isen	no problem
xix jun tumil	no way
mixti	nobody
chkyimb´il	noise
chkyimb´il	noisy
ni junjun	none
wanq'ij	noon
chilka qij	noon
chilqij	noon
mixti	nope
minti tla	nope
ikja	normal
jawnix	north
txa´nb´aj	nose
b'is	nostalgic
lay	not
minti	not
tla	not
xite'	not at all
b´ante	not bad
lay jalin	Not now
namx	not yet
twi chnab´	note
ma kux tz'ib'it	noted
xtix	nothing
kayil	notice
ma tzok tayina	noticed
kyaqil b´ib´aj	noun
jiq´chal	noun
kyaqil b´ib´aj	nouns
jiq´chal	nouns
saq	novel
tjunlaxkaw	november
jalin	now
ja lin te q´ij jalin	nowadays
snak	nuisance
mya wen	null
sk´an	numb
tajlal	number
onil ajq'anil	nurse
jumil	nut
sutjitz´	nut
ch'ilil	nutmeg
k'ach'il	nutrition
jun yol toj tbʼi dios	oath
xtob´	obesity
xb´o´w	obesity
nimb´il	obey
nimal	obey
sipb´al	object
tkb´antel	objective
txi b´inchet	obligation
q´lolj	obscure
k'ayil	observation
k´ayilte	observe
taj ti´j wen	obsessed
obsesion	obsession
asb'en	obsolete
tun t-jyet	obtain
kykʼamoʼn	obtained
iktzen	obvious
iktzen	obviously
mya jotx q´ij	occasionally
mi´ amli	occupation
nya ambli	occupied
na b'aj	occur
ma b'aj	occurred
in b´aj	occurs
kub'ni plow	ocean
jawni plow	ocean
tlaxjaw	october
alkayela	odd
nya mikxe	odds
te	of
iktzen	of course
yupil	off
yupan	off
yupin	off
nach	offensive
q-loq´ barat	offer
ja jatumel	office
aju axix	official
junjen maj	often
tib´aj	Oh
ax	oh really
aseyt	oil
b´anatz´un	ok
b´a´antz´un	ok dear
kutzin k'ujlab'il	ok honey
kutzen	ok my love
b´anatz´un	okay
b´ana tzun nex	okay baby
kutzen	okay dear
kutzen	okay honey
kutzen	okay my love
ojtxi	old
xjoq´	old
toj	on
ju maj	once
jun	one
qa nim yol b´an	one language is never enough
sb'oy	onion
xnakite	onion
kub'ku	online
t-junilx	only
jiq´ijil	only
jaql	open
jqle	open
jqo´n k´ab´li	open
operacion	operation
t-b´isel tib´aje lo	opinion
anb'il	opportunities
anb´il	opportunity
tmaqb´il	opposite
tbʼanel	optimistic
toj tumel	option
onbʼil lu	optional
moqa	or
lanch	orange
txolb´il	order
chi ma ik'x	ordinary
chemb'l	organization
qmal nab'il	orientation
tlok´	origin
axixju	original
Oromo	Oromo
meb´a	orphan
yaj	orphan
b´eyb´il	orphan
juntl	other
me mya lo	otherwise
jaku tzʼoknin	ought
qe	our
qeya	our
qe´y	our
aju q'xime: te q´kaq´il tun tok ojtzq´et twitz tx´otx´ex tun txi qmet toj alux yol	Our mission: to enable everyone, everywhere to understand the world and express themselves across languages.
aju q'xime: tun txi q'mete toj nuk'un te tnam ex t'un ko'k te ajb'en	Our mission: to organize the world's information and make it universally accessible and useful.
ex	out
exil	out
tuʼntzunju	outcome
ijb'aj	outfit
ma tz'el	outgoing
tzexa tzala	outlet
q´amalte	outline
pen	outside
jawil	outstanding
tx'aql	outstanding
tx'aqle	outstanding
jorn	oven
wosb´il	oven
tz´i´lsb´i´l	oven
tibaj	over
chixa	over there
tzachi´n	over there
chix	over there
k´aq´il	overall
tikʼx	overcome
b'isil	overthinking
n-qo ja ka´yen ti´j	overwhelmed
tq'optz'an	overwhelming
k'as	owe
tukru	owl
weye	own
tajwil	owner
tman wakx	ox
tiky'xil xjal	pace
n-a	pack
b'otz'	package
choj	paid
chojb´il	paid
k´ixk´o´j	pain
uk´sil	paint
tk'wa'	painting
kab'	pair
smuq´in	pale
xa'j	palm
pan	pan
pandemia	pandemic
xob'jil	panic
wexj	pants
uj	paper
tbʼanel najbʼil	paradise
mujtten	parallel
nim awal	parcel
ko'pil	pardon
mamb'aj	parents
manb'aj	parents
park	park
tnuq	parrot
tnuqil	parrot
rejil	parsley
q´esin	part
yek´il	participate
ikxje	particular
particularmente	particularly
quk´e	partner
nimq´ij	party
ninq´ij	party
iky´tz	pass
iky´	pass
iky'	passage
ma tz´ik	passed
qa tun t-b´ant	passion
txqan	passionate
tuq'li	passive
tal ja	password
ma k´ej	past
xb´uqb´il	patch
b'e	path
mya wen ka´yen	pathetic
noqx samel	patience
yab´	patient
nejinil	pattern
yoma	pause
ttxa´nklab´	pavement
choj	pay
chojb´il	pay
chjol	payment
nak´i´l	peace
numb´il	peace
txub´txaj	peace
mintiʼ in che qʼojin	peaceful
trasni	peach
trasin	peach
taxan	peach
tuk´b´il	peak
twi´ittzi	peak
tz´i	peak
jaxab lob'aj	pear
chenaq'	peas
aju in bʼant kyuʼn	peculiar
tz´a´lil	pee
txk´omil	peel
tuk´il	peer
t-xb'oj	peers
tz´ib´ab´il	pen
sb'qtz'ib'b'il	pencil
na´m	pending
xjal	people
pimient	pepper
ximil	perceive
tzen n-xi q-kayen	perception
b´a´n	perfect
b´inchalte	perform
yek´el	performance
qapa	perhaps
qaj	perhaps
amb´el	period
n-kij	permanent
permis	permission
amb´il	permit
tbʼanel techel	perseverance
te jumajx	persistent
xjal	person
aq´anal	personal
xjalil	personality
kayet	perspective
b´inchel tun ky-ni´men	persuade
nach	pervert
alu'maj	pet
amb'al	phase
txunab'il	philosophy
yolb´il	phone
tilb'ilal	photo
yoxchi'	phrase
xmilal	physical
sik´olte	pick
tzakj	pick
tun t-yet	pick up
tilb´ilal	picture
taqiky´	piece
tmojchaq´	pieces
b´och	pig
xkawaste´	pigeon
xu´ch	pigeon
k´loj	pile
job´an	pile
q´axweyj	pillow
yekil	pilot
choqol	pilot
b'aq	pin
matzjti'j	pineapple
b'ech	pink
jul	pit
matz'k'	pitch
q´obaj	pity
tenb´il	place
k'ayb'il	places
kʼixbʼisabʼil	plague
twutz tx´otx´	plain
nuk´il	plan
k´xlip	plane
k´ul	plant
k´ul	plants
techil totx´	plate
saqchal	play
saqchal	playing
k´ok´j	pleasant
bichanxa Xtalbil	please
k´uw	pleased
k´okj	pleasure
tuʼn tbʼant jlu kyu	pledge
nimxix	plenty
anq'ib'il	plot
xikyb´txaqb´il	plug
chky'anan	plum
b'inchil tub'	plumber
nimsal	plural
nchi yolin	podcast
pakab´	poem
pakab´	poetry
t´ak	point
venen	poison
xq'uqil	police
kawil	policy
ponex xjal	polite
yajel tx´otx´	pollution
matij pil	pond
piscina	pool
txa'	poop
meb´a	poor
yaj	poor
laq'in	pop
jotx wutzqilte	popular
tnam	population
b´och	pork
sqal	porridge
tziplow	port
tzen tayey	position
qo b´isen b´a´n	positive
etzil	possess
etzal	possession
lak'in	possessive
iktzen	possible
chik´b´a´n	post
toj jumajtil	postpone
sq´al	potato
tipumal	potential
ka'yla'j	pound
yaj	poverty
b´eyb´il	poverty
tipumal	power
kumil	powerful
nya kwest	practical
b´inchal	practice
jun yol b´an ti´je	praise
yaq	prank
naʼn dios	pray
b´anil	precious
ikja	precise
ikyjo	precisely
q'mal	predict
qa tajb'ila	prefer
nya b´an	pregnant
ch´onwi´	pregnant
xmayil	prejudice
ja jatumel	premises
tb'anel	premium
b'inchet	preparation
b'inchalte	prepare
b´inchan	prepared
ktel	presence
jalin	present
yekbʼil	presentation
k´ulte	preserve
nejenel	president
yiq´ob´il	press
b´etz´b´il	press
tipomal	pressure
taj tun tok	pretend
tb´anil	pretty
ka´ayil ti´j	prevent
nejtil	previous
tzyu'n	prey
twi	price
nimaltib'	pride
ajb'ech	priest
txexnaq´tz	primary
winaq	prime
winaq	principal
nam taq	prior
iltij	priority
jpub´il	prison
okx qe tajwil	privacy
te tajwi	private
tbʼanel ambʼil	privilege
chojb´al	prize
kotzalalb´il	prize
kab´ale	probably
q´oj	problem
ja ma tzaje	procedure
kxel b´inchet	proceed
qe tqiky´	process
b´nchalte	produce
k´ax	product
b'ichal yekil	production
in che aqʼunan	profession
ajb´inch	professional
aju´j	professional
plaj	profile
kanb´ab´il	profit
txe'	profound
ch'iysb'il	progress
aqʼuntl	project
q´anchal	prominent
kxel q-b´inchen	promise
n-jax	promote
k'loj	promotion
junratx	prompt
nya kwest tu'n	prone
xelb´ib´aj	pronouns
txelb´ib´aj	pronouns
qʼamanxa qe yol klarxix	pronunciation
niky'b'eb'il	proof
b´a´n	proper
qe	properly
tajwil	properties
iltij	property
txi yek´et	proposal
tzalaj	prosperity
qʼinin	prosperous
k´ayil	protect
tjonk´u´	proud
yek´b´il	prove
q'olte	provide
ma tzajtq'on	provided
kojb'il	province
amli´	provision
kuʼxin	puberty
qexjal	public
te kyaqilx	public
xo´l	pull
mukin	pumpkin
toj amb'il	punctual
xnaq´tzanjtz	pupil
loq´aj	purchase
sjanen	pure
Tikb´antel	purpose
tb´el pwaq	purse
joyil	pursue
jyol	pursue
joyil	pursuit
jyol	pursuit
lamo´n	push
jpu´n	push
qolte	put
tajlal xnaq'tz	qualification
t-kayb´ajtz	quality
tqan	quantity
qokx jpet	quarantine
b'uj	quarrel
te kyaje	quarter
quechua	Quechua
ti tzun la	queer
jyonkuxa	query
xjel	question
tje	queue
q´ela	quick
q´exa	quick
ojq´ela	quick
ojqel ch´intl	quickly
ojqel	quickly
chu´chil	quiet
watb'il	quilt
leb´il	quit
nim	quite
yek´il	quiz
b'il twi'	quotation
b´il twi´	quote
b´il twi´ kax	quotes
xiky	rabbit
rinel	race
ttx'u'jil	rage
xb'al	rain
matijset	raise
ma jaw twi'	raised
ma rinin	ran
noq ja	random
jaxex	range
jalinxix	rapid
oxqelx	rapidly
alkelaya	rare
bisil	rare
mya jotx maj	rarely
aq'unal	rash
ich´	rat
t-wi´	rate
te txel	rather
tiʼ toklen	ratio
mas b'an	rational
cha'x	raw
re	re
kanol	reach
xikan	reach
se´l	reach
ma k´ub´tij	reached
tmod	reaction
aj-u´j	read
ujil	reading
ma qo b´ant	ready
twutx	real
ikja	reality
kayinxa	realize
ma ti la	realized
iktzen	really
xo´pj	rear
xo´pb´aj	rear
txolil	reason
ximil	reasonable
nalte	recall
ma tz´okx	receipt
k´amol	receive
ma tzok k´amona	received
etzqeku	recent
tzma x-b´aj	recently
ttziʼ	reception
tu´jal	recipe
q´anb´il	recipe
nti txob´el	reckless
toklen	recognition
niky'tzil	recognize
o´qxenil	recommend
oq´xenil	recommended
ni juntl o japen ti´j	record
tten juntl maj	recover
ma tz'ajtz	recovery
xqin	rectangle
xqinswej	rectangle
k'eq	red
tx'exb'il	redeem
kyanmi	redemption
much´jsal	reduce
nuchsal	reduce
axjo	redundant
tun txi q-sma´n	refer
b´ilte ti´j	reference
yekʼbʼil	reflect
ximil	reflection
yoma	refrain
cheysb´il	refrigerator
q'ol tx'el	refund
ik'il	refuse
ma tzel ik´in	refused
ti´j	regard
el q´ib´aj	regarding
extzen ikje	regardless
q´olb´el	regards
in tzaj kyqʼamaʼn uʼj	register
tzul toj tk´uja	regret
b'a'nx b'a'n ch'in	regular
kukxjo	regularly
ik´il	reject
kyqʼamaʼn	relate
tok ti´j	related
tuk´e	relationship
relativo	relative
witzel	relatives
qo lajen	relax
tzaqpil	release
tz´loja´	release
me tzel k'opin	released
iltij	relevant
q´uqb´il k´u´j	reliable
b'a'nnixix	relief
q´amalte	relieve
q'anin	relieved
okslab´l	religion
okslal	religious
jun lu´n reacio	reluctant
q´uqk´u´jil	rely
axtz'u tenkuya	remain
ch'intl	remaining
q'anchal	remarkable
ti'chaq	remedy
k´u´jlal	remember
n´al	remind
nalte	reminder
n-qo manejaren ti´j naqche	remote
yekil	remove
yukchil	remove
majil	render
majnal	render
majil	rent
saqsan	repair
kyq´amantza	repeat
kyxnik´b´entza	repeat
txel	replace
tz'aq' wel	reply
n-tza t-q´man	report
xel	represent
q-b´ijte	reputation
q'anilte	request
wajb´le	require
q'anilte	required
iltij	required
klet	rescue
qe ajxpich'il	research
chi ma ikx	resemble
q'oj	resentment
ab'tzil	reserve
te tzalu'n	resident
il tiʼj tuʼn tkyaj ttzaqpiʼn	resign
tjaw weʼ t-xima	resilience
tipumala	resilient
nik'x	resist
ntipa	resistance
tzen kxel b´inchet	resolution
t-xi kybʼinchaʼn	resolve
tb'anel ja	resort
nim at te	resources
nimb´il	respect
tzaq´wel	respond
tz'aq'wel	response
tzaq'wel	response
matoklen	responsibility
xjal b´an b´isen tun t-b´an tu´n	responsible
ojlal	rest
chab´a tz´ojlan	rest in peace
nimwab´il	restaurant
k'awil wab'j	restore
mi tun toktz	restrict
t-pak´b´al	result
tuʼntzunju	results
taltqanil	resume
jun netz´ k´ayel	retail
tzyuma	retain
wab´il	retention
wa´lb´il	retention
retiro	retreat
tten juntl maj	retrieve
meltz'il	return
q'malte	reveal
ma txi tnam	revealed
t-xel	revenge
k'anb'abil	revenue
tijxi	reverse
k´ayilte	review
k'ayilte	revise
k'ayilte	revision
chʼixpubʼil	revolution
chojb´al	reward
kotzalalb´il	reward
ajqelil mo cheb'a	rhythm
xuk´b´aj	rib
tchil	rib
xu´k´b´aj	rib
saqji'l	rice
saqtriy	rice
q´inon	rich
tzaqpil	rid
wa'b'il	ride
q-tzeb´el	ridiculous
b´an	right
jalin	right now
kuj	rigid
xmilq´ab´aj	ring
xmilq´ob´j	ring
numsil	rinse
wulil	riot
laqin	rip
q´an	ripe
jax toj kya´j	rise
nya bʼaʼn	risk
ajq´oj	rival
a´	river
b´e	road
tx'ilin	roast
ma'	robust
ab'aj	rock
tze	rod
role	role
tolu'j	roll
yek´b´itz	roof
toj ja	room
tloq'	root
txe'	root
ech	rope
q´anaq	rotten
q´aynay	rotten
xnak´	rough
ma'xpa	roughly
t´ol	round
b'e	route
axju b'inchet	routine
txol.	row
tok´tz tib´aj	rub
xqechb´il	rubber
tz´is	rubbish
kuj	rude
b´etb´il	rug
jikyb'il	rule
jikyb´il	ruler
tal kawb'il	rules
qelaj	run
rinil	run
qelan	run
qelaj	running
rinil	running
qelan	running
toj aldea	rural
ch'akajlab'il	rush
ch'u'x	sack
ch'x	sack
xjan	sacred
tun txi oyet	sacrifice
axix	safe
q'uqil tk'uj	safe flight
xq'u'q'il	safety
qawaj	sage
ma tma	said
aja'yil	sail
aja´yil	sailing
b´an	sake
twi´ k´u´j	salary
k'axjil	sale
k'a'x	sale
kix	salmon
atz´in. atz´an	salt
ajxu	same
ikx tzalan	Same here
yekb'il	sample
tz´awin q´uq´	sand
Sanskrit	Sanskrit
yolb'il	sarcastic
atrevido	sassy
ma kuqe	sat
ttzalaja	satisfaction
ma noj	satisfied
k'ok'j	satisfy
qeb´ni tk´u´j	satisfying
qaq´ij	Saturday
te ch´um	savage
k'u'lte	save
k'u'l	save
ma til	saw
chitzan	say
q´amal	say
chi	say
t-we´	scale
ma k´u alq´an	scam
tiky'len	scar
ch´in	scarce
xob'il	scared
sik´pul	scared
potzb'il q'qul	scarf
xob´el	scary
chitil	scattered
txokbʼil	scene
chʼixpubʼil	scenery
k´okj	scent
amb´el	schedule
tja xnaq'tzb'l	school
xnaq´tzb´il kyten xjal	science
ajnab'xix	scientist
sjnab´xix	scientists
ch'ers	scissors
ilil	scold
wulil	scold
tpon kanin	scope
taq'b'il	score
tz'is	scrap
skyet xkatil	scratch
sch'il	scream
tilb'ilalb'il	screen
klawo	screw
wa´b´il	script
plow	sea
tipun	seal
otx´	seal
joyb´aj	search
xkotzb'il	season
q'ajtz	seat
tkab'	second
jask'ul	secret
k'loj	section
axix	secure
xq´uq´il	security
kayil	see
qa q'ib'	see you
qa wila nej	see you later
qa wila nej	see you soon
qa wila nejchij	see you tomorrow
ijaj	seed
jyol	seek
chi ma ikx	seem
chi ma ikx	seems
ma ku k'ayin	seen
k'wal	seize
k'al	seize
junjin maj	seldom
jk'ol	select
xilen	self
a	self
kykʼujlabʼil	self healing
xk'a	selfish
k'ayilte	sell
k'ayil	sell
q´olte	send
q´ontza jun tilb´ilala	send me your picture
qman	senior
tat	senior
bab'il	sense
tzeb'il	sense
kub' tna'n	sensible
nxi q-sentiren	sensitive
ma xtx´i	sent
txolyol	sentence
n'ajl dios	sentences
pa'n	separate
pa'in maj	separate
Sepedi	Sepedi
tb´exjaw	september
q-kayb´el	series
axix	serious
twitzxix	seriously
ajb´el	serve
ajb´el	service
amb'il	session
tkub´	set
tx´uk´	setting
qeyb´etz	settle
wuq	seven
wuqlaj	seventeen
oxk´al laj	seventy
txqan	several
kuj	severe
tzol	sew
slepil	sew
lek´in	shade
tewin	shadow
qusb'il	shake
chtol	shake
ma txi ya atz	shall
b'otz txe	shallow
ch´ixb´il	shame
tx´ixwa	shame
tx´ixaw	shame
tten. txolb´al	shape
nak´ul	shape
tz'an tten	shape
oyil	share
etzat ti´yax	share
kchil	sharp
a	she
a ti te	she has
a	she is
kyja chej	shed
rit	sheep
tx´an uj	sheet
yek´b´il k´axjel	shelf
i'jb'aj	shell
pa´til	shelter
ewil	shelter
kolb´aj	shelter
txo'w	shield
tokex	shift
qopil	shine
nim tib´aja´	ship
q´ol	shipping
kamixay	shirt
xjab´	shoes
xol q'aq'	shoot
k´ayil	shop
loq'il	shopping
mlaj	shore
xtok´	short
xkut	short
chin	shortage
sqach tzaq´	shot
tu´ntle	should
semu´l	shoulder
semiil	shoulder
xch'il	shout
yek´il	show
yek´al	show
yekintza	show me
txi su´l ti´b´	shower
txo´m	shrimp
k'oli	shrink
jpulte	shut
jpul	shut
numek´uya	shut up
tx´ixb´el	shy
itzikyb´aj	sibling
Atzikyb´aj	sibling
xib´an	siblings
wanab´e	siblings
anb´aj	siblings
yab´	sick
txlaj	side
b'sil	sigh
jiq'chil	sigh
kayb'il	sight
pasialil	sightseeing
b'til	sightseeing
sqitil	sign
sqitil	signature
tilel	significant
nakb´il	silence
nakb'l	silent
xur	silent
chub'	silk
xnak´	silly
t'ab'	silver
ch'i ma ik'x	similar
xnak	simp
noq	simple
ax ikx	simultaneously
axix toj	since
axix	sincere
axix	sincerely
b'itzil	sing
b´itzil	singer
n-junale	single
tkub´il a´	sink
qman	Sir
tat	Sir
anab´	sister
b´alak	sister in law
b´aluk	sister in law
q´ek´uya	sit
q´uqli	sit
k'a'yb'il	site
tzen tayey	situation
qaq	six
qaqlaj	sixteen
oxk´al	sixty
jni twe'	size
junpaqx	skill
junpaqx	skills
chib'jil	skin
slak´	skinny
slenk	skinny
t´ikypajil	skip
t´ikypaj	skip
mutz´amaj	skirt
kya´j	sky
yajin xjal	slave
tal	sleep
wtal	sleep
ktal	sleep
tal	sleeping
wtal	sleeping
ktal	sleeping
yolok´ watle	sleepy
tq'ob	sleeve
nik'jen	slice
q´itil	slide
cheb´e taj	slightly
slik'	slim
slak'	slim
ma ja q'itj	slip
tzaqʼwet	slope
jul	slot
chab´a	slow
chab´a	slowly
mux. nuch	small
b´o´s	small
q´tik´	smart
siqil	smell
tz´e´l	smile
sich´il	smoke
chab´a	smooth
tchi'	snack
xjul	snail
xleky	snail
kan	snake
pa'l	snap
ch'ew	snow
Yajtzutz	so
tb´anil	so cute
chaq´	so far
aktzan	soak
q´eq	soap
mya k'walq'e'n	sober
xpo'tzil	soccer
ch'uqxjal	social
ja otoye	society
ma'l	socks
chab'a	soft
tu'nxtib'	soft
tajq´xjab´	soil
k´ayin	sold
siktenil	sold out
mixitl	sold out
pint	soldier
o´kx	sole
xpint	solid
ajq´oj	solid
n-xi q-b´inchen tun t-b´ant jun lu´n	solution
jyol tumel	solve
junjun	some
jun qe la	somebody
ikyjo	somehow
a tix juntl	someone
jun lu´n	something
atmaj	sometimes
wechaq	sometimes
b´itz	song
chinxtil	soon
b´an yeken tib´	sophisticated
Sorani	Sorani
n-cho´n	sore
chun	sore throat
ky´ixk´aj q´ulle	sore throat
chunaq. chumb´aj	sore throat
b'isb'il	sorrow
najsama	Sorry
nik'ul	sort
joyb´aj	sought
injyojtz´	sought
anmi	soul
xjal ikxje tzenku awe	soulmate
siqmal	sound
tx'am	sour
kuj	source
kyiw	source
kaw	source
tajatz ta´w	south
temb´il	space
jun correo mya wen	spam
tipaj	span
kyol mos	Spanish
ma qe ch´in	spare
yolil	speak
Tb´anil	special
tk'ujil	species
wiq	species
axexje	specific
ka´yb´itz	spectacular
kib´itz	spectacular
yek´b´il	spectacular
yolina	speech
mixti nyolin	speechless
ti nyolin	speechless
tzʼok tilil	speed
q´mal	spell
nojsal	spend
najsal	spend
ma ku b'aj	spent
yab´	spicy
le'ch	spike
sutil	spin
sutlal	spin
xewb'aj xjan	spirit
tzub´il	spit
tb'anel	splendid
palte	split
chajilte	spoil
nq´ayj	spoiled
talpak´	spoon
t'ak	spot
xu'jilb'aj	spouse
xu'jlal	spouse
loqj	spread
b´echq´ijil	spring
swe'j	square
kyajb'utx'	square
sikte	squeeze
cheb´e	squid
ku'k	squirrel
klab´	st
pejk'il	stab
tbʼanel	stable
tkub´il a´	stack
xjal aq'anal	staff
yek'b'il	stage
b'etel	stain
yotx	stairs
yek´il	stake
lol	stalk
tu´n	stall
te	stall
wa´l	stand
junil	standard
che´w	star
qe'l	start
ajet	start
qetsal	start
ma txi q´e	started
ma k'im tun q'aq''in	starving
nimtam	state
q´mal	statement
xkotzb'il	station
ib´ilal	statue
tzen taye	status
junx tenkuya	stay
q'uqil tk'uj	stay safe
toj tbʼanel	steady
chi'b'j k'asin	steak
alq´amaj	steal
alq´al	steal
elq´an	steal
xb´akix	steam
k'uxb'il	steel
toj tzaj	steep
itz'jil	stem
iky´tz	step
mijajech	stick
kyaqluk'k'aj	stiff
loqey	still
ch'i'o'n	sting
xk´a	stingy
smol	stir
i´tz´	stock
chwiqlal	stock
alq'amaj	stolen
elq'an	stolen
alq'a'n	stolen
tz'on	stomach
k'u'b'aj	stomach
abj	stone
tenb'il	stood
txa´	stool
wab´il	stop
tzuy	stop
k'ulte	storage
kulte	store
nimxix jb'al	storm
aju tqʼama	story
k'achb'il q'aq'	stove
txuk	straight
txulin	straight
tz´inintij	straightforward
jun cepa	strain
alkayela	strange
chin bisine	stranger
tumel	strategy
ch´um	straw
ch´in	straw
xwis	strawberry
sq'it	streak
taq'il xqoptzaj	stream
klab´	street
ajmaq	strength
sik´ten	stress
q´inil	stretch
jun xjal b´an kayen tij amb´el wen	strict
qo ku we´	strike
xpotx´in	string
xonxa	strip
jya'tz	strive
n-tza lipen	stroke
kuj	strong
kyiw	strong
kaw	strong
k'ixb'	struck
tzen kxel b´inchen	structure
q´onka tilil	struggle
jya'tz	struggling
mib´in	stubborn
maqe q´et	stuck
xnaq´tzanjtz	student
u´jil	study
u'jilil	studying
lu´n	stuff
qo ja ka´yenx ti´j	stunning
xnak	stupid
xkonk	stupid
qejil	stupid
tq'anb'ech	style
qman	subject
xjal	subject
txu	subject
q´ol	submission
chq´ol	submit
aju	substance
xelb'aj	substitute
cheb´e	subtle
t-xi tqʼoʼna tbʼanel	succeed
tel b´aj	success
ma b´ant	successful
ikje	such
s'en xju	such as
tz´ub´il	suck
inan	sudden
qaxku	suddenly
mixininj	suddenly
ma k´uch´aj	suffer
yajiltib'il	suffering
okxju	sufficient
ch´iysb´il	sugar
jun q-yol	suggest
jun nab´il yol	suggestion
xb´alamb´alil	suit
t-b´an t-b´inchet	suitable
iq´ijtz	suitcase
talqan	summary
q´ijal	summer
witz	summit
q´j	sun
Domindo	sunday
q'ij	sunny
q'ale	sunset
q'ij	sunshine
nim	super
tibʼaj	superior
nejenel	supervisor
w´al	supper
tun tok	supply
mojel	support
nchiye	suppose
kubʼ kyximen	supposed
ax	sure
tib´aj	surface
chʼiy	surge
jqol xjal	surgery
k'olil	surname
kyimen	surprised
xi tqʼoʼn tibʼ	surrender
wa'b'il	surrounding
xq´uqal	surveillance
kayel qi´j	survey
xa´wan	survive
okslal	suspect
kawil	suspended
k´uj a	suspicious
tz'yul	sustain
tzi´yal	sustainability
txokal	sustainable
chunxjab'	swag
b´ilq´ul	swallow
qo tx'ixpun	swap
jurar	swear
mujk´aj	sweat
ta'yil xmilalb'aj	sweater
tz´isol	sweep
tz´isil	sweep
misol	sweep
chi´	sweet
chi´twatla	sweet dreams
chi´ q´ajt	sweet dreams
liq´	sweet tooth
tzeq	sweet tooth
k'ujlab'il	sweetheart
nmal	swell
mal	swelling
malil	swelling
chi'l	swim
chil	swimming
tik´	swing
tx'exb'il	switch
m´al	swollen
laqte	sword
tech	symbol
cho'n k'uj	sympathy
ti nch'iyon	symptoms
nuk'ul ttxolil	system
Mex	table
tenb'il	table
laq'eb'il	tackle
tu'jal pa	tag
tje	tail
k ´wal l	take
K´al	take
q´inxa	take away
ka´yinx tib´a	take care
loch´al lochi´l	take off
ma tx'iq'in	taken
ma b'aj	taken
yolil	talk
un xjal aju noq tgan tuʼn tyolin	talkative
nimin twe'	tall
makol	tap
si'pj	tape
tkb'antel	target
taq´in	task
yak'ol	taste
k'ok'jal	taste
k'ok'j	tasty
yek´ilte	taught
te'	tea
yek´il	teach
nejenel aq´untl	teacher
b'yuj	team
ta´lwitzb´aj	tear
ta'lwutzb'aj	tears
yajil	tease
saq	technology
b´aj	teeth
chitzan	tell
q´amal	tell
chi	tell
qamantza weya	tell me
tzen kyaq	temper
ab´il	temperature
tja kjawil	temple
junjen amb´el	temporary
lajuj	ten
laj	ten
junch´uy jwe´q´o´	ten thousand
majil	tenant
yob'il	tend
saq	tendency
jun ilicitación	tender
jip	tense
nya bʼaʼn	tension
ja	tent
q'eqab'	tentative
b´ajsil	term
jun yol	terms
taq'wix	terrible
ponix	terrific
n tx'otx'	territory
ka´yel	test
yol tz'ib'in	text
ti ju	than
qol chjonte	thank
chjonte	thank you
tzaj tqona tun qo jyone tij toqxena	Thank you for your patience while we investigate shipment
chjonte te amb´il	Thank you for your patience while we investigate shipment
chjonte	thank you so much
chjonte	thank you very much
chjonte	thanks
chjonte sajon aplicaciones qeye	Thanks for using our app
qeju	that
a natzun	that is
b'a'natzun	that's good
a	the
alqan	theft
qeye	their
aqe	them
tema	theme
eyex	themselves
nej	then
chinaj	theory
machi´w	there
txix	there
a ti	there is
extzen	therefore
ajlu´	these
aye	they
aqe	they
eye	they are
pin	thick
aleq'	thief
twi´tz k´uxe	thigh
slak	thin
slik	thin
lu´n	thing
tx´aqan	things
ximil	think
toxin	third
wje á	thirsty
oxlaj	thirteen
junk´al laj	thirty
a ju lu	this
ajlu´	this is
siktenil	thorough
cheb'a	thoroughly
aj	those
ixqa	though
exlaqa	though
b´awtl	though
xim	thought
k'u'jlan	thoughtful
xim	thoughts
kab´q´o´ lajk´al	thousand
noq´	thread
x'olb'tz'al	threat
xob´ajil	threaten
oxe	three
ox	three
ja tun t-kanen	threshold
tb'anel	thrilled
tun q-q´inex	thrive
qulb´aj	throat
kyoj	through
kyxol	throughout
chitil	throw
xo'l	throw
chita	throw
tal q'ob'aj	thumb
k´inkaq	thunder
q´ankyoq	thunder
kyaq'ij	Thursday
iku k´alani´	thus
q´ol techil	tick
yupaj witzb'aj	tide
txole'	tidy
txolb'i'n	tidy
xmol	tie
jitz'il	tie
b´alan	tiger
b´alun	tiger
noqxex	tight
Tigrinya	Tigrinya
amb´il	time
chin b´otz	tiny
nab'il	tip
nab'il	tips
llanta	tire
sikten	tired
chemaj	tissue
tx'ilu'j	title
tb'i	title
Te	to
tza lo	to be
tx'il wab'j	toast
jalin	today
botz k'wal	toddler
tal tq´an	toes
junx	together
tz´alb´il	toilet
ma tzaj tman	told
nimb'il	tolerance
nimb´il	tolerate
xko´ya	tomato
xkoya	tomato
nejchij	tomorrow
aq'	tongue
aq'b'aj	tongue
ja lin te q'onik'an	tonight
sub´an	too
ikx	too
k'ab'aj	took
k'wa'n	took
k'walte	took
makb'il	tool
makb'il	tools
b'aq	tooth
steb'aj	tooth
eyb'aj	tooth
jawni	top
jawna	top
b'i'yol	topic
lich'il	torn
yajil	torture
jte	total
tzyuma	touch
kuj	tough
ma b´et	tour
jayil	toward
jayil	towards
txo'wa	towel
tnam	town
mya wen	toxic
tik'len	trace
pista	track
k'yil	trade
xk'ayil	trade
anq´ib´il	tradition
n-qb´inchen toj q-tx´otx´	traditional
txqan kar	traffic
b´e	trail
no´xk´ux	train
kotkotan k´uxb´il	train
tiqantib´	train
xnaqtzb´il	training
ikja	trait
transferir	transfer
tx´xpub´l	transition
tel qnikʼ	translate
qanchal	transparent
b'etb'il	transport
b'etb'il	transportation
k'ob'il	trap
txatz´is	trash
tz´is	trash
job'aj	trauma
b´etel	travel
laq	tray
q-tesoro	treasure
txi q-b´inchen	treat
jun lu´n n-xi b´inchet	treatment
tze´	tree
nintz´k´u´	tremendous
ik tzeʼnx in kubʼ	trend
xnik'chalte	trial
xnik'chal	trial
ma chi tb´inchan	tried
b´inchalte	trigger
jol	trim
b´etel	trip
q´oj	trouble
wex	trousers
iqatzb´il	truck
ax	TRUE
ajtz´in	trunk
q´uqb´il tk´u´j	trust
ax	truth
B´inchal	try
Tsonga	Tsonga
tub	tube
kaq´ij	Tuesday
tok letra kyiʼj	tuition
chmeq´	turkey
ptz´ul	turn
paqtzul	turn
paqet	turn
petz	turtle
ab'tzil	tutor
kab´lajuj	twelve
kab´laj	twelve
junk'al	twenty
junk´al jun	twenty-one
Twi	Twi
kab´e maj	twice
sutil	twist
sutlal	twist
kab´	two
kab´e	two
wiq	type
ik tzeʼnx in kubʼ	typical
taq´wix	ugly
b'ajsb'il	ultimate
pa´t	umbrella
mnya b'an	unable
kyan	uncle
najnab´il	unconscious
chin	under
chaba	under
tjaq´	underneath
xnak	underrated
nakeyil	understand
toj twi´	understand
niky´	understand
ma chi kane	understood
i´l	unfortunately
junelni	uniform
junx	unique
tnej	unit
jaxnaq'tzb'il	university
jun xjal ojtzqilte	unknown
me qa n-ti´	unless
to´jtx'io´jtx'I	until
myaxex normal	unusual
jawl	up
aya q´malte	up to you
q-resultado	update
kuchil	upgrade
talsyap	upon
twi´	upon
yut´anmi	upon
q´oj	upset
toj t-nam	urban
ilx ti´j	urge
noj q'elin	urgent
aqoye	us
oksil	use
ajb´en	used
ajb´elil	useful
ti tajb´en	useless
naqʼli qe	usual
junjen maj	usually
ajb'eb'il	utility
ajb'alan	utility
ojlab´il	vacation
toch´il	vaccination
tx'ik	vaccine
tuch'	vaccine
xi toj	vacuum
myaxex twutx	vague
twutx	valid
semil tx'otx'	valley
car wen	valuable
jte twi'	value
chukchaq	variety
b´a´mpun	variety
chukchaq	various
b´a´mpun	various
junxichaq	vary
teb´l b´ech	vase
vasto	vast
k´ayil itzaj	vegetable
itzaj	vegetables
kxb´il te yekelqu	vehicle
xi tq'o'n	vendor
q'anb'il	venom
emrpes	venture
tzalajsb'il	venue
k'ayilte	verify
nim nokn	versatile
nim	version
nukʼun tten	vertical
juntijxex	very
b'an	very good
bark	vessel
toj	via
q-vibra	vibe
t-lipel	vibes
aju otoq chin naqʼete tiʼj	vicious
ok bʼinchan nya bʼaʼn tiʼj	victim
k´ayb´il	view
q-aldea	village
nach	villain
tx'am	vinegar
ojtxax	vintage
q´oj	violence
bʼaʼn qʼojin	violent
txin	virgin
qʼaqʼbʼil tkʼuʼj	virtue
ka'yb'i	vision
u'la	visit
k'ayb'il	visual
vital te qe	vital
chwiqlal	vivid
q-yol	vocabulary
twi´	voice
amil	void
miti´toj	void
tal	volume
aq'anal toj oyaj	volunteer
xab´il	vomit
cheb´e	vulnerable
twi' k'u'j	wage
tw´tk´uj	wages
k´itzb´aj	waist
yolte	wait
yol	wait
majin	waiter
majan	waiter
yol	waiting
ma ja k'ij	wake
k´asil	wake up
k´isil	wake up
k´asul	wake up
b étil	walk
b´etil	walking
twitx ja	wall
tapa	wall
loq'n	wall
tkjub´il pwaq	wallet
b´o´t	wallet
q´il	wander
wajb´ile	wanna
ajb´il	want
jyojtz´	wanted
q´oj	war
k'ub'il b'ush	wardrobe
deposito	warehouse
kyaq	warm
q'mal	warn
qman t-pakb'al	warning
ajq'oj	warrior
ma tz´ok´	was
tx´ajil	wash
tx´ajol	wash
txjol	wash
ik´il	waste
kayil	watch
a´	water
kyaq´oq´	watermelon
tma´lal a´	wave
tza´an	way
tten	way
Aqoye	we
aqo	we
aq´oye	we are
b'antil	we can
nya kuj	weak
xb´unin	weak
numj	weak
nti' tipan	weakness
q'inamab'il	wealth
q'inimil	wealth
b´an	wealthy
oksil	wear
ajb´en	wear
ma ajb'enxi	wearing
na´ltx´otx´	weather
mujeb´ilin	wedding
ixq'ij	Wednesday
itzaj	weed
q'ij	week
wuqb'il	week
taqajan	week
te fin de semana	weekend
al	weight
alkayela	weird
bánkulene´	welcome
b'a'nxix	welfare
b´antzun	Well
b´a´n xb´incheta	well done
ma tzok´	went
ma ten	were
ten	were
toj oeste	west
xb´u´l	wet
wo´kyix	whale
tiju	what
ti xb'aj teya	what about you
Ti bajteya	what are you doing
ti b´ajteya jalin	what are you doing now
ti báj teya jalin	what are you doing right now
ti baj teya	what do you do
s'en nanq'iniya'	what do you do for a living
ti tmana	what do you mean
ti tajb´ila	what do you want
ti xb´aj	what happened
ti tzun la	what is
ti ju lu	what is this
ti la	what is this
te qe naq'unaniya	what is your job
ti tb´iya	what is your name
tqal tb´iya	what is your name
ti xb'aj	what's up
ti tb´iya	what's your name
tixku	whatever
a-trigo	wheat
syutb'il	wheel
jtojtzin	when
jtoj	when
jtoxk´u	whenever
ja´	where
ja	where
jatumuil	where
ja taya	where are you
Te jayila´	where are you from
ja taya jalin	where are you now
ja taya tjaya	where do you live
ja	where is
jatumel tzun	where is
tzenku	whereas
oky	whether
el qe	which
tze´n	while
yolil chab´a	whisper
xub´il	whistle
saq´	white
el qeju	who
alkeya	who are you
el qe	who is
el ke	who is this
junka	whole
chwinqxix	whole
alqe	whom
tuntzen	whose
taquntzun	why
ta q´un lay	why not
nya bʼaʼn xjal	wicked
nim twitz	wide
matij twitz	wide
meb´a xinaq	widow
ja n-qo okx b´aje	width
xu'jilb'aj	wife
xu'jlal	wife
nti´ t-nab´	wild
tqeq´il tkuja	will
taj	willing
kanb´al	win
kanb´il	win
kyq'iq'	wind
spiky'b'il	window
toky'	window
su'lq'e'n	wine
jb'alil	winter
qopsil	wipe
taq'il	wire
b´isel	wisdom
b´isel	wise
ajb´il	wish
b´an teya	wish you all the best
ajitz	witch
tukil	with
q'imila	withdraw
toj	within
xtix	without
kayel	witness
xhtij	witty
xoj	wolf
qya	woman
qya	women
kamb'il	won
lay txi'	won't
xjelil	wonder
ponex	wonderful
tze´	wood
tsmal rit	wool
yol	word
yol	words
aq´anal	work
b'inchal	work out
aquí	working
twitztx´otx´	world
twitz q´ijlal	world
q´ijlalil	world
no'x	worm
xton	worm
ma ajb'en	worn
melj	worried
melj	worry
a mya b´a´n	worse
nimbʼel	worship
mya wen	worst
t-chojb´etz	worth
q'uqil tk'uj	worth it
nim toklen	worthy
okle	would
k´ixb´in	wound
ky´ixbí	wound
Ooo	Wow
pajtz´ulte	wrap
txu'j	wrath
ti q´ob´aj	wrist
tzib´il	write
tzib´inkuya tzala	Write here
tz'ib'b'en	writing
tz´ib´in	written
ma chin qe tzaqje	wrong
ma ku tz´ib´in	wrote
pen	yard
k´ab´il	yawn
oky	Yeah
o´na	Yeah
qa	Yeah
ab´q´i	year
ab´q´i	years
yek'tz'ib'b'il	yeast
sch´in	yell
sch´il	yell
woyil	yell
xq´an	yellow
up	yellow
q´an	yellow
oki	Yes
oky nex	yes baby
ikja txin	yes dear
iktzen	yes honey
iktzen	yes my love
b'a'n	yes of course
ewi	yesterday
namx	yet
tmal twitz	yield
Aya	you
aya	you are
ponix te	you are beautiful
tb'anej te	you are so beautiful
mixti´x	you are welcome
nti´x	you are welcome
k-b´entil	you can
b'il	You know
ex teya	you too
mix tix	you're welcome
kuxin	young
teya	your
mixti	your welcome
xite	your welcome
axa	yourself
k´uxin	youth
xite	you’re welcome
k'ok'j	yummy
kow	zero
