एक	a
थोड़ो सो	a little
घणो	a lot
बोळा सारा	a lot of
छोड देणो	abandon
छोडेडो	abandoned
बात रो पालण करणो	abide
बूतो	ability
योग्य	able
कै बारा मं	about
ऊपर	above
बिदेस	abroad
गैर-हाजिर	absence
आयो कोनी	absent
बिल्कुल	absolutely
कोई चीज रै बारां मं पूरो जाणनो	absorb
बाधाएं	abstract
बै अर्थ को	absurd
बोहोत ज़्यादा	abundance
घणी मात्रा मं	abundant
गाळी देणो	abuse
गाळी	abuse
लहजो	accent
स्वीकार	accept
अनुमति	access
आज्ञा देणी	access
दुर्घटना	accident
रेवण री सुविधा	accommodation
साधणो	accomplish
इस्थापित करणो	accomplished
बिकी जियां	according
खाता	account
शुद्धता	accuracy
एकदम सही	accurate
आरोपी	accused
दरद	ache
पीड़ा होणी	ache
मिलगो	achieve
उपलब्धि	achievement
स्वीकार करणो	acknowledge
जाण- पिछाण	acquaintance
कब्जा मं लेणो	acquire
कब्जा मं लियोड़ो	acquired
कब्जो	acquisition
आर-पार	across
अधिनियम	act
काम	action
सक्रिय	active
न्यारा न्यारा काम करणो	activities
गतिविधि	activity
एक्टर	actor
सांच्याणी	actual
सांच्याणी	actually
तीखो	acute
का हिसाब स्यूं बणाणी	adapt
जोड़ना	add
नसो पत्तो	addicted
जोड़नो	addition
बत्तो	additional
भाषण	address
पता	address
घणो	adequate
कन्न कन्न	adjacent
विशेषण	adjective
एकमेक करणो	adjust
तारीफ करणी	admire
भरती करणा	admit
अपनायो	adopt
सबस्यूं प्यारो	adorable
आगै रो काम	advance
पेशगी	advance
विकसित	advanced
फायदो	advantage
हिम्मत आळा काम	adventure
किरया विसेसण	adverb
विज्ञापन	advertisement
विज्ञापन	advertising
सलाह	advice
सलाह	advise
वकालत करणी	advocate
वकील	advocate
नायण	aesthetic
प्रसंग	affair
असर	affect
प्रीत	affection
डर	afford
सस्तो	affordable
डरावणो	afraid
कै बाद	after
दोपारी	afternoon
ऊण रै बाद	afterwards
दुबारा	again
खिलाफ	against
उमर	age
एजेंसी	agency
बिचावलो	agent
रीस आलो	aggressive
फुर्तीला	agile
पेलि	ago
राजी	agree
समझोतो	agreement
खेती	agriculture
अगाऊ	ahead
सहायता	aid
निशाणो	aim
भाळ	air
हवाई अड्डो	airport
गलियारो	aisle
घंटी	alarm
दारू	alcohol
चेतावनी देणो	alert
जिंवतो	alive
सगळा	all
सौ क्यूं ठीक है	all right
शुुभकामनावां	all the best
अनुमति	allow
अनुुमति देणी	allowed
लगभग	almost
एकलो	alone
रै साथै	along
पेली स्यूं	already
सो क्यूं ठीक है	Alright
भी	also
दूसरो विकल्प	alternative
फेर भी	although
हमेशका	always
मं	am
जोरदार	amazing
जिको साफ कोनी	ambiguous
भोत ज्यादा इच्छा आळो	ambition
महत्वाकांक्षी	ambitious
सही करनो	amend
रै मांय	amid
आं मांयलो	among
आपणा मांय स्यूं	among us
मात्रा	amount
रिप्या	amount
मजा करणो	amusing
एक	an
विसलेशण करणो	analysis
बडैरा	ancestors
लंगर	anchor
साला पुराणो	ancient
अर	and
अर थै	and you
भगवान को दूत	angel
रीस	anger
खुणो	angle
झाळ	angry
जिनावर	animal
टखना	ankle
सालगिरह	anniversary
घोषणा करणी	announcement
चिड़ोकलो	annoy
आक्तो	annoyed
परेसानी करबा आळो	annoying
साल मं	annual
गुमनाम	anonymous
दूसरो	another
उत्तर	answer
उत्तर देणा	answer
अंदाजो लगाणो	anticipate
व्याकुलता	anxiety
बैचेन	anxious
कोई भी	any
ई रे पाछे	anymore
कोयी भी	anyone
क्यू ही	anything
खैर	anyway
बियां भी	anyways
अलग	apart
मकान	apartment
माफी मांगणी	apologize
सामै आणो	apparent
आमनै-सामनै	apparently
अपील करणा	appeal
हाजिर	appear
कै जियाणको	appear
दिखणो	appearance
दिखणो	appeared
भूख	appetite
सेब	apple
अरजी	application
आबेदन	apply
नियुक्ति	appointment
सराणो	appreciate
बढाई करणी	appreciation
नेड़ो आणो	approach
आगे बढ़णो	approach
उचित	appropriate
हाँ भरवानी	approval
मँजुरी	approve
अनुमति मिलणो	approved
करीब-करीब	approximately
अप्रैल	april
आपरै हिसाब स्यूं	arbitrary
वास्तूकार	architect
वास्तुकला	architecture
संगरहण	archive
है	are
कांई थै	are you
थे व्यस्त हो	are you busy
कांई थारो ब्याव होयेड़ो है	are you married
थांको ब्याव हुएडो है कि एकला ही हो	are you married or single
कांई थै अबार भी बठै हो	Are you still there?
कायीं थे बठे हो	are you there
जिग्या	area
माथाफोड़ी करणी	argue
जबान लड़ानो	argument
बढ़णोा	arise
बाँवल्लयो	arm
सेना	army
च्यारूंबांडे	around
बैवस्था	arrange
हिसाब	arrangement
आगमन	arrival
पों'चणा	arrive
पूगणो	arrived
घमंडी	arrogant
तीर	arrow
कला	art
लेख	article
नकली	artificial
कलाकार	artist
जियां	as
जिण टेम	as long as
जियां कै	as well
साग्ग हि	as well as
बानी	ash
सर्म आणो	ashamed
पूछणा	ask
पूछ्यो	asked
सोयड़ो	asleep
पहलू	aspect
असमिया	Assamese
हमलो	assault
सभा	assembly
मानणो	assertive
अनुमति	assess
मूल्यांकन	assessment
संपत्ति	asset
संपत्तियां	assets
सौंपणो	assign
दियेड़ो काम	assignment
मदद करणो	assist
साग्ग काम करबालो	assistant
सहायक	associate
जुडेडो	associated
संगठन	association
कलपना	assume
मान्यता	assumption
पर	at
कम ऊँ कम	at least
खायो	ate
धावक	athlete
रै साथै लगायोड़ो	attach
जड़ेड़ो	attached
हेज़	attachment
हमलो करणो	attack
आजमाइस	attempt
परयास	attempt
हाजिर	attend
हाजिर	attendance
ध्यान	attention
नजरियो	attitude
लुभाणो	attract
ध्याान खींचणो	attraction
आकर्षक	attractive
गुण	attribute
सुणबा ला	audience
अगस्त	august
काकीजी	aunt
काकी	aunty
विश्वास पात्र	authentic
लेखक	author
हक	authority
पतझड़	autumn
मौजूद	available
औसत	average
टाळना	avoid
चोक़न्नो	awake
पुरस्कार	award
जागरूक	aware
जागरूकता	awareness
आंतरैै	away
भोत बढ़िया	awesome
भद्दो	awful
भूड़	awkward
आइमारा	Aymara
नानो टाबर	baby
बिना ब्या करेडो	bachelor
पाछो	back
पुराणो इतिहास	background
बेकार	bad
थैलो	bag
प्रलोभन	bait
सेकणो	bake
बेकरी	bakery
मीठा सोडो	baking soda
संतुुलन	balance
संतुलन बणाणो	balance
गिंडी	ball
बंबारा	Bambara
केळो	banana
मूड़णो	band
भिड़णो	bang
बैंक	bank
छड़ी	bar
दोरो-सोरो	barely
रागड़दी करणो	bargain
भोकणो	bark
छाल	bark
जौ	barley
बाधावां	barrier
आधार	base
आधारित	based
तळघर	basement
सरुआती	basic
मूळ रूप स्यूं	basically
तुलसी	basil
हरामी	bastard
बैच	batch
नहाणो	bath
नहाणघर	bathroom
बैटरी	battery
लड़ाई	battle
खाड़ी	bay
होणो	be
ध्यान स्यूं	be careful
समदर तीर	beach
खुशी से उछलनो	beam
किरण	beam
फळियां	beans
भालू	bear
उधारी	bear
दाढ़ी	beard
दूजां कन स्यूं सामान लेणो	bearing
जानबर	beast
हराणो	beat
ताल	beat
सोऊणा	beautiful
फूटरो	beauty
कै बियां	became
क्यूंकि	because
हुबाळो	become
बिछावणा	bed
सोबा आळी साळ	bedroom
शेद आळी मांखी	bee
भैंस रो मांस	beef
गयो	been
दारू	beer
कै पेली	before
चालु करयो	began
सरूआत	begin
सूरुआत	beginning
ओर सू	behalf
बैवार	behave
बरताव	behavior
व्यवहार	behaviour
पाछलो	behind
अस्तित्व	being
बिस्वास	belief
भरोसो	believe
कमर	belly
संबंंधित होणो	belong
भोत चोखो लागणो	beloved
पाछले बाण्डे	below
बेल्ट	belt
बेंच	bench
मुड़नो	bend
कै तळे	beneath
फ़ायदो	benefit
खुद रो लाभ	benefit
फ़ायदो	benefits
उण कन्नै	beside
ई रै अलावा	besides
सबस्यूं बढ़िया	best
शुभकामनावां	best of luck
आभार रै साथै	best regards
चोखो	better
कै बीच मं	between
खाबा-पीबा रो सामान	beverage
कै पाछै स्यूं	beyond
भोजपुरी	Bhojpuri
पक्षपात	bias
भेदभाव	biased
साइकिल	bicycle
बोली	bid
बडो	big
बाइक	bike
रसीद	bill
बांधणो	bind
चिड़कली	bird
जलमदिन	birthday
भाग	bit
काटना	bite
खाणा	bite
कड़वा	bitter
काळो	black
पत्ती	blade
निनदा करणी	blame
दोष	blame
खाली	blank
कामल्ल	blanket
धमाको	blast
सफेदी करणो	bleach
पिसणो	blend
आशीस देणी	bless
भगवान कि क्रिपा	blessed
आंधो	blind
भोत आणंद	bliss
डाटो	block
खून	blood
खिलणा	bloom
हवा भरणो	blow
नीलो	blue
भोंट	blunt
तख्तो	board
पतवार	boat
शरीर	body
उबाळो देणो	boil
नीडर	bold
बंधन	bond
हाड	bone
किताब	book
पहले ही रोक लेणा	book
बढ़ावो देणो	boost
बढ़ावो	boost
खातावळी करणी	booster
गाड़ी री डिक्की	boot
बूंट	boots
सीमा	border
ऊंबणो	bore
बकवास	bored
ऊबाउ	boring
जलम	born
उधारी करणी	borrow
रोब दिखाणो	boss
दोन्यू	both
तंग करणा	bother
बोतल	bottle
तरळो	bottom
लेणो	bought
उझाळ	bounce
बंधेड़ो	bound
सीमावां	boundaries
झुकणा	bow
बाटको	bowl
डब्बो	box
छोरो	boy
दोस्त	boyfriend
चूड़ी	bracelet
दिमाग	brain
शाखा	branch
ब्रांड	brand
भा'दुर	brave
तोड़नो	breach
रोटी	bread
रुकणा	break
तोड़णो	break
कलेवो	breakfast
बोबा	breast
साँस	breath
साँस लेना	breathe
नसल	breed
ईंट	brick
बिनणीं	bride
पुलियो	bridge
छोटी सी जाणकारी	brief
चमकदार	bright
हुंश्यार	brilliant
ल्याणो	bring
भाईसा	bro
बड़ो	broad
पररसारण	broadcast
टूट ग्यो	broke
टूट्योड़ो	broken
बुहारी	broom
भाई	brother
जीजा	brother in law
खरीद ल्याणो	brought
भूरो	brown
बुरस	brush
बाल्टी	bucket
भायलो	buddy
लेखो जोखो	budget
कीड़ो	bug
नया बणाणा	build
भवन	building
बणायोड़ो	built
थोक	bulk
सांड	bull
धमक़ाणो	bully
ऊंचो उठयोड़ो	bump
गुच्छा	bunch
बंडल	bundle
बजनदार	burden
बजन	burden
गाड्यो	buried
बळनो	burn
फोड़णो	burst
गाड़णो	bury
बस	bus
झाड़	bush
बोपार	business
छाती	bust
ब्यस्त	busy
पण	but
माखण	butter
तितली	butterfly
खटको	button
खरीदणो	buy
कै जरिए	by
खैर	by the way
पधारो	bye
पत्ता गोबी	cabbage
अलमारी	cabinet
पिंजरो	cage
केक	cake
बाछ्यो	calf
बुलाणो	call
पुकारणो	call
फोन करो	call me
बुलावो	called
शांंति राखणो	calm
आयो	came
अभियान	campaign
करणो	can
डब्बो	can
कोनी कर सकूं	can't
रद्द	Cancel
कैन्सर	cancer
काबिल	capable
क्षमता	capacity
राजधानी	capital
शीर्षक	caption
कबजो करणो	capture
कार	car
जीवन सवाणा	career
ध्यान राखणो	careful
साव्वळ	carefully
लापरवा	careless
ध्यान राखबालो	caring
खाती	carpenter
दरी	carpet
गाजर	carrot
साथै	carry
काम जारी राखणो	carry on
साथै लेणो	carry out
मामलो	case
नकद	cash
ढाळ	cast
किलो	castle
अनौपचारिक	casual
मिनकी	cat
पकड़्यो	catch
वर्ग	category
जानबर	cattle
पकड़ो ग्यो	caught
ठीकाणे पुगणो	cause
कारण	cause
सावधानी	caution
सावचेत	cautious
गुफ़ा	cave
बंद करणो	cease
छात	ceiling
त्युवार मनाणो	celebrate
साळ	cell
केन्दर	center
शतक	century
खिंंचड़ी	cereal
समारोह	ceremony
कदै काव	certain
अबार ही	certainly
परमानपत्र	certificate
चेन	chain
कुड़सी	chair
ललकारणो	challenge
चुनौती	challenge
अवसर	chance
बदळणो	change
अव्यवस्था	chaos
चरितर	character
वीसेसता	characteristics
बसूली	charge
आरोप	charge
चंदो	charity
फूटरो	charming
लेखा चितर	chart
पाछो करणो	chase
बात-चीत करणी	chat
चैट	chat
ओछी	cheap
धोको	cheat
बेईमानी करणी	cheating
जांचणा	check
डाट लगाणी	check
गाल	cheek
हौसलो बढ़ाणो	cheer
खुश-मिजाज	cheerful
हिम्मत बढ़ाणी	cheers
पनीर	cheese
रसायन विज्ञान	chemistry
चोखो लाग्णो	cherish
शतरंज	chess
छाती	chest
चाबणो	chew
मुर्गा	chicken
मुखियो	chief
टाबर	child
टाबर पणो	childhood
टाबरां नै	children
शी	chill
शियाळो	chill
ठंडो	chill
चिमनी	chimneys
ठोड़ी	chin
चॉकलेट	chocolate
पसंद	choice
चुण ल्यो	choose
काटना	chop
ऊबणो	chores
गोलमटोळ	chubby
गिरजाघर	church
दालचीनी	cinnamon
घेरो	circle
हालत	circumstances
नागरिक	citizen
से'र	city
मांग	claim
दावो	claim
सफाई देणो	clarify
कक्षा	class
माटी	clay
साफ-सपाई	clean
साफ करणो	clear
साफ	clear
बाबू	clerk
चालाक	clever
आसामी	client
टीबो	cliff
जलवायु	climate
चढ़ना	climb
चिपक बालो	clingy
घड़ी	clock
बंद	close
कोठी	closet
गाबा	cloth
गाबा	clothes
बादल	cloud
बादलाँ ऊँ भरयो	cloudy
जोकर	clown
संकेत	clue
अनाड़ी	clumsy
गिरोह	cluster
कोच	coach
सीखाणो	coach
कोयलो	coal
तट	coast
परत	coat
कॉफी	coffee
ज्ञान पर आधारित	cognitive
संयोग	coincidence
ठंडो	cold
पड़ जाणो	collapse
गळपट्टी	collar
साथ काम करणियो	colleague
सागे काम करबाला	colleagues
भेलो करणों	collect
भेळो करणो	collection
कॉलेज	college
रंग	color
व्याकरण ठीक होबा स्यूं हमेशा सही अरथ कोनी निकळे	colorless green ideas slept furiously
रंग	colour
खानो	column
काँगश्यो	comb
संयोजन	combination
एक होनो	combine
आवो	come
अठै आवो	come here
चालो भी	come on
आराम ऊँ	comfort
आरामदायक	comfortable
आ रयो	coming
जल्दी आ रयो है	coming soon
अधिकार मं राखणोॉ	command
टिप्पणी	comment
व्यावसायिक	commercial
आयोग	commission
सोगन खाओ	commit
शिकायत	commitment
परतीबध	committed
माल	commodity
सामान्य	common
बात करणो	communicate
संचार	communication
समाज	community
आणो-जाणो	commute
साथीड़ो	companion
कमपनी	company
बराबरी करणो	compare
तुलना करणो	comparison
करुणा	compassion
दयालू	compassionate
रै हिसाब स्यूं	compatible
प्रतियोगिता करणो	compete
समर्थ	competent
आपसी मुकाबलो	competition
प्रतिस्पर्दी	competitive
शिकायत करना	complain
ओळमो	complaint
जोड़णो	complement
उल्टो	complement
पूरो करणो	complete
पूतो तरह ऊँ	completely
जटिल	complex
पालण करणो	compliance
उळझेड़ो	complicated
बडाई	compliment
री पालणा करनी	comply
संघटन	composition
मिस्रण	compound
अक्कल	comprehension
लंबो-चौड़ो	comprehensive
समझौतो करणो	compromise
समझौतो	compromise
जरूरी	compulsory
कम्प्यूटर	computer
ध्यान लगाणो	concentrate
धारणा	concept
दिलचस्पी	concern
चिन्ता होणी	concern
चिन्त्या	concerned
मेळ	concert
अंतिम हल	conclusion
ढ़कणो	concrete
बजरी	concrete
ठोस	concrete
हालत	condition
हालत	conditions
आयोजन करणो	conduct
सम्मेलन	conference
गळती मानणी	confess
खुद पर बिसवास	confidence
आतमबिस्वासी	confident
पुख्ता	confirm
आपस में भिडन्त	conflict
चक्करघिनी	confused
भैम	confusion
बधावां	congrats
बधावां	congratulation
बधावां	congratulations
सगळा काम करबा आळो	conjunction
जोड़णो	connect
जीत दरज करणी	conquer
सचेत	conscious
चेतो	consciousness
मरजी	consent
सै'मत होणा	consent
परिणाम	consequences
बचाणो	conservation
रूढ़िवादी	conservative
ध्यान राखिजै	consider
मानणो	considered
कै मांय	consist
गाढ़ो पण	consistency
इकसार	consistent
लगातार	constant
लगातार	constantly
कब्जी	constipation
भींंत बणाणो	construction
खालेणो	consume
काम मं लेणो	consumption
सम्पर्क बणाणा	contact
समपर्क	contact
संक्रामक	contagious
सामिल करणो	contain
थामणो	contains
कै टेम रो	contemporary
आदेश नीं मानणो	contempt
मजा रै मांय	content
परतियोगिता	contest
परसंग	context
महाद्वीप	continent
लगतमार	continue
भेळो होणो	contract
संविदा	contract
उलटो	contrast
विसम	contrast
भागीदारी	contribute
योगदान करणो	contribution
बस मं करणो	control
बातां बणाबा जोगो	controversial
सुविधा	convenience
सुविधा देबा आळो	convenient
बारता	conversation
बदळणो	convert
कॉनवर्ट	convert
बात बताणी	convey
मनवाणो	convince
मनाणो	convinced
खानसामो	cook
खाणो बणाणो	cook
रांदणो	cooking
जोरदार	cool
ठंडो	cool
सहयोग	cooperation
सामनो करणो	cope
तांबो	copper
मुख्य	core
भुट्टो	corn
कुणो	corner
सही	correct
नुकसान	cost
लागत	cost
पोसाक	costume
झूंपो	cottage
कपास	cotton
सोफ़ो	couch
खाँसी	cough
सकणो	could
परिषद	council
गिणती	count
विरोध करणो	counter
देस	country
गांव-ढाणी	countryside
जोड़ो	couple
हिम्मतआळो	courage
पाठ्यक्रम	course
अदालत	court
शिष्टाचार	courtesy
काका-बाबा का	cousin
ढकणा	cover
गाय	cow
कायर	coward
आरामदेह	cozy
केकड़ो	crab
दरार	crack
टूटणो	crack
शिल्प	craft
बकवास करणी	crap
टक्कर	crash
चूर-चूर होणो	crash
किं खाबा रो मन होणो	craving
रिग्सनो	crawl
बावळी झालर	crazy
बणाओ	create
नवो काम करणियो	creative
शरेय	credit
रेंगणो	creep
बेकार	creepy
साथ काम करणिया रो गुट	crew
अपराध	crime
चाटूकार	cringe
चापलूस	cringe
संकट	crisis
मापदंड	criteria
गंभीर	critical
कोई री आलोचणा करणी	criticism
कांट-छांट	crop
खेेती बाड़ी	crops
पार करना	cross
संकर	cross
कागलो	crow
भीड़	crowd
भीड़-भड़क्को	crowded
ताज	crown
विकट	crucial
निरदयी	cruel
समदर में चालबा आळी न्याव	cruise
हराणो	crush
कुचलणो	crush
रोणो	cry
खीरो	cucumber
छाती क लगाणो	cuddle
संस्कृति	culture
छाकटो	cunning
कप	cup
टांड	cupboard
काबू मं राखणो	curb
इलाज करणो	cure
इलााज	cure
कर्फ़्यू	curfew
जाणबा री इच्छा	curiosity
जिज्ञासू	curious
घुँघराळा	curly
पिसा	currency
अबार तण	current
हाल रै मांय	currently
श्राप	curse
परदा	curtain
तकिया	cushion
रिवाज़	custom
गिराक	customer
रीती-रिवाज	customs
घाव	cut
कटाई करणो	cut
प्यारो	cute
चक्कर	cycle
साइकिल चलाणो	cycling
कंवर सा	dad
बापूजी	daddy
रोज	daily
डेरी	dairy
बंधो	dam
चोट	damage
नुकसान पुगाणो	damage
हत्त थारी	damn
तर	damp
नाच	dance
खतरा	danger
खतरनाक	dangerous
अँधेरा	dark
प्रिय	darling
जरा सो	dash
आँकड़ा	data
दिनांक	date
आपस में मेल-जोल	date
बेटी	daughter
दिन	day
मरयोड़ो	dead
समय सीमा	deadline
बेरो	deaf
लेन-देन	deal
सौदो	deal
प्यारो	dear
प्रिय साथिड़ाओ	Dear All
चोखा गिराक	Dear Customer
प्रिय अभिभावक	Dear Parents
प्रिय महोदय	Dear Sir
प्यारा टाबरों	Dear students
प्रिय टीम	Dear Team
मौत	death
बहस	debate
खर्चा मं मांडणो	debit
मळबो	debris
कर्जो	debt
दशक	decade
गिराणो	decay
मरियेड़ो	deceased
ठगणो	deceive
दिसंबर	december
सभ्य	decent
तय	decide
तय	decided
फैसला	decision
झ्याज री छात	deck
उंधो पड़णो	decline
घटाणो	decrease
समरपित	dedicated
समरपण	dedication
डीड	deed
उंडो	deep
हिरण	deer
चूक	default
हार मानणो	defeat
हार	defeat
रक्षा करणी	defend
परिभासित करणो	define
निश्चित	definitely
परिभासा	definition
डिग्री	degree
मोड़ा होणा	delay
रुकावट	delay
मोड़ो होणो	delayed
मिटाणो	delete
जाण'र करयोड़ो काम	deliberate
नाजुक	delicate
भोत सुवाद	delicious
आनन्द	delight
आनन्दित	delighted
बाँटनो	deliver
पुगा दियो	delivered
पुगा देणो	delivery
मांगणा	demand
तकाजो करणो	demand
घणी बातां रो ध्यान राखणो	demanding
लोकतंत्र	democracy
राकस	demon
दिखाणो	demonstrate
नई मानणो	denied
घनाव	density
दांतां रो डाक्टर	dentist
नकारणो	deny
विभाग	department
जाणा	departure
भिसर	depend
मौका माथै लगाणो	deploy
जमा कराणा	deposit
रेहन	deposit
बावलो	depressed
निरासा	depression
उंडो	depth
सार बताणो	describe
बिस्तार	description
मरूस्थल	desert
लायक	deserve
डिजाइन करणो	design
डिजाइन	design
पद	designation
चाहत करणा	desire
चाह	desire
टेबल	desk
निराश होणो	despair
दुखी होणो	desperate
ई रै बावजूज	despite
मिठाई	dessert
मंजिल	destination
किस्मत	destiny
खतम करणो	destroy
नास	destruction
घणी जाणकारी	detail
पुरी बात	details
ठा पटकणो	detect
पक्को इरदो	determination
तय करणो	determine
कस्टो निरणै	determined
सदमो लागणो	devastated
बिकास	develop
बणणो	developed
बिकास	development
उपकरण	device
राकस	devil
हर काम रै वास्ते तियार रेणो	devoted
दिवेही	Dhivehi
सूगर	diabetes
दस्तां लागणी	diarrhea
डायरी	diary
सबदकोष	dictionary
कर दियो	did
मरणो	die
मरेड़ो	died
आहार	diet
अंतर	difference
फरक	different
दोराई	difficult
खाडो	dig
गरिमा	dignity
मेनती मिनख	diligent
ब्याळू	dinner
डुबाणो	dip
सिदो	direct
दिसा	direction
निदेसक	director
बास	dirt
खराब	dirty
गायब होणो	disable
अपंग	disabled
गायब	disappear
निराश	disappointed
आपदा	disaster
खारिज करणो	discard
छुट्टी मिलणी	discharge
सभ्याचार	discipline
छूट	discount
ढूँढणो	discover
पक्षपात	discrimination
बातचीत करणा	discuss
चर्चा	discussion
रोग	disease
बैमारी	diseases
लूखाणो	disguise
ख़राब	disgusting
व्यंजन	dish
बरतन	dishes
रद्द	dismiss
रवाना करणो	dispatch
दिखाणो	display
निपटाणो	disposal
विवाद	dispute
आंतरो	distance
न्यारो-न्यारो	distinct
फासलो करणो	distinguish
तनाव	distress
बाँटणो	distribution
जिलो	district
परेशान करना	disturb
धोखो देणो	ditch
डुबकी लगाणो	dive
अनेक	diverse
कयी भाँत का	diversity
बाँटणो	divide
दिव्य	divine
तलाक	divorce
तलाक लेणा	divorce
चक्कर	dizzy
काम कर दयो	do
काँयी थे	do you
काईं थै मन्नै प्रेम करो हो	do you love me
डागदर	doctor
कागजात	document
करणो	does
अनाप	doesn't
गंडक	dog
डोगरी	Dogri
करणो	doing
गुड्डी	doll
काम करबा आळो एरियो	domain
घरेलू	domestic
असरदार	dominant
नही	don't
चिंता मत कर	Don't worry
दान देणो	donate
सलटाणो	done
गधेड़ो	donkey
नशा री दुवाई	dope
जोड़-तो़ड़	double
दूणा होणो	double
शक	doubt
दुबिधा	doubt
गुंथेड़ो आटो	dough
रै नीचे	down
डाउनलोड करना	download
मसौदो	draft
ढांचा रो नकसो	draft
खिंचणो	drag
नालो	drain
नाटक	drama
मांडणा	draw
दराज	drawer
चित्रकला	drawing
डरपणो	dread
सपनो देखणो	dream
सपनो	dream
गाबा	dress
छेद काडणो	drill
पीनो	drink
पीणो	drink
गाड़ी़ चलाणो	drive
बूंद	drop
गिरणा	drop
छोड़्योड़ो	dropped
सूख गियो	drought
पियेड़ो	drunk
सूखो	dry
बत्तख	duck
छैल	dude
बकायो	due
बी कारण	due to
ढीलो	dull
गूंगा	dumb
कचरा री जिग्या	dump
टेम	duration
कै दौरान	during
धूळ	dust
नौकरी	duty
बसणो	dwell
मरणो	dying
सगळा	each
एक-दूजा	each other
तियारी	eager
चील	eagle
कान	ear
पेलि	earlier
बेगो	early
कमाई	earn
कान	ears
धरती	earth
भूकंप	earthquake
सोरो	ease
आसानी स्यूं	easily
पूरब	east
सरल	easy
जीमो	eat
ब्याळू करणी	eating
रिप्या-टकां रो मामलो	economic
अरथ बैवस्था	economy
किनार	edge
संपादित करणी	edit
सीख	education
परभाव	effect
असरदार	effective
छमता	efficiency
काम रौ पुख्ता	efficient
कोसिस करणी	effort
अंडो	egg
बैंगण	eggplant
घमंड	ego
आठ	eight
अठारह	eighteen
अस्सी	eighty
दोन्या मं स्यूं एक	either
बढ़ा-चढार बताणो	elaborate
खूणी	elbow
बडो	elder
बड्डा बुजर्ग	elderly
भोत अच्छी	elegant
तत्व	element
हाथी	elephant
ग्यारा	eleven
सक्षम	eligible
हटाणो	eliminate
कै अलावा	else
शरम	embarrassed
सर्मिंदा करबालो	embarrassing
अपणावत	embrace
निकळना	emerge
इमरजैंसी	emergency
भावना मं	emotional
सहानुभूति	empathy
जोर	emphasis
जोर देणो	emphasize
नौकर	employee
कर्मचारी	employees
काम पर रखेड़ो आदमी	employer
रोज़गार	employment
रितेड़ो	empty
चालू	enable
भिडंत	encounter
आमनो-सामनो	encounter
बढ़ावो देणो	encourage
खतम	end
खातमो होबा की कतार मं	endangered
कोसिस	endeavor
धीरज स्यूं	endurance
सहन करणो	endure
दुश्मन	enemy
शक्ति	energy
काम माथै लगाणो	engage
काम रै मांय लाग्योड़ा	engaged
सगाई	engagement
इंजन	engine
इंजिनीयर	engineer
अंगरेजी	English
बढ़ाणा	enhance
मजा ल्यो	enjoy
भोत-बडो	enormous
घणो	enough
पैली स्यूं तय करणो	ensure
माँय बड़नो	enter
मनोरंजन	entertainment
राज़ी होनो	enthusiasm
उत्साही	enthusiastic
सगळो	entire
हकदार	entitled
ईकाई	entity
मोड़ा पर	entrance
बौपारी	entrepreneur
लिफाफो	envelope
वातावरण	environment
जळन	envy
महाकाव्य	epic
परकोप	epidemic
बराबर	equal
उपकरण	equipment
हिस्सो	equity
बराबर	equivalent
रबड़	eraser
गळती	error
बच'र भाजणो	escape
खासकर	especially
निबंध	essay
सारी बात	essence
आवश्यक	essential
इस्थापित	establish
इस्थापित	established
जागीर	estate
आंकलन	estimate
अंदाजा स्यूं	estimated
आदि	etc
सदैव	eternal
नैतिकता	ethics
मूल्यांकन करणो	evaluate
मूल्यांकन	evaluation
अर बो	even
इकसार	even
चावै तो भी	even though
दंत्या	evening
आजोजन	event
कदै-काव	eventually
हमेसका	ever
सारा	every
हर कोई	everybody
सगळा	everyone
सो क्यू	everything
सबूत	evidence
बुरो	evil
विकास	evolution
बढ़णो	evolve
एवै	Ewe
पेलि आलो	ex
एकदम बो ही	exact
बिल्कु्ल	exactly
परीक्षा	exam
परीक्षा लेणो	examine
उदाहरण	example
पार करणो	exceed
भोत जोरदार	excellent
रै अलावा	except
अपवाद	exception
घणोही	excess
घणो	excessive
अदळा-बदळी	exchange
उत्साहित	excited
कळाचूक होणा	excitement
जबरदस्त	exciting
अनन्य	exclusive
माफ करणो	excuse
मन्नै माफ करद्यो	excuse me
अमल मं लेणो	execute
काम करणो सरू करनो	execution
काम काढणियो	executive
अभ्यास	exercise
व्यायाम	exercise
थाकेड़ो	exhaust
थकेड़ो	exhausted
दिखाणो	exhibit
परदरसनी	exhibition
अस्तित्व	exist
अस्तित्व	existence
पेलि ऊँ	existing
बारेे निकळणो	exit
बढाणो	expand
उम्मीद करणी	expect
उम्मीद	expected
खर्चो	expenses
मैंगो	expensive
झेलणो	experience
घटना	experience
परयोग	experiment
जाणकार	expert
खत्म हो चुकी	expired
समझाणो	explain
कोई बाराँ मं बताणो	explanation
गुलामी कराणी	exploit
घूमणो-फिरणो	explore
बिदेस मं सामान भेजणो	export
उघाड़णो	expose
भांडो फोड़णो	exposed
खुलासो	exposure
जताणा	express
तेजी	express
हाव-भाव स्यूं बताणो	expression
आगै बढाणो	extend
फैलाव	extended
बढानो	extension
क्षेत्र	extent
बारेला	external
हर कठ नही मिळबा लो	extinct
बत्तो	extra
निकालणो	extract
डेढ़श्याणी	extraordinary
चरम	extreme
अत्यंत	extremely
आँख्याँ	eye
आंख्याँ	eyes
कपड़ा	fabric
अचम्भाली	fabulous
मुंडो	face
सामनो करणो	face
सुविधावां	facilitate
सुविधाएँ	facilities
सुविधा	facility
आंकड़ा	fact
फैक्टर	factor
करखानो	factory
तथ्य	facts
रंग उडणो	fade
चूकणा	fail
असफलता	fail
असफल	failed
असफल	failure
जाड़ा बुचणा	faint
गोरा	fair
बिना भेद भाव कै	fair
भोत बढ़िया	fairly
परी	fairy
बिसवास	faith
ईमानदार	faithful
फर्जी	fake
नीचे पड़णो	fall
पतन	fall
गळत	false
परसिद्धी	fame
जाण्यो पिछाणयो	familiar
घर-परिवार	family
काळ	famine
परसिद्ध	famous
परशंसक	fan
पंखो	fan
तड़क-भड़क	fancy
भोत बढ़िया	fantastic
आंतरै	far
बिदाई	farewell
खेत	farm
कृषक	farmer
भोत आकर्षक	fascinating
फैसन	fashion
खातो सो	fast
मोटो	fat
घातक	fatal
किसमत	fate
बापूजी	father
आकता होणा	fatigue
गळती	fault
सबस्यूं चोखो	favorite
म्हारी मदद	favour
पसंद को	favourite
डर	fear
डरणो	fear
खाणो-पिणो	feast
पांखड़ा	feather
लक्षण	feature
परकट करणो	feature
खासबात	features
फ़रवरी	february
परेसान होणो	fed up
फीस	fee
खाणो जिमाणो	feed
पालण पोषण	feed
पाछो पूछणो	feedback
महसूस होणो	feel
इछ्या	feeling
पग	feet
पड़णो	fell
साथी	fellow
अनुभव किया	felt
लुगाई	female
तारबंदी	fence
उपजाऊ	fertile
त्युहार	festival
मिलाणो	fetch
ऊन(बुखार)	fever
थोड़ो	few
ऊँ कम	fewer
मंगेतर	fiance
उपन्यास	fiction
खेलबा रो मैदान	field
ख़तरनाक	fierce
पंद्रह	fifteen
पचास	fifty
लड़ाई	fight
झगड़ो करणो	fight
लड़ाई करणी	fighting
आकार	figure
गिणती	figure
हल करणो	figure out
फ़ाइल	file
भरणो	fill
भरेड़ो	filled
फिलम	film
गंदो	filthy
आखरी मं	finally
रिप्या-पिसा	finance
आर्थिक	financial
ढूंढो	find
पतो लगाणो	find out
बारीक	fine
जुरमानो	fine
आंगळ्यां	finger
निवडनो	finish
अंत	finished
बास्ते	fire
कंपनी	firm
ठोस	firm
पेली	first
पेलो नाम	first name
मछली	fish
दुरुस्त	fit
गलो खराब हुणो	five
हल करना	fix
एक जिग्या सेट करयोड़ो	fixed
पताका	flag
चांदणो	flash
इकसार	flat
जमीन रो टुकड़ो	flat
गळती	flaw
बेदाग	flawless
रफुचक्कर हो ज्याणो	flee
माँस	flesh
उड गियो	flew
नीचे झुकाणो	flex
रबड़ जियाँको	flexible
उड़ान	flight
उलटो करणो	flip
इसक बाजी करणो	flirt
इसकबाजी करणी	flirting
तिरनो	float
बाढ़	flood
आंगणो	floor
चून	flour
बै'णा	flow
बहाव	flow
फूल	flower
बुखार	flu
प्रवाह	fluent
लगतमार	fluently
फुल्योड़ी	fluffy
तरल	fluid
उड़नो	fly
केंदर	focus
केंदर बिंदु	focus
धुंध	fog
धुंध	foggy
सामटणो	fold
सगळा मिनख	folks
पाछो करणो	follow
संभाळणो	follow up
पाछो करणों	following
खाणो	food
मुरख	fool
ठगणा	fool
मूरखतापूर्ण	foolish
पग	foot
दड़ो	football
कै तांई	for
उदाहरण कि खातर	For example
उदाहरण रै वास्ते	for instance
थारै वास्ते	for you
मना करेडो	forbidden
दम	force
पेलि ऊँ ठा पड़नो	forecast
लिलाट	forehead
बिदेसी	foreign
जंगल	forest
रोजीना	forever
भूलणो	forget
माफ करणो	forgive
भूलगो	forgot
काँटो	fork
फारम	form
बणाणा	form
औपचारिक	formal
पुराणत्यो	former
किसमत स्यूं	fortunately
भाग	fortune
चालीस	forty
बयालीस	forty-two
आगे बढाणो	forward
पोषक	foster
लड्या	fought
मिलगो	found
नींव	foundation
चार	four
चौदह	fourteen
लोमड़ी	fox
दुरबळ	fragile
चोखट	frame
रूपरेखा	framework
धोखो	fraud
बावलों	freak
निशुल्क	free
आजादी	freedom
जमाणो	freeze
आवृति	frequency
कई बार	frequent
बार-बार	frequently
ताजा	fresh
शुक्रवार	friday
फ़्रीज	fridge
मितर	friend
दोस्ताना	friendly
आयला भायला	friends
भाईचारो	friendship
डरयोड़ो	frightened
डरावनो	frightening
मिढ़को	frog
स्यूं	from
आग्ग	front
जमेड़ो	frozen
फल	fruit
दुखी	frustrated
बल्लितो	fuel
फ़ुलफ़ुल्दे	Fulfulde
भरेड़ो	full
मजो	fun
जळसो	function
मौलिक	fundamental
अंतिम संस्कार	funeral
मजाकिया	funny
फर	fur
घणी रीस आणो	furious
काठ को सामान	furniture
आगलो	further
ओर आगै	furthermore
भविष्य	future
फायदो	gain
कमाई	gain
खेल	game
फरक	gap
गाडी खड़ी करबा की जिग्या	garage
कुटलो	garbage
बाड़ी	garden
लसण	garlic
किंवाड़	gate
भेळो करणो	gather
लोग भेळा होणा	gathering
नापणो	gauge
दियो	gave
गियर	gear
लिंग	gender
साधारण	general
आम तौर पर	generally
बनाणो	generate
पीढ़ी	generation
दरियादिल	generous
भोत तेज दिमाग आळो	genius
शैली	genre
सज्जन	gentle
वास्तव मं सही	genuine
हाव- भाव	gesture
तियार	get
ले लयो	get
गावा पे'रो	get dressed
ऊँठणो	get up
जल्दी ठीक हु जाओ	get well soon
प्राप्त करणो	getting
भूत	ghost
आप री छाया	ghosting
भोत बड्डो	giant
उपहार	gift
अदरक	ginger
छोरी	girl
भाईली	girlfriend
देणो	give
छोडणो	give up
दे दियो	given
खुशी	glad
नज़र	glance
कांच	glass
चश्मो	glasses
झलक	glimpse
दुनिया भर रै मांय	global
उदास	gloomy
दस्तानां	gloves
चमकणो	glow
तेज	glow
आगेे बढो	glow up
गुंद	glue
जावो	go
आग्ग चालो	go ahead
आगा जावो	go away
सोबा जाओ	go to bed
लक्षै	goal
लक्ष्य	goals
छ्याळी	goat
भगवान	god
भगवान भलो करे	god bless you
जाव है	goes
जा रयो है	going
जा रियो हूं	going to
सोनो	gold
चल्यो ग्यो	gone
हुबालो	gonna
गूंद	goo
अछ्या	good
और अच्छा	good
शुभ दोपारी	good afternoon
गुड बाय	good bye
दिन चोखो रेवै	good day
शाम की रामराम	good evening
बढ़िया काम	good job
सोवणो	good looking
थानै कामयाबी मिलै	good luck
सुपरभात	good morning
सुबह कि राम राम प्रिय	good morning my love
शुभ रातरी	good night
टाटा	goodbye
शुभ रात्रि	goodnight
सामान	goods
गूगल	Google
गूगल स्यूं भासा बदळणी	Google Translate
बतख	goose
भोत सोवणो	gorgeous
बातां करणो	gossip
ले लियो	got
समझ ग्यो	got it
सरकार	government
झपटणो	grab
नम्बर	grade
धिरर-धिरर	gradually
सोल्वी पास	graduate
नाज	grain
देणो	grant
दिएडो	granted
अंगूर	grapes
पकड़	grasp
घास	grass
आभारी	grateful
धनबाद देणो	gratitude
कबर	grave
भूरो	gray
भोत चोखो	great
म्हा'न	great
लालच	greed
लालची	greedy
हरियो	green
मनुवार करणो	greet
बधावां	greeting
बधाई देणी	greetings
स्लेटी	grey
जाळ	grid
तकलीफ	grief
पिसणो	grind
पकज़णो	grip
राशन -पाणी	grocery
बन्नड़ो	groom
कुल	gross
खेल रो मैदान	ground
झुण्ड	group
आगे बढ़णो	grow
आग्ग बढ़णो	growth
चिड़चिड़ो	grumpy
गुआरानी	Guarani
गारण्टी	guarantee
गारड	guard
अटकळ	guess
पाँवणा	guest
सलाह	guidance
गाइड	guide
रास्तो दिखाणो	guide
दोषी	guilty
भायो	guy
साथिडा	guys
जिम	gym
आदत	habit
परकरती मं बणेड़ो घर	habitat
राखणा	had
जयकारा लगाणा	hail
बाळ	hair
आधो	half
बड़ी साळ	hall
हाथ	hand
रख-रखाव	handle
सोवणो	handsome
टांगणो	hang
लटकानो	hang out
हुणो	happen
घटना होणी	happened
ख़ुशी	happiness
खुस	happy
जनमदिन री बधायां	happy birthday
जनमदिन री शुबकामनावां	happy birthday to you
नया साल री सुभकामनावां	happy new year
दोरो	hard
दोरो सोरो	hardly
बोळो दोरो	hardly ever
बुराई	harm
चोट पुगाणी	harm
नुकसान पूँछाण आलो	harmful
सदभाव	harmony
कलड़ो	harsh
फसल	harvest
राखणो	has
नफरत	hate
कन्नै	have
आपरो दिन बढ़िया रेवे	have a good day
थानको दिन बढ़िया जाव्व	have a nice day
कलेवो कर ल्यो	have breakfast
मजा करो	have fun
काईं थै रोट्यां खा ली	have you eaten
राखणो	having
नुकसान आळी	hazard
धुंध	haze
बो	he
उण रै पाक्ती	he has
ओ है	he is
माथौ	head
माथौ दुखणो	headache
ठीक होणो	heal
ठीक हुणो	healing
तबैत	health
सेहतमंद	healthy
सुणाई देणो	hear
सुणाई देणा	heard
दिल	heart
गर्मी	heat
गरम होणा	heat
स्वर्ग	heaven
बजनदार	heavy
भोत काम मं लामिजेड़ो	hectic
ऊंचाई	height
वारिस	heir
डकैत	heist
काज कराणो	held
नरक	hell
नमस्कार	Hello
नमस्कार प्रिय	hello dear
खम्माघणी कायीं हाल है थांका	hello how are you
नमस्कार सा, कियां हो थे	hello how are you doing
हेलमेट	helmet
मदद	help
काम आबालो	helpful
इयां ही	hence
बीकी	her
घेरो	herd
अठै	here
बिरासत	heritage
संकोच करणो	hesitate
ओये	Hey
नमस्ते	Hi
हैल्लो, थै कियां हो	hi how are you
नमस्कार सा	Hi there
लुखाणो	hidden
लुखाणा	hide
पद क अनुसार	hierarchy
ऊंचो	high
प्रमुख बातां	highlight
बढ़ाणो	hike
दूर तक पेदल चालणो	hiking
भोत जोरदार	hilarious
डूंगर	hill
बीको	him
ईसारो	hint
कूलो	hip
नितंब	hips
किराया माथै लेणो	hire
नौकरी माथै राखणो	hiring
बीकी	his
इतिहास	history
चोट	hit
हम्म	Hmm
कोड	hobby
रोकणो	hold
पकड़या राखणो	hold on
मोखलो	hole
छुट्यां	holiday
थोथो	hollow
घर	home
घरां रो काम	homework
ईमानदार	honest
ईमानदार	honestly
शेद	Honey
म्हारा प्यारा	Honey
सम्मान	honor
कानाँ को टोपो	hood
अंकुश	hook
कूदणो	hop
आसा	hope
उम्मीद राखणी	hope
आसा बांधेड़ी राखणी	hopefully
उम्मीद खत्म होणी	hopeless
आडी लाइण	horizontal
सीटी बजाणी	horn
भयंकर	horrible
डरावणी चीजां	horror
घोड़ो	horse
अस्पताळ	hospital
मेहमाननवाज़ी	hospitality
सवागत करणो	host
मेजबान	host
विरोध करबाला	hostile
तातो	hot
होटल	hotel
घंटो	hour
घंटा	hours
घर	house
घरका	household
कियां	how
थै कियां हो	how about you
थै कियां हो	how are you
थै कियां हो	how are you doing
थै कियां हो आज	how are you doing today
आज थै कियां हो	how are you today
थै कियां हो	how do you do
कियां है	how is
कत्ता	how many
कतरा	how much
कतरी बार	how often
थै करता साल का हो	how old are you
थांको दिन किस्योक हो	how was your day
रात किसिक बीती थांकी	how was your night
हालांकि	however
जग्याँ	hub
भरतार	hubby
गळे लगणा	hug
पकड़णा	hug
भोत बडो	huge
मिनख	human
नरम होणो	humble
भीज्येड़ो	humid
नमी	humidity
सौ	hundred
भूखा	hungry
शिकार करणो	hunt
चकरवात	hurricane
तावलो	hurry
बेगा करो	hurry up
चोट	hurt
बींद	husband
भीड़ मं धक्को लागणो	hustle
बदमासी	hustle
झूंपो	hut
सफाई राखणो	hygiene
मं	I
मं हूं	I am
मं ठीक हूँ	I am fine
मं भी कर सकूं हूं	I can
मं कोनी कर सकूं हूं	I can't
मं करूं हूं	I do
मन्नै कोनी ठा'ह	I do not know
मं समझ्यो कोनी	I do not understand
मं कोनी करूँ	I don't
मन्नै कोनी ध्यान	I don't know
मं समझ्यो कोनी	I don't understand
मं थारो मतलब कोनी समझ्यो	I don't understand what you mean
मन थांकी बात समझ कोनी आयी	I don't understand you
मन्नै कोनी ठा'ह	I don’t know
मं कोनी समझ्यो	I don’t understand
म्हारा बिचार स्यूं	i guess
मं खा लियो	I had
म्हारे कन्नै	I have
मं रियो हूं	I have been
मं उम्मीद करूं हूं	I hope so
मन्नै ध्यान है	I know
मन्नै चोखो लागै है	I like
मन थे चोखा लागो हो	I like you
थै मन्नै चोखा लागो हो	I love
मं म्हारा बडा भाई स्यूं प्रेम करूं हूं	I love my big brother
मन्नै म्हारी बडी भाण स्यूं प्रेम है	I love my big sister
मं म्हारा बापूजी स्यूं प्रेम करूं हूं	I love my father
मं म्हारा नानकड़ा भाई स्यूं प्रेम करूं हूं	I love my little brother
मन्नै म्हारी भाण स्यूं प्रेम है	I love my little sister
मन्नै म्हारी मां स्यूं प्रेम है	I love my mother
मं तन्नै प्रेम करूं हूं	I love you
मं तन्नै भोत प्रेम करू हूं	I love you so much
मं भी थाँ ऊँ प्रेम करूँ हूँ	I love you too
म्हारो मतलब	I mean
मं थनै याद करू हूं	I miss you
मन थांकी भोत याद आव्व है	I miss you so much
इयां की	I see
म सोचूँ	I think
मं समझ सकूं हूं	I understand
मन चहिज	I want
मं थाऊं मिलणो चाहु हूं	I want to see you
मं थानै चाऊं हूं	I want you
मं हो	I was
मं करूंगा	I will
मं बणुला	I would be
मं हूं	I'm
मं ठीक हूं	I'm fine
मं चोख़ो हूँ	I'm good
मं अठै हूं	I'm here
मन्नै माफ कर द्यो	I'm sorry
बर्फ	ice
कुल्फी	ice cream
बिचार	idea
मिसाल	ideal
एक जियाणको	identical
जाण-पैचाण	identify
पिछाण	identity
मूरख	idiot
ठाल्लो	idle
अगर	if
झांकणो ही नी	ignore
बीमार	ill
अवैध	illegal
बीमारी	illness
इलोकानो	Ilocano
फोटू	image
सोचणो	imagine
अबार री अबार	immediate
अबार की अबार	immediately
ज्यादा	immense
असर	impact
परभाव डाळणो	impact
बेसबरो	impatient
अमल मं ल्याणो	implement
बारै स्यूं सामान मंगाणो	import
जरूरी	import
जरूरी	important
थोपणो	impose
हो हि कोनी सक्क	impossible
परभाव छोड़णो	impress
छाप	impression
जबरदस्त	impressive
सुधार करणो	improve
सुधार	improvement
मांय	in
ई रै साथ मं	in addition
सांच्याणी	In fact
कै सामने	in front of
ई हिसाब स्यूं	in order to
बिना बैवार कै	inappropriate
ऊपर का पिस्सा	incentive
घटना	incident
मायं बड़णा	include
मिलार	including
आमदनी	income
असुविधा हुणो	inconvenience
बढत	increase
फैलणो	increase
बढ़ाणी	increased
जिण पर भरोसो कोनी हुवै	incredible
सांच्याणी	indeed
स्वतंत्र	independent
भारत	India
इसारो	indicate
देसी सबद	indigenous
कोई एकलो	individual
उद्योग	industry
जरूरी	inevitable
नवजात	infant
संकरमण	infection
अगणित	infinity
जळन होणी	inflammation
मैंंगाई	inflation
परभाव पटकणो	influence
परभाव	influence
सूचना देणो	inform
सूचनावा	information
सामग्री	ingredients
बाप-दादा री बिरासत	inheritance
सरूआती	initial
पहल करणो	initiative
चोट लागेडि	injured
चोट लागणी	injury
मासूम	innocent
कीं नयो	innovation
जाँच	inquiry
उन्मादी	insane
कीड़ा	insect
असुरक्षित	insecure
मांय बाड़णो	insert
मांयलो	inside
काम कि	insight
जोर देणो	insist
नींद नहीं आणो	insomnia
प्रेरणा	inspiration
प्रेरित करणो	inspire
लगाणो	install
उदाहरण	instance
फटाफट	instant
कै बदळा मं	instead
की बजाय	instead of
निर्देश	instructions
साज-सामान	instrument
निचो दिखाणो	insult
बीमों	insurance
अखंड	intact
एकदम जुड़ाव	integrity
भोत ज्यादा जाणबा आळा मिनख	intellectual
समझदारी	intelligence
दिमागदार	intelligent
इरादो	intend
इरादो राख बा आळा	intended
भोत गंभीर	intense
ईरादो	intention
बात-चीत करणी	interact
मिलणो- जुलणो	interaction
रूचि	interest
मन मं आणो	interested
मजेदार	interesting
बीच मं पड़णो	interfere
दसवीं कक्षा	intermediate
अंधरूनी	internal
दो देशां रै बीच	international
इनटर्नशिप	internship
बताणो	interpret
दुभाषिया	interpreter
बाधा गेरनो	interrupt
साक्षात्कार	interview
संकेत देणो	intimate
रै मांय	into
ओळखाणो	introduce
परिचय	introduction
मांय रैण आळो	introvert
खुद रो ज्ञान	intuition
मान्यो कोनी जाव्व	invalid
खोजणी	invent
भंडार	inventory
रिप्या लगाणा	invest
जाँच करणो	investigate
न्युतो देणो	invitation
बुलाओ	invite
चालाण	invoice
बिल भेजणो	invoice
रलनो	involve
मांय आणो	involved
लोहो	iron
लोहो देणो	iron
है	is
द्वीप	island
एक बांडै रेणो	isolated
मामलो	issue
जारी करणो	issue
तकलीफ	issues
ओ	it
ओ है	it is
बो हो	it was
ई रो	it's
कोई बात नहीं	it's ok
कोई बात कोनी	It's okay
चीज-बस्त	item
वस्तुआं	items
इको	its
मं हूं	I’m
अंगरखो	jacket
जेळ	jail
जनवरी	January
जार	jar
जबाड़ो	jaw
बळत	jealous
झटको	jerk
जेवर	jewelry
नौकरी	job
आराम स्यूं भाजणो	jogging
जुड़णो	join
भेळो	joint
चुटकुलो	joke
संवाददाता	journalist
जातरा	journey
मजा	joy
न्यायाधीश	judge
आंकणा	judge
रस	juice
जुलाई	july
उछळणो	jump
जून	june
कचरो	junk
अबार-अबार	just
न्याय करणो	just
ओ कर ही द्यो	just do it
न्याय	justice
न्याय करणी	justify
कलाल्लिसुत	Kalaallisut
उत्साही	keen
राखो	keep
चालबाद्यो	keep it up
कन्नै मेलणो	kept
केतली	kettle
चाबी	key
लात मारणी	kick
बच्चा	kid
हसी-मजाक	kidding
गुर्दो	kidney
बोळा सारा बच्या	kids
ज्यान स्यूं मारणो	kill
कतरा पराकर	kind
दया	kind
एक तरियां स्यूं	kinda
किरपा	kindly
दया	kindness
राजा	king
चूमणो	kiss
रसोई	kitchen
पतंग	kite
बिलाई रो बचियो	kitten
गोड़ो	knee
जाणनो	knew
चक्कु	knife
सामंत	knight
जाणनो	know
जाणकारी	knowledge
जानणो	known
कोंकणी	Konkani
क्रियो	Krio
पर्चो	label
चिप्पी चेपणो	label
काम करबाला	labor
मजूर	labour
कमी	lack
सीढ़ियां	ladder
लुगाई	lady
जिग्या लेणी	laid
झील	lake
लल्ड़ी	lamb
झूटलो	lame
चिमनी	lamp
तळे उतरणो	land
जमी	land
जमीन रो टूकड़ो	landscape
भासा	language
गोदी	lap
बडो	large
आखरी	last
आखरी है पण खत्म कोनी हुया	last but not least
पाछलो नाम	last name
पछै	late
अबाार मं	lately
बाद मं	later
अबार	latest
पाछै	latter
हंसणा	laugh
हंसणो	laughing
हास्य	laughter
सरू करणा	launch
धोबाला कपड़ा	laundry
कानून	law
घास रा गुवाड़	lawn
वकील	lawyer
मट्टीपलीत	lay
परत	layer
विन्यास	layout
आळसी	lazy
अगाउ	lead
नेता	leader
पत्तो	leaf
निकलणो	leak
पतळो	lean
छलांग लगाणी	leap
सीखणा	learn
सीखणो	learning
पट्टा	lease
कम स्यूं कम	least
चमड़ो	leather
छुट्टी	leave
छोडणो	leave
पत्तयाँ	leaves
अगाऊ	led
छोडणो	left
पग	leg
रीवाज	legacy
क़ानूनी	legal
आदर्श	legend
बैधजी	legit
आळगस	leisure
उधारी	lend
लंबाई	length
कम	less
पाठ	lesson
चालो	let
कागद	letter
सलाद को पत्तो	lettuce
लेबल	level
फ़ायदो उठाणो	leverage
देणो	liability
पुस्तकालय	library
चाटणो	lick
झूठ	lie
आराम करणो	lie
झूठ बोलणो	lies
जीवन	life
लिफ्ट	lift
उपर उठाणो	lift
हळको	light
चमकणो	light
चाणणो	light
बीजळी चिमकणी	lightning
पसंद	like
संभावित	likely
बियाँ ई	likewise
सिध	line
लिंगाला	Lingala
जोड़णो	link
शेर	lion
तरल	liquid
सूची	list
सुणना	listen
सुनना	listening
जीयाणको को जीयाणको	literally
साहित्य	literature
कूटल्लो	litter
थोड़ो	little
रैणो	live
जीवतो	live
कलेजी	liver
जीवन	lives
जीविका	living
घर री बैठक	living room
बिछमरो	lizard
बजन	load
टूकड़ो	loaf
लोन	loan
स्थानीय	local
जगा	location
तालो	lock
लॉक्डाउन	lockdown
लकड़ी को लट्ठो	log
जोरदार हंसणा	lol
एकलो	lonely
लंबो	long
घणा दिना स्यूं मिल्या	long time no see
रूप-रंग	look
देखणो	look
कुंडली	loop
ढीलो	loose
हारणो	loose
भगवान	lord
हारणो	lose
गुमा देणा	lose
घाटो	loss
गमगो	lost
भोत	lot
खाति अवाज	loud
आराम करबा की जिग्यां	lounge
भोत बढ़िया	love
प्रेम	love
थां स्यूं प्यार है	love you
प्यारा	lovely
थोड़ो	low
नीचलो	lower
म्हारो बिसवासी	loyal
निष्ठा	loyalty
किसमत	luck
चोखा भाग आलो	lucky
लुगांडा	Luganda
सामान	luggage
पिंडो	lump
जारी करणा	lunch
फेफड़ा	lungs
लगजरी	luxury
झूठ बोलणो	lying
मसीन	machine
बावली	mad
मैडम	madam
बणायेड़ो	made
पत्रिका	magazine
शानदार	magnificent
बाई	maid
मुख्य	main
संभालणा	maintain
सार-सम्भाळ	maintenance
मैथिली	Maithili
परधान	major
सब स्यूं बडो	major
बहुमत	majority
बणाणो	make
तियाार करणो	make up
आदमी	male
मॉल	mall
पुरुष	man
परबंध करणो	manage
परबंधन	management
प्रबंधक	manager
जरूरी	mandatory
घोषणा रो कागद	manifest
भरमित करणो	manipulate
तरीको	manner
मेन्यूअल	manual
कई	many
आज रै दिन री भोत बधावां	many many happy returns of the day
मार्च	march
चेत	march
फरक	margin
बजार	market
ब्याव	marriage
ब्याव करेडो	married
मारवाड़ी	Marwari
नकाब	mask
भोत बडो	mass
बड्डो	massive
गरूजी	master
मिलणो	match
मिलाण कराणो	match
साथिड़ो	mate
समान	material
गणित	math
मामलो	matter
सामान	matter
प्रौढ़	maturity
मई	may
आज्ञा लेणो	may
हो सकै है	maybe
मं	me
मं भी	me too
भोजण	meal
नीच	mean
इरादो	mean
मतलब	meaning
मतलब	means
मतलब	meant
ई रै तहत	meanwhile
नाप	measure
नपाणो	measures
मांस	meat
ईलाज	medical
दुवाई	medicine
ध्यान लगाणो	meditation
माध्यम	medium
मिलणो	meet
बैठक	meeting
मैतैलोन	Meiteilon
पिंधलणो	melt
यादां	memories
याद	memory
बावळो	mental
मांड्योड़ो	mention
कै बारां में बताणो	mentioned
गैलो दिखाबा आळो मास्टर	mentor
बोपारी	merchant
दयाभाव	mercy
केवल	merely
किसमिस री बधावां	merry christmas
गड़बड़	mess
संदेस	message
बिखरेडो	messy
धातु	metal
तरीक़ो	method
उंदरो	mice
बिचको	middle
ढळती रात	midnight
हा सकै	might
हळको	mild
मील रो भाटो	milestone
सेना	military
दुध	milk
दस लाख	million
ध्यान देवो	mind
दिमाग	mind
मनपसंद	mindset
म्हारो	mine
खदान	mine
आपसरी रै मांय मिलणो	mingle
छोटो	minor
मिनट	minute
मिनट	minutes
चमत्कार	miracle
काच	mirror
मिलएडा	miscellaneous
बदमास	mischievous
आकतो	miserable
दुख	misery
कुमारी	miss
थारी याद आ रही है	miss you
गमएड़ो	missing
मिसन	mission
कुहासा	mist
गळती	mistake
मिज़ो	Mizo
मोबाइल	mobile
दिखावो	mock
नमूना	model
नरम	moderate
संयम राखणो	moderate
आजकाल का	modern
मामूली सो	modest
गीलो	moist
नमी	moisture
साँचो में ढालना	mold
साँचा मं ढालणो	mold
मुंडा माथै होयेड़ो तिल	mole
मां	mom
टेम	moment
सोमार	monday
धन	money
ध्यान रखणो	monitor
बांदरौ	monkey
म्हीनो	month
दिमाग रा भाव	mood
मिजाजी	moody
चाँद	moon
नैतिक	moral
घणो सारो	more
इकै पछे भी	moreover
सूबै	morning
गिरवी मेलणो	mortgage
अधिकतर	most
धणीबार	mostly
मावड़ी	mother
चालणो	motion
परेरणा	motivation
परबत	mountain
उंदरो	mouse
मुंडो	mouth
हिलणा-डुलणा	move
जन आंदोलन	movement
फिलम	movie
श्रीमती	mrs
भोत ज्यादा	much
कादो	mud
लूट ताणी हमलो करणो	mug
माँसपेशियाँ	muscle
संग्रहालय	museum
मशरूम	mushroom
संगीत	music
फफूंद	must
जरूरी	must
बोलणो बंद	mute
आपस मं	mutual
म्हारो	my
म्हारे जीव कि जड़ी	My dear
म्हारो दोस्त	my friend
म्हारो विमान ईल मछली स्यूं भरयोड़ो है	My hovercraft is full of eels
म्हारो प्यार	my love
म्हारो नाम है	my name is
म्हारी खुशी	my pleasure
मं खुद	myself
रहस्यमय	mysterious
रहस्य	mystery
गप्प	myth
नख	nail
अनाड़ी	naive
नाम	name
नरेटिव	narrative
संकड़ा	narrow
भोत-खराब	nasty
देस रो मामलो	national
राष्ट्रीयता	nationality
देसी	native
प्राकृतिक	natural
परकरति	nature
जीव खराब हुणो	nausea
नेड़ो	near
कन्न ही	nearby
करीब-करीब	nearly
साफ	neat
भोत जरूरी	necessary
नाड़	neck
गळा रो हार	necklace
जरूरत	need
दरिदरता	need
नकारात्मक	negative
ध्यान नही देणो	neglect
मोल-भाव करणो	negotiate
अड़ोस-पड़ोस	neighbor
अड़ोस- पड़ोस	neighborhood
नही तो	neither
भतीजा	nephew
पढ़ंतरी	nerd
घबराणा	nervous
घुसाळो	nest
जाळ	net
नेटवर्क	network
कठै को भी नई होणो	neutral
कदै ही नहीं	never
आस मत छोड़ो	never give up
कोई बात कोनी	never mind
कोई बात कोनी	nevermind
जण फेर	nevertheless
नियो	new
खबर	news
आगलो	next
क कन्न	next to
भोत बढिया	nice
थां स्यू मिल'र बढ़िया लाग्यो	nice to meet you
भतीजी	niece
रात	night
बुरो सुपनो	nightmare
नौ	nine
उन्नीस	nineteen
निब्बै	ninety
नीं	No
कोई बात कोनी	no problem
कदे ही नहीं	no way
कोयी कोनी	nobody
अवाज	noise
रोलाँ लो	noisy
किं नहीं	none
दोफारी	noon
कदै इ नी	nope
और न ही	nor
सामान्य	normal
उत्तर	north
नाक	nose
पूराणै टेम री बात	nostalgic
नहीं	not
बिल्कुल हि नही	not at all
ठीक है	not bad
अबार नीं	Not now
हाल तक नी	not yet
लिखणो	note
मशहूर	noted
कांई कोनी	nothing
सूचना	notice
ध्यान द्यो	noticed
संज्ञा	noun
संज्ञा	nouns
उपन्यास	novel
नवंबर	november
अबै	now
आजकाल	nowadays
उपद्रव	nuisance
फालतू	null
सुन्नो	numb
नम्बर	number
नरस	nurse
नट	nut
जायफल	nutmeg
पोषाहार	nutrition
सौगन खाणी	oath
मोटापो	obesity
आदेश रो पालन	obey
मकसद	object
उद्देश्य	objective
दायित्व	obligation
साफ ठा नीं पड़णो	obscure
जाणकारी लेणी	observation
अवलोकन करणो	observe
परभावित	obsessed
जुनून	obsession
एकदम सही	obsolete
बाधा	obstacle
ले लियो	obtain
मिल्यो	obtained
बात नै बताणो	obvious
जाहिर	obviously
कदै-कदै	occasionally
काम-धंधो	occupation
कब्जो हुणो	occupied
घटणा	occur
घटना हुयी	occurred
घटना हुयी	occurs
सागर	ocean
अक्टूबर	october
न्यारो-न्यारो	odd
परेसानी	odds
को	of
जरूर	of course
बंद करणा	off
बैकार	offensive
पेश करणा	offer
प्रस्ताव	offer
ओफिस	office
ओफ़िस को	official
कदै-कदै	often
ओले	Oh
सांच्याई	oh really
तेल	oil
ठीक	ok
ठीक है दोस्त	ok dear
ठीक है प्यारी	ok honey
ठीक है प्यारा	ok my love
ठीक है	okay
ठीक है बेबी	okay baby
ठीक है दोस्त	okay dear
ठीक है म्हारी प्यारी	okay honey
ठीक हैै म्हारा प्यारा	okay my love
पुराणो	old
चालू	on
ऊपर	on
एकर	once
एक	one
एक भासा पूरी कोनी पड़े	one language is never enough
काँदो	onion
ऑनलाइन	online
केवल	only
खुल्योड़ो	open
कारवाही	operation
सलाहवां	opinion
मौको	opportunities
मौको	opportunity
उल्टो	opposite
आसावादी	optimistic
विकल्प	option
वैकेल्पिक	optional
या	or
संतरो	orange
नारंगी रंग	orange
लेण वाइज	order
हूकम देणो	order
कोई खास नी	ordinary
संस्था	organization
कै बारा मं जानणो	orientation
उत्त्पति	origin
मूल	original
ओरोमो	Oromo
अनाथ	orphan
दूसरा	other
नही तो	otherwise
चहिज	ought
आंपारो	our
म्हारो लक्षै है कि हर जिग्या रा मिनखा रा वास्त दुनिया समझण जैड़ी बणावनी अर सबनै आपरी भासा मं बोलबा मं सक्षम बणाणो।	Our mission: to enable everyone, everywhere to understand the world and express themselves across languages.
म्हारो लक्षै है कि दुनिया री जाणकारी नै बैवस्थित कर ईण नै सब रै वास्ते उपलब्ध अर काम री बणाणी।	Our mission: to organize the world's information and make it universally accessible and useful.
बारे होणो	out
परणाम	outcome
घाबा	outfit
मिलनसार	outgoing
दुकाान	outlet
रूपरेखा	outline
बारलो	outside
बकायो	outstanding
एकदम गजब	outstanding
तंदूर	oven
कै ऊपर स्यूं	over
निपट गो	over
बठै	over there
कुलमिलार	overall
काबु पाणो	overcome
घणो सोचणो	overthinking
अभिभूत	overwhelmed
जबरदस्त	overwhelming
ब्याजूणो	owe
उल्लू	owl
मालक	own
मं खुद	own
मालिक	owner
भैसा	ox
भोत तेज	pace
बाँधणो	pack
पैकेज	package
चुका दीयो	paid
दरद	pain
रंगणो	paint
चित्रकारी	painting
जोड़ो	pair
फिको	pale
हथेळी	palm
कड़ाई	pan
महामारी	pandemic
घबराहट	panic
पेंटा	pants
कागज	paper
सरग	paradise
एक साथ	parallel
पारसल	parcel
माफी	pardon
मां-बाप	parents
पारक	park
सुवो	parrot
अजमोद	parsley
टूकड़ो	part
भाग लेणो	participate
खासकर	particular
विशेस रूप ऊँ	particularly
जोड़ीदार	partner
दळ	party
सफल होणो	pass
गुजरणा	pass
मारग	passage
आगै बढ़णो	passed
जोस	passion
जुनून आलो	passionate
चालू नई होणो	passive
पासवर्ड	password
अतीत	past
पैबंद	patch
राह	path
दयनिय	pathetic
धैर्य	patience
धीरज	patient
घायल	patient
सरूप	pattern
थामणा	pause
सड़क री पटरी	pavement
पिसा देणो	pay
रिप्या भेजणा	payment
शांति	peace
शांति आलो	peaceful
आडू	peach
ऊपर	peak
नासपती	pear
मटर	peas
अटपटो	peculiar
पैसाब करणो	pee
पैसाब	pee
छोलणो	peel
समकक्ष	peer
साथै रा मिनख	peers
कलम	pen
रूल	pencil
रूक्योड़ो	pending
लोगबाग	people
मिर्च्या	pepper
देखणो-जानणो	perceive
अैसास	perception
सबस्यूं बढ़िया	perfect
परदरसन करना	perform
परदरसन	performance
कदै-काव	perhaps
समे	period
हमेशा कै लिए डटणो	permanent
अनुमति	permission
आज्ञा देणो	permit
दृढ़ता	perseverance
ज़िद्दीगारो	persistent
व्यक्ति	person
खुद को	personal
व्यक्तित्व	personality
बीके बारा मं	perspective
राजी करणो	persuade
बरगलाणो	pervert
पलेड़ो जानबर	pet
भाग	phase
चमत्कारी सकती	phenomenon
दरसन	philosophy
फोन	phone
फोटू	photo
मुहावरो	phrase
भौतिक	physical
उठाणों	pick
चुण	pick
उठााणो	pick up
तस्वीर	picture
टूकड़ो	piece
टूकड़ो	pieces
सुअर	pig
कबूतर	pigeon
ढेर	pile
तकियो	pillow
पायलेट	pilot
पिन	pin
अनन्नास	pineapple
गुलाबी	pink
खाडो	pit
सपाट जिग्या	pitch
पेस करणो	pitch
दिया	pity
थान	place
जिग्या	place
जिग्या	places
उत्पात	plague
सपाट	plain
जुगत	plan
हवाईज्याज	plane
पौधा	plant
पौधा	plants
पलेट	plate
प्लैटफारम	platform
चलाणो	play
रमणो	play
खेलणो	playing
शानदार	pleasant
किरपा	please
खुशी	pleased
परम सुख	pleasure
पर्तिग्या	pledge
घणा सारा	plenty
प्लोट	plot
प्लग लगाणो	plug
आलूबुखारो	plum
पाणी री पाईप ठीक करणियो	plumber
एक स्यूं घणा	plural
पॉडकास्ट	podcast
कविता	poem
कविता	poetry
बिंदु	point
झैर	poison
पुलिस	police
नीति	policy
नम्र	polite
परदूषण	pollution
तालाब	pond
पोखर	pool
जहाज को लेरलो हिस्सो	poop
गरीब	poor
बेगा आवो	pop
परसिद्ध	popular
जनसंख्या	population
सूलडा को मांस	pork
दळियो	porridge
नाश	port
इस्थिति	position
सकारात्मक	positive
काबू करणो	possess
हक	possession
हक जमाणो	possessive
कर सकणो	possible
पद	post
पद माथै लगाणो	post
स्थगित करणों	postpone
आलु	potato
संभावना	potential
पाउंड	pound
गरीबी	poverty
तागत	power
ताकतवर	powerful
व्यावहारिक	practical
अभ्यास	practice
साधणो	practice
बढ़ाई	praise
मज़ाक	prank
हाथ जोड़ना	pray
मैंंगो	precious
सटीक	precise
एकदम सही	precisely
भविष्यवाणी करणो	predict
प्राथमिकता	prefer
पेली पसंद	preference
पेट ऊँ	pregnant
दुभांत करणों	prejudice
घर-बारणो	premises
बढ़िया	premium
तियारी राखणी	preparation
तियारी राखणी	prepare
तियार	prepared
पेली स्यूं सोच्योड़ो	preposition
मौजूदगी	presence
तोहफो	present
आजकाल	present
मौजूद	present
प्रस्तुत करणो	presentation
सामअर राखणो	preserve
अध्यक्ष	president
दबाणो	press
प्रेस	press
दबाव	pressure
जताणो	pretend
घणो	pretty
सोवणो	pretty
प्रतिबंध	prevent
पूराणत्यो	previous
शिकार करणो	prey
कीमत	price
गरभ	pride
पंडतजी	priest
सरूआती	primary
परथम	prime
राजकुमारी	princess
सिद्धांत	principal
प्रधान अध्यापक	principal
सबस्यूं पेली	prior
सबस्यूं पेली	priority
जेळ	prison
लुखा-छूपा'र	privacy
खुद रौ	private
विशेस अधिकार	privilege
इनाम	prize
हो सकैै है	probably
समस्या	problem
परकिरिया	procedure
आग्ग बढ़णो	proceed
परगती	process
अदालती दावो	process
पैदा करणो	produce
उत्पाद	product
पैदा होणो	production
पेशो	profession
पेशा ऊँ	professional
प्रोफाइल	profile
फ़ायदो	profit
उंडो होणो	profound
परगती	progress
आगे चालणो	progress
परियोजना	project
परमुख	prominent
वादो करणो	promise
वादो	promise
पद माथै आगे बढ़णो	promote
परमोसन	promotion
तियार	prompt
प्रोन	prone
सर्वनाम	pronouns
बोलबा रो तरीको	pronunciation
सबूत	proof
ठीक-ठाक	proper
ठीक तिरयां स्यूं	properly
गुण	properties
सम्मपति	property
प्रस्ताव	proposal
आसा	prospect
समृद्धि	prosperity
खुशहाली	prosperous
बचाणो	protect
गर्व	proud
साबित करणो	prove
उपलब्ध कराणो	provide
मौका पर सामान दिवाणो	provided
रियासत	province
प्रावधान	provision
कोमलता स्यूं	puberty
जनता	public
खींचणो	pull
कोळो	pumpkin
टैम पर काम करणो	punctual
पढ़बाला टाबर	pupil
खरीदारी	purchase
शुद्ध	pure
बैंगणी	purple
मतलब	purpose
बटुओ	purse
पाण री तरकीब	pursue
काम-काज	pursuit
धक्को	push
नीचे मेलो	put
योगिता	qualification
गुणवत्ता	quality
कतरो	quantity
सबस्यूं न्यारो राखनो	quarantine
लड़ाई करणी	quarrel
लड़ाई	quarrel
चोथाड़ो	quarter
केचुओ	Quechua
राणी	queen
अटपटो	queer
सवाल	query
प्रश्न	question
कतार में लागणो	queue
सबस्यूं ऊंचो	queue
जल्दी	quick
बेगो	quickly
चुपच्याप	quiet
काम्बळ	quilt
बिल्कुल चुप	quit
बिल्कुल	quite
पूरी तरयां स्यूं	quite
परसन-उत्तर	quiz
भाव की पर्ची	quotation
बात राखणी	quote
हवालो देणो	quote
किण रा बिचार	quotes
खिरगोस	rabbit
दौड़	race
जाति	race
वंश	race
रीस	rage
बरसात	rain
उठणो	raise
भेळो करणो	raise
ऊठायो	raised
भाजणो	ran
कोई भी	random
सीमा	range
तेज	rapid
खातो सो	rapidly
सबस्यूं न्यारो	rare
कणा काव	rarely
खरोंचा	rash
उन्दरो	rat
भाव	rate
ई कै अलावा	rather
अनुपात	ratio
दिमाग स्यूं	rational
काचो	raw
पाछो	re
पो'च	reach
पूँछ ग्यो	reached
परतिउत्तर	reaction
पढ़णो	read
पढ़णो	reading
तियार	ready
हकीकत	real
सांच्याणी	reality
समझणो	realize
ऐ'सास करणो	realized
साच्याणी	really
लेरलो	rear
कारण	reason
वाजिब	reasonable
याद कराणो	recall
परची	receipt
मिल ग्यो	receive
प्राप्त करणा	received
अबार हि	recent
हाल कै मांय	recently
सुवागत आळी जिग्या	reception
खाणो बणाबा को तरीको	recipe
लापरवाह	reckless
मनेड़ो	recognition
पै'चाण	recognize
अनुशंसा करना	recommend
अनुसासन रै मांय	recommended
अभिलेख	record
लिखणा	record
पाछो लेणो	recover
वसूल करणो	recovery
आयत	rectangle
लाल	red
भुनाणो	redeem
पाप ऊँ मुक्ति	redemption
कम करणो	reduce
जरुरी कोनी	redundant
रेफर	refer
हवालो	reference
पाछो आणो	reflect
पळको	reflection
डटे रेणा	refrain
फ्रिज	refrigerator
रिप्या पाछा आणा	refund
सवीकार नी करणो	refuse
नटणो	refused
सम्मानित	regard
बिका बारा मं	regarding
बिना ध्यान कै	regardless
धन्यवाद	regards
कांकड़	region
बहीखाता	register
पछतावो	regret
लगातार	regular
लगतमार	regularly
मना करणो	reject
जोड़णो	relate
जुड़ाव	related
संबंध	relationship
कै संबंध मं	relative
रिश्तेदार	relative
सगा- सम्बन्धी	relatives
सुस्ताणो	relax
छुटकारो मिलणो	release
रिहा करणो	release
छोड देणो	released
संबंधित	relevant
भरोसाआळो	reliable
राहत	relief
छोड द्यो	relieve
चित्या नीं करणी	relieved
धर्म	religion
धरम स्यूं जुड़ेड़ो	religious
बिना इच्छा कै	reluctant
भरोसो करणो	rely
बचियोड़ी	remain
बचेड़ो	remaining
बढ़िया	remarkable
इळाज रो तरीको	remedy
याद राखणो	remember
याद करणो	remind
याद दिराबो	reminder
आंतरा स्युं	remote
हटाणो	remove
देणो	render
किरायो	rent
ठीक कराणो	repair
दुबारा करणो	repeat
बदलणो	replace
जवाब	reply
जवाब देणो	reply
सूचना	report
विवरण	report
प्रतिनिधित्व करणो	represent
इज्जत	reputation
बिनती	request
परारथना	request
जरूरत	require
जरूरत	required
बचाणो	rescue
शोध	research
इकसार	resemble
झााळ	resentment
आरक्षण	reservation
बचार राखणो	reserve
अठ्यां को रेबा आळो	resident
पद छोड़णो	resign
लचिलो	resilience
लचीला	resilient
बिरोध करणो	resist
रूकाव	resistance
सौगन	resolution
समाधान करणो	resolve
रिसोर्ट	resort
संसाधन	resources
आदर करणो	respect
इज्जत देणी	respect
जवाब देणो	respond
जवाब	response
जिम्मेवारी	responsibility
जवाबदार	responsible
अराम	rest
आत्मा नै शांति मिले	rest in peace
रेस्टोरेंट	restaurant
पाछो ल्याणो	restore
प्रतिबंध लगाणो	restrict
फैसलो	result
परिणाम	results
पाछो चालू करणो	resume
खुलो सामान बेचणो	retail
बणायो राखणो	retain
कै बारा मं बिचार	retention
नौकरी स्यूं उतरेड़ा	retired
पाछै हटणो	retreat
पाछो लेवो	retrieve
पाछौ देणो	return
उघाड़	reveal
खुलासो	revealed
बदलो	revenge
आय	revenue
उल्टो	reverse
समीक्षा	review
समीक्षा करणो	review
दोहराबो	revise
दोहराणो	revision
करांति	revolution
ईनाम	reward
लय	rhythm
पांसळी	rib
चावळ	rice
रईस	rich
छुटकारों	rid
सवारी करणो	ride
सवारी	ride
बकवास	ridiculous
सही	right
दायनो	right
अभी	right now
पाँच	rigid
अँगूठी	ring
कुरलो करणो	rinse
लड़ाई- झगड़ो	riot
फाड़णो	rip
चीरणों	rip
पाक्योड़ो	ripe
उगणा	rise
उठणा	rise
खतरो	risk
खतरो उठाणो	risk
बराबर को	rival
नदी	river
सड़क	road
तळणो	roast
चंगो	robust
डूंगरी	rock
रॉड़	rod
किरदार	role
गुड़णा	roll
छात	roof
कमरो	room
जड़	root
जेवडी	rope
बास्योड़ो	rotten
आयो-गियो	rough
अंदाज रै हिसाब स्यूं	roughly
गोळ	round
रास्तो	route
रोज को टेम	routine
कतार	row
रगड़णो	rub
रबड़	rubber
बकवास	rubbish
कळडावण	rude
दरी	rug
बर्बाद करणो	ruin
नियम	rule
राज करबालो	ruler
नियम	rules
दौड़णा	run
भागणो	running
गाँव	rural
सबस्यूं बैगो	rush
भीड़-भड़क्को	rush
बोरो	sack
शुद्ध	sacred
त्याग करणो	sacrifice
सुरक्सित	safe
सुरक्षा स्यूं ज्याजो	safe flight
सुरक्षा	safety
साधु	sage
खेणो	said
पाणि मं यात्रा	sail
नाव चलानो	sailing
कारण	sake
तनखा	salary
बिक्री	sale
सैमन मछली	salmon
नमक	salt
इकसार	same
मं भी ओ सोच रियो हूं	Same here
नमूनो	sample
रेत	sand
संस्कृत	Sanskrit
तानो मारणो	sarcastic
गळती	sassy
बेठ्यो	sat
धाप	satisfaction
संतुष्ट	satisfied
थयावस	satisfy
संतुष्ट करबा आळो	satisfying
सनिवार	Saturday
मांस रो सॉसेज	sausage
असभ्य	savage
बचावणो	save
देखो	saw
बोलणो	say
इस्कैल	scale
घोटालो	scam
निसाण	scar
पूरो कोनी पड़ै	scarce
डरपेड़ो	scared
कपड़ों	scarf
भयानक	scary
बिखरेड़ो	scattered
सीन	scene
हरयो- भरयो	scenery
सुगंध	scent
कार्यक्रम	schedule
सूची बणाणो	schedule
इस्कूल	school
बिज्यान	science
बिज्ञानिक	scientist
बिज्ञानिक	scientists
कतरनी	scissors
हड़कणो	scold
दायरो	scope
नम्बर	score
कतरन	scrap
खरोंच	scratch
चिल्लाणो	scream
स्क्रीन	screen
पेच	screw
लिखियोड़ी खाणी	script
समदर	sea
बंद	seal
खोज़णो	search
मोसम	season
जगाँ	seat
दूजो	second
थारे म्हारे बीच	secret
भाग	section
सुरक्षित राखणो	secure
सुरक्षा	security
देखो	see
फेर मिलशयाँ	see you
पाछै मिलस्यां	see you later
बेगा मिलस्यां	see you soon
काल मिलस्यां	see you tomorrow
बीज	seed
गुजरणा	seek
लाग्णो	seem
लागरयो है	seems
देख्यो	seen
जब्त	seize
जब्ती करणो	seizure
कदै-काव	seldom
चुनाव करणो	select
खुद	self
खुद स्यूं ठीक करणो	self healing
खुद री सोचणो	selfish
बेचणो	sell
भेजणो	send
मन्नै थै आपरी फोटु भेजो	send me your picture
बड़ो	senior
ज्ञान	sense
कठोर	sensible
नाजुक	sensitive
भेज्यो	sent
वाक्य	sentence
वाक्य	sentences
न्यारो	separate
सेपेडी	Sepedi
सितंबर	september
क्रम ऊँ	sequence
शृंखला	series
गंभीर	serious
गम्भीरता ऊँ	seriously
हिडो करणों	serve
सेवा	service
टेम	session
लगाणो	set
एक जिग्या	set
स्थापित करणो	set up
सेटिंग	setting
निपटाणो	settle
सात	seven
सत्रह	seventeen
सत्तर	seventy
भोत सारा	several
गम्भीर	severe
सिलाई करणी	sew
ह	sh
छाया	shade
छांया	shadow
हलाणो	shake
करणो	shall
गुदळो	shallow
सरम	shame
अकार	shape
साझा	share
किनारी	sharp
बा	she
उण रै पाक्ती	she has
बा है	she is
आसरो	shed
ललडी	sheep
चादरों	sheet
आल्यो	shelf
संख	shell
बसेरो	shelter
शील्ड	shield
बदळाव	shift
चिलको	shine
ज्हाज	ship
ठीडे पुगाणो	shipping
बूर्शेट	shirt
जूता	shoes
गोली मारणो	shoot
दुकान	shop
खरीददारी	shopping
किनारो	shore
नाटो	short
कमी	shortage
गोळी मारणी	shot
निसानो	shot
चाहे	should
कांधो	shoulder
रोळआ करणो	shout
दिखाणा	show
परदरसन	show
मन्नै दिखावो	show me
फ़ुँआरो	shower
झींगा	shrimp
छोटो हुणो	shrink
च्युप रेणो	shut
चुप हु ज्या	shut up
सरमाणो	shy
भाण-भाई	sibling
भाई-भाण	siblings
बीमार	sick
कानी	side
आह	sigh
आंख्यां देख्यो	sight
घूमबा की जिग्या देखणी	sightseeing
हस्ताक्सर	sign
दस्तख़त	signature
भोत आवश्यक	significant
च्युप	silence
चिप च्याप	silent
रेशम	silk
बावळी बात	silly
चाँदी	silver
इकसार	similar
भोलो आदमी	simp
सीदो	simple
इक्क साग्ग हि	simultaneously
कै बाद स्यूं	since
ईमानदार	sincere
ईमानदारी ऊँ	sincerely
गाणो	sing
गायक	singer
अकेलो	single
नाळो	sink
डूबणो	sink
सीरीमान	Sir
भाण	sister
भोजाई	sister in law
बैठणो	sit
साइट	site
हालत	situation
छै	six
सोलह	sixteen
साठ	sixty
अत्तो बड्डो	size
कौशल	skill
कौसल	skills
चामडी	skin
चिपियोड़ो	skinny
छोड़णो	skip
घघरी	skirt
आसमान	sky
गुलाम	slave
सोणा	sleep
सोणो	sleeping
ज्यादा सोबालो	sleepy
बाँवाँ	sleeve
टूकड़ो	slice
स्लाइस	slice
तिसलणो	slide
थोड़ो	slightly
पतलो	slim
तिसलणो	slip
ढळाण	slope
जिग्या	slot
होले होले	slow
धीरे सी	slowly
छोटो	small
बुद्धिमान	smart
सुगन	smell
मुस्कान	smile
मुस्कुराणा	smile
धुआँ	smoke
चीकणो	smooth
कलेवो	snack
घोंघा	snail
सांप	snake
फ़ोटू	snap
बरफ	snow
तो	so
भोत फूटरी	so cute
घणो दूर	so far
पाणी मं डूबाणी	soak
स्याबण	soap
शांत	sober
फुटबाल	soccer
सामाजिक	social
समाज	society
जुराब	socks
कोमल	soft
सॉफ्टवेयर	software
माटी	soil
बिके ड़ो	sold
बिक्योड़ो	sold out
सैनिक	soldier
अकेला	sole
कल्डो	solid
हल	solution
हल करणो	solve
थोड़ो	some
कोई भी मिनख	somebody
कियां-जियां	somehow
कोई भी	someone
थोड़ो़ घणो	something
कदै-कदै	sometimes
गीत	song
बेगो	soon
भोत दोरो	sophisticated
सोरानी	Sorani
घाव	sore
पीड़ा	sore
गळा मं खरास	sore throat
दुख	sorrow
माफी	Sorry
जिस्यो	sort
ढूंढयो	sought
अंतरआत्मा	soul
जीवनसाथी	soulmate
आवाज	sound
सूप	soup
खाटो	sour
साधन	source
दक्षिण	south
आकास	space
बिना चाइजतो ईमेल	spam
टेम	span
इस्पेन री भासा	Spanish
बचाणो	spare
फालतू	spare
बोलना	speak
खास	special
परजाती	species
विशेषकर	specific
शानदाार	spectacular
भासण	speech
चिप-च्याप	speechless
रफ़्तार	speed
उच्चारण करणो	spell
खरच करणो	spend
खरच कर दिया	spent
मसाला लो	spicy
कांटो	spike
घुमाणों	spin
पालको	spinach
बूरी आत्मा	spirit
थूंकणो	spit
भोत बढ़िया	splendid
टुकड़ा करणा	split
बांटणो	split
कोजो करणो	spoil
खराब	spoiled
लगातार	spontaneous
चम्मच	spoon
दाग	spot
मोटियार-लुगाई	spouse
फैलाणो	spread
इस्पिरिंग	spring
बसंत	spring
चौखानो	square
रस काडणो	squeeze
स्क्विड	squid
व्यंग्य	squid
गिल गिटारि	squirrel
छूरो घोपणो	stab
एक जगा	stable
घणा सारा	stack
साथी करमचारी	staff
ओस्था	stage
धब्बो	stain
पेडयाँ	stairs
दांव पर लगाणो	stake
डाळो	stalk
दुकान	stall
ईस्टाम्प	stamp
खड़ो हुणो	stand
ठैराव	stand
माणक	standard
तारो	star
सरू	start
सरू करियोड़ो	started
बिना खाणा-पिणा रै	starving
परदेस रै वास्ते	state
परदेस	state
खियोड़ी बात	statement
टेसण	station
मूर्ति	statue
दरजो	status
डटणा	stay
रुकणा	stay
ध्यान स्यूं रेवो	stay safe
एक जिग्या रुकियोड़ो	steady
मांस	steak
चोरी करणो	steal
भाप	steam
इस्टील	steel
खड़ी ढलाण	steep
तणो	stem
कदम	step
चिपणा	stick
भाटो सो हुणो	stiff
अबार तण	still
रुक्योड़ो	still
डंक मारणो	sting
कंजूस	stingy
हलाणो	stir
कोठ्यार	stock
चोरयोड़ो	stolen
पेट	stomach
भाटो	stone
खड़ो हुणो	stood
ईस्टूल	stool
डटणा	stop
भण्डारण	storage
भेळो करणो	store
आँधी मेह	storm
काणी	story
चूल्हो	stove
सीधो	straight
सटीक	straightforward
छाणनो	strain
अणजाण	strange
अनजाण	stranger
रणनीति	strategy
फूस	straw
इस्ट्रोबेरी	strawberry
धारी	streak
धारा	stream
गळी	street
तागत	strength
तनाव	stress
खिंचणो	stretch
कळडो	strict
हड़ताल	strike
तार	string
पट्टी	strip
कोशिश करणो	strive
दोरो पड़णो	stroke
ताकतवर	strong
भीडणो	struck
ढांचो	structure
परेसानी	struggle
संघर्स करणो	struggle
संघर्ष करणो	struggling
जिद्दी	stubborn
फंसणा	stuck
विद्यार्थी	student
पढ़ाई करणा	study
पढ़ाई	study
पढ़ाई	studying
माल-मसालो	stuff
जबरदस्त	stunning
पागल	stupid
इस्टाइल	style
बिषय	subject
जमा करावणो	submission
जमा	submit
कारक	substance
बदळदियो गियो	substitute
कठिन	subtle
सफल हुणो	succeed
सफलता	success
सफल	successful
जियां की	such
जियाँ कि	such as
चूसणो	suck
एकदम स्यूं	sudden
एकदम स्यूं	suddenly
दुख पाणा	suffer
दुख होणो	suffering
पर्याप्त	sufficient
चिणी	sugar
सुझाव देणो	suggest
सुझाव	suggestion
पोसाक	suit
अनुकूल	suit
लायक	suitable
सूटकेस	suitcase
जोड़णो	sum
सारांश	summary
उंध्याळो	summer
सम्मेलण	summit
सूरज	sun
दीतवार	sunday
तावड़ो	sunny
दिन छिपणो	sunset
तावड़ो	sunshine
बहुत चोखो	super
बढ़िया	superior
सुपरवाइजर	supervisor
सुपर	supper
रसद	supply
दूसरा नै सामान देणो	supply
मदद	support
समर्थन	support
सोचणो	suppose
मान ल्यो	supposed
पक्को	sure
तळ	surface
रीस	surge
ओपरेसन	surgery
उपनाम	surname
भोचक्को	surprise
हैरानी	surprised
समरपण करणो	surrender
चारूं बांडे	surrounding
निगा राखणी	surveillance
सर्वे	survey
सर्वे करणा	survey
जिंवतो रेणो	survive
संदिग्ध आदमी	suspect
सक करणो	suspect
जगा ऊँ हटाणो	suspended
कौतिक	suspicious
बणायो राखणो	sustain
संभाळ सकणो	sustainability
टिकाऊ	sustainable
लूट	swag
निगळणो	swallow
बदलणो	swap
सोगन	swear
पसीनो	sweat
सुटर	sweater
भुआरी  काडणो	sweep
मीठो	sweet
चोखा सुपना देखो	sweet dreams
मीठाई रो सोकीन	sweet tooth
प्रिय	sweetheart
सूजन	swell
सुजन	swelling
तिरी करणी	swim
तिरी करणी	swimming
झूलणो	swing
झूलो	swing
खटको	switch
बदलणो	switch
सूजेड़ो	swollen
तलवार	sword
प्रतीक	symbol
दुख मं सारो देणो	sympathy
लक्षण	symptoms
सिस्टम	system
सारणी	table
टेबल	table
जूझना	tackle
टैग	tag
पूँछ	tail
ले लयो	take
लियावो	take away
ध्यान राखज्यो	take care
लेणो	take off
लियो	taken
बातचीत	talk
बतोवळ करणी	talk
बड़बोलो	talkative
लंबो	tall
टूँटी	tap
पीठ थपथपाणो	tap
फीतो	tape
निसाणो	target
लक्ष्य	target
काम	task
स्वाद	taste
चांखणो	taste
सुआद	tasty
सोच्यो	taught
चाय	tea
पढ़ाणो	teach
माड़साब	teacher
टीम	team
फाड़नो	tear
आँसुडा	tears
चिडाबो	tease
तकनीक	technology
दांत	teeth
बतावो	tell
मन्नै बतावो	tell me
झाळ	temper
तापमान	temperature
मिन्दर	temple
अस्थायी	temporary
दस	ten
दस हज़ार	ten thousand
किरायेदार	tenant
झुकणो	tend
की तरफ झुकाव	tendency
नाजुक	tender
चिंत्या हुणो	tense
तनाव	tension
तंबू	tent
अंदाज स्यूं	tentative
टेम	term
शर्तां	terms
खुंखार	terrible
कमाल को	terrific
इलाको	territory
परीक्षा	test
जाँचणो	test
सन्देस	text
जण	than
धनबाद	thank
धनवाद	thank you
थारा माल की जांच कर रया हां, जठै तण डटबा कै तांई थारो धनवाद	Thank you for your patience while we investigate shipment
भोत-भोत धनवाद	thank you so much
थांको भोत-भात धनवाद	thank you very much
धनवाद	thanks
एप नै काम मं लेण रै वास्ते धनबाद	Thanks for using our app
बो	that
यानी कि	that is
बढ़िया बात है	that's good
चोरी	theft
बांकी	their
बै	them
थीम	theme
बो अपणे आप	themselves
जणां	then
लिखेड़ा आंक	theory
बठै	there
बठै है	there are
बठै है	there is
ई कारण	therefore
अै	these
बे	they
बै है	they are
पतळो	thick
चोर	thief
जाँघ	thigh
माड़ो	thin
चीज	thing
चीजां	things
सोचणो	think
तीसरो	third
तिसायो	thirsty
तेरह	thirteen
तीस	thirty
ओ	this
ओ है	this is
सावळ	thorough
चोखी तरह ऊँ	thoroughly
बानै	those
कणां-कणां	though
बिचार	thought
पुराणा टेम रै मांय	thought
बिचार करबा आळो	thoughtful
बिचार	thoughts
हज़ार	thousand
धागो	thread
धमकाणो	threat
धमकाणो	threaten
तीन	three
ड्योढ़ी	threshold
रोमांचित	thrilled
फलनो	thrive
गळो	throat
कै बिच मूं	through
बिचारजोग	throughout
बगाणा	throw
अँगूठो	thumb
गड़गड़ाहट	thunder
बिस्पतिबार	Thursday
तो	thus
सही निशान लगानो	tick
ज्वार-भाटा	tide
साफ-सुथरो	tidy
गळपट्टो	tie
गांठणो	tie
चीतो	tiger
कस्टा	tight
तिग्रिन्या	Tigrinya
समय	time
डरापोक	timid
छोटो	tiny
बख्शीश	tip
सलावां	tips
थाकेड़ो	tire
मांदो	tired
उत्तक	tissue
शीर्षक	title
कै ताणी	to
होबा के लिए	to be
सेकणो	toast
आज	today
मिंढका रो बच्च्यो	toddler
पग्ग को अँगूठो	toes
साथ रै मांय	together
लेट्रिंग	toilet
कियो	told
सेण शीलता	tolerance
सैण करणो	tolerate
टमाटर	tomato
काल	tomorrow
जुबान	tongue
आज रात	tonight
भोत अधिक	too
ले लियो	took
औजार	tool
औजार	tools
दांत	tooth
सबस्यूं ऊपर	top
विषय	topic
फाटणों	torn
सजा देणी	torture
जोड़	total
हाथ लगाणो	touch
दोरो टेम	tough
टूर	tour
कै बांडे	toward
की तरफ	towards
तोलियो	towel
कस्बा	town
जहरीलो	toxic
बेरो पाड़नो	trace
गेलो(रास्तो)	track
बौपार-धंधो	trade
लेण-देण	trade
परंपरा	tradition
परंपरागत	traditional
यातायात	traffic
पगडंडी	trail
रेलगाड़ी	train
प्रशिक्षण	training
खाशियत	trait
लकसण	traits
दूसरी जगा भेजणो	transfer
फैलाव	transition
अनुवाद	translate
आर-पार	transparent
परिवहन	transport
आबा-जाबा रो साधन	transportation
जाल	trap
कचरो	trash
सदमो	trauma
जातरा	travel
ट्रे	tray
खजानो	treasure
बरताव करणा	treat
इलाज	treatment
रूँखड़ो	tree
जोरको	tremendous
चलण	trend
आजमाइस	trial
चाल	trick
कोसिस करी	tried
खटको	trigger
चलाणो	trigger
कंटाई-छंटाई करणी	trim
सैर	trip
कस्टाई	trouble
पेंटा	trousers
ट्रक	truck
सही	true
डाली	trunk
न्यास	trust
भरोेसो	trust
साँंच	truth
कोसिस करणी	try
त्सोंगा	Tsonga
नळी	tube
मंगलवार	Tuesday
टूशन	tuition
तुर्की	turkey
हल्दी	turmeric
बदळणो	turn
मोड़	turn
काछबो	turtle
पढ़ाबा आळा मास्साब	tutor
बारह	twelve
बीस	twenty
इक्कीस	twenty-one
ट्वी	Twi
दो बार	twice
घुमाव	twist
दोय	two
परकार	type
ठेठ	typical
भुंडीशान को	ugly
आखरी	ultimate
छांगी	umbrella
नीं कर सकै	unable
काकाजी	uncle
बेहोस	unconscious
कै तळै	under
तळे	underneath
कम मानणो	underrated
समझ गो	understand
समझेड़ो	understood
बदकिस्मती	unfortunately
वर्दी	uniform
सब स्यूं न्यारो	unique
इकाई	unit
विश्वविद्यालय	university
बिना जाणकारी रो	unknown
जणा तक	unless
जठै तक	until
असामान्य	unusual
उपरली तरफ	up
सो थां'पर है	up to you
नुवो	update
तियार रेणो	update
परगती करणो	upgrade
तरक्की	upgrade
ऊंचो	upon
दुखी होणो	upset
सेर	urban
तेज इच्छा	urge
प्रारथना करणा	urge
जरूरी	urgent
आपां	us
काम मं लेणो	use
उपयोग	use
काम मं लियेड़ो	used
जरूरतमंद	useful
किं कामको नहीं हुणो	useless
आम तौर पर	usual
आमतौर पर	usually
काम मं आबा का हिसाब स्यूं	utility
छुट्टी	vacation
टीकाकरण	vaccination
सूई लगाणी	vaccine
खाली होणो	vacuum
साफ कोनी	vague
चालणियो	valid
घाटी	valley
काम को	valuable
कदर करणी	value
कीमत	value
कई भांत रा	variety
न्यारो-न्यारो	various
भोत सारा	various
अलग हुणो	vary
गुलदान	vase
विशाल	vast
साग-भाजी	vegetable
सब्जियां	vegetables
गाड़ी़-घोड़ा	vehicle
बेचबालो	vendor
झैर	venom
उद्ययम	venture
कार्यक्रम कि जग्गाँ	venue
सत्यापित करणो	verify
सारी चिजाँ मं चत्तर	versatile
भांत	version
खड़्यो	vertical
बोळो सारो	very
भोत बढ़िया	very good
जहाज	vessel
क सग्ग	via
मै'सूस होणा	vibe
अनुुभूति	vibes
बेकार मिनख	vicious
बापड़ो	victim
वीडियो	video
देखणो	view
गांव	village
दुष्ट	villain
सिरका	vinegar
विंटेज	vintage
मारा कुटी	violence
मारा- कुटी करणो	violent
फैलाळी	viral
कुँआरी	virgin
आभासी	virtual
गुण	virtue
दृष्टि	vision
मिलणो	visit
देखबा आणो	visit
चितर	visual
जीवनाधार	vital
जागतो-फिरतो	vivid
शब्दावली	vocabulary
उवाज	voice
खाली	void
लम्बाई चोड़ायी	volume
स्वयंसेवक	volunteer
उल्टी	vomit
उल्टी करणो	vomit
आलोचना करण आळो	vulnerable
दिहाड़ी	wage
वेतन-भत्ता	wages
संकड़ो	waist
कळाई	waist
रूको	wait
वैटर	waiter
उडिकणो	waiting
जागता रैणा	wake
जागणो	wake up
चलणा	walk
जाणा	walk
टेलणा	walking
भींत	wall
बटुओ	wallet
घूमणो	wander
चाहणो	wanna
चाऊं	want
चाईजतो	wanted
लड़ायी	war
कपडाँ कि अलमारी	wardrobe
गोदाम	warehouse
तातो-तातो	warm
गरमा-गरम	warm
सावचेत करणो	warn
चेतावनी	warning
योद्धा	warrior
हा	was
धोणो	wash
उडाणो	waste
नास	waste
घड़ी	watch
देखणो	watch
पाणी	water
मतीरो	watermelon
लहर	wave
गेलो	way
म्है	we
म्है हां	we are
मं कोनी कर सकूं	we can
माड़ो़	weak
कमज़ोरी	weakness
दौलत	wealth
पिसा लो	wealthy
परणो	wear
पेरेड़ो	wearing
मौसम	weather
ब्याव	wedding
बुधवार	Wednesday
खर-पतवार	weed
हप्ता	week
सप्ताह को अंत	weekend
लादणो	weight
बजनदार	weight
चिन्ता	weird
सुवागत	welcome
कल्याण	welfare
अछ्या	Well
कुओ	Well
चोखो करयो	well done
जाणो	went
थै	were
पश्चिम	west
आलो	wet
वेल	whale
कांई	what
थै कियां हो	what about you
थै कांई करो हो	what are you doing
थै अबार कांई कर रया हो	what are you doing now
थै अबार काईं कर रिया हो	what are you doing right now
थे कायीं करो हो	what do you do
थे जीवन जिबा ताँयी कायीं करो हो	what do you do for a living
थारो कांई मतलब है	what do you mean
थै काईं चावो हो	what do you want
कांई हुयो	what happened
कांई है	what is
ओ काईं है	what is this
थै काईं काम करो हो	what is your job
थारौ नाम कांई है	what is your name
काईं हो रियो है	what's up
थारो काईं नाम है	what's your name
जिको भी	whatever
गिंऊ	wheat
पहियो	wheel
कणां	when
जद कदे भी	whenever
किजा	where
थै कठै हो	where are you
थै कठै स्यूं हो	where are you from
थै अबार कठै हो	where are you now
थे कठ बिराजो	where do you live
कठै है	where is
जबकि	whereas
अगर	whether
कुणसो	which
जबकि	while
कानाफुसी करणी	whisper
सीटी	whistle
धोळो	white
कुण	who
थै कुण हो	who are you
कूँण है	who is
ओ कुण है	who is this
सापतो	whole
किको	whom
कुणको	whose
क्यूं	why
क्यो नीं	why not
उधमी	wicked
चौड़ो होणो	wide
विधवा	widow
चौड़ो	width
घराळी	wife
जंगळी	wild
चाह	will
इच्छा करणा	willing
जितणो	win
भाळ	wind
खिड़की	window
सूँटो	windy
दारू	wine
सियाळो	winter
पुंछणो	wipe
तार	wire
बुद्धिमता	wisdom
दिमागदार	wise
चाहत	wish
इच्छा	wish
थानै कामयाबी मिले	wish you all the best
डाक्कण	witch
रै साथ	with
बारे काढ़णा	withdraw
निकालणो	withdrawal
रै मांय	within
बिके बिना	without
सबूत	witness
गवाह	witness
मजाकी आळो माहोल	witty
गादड़ो	wolf
महिला	woman
लुगाई	woman
लुगाई	women
जीतणो	won
कोनी हुवै	won't
चौकणो	wonder
जोरदार	wonderful
काठ	wood
ऊन	wool
शबद	word
सबद	words
काम	work
चालू राखणो	work
कसरत करणो	work out
काम करणो	working
संसार	world
कीड़ो	worm
पेरेड़ो	worn
चिन्त्या	worried
चिंता	worry
सबस्यूं बेकार	worse
पूजा	worship
भुंडीसानको	worst
मोल	worth
ई काबिल हो	worth it
रै लायक	worthy
चा'णो	would
घाव	wound
गजब	Wow
पळेटणो	wrap
झाळ	wrath
पूँछयो	wrist
आंक मांडणो	write
अठै मांडो	Write here
लिख रियो है	writing
लिखणो	written
गळत	wrong
लिख लियो है	wrote
गज	yard
उबासी	yawn
उबासी लेणो	yawn
हम्बै	Yeah
साल	year
सालां तक	years
उबसणा	yeast
चिल्लाणो	yell
पिलो	yellow
हां	Yes
हाँ बेबी	yes baby
हाँ बाल्ला	yes dear
हाँ, म्हारी प्यारी	yes honey
हां म्हारा प्यार	yes my love
हां एकदम सही	yes of course
बीतेड़ो काल	yesterday
हाल तक	yet
निपज	yield
थै	you
थै	you are
थै सोवणा हो	you are beautiful
थै भोत सोवणा हो	you are so beautiful
थांको सुवागत है	you are welcome
थै कर सको हो	you can
थैै जाणो हो	You know
थान्न भी	you too
थांरो सुवागत है	you're welcome
जुवान	young
थारो	your
थांको स्वागत है	your welcome
थे खुद	yourself
जवान	youth
थारो सुवागत है	you’re welcome
भोत सुवाद	yummy
जीरो	zero
