i	a
kancinyane	a little
kakhulu	a lot
tshiya	abandon
tshiyiweyo	abandoned
amandla	ability
ukwanelisa	able
mayelana	about
phezulu	above
phetsheya	abroad
ukungabi khona	absence
phuths	absent
munca	absorb
inala	abundance
kunengi	abundant
ethuka	abuse
inhlamba	abuse
vuma	accept
imvumo	access
nge	access
ingozi	accident
qeda	accomplish
kufeziwe	accomplished
iakhawunti	account
ukuqonda	accuracy
sole	accused
ubuhlungu	ache
feza	achieve
vuma	acknowledge
umngane	acquaintance
thola	acquire
zuze	acquired
ukuthenga	acquisition
phetsheya	across
imisebenzi	activities
umsebenzi	activity
okwangempela	actual
eqinisweni	actually
ukwengeza	add
ukwengeza	addition
engeziweyo	additional
ikheli	address
tshumayela	address
ukwanela	adequate
lungisa	adjust
ngenisa	admit
thatha	adopt
phucukile	advanced
isaziso	advertisement
ukukhangisa	advertising
iseluleko	advice
eluleka	advise
indaba	affair
uthando	affection
thengekayo	affordable
esaba	afraid
emva	after
imini	afternoon
emuva	afterwards
futhi	again
ubudala	age
ulaka	aggressive
vuma	agree
isivumelwano	agreement
ezolimo	agriculture
phambili	ahead
uncedo	aid
inhloso	aim
umoya	air
utshwala	alcohol
phila	alive
konke	all
kulungile	all right
fisela inhlanhla	all the best
vumela	allow
vunyelwa	allowed
phose	almost
wedwa	alone
Kulungile	Alright
njalo	also
lanxa	although
njalonjalo	always
ngi	am
mangalisa	amazing
ngacaci	ambiguous
phakathi	amid
phakathi	among
phakathi kwethu	among us
inani	amount
hlekisayo	amusing
i	an
okhokho	ancestors
ndala	ancient
la	and
lawe	and you
ingilosi	angel
ulaka	anger
thukuthele	angry
inyamazana	animal
inqagala	ankle
umbiko	announcement
ukucaphula	annoy
caphuka	annoyed
hlupha	annoying
enye	another
phendula	answer
impendulo	answer
melela	anticipate
uvalo	anxiety
uvalo	anxious
loba ngubani	anyone
loba yini	anything
xolisa	apologize
sobala	apparent
ukuncenga	appeal
thutsha	appear
thutshe	appeared
indlala	appetite
apula	apple
isicelo	application
beka isicelo	apply
bonga	appreciate
ukubonga	appreciation
sondela	approach
ukusondela	approach
qondileyo	appropriate
ukugunyazwa	approval
vuma	approve
vunyelwe	approved
uMabasa	april
umakhi	architect
kukhona okwenzayo	are you busy
utshadile na	are you married
utshadile kumbe awutshadanga	are you married or single
Usakhona?	Are you still there?
ukhona	are you there
indawo	area
ukuphika	argue
impikisano	argument
vuka	arise
ingalo	arm
lungisa	arrange
ukuhlela	arrangement
ukufika	arrival
fika	arrive
fikile	arrived
ubuqholo	arrogant
ubuciko	art
futhi	as well
njalo le	as well as
umlotha	ash
mahloni	ashamed
buza	ask
buze	asked
lele	asleep
isiAssamese	Assamese
ukuhlasela	assault
umhlangano	assembly
umhloliso	assessment
nceda	assist
umncedisi	assistant
inhlangano	association
cabanga	assume
ukucabangela	assumption
ku	at
kungenani	at least
dlile	ate
namathisela	attach
namathele	attached
okunamathiselweyo	attachment
ukuhlasela	attack
zama	attempt
ukuqaphela	attention
ukuheha	attract
isici	attribute
uNcwabakazi	august
babakazi	aunty
umlobi	author
amandla	authority
ikwundla	autumn
tholakalayo	available
vika	avoid
phaphama	awake
umvuzo	award
ukwazi	aware
kuyenyanyeka	awful
isiAymara	Aymara
usane	baby
insumbelume	bachelor
emuva	back
kubi	bad
isikhwama	bag
intelelo	bait
ukubhaka	bake
ibhola	ball
isiBambara	Bambara
ibhanana	banana
dubuka	bang
ibhanga	bank
ibhawa	bar
isikhumba	bark
khonkotha	bark
isisekelo	base
ukugeza	bath
indlu yokugezela	bathroom
impi	battle
qaphela	be careful
indumba	beans
thwala	bear
indevu	beard
isilo	beast
tshaya	beat
hle	beautiful
ubuhle	beauty
ngoba	because
umbheda	bed
indlu yokulala	bedroom
inyosi	bee
inyama yenkomo	beef
utshwala	beer
phambi	before
waqala	began
qala	begin
ukuqala	beginning
ziphatha	behave
ukuziphatha	behavior
ukuziphatha	behaviour
emuva	behind
ukuba	being
ukukholwa	belief
kholwa	believe
isisu	belly
bathandekayo	beloved
ngaphansi	below
ibhanti	belt
ibhentshi	bench
goba	bend
ngaphansi	beneath
inzuzo	benefit
zuza	benefit
inzuzo	benefits
eceleni	beside
ngcono	best
kufisela inhlanhla	best of luck
ngcono	better
phakathi	between
phetsheya	beyond
isiBhojpuri	Bhojpuri
ibhasikili	bicycle
khulu	big
ibhayisikili	bike
bopha	bind
inyoni	bird
ilanga lokuzalwa	birthday
luma	bite
ukuluma	bite
mnyama	black
ingqamu	blade
ingubo	blanket
ukudubuka	blast
hlanganisa	blend
busisa	bless
busisiwe	blessed
isiphofu	blind
vimba	block
igazi	blood
qhakaza	bloom
vuthela	blow
luhlaza	blue
buthundu	blunt
isikepe	boat
umzimba	body
bilisa	boil
khaliphile	bold
ithambo	bone
bhalisa	book
ugwalo	book
ibhutsu	boot
izicathulo	boots
umngcele	border
bhola	bore
diniwe	bored
dina	boring
zalwa	born
boleka	borrow
kokubili	both
hlupha	bother
imbodlela	bottle
ngaphansi	bottom
thenge	bought
eqa	bounce
imingcele	boundaries
khothama	bow
inditshi	bowl
ibhokisi	box
umfana	boy
isongo	bracelet
ingqondo	brain
ugatsha	branch
uphawu	brand
lesibindi	brave
ukwephula	breach
isinkwa	bread
qamula	break
ikhefu	break
ukudla kwekuseni	breakfast
ibele	breast
phefumula	breath
phefumula	breathe
isitina	brick
umakoti	bride
ibholoho	bridge
khazimula	bright
letha	bring
bhudi	bro
banzi	broad
ukusakaza	broadcast
ephukile	broke
qamukile	broken
umthanyelo	broom
umfo	brother
umkhwenyana	brother in law
lethe	brought
nsundu	brown
thanyela	brush
ibhakede	bucket
umngane	buddy
isibungu	bug
ukwakha	build
isakhiwo	building
yakhiweyo	built
inkunzi	bull
khahlameza	bully
thuza	bump
inqwaba	bundle
hlupha	burden
umthwalo	burden
ngcwatshwe	buried
tshisa	burn
dubuka	burst
ngcwaba	bury
ibhasi	bus
iganga	bush
ibhizinisi	business
matasatasa	busy
kodwa	but
uvevane	butterfly
isikopela	button
thenga	buy
nge	by
kenje	by the way
hamba kuhle	bye
ikhabitshi	cabbage
ikhabothi	cabinet
ikhekhe	cake
ithole	calf
biza	call
ucingo	call
ngitshayele ucingo	call me
phozisa	calm
umkhankaso	campaign
igabha	can
enzeka	can
ngeke	can't
Yekela	Cancel
umdlavuza	cancer
ubukhulu	capacity
bamba	capture
imota	car
nanza	careful
ngesineke	carefully
lomusa	caring
umbazi	carpenter
thwala	carry
qhubeka	carry on
yenza	carry out
imali	cash
umangoye	cat
gama	catch
isigaba	category
inkomo	cattle
game	caught
ukuqapha	caution
qaphile	cautious
ubhalu	cave
yekela	cease
ikhulu leminyaka	century
umcimbi	ceremony
thize	certain
sibili	certainly
incwadi	certificate
iketane	chain
isitulo	chair
ubunzima	challenge
ithuba	chance
ntshintsha	change
isiphithiphithi	chaos
izici	characteristics
ukugijimisa	chase
xoxa	chat
ingxoxo	chat
tshiphile	cheap
qila	cheat
ukuqila	cheating
khangela	check
ukukhangela	check
isihlathi	cheek
thokoza	cheer
thokozile	cheerful
isifuba	chest
hlafuna	chew
inkukhu	chicken
induna	chief
umntwana	child
ubuntwana	childhood
abantwana	children
qandayo	chill
qandisa	chill
isilevu	chin
itshokholethi	chocolate
ukukhetha	choice
khetha	choose
qoba	chop
isidludla	chubby
isonto	church
isigombolozi	circle
umumo	circumstances
isakhamuzi	citizen
idolobho	city
chasisa	clarify
udaka	clay
ukuhlanzeka	clean
cengeka	clear
obala	clear
umabhalani	clerk
hlakaniphile	clever
iklayenti	client
iliwa	cliff
khwela	climb
nombelela	clingy
iwatshi	clock
vala	close
ikhabothi	closet
ilembu	cloth
izigqoko	clothes
iyezi	cloud
fiphala	cloudy
isiphoxo	clown
iqoqo	cluster
amalahle	coal
ijazi	coat
ikhofi	coffee
qanda	cold
bhidlika	collapse
qoqa	collect
iqoqo	collection
umbala	color
imicabango eluhlaza engenambala yalala ngokufutheka	colorless green ideas slept furiously
umbala	colour
ikama	comb
inhlanganisela	combination
hlanganisa	combine
buya	come
woza lapha	come here
woza	come on
induduzo	comfort
zinza	comfortable
kuyeza masinya	coming soon
laya	command
ukuzibophezela	commit
ukuzimisela	commitment
ukuzimisela	committed
jwayelekileyo	common
ukukhuluma	communicate
ukuya emsebenzini	commute
umngane	companion
fananisa	compare
ukufanisa	comparison
uzwelo	compassion
ububele	compassionate
qomana	compete
umncintiswano	competition
ukuncintisana	competitive
khalaza	complain
isikhalazo	complaint
qeda	complete
ngokuphelele	completely
dida	complex
landela	comply
inhlanganisela	compound
ukuzwisisa	comprehension
pheleleyo	comprehensive
ikhomputha	computer
gxilisa ingqondo	concentrate
umcabango	concept
ukuqondana	concern
qonda	concern
phitsheka	concerned
isigqibo	conclusion
umumo	condition
umumo	conditions
inhlangano	conference
vuma	confess
qiniseka	confirm
ingxabano	conflict
ukudideka	confused
ukudideka	confusion
amhlophe	congrats
amhlophe	congratulation
amhlophe	congratulations
isihlanganiso	conjunction
xhuma	connect
nqoba	conquer
ukuphila	consciousness
vuma	consent
imvumo	consent
nakana	consider
bala	consistent
njalonjalo	constant
njalonjalo	constantly
ukuqunjelwa	constipation
ukwakha	construction
dla	consume
ukudla	consumption
thinta	contact
thelelwanayo	contagious
isimanje	contemporary
enama	content
umncintiswano	contest
ilizwekazi	continent
qhubeka	continue
thola	contract
ikontilika	contract
phamba	contrast
umnikelo	contribution
ukulawula	control
lula	convenience
lula	convenient
ingxoxo	conversation
ukuphenduka	convert
phenduka	convert
ukutshela	convey
umpheki	cook
pheka	cook
ukupheka	cooking
hle	cool
qanda	cool
ukubambisana	cooperation
ithusi	copper
iphakathi	core
umumbu	corn
lungile	correct
intengo	cost
utshinda	cotton
khwehlela	cough
anelisa	could
umphakathi	council
bala	count
ilizwe	country
emaphandleni	countryside
isibindi	courage
indlela	course
inkantolo	court
umusa	courtesy
umzala	cousin
inkomo	cow
igwala	coward
inkala	crab
umkenke	crack
qamula	crack
umsebenzi wezandla	craft
ikaka	crap
ukunxanela	craving
khasa	crawl
ukuhlanya	crazy
dala	create
nyenya	creep
iqembu	crew
ubusela	crime
imibandela	criteria
qakathekile	critical
ukusola	criticism
isilimo	crop
izilimo	crops
isiphamban	cross
phamba	cross
iwabayi	crow
ixuku	crowd
minyene	crowded
umqhele	crown
qakathekile	crucial
ulunya	cruel
fihliza	crush
khala	cry
singatha	cuddle
isiko	culture
ubuqili	cunning
inkomitsho	cup
ikhabothi	cupboard
umuthi	cure
elapha	cure
imali	currency
khathesi	current
khathesi	currently
isithuko	curse
ikhethini	curtain
isiko	custom
khastoma	customer
amasiko	customs
sika	cut
hle	cute
ukutshova ibhasikili	cycling
ubaba	dad
baba	daddy
nsuku zonke	daily
uchago	dairy
idamu	dam
manzi	damp
umgido	dance
ingozi	danger
ingozi	dangerous
mnyama	dark
sithandwa	darling
ilanga	date
indodakazi	daughter
ilanga	day
file	dead
isacuthe	deaf
isivumelwano	deal
thandekayo	dear
Salibonani Lonke	Dear All
Khastoma Elithandekayo	Dear Customer
Bazali Abathandekayo	Dear Parents
Mnumzane Othandekayo	Dear Sir
Bafundi abathandekayo	Dear students
Qembu Elithandekayo	Dear Team
ukufa	death
impikiswano	debate
isikwelede	debt
itshumi leminyaka	decade
ukubola	decay
otshonileyo	deceased
qila	deceive
uMpalakazi	december
nquma	decide
nqume	decided
isinqumo	decision
ukwala	decline
ehlisa	decrease
isenzo	deed
ukutshona	deep
nqoba	defeat
ukunqoba	defeat
vikela	defend
impela	definitely
incazelo	definition
phuza	delay
ukuphuza	delay
phuzile	delayed
susa	delete
ngabomu	deliberate
mnandi	delicious
injabulo	delight
thabile	delighted
hambisa	deliver
ngenkani	demanding
idimoni	demon
tshengisa	demonstrate
aliwe	denied
udokotela wamazinyo	dentist
phika	deny
umnyango	department
ukusuka	departure
sekele	depend
dangele	depressed
ukudangala	depression
ukujula	depth
chasisa	describe
isicasiso	description
inkangala	desert
isifiso	desire
fisela	desire
itafula	desk
phelelewa	despair
loba	despite
isiphetho	destiny
diliza	destroy
ukudiliza	destruction
imininingwane	detail
imininingwane	details
fica	detect
ukuzimisela	determination
nquma	determine
zimisele	determined
usathane	devil
zinikeleyo	devoted
isiDhivehi	Dhivehi
umkhuhlane wetshukela	diabetes
isihudo	diarrhea
wenze	did
ukufa	die
ukudla	diet
umehluko	difference
ahlukile	different
zima	difficult
gebha	dig
isithunzi	dignity
okhuthele	diligent
ukudla kwakusihlwa	dinner
cwilisa	dip
ngqo	direct
indlela	direction
umphathi	director
ingcekeza	dirt
ngcolile	dirty
citsha	disable
nyamalala	disappear
ingozi	disaster
lahla	discard
khupha	discharge
umthetho	discipline
thola	discover
ubandlululo	discrimination
khuluma	discuss
ingxoxo	discussion
isifo	disease
izifo	diseases
zifihle	disguise
kubi	disgusting
umganu	dish
imganu	dishes
thumela	dispatch
ukulahla	disposal
phika	dispute
umango	distance
ahlukanisa	distinguish
umkhono	district
phazamisa	disturb
umsele	ditch
cwila	dive
ezihlukahlukene	diverse
ahlukanisa	divide
ngcwele	divine
ukwahlukana	divorce
hluka	divorce
isiyezi	dizzy
yenza	do
uyangithanda na	do you love me
udokotela	doctor
idokhumenti	document
inja	dog
isiDogri	Dogri
ukwenza	doing
udoli	doll
busayo	dominant
Ungakhathazeki	Don't worry
nikela	donate
qedile	done
ubabhemi	donkey
inhlama	dough
phansi	down
hlela	draft
hudula	drag
cenga	drain
dweba	draw
ikhabothi	drawer
umdwebo	drawing
uvalo	dread
iphupho	dream
phupha	dream
isigqoko	dress
ibhola	drill
tha	drink
uiunatha	drink
ukutshayela	drive
ithonsi	drop
wisa	drop
iwile	dropped
isomiso	drought
dakiwe	drunk
omile	dry
idada	duck
ngenxa	due to
buthundu	dull
sthutha	dumb
lahla	dump
ngesikhathi	during
uthuli	dust
imfanelo	duty
ukufa	dying
munye	each
ukhozi	eagle
indlebe	ear
ngaphambili	earlier
masinyane	early
hola	earn
izindlebe	ears
umhlaba	earth
ukuzamazama komhlaba	earthquake
lula	ease
kalula	easily
empumalanga	east
lula	easy
dlana	eat
ukudla	eating
ezomnotho	economic
umnotho	economy
hlela	edit
imfundo	education
ukusebenza kuhle	efficiency
umzamo	effort
iqanda	egg
isificaminwembili	eight
itshumi lesificaminwembili	eighteen
amatshumi ayisificaminwembili	eighty
kumbe	either
indololwane	elbow
umdala	elder
abantu abadala	elderly
indlovu	elephant
itshumi lanye	eleven
vunyelwa	eligible
qeda	eliminate
phoxekile	embarrassed
amahloni	embarrassing
ukugona	embrace
thutsha	emerge
uzwelo	empathy
qonqosela	emphasis
gcizelela	emphasize
isisebenzi	employee
izisebenzi	employees
umqhatshi	employer
umsebenzi	employment
vumela	enable
ukuhlangana	encounter
khuthaza	encourage
ukuphela	end
engozini	endangered
zama	endeavor
bekezela	endure
isitha	enemy
amandla	energy
ukuxoxisa	engage
injini	engine
Isikhiwa	English
engeza	enhance
kholisa	enjoy
inkalakatha	enormous
anele	enough
qiniseka	ensure
ngena	enter
inhlangano	entity
umnyango	entrance
imvilophu	envelope
umona	envy
umqedazwe	epidemic
lingana	equal
imitshina	equipment
ukulingana	equity
kulingana	equivalent
iphutha	error
ukuphunyuka	escape
ikakhulu	especially
indaba	essay
ingqikithi	essence
qakathekile	essential
ilifa	estate
linganisela	estimate
phakade	eternal
hlolisisa	evaluate
ukuhlola	evaluation
loba	even though
kusihlwa	evening
nke	every
wonke umuntu	everybody
wonke umuntu	everyone
konke	everything
ubufakazi	evidence
okubi	evil
isiEwe	Ewe
ngqo	exact
lakanye	exactly
hlola	exam
hlola	examine
isibonelo	example
dlula	exceed
kuhle kakhulu	excellent
phandle	except
okuhlukileyo	exception
okweqileyo	excess
kakhulu	excessive
tshintshanisana	exchange
phaphathekile	excited
ukuthaba	excitement
izaba	excuse
uxolo	excuse me
enza	execute
ukubulawa	execution
qeda	exhaust
ukudinwa	exhausted
umbukiso	exhibit
umbukiso	exhibition
khona	exist
ekhona	existing
phuma	exit
qhela	expand
lindela	expect
lindele	expected
izindleko	expenses
dula	expensive
ukwenza	experience
ingcitshi	expert
chasisa	explain
isicasiso	explanation
veza	expose
veziwe	exposed
kunwetshiwe	extended
ububanzi	extent
ngaphandle	external
okwengeziweyo	extra
khupha	extract
kakhulu	extremely
ilihlo	eye
amehlo	eyes
ilembu	fabric
ubuso	face
indawo	facility
iqiniso	fact
amaqiniso	facts
ukwehluleka	fail
ahluleka	fail
ehlulekile	failed
ukwehluleka	failure
mhlophe	fair
ukulunga	fair
untokolotsha	fairy
ukukholwa	faith
ethembekileyo	faithful
ukuwa	fall
AMANGA	false
udumo	fame
fanisa	familiar
imuli	family
indlala	famine
dumile	famous
khatshana	far
ipulazi	farm
umlimi	farmer
ukumangalisa	fascinating
phangisa	fast
amafutha	fat
ebulalayo	fatal
ubaba	father
ukudinwa	fatigue
intandokazi	favourite
sabisa	fear
ukwesaba	fear
idili	feast
usiba	feather
uNhlolanja	february
tshipheka	fed up
intengo	fee
funza	feed
impendulo	feedback
ukuzwa	feel
umuzwa	feeling
inyawo	feet
umngane	fellow
ilembu	felt
owesifazana	female
uthango	fence
vundile	fertile
umkhosi	festival
thatha	fetch
umkhuhlane	fever
lutshwana	few
inganekwane	fiction
insimu	field
sabeka	fierce
itshumi lanhlanu	fifteen
amatshumi amahlanu	fifty
ukulwa	fight
ukulwa	fighting
thola indlela	figure out
gcwalisa	fill
gcwaliswe	filled
ifilimu	film
ngcolile	filthy
ekucineni	finally
ezemali	finance
thola	find
thola ukuthi	find out
inhlawulo	fine
ngcono	fine
umunwe	finger
qeda	finish
qedile	finished
umlilo	fire
ukuqina	firm
qinile	firm
kuqala	first
ibizo lokuqala	first name
inhlanzi	fish
lingana	fit
hlanu	five
lungisa	fix
ifulegi	flag
cwazima	flash
isipatalala	flat
iphutha	flaw
baleka	flee
inyama	flesh
ndize	flew
tebha	flex
tebha	flexible
ndenda	float
uzamcolo	flood
ifulawa	flour
geleza	flow
ukugeleza	flow
iluba	flower
umvimbano	flu
amanzi	fluid
ukuphapha	fly
inkungu	fog
lenkungu	foggy
goqa	fold
landela	follow
landelela	follow up
ukulandela	following
ukudla	food
isithutha	fool
qila	fool
ubuthutha	foolish
unywawo	foot
ibhola	football
Ngokwesibonelelo	For example
kwakho	for you
ibunzi	forehead
isizwe	foreign
ihlathi	forest
kokuphela	forever
khohlwa	forget
thethelela	forgive
khohliwe	forgot
imfolokwe	fork
ngenhlanhla	fortunately
inhlanhla	fortune
amatshumi amane	forty
amatshumi amane lambili	forty-two
phambili	forward
ondla	foster
ulwe	fought
thole	found
isisekelo	foundation
kune	four
itshumi lane	fourteen
unga	fox
famanga	fragile
khululeka	free
inkululeko	freedom
kutsha	fresh
uLwesihlanu	friday
ifuliji	fridge
umngane	friend
abangane	friends
ubungane	friendship
thusile	frightened
thusayo	frightening
ixoxo	frog
vela	from
phambili	front
banjiwe	frozen
izithelo	fruit
ukujiyela	frustrated
amafutha	fuel
isiFulfulde	Fulfulde
ukugcwala	full
mnandi	fun
umcimbi	function
okuyisisekelo	fundamental
umngcwabo	funeral
hlekisa	funny
uboya	fur
thukuthela	furious
impahla	furniture
phambili	further
njalo	furthermore
ikusasa	future
umdlalo	game
isikhala	gap
igaraji	garage
ingcekeza	garbage
ingadi	garden
isango	gate
ukubuthana	gather
umbuthwano	gathering
nike	gave
igiya	gear
ubulili	gender
isizakulwana	generation
ukuphana	generous
isihlakaniphi	genius
thola	get
gqoka	get dressed
sukuma	get up
usile masinya	get well soon
ukuthola	getting
isipoko	ghost
isipho	gift
intombi	girl
intombi	girlfriend
nika	give
ukwehluleka	give up
thabile	glad
khangela	glance
ingilazi	glass
izibuko	glasses
tshazi	glimpse
nyukumala	gloomy
amagilovisi	gloves
khanyisa	glow
ukukhanya	glow
iglu	glue
hamba	go
qhubeka	go ahead
hamba	go away
hamba uyelala	go to bed
inhloso	goal
imbuzi	goat
umlimu	god
inkosi ikubusise	god bless you
ukuya	going to
igolide	gold
hambile	gone
ngiza	gonna
hle	good
lungile	good
utshone njani	good afternoon
hamba kuhle	good bye
ilanga elihle	good day
utshone njani	good evening
umsebenzi omuhle	good job
ukubukeka kuhle	good looking
uvukile	good morning
uvukile sithandwa sami	good morning my love
lala kuhle	good night
hamba kuhle	goodbye
ulale kuhle	goodnight
impahla	goods
idada	goose
hle	gorgeous
vetheza	gossip
thole	got
ngiyitholile	got it
uhulumende	government
thatha	grab
uhlamvu	grain
nikiwe	granted
amagilebusi	grapes
bamba	grasp
utshani	grass
bongile	grateful
ukubonga	gratitude
ingcwaba	grave
mpunga	gray
kuhle	great
ubuhwaba	greed
isihwaba	greedy
luhlaza	green
bingelela	greet
ukubingelela	greeting
ukubingelela	greetings
mpunga	grey
usizi	grief
gaya	grind
bamba	grip
umyeni	groom
phansi	ground
iqembu	group
khula	grow
ukukhula	growth
isiGuarani	Guarani
isiqinisekiso	guarantee
umlindo	guard
qagela	guess
umvakatshi	guest
isiqondiso	guidance
qhuba	guide
lecala	guilty
indoda	guy
amadoda	guys
umkhuba	habit
indawo yokuhlala	habitat
isiqhotho	hail
inwele	hair
isandla	hand
isibambo	handle
hle	handsome
lenga	hang
ukuzikhipha	hang out
kwenzeke	happen
kwenzeka	happened
injabulo	happiness
thaba	happy
ilanga lokuzalwa elihle	happy birthday
ilanga lokuzalwa elihle kuwe	happy birthday to you
umnyaka omutsha omuhle	happy new year
nzima	hard
ukulimala	harm
limala	harm
ingozi	harmful
ukuzwana	harmony
isivuno	harvest
ukuzonsa	hate
ukuba le	have
woba lelanga elihle	have a good day
woba lelanga elihle	have a nice day
dlana ukudla kwekuseni	have breakfast
ukholise	have fun
usudlile	have you eaten
ukuba	having
ingozi	hazard
inkungu	haze
yena	he
ikhanda	head
tshaywa likhanda	headache
phola	heal
ukuphola	healing
ukuphila	health
philile	healthy
zwana	hear
zwe	heard
inhliziyo	heart
khudumeza	heat
ukutshisa	heat
izulu	heaven
sinda	heavy
matasatasa	hectic
ubude	height
indlalifa	heir
bambe	held
isihogo	hell
Sakubona	Hello
sakubona sithandwa	hello dear
sakubona unjani	hello how are you
Sakubona kunjani	hello how are you doing
ncedisa	help
uncedo	helpful
ngakho	hence
yena	her
umhlambi	herd
lapha	here
ukuthikaza	hesitate
Sakubona	Hey
Sakubona	Hi
sakubona unjani	hi how are you
Sakuubona lapho	Hi there
fihliweyo	hidden
catsha	hide
phezulu	high
vezisa	highlight
hlekisa	hilarious
intaba	hill
yena	him
inqulu	hip
ukhalo	hips
qhatsha	hire
ukuqatsha	hiring
umlando	history
tshaya	hit
bamba	hold
mana kancane	hold on
umgodi	hole
isikhala	hollow
ikhaya	home
umsebenzi wekhaya	homework
qotho	honest
ngokwethembeka	honestly
uluju	Honey
udumo	honor
ingwegwe	hook
gxuma	hop
ithemba	hope
themba	hope
ngethemba	hopefully
ngelathemba	hopeless
uphondo	horn
ibhiza	horse
isibhedlela	hospital
tshisa	hot
iwetela	hotel
ihola	hour
amahola	hours
indlu	house
ikhaya	household
njani	how
wena ke	how about you
unjani	how are you
unjani	how are you doing
unjani lamuhla	how are you doing today
unjani lamuhla	how are you today
unjani	how do you do
kunjani	how is
mangaki	how many
malini	how much
kangakanani	how often
uleminyaka emingaki	how old are you
utshone njani	how was your day
bebunjani ubusuku bakho	how was your night
kodwa	however
umyeni	hubby
go	hug
ukugona	hug
khulu	huge
umuntu	human
ukuthobeka	humble
khudumala	humid
isikhudumezi	humidity
ikhulu	hundred
lambile	hungry
ukuzingela	hunt
isiphepho	hurricane
phangisa	hurry
phangisa	hurry up
limala	hurt
umyeni	husband
iqhugwane	hut
Ngi	I
Ngi	I am
Ngiyaphila	I am fine
Nginga	I can
Angenelisi	I can't
Ngiyavuma	I do
angikwazi	I do not know
Angizwisisi	I do not understand
angifuni	I don't
Angikwazi	I don't know
Angizwisisi	I don't understand
Angizwisisi ukuthi uthini	I don't understand what you mean
Angikuzwisisi	I don't understand you
angikwazi	I don’t know
Angizwisisi	I don’t understand
Ngiyathemba	I hope so
Ngiyakwazi	I know
ngithanda	I like
Ngiyakuthanda	I like you
Ngiyathanda	I love
Ngiyamthanda umfowethu omdala	I love my big brother
Ngiyamthanda udadewethu omdala	I love my big sister
Ngiyamthanda ubaba wami	I love my father
Ngiyamthanda umfowethu omncane	I love my little brother
Ngiyamthanda udadewethu omncane	I love my little sister
Ngiyamthanda umama wami	I love my mother
Ngiyakuthanda	I love you
Ngiyakuthanda kakhulu	I love you so much
lami ngiyakuthanda	I love you too
Ngitsho	I mean
Ngiyakukhanuka	I miss you
Ngiyakukhanuka kakhulu	I miss you so much
Ngiyabona	I see
ngicabanga	I think
Ngiyazwisisa	I understand
Ngifuna	I want
Ngifuna ukukubona	I want to see you
ngiyakufuna	I want you
Ngiza	I will
Nginga	I would be
Ngi	I'm
Ngiyaphila	I'm fine
Ngiyaphila	I'm good
Ngikhona	I'm here
Ngiyaxolisa	I'm sorry
iliqhwa	ice
ayisikhilimu	ice cream
umcabango	idea
efanayo	identical
isithutha	idiot
vilapha	idle
nxa	if
gula	ill
ngekho emthethweni	illegal
ukugula	illness
isiIlocano	Ilocano
isithombe	image
cabanga	imagine
masinya	immediate
kathesi	immediately
okukhulu	immense
iwala	impatient
ukusungula	implement
ngenisa	import
qakathekile	important
akwenzeki	impossible
umbono	impression
ukumangaza	impressive
ngcono	improve
ngcono	improvement
phakathi	in
ngaphezu kwalokho	in addition
eqinisweni	In fact
ngaphambi kwe	in front of
ukuze	in order to
isikhuthazo	incentive
isenzakalo	incident
kuhlanganisa	including
imali engenayo	income
ukuphazamiseka	inconvenience
engeza	increase
ukwengeza	increase
anda	increased
mangalisa	incredible
sibili	indeed
zimele	independent
Indiya	India
abomdabu	indigenous
usana	infant
ukutheleleka	infection
kokuphela	infinity
ukuvuvukala	inflammation
tshela	inform
ulwazi	information
ilifa	inheritance
okuqala	initial
limele	injured
ukulimala	injury
msulwa	innocent
emisha	innovation
uphenyo	inquiry
ubuhlanya	insane
ukungazethembi	insecure
faka	insert
phakathi	inside
umbono	insight
gcizelela	insist
faka	install
kuloku	instead
kulokuthi	instead of
imilayezelo	instructions
ithuluzi	instrument
isithuko	insult
ihlangene	intact
ubuqotho	integrity
inhlakanipho	intelligence
ukuhlakanipha	intelligent
hlose	intend
umqondo	intention
ukufuna	interested
chazayo	interesting
phazamisa	interfere
ngaphakathi	internal
tolika	interpret
umtoliki	interpreter
phazamisa	interrupt
phakathi	into
ukwazisa	introduce
isingeniso	introduction
okungalunganga	invalid
qamba	invent
impahla	inventory
phenya	investigate
isimemo	invitation
nxusa	invite
insimbi	iron
ku	is
isihlenge	island
ubunzima	issue
ubunzima	issues
kulungile	it's ok
Kulungile	It's okay
into	item
izinto	items
ngi	I’m
ibhatshi	jacket
ijele	jail
uZibandlela	January
imbiza	jar
umhlathi	jaw
hawukela	jealous
ubucwebecwebe	jewelry
umsebenzi	job
ukugijima	jogging
ihlayaza	joke
intatheli	journalist
uhambo	journey
injabulo	joy
umgwebi	judge
thonisisa	judge
uNtulikazi	july
yeqa	jump
uNhlangula	june
ingcekeza	junk
sanda	just
ukulunga	just
kwenze nje	just do it
ukulunga	justice
thethelela	justify
isiKalaallisut	Kalaallisut
tshiseka	keen
gcina	keep
qhubeka ngomsebenzi omuhle	keep it up
igcinwe	kept
Igedlela	kettle
ikhiye	key
khahlela	kick
umntwana	kid
ukudlala	kidding
inso	kidney
abantwana	kids
bulala	kill
umusa	kind
musa	kind
ngomusa	kindly
umusa	kindness
inkosi	king
qabuza	kiss
umkulu	kitchen
umangoye	kitten
idolo	knee
bekwazi	knew
ingqamu	knife
ukwazi	know
ulwazi	knowledge
aziwayo	known
isiKonkani	Konkani
isiKrio	Krio
umsebenzi	labor
umsebenzi	labour
swela	lack
ilele	ladder
umama	lady
beke	laid
ichibi	lake
imvu	lamb
umhlaba	land
indawo	landscape
ulimi	language
khulu	large
kucineni	last
okokucina	last but not least
isibongo	last name
phuza	late
mbayimbayi	later
hleka	laugh
ukuhleka	laughing
ukuhleka	laughter
qala	launch
impahla zokuwatsha	laundry
umthetho	law
utshani	lawn
ummeli	lawyer
beka	lay
ubuvila	lazy
khokhela	lead
umholi	leader
ihlamvu	leaf
ukuvuza	leak
ukweyama	lean
gxuma	leap
funda	learn
ukufunda	learning
valelisa	leave
ikhefu	leave
amahlamvu	leaves
khokhelwa	led
ikhohlo	left
umlenze	leg
okusemthethweni	legal
boleka	lend
ubude	length
phungula	less
isifundo	lesson
yekela	let
incwadi	letter
icala	liability
khotha	lick
amanga	lie
cambalala	lie
amanga	lies
impilo	life
ukuphakamisa	lift
phakamisa	lift
mhlophe	light
khanyisa	light
ukukhanya	light
umbane	lightning
thanda	like
kungenzeka	likely
ngokufana	likewise
umzila	line
isiLingala	Lingala
isixhumanisi	link
isilwane	lion
uluhlu	list
lalela	listen
ukulalela	listening
idoti	litter
ncane	little
phila	live
ukuphila	live
isibindi	liver
impilo	lives
ukuphila	living
umbankwa	lizard
umthwalo	load
isinkwa	loaf
iseboleko	loan
wendawo	local
indawo	location
khiya	lock
ukuvalwa kwelizwe	lockdown
ugodo	log
isizungu	lonely
mehlo madala	long time no see
khangela	look
ukukhangela	look
nkosi	lord
lahlekelwa	lose
ukulahlekelwa	loss
lahlekile	lost
okunengi	lot
umsindo	loud
ukuthanda	love
thanda	love
ngiyakuthanda	love you
kuhle	lovely
phansi	low
ngaphansi	lower
ukwethembeka	loyalty
inhlanhla	luck
nhlanhla	lucky
isiLuganda	Luganda
imapahla	luggage
isigaqa	lump
ukudla kwemini	lunch
amaphaphu	lungs
amanga	lying
umtshina	machine
hlanya	mad
nkosikazi	madam
enze	made
imagazini	magazine
gcina	maintain
isiMaithili	Maithili
inengi	majority
yenza	make
owesilisa	male
indoda	man
ukuphatha	manage
abaphathi	management
umphathi	manager
indlela	manner
nengi	many
woba lamanye amalanga okuzalwa amanengi	many many happy returns of the day
uMbimbitho	march
umsika	market
umtshado	marriage
tshadile	married
imaski	mask
nkulu	massive
umnikazi	master
ukudlala	match
umdlalo	match
umgane	mate
izibalo	math
indaba	matter
uNkwenkwezi	may
unga	may
mhlawumbe	maybe
mina	me
lami	me too
ukudla	meal
isicasiso	meaning
kutsho ukuthi	means
okwakhathesi	meanwhile
linganisa	measure
inyama	meat
ezokwelapha	medical
umuthi	medicine
okuphakathi	medium
hlangana	meet
umhlangano	meeting
isiMeiteilon	Meiteilon
ncibilika	melt
izinkumbulo	memories
umkhumbulo	memory
ukuqamba	mention
qambe	mentioned
umeluleki	mentor
umthengisi	merchant
umusa	mercy
nje	merely
woba lekhisimusi enhle	merry christmas
umlayezo	message
umbhixi	messy
insimbi	metal
ilisu	method
amagundwane	mice
iphakathi	middle
mhlawumbe	might
uchago	milk
izigidi	million
qaphela	mind
ingqondo	mind
yami	mine
umgodi	mine
umntwana	minor
umzuzu	minute
imizuzu	minutes
isimangaliso	miracle
isibuko	mirror
ubugangi	mischievous
usizi	misery
khutha	miss
ngiyakukhanuka	miss you
lahlekile	missing
umsebenzi	mission
inkungu	mist
iphutha	mistake
isiMizo	Mizo
iselula	mobile
qala	mock
lawula	moderate
isimanje	modern
ubumanzi	moist
ubumanzi	moisture
imvukuzane	mole
umama	mom
umzuzu	moment
mvulo	monday
imali	money
qapha	monitor
inkawu	monkey
inyanga	month
inyanga	moon
ukuziphatha	moral
okunye	more
futhi	moreover
ikuseni	morning
iseboleko sendlu	mortgage
nengi	most
kakhulukazi	mostly
umama	mother
intaba	mountain
igundwane	mouse
umlomo	mouth
hamba	move
ukunyakaza	movement
ibhayisikopo	movie
nkosikazi	mrs
udaka	mud
inkomitsho	mug
umsipha	muscle
ikhowa	mushroom
ingoma	music
kumele	must
mi	my
Sithandwa sami	My dear
mngane wami	my friend
I-hovercraft yami igcwele ama-eels	My hovercraft is full of eels
sithandwa sami	my love
ibizo lami ngu	my name is
kubonga mina	my pleasure
mina	myself
imfihlakalo	mystery
untokolotsha	myth
isipikili	nail
isithutha	naive
ibizo	name
ukulandisa	narrative
minyene	narrow
kubi	nasty
ubuzwe	nationality
imvelo	nature
isinengiso	nausea
eduze	near
eduze	nearby
phose	nearly
dingakala	necessary
intamo	neck
umgaxo	necklace
dinga	need
ukudinga	need
tshiya	neglect
xoxisana	negotiate
umakhelwane	neighbor
umzukulu	nephew
tatazela	nervous
isidleke	nest
inethiwekhi	network
zange	never
ungalahli ithemba	never give up
akula ndaba	never mind
akulandaba	nevermind
ntsha	new
indaba	news
landelayo	next
eduze le	next to
mnandi	nice
kuhle ukuhlangana lawe	nice to meet you
umzukulu	niece
ebusuku	night
iphupho elibi	nightmare
isificamunwemunye	nine
itshumi lesificamunwemunye	nineteen
amatshumi ayisificamunwemunye	ninety
Hatshi	No
ayikho inkinga	no problem
akwenzakali	no way
umsindo	noise
umsindo	noisy
imini	noon
hayi	nope
loba	nor
evamile	normal
inyakatho	north
IsiNdebele	North Ndebele
amakhala	nose
hayi	not
akukubi	not bad
Hayi khathesi	Not now
akula	nothing
nanzelela	notice
uqaphele	noticed
ibala	noun
ibala	nouns
ibhuku	novel
uKwezi	november
khathesi	now
lamuhla	nowadays
inkathazo	nuisance
inombolo	number
unesi	nurse
ibhawudo	nut
isifungo	oath
ubududla	obesity
lalela	obey
into	object
inhloso	objective
afihlekile	obscure
ukuqaphela	observation
khangela	observe
thathekile	obsessed
ukuthatheka	obsession
isikhubekiso	obstacle
thola	obtain
caca	obvious
ngokusobala	obviously
umsebenzi	occupation
matasa	occupied
enzeka	occur
kwenzeka	occurred
kwenzeka	occurs
ulwandle	ocean
uMfumfu	october
amathuba	odds
yebo	of course
nikela	offer
iwofisi	office
kanengi	often
Hawu	Oh
hawu sibili	oh really
amafutha	oil
kulungile	ok
kulungile sithandwa	ok dear
yebo sithandwa	ok honey
yebo sithandwa sami	ok my love
kulungile	okay
kulungile sithandwa	okay baby
kulungile sithandwa	okay dear
kulungile sithandwa	okay honey
kulungile sithandwa sami	okay my love
dala	old
phezu kwa	on
kanye	once
kunye	one
ulimi olulodwa alwanele	one language is never enough
ihanyanisi	onion
ku-inthanethi	online
kuphela	only
vula	open
umbono	opinion
amathuba	opportunities
ithuba	opportunity
maqondana	opposite
loba	or
layeza	order
umdabuko	original
isiOromo	Oromo
intandane	orphan
okunye	other
kufuze	ought
ethu	our
Injongo yethu: ukwenza wonke umuntu, yonke indawo, ezwisise umhlaba njalo eveze ukuthi uzizwa njani ngezilimi zonkana.	Our mission: to enable everyone, everywhere to understand the world and express themselves across languages.
Injongo yethu: ukuhlela ulwazi lomhlaba lokuwenza ufinyeleleke njalo usebenziseke emhlabeni wonke.	Our mission: to organize the world's information and make it universally accessible and useful.
phandle	out
umphumela	outcome
izigqoko	outfit
phumayo	outgoing
ngaphezulu	over
laphayana	over there
jikelele	overall
ehlula	overcome
ukukweleda	owe
isikhova	owl
umnikazi	owner
inkabi	ox
phakethi	pack
bhadaliwe	paid
ubuhlungu	pain
penda	paint
umdwebo	painting
mhlophe	pale
impama	palm
ipani	pan
uvalo	panic
ibhulugwe	pants
iphepha	paper
iphaseli	parcel
uxolo	pardon
abazali	parents
iwenka	parrot
ingxenye	part
thize	particular
ikakhulu	particularly
edlula	pass
dlule	passed
lothando	passionate
iphasiwedi	password
indlela	path
isineke	patience
isineke	patient
isiguli	patient
mana	pause
bhadala	pay
imbadalo	payment
ukuthula	peace
lokuthula	peaceful
isihloko	peak
thize	peculiar
umchamo	pee
chama	pee
hluba	peel
intanga	peer
ontanga	peers
ipenseli	pencil
abantu	people
ukuphelela	perfect
engxenye	perhaps
isibanga	period
imvumo	permission
imvumo	permit
ukubekezela	perseverance
phikelelayo	persistent
umuntu	person
ncenga	persuade
isigaba	phase
isimanga	phenomenon
ucingo	phone
isithombe	photo
umutsho	phrase
khetha	pick
dobha	pick up
isithombe	picture
ucezu	piece
izincezu	pieces
ingulube	pig
inkwilimba	pigeon
inqwaba	pile
umqamelo	pillow
umtshayeli wefulayimatshina	pilot
phini	pin
umgodi	pit
ukuhawukela	pity
indawo	place
beka	place
izindawo	places
isifo	plague
iqhinga	plan
indizamtshina	plane
isihlahla	plant
isihlahla	plants
umganu	plate
inkundla	platform
ukudlala	play
umdlalo	play
ukudlala	playing
thabile	pleased
ubumnandi	pleasure
isibambiso	pledge
nengi	plenty
icebo	plot
ipulagi	plug
ubunengi	plural
inkondlo	poem
izinkondlo	poetry
umcijo	point
itshefu	poison
amapholisa	police
inqubomgomo	policy
chumile	polite
ichibi	pond
isiziba	pool
ikaka	poop
ubuyanga	poor
inyama yengulube	pork
ilambazi	porridge
indawo	position
phatha	possess
ukumisa	postpone
igwili	potato
ubuyanga	poverty
amandla	power
amandla	powerful
ukwenza	practice
indumiso	praise
soma	prank
khuleka	pray
igugu	precious
bikezela	predict
khetha	prefer
khulelwe	pregnant
ukulungiselela	preparation
lungiselela	prepare
ilungisiwe	prepared
khathesi	present
isipho	present
sipho	present
gcina	preserve
umongameli	president
ukufithizela	press
fithizela	press
umfutho	pressure
hle	pretty
vimbela	prevent
inyamazane	prey
intengo	price
ukuziqhenya	pride
umpristi	priest
nkosazane	princess
phambi	prior
ijele	prison
ubumfihlo	privacy
umvuzo	prize
mhlawumbe	probably
ubunzima	problem
indlela	procedure
qhubeka	proceed
umsebenzi	profession
inzuzo	profit
isithembiso	promise
thembisa	promise
phakamisa	promote
khuthaza	prompt
izabizwana	pronouns
ubufakazi	proof
kuhle	properly
izakhiwo	properties
impahla	property
impumelelo	prosperity
phumelela	prosperous
vikela	protect
ziqhenya	proud
nika	provide
nike	provided
thomba	puberty
uzulu	public
donsa	pull
ithanga	pumpkin
gcina isikhathi	punctual
umfundi	pupil
thenga	purchase
colekile	pure
inhloso	purpose
isikhwama	purse
fuqa	push
faka	put
isithupha	qualification
ubunengi	quantity
ukubanga	quarrel
bangisa	quarrel
isiQuechua	Quechua
indlovukazi	queen
umbuzo	query
umbuzo	question
fola	queue
masinya	quick
masinya	quickly
thule	quiet
yekela	quit
imibuzo	quiz
isisho	quote
umvundla	rabbit
umncintiswano	race
ukufutheka	rage
izulu	rain
phakamisa	raise
phakanyisiwe	raised
gijima	ran
masinya	rapid
ngokuphangisa	rapidly
ukuqubuka	rash
igundwane	rat
ngcono	rather
luhlaza	raw
fikela	reach
finyelele	reached
ukusabela	reaction
bala	read
ukubala	reading
lungele	ready
uqobo	real
ukunanzelela	realize
nanzelele	realized
sibili	really
emuva	rear
isizatho	reason
lengqondo	reasonable
khumbula	recall
thola	receive
thole	received
kwazi	recognition
fanisa	recognize
ukuncoma	recommend
lulama	recover
ukululama	recovery
bomvu	red
hlenga	redeem
ukuhlengwa	redemption
ehlisa	reduce
okungadingeki	redundant
zibambe	refrain
ifuliji	refrigerator
bisela imali	refund
ukwala	refuse
alele	refused
mayelana	regarding
bhalisa	register
zisola	regret
jwayelekileyo	regular
njalonjalo	regularly
yala	reject
landisa	relate
ubuhlobo	relationship
isihlobo	relative
izihlobo	relatives
ukwekela	release
yekela	release
khululiwe	released
thembekileyo	reliable
khulula	relieve
khululekile	relieved
inkolo	religion
thembela	rely
sala	remain
eseleyo	remaining
khumbula	remember
khumbuza	remind
umkhumbuzo	reminder
susa	remove
qatsha	rent
lungisa	repair
phinda	repeat
phendula	reply
impendulo	reply
mela	represent
cela	request
isicelo	request
dinga	require
dingeka	required
phephisa	rescue
ucwaningo	research
fana	resemble
ukwenyanya	resentment
ukubhuka	reservation
gcina	reserve
umhlali	resident
tshiya	resign
ukuqina	resilience
ukumelana	resist
ukumelana	resistance
isixazululo	resolution
xazulula	resolve
inhlonipho	respect
ukuhlonipha	respect
phendula	respond
impendulo	response
phumula	rest
lala ngokuthula	rest in peace
bisela	restore
khawula	restrict
imiphumela	results
qhubeka	resume
ukugcinwa	retention
hlehla	retreat
buyisa	retrieve
buyela	return
vumbulula	reveal
vunjululwa	revealed
phindisela	revenge
hlehla	reverse
uguquko	revolution
umvuzo	reward
imbambo	rib
ilayisi	rice
nothile	rich
susa	rid
gada	ride
ukugada	ride
ukunene	right
kulungile	right
khathesi	right now
qina	rigid
indandatho	ring
hlambulula	rinse
isiphithiphithi	riot
dabula	rip
ukudabula	rip
vuthiwe	ripe
sukuma	rise
imbangi	rival
umfula	river
umgwaqo	road
roast	roast
qinileyo	robust
idwala	rock
giqika	roll
uphahla	roof
indlu	room
impande	root
intambo	rope
bolile	rotten
indlela	route
hlikihla	rub
ingcekeza	rubbish
delela	rude
diliza	ruin
umthetho	rule
imithetho	rules
gijima	run
ukugijima	running
amaphandle	rural
ukujaha	rush
jaha	rush
isaka	sack
umhlatshela	sacrifice
vikelekile	safe
ukuphepha	safety
impepha	sage
ngenxa	sake
umholo	salary
ukuthengisa	sale
isawudo	salt
fana	same
isifanekiso	sample
inhlabathi	sand
isiSanskrit	Sanskrit
hlale	sat
ukusuthiseka	satisfaction
ukusuthiseka	satisfied
anelise	satisfy
suthisayo	satisfying
uMgqibelo	Saturday
bone	saw
wothi	say
isikali	scale
qilibezela	scam
inxeba	scar
tholakali	scarce
esaba	scared
isikhava	scarf
sabisa	scary
hlakazeka	scattered
indawo	scene
indawo	scenery
iphunga	scent
hlela	schedule
uhlelo	schedule
isikolo	school
isayensi	science
isigelo	scissors
thethisa	scold
ububanzi	scope
umphumela	score
izicucu	scrap
ukwenwaya	scratch
memeza	scream
umbhalo	script
ulwandle	sea
isivalo	seal
dinga	search
isikhathi somnyaka	season
isihlalo	seat
umzuzwana	second
imfihlo	secret
ingxenye	section
vikelekile	secure
ukuphepha	security
bona	see
ngizakubona	see you
ngizakubona mbayimbayi	see you later
sizabonana masinya	see you soon
ngizakubona kusasa	see you tomorrow
intanga	seed
dinga	seek
kukhanya	seem
kubonakala	seems
sibonile	seen
bamba	seize
khetha	select
uqobo	self
ncitshana	selfish
thengisa	sell
thumeza	send
ngithumezele isithombe sakho	send me your picture
omdala	senior
ingqondo	sense
lengqondo	sensible
thumele	sent
umutsho	sentence
imitsho	sentences
isiPedi	Sepedi
uMpandula	september
qinisile	serious
ngeqinisino	seriously
sebenzela	serve
hlela	set
lungiselela	set up
ukuzinza	settle
isikhombisa	seven
itshumi lesikhombisa	seventeen
amatshumi ayisikhombisa	seventy
okunengi	several
kakhulu	severe
thunga	sew
umthunzi	shade
isithunzi	shadow
khuhluza	shake
inhloni	shame
ukwabela	share
ubukhali	sharp
yena	she
imvu	sheep
inkumba	shell
isihlangu	shield
cwebezela	shine
isikebhe	ship
iyembe	shirt
izicathulo	shoes
dubula	shoot
isitolo	shop
ukuthenga	shopping
ukhumbi	shore
fitshane	short
ukuswela	shortage
dubula	shot
ukudubudla	shot
kufanele	should
ihlombe	shoulder
memeza	shout
ukubonisa	show
bonisa	show
ngithegise	show me
ukugeza	shower
N	shrimp
tshwabhana	shrink
vala	shut
thula	shut up
amakhethe	shy
izelamani	sibling
izelamani	siblings
gula	sick
uhlangothi	side
bubula	sigh
ukubona indawo	sightseeing
uphawu	sign
qakathekile	significant
ukuthula	silence
thule	silent
isilika	silk
isiliva	silver
fanana	similar
lula	simple
kanye kanye	simultaneously
njengoba	since
ubuqotho	sincere
ngobuqotho	sincerely
hlabelela	sing
umhlabeli	singer
ukucwila	sink
cwila	sink
Mnumzana	Sir
udade	sister
umlamu	sister in law
hlala	sit
indawo	site
umumo	situation
isithupha	six
itshumi lesithupha	sixteen
amatshumi ayisithupha	sixty
iminwe	skill
iminwe	skills
isikhumba	skin
cakileyo	skinny
yeqa	skip
isibhakabhaka	sky
isigqila	slave
lala	sleep
elele	sleeping
ubuthongo	sleepy
umkhono	sleeve
sika	slice
tshelela	slide
kancinyane	slightly
mncane	slim
tshelela	slip
umgenquko	slope
donda	slow
kancinyane	slowly
ncane	small
hlakaniphile	smart
iphunga	smell
ukubobotheka	smile
bobotheka	smile
intuthu	smoke
butshelezi	smooth
umnenke	snail
inyoka	snake
ephula	snap
iliqhwa	snow
ukuze	so
ukuthambisa	soak
isepa	soap
ibhola	soccer
amasokisi	socks
buthakathaka	soft
umhlabathi	soil
thengisiwe	sold
isotsha	soldier
isigaqa	solid
xazulula	solve
nye	some
umuntu	somebody
omunye	someone
okunye	something
ngezinye izikhathi	sometimes
ingoma	song
masinya	soon
isiSorani	Sorani
isilonda	sore
buhlungu	sore
umphimbo obuhlungu	sore throat
usizi	sorrow
Phepha	Sorry
hlela	sort
dinge	sought
umoya	soul
umsindo	sound
umhluzi	soup
munyu	sour
umthapho	source
izansi	south
indawo	space
iSpanishi	Spanish
khuluma	speak
qakathekileyo	special
uhlobo	species
thize	specific
mangalisa	spectacular
ikulumo	speech
ukuswela amazwi	speechless
ijubane	speed
amaphoso	spell
sebenzisa	spend
babayo	spicy
tshibikilisa	spin
umoya	spirit
amathe	spit
kuhle	splendid
dabula	split
ukubola	spoil
onakele	spoiled
ukhezo	spoon
ibala	spot
sabalala	spread
intwasa	spring
khama	squeeze
indlegu	squirrel
gwaza	stab
ezinzile	stable
inqwaba	stack
izisebenzi	staff
ichatha	stain
izitezi	stairs
isiqu	stalk
isitolo	stall
isidindo	stamp
ma	stand
ukuma	stand
inkanyezi	star
qala	start
qale	started
ukulamba	starving
umumo	state
ukutsho	state
isitatimende	statement
isititshi	station
isithombe	statue
umumo	status
ukuhlala	stay
sala	stay
hlala uvikelekile	stay safe
inyama yenkomo	steak
ntshontsha	steal
intuthu	steam
insimbi	steel
emaweni	steep
uluthi	stem
isinyathelo	step
uluthi	stick
lukhuni	stiff
mileyo	still
mile	still
luma	sting
ncitshana	stingy
goqoza	stir
ntshontshiwe	stolen
isisu	stomach
ilitshe	stone
wema	stood
isitulo	stool
mana	stop
isitolo	store
isiphepho	storm
indaba	story
isitofu	stove
qondile	straight
qondileyo	straightforward
khama	strain
dida	strange
umfokazi	stranger
iqhinga	strategy
umfudlana	stream
isitalada	street
amandla	strength
nanabula	stretch
tshaya	strike
intambo	string
hlubula	strip
qinile	strong
tshaye	struck
ukwehluleka	struggling
inkani	stubborn
namathele	stuck
umfundi	student
ukubala	study
bala	study
ukufunda	studying
izinto	stuff
isimanga	stunning
sthutha	stupid
isitayela	style
isihloko	subject
ukuzithoba	submission
hambisa	submit
esikhundleni	substitute
phumelela	succeed
impumelelo	success
nje	such
njenge	such as
munya	suck
hle	suddenly
ukuphathwa	suffer
ukuhlupheka	suffering
anela	sufficient
itshukela	sugar
phakamisa	suggest
umbono	suggestion
fanele	suitable
isikhwama	suitcase
ihlobo	summer
isiqongo	summit
ilanga	sun
isonto	sunday
ukutshona kwelanga	sunset
ukukhanya kwelanga	sunshine
ukudla kwantambama	supper
sekela	support
ukusekela	support
mhlawumbe	suppose
kufanele	supposed
kulungile	sure
ukuhlinzwa	surgery
isibongo	surname
mangalisa	surprise
mangele	surprised
nikela	surrender
gombolozele	surrounding
ukulinda	surveillance
ukusila	survive
sola	suspect
umsol	suspect
lengisiwe	suspended
ginya	swallow
tshintsha	swap
inhlamba	swear
umjuluko	sweat
ijesi	sweater
thanyela	sweep
mnandi	sweet
amaphupho amahle	sweet dreams
sithandwa	sweetheart
khukhumala	swell
ukuvuvukala	swelling
bhukutsha	swim
ukubhukutsha	swimming
ukulenga	swing
lenga	swing
ukutshintsha	switch
vuvukile	swollen
umhedla	sword
uphawu	symbol
uzwelo	sympathy
izimpawu	symptoms
uhlelo	system
itafula	table
ukuwisa	tackle
umaka	tag
umsila	tail
thatha	take
nakekela	take care
khupha	take off
thathwe	taken
khuluma	talk
ukukhuluma	talk
mude	tall
qhweba	tap
impompi	tap
umsebenzi	task
mbitha	taste
ukunambitha	taste
hlabusa	tasty
fundise	taught
itiye	tea
fundisa	teach
utitshala	teacher
iqembu	team
unyembezi	tear
inyembezi	tears
qala	tease
amazinyo	teeth
tshela	tell
ngitshela	tell me
ulaka	temper
ithempele	temple
isikhatshana	temporary
itshumi	ten
inkulungwane ezilitshumi	ten thousand
ukuphatha	tend
buthakathaka	tender
ukungezwani	tension
imigomo	terms
sabeka	terrible
kuhle kakhulu	terrific
zama	test
umhloliso	test
umbhalo	text
bonga	thank
ngiyabonga	thank you
Siyabonga ngesineke sakho sisahlola impahla zakho ezithunyelweyo	Thank you for your patience while we investigate shipment
ngiyabonga kakhulu	thank you so much
ngiyabonga kakhulu	thank you very much
ngiyabonga	thanks
Siyabonga ngokusebenzisa i-app yethu	Thanks for using our app
kuhle lokho	that's good
i	the
ubusela	theft
yabo	their
bona	them
ngokwabo	themselves
laphana	there
kule	there is
ngakho	therefore
lezi	these
bona	they
jiyile	thick
isela	thief
ithangazi	thigh
cakile	thin
into	thing
izinto	things
cabanga	think
isithathu	third
omile	thirsty
itshumi lantathu	thirteen
amatshumi amathathu	thirty
lokhu	this
kule	this is
ngokupheleleyo	thoroughly
lanxa	though
cabanga	thought
umcabango	thought
imicabango	thoughts
inkulungwane	thousand
uhali	thread
ingozi	threat
songela	threaten
kuthathu	three
ngithabe	thrilled
umphimbo	throat
phakathi kwa	through
jikijela	throw
isithupha	thumb
ukuduma	thunder
ULwesine	Thursday
ngakho	thus
bopha	tie
qinile	tight
isiTigrinya	Tigrinya
isikhathi	time
ubugwala	timid
ncinyane	tiny
iseluleko	tip
iseluleko	tips
isondo	tire
dinwa	tired
isihloko	title
ku	to
lamuhla	today
usana	toddler
amazwane	toes
ndawonye	together
indlu yangasese	toilet
tshele	told
bekezela	tolerate
itamatisi	tomato
kusasa	tomorrow
ulimi	tongue
lamuhla ebusuku	tonight
futhi	too
thathe	took
ithuluzi	tool
amathuluzi	tools
izinyo	tooth
phezulu	top
isihloko	topic
dabukile	torn
ukuhlukunyezwa	torture
thinta	touch
lukhuni	tough
ukuvakatsha	tour
ithawulo	towel
idolobho	town
landelela	trace
indlela	track
thengisela	trade
isiko	tradition
okwesiko	traditional
umkhondo	trail
isitimela	train
izici	traits
ukudlulisa	transfer
uguquko	transition
humutsha	translate
ezokuthutha	transportation
thiya	trap
ingcekeza	trash
ukulimala	trauma
hamba	travel
igugu	treasure
gcina	treat
isiphatho	treatment
isihlahla	tree
umkhuba	trend
umzamo	trial
qila	trick
zame	tried
qala	trigger
quma	trim
uhambo	trip
inkathazo	trouble
ibhulugwe	trousers
iloli	truck
IQINISO	true
ithemba	trust
themba	trust
iqiniso	truth
zama	try
isiTsonga	Tsonga
itshubhu	tube
Lwesibili	Tuesday
imfundo	tuition
jika	turn
ufudu	turtle
utitshala	tutor
itshumi lambili	twelve
amatshumi amabili	twenty
amatshumi amabili lanye	twenty-one
isiTwi	Twi
kabili	twice
kubili	two
uhlobo	type
jwayelekileyo	typical
kubi	ugly
ekucineni	ultimate
ngaphansi	under
ngaphansi	underneath
zwisisa	understand
zwisisile	understood
hlukileyo	unique
inyuvesi	university
akwaziwa	unknown
kuze	until
phezulu	up
kukuwe	up to you
kwazisa	update
thunukala	upset
edolobha	urban
ukuqonqosela	urge
qonqosela	urge
thina	us
ukusebenzisa	use
sebenzisa	use
setshenzisiwe	used
ukunceda	useful
ngelamsebenzi	useless
vamileyo	usual
ngokujwayelekileyo	usually
ikhefu	vacation
ukugoma	vaccination
isigodi	valley
qakathekisa	value
intengo	value
inhlobonhlobo	various
ahlukile	vary
banzi	vast
imota	vehicle
umthengisi	vendor
ubuhlungu	venom
indawo	venue
qinisekisa	verify
inguqulo	version
nta	vertical
kakhulu	very
kuhle kakhula	very good
umkhumbi	vessel
ividiyo	video
umuzi	village
isigebengu	villain
udlame	violence
udlame	violent
umbono	vision
vakatsha	visit
ukuvakatsha	visit
qakathekile	vital
cacileyo	vivid
ilizwi	voice
isikhala	void
hlanza	vomit
amahlanzo	vomit
umholo	wage
umholo	wages
ukhalo	waist
mana	wait
ukumeleleala	waiting
vuka	wake
vuka	wake up
ukuhamba	walk
hamba	walk
ukuhamba	walking
umduli	wall
isikhwama semali	wallet
zula	wander
ufuna	wanna
funa	want
impi	war
khudumeza	warm
khudumala	warm
xwayisa	warn
isixwayiso	warning
iqhawe	warrior
geza	wash
ukudlalisa	waste
ingcekeza	waste
bukela	watch
amanzi	water
ikhabe	watermelon
indlela	way
thina	we
singa	we can
buthakathaka	weak
ubuthakathaka	weakness
inotho	wealth
isinothi	wealthy
gqoka	wear
gqoke	wearing
umkhathi	weather
umtshado	wedding
ULwesithathu	Wednesday
ukhula	weed
iviki	week
impelaviki	weekend
ukusinda	weight
dida	weird
amukela	welcome
inhlalakuhle	welfare
Kuhle	Well
wenze kuhle	well done
hambe	went
bebe	were
intshonalanga	west
manzi	wet
insikabayitshiye	whale
ini	what
wena ke	what about you
wenzani	what are you doing
wenzani khathesi	what are you doing now
wenzani khathesi	what are you doing right now
uwenzani	what do you do
uziphilisa ngani	what do you do for a living
utsho ukuthini	what do you mean
ufunani	what do you want
kwenzekeni	what happened
yini i	what is
kuyini lokhu	what is this
yini umsebenzi wakho	what is your job
ungubani ibizo lakho	what is your name
kunjani	what's up
ngubani ibizo lakho	what's your name
loba yini	whatever
isondo	wheel
nxa	when
loba nini	whenever
ngaphi	where
ungaphi	where are you
uvela ngaphi	where are you from
ungaphi khathesi	where are you now
uhlala ngaphi	where do you live
kanti	whereas
kumbe	whether
ngesikhathi	while
nyenyeza	whisper
impembe	whistle
mhlophe	white
ubani	who
ungubani	who are you
ngubani	who is
ngubani lo	who is this
konke	whole
ngani	why
yindaba kunganjalo	why not
ububi	wicked
banzi	wide
umfelokazi	widow
ububanzi	width
umfazi	wife
ukufuna	willing
nqoba	win
umoya	wind
iwindi	window
kulomoya	windy
iwayini	wine
ubusika	winter
sula	wipe
ucingo	wire
inhlakanipho	wisdom
isazi	wise
fisela	wish
ukufisela	wish
kufisela konke okuhle	wish you all the best
umthakathi	witch
lo	with
ukudonsa	withdrawal
ngaphakathi	within
phandle	without
fakaza	witness
ufakazi	witness
hlakaniphile	witty
impisi	wolf
owesifazana	woman
abesifazana	women
nqobile	won
mangala	wonder
mangalisa	wonderful
ukhuni	wood
ibala	word
amazwi	words
umsebenzi	work
sebenza	work
ukusebenza	working
umhlaba	world
isibungu	worm
gugile	worn
ukukhathazeka	worried
duba	worry
ukukhonza	worship
kungathi	would
isilonda	wound
Hawu	Wow
embathisa	wrap
ulaka	wrath
isihlakala	wrist
bhala	write
Bhala lapha	Write here
ukubhala	writing
bhaliweyo	written
akulunganga	wrong
bhale	wrote
igceke	yard
ukuzamula	yawn
zamula	yawn
Yebo	Yeah
umnyaka	year
iminyaka	years
imvubelo	yeast
memeza	yell
iganu	yellow
Yebo	Yes
yebo sithandwa	yes baby
yebo sithandwa	yes dear
yebo sithandwa	yes honey
yebo sithandwa sami	yes my love
yebo kunjalo	yes of course
izolo	yesterday
kanti	yet
wena	you
umuhle	you are beautiful
umuhle kakhulu	you are so beautiful
wamukelekile	you are welcome
unga	you can
Uyakwazi	You know
lawe	you too
kulungile	you're welcome
ncinyane	young
yakho	your
kulungile	your welcome
ngokwakho	yourself
ubutsha	youth
kulungile	you’re welcome
mnandi	yummy
