chimwe	a
padoko	a little
-wanda	a lot
kuwanda kwe-	a lot of
kuramwa	abandon
kurambana	abandoned
kupona	abide
kuvhija	ability
-kona	able
njiyo yo	about
kudera	above
padera	above
mufambi	abroad
kugara ucipo	absence
-tamika	absent
-rova	absent
zvonadi	absolutely
nyungurusa	absorb
maguriro	abstract
zvichikadiki	absurd
zvizinji	abundance
kumbandisisa	abundant
kuneswa	abuse
kutambudzwa	abuse
maverekertero	accent
-ashira	accept
-tenda	accept
kupuwa gwanja	access
ngozi	accident
panogwa	accommodation
-pedza	accomplish
zvakapera	accomplished
kuzwirana	according
mbuto	account
kunangisa	accuracy
ndizvona	accurate
kumangarirwa	accused
kuhwajihwa	ache
-ruma	ache
kukwanisa	achieve
kubudirira	achievement
kuziva ngo phapsa	acknowledge
uzivi	acquaintance
kupsanga	acquire
kuwanika	acquired
ndariro	acquisition
panyasi po	across
magariro	act
chiyitiko	action
kungwarira	active
basa	activities
basa	activity
muno o mayitiro	actor
zvowari	actual
no zvokwadi	actually
chukureba	acute
dzidzo	adapt
kuwedzera	add
engejehwa	addicted
kuyengejera	addition
kuyengedzera	additional
kwanogara	address
kufanera	adequate
mudoni o	adjacent
chivakasure	adjective
kudira ushoni	adjust
-kahamara	admire
-tenda	admit
kutora	adopt
zvinodika	adorable
kuyenda mberi	advance
tungamidzwa	advanced
mukana	advantage
anofamba chikathi	adventure
adivherbhiyo	adverb
chiziviso	advertisement
kukombidza	advertising
Kupanga	advice
-chenjedza	advise
-panga	advise
muvhikiri	advocate
mamiriro ezviro	aesthetic
ndango yo rudo	affair
kubatika	affect
sengwa	affection
kubadara	afford
zvinotengeka	affordable
zvirinane	affordable
kuthya	afraid
kuvhira apo	after
masikati	afternoon
sure	afterwards
umweni	again
kufuratira umweni	against
ndanga	age
ajensiya	agency
mutungamiriri	agent
anohasha	aggressive
kuita ngekukasira	agile
kare	ago
kutenda	agree
kuzwanana	agreement
marimwa	agriculture
mbheri	ahead
rodetsero	aid
kupinda	aim
mphepo	air
kugavhe	airport
njira	aisle
chichewukijo	alarm
doro	alcohol
kuzivisa	alert
upenye	alive
zveshe	all
zvakanaka	all right
zveshe zvizohamba zvakanaka	all the best
kuyitisa	allow
-rekererwa	allowed
-tenderwa	allowed
pedo una kukwanisa	almost
gara wega	alone
kare	along
wari uno	already
zvese zviri ushoni	Alright
na	also
njira	alternative
kunyange zvidini	although
njiku dzeshe	always
-ndiri	am
zvakanaka yaamho	amazing
zvakasiyana	ambiguous
kujitisa	ambition
kudzitisa	ambitious
kuchicha	amend
pakati	amid
kuvira na apa	among
ngo chedu	among us
dundhu	amount
kudakajisa	amusing
chimwe	an
kuvonesesa ushoni	analysis
matateguru	ancestors
phophoma	anchor
achikapengi	ancient
no	and
na iwewe	and you
ngirozi	angel
shungu	anger
njara	angle
-nyangadzwa	angry
chinyama	animal
disho ro murenje	ankle
njiku yo kubawa	anniversary
chiziviso	announcement
ushungu	annoy
kushatiswa	annoyed
-nyangadzisa	annoying
gore ngo gore	annual
kufindarika	anonymous
umweni	another
-davira	answer
kutarisira	anticipate
-veteresesa	anxiety
kudayima moyo	anxious
chese acho	any
na-	anymore
ariwese	anyone
zviro zvizhinji	anything
chiro chese	anyway
tinga dini	anyways
pa divi	apart
bawukwa	apartment
kumbira rurekerero	apologize
kufanana	apparent
kufanana	apparently
kuzivisa	appeal
kuwanika	appear
kuyezana	appearance
kubuda ngo c]havhumbu	appeared
kuda kuha	appetite
sanika	apple
mbuto	application
kutarihwa	apply
kusana	appointment
kuda kubonga	appreciate
kuhemura	appreciation
kuguma	approach
zvoponapo	appropriate
mubvumo	approval
kuphasa	approval
kupasa	approve
kupasa	approved
kufedera	approximately
kubvumbi	april
kuphitari	arbitrary
muvhaki	architect
arikutetura	architecture
munovigwa zvithupha	archive
ndiwo	are
na iwewe	are you
wakabatika ere?	are you busy
wakaroorwa ere	are you married
wakarovohwa kana awuzivi	are you married or single
Nuri pano vakuru	Are you still there?
uripo	are you there
mutengo o ruvanje	area
kunesana	argue
kunesesana	argument
kubuda ngo chavhumbo	arise
nvhuti	arm
chikwata cho hondo	army
panyasi po	around
kuyizanisa	arrange
dzidzo	arrangement
kuguma	arrival
-guma	arrive
kuguma	arrived
achikazwi	arrogant
muphasha	arrow
basa ro nyara	art
aritigu	article
zvokuyitwa ngo makina	artificial
anohita zviro	artist
kudai ngeku	as
kuvhira	as long as
nokuti	as well
engati	as well as
marasha	ash
kudhana	ashamed
-nyowejeka	ashamed
kuvhunjisa	ask
kudavira	asked
wakavata	asleep
magariro no kuyita	aspect
Chi Assamese	Assamese
kubiwa	assault
gungano	assembly
chupisiyari	assertive
kupuwa gwanja	assess
kuningira	assessment
zvidziyo	asset
zvidziyo	assets
kusinayi	assign
sinazwi	assignment
kubesa	assist
mudetseri	assistant
gungano	associate
kubhatana	associated
kuyita chikwata	association
kufunga kuti haii	assume
kutenda ndava	assumption
pa-	at
unane hako	at least
warhya	ate
anogogoma kumubikizano	athlete
kuhwana	attach
kutaka	attached
zvinoyita divi	attachment
kuvhida	attack
-tangisira	attempt
kuhanira	attend
kuwashira	attendance
ngwarira	attention
magariro	attitude
kuteya	attract
kusisika marodha yakayima	attraction
musiridzi	attractive
kuphavo	attribute
kudanwa	audience
Nyamavhuvhu	august
atete	aunt
atete	aunty
kutenda	authentic
muno o basa	author
vatongi	authority
vatungamiri	authority
akuru	authority
ngari yo nduva	autumn
zviripo	available
pakati no pakati	average
gara kure	avoid
-muka	awake
-pira	awake
chipuwo cho kuwina	award
unozwiro	aware
ruzivo	awareness
ndambo	away
zvakanaka	awesome
kuthyisa	awful
zvinonyowedza	awkward
Chi Aymara	Aymara
mwana	baby
achina mukaji kana mamuna	bachelor
-hwirira	back
zvinangwa zvikuru	background
shata	bad
bhegi	bag
nyambo	bait
kukocha	bake
padhariya	bakery
oda yekubikisa	baking soda
muphimo	balance
bhora	ball
Chi Bambara	Bambara
ninga	banana
qheyo	band
makaran'ganda	bang
bhanko	bank
bhare	bar
zvishomani	barely
bizi	bargain
deme	bark
mutumwi	barley
ruvharo	barrier
chiphingo	barrier
dako	base
kwanova	based
kuwunganija	basement
dako	basic
zvonazvo kamare	basically
bhariri	basil
wakashatiswa	bastard
mutoro	batch
kushamba	bath
charota	bathroom
bhathuri	battery
hondho	battle
chitundhu	bay
kuva	be
bhasopha	be careful
kugungwa	beach
vhiga	beam
bhochisi	beans
makhibwi	bear
ndhevhu	beard
chakaphotaphota	bearing
chinyama	beast
kutakataka	beat
zvakanaka	beautiful
kunaka	beauty
kuvha	became
ngokuti	because
-va	become
mubhedha	bed
mukuvata	bedroom
nyuchi	bee
ndindhi	beef
ave	been
doro	beer
sure	before
-tanga	began
-amba	begin
kutanga	beginning
unyasha	behalf
kugara zvakanaka	behave
mayitiro	behavior
mayitiro o kugara	behaviour
pasure	behind
kuri	being
kukhorwa	belief
-tenda	believe
ndani	belly
mundani	belly
kuva o umweni	belong
mudikani	beloved
pashi	below
sintu	belt
mabanko	bench
-gobesa	bend
pasi po	beneath
rubesero	benefit
zvinobesa	benefits
pamutivi	beside
achikaripi zvondhozvo	besides
zvakanakisa	best
rombo rakanaka	best of luck
vatambisenyi	best regards
-ita nane	better
pakati	between
doro	beverage
mberi	beyond
Chi Bhojpuri	Bhojpuri
kurerekera	bias
mayitiro o hasha	biased
bhasikoro	bicycle
chipho	bid
guru	big
bhasikoro	bike
fatura	bill
kubatanidza	bind
shiri	bird
njiku yo kubahwa	birthday
zvidoko	bit
-ruma	bite
kushasha	bitter
kusvipha	black
chireze	blade
kupa ndhango	blame
zvakachena	blank
bharangeti	blanket
kuphutika	blast
kumwa yo kurapa	bleach
kuvhengedza	blend
komborera	bless
kombhorehwa	blessed
bofu	blind
kudakara	bliss
kuvharira	block
ngazi	blood
kubuda nduva	bloom
kuyita zvakashata	blow
burumu	blue
-fondora	blunt
garan'andha	blunt
bhodhi	board
chikepe	boat
muviri	body
-ira	boil
kushinga	bold
kawusawu	bond
godo	bone
bhuku	book
kuyengejera ngo hasha	boost
kupa simba	booster
bhusu	boot
mabhota	boots
mugano	border
mucheto	border
-ntsekentsa	bore
bovoka	bore
muvhandabahwa	bored
kusadakadza	boring
-barhwa	born
kushonga	borrow
mukuru	boss
zveshe	both
-nesana	bother
botora	bottle
bwiko	bottom
kutengwa	bought
-tomuka	bounce
kuhanira	bound
mugano	boundaries
uta	bow
tasa	bowl
kaxa	box
bhokisi	box
murumbwana	boy
jaha	boy
mufana	boy
mudumbi	boyfriend
purechera	bracelet
ngqondo	brain
davi	branch
manyora	brand
-shinga	brave
kujipa	breach
chingwa	bread
-dambura	break
zvekurhya zvemangawanai	breakfast
mukaka	breast
zamu	breast
kufemesa	breath
-fema	breathe
rudzi	breed
muhlobo	breed
tijoro	brick
mudzimayi	bride
bhiriji	bridge
gurisira	brief
-n'anikira	bright
munikira	brilliant
-kuunza	bring
mukoma	bro
-pamphama	broad
fiyo	broadcast
kufambisa	broadcast
-pwanyika	broke
zvakapwanyika	broken
mutsvairo	broom
mukoma	brother
mukwambo	brother in law
zvaviswa	brought
bhurauni	brown
bhuratsho	brush
-bhuratsha	brush
bagedhi	bucket
shamwari	buddy
mare yo kuvaka	budget
kambuyu	bug
-vaka	build
kuvaka	building
kuvaka	built
kukura	bulk
burutu	bull
-yeyisa	bully
jowoyowoyo	bump
chikwata	bunch
butwa	bundle
muthwaro	burden
kuvigwa	buried
kupisha	burn
-putika	burst
bovoka	burst
-fuchira	bury
-tsira	bury
-ika	bury
bhasi	bus
gwasha	bush
bhizinisi	business
kuputika	bust
-batika	busy
asi	but
mantega	butter
betepeswa	butterfly
butawu	button
-tenga	buy
na-	by
ngo	by
zviyani	by the way
toonana	bye
kabichi	cabbage
reporiyo	cabbage
mubatira vandhu vo utongi	cabinet
dendhere	cage
khekhe	cake
gonyana	calf
-dana	call
ndifonereyi	call me
kunanwa	called
-porayi	calm
viyayi	came
mushandirapamwe	campaign
kukona kuyita	can
azvivhiri	can't
kugura bote	Cancel
gomara	cancer
-kona	capable
zvanokwanisa	capacity
dhorobha guru	capital
zvonotahwa ngo pasi	caption
-sunga	capture
movha	car
nguva yo kubata	career
hokoyo	careful
ngokungwarira	carefully
kuyita zvokumbombozeka	careless
itayi basopha	caring
muvaki	carpenter
rupasa	carpet
karoti	carrot
kuthwara	carry
enfayi mberi	carry on
kuyita	carry out
kaxa	case
mare	cash
chikwata	cast
mhatso yamambo	castle
kuzwirana	casual
chimangowe	cat
tsimba	cat
-bata	catch
chikamu	category
guzu ro n'gombe	cattle
kubodza	caught
ndava	cause
kawusawu	caution
chenjera	caution
-ngwara	cautious
bako	cave
kupeja	cease
mugano	ceiling
kudakara	celebrate
fone	cell
pakati	center
magumi o magumi o makore	century
musere	cereal
mushongano	ceremony
zvokwadi	certain
ndizvona kamare	certainly
chiphasera	certificate
mugunya	chain
chigaro	chair
-ambira	challenge
sana	chance
pinduja	change
-chicha	change
pasi	chaos
hundhu	character
hunhu	characteristics
kuzadza	charge
usizi	charity
wakasedza	charming
samba	chart
umbwa	chase
kurumbiswa	chase
mabuyo	chat
-tengeka	cheap
kuchengeja	cheat
shitawanya	cheating
kuverenga	check
dama	cheek
kudakajisa	cheer
kudakadzihwa	cheerful
kutaka manja	cheers
kejo	cheese
kimika	chemistry
kukhoronda	cherish
shadreji	chess
diti	chest
-tsenga	chew
huku	chicken
mambo	chief
mwana	child
udoko	childhood
uchia	childhood
vana	children
tukayi	chill
kandeya shamineya	chimneys
chirebvu	chin
chokhoreti	chocolate
chikheto	choice
kusana	choose
kubayiwa	chop
basa ro pamuzi	chores
muphundi	chubby
chiara	church
sonto	church
chanera	cinnamon
denderedzwa	circle
njiku no njiku	circumstances
vagari vo nyika	citizen
dhorobha	city
kuyita hondo uwane kuzika	claim
kuturujira	clarify
-qhasa	clarify
vadzidzi	class
mathope	clay
-chenesa	clean
kujeka	clear
ano ashira mare	clerk
-ngwara	clever
mutengi	client
mudzeu	cliff
zvonazvo	cliff
mamiriro okunze	climate
-khwira	climb
kubatana	clingy
rerogiyo	clock
-konya	close
munogara nguvo	closet
nguvo	cloth
nguvo	clothes
gore	cloud
makwiti	cloudy
madakadze	clown
chitatidzo	clue
kupsejeka	clumsy
phakahwandihwa	cluster
mudzidzisi	coach
masimbe	coal
mahombekombe	coast
bhachi	coat
kofi	coffee
zvinozika	cognitive
kudoyezana	coincidence
tondhora	cold
-hohloka	collapse
-dhirika	collapse
kunamikija	collar
mudoni o kubasa kana kucikora	colleague
-doni	colleagues
kukorora	collect
kukokova	collection
konofundwa mabuku makuru	college
ruara	color
vara	color
mazano o burumo acikana mushovo akavata akanyangajwa	colorless green ideas slept furiously
mushovo	colour
musana	column
phente	comb
phangana	combination
kuzwanana	combine
-za	come
-uya	come
viyayi kuno	come here
hambai	come on
garika	comfort
-nyararisa	comfort
kugarika	comfortable
samusambi	coming
kuuya	coming
samusambi	coming soon
murawu	command
mavonero	comment
kunotengeswa	commercial
chikwata	commission
kuzvipira	commit
kugara wakabatwa	commitment
gungano	committed
mujiyo jo kutengesa	commodity
ngari ese	common
kubuya no vamweni	communicate
masoko makuru	communication
gungano	community
kenda kubasa	commute
mudoni wako	companion
kuperekedzwa	company
kuyezanisa	compare
-ezanisa	comparison
usizi	compassion
usizi	compassionate
chinokwanisa	compatible
muphikizano	compete
anokwanisa kushanda	competent
muphikisano	competition
muphikizano	competitive
kunesa	complain
nyunyuto	complaint
anogumisa	complement
-zvese	complete
kuphedzisa	completely
kukura	complex
kurungama	compliance
kunesa	complicated
kurumbidza	compliment
kutendera	comply
muvhaki	composition
komboni	compound
kuzwirana	comprehension
kuzika	comprehensive
kubata ayite wako	compromise
chichimidza	compulsory
kombiuta	computer
wakangwarira	concentrate
ciziviso	concept
thukathuka	concern
ngo ndava yo	concerned
mutambo	concert
gumisa	conclusion
zvokwadi	concrete
mamiriro e-	condition
muthemo	conditions
mayitiro akanaka	conduct
muhlangano	conference
-dekecha	confess
ugondi	confidence
zvakafinarika	confident
-tenda	confirm
johoyowoyo	conflict
ndhango	confused
ndhango	confusion
makorokoto	congrats
makorokoto	congratulation
rudakaro kwawuri	congratulations
mavereketero	conjunction
-batanidza	connect
-nyisa	conquer
-hluya	conquer
kugara no hwiru	conscious
kuzwanana	consciousness
kuyitira usizi	consent
ruphochero	consequences
kuchengeta	conservation
munochengetwa	conservative
kunyinda	consider
kunyinda	considered
zvinodari ngokuti	consist
kuwirirana	consistency
kuenderana	consistent
kazhinji	constant
kazhinji	constantly
kukhosora	constipation
kuvaka	construction
kushandisa	consume
kushandisa	consumption
rusungo	contact
kupavo ndhenda	contagious
kupha ndhenda	contain
zvina	contains
zvowari	contemporary
kutama rugondiso	contempt
kudakara	content
kugara pamwepo	contest
zvinoyita maga amwe	context
nyika	continent
-enda mberi	continue
rusongano	contract
rereka	contrast
-besera	contribute
muhengomuhengo	contribution
kuvonerera	control
kuphinga	controversial
kufanera	convenience
kuyita nyore	convenient
mubiyisano	conversation
kuchicha	convert
kunanga	convey
kuyitisa atende	convince
kuyita vatende	convinced
-bika	cook
-bika	cooking
kutondhora	cool
kubatana	cooperation
kuva na	cope
mutongi	copper
mushovo	core
hlobo	corn
bonore	corn
phamutivi	corner
izvona	correct
mutengo	cost
kuroveja	costume
mhatso	cottage
thonje	cotton
kadera sofa	couch
-kotsora	cough
zvayidika	could
maga anophonesa	council
kuverenga	count
chekuverengesa	counter
nyika	country
kuchiripi dhorobha	countryside
vachadhi	couple
-chunga	courage
dare	court
kuyita unyasha	courtesy
hama vana va sekuru	cousin
kapha	cover
n'ombe yo kadzi	cow
wakahungwa	coward
kusununguka	cozy
gaye	crab
nghara	crab
-mwesa	crack
zvokuyita ngo nyara	craft
svina	crap
ngozi	crash
nthomba	craving
kwava	crawl
benzi	crazy
-sika	create
haraka	creative
chikwereti	credit
kufamba ngo ndani	creep
-tambarara	creepy
chikwata	crew
ndhango	crime
vhahira vhahira	cringe
kunesa	crisis
ndaa	crisis
gwanja kuti uyite	criteria
kukosha	critical
karira	criticism
chirimwa	crop
marimwa	crops
-sika	cross
gunguhwe	crow
mbumba yo vandhu	crowd
kutsvikinyidzana	crowded
-gadza	crown
-fanera	crucial
kushata mwoyo	cruel
kusika	cruise
-chwanya	crush
-chema	cry
gaka	cucumber
kumbatira	cuddle
magariro	culture
kungwarisa	cunning
kumicho	cup
khabhadhi	cupboard
kuyimisa	curb
-rapa	cure
nguwa yekupetuka kumhatso	curfew
kuzivisisa	curiosity
kuda kuvona	curious
mavara mavara	curly
mare	currency
wari	current
wari	currently
chitukwa	curse
keteni	curtain
muchago	cushion
muthetho	custom
mutengi	customer
mutengi	customs
-gura	cut
chakanyarisa	cute
bororindo	cycle
kufamba ngo basikoro	cycling
baba	dad
baba	daddy
njiku no njiku	daily
zvemukaka	dairy
kunovha magezi	dam
ngozi	damage
kubirabira	damp
kutamba ngoma	dance
perigu	danger
chikerema	dangerous
-svina	dark
mudikani	darling
mutatariko	dash
njiku	data
njiku	date
mwanasikana	daughter
njiku	day
zuva	day
kufa	dead
-tamika	dead
mugano	deadline
mburunzee	deaf
tazwana	deal
mudiwa	dear
Imwe mese	Dear All
nandiwe mutengi	Dear Customer
Haye vaberi vagu	Dear Parents
Haye Vakuru	Dear Sir
Haye Mujiji	Dear students
Haye Chikwata	Dear Team
rufo	death
mushongano	debate
mare	debit
mumba	debris
chikwereti	debt
gumi ro makore	decade
kuruka	decay
njuwaneji	deceased
-chengedzera	deceive
zvita	december
mundhu kwaye	decent
kuketa	decide
kusarudza	decided
mutemo	decision
kuvhevhenga	deck
kuramba	decline
kupungura	decrease
haraka	dedicated
haraka	dedication
chiito	deed
kudzamisa	deep
varekhe	deer
-nesa	default
-nyisa	defeat
-vhika	defend
-vhikira	defend
kujekesa	define
zvonazvo	definitely
kutukira	definition
mukwiro	degree
-nonosa	delay
-nonoka	delayed
nyungurusa	delete
kuregera	deliberate
kurembaremba	delicate
-naka	delicious
kuseja	delight
sisimudzwa	delighted
kuphekeja	deliver
kuphekeja	delivered
kupekeja	delivery
kuda	demand
-khumbusa	demanding
rutendere	democracy
dhimoni	demon
kuratidza	demonstrate
kurambiwa	denied
kukura	density
anovhisa mazino	dentist
-ramba	deny
-nyima	deny
pawukwa	department
hwendo	departure
-gonda	depend
kukovanisana	deploy
kuisa-	deposit
kusvinyika	depressed
ushungu	depression
udzamu	depth
kudzama	depth
kujekesa	describe
kuverenga	description
gwenya	desert
kufanera	deserve
chidombe	design
manangiro	designation
chishuwo	desire
tebhura	desk
kuchumbachumba	despair
kupera chigondiso	desperate
achikaripi ngo	despite
mugomo	destination
kwayida gumira	destiny
-pwanya	destroy
kupwanyapwanya	destruction
masoko	detail
kupha gwanja	details
kuvona	detect
kuwana simba	determination
kupana simba	determine
-tsunga	determined
kupwanyapwanya	devastated
kunasira	develop
kuva o pamwepo	developed
kukura	development
diyabho	devil
kucheneswa	devoted
Chi Dhivehi	Dhivehi
dhiyabhete	diabetes
muhudho	diarrhea
thwetwetwe	diarrhea
njiku no njiku	diary
disiyonariyo	dictionary
zvakayitwa	did
-tamika	die
rufu	died
kurhya kwakanaka	diet
musiyano	difference
kusiyana	different
-nesa	difficult
-phauya	dig
-rima	dig
-tsa	dig
wakanaka	dignity
kutumira	diligent
kurarira	dinner
mutoro	dip
-dhibhi	dip
-pinga	direct
-tintha	direct
divi	direction
musharukwa	director
-svina	dirt
-svipa	dirty
kujima	disable
chigono	disabled
ngarangara	disappear
-nyangarika	disappear
kunyangadziswa	disappointed
phikizwa	disaster
siyayi hako	discard
kuvhisa muriro	discharge
unthu hwakanaka	discipline
kuphungura	discount
-thumba	discover
kuramba mudoni wako	discrimination
jawoyowoyo	discuss
kuyita yowoyowoyo	discussion
ndhenda	disease
ndhenda	diseases
kufayeresa	disguise
zvinosembuza	disgusting
ndiro	dish
ndiro	dishes
kuyeneka	dismiss
kuyita ngokasikakasika	dispatch
panovoneka muterefone	display
kupseja	disposal
kuyita muphikisano	dispute
ndhambo	distance
zvonazvo	distinct
kuziva kuziyanisa	distinguish
kunyangajwa	distress
kukovanisa	distribution
mudhundhu mudoko	district
-nyangadza	disturb
mugero	ditch
bwimira	dive
zvaksiyana siyana	diverse
zvakasiyana siyana	diversity
kukovanisa	divide
zvokudenga	divine
-tura	divorce
jungu	dizzy
kuyita	do
muno----ere	do you
unondida ere	do you love me
chiremba	doctor
chithupha	document
ano	does
ana	doesn't
imbwa	dog
Chi Dogri	Dogri
kuyita	doing
masaramuso	doll
kukwanisa	domain
basa ro kanyi	domestic
kunyisa	dominant
asipi	don't
usa neseka	Don't worry
mupako	donate
-nikera	donate
zvapera	done
mbongora	donkey
fowha	dope
zviviri	double
kutama chigondiso	doubt
saja	dough
pashi	down
kujusa	download
achikashandi	draft
kwekweredza	drag
-bomphesa	drain
mugeri	drain
mutambo jo ngano	drama
kunyora mufananidzo	draw
gavheta	drawer
chithombe	drawing
kunyaruka	dread
hope	dream
-gqoka	dress
chinibovora	drill
-svuta	drink
kumwa	drink
-vhuta	drive
-riga	drop
kuwa	dropped
-vomesa	drought
kudhakwa	drunk
-omesa	dry
sekwe	duck
mumeso	dude
ngo ndaa yo.	due
ngo ndava yo	due to
dofo	dull
kuhungwa	dumb
kupata	dumb
kurasa	dump
mukuvo	duration
panguwa yo-	during
bukuta	dust
mphukuta	dust
-shonga	duty
kugara	dwell
chomasikati	dying
umwe na umwe	each
inini kana imwimwi	each other
kuvetera no moyo wese	eager
chapungu	eagle
nzee	ear
mangwanani matete	earlier
fumirisa	early
kuwana	earn
njeve	ears
mavhu	earth
kutengenda	earthquake
kutama kunesa	ease
zvichikanesi	easily
kakusi	east
-reruka	easy
kurhya	eat
kuha	eating
kuchengerera	economic
kuchengeta	economy
mombera	edge
kunasira	edit
fundo	education
kubatika	effect
kushanda	effective
kushanda yaamho	efficiency
unane	efficient
kuyedza kuyita	effort
zanda	egg
birinjari	eggplant
musoro	ego
sere	eight
gumi no makumasere	eighteen
-sere	eighty
-kana-	either
kujekesa	elaborate
chikokora	elbow
ndodha	elder
chikarahwa	elderly
kusedza	elegant
vanoyina divi	element
nzou	elephant
gumi na posa	eleven
zvinovoneka	eligible
kufudzura	eliminate
kutama zvino.	else
kudhana	embarrassed
kupseruka	embarrassed
kutsveruka	embarrassed
kudhanisa	embarrassing
kubinga	embarrassing
kumbatira	embrace
kupa zano	emerge
kasikira	emergency
kuthimwathimwa	emotional
kugara pachina chiro	empathy
panovoneka	emphasis
kuchingijira	emphasize
mushandi	employee
vareke	employees
varanda	employees
mushandirwi	employer
kuva pabasa	employment
pachina chiro	empty
ativari	enable
rusongano	encounter
kukurudzira	encourage
gumisira	end
uri pangozi	endangered
bizi	endeavor
utsungi	endurance
kutsungirira	endure
muvengi	enemy
simba	energy
kuyita divi	engage
-batikana	engaged
kuyita umwevo	engagement
motori	engine
muvaki wakadzidza	engineer
chiyungu	English
chingezi	English
kuvangisa	enhance
kuwana chiro chese	enjoy
kukura yaamho	enormous
-kwana	enough
kunyisa	ensure
-pinda	enter
-ngena	enter
mutambo	entertainment
kudakarasisa	enthusiasm
vanodzigondha	enthusiastic
zveshe	entire
chitendehwa	entitled
kuzivika	entity
pamusuvo	entrance
mukuphuki	entrepreneur
munogara samba	envelope
ruvanje ukuru	environment
godo	envy
ngano	epic
Urwere	epidemic
kuenzana	equal
midziyo ye-	equipment
kuenzana	equity
kuyezanisa	equivalent
chifujuri	eraser
kuphosa	error
-pokonyoka	escape
kakarutu	especially
samba yo kupedzisa kudzidza	essay
mayitiro	essence
fanera	essential
kudzidzisa	establish
zvisinei	established
utongi	estate
kurera	estimate
kurehwa	estimated
no zvimwenizve	etc
zvomukati	eternal
mayitiro	ethics
kupima	evaluate
kupima	evaluation
zvakayenzana	even
kudayi	even though
madeekoni	evening
chiitiko	event
mudiro	event
kasinji	eventually
narini	ever
vese	every
vandhu vese	everybody
munthu weshe	everyone
zveshe	everything
zvitatidziro	evidence
-shata	evil
kubudirira	evolution
chinoyita divi	evolve
Chi Ewe	Ewe
okare	ex
ndizvona	exact
ndizvona	exactly
zama	exam
kuda kuvona zvicini zvamba	examine
muedzaniso	example
mutodzaniso	example
-pinda	exceed
zvakanaka yaamho	excellent
kusiya	except
kudira phamutivi	exception
kuwanda	excess
ngari zhinji	excessive
-chicha	exchange
-onyerwa	excited
manyau	excitement
kudakadzisa	exciting
haye	exclusive
rusesa	excuse
rusesa	excuse me
kuwuraya	execute
kuwuraya	execution
vakuru	executive
kuyita	exercise
sembhuswa	exhaust
kusembhuswa	exhausted
kukombidza	exhibit
kukombidzwa	exhibition
kuriyo	exist
kuphunda	existence
kuvepho	existing
-buda	exit
kuphandaraja	expand
kutarisira	expect
kuvetehwa	expected
dishipheza	expenses
kudhura	expensive
ruzivo	experience
-eja	experiment
kungwara	expert
kupera kota	expired
kufundisa	explain
maverekero	explanation
kuha zvo umweni	exploit
kutsvaka	explore
kuvhisa	export
kudira	expose
kudhihwa	exposed
mushongano	exposure
manangiro	express
mazwi	expression
kuguma-	extend
kukura enga kunika	extended
kukura	extension
kuwedzera kukura	extent
zvokunja	external
mazvonero	extinct
zvimweni	extra
kupuwa chiziviso	extract
zvakaphindirisisa	extraordinary
zvikuru	extreme
zvona kamare	extremely
dziso	eye
madziso	eyes
chira	fabric
kudakadzisa	fabulous
hope	face
kubeseka	facilitate
-besera	facilities
kuyita zvitame kunesa	facility
chironjo	fact
kuyitwa	factor
fekitari	factory
zvokadi	facts
ngarangara	fade
-korerwa	fail
kuphosa	failed
kukorerwa	failure
-ti khwabada	faint
zvisina sarudzo	fair
zvakaenzana	fairly
fadha	fairy
kugonda	faith
mugondeki	faithful
kushata	fake
kuwa	fall
manyepo	FALSE
fama	fame
kujaira	familiar
ukama	family
mhuri	family
njara	famine
wakakudzwa	famous
vhintwinya	fan
zvonodakadza azvo	fancy
zvakanaka yaamho	fantastic
ndhambo	far
kuyeneka	farewell
marimwa	farm
murimi	farmer
zvinosisimudza	fascinating
-ntsentsa	fashion
kasika	fast
fema	fat
kufisa	fatal
kukwana ko zuva	fate
baba	father
kuremba	fatigue
ndaa	fault
kudika	favorite
unyasha	favour
chokudika	favourite
kuthya	fear
-busa	feast
buso	feast
pena	feather
kushandiro	feature
kushandira	features
Kukadzi	february
kuremba	fed up
mutengo	fee
-paka	feed
ziviso	feedback
kuzwa muviri	feel
kuzwa	feeling
mirenje	feet
kuwa	fell
mudoni	fellow
ndayiti	felt
mwanakadzi	female
fenzi	fence
-orera	fertile
-vhundira	fertile
mutambo	festival
-tora	fetch
kupisha muiri	fever
shomani	few
zvishomani	fewer
rugondeko	fiance
machengejero	fiction
munda	field
chinoruma	fierce
gumi no mashanu	fifteen
makumashanu	fifty
-rova	fight
kurovana	fighting
chithombe	figure
fukunyura	figure out
bokiso	file
-kwiza	file
-zadza	fill
chakakwana	filled
firimu	film
wakangora	filthy
kugumisira	finally
kupocheresa	finance
kubhadara	financial
-ona	find
kufukunyura	find out
zvirinane	fine
chikunwe	finger
zvapera	finish
kuphejiswa	finished
muriro	fire
bhizinisi	firm
khampane	firm
-kutanga	first
zina rokutanga	first name
hove	fish
-sisa	fit
shanu	five
-nasira	fix
kugarepho	fixed
bandera	flag
mbhene	flash
-terama	flat
kuphosa	flaw
wakanaka	flawless
kutiza	flee
nyama	flesh
mburuka	flew
kasika	flex
kusanduka	flexible
kumburuka	flight
vindhuja	flip
vhunjirira	flirt
kuvhunjirira	flirting
nderuka	float
guwe	flood
pashi	floor
upfu	flour
-popoma	flow
ruva	flower
mukhuhlani	flu
zvinyorenore	fluent
kazinji	fluently
kufhava	fluffy
kumwakumwa	fluid
-mburuka	fly
gwanja rimwe	focus
mphute	fog
makwiti	foggy
-pheta	fold
vandhumwi	folks
kutevera	follow
kuperekeja	follow up
pakayita cibovo	following
zvokurhya	food
n'gombe pongo	fool
kuwungwa	foolish
njoka	foot
thudo	football
ku-	for
kuyita mufakizo	For example
mufananijo	for instance
na iwewe	for you
kurambiswa	forbidden
simba	force
nguva	forecast
huma	forehead
mugumi	foreign
gwasha	forest
nariini	forever
kanganwa	forget
kurekerera	forgive
hangano	forgot
foroko	fork
muvhunjo	form
zvomutemo	formal
kare	former
ufumi	fortunately
ufumi	fortune
makumarongomuna	forty
makumarongomuna na piri	forty-two
kuenda mberi	forward
kugwinyisa	foster
kuchengeta	foster
kurovana	fought
kuwanika	found
kuvakwa	foundation
marongomuna	four
gumi na rongomuna	fourteen
chimukorovonjo	fox
zvakaremba	fragile
kurukira	frame
kudihwa	framework
Vatendi va mwari	fraud
chiropa	freak
mahara	free
kusununguka	freedom
kudondhoresa	freeze
njiku zhinji	frequency
kazinji	frequent
kazhinji	frequently
mushuna	fresh
chishanu	friday
mutondhora	fridge
shamwari	friend
ushamwari	friendly
shamwari	friends
mudumbi o rume	friendship
kuthyisa	frightened
kuthisa	frightening
kushaphuta	frog
okwapi	from
kumberi	front
zvakatondora	frozen
mucheru	fruit
kunyangadzwa	frustrated
mafuta	fuel
Chi Fulfulde	Fulfulde
kudzara	full
kudakadza	fun
shanda	function
zvinofanera	fundamental
rufu	funeral
-sekesa	funny
ganda	fur
kunyangadzwa	furious
mujiyo	furniture
kuchiripi	further
zvimweni	furthermore
mazuva o mberi	future
kuwina	gain
mutambo	game
bovo	gap
garaje	garage
njakani	garbage
munda	garden
hadiyo	garlic
gedhi	gate
kusonganisa	gather
muhlangano	gathering
simba	gauge
-pha	gave
chikwata	gear
hunduni	gender
mukuru	general
makuru	generally
mukurukuru	generate
kufikitira	generation
wakanaka	generous
wakanaka	genius
nyokeni	genre
-pfaa	gentle
mundhu kwaye	genuine
kubuya ngo nyara	gesture
kuwana	get
kusimira	get dressed
kumuka	get up
yitayi nane	get well soon
kuwana	getting
chiphoko	ghost
gira	ghosting
zimurebo	giant
chipho	gift
tsangamidzi	ginger
musikana	girl
nthombi	girl
mudumbi o kaji	girlfriend
-hina	give
kusiya	give up
kupekeja	given
-dakara	glad
kuringisa	glance
vhiduru	glass
magirazi	glasses
kuvoneka	glimpse
nyika	global
zvakashata	gloomy
ruvha	gloves
-baka	glow
-khanya	glow
kunaka	glow up
chimanikizo	glue
kupinda	go
hambayi mberi	go ahead
endayi ndhambo	go away
kenda kovata	go to bed
chinangwa	goal
zvinangwa	goals
mbudzi	goat
mwari	god
mwari nga kukomborere	god bless you
endayi	goes
kupinda	going
kenda	going to
oro	gold
wakaphinda	gone
kuyita	gonna
zvanaka	goo
zvakanaka	good
matakatira	good afternoon
ndophinda	good bye
njiko yakanaka	good day
mavirihwa	good evening
mwabira wani	good evening
basa rakanaka	good job
vonesesayi	good looking
itayi ushoni	good luck
Mangwanani	good morning
manwanani mudikani wangu	good morning my love
tinomusana mangwana	good night
toonana	goodbye
ndenha kovata	goodnight
zviro	goods
-fuma	goods
Google	Google
Google yokuphindhuja	Google Translate
sekwe	goose
kunaka yaamho	gorgeous
magumbu	gossip
kuva	got
ngatende	got it
utongi	government
-haka	grab
mazvikiro	grade
padoko ngepadoko	gradually
zvishoma nezvishoma	gradually
kugadzwa	graduate
chirimwa	grain
kuzwirana	grant
zvakanyinduwa	granted
uvha	grapes
kuhaka	grasp
soro	grass
kubonga	grateful
kubonga	gratitude
guwa	grave
marota	gray
zvakanaka	great
kusirira	greed
ukakata	greedy
kayindi yo marova	green
chungamija	greet
kuchingamidza	greeting
-chungamija	greetings
gireyi	grey
engati marota	grey
giridhi	grid
dambudziko	grief
kukwisa	grind
kuwanihwa	grip
kunotengeswa	grocery
murume	groom
kungwa	gross
tariyawu	ground
chikwata	group
-kura	grow
kukura	growth
kuchamwa	grumpy
Chi Guarani	Guarani
gondiso	guarantee
kunyinda	guarantee
-rinda	guard
-ngwarira	guard
-fembera	guess
muenzi	guest
kuvhunja uyite	guidance
mupherekedzi	guide
ano ndava	guilty
nandiwe	guy
anoda kuyita mwanakaji nari mwanarume	guys
mukugwinha muviri	gym
mukhuba	habit
gwasha	habitat
wakava	had
mvura yo mapuwe	hail
vhudzi	hair
dimbu	half
sara guru	hall
nyara	hand
-batabata	handle
kunaka hope	handsome
kupayika	hang
kugara tese mukuvo mukuru	hang out
kuyitika	happen
kuyitika	happened
rudakaro	happiness
-dakara	happy
dakara ngo makore	happy birthday
dakarayi ngo makore	happy birthday to you
gore idzva	happy new year
-konza	hard
zvinonesa	hardly
narini	hardly ever
kupwanya pwanya	harm
zvinopwanya	harmful
kuzwanana	harmony
kuvanga kuipa	harsh
-kukukura	harvest
kuva	has
kurwadziwa	hate
kuwana	have
ivayi no njiku yakanaka	have a good day
ivayi no njiku yakanaka	have a nice day
ndinamurajuwa	have breakfast
kutamba	have fun
ndakaha	have you eaten
unazvo	having
ngozi	hazard
kuzoja	haze
iyena	he
iyena ano	he has
iyena ndi	he is
hloko	head
kuphanda musoro	headache
-rapa	heal
-ponesa	heal
kuvonga mbanga	healing
kuvanga muviri	health
hutano hwakanaka	healthy
kuzwa	hear
kuzwika	heard
mwoyo	heart
kupisa	heat
kudenga	heaven
-rema	heavy
kubwaza	hectic
urebu	height
anozosara no ufumi	heir
kubiwa	heist
zvakayitika	held
gehena	hell
mwakadini	Hello
nandiwe shamari	hello dear
mwakaita wani	hello how are you
hukuyiteni wari	hello how are you doing
panogara mujiyo	helmet
-ruphesero	help
rudetsero	help
anoshanda	helpful
ponapo	hence
chake	her
phando	herd
apa	here
rusongano	heritage
kurangaridza kuyita	hesitate
iwe	Hey
mwakadini	Hi
haye wakadini	hi how are you
nandiwe ndandiwe	Hi there
-fishwa	hidden
chakafindara	hidden
-hwara	hide
ndanga	hierarchy
urebo	high
kuronzera	highlight
hwedo	hike
hwendo	hiking
zvinonyongora	hilarious
machikina	hill
iyena	him
zano	hint
chihunu cho mwanakaji	hip
chihunyu	hips
haya	hire
kupa basa	hiring
zvako	his
chako	his
ngano	history
kutaka	hit
hmm	Hmm
kuvecha nguva	hobby
-bata	hold
-vetera	hold on
bovo	hole
buri	hole
kuzorora	holiday
chithombe	hollow
pamuzi	home
basa ro pamuzi	homework
zvechokwadi	honest
kuthembeka	honestly
wakana	honestly
uchi	Honey
nyasha	honor
kapudzi	hood
chivejo	hook
tharika	hop
ruvetero	hope
kuvetera kuti	hopefully
kutama kugonda	hopeless
kurebo	horizontal
nyanga	horn
zvakashata	horrible
kushata	horror
hashi	horse
nyumba yo homi	hospital
nyumba yo homi	hospitality
munoyitihwa mushonano	host
umwevo	hostile
kupisa	hot
hotera	hotel
nguva	hour
nguva	hours
mhatso	house
mphuri	household
zvadini	how
ko iwewe	how about you
mwakadini	how are you
zvukudini	how are you doing
uri kuyiteni nyamasi	how are you doing today
wakadini nyamasi	how are you today
kurikuyiteni iwewe	how do you do
zvichini izvi	how is
mutongoni	how many
mutongonyi	how much
kasinji	how often
una makore mangana	how old are you
wavona kudini njikuyi	how was your day
wagara kudini usiku	how was your night
kuvhira apo	however
finini	hub
murume	hubby
kumbatira	hug
-rukuro	huge
vandhu	human
wakathuruka	humble
kubira	humid
kugara wakafara	humidity
magumi o mazana	hundred
nzara	hungry
kuvhima	hunt
bepho	hurricane
kasika	hurry
kasirai	hurry up
kunyangadzwa	hurt
mwamuna	husband
kumijira	hustle
chidumba	hut
usiri	hygiene
Inini	I
inini ndini	I am
ndiri ushoni	I am fine
ndingava	I can
kukorera	I can't
andingavi	I can't
ndikuyita	I do
Andizvizivi	I do not know
andizvizvi ushoni	I do not understand
andivhiri	I don't
andizvizivi	I don't know
andizi kuzvizwisisa	I don't understand
Andiripi kuzwa zawukunagaro	I don't understand what you mean
andiriphi kukuzwa ushoni	I don't understand you
andizvizivi	I don’t know
andizivi kuzwa ushoni	I don’t understand
Ndinoqajera	i guess
Ndinofembera	i guess
Inini ndayinga nayo	I had
inini ndina	I have
Ndayinga ndapinda	I have been
Ndinovetera kutendehwa	I hope so
inini ndinozviziva	I know
ndinodha	I like
ndinokuda	I like you
ndino kudisisa	I love
Ndinomudanyi njavanji wangu	I love my big brother
Ndinuda yayangu	I love my big sister
Ndinomuda baba wangu	I love my father
Ndinokuda hama yangu yo doko	I love my little brother
Ndinokuda munukuna wangu o kaji	I love my little sister
Ndinomuda mayi wangu	I love my mother
ndinokudisisa	I love you
ndinokudisisa	I love you so much
na ininivo ndinokudavo	I love you too
ndinoreva kuti	I mean
na madanda na iwewe	I miss you
ndina chisuho na iwewe	I miss you so much
ndikuvona	I see
ndinofunga	I think
inini ndazwisa	I understand
inini ndinoda	I want
ndikuda kukuvona	I want to see you
ndiri kukuda	I want you
ndayinga.	I was
ndi nozo-	I will
Ndayizova	I would be
inini ndiri	I'm
ndiri ushoni	I'm fine
ndiri ushoni	I'm good
Ndiripano	I'm here
ndirekerere	I'm sorry
gero	ice
pingu	ice cream
dama	idea
zvonadi	ideal
zvayezana	identical
kukhombidza	identify
kutatidza	identity
chitupa	identity
benzi	idiot
rovha	idle
danganyi	if
kutama kuphurikira	ignore
wakabatika ngo ndhenda	ill
azvizivi kunaka	illegal
chirwere	illness
ndhuaje	illness
Chi Ilocano	Ilocano
mufanikiso	image
kufunga	imagine
kasika	immediate
kasikira	immediately
ngo nyasha	immense
zvinoyitisa	impact
achina kuvetera	impatient
kuyita	implement
kungwinisa zvo kunja	import
kukosha	important
kudirira	impose
zvichiyikayitiki	impossible
kuyita atende ndiwe	impress
maonero	impression
zvinisisimudza	impressive
kuyita nane	improve
kuyita unane	improvement
mu-	in
kuyengejera	in addition
ndizvona kamare	In fact
kumberi ko	in front of
zvikarahwa zvinodika	in order to
zvichiripi zvona	inappropriate
kupha simba	incentive
chiitiko	incident
kudiravo	include
kusanganisisra	including
muphocero	income
mare	income
azvichikabesi	inconvenience
-engeja	increase
zvakayengehwa	increased
zvakanaka yaamho	incredible
no zvakadaro	indeed
mutendere	independent
Indiya	India
tatija	indicate
achikafaneri	indigenous
umwe umwe	individual
indushitiriya	industry
azvichikavhikiki	inevitable
kunotambira vana	infant
kuphaphayira	infection
kwenda no kwenda	infinity
kuzvimba	inflammation
kukwira	inflation
kuyitiswa	influence
kuzivisa	inform
masoko	information
ndwiro	ingredients
zvokusiwa ndi baba	inheritance
katanga enga kartawu	initial
simba ro kutanga	initiative
kupicha	injured
achina usizi	injury
achina ndaa	innocent
kuyitisa chikure	innovation
ndariro	inquiry
kupenga	insane
chibhisho	insect
kugara awuchizivi kugwinya	insecure
zvichikazi zvona	insert
mukati	inside
mavonero	insight
kuphinda	insist
jungu	insomnia
kufemehwa	inspiration
kufemehwa	inspire
-gadza	install
mavonero	instance
ngokukasika	instant
achikaripi ngo	instead
kuchiripi ku-	instead of
kufundisa	instructions
zvithengerebwe	instrument
kutuka	insult
zvinozwana	intact
kudihwa	integrity
muzivi	intellectual
kungwara	intelligence
mungwari	intelligent
zvayida	intend
chinangwa	intended
vanga	intense
kuyita uchizviziva	intention
kubuyisana	interact
kubhuyisana	interaction
shuwa	interest
ano haraka	interested
haraka	interesting
kuyitisa	interfere
ndumwa	intermediate
mukati	internal
vokunya ko nyika	international
kunogara vajiji	internship
muturudziri	interpret
kuturujira	interpreter
-gura bote	interrupt
kuva umpwepo	interview
zvomumoyo	intimate
panyasi	into
matangiro	introduce
kutanga	introduction
munthu akanyarara	introvert
kuyita ngo kucicimijwa	intuition
azvikashandi	invalid
kunasira	invent
anotanga nazvo	inventory
kuyita kuti zvikure	invest
kuningirisa	investigate
kukoka	invitation
kukoka	invite
fatura	invoice
kuyita divi	involve
kudihwa ubuye	involved
fero yo nguvo	iron
ndi	is
chirundhu	island
kugara wega	isolated
ndaa	issue
ndaa	issues
ndhango	issues
izvi	it
ichi i	it is
waphinda	it was
izvi	it's
zvakanaka	it's ok
zvakanaka	It's okay
chiro	item
zvipho	items
izvi	its
inini ndini	I’m
bhachi	jacket
kasako	jacket
muguniya	jail
Ndira	January
jaro	jar
meno	jaw
ushanje	jealous
-ndhundha	jerk
mbete	jewelry
mushando	job
muphikizano o kugogoma	jogging
kubatana	join
kuyitisa	joint
gozo	joke
anothura masoko o nyika	journalist
hwendo	journey
kudakara	joy
mutongi	judge
simu	juice
juriyo	july
-phukapuka	jump
junyu	june
njakani	junk
basi	just
tingayita izvi	just do it
usizi	justice
kunanga o jivhikire	justify
Chi Kalaallisut	Kalaallisut
chakarodzwa	keen
kudira	keep
kuramba weidaro	keep it up
kugarisika	kept
kandirinyo	kettle
shavhe	key
keyi	key
kukaba	kick
mwana	kid
mutambo jo vanadoko	kidding
chitundira	kidney
vana	kids
-raya	kill
mushovo	kind
kundaka moyo	kinda
wakanaka	kindly
unyasha	kindness
mambo	king
svonsva	kiss
chokubikira	kitchen
baphiro	kite
cimbhaka	kitten
makokovhi	knee
muzivi	knew
chiphanga	knife
vanovhuta kavharo	knight
-ziva	know
ruzivi	knowledge
kuziva	known
Chi Konkani	Konkani
Chi Kiriyo	Krio
etiketa	label
mare yo kubatisa basa	labor
nyiku yo basa	labour
kushota	lack
manera	ladder
musikane	lady
mudumbi	laid
nyanza	lake
kunakata	lamb
chigono	lame
mwenje	lamp
ruvanje	land
kunyara ko nyika	landscape
ndimi	language
kupotwa ngo	lap
zvikuru	large
kugumisira	last
kufafaja ufumi azvizivi kunaka	last but not least
zina ro kugumisira	last name
madeko	late
gumisira	lately
-pera	later
masoko okugumisira	latest
gumisira	latter
-seka	laugh
kusekerera	laughing
kusheka	laughter
khandira	launch
kuwacha	laundry
zvemutemo	law
jaridim	lawn
muvhikiri o ndango	lawyer
mukuruwane	lay
muthundo	layer
kumuka wakadini	layout
nyawumbwa	lazy
-verenga	lead
kutungamira	leader
mukuru	leader
zakani	leaf
tiza	leak
-juja	leak
kuvonda	lean
kukwira ndeki kana navhiyo	leap
kufunda	learn
zvijijo	learning
kugara ucibhadara	lease
zvishomani	least
gandha	leather
kubuda	leave
masakani	leaves
kutungamirwa	led
boshuwe	left
murenje	leg
kugarika	legacy
zvakanaka	legal
mazwi o kuturijira	legend
o mundani imwe	legit
kugarika	leisure
kushonga	lend
urebu	length
kuvisa	less
jijo ro nyamasi	lesson
kusiya	let
samba	letter
arifase	lettuce
kukwira	level
kupandha	leverage
mutoro	liability
munogara mabhuku	library
kunakata	lick
kunyepa	lie
manyepho	lies
upenyu	life
kukwira	lift
ruvheneko	light
mbhene	lightning
-da	like
mufanikiso	likely
mayitiro ondho	likewise
bote	line
Chi Lingala	Lingala
gwanja ro kufona	link
mbhondhoro	lion
kumwakumwa	liquid
ndharihwa	list
kuzwa	listen
zvizvayi	listening
muzivi anotara mgano	literally
mutari o ngano	literature
manyora	litter
-shoma	little
pamphene	live
chiropa	liver
upenyu	lives
-phona	living
sara yo kugara	living room
chinyamukorovonjo	lizard
muriro	load
pawu	loaf
kushonga	loan
ndawu	local
kwawuri	location
kukonya	lock
kufunga	lockdown
kutarihwa	log
danda	log
kusheka	lol
kugara wega	lonely
ndhambo	long
amazuva ndicina kukuvona	long time no see
kuvona	look
divi	loop
rekererwa	loose
va-	lord
-ruza	lose
kurukura	loss
kuruza	lost
muthuthu	lot
ruzha	loud
sara yokudika	lounge
kuda	love
ndinokudisisa	love you
zvinodakadzisa	lovely
kudzasi	low
padzasi	lower
mudoko	lower
wechokwadi	loyal
usizi	loyalty
rombo rakanaka	luck
rombo	lucky
Chi Luganda	Luganda
muthwaro	luggage
sisi	lump
kusvusvura	lunch
kurhya kwemasikati	lunch
mazazo	lungs
kuvhisa ufumi	luxury
manyepo	lying
mechini	machine
kutsamwa	mad
rethe	mad
va-	madam
kuvakwa	made
revhista	magazine
zvakanakisa yaamho	magnificent
murekhe o pamuzi	maid
zvondhozvo	main
kudira	maintain
kunejerera	maintenance
Chi Mayithili	Maithili
mukuru	major
kuwandihwa	majority
kuyita	make
makiyaji	make up
mwanarume	male
kuroja	mall
manarume	man
kuyitisa	manage
kuvhisa padokopadoko	management
mutungamiriri	manager
mutumwi	mandatory
kukombidza	manifest
kunyisa	manipulate
zano	manner
mabhuku	manual
zvisinji	many
vazinji vanozoviya vakadakara	many many happy returns of the day
kumacha	march
mombera	margin
kubazari	market
vakadhi	marriage
vakachadha	married
kashikara	mask
misa	mass
kukura yaamho	massive
mambo	master
mutambo	match
hama	mate
zvokushanda nazvo	material
kuverenga	math
masoko	matter
kukura	maturity
mayo	may
danganyi	maybe
inini	me
na ininivo	me too
chikhafu	meal
pakati no pakati	mean
zvinoreva	meaning
panyasi	means
zvinoti	meant
ngokudaro	meanwhile
mupimo	measure
muphimo	measures
nyama	meat
murapi	medical
kunorapwa	medicine
kunamata	meditation
pakati no pakati	medium
-ziva	meet
mushongano	meeting
Chi Meiteilon	Meiteilon
nyunguruka	melt
hwiru	memories
mugara hwiru	memory
hwiru	mental
kukhombidza	mention
kuronzera	mention
kunamata	mentioned
musoro	mentor
mutengesi	merchant
unyasha	mercy
kwega	merely
Kue neKhisimusi rakanaka	merry christmas
kuyita vhukuvhuku	mess
sambha	message
khanganisa zviro	messy
zvakayitwa ngo simbi	metal
gwanja rokuyita	method
gonjo	mice
upakati	middle
pakati po usiku	midnight
ungada	might
zviripakati	mild
zvirinane	mild
manyora	milestone
mumiritari	military
mukaka	milk
zviwuru	million
fungwa	mind
hwiru	mindset
zvangu	mine
kuvhengana	mingle
udoko	minor
museswa	minute
musesuwa	minutes
mushamiso	miracle
girazi	mirror
kusiyana siyana	miscellaneous
ndariko	mischievous
kuneseka	miserable
dambujiko	misery
madandha	miss
dandha na iwewe	miss you
kushota	missing
kuthumwa	mission
mbute	mist
kuposheka	mistake
nyathwa	mistake
Chi Mizo	Mizo
mujiyo	mobile
kutatijira	mock
moderi	model
kuyita unane	moderate
zvowari	modern
kunyarisisa	modest
kubira	moist
kubirabira	moisture
kusona	mold
zvakafava	mole
mayi	mom
wari uno	moment
chiposa	monday
mare	money
mujijisi	monitor
zindhede	monkey
mwedzi	month
ugariko	mood
kuchamwa	moody
mwedzi o kudenga	moon
kuva no simba	moral
ngezvimweni-	more
pamusoro-	moreover
mangwanani	morning
iphotetika	mortgage
kuwanda	most
pakuru pakona	mostly
mayina	mother
kunanga	motion
kupha simba	motivation
dundhu	mountain
gonjo	mouse
mukanwa	mouth
kufundurusa	move
sikasika	movement
firumu	movie
va-	mrs
kuwanda	much
matope	mud
kaneka	mug
mujira	muscle
muzewu	museum
chowa	mushroom
mumbo	music
kudika	must
-mbeveve	mute
kuwanda	mutual
zvangu	my
changu	my
mudikani wangu	My dear
shawmwari yangu	my friend
Chigondeka Changu Chokunyinda	My hovercraft is full of eels
mudiwa wango	my love
zina rangu ndi	my name is
kuda ikwangu	my pleasure
inini kamare	myself
kuthisa	mysterious
chakavanzika	mystery
mutemo	myth
ndwara	nail
achina usiri	naive
zina	name
kuverenga ngano	narrative
padoko	narrow
azvidakadzisi	nasty
nasinari	national
muno o nyika	nationality
veno vo nyika	native
muno o nyika	natural
muno o muthundu	nature
marucho	nausea
Chindawu	Ndau
pedo	near
phedo	nearby
kuchota badoko	nearly
zvakachena	neat
kufanera	necessary
musipa	neck
kumanikisa	necklace
kuda	need
azvishandi	negative
mayitiro o kushata	neglect
bizi	negotiate
chigarirano	neighbor
nharaunda	neighborhood
hayiwa	neither
muzukururu	nephew
munthu anodakarira mabhuku	nerd
ano hasha	nervous
shaki	nest
kumwakumwa	net
indaneti	network
kuyima	neutral
narini	never
narini ndizotiza	never give up
siyayi hako	never mind
siyayi hako	nevermind
nozvakadaro	nevertheless
chipsa	new
Nhau	news
umweni	next
parutivi pe-	next to
umweni	next to
zvinodakadzisa	nice
ndadakara ngo kukuziva	nice to meet you
muzukuru o kaji	niece
usiku	night
kurota zvakshata	nightmare
fumbwamwe	nine
gumi no makufambamwe	nineteen
makumafumbamwe	ninety
hayiwa	No
azvina ndango	no problem
azvingayiti	no way
akuna ariwese	nobody
ruzha	noise
panoja oyo oyo	noisy
apana	none
masikati	noon
hayiwa	nope
kuramba	nor
zvakajairika	normal
kanjikazi	north
miro	nose
mazuva	nostalgic
hayiwa	not
apana	not at all
azvizi kushata	not bad
Asipi Wari	Not now
azvisati kuita	not yet
kouvonesesa	note
zvatahwa	noted
apana	nothing
masoko	notice
zvatarihwa	noticed
zina	noun
mazina	nouns
ngano	novel
novhembero	november
wari	now
njiku yamashi	nowadays
kuneseka	nuisance
kutama kuzivika	null
kuwa chikomo	numb
namba	number
murapi	nurse
rethe	nut
ndunji	nutmeg
kununa	nutrition
kuphika	oath
kuphunda	obesity
kuyita zvawunovhunzwa	obey
zviro zvakafanga	object
chinangwa	objective
kuchichimidza	obligation
chakafindarika	obscure
kuvonesesa	observation
kuvona	observe
kudisisa	obsessed
kunyangajiswa	obsession
zvona kamare	obsolete
chipingo	obstacle
kuwana	obtain
yakadihwa	obtained
ndizvona	obvious
zvonazvo	obviously
ngariyo	occasionally
kubatika ngo basa	occupation
zvakabatwa	occupied
zvinoyitika	occur
zvakayitika	occurred
kuyitika	occurs
gungwa	ocean
jombe	ocean
gumiguru	october
kusiyana	odd
kuvoneka	odds
ro	of
ra	of
zvonazvo	of course
kudzima	off
kutukura	offensive
chipuwo	offer
hofisi	office
kuvese	official
kazhinji	often
oho	Oh
chokwadi	oh really
mafuta	oil
ndizvo	ok
zvakanaka mudikani	ok dear
ok uchi	ok honey
zvakanaka mudiwa wangu	ok my love
ndizvo	okay
zvakana mudiki wangu	okay baby
zvakanaka muzaya	okay dear
uchi wakanaka	okay honey
zvakanaka mudiwa wangu	okay my love
kare	old
pa-	on
ngari imwe kuti	once
chimwe	one
ndimi imwe ayikwani	one language is never enough
sabora	onion
onilayine	online
zvonazvo basi	only
-fungunyura	open
kuchekwa oda kubara	operation
kuzikavo	opinion
kuwana nguva	opportunities
kuwana zvinokubesa	opportunity
chibingo	opposite
mundhu anodzida	optimistic
kupavo murangarijo wako	option
kusana	optional
kana	or
safarawu	orange
zvokutumira	order
zvakarongeka	ordinary
kusongana	organization
kupa gwanja	orientation
choponapo	origin
chokadi	original
Chi Oromo	Oromo
vhana vo kusiwa	orphan
imweni	other
kudaro	otherwise
unodikana	ought
zvedu	our
Basa redu: kuyita kuti vese, ndawu jese, vazive nyika nokuti vabuye ngo ndimi	Our mission: to enable everyone, everywhere to understand the world and express themselves across languages.
Basa redu: kusonganisa masoko o munyika towayitisa kuti afanere nokuti kushandira vese	Our mission: to organize the world's information and make it universally accessible and useful.
-pinda	out
-buda	out
zvokugumisira	outcome
ngubo	outfit
kubuda	outgoing
panodiwa tomadha	outlet
maguriro	outline
pabanze	outside
zvakanakisa	outstanding
muchoto	oven
zvapera	over
phondopho	over there
zvese	overall
kubudirira	overcome
kurangarija kazinji	overthinking
muthwaro mukuru	overwhelmed
muthwaro mukuru	overwhelming
unodika	owe
zizi	owl
zvoponapo	own
muno	owner
n'gombe	ox
mumbo	pace
maso	pack
pakote	package
zvabhadharwa	paid
-rwadza	pain
kuthahwa zvothombhe	paint
kupama	painting
vaviri vaviri	pair
kuvondha	pale
munyara	palm
mbende	pan
ndhuramo	pandemic
jowoyowoyo	panic
karasawu	pants
bepa	paper
kamwari	paradise
kureba	parallel
kuyita divi	parcel
kuregerera	pardon
vabari	parents
panoyema movha	park
phaphagayo	parrot
chekubikisa	parsley
divi	part
kuvhepo	participate
pamutivi	particular
pamutivi	particularly
vanozwanana	partner
mudiro	party
mugogo	pass
kuphinda	passage
kupasa	passed
kuhemura	passion
kuda mwanakaji kana mwanarume	passionate
achina hasha	passive
samba yo kufungura	password
mazuva akapera	past
chigamba	patch
gwanja	path
njira	path
wakaremba	pathetic
mutendhi	patience
mutenta	patient
muenzaniso	pattern
kuyima	pause
zwirinja	pavement
bhadhara	pay
kubhadhara	payment
rufaro	peace
-garisika	peaceful
runyararo	peaceful
pichisi	peach
mizwa	peak
pera	pear
erivhiriya	peas
umwewumwe	peculiar
mathundo	pee
deme	peel
mugogo	peer
mudoni wako	peers
rapi	pen
lapishi	pencil
zvakayima	pending
vandhu	people
mhiripiri	pepper
zvizvayi	perceive
kuzwisa	perception
zvakadakadza	perfect
hundhu	perform
ukuru	performance
dangani	perhaps
mazuva	period
kugara no kugara	permanent
kutendehwa	permission
kutendesa	permit
ruvetero ukuru	perseverance
achikarembi	persistent
mundhu	person
hundhu	personal
hundhu	personality
zano	perspective
kuyita kunyengeteza	persuade
-juja	pervert
mhuka yepamhuzi	pet
nguva	phase
zviro zvinoshamisa yaamho	phenomenon
firozofiya	philosophy
runhare	phone
foto	photo
mavereketero	phrase
pamuviri	physical
kusana	pick
kunonga	pick up
mufodho	picture
chithombe	picture
divi	piece
chikwata no chirichese	pieces
nguruve	pig
njiva	pigeon
phiriya	pile
mbariro	pillow
ndhariko	pillow
anovhuta ndeki	pilot
mugogo	pin
chihenge	pineapple
yakadospuka	pink
rindi	pit
mutoro	pitch
pena	pity
ndawu	place
ndawu	places
ndhenda	plague
zvisinganesi	plain
zano	plan
ndeki	plane
kusima	plant
mbewu	plants
ndiro	plate
paraka	plate
musuvo	platform
Kutamba	play
muthambo	playing
zvinodakadzisa	pleasant
ndinokumbirawo	please
ngo unyasha	pleased
kudakarira kuvona	pleasure
kusonganisa chigondiso nariwese	pledge
kuwandisa	plenty
kuruka	plot
fixa	plug
kurijira	plum
kanarizadori	plumber
vese	plural
podikasite	podcast
nduyo	poem
nduyo	poetry
magumo	point
veneno	poison
muphorise	police
mutemo	policy
wakapangwa	polite
kudira zvakashata	pollution
zvimurambo	pond
dzia	pool
matuzvi	poop
murombo	poor
vandhu	pop
zvovandhu	popular
vandhu	population
nguruve	pork
bota	porridge
mugombe	port
kuema	position
zvowushoni	positive
kuwana	possess
kugara pa ndiri	possession
muridzi	possessive
mukana	possible
kutokotesa	post
kuzvita njiku imweni	postpone
-rungu	potato
kuvanga zvinokona	potential
mujira no simba	pound
urombo	poverty
simba	power
anosimba	powerful
kuyita kazhinji	practical
kuyita	practice
kurumbidza	praise
mutambo	prank
kunamata	pray
kosha	precious
kuda	precise
zvinodika	precisely
o pamoyo	predict
kudakarira -	prefer
chokuda	preference
mimba	pregnant
pamuviri	pregnant
zvinotambudzisa	prejudice
ndawu	premises
chipuwo cho kuwina	premium
kunasira	preparation
-nasira	prepare
kuronga	prepared
pherephozisawu	preposition
kuva uripo	presence
pondhopo	present
mharidzo	presentation
kuchengeta	preserve
mambo vo nyika	president
-pfanya	press
kuyita ngo simba	pressure
shinga	pretend
kunaka	pretty
kuvhikira	prevent
sure	previous
nyama ya batwa	prey
rutengo	price
kuthatha	pride
mupiri	priest
kutanga	primary
hama vana va cekuru	prime
mwana wa mambo o kaji	princess
chokutanga	principal
mberi kwe	prior
achito	prior
kupekeja nguva	priority
muguniya	prison
pamutivi pawega	privacy
wega	private
kuphuwa nyasha	privilege
chiphuwo cho kuwina	prize
danganyi	probably
ndhango	problem
mafambiro o kutongwa	procedure
kwenda mberi	proceed
kuvetera	process
kubarisa	produce
zviro	product
kuyita	production
basa	profession
anozviziva	professional
mutatijiro	profile
hukuru	profit
kuyenda mukati	profound
kuyenda mberi	progress
mudiro	project
chirongwa	project
kubudirira	prominent
kunanga unozozvita	promise
kukwidza	promote
kusimudzirwa	promotion
chiziviso	prompt
kufanera	prone
maphoronome	pronouns
kuvereketa	pronunciation
uchapupu	proof
anodikana	proper
zvonadi	properly
zvoponapo	properties
zvidziyo	properties
mudziyo	property
cho veno vacho	property
chikokonejo	proposal
rugondeko	prospect
ruvetero	prosperity
rigondeko	prosperous
kuvhikira	protect
kuphotwa	proud
kukombidza	prove
kupa	provide
kupuwa	provided
dunhu	province
kugaririka	provision
kuphuva	puberty
zvo vandhu	public
kweva	pull
dikiti	pumpkin
anokasika guma	punctual
mudzidzi	pupil
kutenga	purchase
chokwadi	pure
marovarova	purple
chinangwa	purpose
borosa	purse
kuyenda mberi	pursue
kuteverehwa	pursuit
sunda	push
-dira	put
kuwina pa mupikizano	qualification
mhando yepamusoro	quality
mutongo	quantity
-tukana	quarrel
-ambana	quarrel
kwariteri	quarter
Chi Quechua	Quechua
mukadzi wa mambo	queen
bisha	queer
kuvhunjisira	query
mubvunzo	question
kuema mumutsetse	queue
-kasira	quick
kasika	quickly
garisika	quiet
chokufuka	quilt
kusiya	quit
-kwana	quite
kuhejwa	quiz
muverenga	quotation
kuverenga muno	quote
mavereketero	quotes
chitsuro	rabbit
makwikwi	race
mujaho	race
shungu	rage
mvura	rain
kuyengedzera	raise
wakamuka	raised
-gogoma	ran
kusana	random
ngo kukasika	rapid
kukasika	rapidly
kunesa	rare
kuchota	rarely
asayira	rash
gonzo	rat
kuchichachicha	rate
achikaripi ngo	rather
kuyita unyasha	ratio
kuyita no hwiru	rational
mbishi	raw
-zvakare	re
-ambamira	reach
kuguma	reached
kuviya ngo sure	reaction
verengayi	read
kuverenga	reading
kunasira	ready
zvonazvo	real
chokwadi	reality
kuzoziya	realize
kuyitika	realized
zvokwadi	really
-rera	rear
chizato	reason
kuwozira	reasonable
kuchewukija	recall
kuyashihwa	receipt
-ashira	receive
-ashihwa	received
mukuvo waperari	recent
mukuvo wapherari	recently
panohashiwa	reception
resipi	recipe
achina hwiru	reckless
kuzivika	recognition
kuchewukidza	recognize
kutumira	recommend
kuthimihwa	recommended
rekodhi	record
-pona	recover
kuyita nane	recovery
retanguro	rectangle
kutsvuka	red
kudzikinura	redeem
kupoterehwa	redemption
pungura	reduce
zvonazvondhozvo	redundant
kuvhujisa	refer
kuyezana	reference
kumborangarira	reflect
mukarakadzo	reflection
tese	refrain
chinothondoja nyama	refrigerator
kuzwirija	refund
kuramba	refuse
kuramba	refused
kugara wakangwara	regard
zvinangwa zvo	regarding
kugarika	regardless
makomborero	regards
nyika	region
kutarira	register
-tsumba	regret
zvonane	regular
zvonane	regularly
kuramba	reject
kurondedzera	relate
zvine chekuita nge-	related
ukama	relationship
zvakayezana	relative
hama	relatives
kugarisika	relax
kusunungura	release
kusiwa	released
zvinofanera	relevant
zvakagondeka	reliable
kuthuruka	relief
kudhura	relieve
kupindiswa	relieved
chinamato	religion
utenderi	religious
taahara	reluctant
-gonda	rely
-themba	rely
kugara	remain
-sara	remaining
zvikuvoneka	remarkable
muthombo	remedy
-chewukidza	remember
karakadzisa	remind
-edzurira	remind
chiedziriro	reminder
remote	remote
kuvhisa	remove
kunangira	render
kugara nyumba yo kubhadara	rent
kunasira	repair
kuphinda	repeat
kudira chimweni	replace
-pingura	reply
ndumwa	report
-emera	represent
mukurumbira	reputation
mbiri	reputation
kukoka	request
kukmbira ngo samba	require
kudikana	required
kuponeswa	rescue
kutsvaka	research
kuyezana	resemble
pena	resentment
kungwarira	reservation
kuchengeta	reserve
pamhatso	resident
mugari	resident
kuvhisa basa	resign
kutsungirira	resilience
ndandamuka	resilient
kuramba	resist
kuyita hasha	resistance
ruphochero	resolution
kutonga	resolve
psaka	resort
zvokukwanisa nazvo	resources
reremera	respect
kudavira	respond
mudaviro	response
kutungamirira	responsibility
kutungamirira	responsible
kuzorora	rest
zororayi no rufaro	rest in peace
kunorhyiwa	restaurant
kupetudza	restore
kurambidza	restrict
magumisiro	result
mudavhiro	results
kupungura	resume
-buya padoko	resume
chitoro	retail
kuhimisa	retain
kuchengeta	retention
kuviga	retention
kungwarira	retention
kuvhiswa	retired
kutisa	retreat
kuvanga padokopadoko	retrieve
-petuka	return
kuzokera	return
kudira pachena	reveal
kubuta pachena	revealed
kuteverera	revenge
reseta	revenue
kuchika	reverse
kuvoneswa zvawadzidza	review
kuongorora	revise
unovona ngo phapsa	revision
kubudirira	revolution
chipuwo	reward
mumbo	rhythm
nthii	rib
musere o mupunga	rice
mukhuphuki	rich
mufumi	rich
kuponsa	rid
-gadha	ride
wakawungwa	ridiculous
-kanaka	right
wari	right now
phaphata	rigid
mbethe	ring
kumina	rinse
jawoyowoyo	riot
kumwesa	rip
kuibva	ripe
kujuka	rise
nyatwa	risk
ngozi	risk
chano no mbwere	rival
murambo	river
njira	road
-kocha	roast
gwasha	robust
buwe	rock
mugeri	rod
-shanda	role
-mburumbuka	roll
denga remhatso	roof
mhatso	room
mije	root
bote	rope
-ora	rotten
kuneseka	rough
anofedera	roughly
-tenderera	round
kunyiswa	route
nguva yo kuyita zvese	routine
bote	row
-zora	rub
-pukuta	rub
ndande	rubber
njakani	rubbish
utsinye	rude
thaphethe	rug
kaparadza	ruin
mutemo	rule
regwa	ruler
mutemo	rules
kurumba	run
kurumba	running
kuchiripi dhorobha	rural
kukasira	rush
saka	sack
zvakacheneswa	sacred
kupira	sacrifice
chibayiro	sacrifice
chivigiro	safe
kumburuka kwawushoni	safe flight
kuchengeteka	safety
muzivi	sage
zvakanangwa	said
vhera	sail
vhera	sailing
moponesi	sake
muphochero	salary
kutengesa	sale
muchena	salmon
munyu	salt
zvonezvo	same
apa	Same here
chitatijoo	sample
jecha	sand
Chi Sanskrit	Sanskrit
anodakajisa	sarcastic
kuvhindimwa	sassy
kugare pashi	sat
sabudu	sat
kudakadzisa	satisfaction
kudakadziswa	satisfied
kuyita umweni adakare	satisfy
kudakara	satisfying
musabudu	Saturday
sarsisha	sausage
utsinye	savage
kuchengeta	save
-kavona	saw
-reketa	say
-daro	say
bande	scale
kuyita chitsotsa	scam
mbhonje	scar
kunesa	scarce
kuthyisa	scared
dhuku	scarf
zvinothyisa	scary
-parara	scattered
zviro	scene
maruva o nyika	scenery
kunuhira	scent
hurongwa	schedule
mudiro	schedule
chikora	school
ruzivo o nyika	science
siyentishita	scientist
vazivi vo zvijijo	scientists
chigero	scissors
-tuka	scold
muphochero	scope
zvibodzwa	score
-kwenga	scrap
sukata	scrap
-para	scratch
-boorera	scream
panovoneka pa torofone kana komputadori	screen
pharafuzo	screw
chitatijiro	script
jombe	sea
mugano	seal
kutsvska	search
mukuvo	season
chigaro	seat
piri	second
chafindefinde	secret
divi	section
kugogwa	secure
kuchengetedzeka	security
-vona	see
ndikukuvona	see you
ndinokuvona ngari imweni	see you later
tinovonanazve	see you soon
ndinokuvona mangwana	see you tomorrow
tsangu	seed
-tsvaka	seek
engati	seem
kuyezana	seems
-vona	seen
kujija	seize
kuwa chikomu	seizure
asipi kazinji	seldom
-kheta	select
upenyu	self
kujirapa	self healing
muvonehwi	selfish
tengesa	sell
-tumira	send
ndithumireyi mufanikiso wako	send me your picture
musharukwa	senior
kushumbari	sense
zvine musoro	sensible
zvakati hwee	sensible
kuphafa	sensitive
-tumihwa	sent
mutemo	sentence
kuzika	sentences
-paradzanisa	separate
Chi Sepedi	Sepedi
gunyana	september
ndariro	sequence
zviro zvokadikadi	series
okwadi	serious
kuva	seriously
khonza	serve
mushando	service
mushongano	session
tese takabatana	set
-nejerera	set up
kudira ushoni	setting
-terama	settle
nomwe	seven
gumi na nomwe	seventeen
makumanomwe	seventy
zvimweni	several
kushatisisa	severe
tunga	sew
bvute	shade
vhute	shade
bvute	shadow
mumvuri	shadow
-zungunusa	shake
kudika	shall
setete	shallow
-tshverudza	shame
chimiro	shape
-kowa	share
-rojeka	sharp
iyena	she
iyena ano	she has
u ndi	she is
panotambihwa	shed
mavhuta	sheep
zakani	sheet
panogara mudziyo	shelf
-menya	shell
pokuzorora	shelter
chivhikiri	shield
turinu	shift
munikira	shine
ngarava	ship
kubazari	shipping
ngubo	shirt
magwada	shoes
khandira	shoot
chitoro	shop
kubazari	shopping
mombhera	shore
zvakadodoka	short
kuchota	shortage
chidoko	shot
-fanira	should
kadza	shoulder
-daidzira	shout
-khombisa	show
ndikombidze	show me
shuvhero	shower
mangambha	shrimp
kuphungura	shrink
tetete	shut
nyararayi	shut up
kudhana dhana	shy
hama	sibling
hama	siblings
-rwara	sick
divi	side
kufemesa	sigh
kwangwarira	sight
kusika kuvona nyika	sightseeing
-sayina	sign
sinayi	signature
kunoti	significant
-nyaradza	silence
nyararra	silent
thula	silent
murebvu	silk
benzi	silly
munganga	silver
kuyezana	similar
ubiresi	simp
zvichikanesi	simple
pamwepo	simultaneously
kuvhira	since
chokadi	sincere
vokadi	sincerely
-imba	sing
muembi	singer
nyokenyi	single
kunophadzihwa	sink
musharuka	Sir
mukunda	sister
hama mwana wacekuru	sister in law
kugara pasi	sit
ndawu	site
mayitiro	situation
tanthatu	six
gumi na thandhathu	sixteen
makumathadathu	sixty
kayindi	size
kubhudirira	skill
simbisa	skills
ganda	skin
kuvonda	skinny
kuphuka	skip
saya	skirt
denga	sky
gore	sky
mubatwa	slave
chibochwa	slave
-ata	sleep
-vata	sleeping
kuwozira	sleepy
-rejera	sleeve
dimbu	slice
sarade	slide
Padoko	slightly
tetepa	slim
-phokonyoka	slip
-terera	slope
nguva	slot
padokopadoko	slow
padoko padoko	slowly
chidoko	small
wakangwara	smart
-femba	smell
munhuwi	smell
kushekerera	smile
svuta	smoke
phwititika	smoke
chiutsi	smoke
-serera	smooth
muranuwa	snack
honjwe	snail
nyoka	snake
-dimbura	snap
mbhute	snow
kudaro	so
zvakafava	so cute
na wari	so far
kubija	soak
-nyakatisa	soak
sipho	soap
-femeruka	sober
bhora	soccer
thudo	soccer
zvogungano	social
gungano	society
sokisi	socks
kufhava	soft
software	software
machu	soil
zvatengwa	sold
zvapera	sold out
musocha	soldier
tsoka	sole
zvakavanga	solid
dzidzo	solution
kutonga	solve
zvimweni	some
ariwese	somebody
mayitiro okusiyana	somehow
umweni munthu	someone
chimwe chiro	something
dzimwe nguwa	sometimes
mumbo	song
garegare	soon
kuoma	sophisticated
Chi Sorani	Sorani
chivonje	sore
kubanda	sore
huro inobanda	sore throat
kutambudzika	sorrow
kuhlupheka	sorrow
ndirekerere	Sorry
-hleya	sort
kutsvaka	sought
mweya	soul
mudikani	soulmate
ngoma	sound
muto	soup
kushasha	sour
murambo	source
kubani	south
ndawu	space
njakani	spam
njakani jichikanuhi	span
Chipanyori	Spanish
ukuzodira panoshata	spare
-reketa	speak
-bhuya	speak
-mangaisa	special
muhlobo	species
zvonazvo	specific
kudakadzisa	spectacular
mavereketero	speech
kupera mazwi	speechless
kurumba	speed
-pera	spell
kushandisa	spend
kutumira	spent
kuvavira	spicy
mizwa	spike
-tenderera	spin
sipinachi	spinach
mujimu	spirit
-pfira	spit
kuvhenganija	splendid
kupanana	split
kuphwanya	spoil
-shishimidza	spoil
kugujuka	spoiled
kuda kwako	spontaneous
chipuni	spoon
ema	spot
vachano	spouse
-paradza	spread
ngari yo mapepo	spring
-ezana	square
-svina	squeeze
rabaraba	squid
chikiro	squirrel
-baya	stab
kugadzikana	stable
-turikidza	stack
piriya	stack
vabati vo basa	staff
dariro	stage
marovarova	stain
madantho	stairs
zimuti	stake
-nyangwira	stalk
nyangira	stalk
chinyumba	stall
karimbo	stamp
chitembu	stamp
-ema	stand
mwero	standard
ndhondo	star
-tanga	start
kutanda	started
kuzwa njara	starving
chitado	state
chinangwa	statement
chitesheni	station
chithombe	statue
chithado	status
-gara	stay
garayi wakagwinya	stay safe
anotambira mukumwa	steady
ndhindhi	steak
-ba	steal
fuhwi	steam
simbi	steel
zvakavikwa	steep
davi	stem
mudantho	step
mushakwe	stick
kambuti	stick
chitanda	stick
yakavanga	stiff
azvito	still
kubayiwa	sting
anokara	stingy
-nyima	stingy
-dhunga	stir
midziyo	stock
zvakabiwa	stolen
mundani	stomach
buwe	stone
wayima	stood
matuzvi	stool
-yima	stop
kuviga	storage
mwekuchengetera	storage
bhanka	store
dutu	storm
ngano	story
fogawu	stove
-reba	straight
zvakananga	straightforward
hluza	strain
zvinoshamisa	strange
achikaziviki	stranger
qhinga	strategy
ushwa	straw
morango	strawberry
mujira	streak
gwanja	stream
gwanja	street
njira	street
ngesimba	strength
ushungu	stress
dadamira	stretch
kusabvuma zveshe zveshe	strict
hashahasha	strike
-kunga	string
funura	strip
tsamwirira	strive
nhenda yo kupenga	stroke
kugwinya	strong
kuchoswa	struck
mayitiro	structure
kurovana	struggle
kunesa	struggling
-kwesa	stubborn
ndendende	stuck
mudzidzi	student
zvidzidzo	study
kutatitsha	studying
zviro	stuff
kuyita vakuvone ushoni	stunning
shekeba	stupid
kupata	stupid
mayitiro	style
soko	subject
kukokoneja	submission
kutumira	submit
zina	substance
kudira chimweni	substitute
-fanera	subtle
kubudirira	succeed
budiriro	success
budiriro	successful
izvo	such
engati	such as
-svisvina	suck
kubuda ngo cavhumbu	sudden
nozvakadaro	suddenly
hlamburuka	suffer
-hlupheka	suffer
dambudziko	suffering
-kwana	sufficient
tshukera	sugar
kupa maga	suggest
mavereketero	suggestion
-fanira	suit
-nakira	suitable
sutukezi	suitcase
mutongo	sum
musoro o masoko	summary
zienza	summer
chimera	summit
zuva	sun
soto	sunday
kupokotehwa	sunny
kubira ko zuva	sunset
zuva	sunshine
kukura	super
vakuru	superior
muthungamiriri	supervisor
chirariro	supper
kuzadza	supply
njiki	support
ngativone kudari	suppose
danganyi	supposed
shuwa	sure
mukwiro	surface
kuwanda	surge
kuvhunja	surgery
zina ro cipiri	surname
chishamiso	surprise
kuguma awuchina kunanga	surprised
kupira	surrender
-tenderedza	surrounding
kuvonerera	surveillance
ndariro	survey
-pona	survive
-fungidzira	suspect
kugoga	suspended
-nyumwa	suspicious
kuhisa	sustain
kuyisa vana	sustainability
kuhwisa	sustainable
chinyama co kubata ngo kuvhima	swag
-medza	swallow
kuchicha	swap
-pika	swear
ziya	sweat
bhachi	sweater
tsvaira	sweep
kutapira	sweet
hope jinonaka	sweet dreams
anokara	sweet tooth
mudikani	sweetheart
-zvimba	swell
kuzvimba	swelling
-hlambeya	swim
-dhuvha	swim
kuhlambeya	swimming
kudhuvha	swimming
ungure	swing
-shwapura	switch
kuzvimba	swollen
banga rokurovana naro	sword
simboro	symbol
urombo	sympathy
zviratidzo zvo dhenda	symptoms
sishitema	system
meza	table
tebhura	table
kuyenda awucina kuthiya	tackle
munganga	tag
mushe	tail
-tora	take
torayi	take away
kuchichengeta	take care
kutora chirichese	take off
-tora	taken
-bhuya	talk
mubuyi	talkative
rebu	tall
pombi	tap
fita	tape
vandhu vakasanwa	target
mushando	task
muho	taste
kuzika mukanwa	taste
zvinonaka	tasty
taphira	tasty
kufundiswa	taught
icha	tea
kufundisa	teach
mufundisi	teacher
chikwata	team
-tatura	tear
musodzi	tears
-ambira	tease
tekinorogiya	technology
mantsantsanwa	teeth
-ronzera	tell
ndibhyuyire	tell me
kugara ngo maji	temper
kugara ko nyika	temperature
themberi	temple
nguva doko	temporary
gumi	ten
gumi ro zviwuru	ten thousand
anohara panyumba achi badhara	tenant
-usha	tend
mayitiro o kunyisa	tendency
muphikizano	tender
nyangajwa	tense
hondho	tension
tende	tent
kuyejazve	tentative
magumo	term
mutemo	terms
zvinothyisa	terrible
zvinazvo	terrific
muthundu	territory
kuyejwa	test
samba	text
kupfura-	than
kubonga	thank
tabonga	thank you
ndinobonga ngo kuthiva kwako pacindikuchesari  kupinda ko zviro	Thank you for your patience while we investigate shipment
ndinobonga zvikuru	thank you so much
ndinomubongesesa	thank you very much
mwashuma yaamho	thank you very much
tinobonga	thanks
Ndinobonga Ngo Kushandisa App Yedu	Thanks for using our app
icho	that
ndizvona	that is
zvakanaka	that's good
u	the
kuba	theft
wavo	their
yavo	their
va	them
musoro we ndaa	theme
vona kamare	themselves
vemene	themselves
apapo	then
maga	theory
ino	there
ivona yi-	there are
izvi ndi	there is
ngo kudaro	therefore
idzi	these
ava	they
ivona	they
ivona i	they are
kugobvuka	thick
mubi	thief
mbavha	thief
mutezo	thigh
danyura	thigh
tetepa	thin
zviro	thing
zviro	things
murangariro	think
yechitatu	third
nyota	thirsty
gumi na tatu	thirteen
makumatatu	thirty
izvi	this
ichi ngeyichi	this is
zvakapedziswa	thorough
zvakakwana	thoroughly
izvi	those
kunyangwe zvakadaro	though
murangariro	thought
karangariro	thoughtful
murangaridzo	thoughts
chiwuru	thousand
musoro o gama	thread
kuthuswa	threat
kuthusa	threaten
-tatu	three
mugano	threshold
kuyimisa	thrilled
kufhuma	thrive
thokoriro	throat
pakati po	through
pakati po vese	throughout
kufura	throw
chikunwe	thumb
kutaka mbene	thunder
China	Thursday
kudari	thus
kusinayi	tick
maji	tide
-nasira	tidy
-sunga	tie
mhondhoro	tiger
kubata	tight
ChiTigrinya	Tigrinya
nguva	time
mukuvo	time
kunyaruka	timid
chidoko	tiny
-pikura	tip
mushovo	tips
penewu	tire
kurempha	tired
bendera	tissue
musoro o mapatahwa	title
ku-	to
kuva	to be
zvakakangwa	toast
nyamashi	today
ndumure	toddler
zvikunwe zvo njoka	toes
tese	together
chilavha	toilet
kubhyuira	told
kubhyuirwa	told
kuzoroja	tolerance
kuregerehwa	tolerate
dimati	tomato
Mangwana	tomorrow
rurimi	tongue
usukuno	tonight
futhi	too
kutora	took
zvikwata zvo-	tool
zvikwata zvochirichese	tools
zino	tooth
nyezuru	top
musoro wendaa	topic
-tatuka	torn
kujipa	torture
zvese	total
-bata	touch
kufanga	tough
rwendo	tour
pa-	toward
ku-	toward
pa-	towards
ku-	towards
thaura	towel
thaundi	town
dhorobha	town
zvinonuha	toxic
kuyonda	trace
-perekeja	track
chicha	trade
mayitiro etsika dzeanthu	tradition
mutemo dzo chichete	traditional
kufungika	traffic
gwara	trail
chomboyo	train
kufunda ngo zvito	training
munganga	trait
kurebo	traits
kuchicha	transfer
kutumira	transfer
kuphuka	transition
turukidzira	translate
chinovoneka kuberi	transparent
chifambo	transport
movhaa dzinothwara	transportation
murau	trap
muravo	trap
njakani	trash
thambujiko	trauma
kuhamba	travel
pharanganya	tray
ufumi	treasure
kurapa	treat
kurapuwa	treatment
muti	tree
chakakura	tremendous
kukwira ufumi	trend
kutongwa	trial
-cheneja	trick
wakayedza	tried
kokenzeresa	trigger
kupejisa	trim
rwendo	trip
dambudziko	trouble
neseka	trouble
muthothi	trousers
zingamba	truck
kadi	TRUE
musinga	trunk
-themba	trust
-gonda	trust
chokwadi	truth
-edza	try
Chi Tsonga	Tsonga
thubhu	tube
muchipiri	Tuesday
mare yo kuchikoro	tuition
toki	turkey
safarawu	turmeric
-tenderedza	turn
chikomu	turtle
mujijisi	tutor
gumi na piri	twelve
magumi maviri	twenty
makumi maviri na piri	twenty-one
Chi Twi	Twi
kairi	twice
-shongorora	twist
piri	two
mbiri	two
rudzi	type
zvakadoyita	typical
zvichikafaneri	ugly
gumisira	ultimate
chiamburera	umbrella
achikakwanisi	unable
sekuru	uncle
kuwa chikomo	unconscious
panyasi	under
basi po-	underneath
kunyaruka	underrated
kuzwisisa	understand
kuzvizva	understood
kutama chigondiso	unfortunately
nguvo jokubasa	uniform
chimwecho	unique
rubatano	unit
yunivhesithi	university
chichikaziviki	unknown
zvakaremba	unless
gumira	until
maninji	unusual
mbera	up
ndiwe uno zviziva	up to you
kuvisa papsa	update
kuyitisa	upgrade
pamusoro	upon
nyangadziswa	upset
dhorobha	urban
kasika	urge
-kasika	urgent
itisu	us
kushandisa	use
-shandisa	used
zvonidika	useful
zvisikashandi	useless
kazinji	usual
kazhinji	usually
zvinoshanda	utility
zororo	vacation
madhunguyo	vaccination
mutondoro	vaccine
pachina chiro	vacuum
zvisina kujeka	vague
-guma	valid
bani	valley
chinodika	valuable
rutengo	value
kusiyanasiyana	variety
zvakasiyana siyana	various
kuchichachicha	vary
vhazo	vase
siyana	vast
murivo	vegetable
murivo	vegetables
chifambo	vehicle
movha	vehicle
anotengesa	vendor
vheneno	venom
kufamba ucina kunikihwa	venture
ndawu	venue
kwawuri	venue
kusotesa	verify
zvovamweni	versatile
mushovo	version
zvakavindujwa	vertical
yaamho	very
zvakanaka yaamho	very good
mudziyo	vessel
gwaja	via
dumaduma	vibe
kududumayira	vibes
zvito zvokunesa kusiya	vicious
mubatiki	victim
videwo	video
kuvoneswa	view
kanyi	village
mbavha	villain
muto o mafurungu	vinegar
chokare	vintage
kudzipa	violence
zvechisimba	violent
jinorapa ndhenda huru	viral
mbandwe	virgin
mayitiro o kunaka	virtue
hophe	vision
kufambirana	visit
mavonero	visual
zvakakosha	vital
chakapona	vivid
mazwi	vocabulary
izwi	voice
pachina chiro	void
izwi	volume
ukanda wega	volunteer
-rucha	vomit
kushupheka	vulnerable
mubhdharo	wage
muhoro	wage
mupochero	wages
chihunyu	waist
imirayi	wait
weita	waiter
-emera	waiting
-garira	waiting
-muka	wake
-muka	wake up
-hamba	walk
-famba	walking
rukubati	wall
chigariro	wallet
fambafamba	wander
-pepesheka	wander
kuda	wanna
-da	want
wakada	wanted
hondo	war
mugiba	wardrobe
nyumbo	warehouse
-dziya	warm
kuzivisa	warn
chiziviso	warning
muchosa	warrior
zvayinga	was
-shamba	wash
-geza	wash
zvitengerebwe	waste
-rinda	watch
mwura	water
shamba	watermelon
maphendo	wave
gwanja	way
itisu	we
itisu tinoti	we are
inini tingada	we can
kuremba	weak
marembo	weakness
ufumi	wealth
mukhuphuki	wealthy
gqoka	wear
ngqoka	wearing
makuvona zvonyika	weather
kuchada	wedding
muchitatu	Wednesday
sora	weed
vhiki	week
vhiki ropera	weekend
uremu	weight
kushaya	weird
mwauya	welcome
gumanyi ushoni	welcome
kugarika	welfare
zvowushoni	Well
zvakana	well done
-kayenda	went
vayinga	were
kumabirira	west
shururika	wet
bareya	whale
kudini	what
ko imwi	what about you
urikuyiteni	what are you doing
urikuyiteni wari	what are you doing now
urikuyiteni wari uno	what are you doing right now
ndida kukuyitisa	what do you do
munoita mushando uri	what do you do for a living
unondiverengerenyi	what do you mean
onodenyi	what do you want
kukushatenyi	what happened
chinyi ichi	what is
chini ichi	what is this
unobatira kwapi	what is your job
zina rako ndiyani	what is your name
nzvini	what's up
zina rako ndiyani	what's your name
zvazoyitikaro	whatever
kuyimira	wheat
vhiri	wheel
rodha	wheel
rini	when
ngari yese	whenever
kuri	where
unobvepi	where are you
unobve kuri	where are you from
urikuri	where are you now
unogara kuri	where do you live
zvichini izvo	where is
kuvona kuti	whereas
dangani	whether
chinyi	which
apo	while
n'gun'guta	whisper
ridza murudzo	whistle
kuchena	white
ndiyani	who
ndimwi ani	who are you
munoita ani	who are you
ndiyani	who is
zvichini izvo	who is this
rese	whole
ndiani	whom
ngechani	whose
ngenyi	why
ngenyi hayiwa	why not
rasika	wicked
fara	wide
noni	widow
kupamphana	width
mudzimai	wife
mukadzi	wife
mugwasha	wild
nozo-	will
kuda	willing
chido	willing
nyisa	win
kuwina	win
maphepho	wind
chibuko	window
kuphephera	windy
-wina	wine
chando	winter
pukuta	wipe
waya	wire
ungwaru	wisdom
mungwari	wise
kudadayira	wish
chini chawuno vona nane	wish you all the best
muthakathi	witch
muroyi	witch
na	with
kuvhisa	withdraw
kuvhisa	withdrawal
mupimo	within
-tama	without
fakaza	witness
zvomujimu	witty
imbwa yo musora	wolf
dzimai	woman
mudzimai	woman
mwanakadzi	women
wawina	won
awendi	won't
shama	wonder
kudakadzisa	wonderful
muntsentsi	wood
matanda	wood
jehe	wool
soko	word
izwi	word
magama	words
-shanda	work
kubatira kunja	work out
kubata mushando	working
nyika	world
honye	worm
gonye	worm
chapera	worn
kuneseka	worried
thukathuka	worry
kuneseka	worry
kupinda umweni	worse
kunamata	worship
kushatisisa	worst
zvinofanera	worth
zviri nane	worth it
wakanaka	worthy
ndayizozvita	would
chivonje	wound
Yuwii	Wow
putira	wrap
uchunga	wrath
dziso romuhoko	wrist
-nyora	write
Bhara apa	Write here
Nyora apa	Write here
kunyora : zvinyorwa	writing
zvanyohwa	written
andizvopi	wrong
wakanyora	wrote
ruvanje	yard
amura	yawn
eya	Yeah
gore	year
makore	years
muthombo	yeast
gokorora	yell
safarawu	yellow
eya	Yes
zvakana mudikani wangu	yes baby
zvakanaka mudikani wangu	yes dear
uchi wakanaka	yes honey
ndizvona mudiwa wangu	yes my love
ndozvina kamare	yes of course
zuro	yesterday
kubeno	yet
ruphochero	yield
iwewe	you
iwewe ndiwe	you are
wakabanaka	you are beautiful
wakaseja iwewe	you are so beautiful
mweyibongei	you are welcome
gumayi ushoni	you are welcome
unokwanisa kuyita	you can
unozviziva	You know
na iwewevo	you too
kugami ushoni	you're welcome
mujaha	young
mufana	young
chako	your
mwauya	your welcome
gumayi	your welcome
iwewe	yourself
iwe	yourself
majaha	youth
mweibongei	you’re welcome
zvinonaka	yummy
zero	zero
