Un	a
se kentsi	a little
miyak	a lot
miyak	a lot of
teijkaua	abandon
ijkatoke	abandoned
kieua	abide
yolokayotl	ability
uelitini	able
tlen tlachke	about
pechitok	above
ipan tlen chontali	abroad
axkanaki	absence
amoixpani	absent
nouanyotl	absolutely
ijitilana	absorb
abstracto	abstract
absurdo	absurd
tlaojonka	abundance
tlalkiuak	abundant
Tepantlaksalistli.	abuse
katsakamanali	accent
uelkaki	accept
kalakilis	access
tlakokoke	accident
tesiliya	accommodation
tlanokpiliua	accomplish
axiltiya	accomplished
tlateuxpanuili	according
pouali	account
saueltsi	accuracy
saueltsi	accurate
tlateiljuitoke	accused
kokoa	ache
axitis	achieve
tlamamatsolistli	achievement
machiotlayotl	acknowledge
nikixmati	acquaintance
temolia	acquire
axkauiya	acquired
axkatiani	acquisition
ixpano	across
ainilistli	act
xipeua	action
aini	active
tekipanolistli	activities
tekipanolistli	activity
actor	actor
tleneliya	actual
in tlaneltika	actually
tenatik	acute
moyetstika	adapt
piuili	add
koxhipatili	addicted
piui	addition
setiliya	additional
mocha	address
inamik	adequate
adyacente	adjacent
tlajtouali	adjective
tlakualali	adjust
teitsauiya	admire
tlaseliya	admit
piltsintia	adopt
netetoloani	adorable
nenemilchitoke	advance
nenemi	advanced
nitekixtia	advantage
tetsauyotl	adventure
kautik	adverb
teneua	advertisement
teneua	advertising
tlaltolnamijki	advice
mamanali	advise
temanauia	advocate
motlayoltilis	aesthetic
tlamantli	affair
teijnelia	affect
tlasojtli	affection
istok nechkatsi	afford
asequible	affordable
nimamauij	afraid
Teipa	after
tiotlak	afternoon
teipa	afterwards
sampayanok	again
axkualtijtok	against
moxiui	age
amatlakuilokan	agency
kalotl	agent
sankinenejktok	aggressive
axetik	agile
ijka	ago
tlainamiki	agree
senkaua	agreement
milsnkayotl	agriculture
axtui	ahead
tlapaleuili	aid
axiltiya	aim
ajakatl	air
ejelkixoayan	airport
kalojtli	aisle
kakalmeualistli	alarm
uino	alcohol
alertar	alert
yoltok	alive
nochimej	all
kuali ti'istok	all right
nochi tlen kuakuali	all the best
nijkauas	allow
mokaua	allowed
nexka	almost
iselti	alone
tlen ueyi ipan	along
ya	already
necepatlantoli	Alright
nojkia	also
kauantinami	alternative
masje	although
nochipa	always
na ni	am
ax nichiyaya	amazing
ambiguo	ambiguous
ixtlaneneki	ambition
tlaixneneki	ambitious
tlakualalilis	amend
tlajkoyan	amid
tlatlajko	among
san pantojuati	among us
keski	amount
Tlamauisoli	amusing
se	an
ijitlajolistli	analysis
uejkapanimej	ancestors
akachikoli	anchor
tetatsi	ancient
uan	and
uan Ta?	and you
ángel	angel
sankuajkualantok	anger
ángulo	angle
kualantok	angry
tekuani	animal
kekeyoli	ankle
senuauetilistli	anniversary
yolmeyauali	announcement
tlaajasi	annoy
ixkualantok	annoyed
kualantok	annoying
xijuitla	annual
axtikixmati	anonymous
seyoj	another
tetlalkuepalistli	answer
ximoaxtui	anticipate
axueli tlaiyontilana	anxiety
kinenejtok	anxious
tlenueli	any
ayoktle	anymore
tlenueli	anyone
axtleno	anything
tlen uelij panos	anyway
maske	anyways
sekoyoj	apart
chankali	apartment
tlapopouiya	apologize
tepatlajtoli	apparent
uelitita	apparently
ompayotl	appeal
nextia	appear
ixpantia	appearance
nimonexti	appeared
mayana	appetite
mantsanatl	apple
tlasiuitilistli	application
tetechkitoa	apply
nauatiya	appointment
teijnelsi	appreciate
iknekilis	appreciation
asikojya	approach
yani	appropriate
yolnankilistli	approval
yolnankiliya	approve
tlatemolili	approved
niixtlaliya elij	approximately
abril	april
arbitrario	arbitrary
kalmanani	architect
kalmanayotl	architecture
amatltlapia	archive
elij	are
ti istok	are you
timo tekiuijtok	are you busy
timo namijtiktok	are you married
ti monamijtok o timoselti	are you married or single
nojuan ti'istok nopano	Are you still there?
ti'istok nopano	are you there
tlskuikui	area
kualantlikayotl	argue
kamalistli	argument
kueponi	arise
akolmaitl	arm
yoatltekemej	army
tlen iyaloj	around
senkaua	arrange
tlayektilistli	arrangement
asikoli	arrival
asik	arrive
asiko	arrived
omeyolo	arrogant
mitl	arrow
toltekayotl	art
ijtoli	article
tlatotelkauili	artificial
toltekatl	artist
kejatsa	as
ijkuak	as long as
nojkia	as well
tlen kuali kejatsa	as well as
nextli	ash
pinauali	ashamed
tlatlani	ask
tlatlanki	asked
kochtok	asleep
katsa nesi	aspect
Assamese	Assamese
tlaixtekili	assault
ensamblar	assembly
kiaxiltili	assertive
ilnamikamatl	assess
ilnamikamatl	assessment
aini	asset
aini	assets
temamaka	assign
semiluitekitl	assignment
ita	assist
tepantilo	assistant
achiuikal	associate
nechikoli	associated
nechikolistli	association
tlejkoliya	assume
nijtlaliyaya	assumption
in	at
maske kentsi	at least
tlakuajki	ate
painalton	athlete
titlalis	attach
on titlania	attached
nitlaliya	attachment
tkauilanketl	attack
keloa	attempt
ixiptlati	attend
tlen asiko	attendance
tlayeuakilistli	attention
tetsauil	attitude
tlamatlaluiya	attract
tlatlakuoilini	attraction
senka yeyejtsi	attractive
tenamaktli	attribute
poualtlajtoli	audience
agosto	august
aui	aunt
aui	aunty
autentico	authentic
autor	author
tlanauatikame	authority
tonalko	autumn
eltoj titekiuis	available
tlen tkajko elij	average
axtikauilis	avoid
isatok	awake
tetlautili	award
tlailnamiktok	aware
inonemilis	awareness
kalteno	away
kuali yeyejtsi	awesome
fiero	awful
iaxkualistok	awkward
Aymara	Aymara
pilkonetsi	baby
siuatlanki	bachelor
ijka	back
antecedentes	background
tlanaui	bad
xikiplitontli	bag
cebo	bait
ijsi	bake
pantsichiuayan	bakery
bicarbonato de sodio	baking soda
Tomi mokaua	balance
tlachtli	ball
Bambara	Bambara
kuaxilotl	banana
uampoyomej	band
tlatopontli	bang
tominkali	bank
oknankali	bar
sanok	barely
achinijtemouiya	bargain
tllauaja	bark
tlauli	barley
tlatsakuili	barrier
neluayotl	base
tlinkatsa	based
tolkaltsintla	basement
moneki	basic
basicamente	basically
albahaca	basil
tepalkonetl	bastard
tlalkaltsi	batch
axixkali	bath
kuitlakali	bathroom
batería	battery
nekalilistli	battle
anepalko	bay
elij	be
ximomaljui	be careful
xaltentli	beach
tlauil tlapetlantli	beam
etl	beans
ni ijiyouiya	bear
tentsontli	beard
yelistli	bearing
tekuani	beast
tlauiuika	beat
Kualualtsi	beautiful
nematini	beauty
nimokuepki	became
paratle	because
kueptok	become
tlapechtli	bed
kochiuayan	bedroom
neksayoli	bee
nakatl	beef
sido	been
achichik	beer
achtui	before
pejki	began
peuas	begin
pejtli	beginning
tlen tla makaua	behalf
yelia	behave
katsa nenemilis	behavior
katsamochiua	behaviour
ne ika	behind
eltoj	being
neltokokayotl	belief
temactli	believe
ijti	belly
axkaitl	belong
tlasojtli	beloved
tlatsintla	below
pitsauautli	belt
ikpali	bench
kualpachoa	bend
intsintlan	beneath
teiknekilistli	benefit
teiknekilistli	benefits
sansejko in	beside
nojkia	besides
senka	best
miyak itonali	best of luck
tlenkikuilo	best regards
osenka	better
xoloxtli	between
tlaili	beverage
achi ne	beyond
Bhojpuri	Bhojpuri
tetlapalnsuilistli	bias
sesgado	biased
omemalakatl	bicycle
tlatomintemoli	bid
ueyi	big
omemalakatl	bike
postektli	bill
ilpia	bind
tototl	bird
pakilis itonaltlakatki	birthday
pilkentsi	bit
tlankechili	bite
chichik	bitter
yayauik	black
xiuitl	blade
tlajtlakoli	blame
in chipauak	blank
tlakemitl	blanket
tlatopontli	blast
tlachipauili	bleach
tlaneloa	blend
tlatiochiuali	bless
teotiochiuali	blessed
axtlachiya	blind
pakilistli	bliss
nopanoyiya	block
estli	blood
xochitl	bloom
tlaajapeua	blow
matlaltik	blue
axtlateki	blunt
uapali	board
tepoxkaxil	boat
nakayotl	body
moloni	boil
apinauani	bold
mekatl	bond
omitl	bone
amoxtli	book
piui	boost
ual tlapaleuiya	booster
kaktli	boot
kaktli	boots
kalixkuatl	border
atlauinani	bore
kuesiui	bored
tlatsiuili	boring
elki	born
tlaneltili	borrow
tlanauatijki	boss
ojome	both
tlaajasi	bother
teuilospastli	bottle
sentlani	bottom
nikokjki	bought
tempixoa	bounce
tlatsoyitili	bound
kualixkuatl	boundaries
pachoa	bow
tazón	bowl
kalotl	box
telpokatl	boy
tlaixnamik	boyfriend
makistli	bracelet
kuayolotl	brain
seyok amatlakuilokan	branch
tekineskayotl	brand
kolotik	brave
infracción	breach
pantsi	bread
siakauilis	break
tenisalistli	breakfast
elpantli	breast
tlaiyotilana	breath
tlaiyotilantli	breathe
mekayotl	breed
xamixtli	brick
noaxka	bride
panotlaokan	bridge
achik	brief
Tlapetlantli	bright
tlapetlantli	brilliant
ualika	bring
ijni	bro
patlantik	broad
transmisión	broadcast
postektok	broke
tsayantok	broken
tlaxpanotl	broom
ijni	brother
kompa	brother in law
koyoyomitl	brought
poktik	brown
tlaixpetlaua	brush
teposkaxil	bucket
uampo	buddy
istlapoaloni	budget
ilamaokuilin	bug
kalchiuani	build
uekapanksli	building
tlakestli	built
tlamamali	bulk
okichuajka	bull
tlaajasi	bully
tlaluitekilistli	bump
sempcholi	bunch
tlamamali	bundle
tlamama	burden
kijtokeya	buried
tlatla	burn
topontli	burst
toka	bury
ueyiteposkauayo	bus
kuautontli	bush
kaltlanamakaketl	business
tetltlaixkopinka	bust
motekipachoa	busy
pero	but
kuakuauaseseyotl	butter
papalotl	butterfly
boto N\A	button
coui	buy
uajka	by
uan nojkia	by the way
ti moitase	bye
kiltektli	cabbage
tekiuejmej	cabinet
teposkali	cage
nekuyopantsin	cake
kotstli	calf
tsanonotsalistli	call
xinechnotsa	call me
nonotski	called
seseuili	calm
uslajki	came
campaña	campaign
tepostkajtli	can
axniueli	can't
tlatiluauani	Cancel
temalotl	cancer
uelitini	capable
tlen uelij	capacity
altepetepantlajtokan	capital
piltlakuiloli	caption
matilistli	capture
teposkauayo	car
ijisiulti	career
netlakuitlauini	careful
ikalmaluili	carefully
yolokimalo	careless
tlasojtli	caring
kuauxinki	carpenter
palpetlatl	carpet
kaxtilkamojtli	carrot
kiuika	carry
tepostoka	carry on
tijukas tlanauatiketl	carry out
tlajkia	case
tomi	cash
tetatlxexeuilistli	cast
kaxtilkali	castle
atenamachpan	casual
misto	cat
itski	catch
categoría	category
kkyakuapialmej	cattle
kiski	caught
pejki	cause
icamanajuili	caution
precavido	cautious
ostotl	cave
cesar	cease
eljuikak tlakakayali	ceiling
iljuitl	celebrate
yolisatichitontli	cell
tlajtlajko	center
poualxiuilistli	century
cereal	cereal
ijtotl	ceremony
nelia	certain
nelnelia	certainly
yolnankili	certificate
teposmekatl	chain
ikpali	chair
ouilistli	challenge
inmanyotl	chance
patlas	change
tlaxitinilia	chaos
ajkaya maseual	character
kejatsa ekij	characteristics
tekitiya	charge
ikneliyotl	charity
tlaxochiuilistli	charming
nautlateuili	chart
atlakamachtili	chase
tlakamauili	chat
axpatiyo	cheap
tlakakayaua	cheat
netlakanekolistli	cheating
amatltlaxtlauili	check
kamapantli	cheek
yolomajka	cheer
paki	cheerful
kuatsatsitlapaleuili	cheers
tlatetsauili	cheese
paleyislotl	chemistry
mauilotsi	cherish
kuapatoli	chess
ixpa	chest
tlakuajka	chew
piyo	chicken
tlanauatiketl	chief
konetsa	child
koneyotl	childhood
konemej	children
tlasesekayotl	chill
popokalkisani	chimneys
tenchali	chin
chokolatl	chocolate
tlapepenali	choice
tlatemoli	choose
tlatejteki	chop
tekiotl	chores
tomaktik	chubby
teokali	church
auiyakpopotli	cinnamon
malakachtli	circle
panoj tlamantli	circumstances
altepetlakatl	citizen
ueyialtepetl	city
tlateluili	claim
tlauiya	clarify
machtiyotl	class
tsokitl	clay
chikuentli	clean
tlaauilo	clear
tlen tlanamaka	clerk
isnamiketl	clever
tlajkoketl	client
tepixiuiyo	cliff
tlaliskayotl	climate
tlaxoxotlali	climb
kinamiki	clingy
tonalmachiotl	clock
nechka	close
kuautilmakali	closet
yoyomitl	cloth
yoyomitl	clothes
mixtli	cloud
tlamixtemi	cloudy
nenexolotl	clown
kualojtli	clue
tsotsonak	clumsy
clúster	cluster
tlamaxtiketl	coach
tlikoli	coal
anauatl	coast
netlakentilistli	coat
maluili	coffee
cognitivo	cognitive
tijmopantijke	coincidence
sesek	cold
uetski	collapse
kostli	collar
uampo	colleague
uampoyomejtekitini	colleagues
pixkalistli	collect
semanalistli	collection
ueitlamachtikalko	college
tlapaktli	color
Las ideas verdes incoloras duermen furiosamente	colorless green ideas slept furiously
tlapaktli	colour
temimili	column
xiluiya	comb
tlamaneloa	combination
tlamaneli	combine
ualaj	come
xiuala nika	come here
tiyuii	come on
kochsikaualistli	comfort
kualisiyakajtok	comfortable
nenechka	coming
nexkaya	coming soon
nauatini	command
nokamanali	comment
tlakoyan	commercial
tlaxtlauili	commission
techiuili	commit
motemaka	commitment
tetechtlakautli	committed
siajkakuchilistli	commodity
axkatl	common
tlamatilistli	communicate
machiyopanolistli	communication
nepetlantikayotl	community
nenemilis tipan tekitl	commute
uampo	companion
ueyitekimakani	company
tlaneneuili	compare
tlaneneuilistli	comparison
iknoakayotl	compassion
tlaijnelia	compassionate
compatible	compatible
mokuenta	compete
ixkomalistli	competent
ixkomalistli	competition
ixkonmakayotl	competitive
tena	complain
kauaj	complaint
axiltili	complement
piuili	complete
sententika	completely
nejneliaoui	complex
kaua	compliance
ouili	complicated
axili	compliment
axitiya	comply
amatlakuiloli	composition
tlalilijtok	compound
iknomatilistli	comprehension
axiltok	comprehensive
yolkamanalmaka	compromise
telsoyalistilistli	compulsory
chiupoualuastli	computer
concentrarse	concentrate
ki'itosneki	concept
tlapololtia	concern
mokuesoli	concerned
tetoskanamiklistli	concert
tlamilistli	conclusion
temachtli	concrete
yun	condition
condiciones	conditions
mekamay	conduct
tlakamanalistli	conference
yolmelaua	confess
temaxtli	confidence
tikamauilis	confident
nisenkauas	confirm
kualantlikayotl	conflict
ixkuepa	confused
tentsakualistli	confusion
kisenpakayotl	congrats
pakilistli	congratulation
pakilistli	congratulations
iuanistli	conjunction
olmekatl	connect
peuamatoma	conquer
kiixmachiliya	conscious
neyoliximalistli	consciousness
tetlauelkakilistli	consent
tlamispantilis	consequences
tlachiualistli	conservation
tlachiuali	conservative
noyolnonotsa	consider
neyononotsali	considered
consistir	consist
consistencia	consistency
teixnamikini	consistent
yolotlapaltik	constant
yotlapaltik	constantly
tletokoltilistli	constipation
tlachichiuali	construction
sentlamia	consume
tlen nimokauiya	consumption
tetsinuiliya	contact
temaua	contagious
ixchiya	contain
tlenkipixtok	contains
amanok	contemporary
yolispacholi	contempt
tlen kipiya	content
ixkomakalistli	contest
contexto	context
ueytlapan	continent
tepostoka	continue
tlakeuali	contract
contraste	contrast
Tominpalewilistli:	contribute
tomitlapaneuili	contribution
control	control
tlakualantli	controversial
neltokayotl	convenience
neltokayotl	convenient
kamanaloa	conversation
mokuepa	convert
kamanali	convey
ejeleki	convince
elekili	convinced
tlakualchiuali	cook
tlakualchiualoyan	cooking
selik	cool
tlaixtlauili	cooperation
sempapano	cope
amochitl	copper
tlajtlajko	core
sintli	corn
kalnakalistli	corner
melauak	correct
ipati	cost
koyoyomitl	costume
xakali	cottage
ichkatl	cotton
sillón	couch
Tlatlasi	cough
ueliskiaj	could
necentlalistli	council
konde	count
i'ixko	counter
mexkotlali	country
ixtlauak	countryside
sansejko	couple
patiyotl	courage
tlamaxnextili	course
tlatlalislatokan	court
nematkayotl	courtesy
machijkni	cousin
ixpachoa	cover
uakax	cow
amotlapaltik	coward
yolchankayotl	cozy
atekuistli	crab
tlaltlapajktli	crack
ijkimailchiuali	craft
kuitlatl	crap
kalani	crash
kixtoka	craving
manenemi	crawl
yolopoluiki	crazy
kichiua	create
nextilistli	creative
Tomintlanetilistli:	credit
mouatana	creep
espeluznante	creepy
tepostekitini	crew
tlatlajkoli	crime
tlapenaualti	cringe
crisis	crisis
ixkoyotl	criteria
popoua	critical
tlapinatiya	criticism
tlapixkayotl	crop
tlaxpilkayotl	crops
kuatolo	cross
kakalotl	crow
sentilismaseualmej	crowd
temouak	crowded
kopili	crown
tlauel moneki	crucial
atlakayotl	cruel
panoayan	cruise
miyakej	crush
chokolistli	cry
ayoxoxoukatl	cucumber
tekochili	cuddle
ueuetlajtoli	culture
tlachialiani	cunning
apiloli	cup
kuautlauankali	cupboard
tlatentli	curb
tlachikauali	cure
tlapitsali axkisa	curfew
tlanematkachiualistli	curiosity
tlanematkachiuani	curious
kolotsin	curly
tepostomi	currency
amanok	current
amanok	currently
akualitilistli	curse
tokapantli	curtain
kuachikpali	cushion
tlamanatilistli	custom
tlakoketl	customer
kualuxkuakali	customs
teeki	cut
yeyejtsi	cute
youaltiketl	cycle
omemakani	cycling
tata	dad
tatatsi	daddy
momostlatika	daily
lechiualayo	dairy
apatlikuiuayan	dam
itlakoa	damage
tlatelchiualistli	damn
kuachauastli	damp
mitotilistli	dance
ouilistli	danger
maluili	dangerous
yayauik	dark
teijnelsi	darling
guion	dash
tonaliistoke	data
tonali tistoke	date
nosiuakone	daughter
tonal	day
mijtok	dead
tonal tlami	deadline
axtlakaki	deaf
timokaua	deal
non poui	dear
mauiloki	Dear All
kuali tlakoketl	Dear Customer
maluiloki tatamej	Dear Parents
maluiloki	Dear Sir
maluiloki temachtiamej	Dear students
maluiloki uampoyomej	Dear Team
mikilis	death
kamamoiluiya	debate
débito	debit
mokajki	debris
tlauika	debt
matlaktli xiutl	decade
palantok	decay
mijktok	deceased
tlakakayaua	deceive
diciembre	december
kualmaceual	decent
tlapepena	decide
ninejki	decided
tlanekilistli	decision
mazo	deck
exelistli	decline
temoili	decrease
itechpoani	dedicated
kichiuiliya	dedication
tlajkuilolistli	deed
sentlakoyauak	deep
masatl	deer
in tlapilchaualistli	default
yoatlapolojke	defeat
mamauiya	defend
kejtsa	define
keni mokauas	definitely
tlanesemixnauali	definition
tlen tlamaxtili tiyaj	degree
mokajtok	delay
mojkatok	delayed
kotona	delete
deliberado	deliberate
nematkatili	delicate
ajuiyak	delicious
pajktia	delight
tlaxochiuili	delighted
temaka	deliver
temakak	delivered
kauiltili icha	delivery
tlateluili	demand
itstlakauiya	demanding
tlajkatlatokayotl	democracy
tlakatekolo	demon
nextiliya	demonstrate
amonijmati	denied
tonali	density
tlankopinani	dentist
amonijmati	deny
chankali	department
kisalistli	departure
kenijkatsa	depend
tlasoua	deploy
tetlakakaua	deposit
anonotsalani	depressed
axueli tlaiyontilana	depression
uejkatlaya	depth
keni elij	describe
kejatsa	description
tlauajkapanixtlauak	desert
niseliya	deserve
nextiyotl	design
tekikajketl	designation
nekiskia	desire
akopechtli	desk
ijiyomijki	despair
motlaluelpoloani	desperate
maske axkeni	despite
tekualualistli	dessert
tonali asis	destination
tonali	destiny
tlaixpoloua	destroy
tlapouilistli	destruction
detalle	detail
kenijatsa	details
tlamachili	detect
tlaselmiluilistli	determination
tlamiyali	determine
determinado	determined
pisili	devastated
moskaltik	develop
tomoskaltia	developed
mochichiuali	development
tlamantli	device
tlakatekolotl	devil
neltokani	devoted
Dhivehi	Dhivehi
tlatsopelkokolistli	diabetes
mapitsa	diarrhea
nochipa	diary
tlajtolamoxtli	dictionary
chijki	did
mikistli	die
mijktok	died
netlakualistli	diet
amoneneukayotl	difference
ax ijuikal	different
oui	difficult
oskali	dig
tekuyutl	dignity
miyakmomachtiya	diligent
tlayoltlakuali	dinner
chilmoli	dip
tlamelaualia	direct
dirección	direction
tlakatltlajtoani	director
sokiyo	dirt
sukiyo	dirty
tij tlakokolo	disable
takololi	disabled
poliui	disappear
mokajkayajki	disappointed
ouitepanyalistli	disaster
tlatemouili	discard
ma moketsa	discharge
tenonotialistli	discipline
tomintemo	discount
tlanextia	discover
axkinekiitase	discrimination
kamanalkualankayotl	discuss
tlakualantli	discussion
kokolistli	disease
kokoxkayotl	diseases
mixpolouaj	disguise
motlailtiani	disgusting
tlakuali	dish
tlakuakusli	dishes
ixkomotona	dismiss
makaua	dispatch
tetlauitilistli	display
payanki	disposal
kualankayotl	dispute
kalkayotl	distance
seyoj	distinct
ixmati	distinguish
eleli	distress
xexeloli	distribution
altepetlatilantok	district
tekamatsakua	disturb
kuatlakoyontli	ditch
apoxontli	dive
amoneuki	diverse
nepanyotl	diversity
xexeloa	divide
olinyotl	divine
nematumalistli	divorce
kuaixpoyaui	dizzy
chiua	do
Ta	do you
tinech tlasojtla	do you love me
tlapatijketl	doctor
amatl	document
kichiua	does
axtle	doesn't
chichi	dog
Dogri	Dogri
kichiua	doing
siuajauili	doll
axkayotl	domain
tlakasiuki	domestic
tekpani	dominant
axtle	don't
amo ximotekipacho	Don't worry
temaktia	donate
keni elki	done
poloko	donkey
xiuiyo	dope
tlakuelpacholi	double
sanelli	doubt
tixtli	dough
tlatsintla	down
tlatemouili	download
axtui ixkopinka	draft
mouatani	drag
akoyojtli	drain
ixeusyilistli	drama
tlaixkopinkayotl	draw
kalotl	drawer
tlajkuiloli	drawing
majmajtli	dread
kochilistli	dream
kentiaj	dress
amalokotl	drill
tlaili	drink
note yakana	drive
tlachipintli	drop
xikixtika	dropped
tlauakapatlan	drought
iuintini	drunk
uajtok	dry
patox	duck
tlakopinali	dude
uajkaparatle	due
axuelis pampa	due to
pilachi	dull
kuauiuiti	dumb
potlania	dump
uejkaktli	duration
kema panoyaya	during
poktli	dust
tepanichketsa	duty
chantli	dwell
nemosiuilistli	dying
kema	each
se se	each other
ansioso	eager
kuaitli	eagle
nakas	ear
achi kualka	earlier
inaltsi	early
tlatlani	earn
nakas	ears
tlaltepaktli	earth
tlalolin	earthquake
oyouijka	ease
axui	easily
nin	east
Nahuatlajtoli Kuextekan ikisayo	Eastern Huasteca Nahuatl
amoui	easy
tlakualistli	eat
tlakualilistli	eating
amopatik	economic
tominatilistli	economy
tlatentli	edge
ixkatokyalalili	edit
temachtiloyan	education
kasaneli	effect
Tomi	effective
saueltsi	efficiency
tekisemakayotl	efficient
temakatl	effort
teksistli	egg
kamojtomatl	eggplant
chauastli	ego
chikueyi	eight
matlaktli uan chikueyi	eighteen
najpoali	eighty
o	either
tlachichiualistli	elaborate
moli	elbow
ueuentsi	elder
ueuentsi	elderly
piltikayotl	elegant
tlapeukayotl	element
elepantli	elephant
matlaktli uan se	eleven
kipepenasej	eligible
kotona	eliminate
puitl	else
pinatok	embarrassed
tlapinatiya	embarrassing
nanajua	embrace
tsonkisa	emerge
ijisiultitlayolmelauili	emergency
olinyotl	emotional
nojnimachiliya	empathy
énfasis	emphasis
enfatizar	emphasize
tekitlakakili	employee
tlakakili	employees
tekimakaketl	employer
tekitl	employment
kakjtok	empty
tlaktepan	enable
pantis	encounter
yolpaleuili	encourage
tlanki	end
tlen nexka poliuis	endangered
chikaulistli	endeavor
teixnauatilistli	endurance
axmijki	endure
yaotl	enemy
teotilistli	energy
mo temaka	engage
tetechtlakaualistli	engaged
tetechtlakaualistli	engagement
teposyolotl	engine
kuayolomachtiani	engineer
anglitekatl	English
tlachikauali	enhance
tlauisolij	enjoy
uextik	enormous
kenopaya	enough
ueyoloyia	ensure
kalaki	enter
tlamauitsoli	entertainment
tlayolpakiliya	enthusiasm
ueyi ipakilis	enthusiastic
senkiska	entire
amoxtokaitl	entitled
entidad	entity
kalakilistli	entrance
tekitekuli	entrepreneur
ipan	envelope
nochi nikani	environment
yolkokoa	envy
épico	epic
tlaltepakokolistli	epidemic
iuikal	equal
equipo	equipment
tlakiyotl	equity
iuikal	equivalent
tetlaixpouili	eraser
kuapololi	error
choloua	escape
especialmente	especially
yeyekolistli	essay
uojiyakpopochuiya	essence
monenekayotl	essential
tetlaliya	establish
tlatlalili	established
axkatiani	estate
maluiyokayotl	estimate
mauiloki	estimated
sampayanok	etc
amotlami	eternal
ética	ethics
ilnamikamak	evaluate
ilnamikamatl	evaluation
nouan	even
maske kema	even though
tlayoua	evening
sentilis	event
sankemantsi	eventually
se uelta	ever
sesen	every
nochimej	everybody
nochimej	everyone
nochi	everything
tepatlajtoli	evidence
tlauelilok	evil
uejkatlapatla	evolution
uejkatlapatla	evolve
Ewe	Ewe
ayo	ex
saueltsi	exact
mero kenopa	exactly
tetlamolistli	exam
tetlatlachiya	examine
machiotl	example
panoltik	exceed
tlauel senka kuali	excellent
neaxtle	except
neaxtle	exception
chimaltolistli	excess
chimaltolo	excessive
tlapatla	exchange
yolpaki	excited
pakilistli	excitement
olinyotl	exciting
exclusivo	exclusive
ixtlakamanali	excuse
tetlapopoluili	excuse me
miktichiuas	execute
ipanchiualistli	execution
ichtkakatekitili	executive
neyekolistli	exercise
auatsalistli	exhaust
pokyotl	exhausted
tlanextilini	exhibit
nextiliya	exhibition
yolistli	exist
yolistli	existence
yolistli	existing
kisalistli	exit
ueychiua	expand
mochiya	expect
chistok	expected
yalti	expenses
patiyoj	expensive
uejkatlaixmatilistli	experience
tlateixpaueli	experiment
tlaixmamati	expert
tepanauili	expired
melauaknikitoa	explain
tlamachtili	explanation
tlatopontl	exploit
tlatetemoli	explore
ontlakixtiliyan	export
tlachilistli	expose
monextijtok	exposed
kakiskamanali	exposure
ijisiulti	express
mitspantsinko	expression
moyaua	extend
moyauak	extended
piuili	extension
patlauak	extent
kalteno	external
extintotksseuilotl	extinct
seyoj	extra
kixtiya	extract
extraordinario	extraordinary
mauistik	extreme
tlauel	extremely
ixtiyol	eye
ixtiyol	eyes
yoyomitl	fabric
sanpajktok	fabulous
ixko	face
ayouijka	facilitate
tlakualilistli	facilities
tlatlatlaliya	facility
chiuali	fact
tlayokoyan	factor
tlayokoyan	factory
chiuali	facts
yolmikilistli	fade
ijtlajko	fail
fallé	failed
itlajko	failure
sotlajki	faint
kuali melauak	fair
melauak	fairly
hada	fairy
tlaneltokilis	faith
netlakanekili	faithful
istlakatik	fake
ueski	fall
TLAISTLAKATI	false
tenyilistli	fame
senyeloj	familiar
senyelistli	family
apismikistli	famine
tenyotekatl	famous
tenenekij	fan
tlayekchichiuilistli	fancy
topali	fantastic
uejka	far
teixnauatilistli	farewell
chantlajkali	farm
yolkapixki	farmer
tlauel senka kuali	fascinating
tlasojmayotl	fashion
ijisiulti	fast
tomauak	fat
mikilistli	fatal
tonali nemilis	fate
Tata	father
kuatijka	fatigue
poliui	fault
iknelia	favorite
tepaleuilistli	favour
paleuiloni	favourite
mamajketl	fear
iljuitl	feast
ijuitl	feather
kejatsa tikixmatis	feature
kejatsa tikixmatis	features
febrero	february
tlakuali	fed up
tekatlaxtlauili	fee
tetlamaka	feed
sampa ti chiuasej	feedback
machili	feel
yolmachilistli	feeling
mets	feet
uetski	fell
uampo	fellow
machili	felt
siuatlmaseual	female
nexka	fence
tlakoneuiya	fertile
iluiyotl	festival
ualijka	fetch
kokolistotonikayotl	fever
pilkentsi	few
kentsi	fewer
tetecholi	fiance
axneliya	fiction
teotlali	field
tekuani	fierce
kaxtoli	fifteen
ompoali uan matlaktli	fifty
tlauilantli	fight
tlauilantli	fighting
ijkuilolistli	figure
kisenkaua	figure out
amatlajokuilo	file
tlatemitili	fill
relleno	filled
nelmelaua	film
motlailtiani	filthy
Tlamitilijke	finally
tominkayotl	finance
totomikayotl	financial
panti	find
tlatsontekilis	find out
kuali	fine
mailpil	finger
tlamijka	finish
tlanki	finished
tlitl	fire
tlaneltiloni	firm
axtuui	first
sentokayatlo	first name
michi	fish
kikui	fit
makuili	five
senkaua	fix
tlakualalijki	fixed
pantli	flag
tlapetlantli	flash
kuetsikali	flat
tlapilchiualistli	flaw
yektik	flawless
choloa	flee
nakatl	flesh
patlanki	flew
kuextlaxtli	flex
kuextlaxtli	flexible
patlantli	flight
sampa mokuepa	flip
coquetear	flirt
coqueteo	flirting
semantiuilistli	float
atitlakalakia	flood
tlapepechtli	floor
yoltechtli	flour
yuyuui	flow
Xochitl	flower
tsonpili	flu
yuyujui	fluent
con fluidez	fluently
pachontik	fluffy
fluido	fluid
pantli	fly
tlaixiuilistli	focus
ayauitl	fog
tlamixtemi	foggy
kuexpacho	fold
ikniutin	folks
totokati	follow
tepostoka	follow up
siguiente	following
tlakuali	food
kuauiuiti	fool
xolopitli	foolish
mets	foot
fútbol	football
para	for
tetlapolotia	For example
xi yeyekoli	for instance
tlen ta	for you
achiualoni	forbidden
chikaulistli	force
tlayolteouilistli	forecast
ixpan	forehead
koyotl	foreign
tlauitlanti	forest
nochipa	forever
kilkauaj	forget
tlapopoljui	forgive
kilkalki	forgot
teposnakateki	fork
tlapoaltlakuiloli	form
nitse	formal
achtopan	former
tlen itonal	fortunately
tlatkitl	fortune
ompoali	forty
ompoali uan ome	forty-two
axtui	forward
tiselis	foster
nitla uilanki	fought
nipanti	found
peualistli	foundation
naui	four
matlaktli uan naui	fourteen
ostoatl	fox
yamanik	fragile
nautlateuili	frame
armazón	framework
tlakakayali	fraud
xolotl	freak
amotlainaketl	free
tlanemakayotl	freedom
istik	freeze
ajachika	frequency
achi nochipa	frequent
achi nochipa	frequently
seseltik	fresh
viernes	friday
teposesekayotl	fridge
uampo	friend
ijuitoloni	friendly
ijniuamej	friends
ikniyotl	friendship
majmajtli	frightened
tlamamajketl	frightening
xokualochi	frog
in	from
kuajtol	front
semiktli	frozen
ijtlajka	fruit
polantok	frustrated
tlen tlatla	fuel
Fulfulde	Fulfulde
temik	full
pakili	fun
tlaakiltlachiua	function
neluayotl	fundamental
tlamikilistli	funeral
pakilis	funny
tsonkal	fur
tlilkualantok	furious
tlatkitl	furniture
piui	further
nojkia	furthermore
okachiuali	future
asik tlamantli	gain
ajauili	game
kakauatik	gap
teposkauakajokui	garage
tlasoli	garbage
xochitla	garden
kosnakatl	garlic
tlatsakuiloli	gate
pixkanilistli	gather
piskanilistli	gathering
tlayeyekoua	gauge
kijto	gave
sansejkomej	gear
sesentlamantli	gender
ipanokayotl	general
ipanokayotl	generally
kitlatlani	generate
kintlakatilistli	generation
yoltkapaktitl	generous
tlalnamijketl	genius
sesentlamantli	genre
tlateokanil	gentle
sanyeyo	genuine
xoloxayakatl	gesture
tlanis	get
yoyontiya	get dressed
meualistli	get up
xomochikuaj nima	get well soon
niseliya	getting
sentlapachontli	ghost
ixpatltlakakayajketl	ghosting
tlsauejkapantik	giant
tetlautili	gift
jenginbre	ginger
ixpokatl	girl
noaxka	girlfriend
makas	give
nimo temaka	give up
patoli	given
pakilis	glad
tlachilistli	glance
teskatl	glass
ixteuilotl	glasses
kuali tlachiyali	glimpse
semanauak	global
atle pakyotl	gloomy
maixpachoa	gloves
petlani	glow
tlapetlantli	glow up
tlatlaskiltli	glue
xia	go
tlayakantok	go ahead
xiya	go away
motekas	go to bed
tlen nikasis	goal
panmachiotl	goals
tentsontli	goat
Toteko	god
toteko mistiochiuaj	god bless you
yaui	goes
youi	going
yas ne	going to
teokuitlatl	gold
yatok	gone
yas kanke	gonna
tenkualaktli	goo
kuali	good
tiotlakilti	good afternoon
timoitase	good bye
kuali tonal	good day
Tlapoyoualti	good evening
kuali tekitl	good job
kuali nenestli	good looking
kuali itonal	good luck
tonalti	good morning
tonalti no tlasojtli	good morning my love
Tlapoyoualti	good night
timoita	goodbye
tlapoyoualti	goodnight
iaxka	goods
tiremos ipan internet	Google
Tlajtolkuepa tlen Google	Google Translate
tlalalakatl	goose
tlauel yeyejtsi	gorgeous
sasamijtoa	gossip
niselij	got
nikuamachiliya	got it
tepachiolistli	government
xikiski	grab
youimachtili	grade
pilpilkentsi	gradually
mauismakitilistli	graduate
achtli	grain
tlamakaualistli	grant
tlamakauiltili	granted
xokomekatl	grapes
kiski	grasp
akakauastli	grass
tlasojkamatili	grateful
tlaxolkamakayotl	gratitude
motlalkontli	grave
tenextik	gray
ueyi	great
netlaikolistlilistli	greed
nexikoli	greedy
xoxoktik	green
ximopanolti	greet
tlajpaloli	greeting
tlajpaloli	greetings
tenextik	grey
rejilla	grid
pinaua	grief
tisi	grind
kiski	grip
xiukaloyan	grocery
tlaixnamik	groom
atlakamachtili	gross
tlali	ground
ololi	group
moskalti	grow
iskalti	growth
sankuajkualantok	grumpy
Guarani	Guarani
tlenmelauak	guarantee
tlapiani	guard
nitonalpoa	guess
tlakuanotstli	guest
tlayekanketl	guidance
tlayenkamauiliya	guide
tlaltlakoli	guilty
ajkeya	guy
pilkuekuetsin	guys
netekoliskokoyan	gym
tlamamali	habit
tepetlali	habitat
ni pixtok	had
tlaseuitstli	hail
tsonkali	hair
tlajko	half
kalmelaktli	hall
maitl	hand
euika	handle
tlakatl yeyejtsi	handsome
tlakuapiloa	hang
tiontlapanosej	hang out
pano	happen
panotok	happened
pakilistli	happiness
pakilis	happy
pakilis itonaltlakatki	happy birthday
pakilis motonalejketl	happy birthday to you
yeyejtsi yankuik xiuitl	happy new year
tetik	hard
sanok	hardly
ax axkema	hardly ever
itlakotilistli	harm
iltlakoltik	harmful
armonía	harmony
tlakualantli	harsh
pixkalistli	harvest
pixtok	has
kokoli	hate
pichtok	have
xipiya se kuali tonali	have a good day
xijpita se kuali tonali	have a nice day
tenisalistli	have breakfast
mauisoli	have fun
tijtlakuajki	have you eaten
kipixtok	having
ouilistli	hazard
mixtentli	haze
Ya	he
ya kipistok	he has
ne elij	he is
tsonteko	head
kokoua notsonteko	headache
pachiui	heal
pachiui	healing
chikaulistli	health
pakinemilistli	healthy
tlakaki	hear
nakastli	heard
yoloj	heart
totoniya	heat
eljuikak	heaven
etik	heavy
frenético	hectic
uejkapa	height
tlasemokaui	heir
tlaxtekeme	heist
nipixki	held
miktlantli	hell
Piali	Hello
piali nenejkitl	hello dear
piali kejatsa ti'istok	hello how are you
piali kejatsa ti'istok	hello how are you doing
kuachimali	helmet
tlapaleuili	help
tlatekalistli	helpful
maske	hence
tlen	her
sentlamayolkatl	herd
nika	here
tetlakakauili	heritage
amoneltika	hesitate
kaki	Hey
Piali	Hi
piali kejatsa ti'istok	hi how are you
tlachketl	Hi there
tlatitok	hidden
tlatilistli	hide
tekikayotl	hierarchy
uejkapantik	high
resaltar	highlight
nenejkayotl	hike
tepentlekoa	hiking
tlatlaueliueskayotl	hilarious
Tepexitl	hill
tlen	him
ojtli	hint
topitsauayan	hip
topitsauayan	hips
tlanekuiloa	hire
tlanekuilolistli	hiring
an	his
nemiliskayotl	history
maitl	hit
Mmm	Hmm
panonemilis	hobby
kiski	hold
chia	hold on
ostotl	hole
tekitlasiyakaketl	holiday
kakauatik	hollow
nocha	home
semiluitekitl	homework
mimatki	honest
elchipaualistli	honestly
Nektli	Honey
itaukayotl	honor
kalalajtli	hood
kuamaxali	hook
tsikuini	hop
techialistli	hope
ika tonali	hopefully
ayok temachikayotl	hopeless
auemanilistli	horizontal
tlajtoaki	horn
temanajtli	horrible
tlamamajtli	horror
kauayo	horse
kokoxkali	hospital
kokoxkalpan	hospitality
anfitrión	host
tkauilanketl	hostile
totonik	hot
axiuayani	hotel
imani	hour
imamin	hours
Kali	house
tlenistojke kalitij	household
katsa	how
tlen eltok ta	how about you
Kejatsa ti'istok	how are you
Kejatsa ti'istok	how are you doing
kejatsa elij ama motonal	how are you doing today
kejatsa ti'istok ama	how are you today
kejatsa ti'istok	how do you do
kejatsa	how is
keski	how many
keski	how much
jeje achi nochipa	how often
keski xiuitl tipiyaj	how old are you
kejatsa tipanok mo tonal	how was your day
kejatsa elki moyouali	how was your night
maske	however
tlaxantetektli	hub
ueue	hubby
nanajua	hug
tlauel ueyi	huge
maseual	human
teijnelsi	humble
achixolontok	humid
kuachauastli	humidity
makuilpoali	hundred
mayankayotl	hungry
tlapeuajtli	hunt
ajakatlnamikitilistli	hurricane
isiuitiya	hurry
ximoijisiuilti	hurry up
tekokoua	hurt
ueue	husband
tlaojonolistli	hustle
xakali	hut
tlachipajketl	hygiene
Nani elij	I am
kuali niistok	I am fine
niuelij	I can
axniueli	I can't
na nichiua	I do
axnimati	I do not know
axnimachiliya	I do not understand
na axtle	I don't
ax nimati	I don't know
axnimachiliya	I don't understand
axnimachiliya tlen tijneki tikijtos	I don't understand what you mean
axnimachiliya	I don't understand you
axnimati	I don’t know
axnimachiliya	I don’t understand
nitlaliya	i guess
pixki	I had
pixtok	I have
ni eltok	I have been
nopa nochiya	I hope so
na nimati	I know
tinexpajktiaj	I like
tinexpajktiaj	I like you
tlasojtli	I love
nitlasojtka no ueyijni	I love my big brother
nitlasojtla no siuaueyijni	I love my big sister
nitlasojtla notata	I love my father
nitlasojtla nopilijni	I love my little brother
nitlasojtla nopilsiuaijni	I love my little sister
nitlasojtla nonana	I love my mother
nimitstlasotla	I love you
nimitstlasotla miyaj	I love you so much
na nojkia nimitstlasotla	I love you too
nejki nikitos	I mean
nimitsilnamiki	I miss you
nimitsilnamiki miyak	I miss you so much
kita	I see
na nitlamachiliya	I think
machiliya	I understand
nejki	I want
nijneki sempoali	I want to see you
nimitsneki	I want you
niyajki	I was
niyas	I will
eliskia	I would be
ni elij	I'm
kuali ni istok	I'm fine
kuali niistok	I'm good
nika niistok	I'm here
ni machiliya	I'm sorry
sesekpan	ice
itstik	ice cream
yeyekolistli	idea
yeyekolistli	ideal
iuikal	identical
tlakamatlakuilotontli	identify
neneukayotl	identity
kuauiui	idiot
tlatsiuili	idle
kena	if
akuayolo	ignore
kokolistli	ill
ilegal	illegal
kokolistli	illness
Ilocano	Ilocano
ixiptli	image
ijnamikis	imagine
ninan	immediate
amantsi	immediately
uextik	immense
chikauaknextili	impact
kokoli	impatient
kipeualtisnekilis	implement
kalakitlamankayotl	import
tlanenekoli	important
tlatlaliya	impose
amoueli	impossible
mauisok	impress
tepostlakuilolistli	impression
impresionante	impressive
ni tlakualaliya	improve
kuakualili	improvement
tlen	in
nojkia	in addition
tlen chiuali	In fact
ixpan tlen	in front of
ketsa	in order to
inapropiado	inappropriate
incentivo	incentive
incidente	incident
tlapouili	include
niixtlali	including
tominkakalakilistli	income
aonteneki	inconvenience
piuiltilistli	increase
incrementado	increased
auelnektoktok	incredible
sialistli	indeed
selkatik	independent
India	India
temoa	indicate
maseualmej	indigenous
seselti	individual
industria	industry
moneki	inevitable
pilkonetl	infant
temalotl	infection
amotlami	infinity
posauak	inflammation
patiuayotl	inflation
tepatlantoyotl	influence
tlanonotsali	inform
amochpantilistli	information
tlen motekiuiya	ingredients
tetlakauilili	inheritance
peuali	initial
peualtili	initiative
mokokojtok	injured
tekokolistli	injury
aketenchiuani	innocent
tlajkualaliya	innovation
neyolnotsalistli	inquiry
tsonyolpolitok	insane
yolkatsin	insect
majmajtok	insecure
kalakilis	insert
kalitij	inside
machtilistli	insight
insistir	insist
ajkochilistli	insomnia
teyotilistli	inspiration
iteyolitilistli	inspire
tlatlaliya	install
kemantsi	instance
achika	instant
ya ni	instead
sepan	instead of
katsamochiua	instructions
tlachiualoni	instrument
fierokamanali	insult
tleneliya	insurance
axtleno ipantik	intact
nechikokilia	integrity
intelectual	intellectual
yolokayotl	intelligence
tlaueuelij	intelligent
ninejki yukatelolistli	intend
sankinenejki	intended
tleueyimaka	intense
yukatelolistli	intention
interactuar	interact
interacción	interaction
tlaixnextok	interest
kinenejtok	interested
tlaixkisa	interesting
mokalakia	interfere
intlajkoli	intermediate
kalitik	internal
tlaltepaktli	international
pasantía	internship
kuepatlajtoli	interpret
kuepatlajtol	interpreter
tlakotonia	interrupt
onkamanalkali	interview
auilnestli	intimate
a	into
tlatsintilistli	introduce
kamanaltlapeuali	introduction
maukayotl	introvert
niixmachiliya	intuition
tenonotialistli	invalid
tlayoyokoa	invent
tlasentlalimatl	inventory
invertir	invest
tlatemoa	investigate
tlakuanotstli	invitation
invitar	invite
tklakuilasis	invoice
mokalakiya	involve
tikalakiya	involved
tepostlauilkomali	iron
kaxtiltlajtoli	is
ayoualtlali	island
anakmosatlani	isolated
Tlamantli	issue
tlamantli	issues
lo	it
elij	it is
yajki	it was
sin	it's
kuali titok	it's ok
kualtitok	It's okay
inik	item
sentlamantli	items
in	its
tlamamali	jacket
kalteltsakuali	jail
Enero	January
axaloj	jar
mandíbula	jaw
nechikauani	jealous
kuauiuiti	jerk
teokuitlakayotl	jewelry
tekitl	job
tlaloli	jogging
sejkotilistli	join
saliuyantli	joint
uetskalistli	joke
periodista	journalist
nenemilis	journey
tlaipantilis	joy
tlatlakoliaxilani	judge
paskatl	juice
julio	july
tsikuini	jump
junio	june
tlasoli	junk
melauaknemilise	just
san xichiua	just do it
melankayeyekoli	justice
justificar	justify
Kalaallisut	Kalaallisut
tlatoani	keen
tlakualtia	keep
kenopa xinemi	keep it up
tekipanoli	kept
tepostxiuatl	kettle
tlatlapoloni	key
tekteleksa	kick
konetsa	kid
kamanatlajtoa	kidding
atekojtli	kidney
konemej	kids
mikilis	kill
keya	kind
se kentsi	kinda
tlasojtlalistli	kindly
yeknakayotl	kindness
tlatoani	king
tsokontli	kiss
tlakualchiualoyan	kitchen
xikoatl	kite
mistontsi	kitten
tlankua	knee
nijmatki	knew
tlatekini	knife
tlakatsintli	knight
nokonmati	know
tlaixnachili	knowledge
temajti	known
Konkani	Konkani
Krio	Krio
etiqueta	label
tlakoneui	labor
tekitl	labour
axualajki	lack
kuatlatekoli	ladder
ichpotsiual	lady
tlalis	laid
ueyateskatl	lake
ixkatl	lamb
kuacho	lame
tlauli	lamp
tlali	land
panorama	landscape
Tlajtoli	language
kuaxantli	lap
uextik	large
teija	last
tlen tlatsonko uan nojkia monenejki	last but not least
tsonka	last name
tiotlakili	late
satlasonko	lately
achi San kentsi	later
tlenijika	latest
tlaika	latter
ueska	laugh
ueskayotl	laughing
chikauatlueskayotl	laughter
inalojtlakuali	launch
yoyontsokiyo	laundry
machiyotl	law
sakapechtli	lawn
tepantlajtoani	lawyer
tlalis	lay
tilmatli	layer
patlachtik	layout
tlatsiui	lazy
melankauiya	lead
uelitini	leader
amatl	leaf
chipinki	leak
pachoa	lean
tsikuini	leap
uelis	learn
tlamachtilistli	learning
tlakeua	lease
tlen teipa	least
kuetlaxchi	leather
texkauilis	leave
amatl	leaves
uiuijkak	led
opuchmaitl	left
mestli	leg
tlakanauatili	legacy
machioketstli	legal
nemiliakamali	legend
ueltetlatki	legit
tlatsiui	leisure
tlanelti	lend
ueyi	length
San achi	less
nemachtilistli	lesson
xikaua	let
tlakuiloli	letter
axoxoukilitk	lettuce
aueyak	level
chiuas kuamitl	leverage
responsabilidad	liability
amoxtlatiloyan	library
pipitsoa	lick
tllakakayajketl	lie
kajayaua	lies
nemilis	life
tepantlajkok	lift
tlaauli	light
tlapetlantli	lightning
katsa	like
noueli	likely
nojkia	likewise
tlaxotlali	line
Lingala	Lingala
tetsonuilistli	link
ocelotl	lion
aauitl	liquid
poaltlakuiloli	list
Tlakakili	listen
tlakakili	listening
kejatsa nikitoa	literally
amoxtlajtoyotl	literature
tlasoli	litter
pilkuekuetsi	little
yoyltok nesi ixkopinka	live
eltapachtli	liver
nenemilistli	lives
yolitok	living
kalmelaktli	living room
topitsi	lizard
tlamamaltia	load
malachtektektli	loaf
tlaneuali	loan
kaltlanamatili	local
kanke	location
kaltsakua	lock
aislamiento	lockdown
amoxtepanoli	log
jajaja	lol
isetlakatl	lonely
uextik	long
miyak kauitl axnimitsistok	long time no see
tlachiyali	look
sampaeua	loop
tlatsiui	loose
totlayi	lord
poliuis	lose
politik	loss
kuapolotok	lost
tlalkali	lot
chikaulistli	loud
kalmelaktli	lounge
tlasojtlalistli	love
nimitstlasotla	love you
yeyejtsi	lovely
tlatsintla	low
temo	lower
netlakanekili	loyal
netlakanelistli	loyalty
tonali	luck
tonali	lucky
Luganda	Luganda
kuajpanitlauijuijka	luggage
mamali	lump
tlakuasaloni	lunch
tochichin	lungs
momochkatl	luxury
ixtlakatini	lying
tepostlaolini	machine
kualantok	mad
toaui	madam
mochitok	made
amoxtontli	magazine
yolueyilistli	magnificent
mucama	maid
tlayakaniya	main
tekipanoa	maintain
tlakualilistli	maintenance
Maithili	Maithili
momayakayotl	major
nochimej	majority
chiuas	make
tijkuepas	make up
tlakatl	male
ueyitlanamakatia	mall
tlakatl	man
melaualiyaj	manage
kaltlajtoani	management
tlanauatiketl	manager
tlatenkuilili	mandatory
monechtia	manifest
tlajkakayajketl	manipulate
kenopa	manner
mochiuas	manual
miyakej	many
xikaxiti miyak xiutl	many many happy returns of the day
nenemilis	march
amoxtentli	margin
tiankistli	market
mamiktikistli	marriage
siuajtok	married
ixtlajtsakui	mask
teokalpan	mass
ueynextikimaseualmej	massive
tlasojtli	master
tlamina	match
ijniui	mate
tekiuili	material
tlapoalmatilistli	math
tlamantli	matter
ikoxilistli	maturity
mayo	may
nouelij	maybe
me	me
na nojkia	me too
tlakuali	meal
ki'itosneki	mean
ki'itosneki	meaning
in kenin	means
nijneki nikijtos	meant
uajka katsa	meanwhile
yeyejkoa	measure
tlayeyekoli	measures
nakatl	meat
Tlapatijketl	medical
pajtli	medicine
meditación	meditation
tkajko	medium
kixmatis	meet
sentilistli	meeting
Meiteilon	Meiteilon
atia	melt
ilnamili	memories
ilnamili	memory
kuatlatsonkotl	mental
nikonijtoua	mention
iniljuitl	mentioned
tlaixmatka	mentor
tlasemananki	merchant
teiknotslistli	mercy
simplemente	merely
pakilis tlakatilistli	merry christmas
ouitepanyalistli	mess
amatlakuiloli	message
tlaxitinilini	messy
tepostli	metal
kentlachiuali	method
kimichimej	mice
tkajko	middle
tlakoyoual	midnight
Atlak	might
yamanik	mild
tsintli	milestone
yaotl	military
lechi	milk
chikuase poali uan makuili xikipili	million
tlaknamikilis	mind
mentalidad	mindset
tlen na	mine
tixnemi	mingle
achiteipan	minor
amatsinya	minute
achikentsi	minutes
tlamauisoli	miracle
teskatl	mirror
amoneuki	miscellaneous
atlakanemini	mischievous
iknoli	miserable
ikniyotl	misery
nimitsilnamiki	miss
nimitsilnamiki	miss you
kuapolojtok	missing
misión	mission
mixtemi	mist
kuapolo	mistake
Mizo	Mizo
ejetlakanonostli	mobile
ajauiya	mock
modelo	model
yolismatini	moderate
yankuik	modern
youinemini	modest
achi xolontok	moist
achi xolontok	moisture
kopinali	mold
tusa	mole
Nana	mom
achitsi	moment
lunes	monday
Tomy	money
tlapaloni	monitor
osomatli	monkey
metstli	month
pakilchuilistli	mood
ixkualantok	moody
metstli	moon
moral	moral
piui	more
además una nojkia	moreover
mostla	morning
kalitomitlanextili	mortgage
nochimej	most
nochimej	mostly
Nana	mother
olintli	motion
neyoleualoni	motivation
tepetl	mountain
kimichi	mouse
kamak	mouth
oliniya	move
olintli	movement
metlaixkopinali	movie
toaui	mrs
miyaj	much
nochi	mud
toxkaxil	mug
tlachikatli	muscle
tlakikali	museum
nanajkatl	mushroom
tlatsotsonalistli	music
tlachichiualistli	must
achkamati	mute
tiompa	mutual
no tlasojtli	My dear
niukni	my friend
Ni aerodeslizador temiton ika anguilas	My hovercraft is full of eels
no tlasojtla	my love
no toka elij	my name is
se pakilis	my pleasure
ni na	myself
neiyanilistli	mysterious
neyanalistli	mystery
kamanali	myth
isti	nail
tlachialistli	naive
toka	name
sasalinl	narrative
pitsaktik	narrow
motlaiktiani	nasty
tlalpankayotl	national
tlalpankayotl	nationality
altepekakonetl	native
iukayo	natural
iukayotl	nature
patstlami	nausea
nechka	near
nexkatsi	nearby
nechka	nearly
ateskali	neat
monejki	necessary
kextla	neck
kostli	necklace
nenejkilistli	need
axkana	negative
iskalkauaj	neglect
tekipanoa	negotiate
kalnauak	neighbor
kalpoli	neighborhood
tlen	neither
machkone	nephew
nerdo	nerd
tlauatini	nervous
tepasol	nest
kipiya	net
matlatl	network
neutral	neutral
axkema	never
axkema ximotemaka	never give up
xikilkauaj	never mind
xikilkauaj	nevermind
nojkia	nevertheless
yankuik	new
tlaixmachilistli	news
tech	next
iuikal	next to
tonalti	nice
paki ni mitsixmati	nice to meet you
machijni	niece
tlayoua	night
fierotlatemiktli	nightmare
chiknaui	nine
matlaktli uan naui	nineteen
najpoali uan matlaktli	ninety
Axtle	No
axunka kualantli	no problem
axuelis	no way
axaka	nobody
moliniketl	noise
tlakakaloa	noisy
amaka	none
tlajkotonal	noon
axtle	nope
ne	nor
kenijki	normal
ayamiktlan	north
yakatsol	nose
kaktimanilistli	nostalgic
axtle	not
aujka axtleno	not at all
kualtitok	not bad
ama axtle	Not now
ayatle	not yet
tlakuiloli	note
kijkuilojtok	noted
axtleno	nothing
makas kuenta	notice
tlachiyali	noticed
yeltik	noun
yeltik	nouns
ikpasasanili	novel
noviembre	november
amantsi	now
ama in tonali	nowadays
kuesiyotl	nuisance
axunka	null
sesepoa	numb
tlapoali	number
kokoxsiuapixkii	nurse
senyoyotl	nut
senyeloj	nutmeg
nutrición	nutrition
itechtlajtololistli	oath
tomauak	obesity
tlaneltoka	obey
tlajkia	object
asilistli	objective
tesoltlatiyani	obligation
tlayoua	obscure
tlatkachiyalistli	observation
tlachia	observe
tochontik	obsessed
obsesión	obsession
obsoleto	obsolete
tlatsakuiliya	obstacle
pixtos	obtain
nipixki	obtained
kenopa elis	obvious
saueltsi kenopa	obviously
kemanika	occasionally
moteki	occupation
tlenteki	occupied
tekipanolistli	occur
tlen panotok	occurred
mochiua	occurs
ueyiatl	ocean
octubre	october
raro	odd
senkamochiuaj	odds
in	of
uajka kenopa	of course
sejtok	off
kanalkualantli	offensive
tomitemo	offer
amatlakuilolan	office
taltekatl	official
kemantsi	often
Oh	Oh
ah tlen neliya	oh really
chiauikayotl	oil
Kuali	ok
kuali teijnelsi	ok dear
kuali tlasojtli	ok honey
kuali no tlasojtli	ok my love
Kuali	okay
kena pilkonetsi	okay baby
senka tlasojtli	okay dear
senka kuali yeyejtsi	okay honey
Kena kuali no tlasojtla	okay my love
ueuentsi	old
tlen	on
se uelta	once
se	one
se tlajtoli axkema tematchin	one language is never enough
xonakatl	onion
in tlauasani	online
iselti	only
tlapojtok	open
tisikali	operation
nikitosneki	opinion
imankayotl	opportunities
monekilistli	opportunity
hualnichketsali	opposite
moueyimaka	optimistic
opción	option
tlatinejki	optional
o	or
lalax	orange
tlapamitl	order
tlakxitokoa	ordinary
tlakepanolistli	organization
ikisauayankayotl	orientation
peuali	origin
tlense	original
Oromo	Oromo
ijnotsi	orphan
seyoj	other
tlen seyok tlamantli	otherwise
uikili	ought
tlen toaxka	our
Nuestra misión: Permitir que todos, en todas partes, conozcan el mundo y se expresen en todos los idiomas.	Our mission: to enable everyone, everywhere to understand the world and express themselves across languages.
Nuestra misión: organizar la información del mundo y hacer que sea accesible y útil.	Our mission: to organize the world's information and make it universally accessible and useful.
kalteno	out
tlentemaka	outcome
tlakemitl	outfit
extrovertido	outgoing
kiski auilikalotl	outlet
nauak	outline
kalteno	outside
ixkisa	outstanding
xamitlkaltexkali	oven
ipani	over
nikanika	over there
ipan nochi	overall
ixpanos	overcome
miyak tlainamiki	overthinking
tetlokoktia	overwhelmed
kuesiui	overwhelming
uikili	owe
tekolotl	owl
tlen na	own
axka	owner
kuakuyeyotl	ox
pano	pace
tlapiloli	pack
tlapiloli	package
tlaxtlajke	paid
kokoua	pain
tlapatla	paint
tlakuiloyitl	painting
sansejko	pair
iztaltik	pale
apaxchtli	palm
tlatsoyolinoni	pan
tlaltepakokolistli	pandemic
mamajketl	panic
pantaloj	pants
amatl	paper
iljuikatliltik	paradise
paralelo	parallel
atiuitsouilistli	parcel
tlapopoljuiya	pardon
itatamej	parents
kenke	park
alotl	parrot
sakalijpajtli	parsley
achi	part
techmotlaliya	participate
teaxka	particular
seknikiski	particularly
sansejko	partner
iljuitl	party
pano	pass
ojtli	passage
xipano	passed
pasmikilistli	passion
komoni	passionate
mojkaua	passive
tlstlapololistli	password
panojka	past
salotok	patch
ojtli	path
olinyotl	pathetic
tlapakaiyotl	patience
kokochketl	patient
tlanauatiketl	pattern
kiketski	pause
tlapepechtli	pavement
tlaxtlajke	pay
tlaxtlaua	payment
tlamatkayotk	peace
paktinemi	peaceful
yoloxokotl	peach
kuautlatsakuali	peak
atsapotl	pear
exotl	peas
peculiar	peculiar
axixtli	pee
xima	peel
ompa	peer
iuikal	peers
totolakatl	pen
kautlakuiloli	pencil
tlenpoliui	pending
maseualmej	people
kaxtilchil	pepper
kiselia	perceive
yolismati	perception
senkiska	perfect
kichiua	perform
yoltekii	performance
nouelij	perhaps
tonali	period
nochipa	permanent
teixkontsinko	permission
nijkaua	permit
perseverancia	perseverance
insistente	persistent
maseual	person
ixkoyan	personal
personalidad	personality
tlaixiuilistli	perspective
elejkia	persuade
tlauelilok	pervert
yolkaijniuitl	pet
fase	phase
tlapoloamoxtli	phenomenon
yolismatilistli	philosophy
tlanonotsaloli	phone
tlaixkopinkayotl	photo
kamanali	phrase
semanauatini	physical
nitlasekojtiliya	pick
pepenoa	pick up
tlaixkopinkayotl	picture
se se	piece
senseyo	pieces
pitso	pig
uilotl	pigeon
pila	pile
tsonikpali	pillow
kamilmijka	pilot
tilmasoani	pin
matsajtli	pineapple
Tlatakeualtik	pink
ostotl	pit
ixtlauak	pitch
pinaua	pity
kampeka	place
miekaan	places
plaga	plague
tlamaya	plain
xiuitl	plan
tepostototl	plane
xiuitl	plant
xiumi	plants
kalpechtli	plate
tepancholoantli	platform
tekipanolistli	play
mauili	playing
auiyani	pleasant
se tlapaleuili	please
ajauiyakatl	pleased
nipapakilia	pleasure
tetechkautli	pledge
ixiachi	plenty
pakyotl	plot
tomacorriente	plug
masaxokotl	plum
temetspixki	plumber
miyake	plural
podcast	podcast
xochikuikatl	poem
tlajtokuikayotl	poetry
tliltetl	point
mikoapatli	poison
tlapixki	police
semitkamitilistli	policy
Tepiltikayotl	polite
tlalpopochitlajkoli	pollution
akalotl	pond
amanali	pool
kuitlatl	poop
axtomikipiyaj	poor
kotonki	pop
tenyotekatl	popular
altepeme	population
pitso	pork
metlakauili	porridge
akalkixoayan	port
nesenkaualistli	position
kena	positive
pixtok	possess
axkatia	possession
axkatilis	possessive
nouelis	possible
amstltlakuiloyan	post
seyojuelta	postpone
tchipajkamojtli	potato
uelitilistli	potential
akalotl	pound
toxontinemi	poverty
ueltiyotl	power
uelitini	powerful
tlayeyekoa	practical
tlayeyekouaj	practice
tetlamachiya	praise
uestkalistli	prank
teomaniliya	pray
tlauel yeyejtsi	precious
kenopa	precise
on senka	precisely
predecir	predict
tikaltlaliya	prefer
tetlapanaljuili	preference
tkakualtilistli	pregnant
prejuicio	prejudice
tlatlaliya	premises
axtui kualkuali	premium
momachtia	preparation
tlachichiua	prepare
chichiketl	prepared
preposición	preposition
nextilistli	presence
ama pano	present
nextilistli	presentation
kauis	preserve
altepetlajtoani	president
tlamalistli	press
kuanauatili	pressure
sanmochiua	pretend
yeyejtsi	pretty
ximomalui	prevent
axtui	previous
atsakuali	prey
keski	price
nakastsonteyotl	pride
totatsi	priest
tlen peki	primary
neliakualtitok	prime
siuapiltin	princess
tlanauatiketl	principal
axtui	prior
axtuui	priority
kaltsakualko	prison
privacidad	privacy
tesekaltili	private
teikneniloni	privilege
tetlautili	prize
nouelij panos	probably
tetsakualistli	problem
Tekiyochiwalistli:	procedure
chiuaka	proceed
katsamochitiyas	process
tlenmochiua	produce
kiankistiloni	product
tlenmochiua	production
netoltialistli	profession
profesional	professional
perfil	profile
tlatlantli	profit
uejkatla	profound
akokitsalistli	progress
nextiltekitlchiualistli	project
Tenyotekatl	prominent
tlauelkakilistli	promise
tlekojtiya	promote
tletlekoli	promotion
chikauak	prompt
kamatlatsintla	prone
achkaitl	pronouns
moitojua	pronunciation
tlayeyekoli	proof
neaxkatilistli	proper
kuali inamik	properly
axkatiani	properties
noaxka	property
kamanalijtoli	proposal
tlen nichiuas	prospect
kisenpakayotl	prosperity
tlasempaktiani	prosperous
tanankiliya	protect
ueyimatketl	proud
machilis	prove
tlaskamatilis	provide
tlaonilipixki	provided
pitepetl	province
tlamantli	provision
tlaiskaltilistli	puberty
tlen nochimej	public
tlailana	pull
ayojtli	pumpkin
puntual	punctual
tlamachtiketl	pupil
tlakoa	purchase
atlaneyolo	pure
kamojpaltil	purple
keloa	purpose
xikiplitontli	purse
totoka	pursue
kitotoka	pursuit
kuatopeuaj	push
xitlali	put
yolnankilistli	qualification
kualtitok	quality
poalis	quantity
ompoalitonaltsajktok	quarantine
kamanalkualankayotl	quarrel
inik naui	quarter
Quechua	Quechua
siuatlajtoani	queen
uilontli	queer
kantekalokan	query
tlatlanitl	question
pantli	queue
ijisiuli	quick
chikauak	quickly
motonaluij	quiet
ueyitlakemitl	quilt
kaua	quit
muchijka	quite
tlaneltilistli	quiz
tenauatilistli	quotation
tenauatilistli	quote
tenonotsa	quotes
kuatochi	rabbit
mekayotl	race
chichitlauelilokayon	rage
kiauitl	rain
piui	raise
iskatiloni	raised
tlatlo	ran
in patoli	random
tlentekiti	range
ijisiulti	rapid
ijisiulti	rapidly
senkamochiuaj	rare
sankemantsi	rarely
sauatli	rash
tusa	rat
tochkaxil	rate
achkamati	rather
tlatlanotsalistli	ratio
tlainamiki	rational
ayaiksi	raw
tlamantli	re
xikasiti	reach
nikasik	reached
reacción	reaction
tlapoa	read
tlepojki	reading
toiuka	ready
tlenkayotl	real
yoyoniuikal	reality
ti'ijta	realize
asikamatili	realized
tlen neliya	really
ijka	rear
tlasikayotl	reason
ixtlamaki	reasonable
kinamiki	recall
tlaselitlakuiloli	receipt
niselij	receive
niseli	received
amanok	recent
amanok	recently
salistli	reception
tlajkuiloltlakuali	recipe
amonauatilmak	reckless
noyolomaxilistli	recognition
teixmatis	recognize
tlalnemiktia	recommend
tlalnelmiktia	recommended
amochtlakuiloli	record
kipanti	recover
mochikaua	recovery
rectángulo	rectangle
chichiltik	red
tlaxtlauili	redeem
temakixtiani	redemption
nitlachiua	reduce
sampayanok	redundant
kimakatoke	refer
tlen ikamoita	reference
akeskauiya	reflect
teskatilistli	reflection
saualistli	refrain
sesekotlasaloni	refrigerator
xikuepa	refund
ayok nochiuas	refuse
sampa nitekiui	refused
niyolnonotsa	regard
ika ajkeya	regarding
in tlamachiui	regardless
tlapololij	regards
Tlaltokayotl	region
tlasemachilistli	register
yolchokas	regret
sankuali	regular
regularmente	regularly
mayoui	reject
tenotsali	relate
tenenotsali	related
Tenonotsali	relationship
teixmatkauaj	relative
teixmatkauaj	relatives
mokoxteka	relax
tepanmoyaualistli	release
momajkatok	released
ixnextili	relevant
niyolmaka	reliable
teseuili	relief
pachijki	relieve
teseuli	relieved
yeknemilistli	religion
teknemini	religious
achtekakini	reluctant
temachi	rely
niuekaua	remain
tlen poliui	remaining
nenexi	remarkable
tlapatilistli	remedy
tlainamiki	remember
kilnamiki	remind
teiknamili	reminder
uejkaelij	remote
tlamaneloa	remove
kaua	render
tlakeua	rent
yejtia	repair
sampayanok	repeat
ixpatli	replace
tenankilistli	reply
chiualispantilistli	report
tepankisketl	represent
teyotl	reputation
amatltlapaleuili	request
moneneki	require
tlatlani	required
kipantijke	rescue
tlatsintoka	research
pixaui	resemble
kualankayotl	resentment
kuania	reservation
reservar	reserve
nemini	resident
mauiltsoltechiua	resign
resiliencia	resilience
resiliente	resilient
ixnamikilis	resist
chikaukayotl	resistance
tlen asik	resolution
nikualalis	resolve
tekiuili	resort
tlenoktekouili	resources
tlaixtilistli	respect
tlanankili	respond
tlanankili	response
responsabilidad	responsibility
tepanichketsa	responsible
siajkaua	rest
paxia moseluili	rest in peace
kalitlakualnamakake	restaurant
tlapajtia	restore
axkiksuiya	restrict
katsa kiski	result
resultados	results
tlakuilolmachitili	resume
sesen namakas	retail
tlatsakuili	retain
tlatsakuali	retention
yolitlamanemi	retired
uejkatika	retreat
kikuiti	retrieve
mokuepa	return
nextiliya	reveal
nextilistli	revealed
netsonkuilistli	revenge
Tominxochiotilistli:	revenue
ijikanemi	reverse
seyojuekta	review
tlaltlachiliya	revise
tlamamachiliya	revision
ikniuyaoyotl	revolution
tetlanilili	reward
ritmo	rhythm
sikuili	rib
asentli	rice
ajuiyak	rich
kichti	rid
tlanenemi	ride
nauilaua	ridiculous
kualtitok	right
amatsi	right now
topalkatl	rigid
maxitlastli	ring
uatsa	rinse
yaolkuayankayotl	riot
postektli	rip
ikoxik	ripe
tlekojtis	rise
akilistli	risk
rival	rival
atemitl	river
ojtli	road
iksitoj	roast
tomauak	robust
texkali	rock
kuapipitstsi	rod
tlen tichiuas	role
tlayoualochtia	roll
kalkuauitl	roof
innaui	room
nejuayo	root
mekatl	rope
palantok	rotten
chachauak	rough
aproximadamente	roughly
youaltik	round
oktipa	route
sampayanok	routine
pantli	row
mamatso	rub
tetlaixpouili	rubber
tlasoli	rubbish
fiero kamati	rude
papetlatl	rug
uejkaxolejtok	ruin
tlauaualoni	rule
tlanay	ruler
piltlayeyekoli	rules
tlalolistli	run
otskayotl	running
chinankotl	rural
siajkapa	rush
yoyomitlamanali	sack
teoyojtika	sacred
tlamanayotl	sacrifice
melajtik	safe
kuali patlantli	safe flight
yoatlmotlakuauiya	safety
salviatl	sage
kiijtok	said
akalnemi	sail
akaltikanemilistli	sailing
tlen itonal ne	sake
tlaxtlauili	salary
namakas	sale
xochimichin	salmon
tsikuini	salt
iuikal	same
aquí también	Same here
nextili	sample
xali	sand
Sanskrit	Sanskrit
sarcástico	sarcastic
pícaro	sassy
moseui	sat
teyolmaxilistli	satisfaction
teyolmachilistli	satisfied
yolmaxilia	satisfy
teyolmachilistli	satisfying
Sábado	Saturday
tlanakasali	sausage
chanek	savage
tlajokuili	save
kitak	saw
kiito	say
etik	scale
timo	scam
tsotsouistli	scar
poliui	scarce
mamajtok	scared
ichkamekatl	scarf
majmajtok	scary
tetlaokoli	scattered
akana	scene
tlayekatitok	scenery
auiyoinekistli	scent
tlamapiluiloni	schedule
tlamachtiloya	school
tlamatilistli	science
tlatilismatini	scientist
científicos	scientists
tepostejtekitl	scissors
kiuajua	scold
asitok	scope
puntuación	score
se kentsi	scrap
uauana	scratch
kuatsatsili	scream
tlapaloni	screen
tornillo	screw
tlakuiloli	script
ueyiatl	sea
namakas	seal
temoli	search
panos	season
ikpali	seat
ompa	second
ichtakayotl	secret
sección	section
aujka kena	secure
tlakatokak	security
tlachiya	see
nimitsita	see you
sankentsi nimitsitas	see you later
ninitsitas nima	see you soon
mostla timoitase	see you tomorrow
ijyoli	seed
temoua	seek
sanijki	seem
sanijki	seems
kiitak	seen
kiski	seize
tetlakakaualtilistli	seizure
San kemantsi	seldom
tlapepenili	select
iuikal	self
selti pachiui	self healing
chauastili	selfish
tlanamakilis	sell
makajki	send
ximakaua moixkopinkayotl	send me your picture
achtui	senior
nematiuanij	sense
nematini	sensible
ontlamatilistli	sensitive
makajki	sent
teotlajtoli	sentence
teotlajtoli	sentences
moxexeloa	separate
Sepedi	Sepedi
septiembre	september
tlakuilchiuali	sequence
serie	series
nelmauili	serious
nenejliya	seriously
tekiuiya	serve
tlatekalistli	service
nechikali	session
mauiltili	set
tlatlaliya	set up
tentli	setting
tlatlalijke	settle
chikome	seven
matlaktli uan chikome	seventeen
expoali uan matlaktli	seventy
sekinojmej	several
tekokoliani	severe
tlasoma	sew
ya	sh
tlakauili	shade
tlakauilotl	shadow
tsetseloa	shake
axmotekiuiya	shall
ixmanil	shallow
teijneltsi	shame
chiualistli	shape
ajachimaka	share
tlateki	sharp
ya	she
yeuaj kipiya	she has
ne ya elij	she is
tapanko	shed
ixkatl	sheep
xiuitl	sheet
tlakitltlakalakiya	shelf
ektli	shell
choloakoyon	shelter
chimali	shield
youalteki	shift
tlapetlantli	shine
auakali	ship
tlamakaua	shipping
kemitl	shirt
kaktli	shoes
tlatopontli	shoot
kaltlanamatili	shop
tlakouani	shopping
tlatemoa	shore
kuekuetsi	short
anekotonali	shortage
tepontlalistli	shot
tlauika	should
ajkol	shoulder
kuatsaske	shout
tlamauisoli	show
nexnextili	show me
auiuastli	shower
chakali	shrimp
kototsiui	shrink
kasajktok	shut
kamatsakuaka	shut up
mamajketl	shy
ikni	sibling
ijnime	siblings
kokoyiya	sick
kampa	side
elsisiuilistli	sigh
tlachiyali	sight
chiua uijyayotl	sightseeing
tlamachiyotl	sign
tlaneltiloni	signature
ki'itosneki	significant
ichaka	silence
mokaualistli	silent
seda	silk
uiui	silly
istateokuauitl	silver
iuikal	similar
ampoaneuak	simp
axpoyek	simple
sansempainpeuasej	simultaneously
onkan	since
ijniyutl	sincere
ijniyotl	sincerely
uikatl	sing
kuikani	singer
amo namiki	single
tlapapakatl	sink
Totlayi	Sir
pipi	sister
uejpol	sister in law
moseui	sit
onouayan	site
tlamantli	situation
chikuase	six
matlaktli uan chikuase	sixteen
expoali	sixty
uext	size
yolokayotl	skill
yolokayotl	skills
kuetlax	skin
pitsauak	skinny
tsikuintlu	skip
kueitl	skirt
eljuikak	sky
tlakotli	slave
kochilistli	sleep
koxtik	sleeping
kochmiki	sleepy
tlamaitl	sleeve
tlaxoxoli	slice
alaxtik	slide
se kensi	slightly
piastik	slim
xitlania	slip
tlekoayan	slope
tlauasantli	slot
yolik	slow
yolik	slowly
kuekuetsi	small
toiuka	smart
miyotilistli	smell
ixueskayotl	smile
poktli	smoke
yamanik	smooth
sekotlasalistli	snack
atekokolin	snail
coatl	snake
chasquear	snap
sepauitl	snow
uajka	so
tlan yeyejtsi	so cute
hasta amantsi	so far
apachoa	soak
xapo	soap
axtlaoni	sober
tapayoliani	soccer
tlakakijnimej	social
maseualmej	society
nometsyoyomitl	socks
yamantik	soft
software	software
tlali	soil
namakatok	sold
namakajka	sold out
yaotl	soldier
iyojtsi	sole
tetik	solid
mosenkaua	solution
kiyeyekos	solve
se kentsi tlen	some
ajkaya	somebody
in kenin	somehow
ajkaya	someone
kentsi	something
kemantsi	sometimes
tlauikali	song
chiuaya	soon
piltikayotl	sophisticated
Sorani	Sorani
chichinajtik	sore
toskajauaj	sore throat
pinaua	sorrow
Ni machiliya	Sorry
tlakualali	sort
temojki	sought
itonal	soul
itonal koatli	soulmate
kakalakistli	sound
tsopiatl	soup
chichik	sour
yameyali	source
uitstlan	south
tlakatoyan	space
tlasolamatlakuiloli	spam
malkochka	span
kaxtiltlajtoli	Spanish
tlasenkemiloni	spare
kamati	speak
tlapanauiya	special
tlapiyalmej	species
temachtitlani	specific
tlamauisoli	spectacular
amamekatlkamanali	speech
axkamanali	speechless
ueyojtli	speed
sesekamanali	spell
yalti	spend
yaltitok	spent
kokolis	spicy
uistli	spike
malakachoa	spin
kanaukilitl	spinach
itonal	spirit
chajcha	spit
espléndido	splendid
xeliuilistli	split
tetlauelkatiliya	spoil
tetlauelkaki	spoiled
kamantikayotl	spontaneous
neollani	spoon
kanke	spot
siua	spouse
tlakamauiyaj	spread
xopanili	spring
tlanajasantli	square
tlapaxka	squeeze
calamar	squid
tokomajtli	squirrel
ojkali	st
apuñalar	stab
axmoliniya	stable
pila	stack
tekimaceualmej	staff
kampa sentilise	stage
mancha	stain
tlamamatlatl	stairs
Tlakoipili	stake
isijiuiya	stalk
tlaxikali	stall
tekiluastli	stamp
ketsa	stand
estándar	standard
sitlali	star
peualtili	start
pejki	started
apismiki	starving
Altepetl	state
melaualistli	statement
teposkalmimilolkoyan	station
tekikuili	statue
Tlaltokayotl	status
makauas	stay
kuali ximotekipano	stay safe
chikauak	steady
uakaxnakatl	steak
tlaxtekili	steal
apojtli	steam
ueytepostli	steel
malinali	steep
kiyotl	stem
se nenenki	step
kuauitl	stick
topalkatl	stiff
nojuan	still
tlitsopintli	sting
nexikoli	stingy
maneloli	stir
chiuali	stock
tlaixtektli	stolen
ijti	stomach
tetl	stone
mokestok	stood
ikpal	stool
ketsa	stop
semanali	storage
tlanamakiskali	store
atlakamanilistli	storm
nemiliskayotl	story
tepostlekuili	stove
melauak	straight
xitlahuak	straightforward
kechtkaposteki	strain
chontali	strange
koyotl	stranger
mochiuastili	strategy
popotli	straw
asexokotl	strawberry
chichikuaua	streak
apachkatl	stream
ojtli	street
chikajtok	strength
kuesoualij	stress
motitijlana	stretch
tlanachikauak	strict
tekiketsa	strike
mekatl	string
majkaua	strip
nisenkauas tlen	strive
apoplejía	stroke
chikajtok	strong
xoxoktok	struck
kalmikistetl	structure
tlauilantli	struggle
tlauilantli	struggling
axtlakaki	stubborn
potsaki	stuck
machtiani	student
tlamachtili	study
machitilistli	studying
tlamantli	stuff
ixapilpintsi	stunning
kuawiwiti	stupid
yautlajtolistli	style
ajkeya	subject
Sanmokaua	submission
ipantlanextiliya	submit
yelistli	substance
maxiltiani	substitute
sutil	subtle
nijpiya tlen nijkeki	succeed
teasistli	success
teasilistli	successful
tal	such
kejtsa	such as
chichina	suck
tlalochtla	sudden
onmonextiya	suddenly
ejeyouiya	suffer
tlaiyouili	suffering
ixachi	sufficient
tlasopeli	sugar
tlen nikijtoua	suggest
kejatsa nochiuas	suggestion
yoyomitltsontli	suit
kimonamiktia	suitable
euapetlakali	suitcase
piui	sum
tlakuilolmachitili	summary
xopanatl	summer
itsonyok	summit
iselti	sun
domingo	sunday
tona	sunny
teotlakili	sunset
tonamini	sunshine
súper	super
sempaueyi	superior
tlachiyalitlanauatili	supervisor
kochkayotia	supper
tlailiuischiutli	supply
tlapaleuili	support
nitlaliyaya	suppose
atlak	supposed
tlamelaualistli	sure
ixko	surface
tlatejkoli	surge
texotlatilistli	surgery
tsonka	surname
axnichiyayaya	surprise
sorprendido	surprised
motemaka	surrender
tlayoualouaj	surrounding
ixtetlakuitlauiya	surveillance
maseualtlatlanilistli	survey
niyoltok	survive
chikoyoloani	suspect
piloa	suspended
ixkakauanelij	suspicious
tekipanoa	sustain
sostenibilidad	sustainability
mopaleuiketl	sustainable
tlsixtektekoli	swag
tlatoloa	swallow
tlapatlili	swap
itechtlajtoa	swear
tlaitonal	sweat
uipiltejtektli	sweater
tlaxpana	sweep
tsopelik	sweet
tsopelik kuckitl	sweet dreams
apixmiki	sweet tooth
tlaxochiuilistli	sweetheart
poxaua	swell
xipotli	swelling
ajki	swim
ajkilistli	swimming
tlauiuixoli	swing
tlapatlalistli	switch
poxajtik	swollen
teposmakuauitl	sword
símbolo	symbol
simpatía	sympathy
tlen mitskokoa	symptoms
sistema	system
akolpechtli	table
tlejkolis	tackle
pilamatlakuiloli	tag
tsimpa	tail
kiski	take
uijka	take away
ikayolik	take care
akopatlantli	take off
tlaitok	taken
kamalistli	talk
sankamatijketl	talkative
uejkapantik	tall
teposkisatl	tap
mekatl	tape
neyoleualoni	target
semiluitekitl	task
pakilistli	taste
ajuiyak	tasty
nextili	taught
xiuatl	tea
tlamaxtili	teach
tlamaxtiketl	teacher
tlajkia	team
kotoni	tear
ixayo	tears
tlamakakauiya	tease
teknolotilistli	technology
tlankoch	teeth
kijto	tell
tleljui	tell me
chiuilistli	temper
totonanmakachiyola	temperature
teokali	temple
atlakualo	temporary
matlaktli	ten
se xikipili una makuili tsontli	ten thousand
kalitlanextili	tenant
patlaua	tend
tendencia	tendency
seseltik	tender
imixpa	tense
tenkayotl	tension
kalitlanamakaketl	tent
teteyeokani	tentative
tsonkisalistli	term
sentlaloni	terms
temamaui	terrible
ueyik	terrific
kalitiloayan	territory
tetlatemolistli	test
tlajkuiloli	text
tlen	than
tlaskamati	thank
Tlaskamati	thank you
Tlaskamati ti mochistok tikitasej kanke eltok tlen timismakauiluke	Thank you for your patience while we investigate shipment
miyaj tlaskamati	thank you so much
miyak tlaskamati	thank you very much
Tlaskamati	thanks
tlaskamati titekiuuiya tlen to aplicación	Thanks for using our app
Tlachke	that
kenopa	that is
nopa kuali	that's good
in	the
tlaxtekitl	theft
tlen	their
tlen	them
temachtli	theme
ne yeuantin	themselves
uajka	then
teoria	theory
nopano	there
onka	there are
unka	there is
yejka elis	therefore
ni me	these
yeuanti	they
tlen	they are
tomauak	thick
tlaxtejketl	thief
mestli	thigh
pitsatsi	thin
tlamantli	thing
tlenueli	things
tlainamiki	think
tlen eyi	third
amiki	thirsty
matlaktli uan eyi	thirteen
sempoali uan matlaktli	thirty
ni	this
ni elij	this is
in iitsintla	thorough
malmauili	thoroughly
inin	those
maske	though
tlainamikili	thought
inani	thoughtful
ilnamikamatl	thoughts
ometsontli uan matlakpoali	thousand
ikpatl	thread
kamanalmamauiya	threat
atemamauiya	threaten
eyi	three
umbral	threshold
yolpakili	thrilled
temoskalistli	thrive
toskitl	throat
kakanke	through
tlen nochipa	throughout
majkaualistli	throw
ueymapili	thumb
tlatomontli	thunder
Jueves	Thursday
por consiguiente	thus
chipojtli	tick
aejekatl	tide
tlatekpanali	tidy
kechmekatl	tie
yaoselotl	tiger
tetsiltik	tight
Tigrinya	Tigrinya
nemilis	time
maukayotl	timid
pilkinitsi	tiny
tomitlatlami	tip
temakatlachtlauili	tips
olmalakatl	tire
tlasiauilistli	tired
ikitilistli	tissue
Tlatokayotl	title
a	to
elij	to be
totopochuitsa	toast
ama	today
pilkonetsa	toddler
xokpili	toes
sansejko	together
kuitlakali	toilet
kijto	told
tolerancia	tolerance
tolerar	tolerate
tomatl	tomato
mostla	tomorrow
nejnepili	tongue
ni youali	tonight
nojkia	too
nikuik	took
tepostlatkil	tool
tepostlatkil	tools
tlankoch	tooth
itsima	top
semaxkayotl	topic
tlatlatsayantli	torn
tlaktepauiya	torture
nochi	total
matoka	touch
ui	tough
nejnemi	tour
nepa	toward
kanke	towards
yoyonuajki	towel
chinanko	town
tóxico	toxic
tlatemachiua	trace
pista	track
tlasemananki	trade
tlamamatilistli	tradition
tlen mochichiua	traditional
ixtlakaualijka	traffic
tlanekuilistli	trail
teposokuili	train
machtilistli	training
kejatsa	trait
tlanechyalistli	traits
makaualtomij	transfer
tlapatlalistli	transition
tlaltojkuepa	translate
tsalantik	transparent
aniuaya	transport
nailkixtilistli	transportation
tlakestli	trap
tlasoli	trash
trauma	trauma
nenemilis	travel
akomitl	tray
teokuitlakayotl	treasure
nenemilis	treat
tepatilistli	treatment
kuauitl	tree
axtlakaki	tremendous
tendencia	trend
tetlasontekilistli	trial
truco	trick
nisenkajki	tried
tepostlatoponi	trigger
tejtejki	trim
nenemilis	trip
tlauililokani	trouble
pantaloj	trousers
ueyiteposkauayo	truck
MELAUAK	true
kuatsomitl	trunk
netechmachiliya	trust
Tlamelauak	truth
uelis	try
Tsonga	Tsonga
kokojtli	tube
martes	Tuesday
tlaxtlauilmachtiyola	tuition
totoli	turkey
cúrcuma	turmeric
kueptok	turn
ayotsi	turtle
motatakajtok	tutor
matlaktli uan ome	twelve
sempoali	twenty
sempoali uan se	twenty-one
Twi	Twi
ome uelta	twice
malina	twist
ome	two
ajkaya	type
kolenopaelij	typical
axyeyejtsi	ugly
tlaijka	ultimate
kiauiloni	umbrella
imimatki	unable
tlayi	uncle
iuintik	unconscious
tlatsintla tlen	under
tlatsintla	underneath
infravalorado	underrated
tlamachili	understand
nikuamachili	understood
tlen aompayotl	unfortunately
yoyoniuikal	uniform
iyoltsi	unique
se	unit
ueyitlamachtiyoli	university
axnikixmati	unknown
in pil maske	unless
kani	until
inusual	unusual
ixko	up
ta tijmati	up to you
tlen amanok	update
actualización	upgrade
ipa	upon
pilkualantok	upset
altepeyotl	urban
isiuteua	urge
ijisiulti	urgent
tlen	us
tekiutl	use
tekiuijtok	used
tekiuili	useful
nenkoyotl	useless
tekouiya	usual
tlatekiuili	usually
kitekuiuya	utility
tekitlasiyakaketl	vacation
tlatsopintli	vaccination
pajtlitsopintli	vaccine
ilakatstik	vacuum
sanenemi	vague
nouan kuali	valid
tepetsalan	valley
patiyo	valuable
mosemakas	value
kentsi nochi onka	variety
sekinoj	various
tlen ueli	vary
atliuani	vase
poli	vast
xiuitl	vegetable
achiotl	vegetables
teposkauayo	vehicle
tlanamakaketl	vendor
mikoapatli	venom
arriesgarse	venture
kanaya	venue
sampa xitlachili	verify
versátil	versatile
mokamanalis	version
vertical	vertical
miam	very
senka kuali	very good
atliuani	vessel
tepots oktli	via
itonalpoloua	vibe
vibras	vibes
auilnemini	vicious
tlajkoketl	victim
ichtlakopinkamoliniya	video
tlachialis	view
chinanko	village
tlajpaliuik	villain
xokoktli	vinegar
uejkani	vintage
tlauilantli	violence
tlauisneki	violent
viral	viral
ichpochtli	virgin
tepostlaixnextili	virtual
chikaulistli	virtue
tlachkotalistli	vision
paxaloketl	visit
tikijta	visual
yolnemili	vital
nemilis	vivid
tlajtolsentilistli	vocabulary
toska	voice
ayojtle	void
chikauak	volume
motemaka	volunteer
misotla	vomit
teijnelsi	vulnerable
tlaxtlauili	wage
tlaxtlauili	wages
pitsakayotl	waist
chia	wait
Tlapaleuitlamakaketl	waiter
chía	waiting
isak	wake
isa	wake up
nenemi	walk
nenemilistli	walking
tepamitl	wall
ajoktomin	wallet
neneketl	wander
nejki	wanna
kineki	want
nenejki	wanted
yoatltlauilantli	war
kakokuiyoyomitl	wardrobe
tlatiloyan	warehouse
achi tlatotoniya	warm
yolmeyauali	warn
kiluijkiya	warning
yaotl	warrior
yajki	was
chikuentli	wash
polijtok	waste
tlachiya	watch
atl	water
meloj	watermelon
akueyotl	wave
teposojtli	way
tojuanti	we
tojuanti	we are
tiuelij	we can
kokoxkayotl	weak
kokoxkayotl	weakness
tlatkilistli	wealth
ajuiyak	wealthy
uika	wear
nijuika	wearing
tlaliskayotl	weather
ijuitlsiuali	wedding
miércoles	Wednesday
akauatl	weed
semano	week
tlanki semano	weekend
etik	weight
raro	weird
kualitiasij	welcome
chikaulistli	welfare
Kuali	Well
kuali kichtol	well done
yajki	went
yajke	were
ikalakian	west
xolontok	wet
ueyimichin	whale
Tlachke	what
tlen ipan ta	what about you
Tlachke ti chiua	what are you doing
Tlachke tichiua amantsi	what are you doing now
tlachke tichiua amantsi	what are you doing right now
tlachke tichiua	what do you do
tlen timotekichiuaj	what do you do for a living
tlaxke tijneki tikijtos	what do you mean
tlaxke tijneki	what do you want
tlen panok	what happened
tlachke	what is
nitlachi	what is this
katlia moteki	what is your job
kejatsa motoka	what is your name
tlachi pano	what's up
kejatsa mo toka	what's your name
tlen ueli	whatever
mekatlauili	wheat
malakachtli	wheel
kema	when
kema uelij	whenever
Kanke	where
kanke ti'istok	where are you
Kanke ti ualaj	where are you from
kanke ti'istok amantsi	where are you now
kanke mocha	where do you live
kanke eltok	where is
neyononotsali	whereas
kena	whether
katlia	which
maske ni	while
ixtakakamati	whisper
tlankikisa	whistle
chipauak	white
Ajkeya	who
tiajkeya	who are you
ajkeya	who is
ejkeya	who is this
tlantok	whole
ajkeya	whom
tlen ajkeya	whose
paratle	why
kenke axtle	why not
tlauelilok	wicked
tlauexko	wide
okichmijki	widow
koyauak	width
siua	wife
tekualchine	wild
tlanekilistli	will
mosenkauani	willing
tlatlani	win
ajakatl	wind
tlanexilotl	window
iyeyi	windy
oktli	wine
tlaseseyankapa	winter
xinechpanolti se yoyomitl	wipe
mejatepostli	wire
tlamatilistli	wisdom
tlamatini	wise
aonemalistika	wish
tlen eluitilistli senka kuali	wish you all the best
siuanauali	witch
uaya	with
xiuikata	withdraw
kueniya	withdrawal
kalajtok	within
atle	without
tlen kiitak	witness
tlachialiani	witty
koyotl	wolf
siuatl	woman
toauimej	women
tlatlanki	won
axtiase	won't
nimotlatlani	wonder
tlamauitsoli	wonderful
kuauitl	wood
ixkatsomitl	wool
kamanali	word
kamanali	words
tekitl	work
neyekolistli	work out
peualistli	working
Tlaltepaktli	world
okuili	worm
nijuikak	worn
tekipachoa	worried
kuesoualij	worry
tlanaluili	worse
teotia	worship
tlanalui	worst
patiyotl	worth
axtlapijnaltli	worth it
ixtikiloni	worthy
Axueli	would
tlauitektli	wound
guau	Wow
kemiloa	wrap
kokoli	wrath
siuajauili	wrist
tlakuiloli	write
nikani xitlakuilo	Write here
machioli	writing
tlakuiloli	written
axkuali	wrong
notlakuilo	wrote
kalika	yard
kochkamachaloli	yawn
Kena	Yeah
xiutl	year
xiuitl	years
xokotextli	yeast
kuatsatsili	yell
kostik	yellow
Kena	Yes
kena konetl	yes baby
kena teijnelsi	yes dear
kejna teijnelsi	yes honey
Kena no tlasojtla	yes my love
kenaj	yes of course
yaljuaya	yesterday
nojuan	yet
tlatlanitomi	yield
Ta	you
elij	you are
tu elij yeyejtsi	you are beautiful
ta ti elij tlauel yeyejtsi	you are so beautiful
Axtleno	you are welcome
ya ti uelij	you can
ya tijmati	You know
ta nojkia	you too
axtleno	you're welcome
telpokatl	young
ta	your
axtleno	your welcome
ta niman	yourself
telpokayotl	youth
axtleno	you’re welcome
ajuiyak	yummy
amopouali	zero
