éí	a
ałtsʼíísí	a little
tʼóó ahayóí	a lot
ląʼí da	a lot of
baazhdiiyáh	abandon
baa dááʼdiildeeʼ	abandoned
baa hayoosnah	abandoned
bikʼeh hojiłʼį́h	abide
bijíighahgo	ability
bíjíighah	ability
bíighahgo	able
baa	about
hodahgo	above
iihjííyá	abroad
doo áadi naʼadáágóó	absence
doo kǫ́ǫ́h sidáa da	absent
doo níyáa da	absent
tsídá tʼáá ákotʼé	absolutely
biłtah yileeh	absorb
tóó baa nitsáhákees	abstract
doo yáʼátʼéeh da	absurd
tʼóó ahayóí	abundance
tʼóó ahayóo	abundant
tiʼjiłʼį́h	abuse
tíʼáhoʼdilį́h	abuse
saad bee yátiʼígíí	accent
nizhdiinil	accept
bee lą́go	accept
bichʼįʼ ahootʼiʼ	access
tiiʼhoodzaa	accident
bee hákaʼeʼeyeedígíí	accommodation
yidadiiyá	accomplish
tʼáadooleʼé ałtsoh ájiilaago	accomplished
bidajiyáago	accomplished
bikʼehgooígíí	according
naaltsoos bee haʼdítʼéhígíí	account
tsʼídá tʼáá ákotʼéego	accuracy
tsʼídá tʼáá ákotʼé	accurate
akʼíhastʼah	accused
adiniih	ache
bíighah alyaa	achieve
bideijiiyáhígíí	achievement
bééhojisinígíí	acknowledge
hwił ééhozinígíí	acknowledge
ałhxééhoʼdoolziih	acquaintance
bóhojiiłʼą́ʼígíí	acquire
nízhdiilá	acquired
tʼáá haʼátʼííshį́į́ nídiilyáago	acquisition
tséʼnaah	across
ahatʼį́h	act
ajootʼįįłígíí	action
ajítʼínígíí	action
naalnishígíí	active
áánííłígíí	active
tʼáadooleʼé baa nidaʼaldeehígíí	activities
tʼáá haʼátʼííshį́į́ baaʼnaʼaldeehígíí	activity
diné áátʼįįłígíí	actor
átʼéhígíí	actual
akoh nidi eii	actually
yéego nanitłʼah	acute
binildin	adapt
bíidzoh	add
ádíhwiiltsood	addicted
bíhiiʼníłígíí	addition
bídaʼiidzóhígíí	addition
nááná łaʼ bináánáaʼnil	additional
ił hazʼánídi	address
ił hazʼánígi	address
tʼáá bíighahgo	adequate
bíighahgi doodago bił bíiltsoodgo	adjacent
tʼáá haʼátʼííshį́į́ ánoolninígíí baa haneʼ	adjective
naalkidgo bikʼeh niilkiʼígíí	adjust
hwił nizhónígo	admire
tʼáá anínígíí bee haʼoodzííʼ	admit
bidajiyáh	adopt
ayóóʼánoolnin	adorable
bee náás adeesdzá	advance
bee náás adzaa	advance
bee náás jideeyáh	advanced
bee náás ádzaa	advanced
achʼihjí aztą́h	advantage
biyiʼ adahwiiztʼiʼ bee biyiʼ honítʼiʼígíí	adventure
saad naadzoh biyiʼdi sinilígíí	adverb
bóʼoolkąąhí	advertisement
bóʼoolkąąhígíí	advertisement
tʼáá haʼátʼííshį́į́ bóʼoolkąąhgo	advertising
ił chʼíhatʼaah	advice
ił chʼíhootʼaah	advise
bá yátiʼ	advocate
azhdilshǫǫh	aesthetic
tʼáá haʼátʼííshį́į́ baa nidaʼaldeehígíí	affair
hweenítʼįįh	affect
anítʼį́h	affect
hwił nizhónígo	affection
nahaniih bíighah	afford
nahidoonih tʼáá bíighah	affordable
nahadzid	afraid
akéédóó	after
bikéédóó	after
ałníʼníʼą́ą́dóó yihwohjįʼ	afternoon
bikéédóó	afterwards
nááná	again
bikʼihjįʼ	against
hwinááhaaígíí	age
iłhahoodzoh bił hazʼánígíí	agency
naanish bił hazʼą́ągi yá naagháhí	agent
ádáhojilchxįʼ	aggressive
dziil hwiinidzin	aggressive
doo nizhdilnaʼ da	agile
-dą́ą́	ago
bee lą́ hwiinidzin	agree
ałchʼishdę́ę́ʼ bee lą́ʼ aleehígíí	agreement
dadaʼakʼeh	agriculture
alą́ąjįʼ	ahead
ákaʼeʼeyeed	aid
hazhóʼó bikʼeh nishníyáago	aim
níłchʼih	air
chidí naatʼaʼí náádadiitʼahídi	airport
ahodiiláhígíí	aisle
tʼáá haʼátʼííshį́į́ doo yáʼátʼéhígíí hachʼįʼ deeztʼiʼgo bee baaʼákonízinígíí	alarm
étłohí	alcohol
baaʼákohwiinidzin	alert
hiiná	alive
tʼáá ałtsoh	all
tʼáá áko	all right
nizhónígíí tʼáá ałtsoh	all the best
bá ąąʼályaa	allow
bee hooʼaʼ	allowed
kʼasdą́ą́ʼ	almost
tʼáá sáhí	alone
akʼééʼ ídlį́	along
hashtʼeetʼé	already
hastʼeedzaa	already
tʼáá áko shį́į́	Alright
aooʼ	Alright
nááʼałdó	also
nááná łahgo átʼéego shąʼ	alternative
ákotée nidi	although
tʼáá ałhahjįʼ	always
shí éí	am
nizhóní	amazing
tʼahdoo hazhóʼó bééhoozįįh da	ambiguous
tʼáá haʼátʼííshį́į́ tʼáá íiyisíí ádeeshłííł jinízingo	ambition
doo bichʼįʼ neʼjilį́į́góó ajilééh	ambitious
naaltsoos łahgo átʼéego háádilyaa	amend
ałníiʼgi	amid
bitah	among
nihitah	among us
anéeltʼeʼígíí	amount
baa honeenih	amusing
nélʼį́įgo binahjįʼ nitsáhákees	analysis
nihizáanii	ancestors
bee ólzhaʼí bee iltsódígíí	anchor
ałkʼidą́ą́ʼ naaznilígíí	ancient
dóó	and
dóó ni	and you
naaniigo deezáhígíí	angel
áhachxįʼ	anger
dínéeztį́h	angle
áhachxįʼ	angry
naaldlooshii	animal
akétsíín	ankle
baa náhoolzhizh	anniversary
haneʼ baa chʼíhatʼaahígíí	announcement
bá hodoonih	annoy
bá hodoonih	annoyed
báhodoonih	annoying
nináhaháahgo	annual
doo baa haneʼ da	anonymous
nááná łaʼ	another
baa náhaneʼ	answer
nawolníh	anticipate
atah nitsééhaltłiʼ	anxiety
nitsééjiltłiʼ	anxious
tʼáá haidííshį́į́	any
ádin	anymore
tʼáá háí shį́į́	anyone
tʼáá haʼátʼííshį́į́	anything
tʼáadooleʼé	anything
jó ákoté	anyway
ákotée nidi	anyways
bił booltąʼ	apart
ałkʼih dahooghanígíí	apartment
bee há náhootʼaah jókeedgo	apologize
tʼáá bééhoziní	apparent
ákótʼéego	apparently
bee nináʼiltsóós	appeal
ííshjání ádzaa	appear
ííshjání ádzaaígíí	appearance
tʼáh nítʼę́ę́ʼ kǫ́ǫ́h	appeared
ajilniihígíí	appetite
bilasáana	apple
naaltsoos hadilnéhígíí	application
ajilééh	apply
haʼdilnééh	apply
baa nihootʼánígíí	appointment
baaʼáhxééhwiinidzin	appreciate
baaʼahxééhwiinidzin	appreciation
bichʼįʼ	approach
tʼáá ákotʼé	appropriate
bee lą́ʼ azlį́į́ʼ	approval
bee lą́ʼ azlį́į́ʼ	approve
bee lą́ʼ azlį́į́ʼ	approved
ako néeltʼeʼ shąʼshin	approximately
akotʼé shąʼshin	approximately
Tʼą́ą́chil	april
tʼáadoo hooyání	arbitrary
hooghan hadadilʼį́įgi neichʼąąhí	architect
hooghan doodago kin naachʼąąhígíí	architecture
hashtʼeʼ niiʼnił	archive
ni éí	are you
daʼ ninaanish hólǫ́	are you busy
daʼ tʼáadooleʼéíísh baa naniná	are you busy
asiniyeh	are you married
daʼ íyééhísh doodago tʼáá sáhí naniná	are you married or single
Daʼ tʼahdiísh tʼáá aadi?	Are you still there?
ni éí áadi	are you there
hazʼą́ądi	area
hazʼą́ągi	area
saad doo yáʼátʼéhígíí bee achʼįʼ yájiłtiʼ	argue
saad nichxǫ́ʼí ałchʼįʼ aheʼnííł	argument
saad nichxǫ́ʼí hazlį́į́ʼ	argument
hááyá	arise
agaan	arm
silaołtsooí	army
binaagóó	around
ałkééʼ niiʼnil	arrange
hashtʼeel yaaígíí	arrangement
jiníyáago	arrival
idzáh	arrive
jiníyá	arrived
ázhdoolnih	arrogant
kʼaaʼ	arrow
naʼachʼąąh	art
naaltsoos bee ił haneʼgo hadilyaaígíí	article
tʼóó bééʼalyaaígíí	artificial
naʼachʼąąhí	artist
tʼáá hoolzhish	as long as
ałdóʼ	as well
ałdóʼ	as well as
łeeshchʼiih	ash
baa yázhniizį́į́ʼ	ashamed
naʼídikid	ask
naʼídeekid	asked
ałwosh	asleep
tʼáá háádę́ęgo shį́į́	aspect
Assam Dineʼé Bizaad	Assamese
diné nízhdííłtsʼingo	assault
ałhíʼayiildééh	assembly
ałhiih yiʼnííł	assembly
doo chʼééh ahaʼníi da	assertive
biʼneelʼąąh	assess
naanish aadeetʼánígíí	assessment
daʼilíinii daahóhígíí	asset
tʼáá haʼátʼíízhį́į́ daahóhígíí	assets
naanish baadeetʼą́h	assign
naanish aadeetʼánígíí	assignment
ákaʼeʼeyeed	assist
ákaʼanálwoʼí	assistant
bił naʼanishí	associate
yił daʼahotąʼígíí	associated
dah ooldah bił hazʼánígíí	association
shąʼshin hwiinidzinígíí	assume
daatsʼí hwiinidzinígíí	assume
shąʼshin jinízingo	assumption
-di	at
tʼaa biʼohgo	at least
ajiiyą́ą́ʼ	ate
diné jooł yee naanéhí	athlete
biheestłʼǫ́	attach
bóóltąʼ	attach
béheestłʼǫ́h	attached
bíiltsoodígíí	attachment
bóóltąʼígíí	attachment
bikʼijiilwod	attack
akʼiilwod	attack
bizhneeztą́ą́ʼ	attempt
jiniyá	attend
áadi naʼadáago	attendance
shooh kweʼé	attention
aʼátʼeʼ	attitude
tʼáá haʼátʼííshį́į́ baa nidaʼaldeehgo hwił honeenih	attract
hwił nizhóní	attraction
adáhoneeníh	attractive
bee hohónéedzánígíí	attribute
diné dabináłígíí	audience
Bineʼanitʼą́ą́tsʼósí	august
abizhí	aunt
amá yázhí	aunt
amáyázhí	aunty
abizhí	aunty
tʼáá anínígíí	authentic
doo bééʼalyaaígíí	authentic
haneʼ haidiilaaígíí	author
óholnííh ąąh silá	authority
akʼee	autumn
hólǫ́ǫgo	available
tʼáá bíighahígíí	average
bikʼeeʼąąh	avoid
chʼénadzid	awake
bee hwééhoʼdoolzįįhgo aaʼilyéhígíí	award
baaʼákohwiinidzin	aware
baaʼákohwiinidzinígíí	awareness
niláá	away
nizhóní	awesome
sxih	awesome
baaʼih	awful
tʼóó haashį́į́ yitʼé	awkward
Bolivian Bitsįʼ Yishtłizhii Bizaad	Aymara
awééʼ	baby
diné tʼáhdoo iiyehígíí	bachelor
bikéédóó	back
bineʼdę́ę́ʼ	back
nákééʼ náhaneʼ	background
baaʼih	bad
azis	bag
bee ódleeh	bait
atʼees	bake
bááh nidahatʼees bił hazʼą́ągi	bakery
bił éʼalʼíní dibahígíí	baking soda
ałhxeełtʼéego naadloʼ	balance
jooł	ball
Mali Dineʼé Bizaad	Bambara
hashkʼaan	banana
dilníh yee nidaanénígíí	band
názhniłhxał	bang
béeso báhooghan	bank
béésh	bar
kʼasdą́ą́ʼ	barely
doo alʼį́į́góó bee ałghazhdiitʼaah	bargain
nahałʼin	bark
naadą́ʼastʼé	barley
adáahgi hólónígíí	barrier
bitłʼáahdi	base
bee hooʼah	based
hooghan biyaadi nááhastʼánígíí	basement
tʼóó ákotʼéhígo	basic
akotée dah łeh	basically
chʼil	basil
diigis	bastard
ałchʼįʼ beʼastłʼǫ́	batch
taʼadigis	bath
niʼoh nídaʼaldah góneʼ	bathroom
ajéí	battery
anaʼ hazlį́į́ʼ	battle
tó nihiníyį́įgi	bay
hazhóʼó ádaaʼáholyą́	be careful
tábąąh	beach
tsin ádahsitánígíí	beam
tsin ániʼánígíí	beam
naaʼółí	beans
shash	bear
dághaaʼ	beard
naʼazhdiidláhígíí	bearing
yéʼii	beast
bááhadzidii	beast
bikʼeh hodidleeh	beat
nizhóní	beautiful
yaʼátʼééh	beautiful
hózhǫ́	beauty
adzaa	became
biniiyéhígíí	because
biniinaaígíí	because
adzaa	become
tsáskʼeh	bed
níʼjiilwosh góneʼ	bedroom
tséskʼeh bił hazʼání góneʼ	bedroom
tłʼézhii	bee
béégashii bitsįʼ	beef
íídą́ą́ʼ adzaago	been
bizhééʼ hólóní	beer
tó tsiʼnaʼiiłáhí	beer
bilą́ąjįʼ	before
alą́ąjįʼ	before
hahoolzhiizh	began
bee hahoolzhiizh	begin
bee hahalzhíishgo	beginning
łahdóó bá	behalf
haʼátʼeʼ	behave
aʼátʼeʼ	behavior
diné baʼátʼeʼ yee ádééholzinígíí	behaviour
bineʼdę́ę́ʼ	behind
jilį́	being
nilį́	being
oodląʼ	belief
joodlánígíí	believe
abid	belly
bígo	belong
ayóóʼóóníinii	beloved
hoyahdi	below
sis	belt
bikááʼ dah nídaʼnidaahí	bench
názhahgo ályaa	bend
biyaagi	beneath
biyaadi	beneath
bee aaʼáhayánígíí	benefit
bee aaʼádahayánígíí	benefits
bíighahgi	beside
bíighahjígo	besides
nizhónígíí	best
nikʼihojidlíi leʼ	best of luck
hazhóʼó aanitáhákees	best regards
yaʼátʼééh	better
bitaʼdi	between
bitaʼgi	between
tʼáá haʼátʼííshį́į́ yidlánígíí	beverage
biláadi	beyond
Bhojpur-Purvanchal Dineʼé Bizaad	Bhojpuri
diné jojoodláago	bias
ázhdoolnih	bias
hakʼihjįʼ haʼoodzííʼ	biased
dziʼizí	bicycle
bą́ą́h adooleełígíí	bid
nitsxaaz	big
dziʼizí	bike
bee ą́ą́hááʼáhí	bill
beʼastłʼǫ́h	bind
tsídii	bird
hodizhchínéejįʼ anínáhoolzhiizh	birthday
jishxash	bit
yishxash	bite
dichʼííʼ	bitter
łizhin	black
béésh nawoʼí	blade
akʼíhatʼááh	blame
doo bikáʼí da	blank
beeldlei	blanket
deesdǫǫh	blast
bee náʼiilgáhí	bleach
bił naʼastsih	blend
akʼihojidlíh	bless
akʼihojoosdliʼ	blessed
doo hootʼį́į da	blind
ił hózhǫ́	bliss
bichʼą́ą́h azʼą́h	block
dił	blood
neestʼą́h	bloom
jisoł	blow
yágo dootłʼizh	blue
doo deeníi da	blunt
tsineheeshjį́hí niteelígíí	board
tsin naaʼeeł	boat
atsʼíís	body
yibéézh	boil
diłhxił	bold
ahíiltsoos	bond
atsʼin	bone
naaltsoos wóltaʼí	book
bee bidoochidígíí	boost
bee náás óólzinígíí	booster
kéjeehí	boot
kéjeehí	boots
náhasdzoh	border
bąąh ahééʼniʼáhí	border
ádahozhdeelá	bore
ádahozhdeesłááʼ	bored
ádahozhdeelá	boring
yizhchį́h	born
aʼítʼaah	borrow
aʼínííł	borrow
naanish bee bóholníhígíí	boss
tʼáá áłah	both
aanáhatʼį́h	bother
tózis	bottle
bitłʼáahdi	bottom
nahaazniiʼ	bought
nikídiltsʼih	bounce
ákǫ́ǫ́h	bound
nahasdzoh	boundaries
ałtį́į́ʼ	bow
haabąs	bow
ásaaʼ	bowl
sitsʼaaʼ	box
ashkii	boy
tséłkéí	boy
eʼashkii	boyfriend
látsíní	bracelet
atsiighąąʼ	brain
tsin bitsʼaozʼah	branch
bee ádiidlííd	brand
adziil	brave
bił oodzííʼ	breach
bááh	bread
nahgóó naʼadáh	break
kʼeʼaltǫǫǫh	break
abinígo chʼiyáán yidánígíí	breakfast
abeʼ	breast
náhizhdidziih	breath
nahizhdidziih	breathe
naaldlooshii oołchíłígíí	breed
tsétʼáhí	brick
asdzání iiyehígíí	bride
naʼniʼáh	bridge
tʼóó baa chʼíhootʼá	brief
disxǫsgo bitsʼádiʼnídíín	bright
nizhóní	brilliant
jiʼaah	bring
akʼis	bro
niteel	broad
tʼáá haʼátʼííshį́į́ baa haneʼgo	broadcast
yichxǫʼ	broke
kʼéʼaltǫʼ	broke
kʼéʼaltǫʼ	broken
yíchxǫʼ	broken
bee nahalzhoohí	broom
anaaí	brother
atsilí	brother
aʼayééh	brother in law
yilyá	brought
dibéłchíʼí	brown
beʼazhóóʼ	brush
naadloʼí	bucket
akʼis	buddy
béeso nanideehígíí	budget
chʼosh	bug
tʼáá haʼátʼííshį́į́ ajiléehgo	build
tʼáá haʼátʼííshį́į́ ajilééh	building
tʼáá haʼátʼííshį́į́ ajilééh	built
haʼátʼííshį́į́ nitsaago	bulk
dóola	bull
adeijódlíh	bully
doo áhodiikóóh	bully
diwol	bump
dah shijaaʼ	bunch
ałchʼįʼ beʼastłʼǫ́	bunch
tʼáadooleʼé ałchʼįʼ beʼastłʼǫ́ǫgo	bundle
hayéél nidaazí	burden
łeeh yiltį́h	buried
díílid	burn
deesdǫǫh	burst
łeeh yiltį́h	bury
chidíłtsooí	bus
chʼil	bush
naanish deiyíjeehígíí	business
diitaaʼ	bust
naanish hólǫ́	busy
nidi	but
mondigíiya	butter
kʼaalógii	butterfly
ałdahnátʼáhí	button
nahaniih	buy
bíighahgi	by
shooh kweʼé	by the way
hágoóneeʼ	bye
chʼił chʼiyáán	cabbage
azeeʼ biih náʼniłí	cabinet
béésh naneesdizí	cage
bááh łikaní	cake
béégashii yáázh	calf
hojilneʼ	call
shichʼįʼ hólneʼ	call me
hóóneʼ	called
hashtʼeʼ adolzin	calm
niyá	came
naatʼáanii iʼiiʼnííł yá deiyíjeehgo yádaałtiʼígíí	campaign
bíighah	can
yadiizíní	can
doo	can't
ą́ʼnasdziid	Cancel
naałniihii	cancer
łóód doo nádziihii	cancer
tʼáá ałtsohjįʼ bíighah	capable
hazʼánígíí bíighahgo ánéeltʼeʼ dooleełígíí	capacity
naatʼáanii bił hazʼánígíí	capital
naʼadzogo aląąjįʼ bee hahooláhígíí	capital
baa haneʼgo saad bikááʼ	caption
iiltsood	capture
chidí nímazí	car
honaanish ájiłʼínígíí	career
hazhóʼó	careful
baaʼaháyą́	carefully
doo baaʼáhayą́ą́góó	careless
hwił ílį́	caring
hooghan ííłʼíní	carpenter
neʼgóó sikaadígíí	carpet
chąąshtʼézhiitsoh	carrot
yitʼááł	carry
niwohjįʼ bee íʼilééh	carry on
chʼétʼaah	carry out
sitsʼaaʼ	case
béeso	cash
tʼáadooleʼé alnééh	cast
kin yah diitłʼinígíí	castle
tʼáá hazhóóʼígo	casual
másí	cat
idoolnaʼ	catch
bił adeesdéél	catch
ałʼąą ádaatʼéego dah naazhjaaʼ	category
béégashii	cattle
iiltsood	caught
biniinaa ádzaaígíí	cause
ádaaʼákohwiinidzin	caution
baaʼákohwiinidzin	cautious
tsé biyiʼ ahoodzą́h	cave
neʼ kólyaago	cease
hooghan biyiʼ hódahdi	ceiling
baaʼahééhwiinidzin	celebrate
chʼosh doo yitʼíinii	cell
ałnííʼ	center
neeznádiin nááhaijįʼ	century
tséstʼéí	cereal
nahaghá	ceremony
tʼáá ákotʼé	certain
tʼáá áko	certainly
naaltsoos binahjįʼ bee éédahozinígíí	certificate
béésh bee naʼadzį́zí	chain
bikááʼ dah asdáhí	chair
bee niʼíhonitaahí	challenge
bee hooʼah	chance
łahgo ádzaa	change
chʼohooshkał	chaos
tʼáá haishį́į́ baa haneʼígíí	character
tʼáá haishį́į́ diné	character
tʼáá haʼátʼííshį́į́ doodago tʼáá háįda átʼéhígíí	characteristics
bee ąąháázil	charge
nániildóóh	charge
ił hadleeʼ	charity
báhozhǫ́	charming
tʼáá haʼátʼííshį́į́ baa haneʼgo bee naʼashchʼąąʼ	chart
jinoołchééł	chase
ahxił haneʼ	chat
doo ilį́į da	cheap
honaʼadloʼ	cheat
inaʼadloʼ	cheating
naaltsoos béeso	check
nélʼį́h	check
aniitsiʼ	cheek
hwił hózhǫ́	cheer
ił hózhǫ́	cheerful
íhoneedlį́	cheers
géeso	cheese
nahasdzáán biyiʼdóó haagéedgo bee naʼalkaah	chemistry
hwił nilį́įgo baa nitsáhákees	cherish
daanéʼé	chess
ayid	chest
yitʼaał	chew
naʼahóóhai	chicken
naatʼáanii	chief
awééʼ	child
áłchíní ídlį́į́dą́ą́ʼ	childhood
nooséłí	children
áłchíní	children
atah hahosdiiszííʼ	chill
łid bá hazéí	chimneys
ayaatsʼiin	chin
abeʼ nihxiní	chocolate
tʼáá hó íizhnízingo	choice
bikʼih hodiinííh	choose
jilneʼ	chop
honaanish ájiłʼínígíí	chores
neeskʼah	chubby
nitsxaaz	chubby
tsodizin báhooghan	church
dikǫ́zhí	cinnamon
nábąs	circle
bee ił hazʼánígíí	circumstances
diné kééhatʼínígíí	citizen
kintah	city
hó silį́į	claim
naaltsoos nináltsooz	claim
hazhóʼó bééhozingo	clarify
óltaʼ góneʼ	class
hashtłʼish	clay
nizhóní	clean
doo bąąh chxin da	clean
niłtóólí	clear
naaltsoos ííłʼíní	clerk
áyóo hwił ééhozin	clever
bił naʼanishí	client
tsé naachiiʼ	cliff
níłchʼih bee áhootʼéhígíí	climate
yiʼnah	climb
bąąh dah jiztʼį́įgo	clingy
náʼoolkiłí	clock
ałchʼih ánalyaa	close
daʼdeelkaal	close
ééʼ inídaaʼniłí góneʼ	closet
naatʼą́hí	cloth
ééʼ	clothes
kʼos	cloud
kʼos dah sikaad	cloudy
diné maʼádilíní	clown
binahjįʼ áhwiinidzinígíí	clue
bee áhwiinidzinígíí	clue
doo hatah hwiinéí da	clumsy
nimazgo ałhiih yiʼnilgo	cluster
naʼnitiní	coach
tsékǫʼ	coal
tóniteeł bąąhgi	coast
éétsoh	coat
gohwééh	coffee
akʼiʼdiitįįh	cognitive
tʼáá ákohanéehgo ádzaa	coincidence
deeskʼaaz	cold
sikʼaz	cold
naałdas	collapse
nidoołdas	collapse
azénáʼtʼiʼ	collar
bił ałhił nidajilnishí	colleague
diné bił nidaʼanishígíí	colleagues
nahadlááh	collect
ałhxaʼádaalyaaígíí	collection
hódahdi bidziilgo óltaʼígíí	college
naashchʼąąʼígíí	color
tátłʼidgo dootłʼizh doo bee naashchʼąąʼgóó doo hodítéehii daʼawosh	colorless green ideas slept furiously
nidaashchʼąąʼígíí	colour
noolkáál	column
tsiighá bee yilzhóhí	comb
ałhxiiʼjįʼ	combination
ałhíidzoh	combine
ałhíinil	combine
hágo	come
hágo	come here
tįʼ	come on
doo hwidítéehiiʼ	comfort
hwił yáʼáhootʼééh	comfortable
aadę́ę́ʼ	coming
hodíinaʼgo aadę́ę́ʼ	coming soon
ajiłáago	command
baa haʼoodzííʼ	comment
bóʼookąąhí	commercial
diné naanish baadeetʼánígíí	commission
bee adeehazhdoodzííʼ	commit
bee ádeehaʼdoodzííʼ	commitment
adeehaʼdoodzííʼ	committed
chʼiyáán aanídaajihígíí	commodity
ádaatʼéhígíí	common
tʼáá haashį́į́ yitʼéego hxił haneʼ	communicate
tʼáá haʼátʼííshį́į́ bee ahxił haneʼ	communication
dinéʼ kééhatʼį́įgi	community
diné kééhatʼínígíí	community
ałnááʼádááh	commute
diné bił nijiʼaashígíí	companion
naanish deiyijeehígíí	company
ałhxąąh naaʼnil	compare
ałhxąąh naaʼnil	comparison
baa hwił hózhǫ́ǫgo bizhneedlį́h	compassion
hwił yáʼátéehgo	compassionate
ałhídinéelná	compatible
ałkʼiʼayiildééh	compete
tʼáá ałtsohjįʼ bíjíighah	competent
bee ałkʼééʼayiildahígíí	competition
bee ałhaaʼayooldah	competitive
baa saad hojołį́	complain
baa saad hojiłeehgo	complaint
saad yáʼátʼéhígíí bee yátiʼ	complement
ałtsoh ályaa	complete
tʼáá átʼé	completely
tʼáá dikwíigo shį́į́ ałʼąą átʼéego bee hadítʼéhígíí	complex
bikʼehgo nidaʼanishígíí	compliance
tʼáá nanitłʼah	complicated
saad yáʼátʼéhígíí bee yátiʼ	compliment
bikʼehgo ajiłʼį́h	comply
tʼáá haʼátʼííshį́į́ bee ályaaígíí	composition
tʼáá haʼátʼííshį́į́ bee hadilyaaígíí	composition
tʼáá haʼátʼííshį́į́ ałhxíiʼnilgo	compound
tʼáá haʼátʼííshį́į́ ałhxiih yilyáago	compound
akʼiʼdiitįįh	comprehension
akʼizhdiitįįh	comprehensive
bee ałghashdeestʼą́h	compromise
bee hazʼánígíí	compulsory
béésh łichíiʼii nitsékeesí	computer
tʼááłáhídóó chóoztʼeʼgo	concentrate
yéego baa nitsáhákees	concentrate
baa nitsíhakeesígíí	concept
baa haneʼgo	concern
hoʼdiiłáago	concern
hoʼdiiłáh	concerned
baa haneʼ	concerned
hazhǫʼ	concert
bee ééhoozinígíí	conclusion
yitʼį́įgo bééhozinígíí	concrete
bee átʼéhígíí	condition
ádaatʼéhígíí	conditions
aʼjilééh	conduct
ahxił haneʼ	conference
chʼééʼditʼaah	confess
chʼééjiʼditʼaah	confess
haʼahoníh	confidence
haʼahoníh	confident
bee lą́	confirm
doo ałhíhodínéenáa da	conflict
tʼóó hwił ałtaahaʼaʼ	confused
doo hazhóʼó bikʼiʼdiitįįh da	confused
doo hwił ééhozin da	confusion
baaʼahxééhwiinidzin	congrats
nizhóní baaʼahxééhwiinidzin	congratulation
doo lá dóʼ da nizhóní	congratulations
saad naadzohgo bee yátiʼ	conjunction
ałhíiltsood	connect
bilajiyáago	conquer
hontsékees átʼéhígíí	conscious
chʼééjidzin dóó tʼáá ałtsohjįʼ baaʼáhozhnízin	consciousness
bee ląʼ aleeh	consent
tʼáá haʼátʼííshį́į́ doo ákojiiłįįhgóó biniinaa akʼihnéítʼihígíí	consequences
ahxił haneʼ	conservation
ahxił haneʼ	conservative
baa nitsíníkees	consider
baa nitsáháskééz	considered
bee hadítʼéhígíí	consist
tʼááłáhígi átʼéego bee injiiłʼįįhgo	consistency
tʼáá łáhígi átʼéego bee áʼjoolííł	consistent
tʼáá ałhxą́ą́h	constant
tʼáá ałhxą́ą́h ááníiłgo	constantly
atsą́ądi íítłʼish	constipation
nidaʼanishídi	construction
nidaʼanishígi	construction
jiyą́ągo	consume
yidą́	consume
yidánígíí	consumption
bichʼįʼ haneʼ alyaa	contact
ayóo idilnééh	contagious
biyiʼígíí	contain
dabiyiʼígíí	contains
kʼad áhooníłígíí	contemporary
doo haahodzídlíi da	contempt
baa haneʼí	content
baa haneʼígíí	content
hwininéh	contest
áhootʼéhígíí	context
kéyah nitsaago bił hadahwiisdzooígíí	continent
náásgóó hoolzhish	continue
naaltsoos bee ałghaʼdeetʼánígíí	contract
tʼáá sahdii átʼé	contrast
ił hadleeʼ	contribute
tʼáadooleʼé aazhnínilígíí	contribution
bóholnííh	control
óholnííh	control
tʼáá haʼátʼííshį́į́ baa saad hólǫ́ǫgo	controversial
tʼáá ałtsohjįʼ bee bichʼįʼ háʼahootʼiʼígíí	convenience
doo bichʼįʼ nahonitłʼah da	convenient
ahił haneʼ	conversation
łahgo alnééh	convert
yigééł	convey
diné tʼáá haʼátʼííshį́į́ bijiníigo yikʼehgóó ádzaago	convince
ábizhniisį́įgo	convinced
chʼiyáán alnééh	cook
chʼiyáán alnééh	cooking
honeezkʼází	cool
sikʼází	cool
naanish bił nahazʼánígíí	cooperation
nanitłʼaaígíí bił joogááł	cope
béésh łichíiʼii	copper
bitsiin	core
naadą́ą́ʼ	corn
nástłʼah	corner
hashtʼeelyaa	correct
bą́ą́h alʼínígíí	cost
ééʼ hózhǫʼ biniiyé bee hááʼdiitʼįįhígíí	costume
hooghan yázhí	cottage
naʼakʼąʼ	cotton
bikááʼ dah asdáhí hideeneezígíí	couch
dikos	cough
bíighahdą́ą́ʼ	could
naatʼáanii dah naháaztánígíí	council
anéeltʼeʼ woltaʼígíí	count
bikááʼ dah nídaʼaniłí	counter
kéyah nitsaago hahoodzoh	country
kéyah	countryside
ałhidiʼnáanii	couple
naakigo	couple
siiʼhasin	courage
atiin	course
aahwiinítʼíní góneʼ	court
aahwiinítʼį́ bił hazʼánígíí	court
ił ílį́	courtesy
shił naaʼaash	cousin
bikʼéstiʼ	cover
béégashii	cow
diigis	coward
honeezilí	cozy
tátłʼááh chʼosh	crab
sitsʼil	crack
álá bee álʼínígíí	craft
tʼáá haʼátʼííshį́į́ nichxǫʼį́	crap
ałhiihíłdááz	crash
biká íizhnízin	craving
yiʼnah	crawl
jooʼnah	crawl
dooʼáhayąʼ	crazy
diigis	crazy
eʼelnééh	create
ayóo tʼáadooleʼé alʼínígíí	creative
ąąhááʼáh	credit
ąąh nijiʼnaʼ	creep
tʼáá haashį́į́ yitʼé	creepy
doo yáʼátʼéeh da	creepy
ahił nidaanishgo dah yikahígíí	crew
oodzííʼ	crime
azhdiigaʼ	cringe
anáhwiitééh	crisis
bee nahazʼánígíí	criteria
tʼáá íiyiíí ákotʼé	critical
diné biyátiʼ	criticism
naniseʼ kʼéédilyéhígíí	crop
kʼidaʼdilyé	crops
kʼidadeesyáhígíí	crops
ałnáʼasdzoh	cross
gáagii	crow
hasdlą́h	crowd
hasdlą́h	crowded
chʼah nizhóní	crown
Tsʼídá yéego bee hazʼánígíí	crucial
tʼáá atíʼdoolníiłgo nitsáhákees	cruel
hwił oolwołgo	cruise
shizhįzh	crush
yichah	cry
chʼil naniseʼ yidánígíí	cucumber
ałhxééjisniiʼ	cuddle
óʼoolįįł	culture
tʼáá inaʼadloʼ bóóltąʼgo	cunning
bąąh haʼíizhahí	cup
azaaʼ biih náʼniłí	cupboard
naanázʼáh	curb
nádziih	cure
náádzííʼ	cure
oolkił bikʼehgo naʼadáhígíí	curfew
oolkił bikʼehgo yah anínaʼiidáhígíí	curfew
tʼáá haʼátʼííshį́į́ shił bééhodoozįįł jinízingo	curiosity
haʼalzííd	curious
yishchʼil	curly
béeso	currency
kʼad hoolzhishígíí	current
kʼad	currently
baa hodeetʼą́h	curse
tsósxǫʼgi dánídilbałí	curtain
tsiiʼááł	cushion
bee óʼoolįįł	custom
naʼiiłniihí	customer
óʼoolʼįįł	customs
kʼégéésh	cut
nizhóní	cute
ałhééhwiilzhíísh	cycle
dziʼiz	cycling
azheʼé	dad
azheʼé	daddy
tʼáá ákwii jį́h	daily
chʼiyáán abeʼ biłtahígíí	dairy
daʼdeestłʼin	dam
yichxǫʼ	damage
yáadilá	damn
ditłééʼ	damp
azhish	dance
bááhadzid	danger
bááhadzid	dangerous
chahałhxeeł	dark
tłʼééʼ	dark
shiyázhí	darling
awééʼ	darling
tsxį́į́ł jilį́	dash
naʼaskáaʼgo naaltsoos bee hadilyaaígíí	data
yoołkáłígíí	date
achéʼé	daughter
jį́h	day
daaztsą́h	dead
ádin silį́į́ʼ	dead
bee eʼeʼaah	deadline
ajéékał	deaf
bee ałghaʼdeetʼą́ągo	deal
yaʼátʼééh	dear
Tʼáá Áłtsoh Yaʼátʼééh	Dear All
Naʼiiłniihí	Dear Customer
Yaʼátʼééh	Dear Customer
Yaʼátʼééh amá dóó azheʼé	Dear Parents
Yaʼátʼééh Hastiin	Dear Sir
Yaʼátʼééh daʼółtaʼí	Dear students
Yaʼátʼééh Nidaanéhí	Dear Team
daʼaztsą́h	death
ádin silį́į́ʼ	death
baa nikʼíyatiʼ	debate
ąąh hadaazʼáh	debit
tʼáá haʼátʼííshį́į́ bitsʼą́ą́dóó yidiłdaasígíí	debris
bee ąąh hááʼáhígíí	debt
neeznáá nááhaijįʼ	decade
dííłdzid	decay
daaztsą́h	deceased
ádin silį́į́ʼ	deceased
hoʼdeesdloʼgo	deceive
Níłchʼihtsoh	december
nizhóní	decent
áhwiiniidzį́į́ʼ	decide
bee nihozhniʼą́h	decided
hwiinidzinígíí	decision
dah náhastʼą́h	deck
dooda hodooʼniid	decline
yaa kódzaa	decrease
haʼátʼííshį́į́ ajiłʼínígíí bizhneedlį́	dedicated
bizhdeelkaal	dedication
tʼáá haʼátʼííshį́į́ ajiléehgo	deed
ditą́	deep
bįįh	deer
tʼáá łáhígi átʼéego bá siłkidígíí	default
bikʼeh hodidleeh	defeat
bichʼą́ą́h nijigháh	defend
óolyéhígíí baa haneʼ	define
tʼáá anííh átʼéego	definitely
tʼáá haʼnínígíí	definition
óolyéhígíí	definition
hadoh neiłkidí	degree
nátʼą́ą́ʼ adzaa	delay
nátʼą́ą́ʼ kónályaa	delayed
kʼééʼalchxǫǫh	delete
tʼáá ákodoolníiłgo ádzaa	deliberate
baa hastiʼ	delicate
łikan	delicious
hwił hózhǫ́	delight
ił hózhǫ́	delighted
tʼáadooleʼé jiníyį́įgo	deliver
yilyá	delivered
bił éʼélyaago yilwod	delivery
bee haʼoodzííʼ	demand
ajiłáh	demanding
jókeed	demanding
tʼáá ałtsoh óholnííh bąąh silá	democracy
chʼį́įdii	demon
ííshjání álnééh	demonstrate
dooda hoʼniʼniihgo	denied
haashį́į́ niłtsohgo	density
haashį́į́ honiłtéelgo	density
azeeʼ ííłʼíní awooʼ yinaalnishí	dentist
dooda hoʼdooʼniid	deny
naanish bił hazʼánígíí	department
dashdiigááhdóó	departure
baʼahodlíh	depend
biʼilniiʼ	deploy
yah eeʼnil	deposit
adił nitsáhákees	depressed
adił nitsáhákees	depression
ditą́	depth
hazhóʼó baa haneʼ	describe
baa haneʼí	description
kéyah hóóltséígo	desert
bee akʼihojidlíh	deserve
haʼátʼííshį́į́ hadilyaa	design
haʼátʼííshį́į́ alyaa	design
jideeyáajįʼ	designation
tʼáá íiyisíí nidzin	desire
bikááʼ naʼanishí	desk
doo hwił hasxihjįʼgóó	despair
doo hasxihjįʼ dagóó	despair
hwił nitsééhadááh	desperate
akotʼée nidi	despite
łikání	dessert
adeesdzáajįʼ	destination
náasdi háʼáhootʼéhígíí	destiny
jiłchǫǫhgo	destroy
hoochxǫǫhígíí	destruction
bee baa haneʼí	detail
hazhóʼó bee baa haneʼí	details
bikʼínitáahgo bééhoozįįh	detect
haʼahóníigo éʼalnééh	determination
haʼahoníh	determine
haʼahóníh	determined
yichxóʼ	devastated
hadilnééh	develop
hadilyaa	developed
hadadilyaaígíí	development
hadilyaaígíí	development
tʼáá haʼátʼííshį́į́ béésh łichíiʼii yee naalnishígíí	device
chʼį́įdii	devil
baaʼázhdeetʼą́	devoted
Indo-Aryan Dineʼé Bizaad	Dhivehi
ashįįh łikan atsʼíís yeinístʼįįd	diabetes
alohkʼeh bąąh dahazʼą́	diabetes
atsą́ hodiniih	diarrhea
abeʼ bee ádaalyaaígíí	diary
saad tʼáá haʼnígíí dabikáʼígíí	dictionary
íishłaa	did
daatsaah	die
daaztsą́h	died
chʼiyáán yidánígíí baaʼákohwiinidzin	diet
bee ałʼąą ádaatʼéhígíí	difference
tʼáá sahdii átʼé	different
nanitłah	difficult
naʼageed	dig
niʼjigeed	dig
ajilį́	dignity
yéego nijilnishgo	diligent
eʼeʼáahgo chʼiyáán yidánígíí	dinner
biih yitiʼ	dip
ahoʼdiʼníigo	direct
abijiníigo	direct
bikʼehgo éʼalnéhígíí	direction
bikʼehgo nidaʼanishí	director
łeezh	dirt
niłhxin	dirty
baaʼih	dirty
doo naalnish da	disable
doo naalnish dagóó alyaa	disabled
doo bééhozin da	disappear
doo hwił yáʼátʼéeh da	disappointed
nitsihodinídéél	disaster
nahgóó ahoolghan	discard
bééʼilniiʼ	discharge
naʼadizhnitaah	discipline
béédooʼnil	discount
bikʼíʼneestą́ą́ʼ	discover
diné báhodoonih	discrimination
baa yátiʼ	discuss
tʼáá haʼátʼííshį́į́ baa yátiʼ	discussion
naałniih	disease
nidaałniih	diseases
doo hwééhozingóó	disguise
baaʼih	disgusting
asaaʼ	dish
asaaʼ	dishes
biʼilnííh	dismiss
bichʼįʼ haneʼ alʼínígíí	dispatch
ííshjání ályaa	display
nahgóó ahalghan	disposal
bee ałghazhditááh	dispute
anizahjįʼ	distance
anizáád	distance
tʼáá ííshjání łahgo átʼé	distinct
ałʼąą naaʼnilgo baa nitsáhákees	distinguish
tʼáá haʼátʼííshį́į́ baa yínííł nijigháh	distress
doo ił hózhǫ́ǫ da	distress
naʼaniih	distribution
bił hahoodzoh	district
naʼniłtłʼah	disturb
bikooh	ditch
taahyilwod	dive
tʼáá ałʼąą ádaatʼéhígíí	diverse
ałʼąą ádaatʼéhígíí	diversity
ałtsʼá daadzoh	divide
diyin	divine
ałtsʼáʼitʼaash	divorce
hwił nahoniyil	dizzy
íshłééh	do
daʼ niiísh	do you
daʼ ayóóʼáshííniʼníh	do you love me
azeeʼ ííłʼíní	doctor
naaltsoos bee éédahozinígíí	document
adzaa	does
nida	doesn't
dooda	doesn't
łééchąąʼí	dog
Jammu Dineʼé Bizaad	Dogri
ajiléehgo	doing
awééshchíín	doll
naatʼáanii bił hahoodzoh	domain
hooghan hazʼánígíí	domestic
yéego bidziilgo	dominant
tʼáadoo	don't
tʼáadoo baah níneʼí	Don't worry
tʼáadooleʼé diné baa jiléehgo	donate
ałtsoh ályaa	done
télii	donkey
nátʼoh tsiʼnaʼiiłáhí	dope
naakigo	double
hwił naaki nilį́	doubt
taosniiʼ	dough
yaago	down
bééʼalyaa	download
naaltsoos ałtsé bee haʼdilyaaígíí	draft
jooshoł	drag
bąąh hááʼéél	drain
bąąh haaʼoł	drain
haashį́į́ hootʼįįh	drama
naʼachʼąąʼ	draw
análzhoʼí	drawer
niʼjichʼąąh	drawing
bichʼįʼ neʼjilį́h	dread
naʼiizeeł	dream
ééʼ tłʼaakał	dress
bee naʼihonitaah	drill
adlą́h	drink
yidlánígíí	drink
oołbąs	drive
naaltsʼid	drop
naaltsʼid	dropped
hoołtséí	drought
hazgan	drought
hwił honeezdoh	drunk
hwił nahoniyil	drunk
yíłtséí	dry
naaleełí	duck
hastiin	dude
ashkii	dude
yidziih	due
binahjįʼdo	due to
tʼóó átʼé	dull
diigis	dumb
yah iikąh	dump
yaaką́h	dump
biyiʼ hoolzhishígíí	duration
biyiʼ hoolzhish	during
łeezh	dust
naanish	duty
haghan	dwell
biʼniitsą́ągo	dying
tʼáá átʼé	each
tʼáá ájiłah	each other
tsxį́įłgo ádeeshdlííł hwiinidzin	eager
atsá	eagle
ajaaʼ	ear
tʼáá aniidígo	earlier
tʼáadoo hodinaʼí	early
joosbą́h	earn
ajaaʼ	ears
nahasdzáán	earth
kéyah hideesnááʼ	earthquake
hazhóʼógo	ease
doo nanitłʼahgóógo	easily
haʼaʼaah	east
doo nanitłʼah da	easy
adą́	eat
iyą́	eating
béeso dah hólǫ́	economic
ajitį́h	economy
bidáaʼgi	edge
bidáaʼdi	edge
naaltsoos ninánélʼį́įgo hashtʼeelnééh	edit
óhooʼaah	education
hweidínóotʼįįłgo nijólíhígíí	effect
aanídóotʼiiłgo	effect
tʼáá haʼátʼííshį́į́ idééłníigo naalnishígíí	effective
ideełnínígi átʼéego	efficiency
tʼáá haʼátʼííshį́į́ yáʼátʼéehgo alį́nígíí	efficient
tʼáá hó ájitʼéego	effort
ayęęzhii	egg
ayęęzhii yiltʼąąʼí	eggplant
adaaʼáhodlíh	ego
tseebíí	eight
tseebíítsʼáadah	eighteen
tseebídiin	eighty
tʼáá háídíí shį́į́	either
tʼáá háídígíí dah	either
baa yátiʼ	elaborate
achʼoozhlaaʼ	elbow
asdzą́ą́ náás silį́ʼígíí	elder
hastiin náás silį́ʼígíí	elder
hastóí náás silį́ʼígíí	elderly
sáanii náás silį́ʼígíí	elderly
nizhóní yeeʼ	elegant
tʼáá haʼátʼííshį́į́ biyiʼgo ályaaígíí	element
bichį́į́h yee adilohii	elephant
łaʼtsáadah	eleven
bee háʼahootʼiʼ	eligible
nahjįʼ atsʼáhoʼdooltʼeʼ	eliminate
háíshdóʼ	else
haʼátʼíishdóʼ	else
baa yáhwiiniidzííʼ	embarrassed
tʼóó baa yáhasin	embarrassing
ádizhdiiltsood	embrace
tʼáá haʼátʼííshį́į́ haayáago	emerge
nitsihodiniłgo	emergency
hatah áhootʼéhígíí	emotional
aahojoobaʼ	empathy
yéego bóholníhígíí	emphasis
tʼáá haʼnínígi átʼéego	emphasize
naalnishí	employee
nidaalnishí	employees
bá nidaʼanishí	employer
naanish	employment
biyi ádin	empty
naalnishgo alnééh	enable
ałkʼíhonítʼiʼ	encounter
saad yáʼátʼéhígíí	encourage
neʼ ádzaa	end
báádahadzidii hwinoolʼáaʼgo	endangered
naʼádizhnitaah	endeavor
achʼįʼ nahwiiʼnáh	endurance
biyiʼ tázhdigháahgo	endure
biyiʼ hwił hoolzhishgo	endure
anaʼí	enemy
níłchʼih	energy
naanish ajilééh	engage
naanish ajilééh	engaged
iigehgo bee nihootʼánígíí	engagement
tʼáá haʼátʼííshį́į́ bee nihootʼánígíí biniiyé áadi jidoogáłígíí	engagement
chidí bitsiitsʼiin	engine
diné tʼáá haʼátʼííshį́į́ haidileʼgo áyooliiłígíí	engineer
Bilagáana	English
náás hideesnilgo ályaa	enhance
nizhónígo	enjoy
nitsxaaz	enormous
bíighah	enough
ííshją́ą́shį́į́	ensure
yah eʼedááh	enter
honeenih bił náhootʼaahígíí	entertainment
bizhneedlį́h	enthusiasm
bóhoneedlínígíí	enthusiastic
tʼáá átʼé	entire
tʼáá ałtsoh	entire
hó silį́įgo	entitled
tʼáá haʼátʼííshį́į́ hólǫ́ǫgo	entity
yah ahootiʼídę́ę́ʼ	entrance
naanish yiyoołwołí	entrepreneur
naaltsoos bee bił éʼalʼínígíí	envelope
hanagóó áhootʼéhígíí	environment
tʼáá haʼátʼííshį́į́ diné bíhígíí bee shídooleeł bee laanaa hwiinidzin	envy
ałkʼidą́ą́ʼ haneʼígíí	epic
naałniih neesniiʼ	epidemic
ałhxeełtʼé	equal
bee nidaʼanishí	equipment
ahił ídį́h	equity
tʼáá ałhxeełtʼéego	equivalent
tʼáá ałhxeełtʼéhígíí	equivalent
bee akʼééʼalchxǫǫhí	eraser
isdzih	error
chʼélwod	escape
eii tʼáá íiyisíí	especially
naaltsoos haneʼ bee hadilyaaígíí	essay
tʼáá haʼátʼííshį́į́ átʼéhígíí	essence
íiyisíí bóholnííh	essential
hadilnééh	establish
hazhdiilaa	established
kéyah ił hahoodzooígíí	estate
daatsʼí bíighahígíí	estimate
daatsʼí hwiinidzinígíí	estimated
akódaatʼéhígíí	etc
doo ninítʼiʼ da	eternal
naʼnitin bee ayaahooʼaʼ bee ájitʼéhígíí	ethics
nátʼą́ą́ʼ nináʼalkaahgo bee íʼneelʼąąh	evaluate
nátʼą́ą́ʼ nináʼalkaahgo bee íʼneelʼąąhígíí	evaluation
ałhxeełtéego	even
tʼáá ákótʼée nidi	even though
eʼeʼaah	evening
bił hoohaaígíí	event
akotʼéego	eventually
łahdaásh	ever
tʼáá átʼé	every
dinéʼ tʼáá ałtsoh	everybody
diné tʼáá ałtsoh	everyone
tʼáá ałtsohní	everything
binahjįʼ bikʼíʼneetąʼígíí	evidence
iiníziin	evil
hoolzhishdę́ę́ʼ dahinánígíí dahazlį́į́dą́ą́ʼ	evolution
tʼáá hazhóóʼígo aníił	evolve
West Africa Dineʼé Bizaad	Ewe
ahastiinée	ex
eʼasdzánée	ex
tsʼídá tʼáá ákotʼé	exact
tsʼídá tʼáá ákotʼé	exactly
hazhóʼó nélʼį́	exam
hazhóʼó nélʼį́	examine
binahjįʼ haneʼí	example
bilááh eʼelyaa	exceed
nizhóní	excellent
nizhdiiʼaah	except
nahjįʼ kólyaa	exception
bilááh anéeltʼeʼ	excess
tʼóó ahayóí	excessive
ałnááʼilyá	exchange
ił hózhǫ́	excited
baa hwił hózhǫ́	excitement
bóhoneedlį́h	exciting
tʼáá haanídzahjįʼ shį́į́ tʼéíyá bee hazʼą́h	exclusive
biniinaaígíí	excuse
biʼilííh	excuse
bee shá náhoołʼaah	excuse me
biʼdeezhnish	execute
bidaʼdeezhnish	execution
naatʼáanii aląąjįʼ bił hahodítʼéhígíí	executive
hatah áhoshdilzééh	exercise
chʼééh adeesdzáh	exhaust
chʼééh adeesdzáh	exhausted
tʼáadooleʼé danélʼínígíí	exhibit
tʼáadooléʼé danélʼínígíí	exhibition
hólǫ́	exist
hináago	existence
hólǫ́ǫgo	existence
chʼéʼádááh	existing
chʼíhonítʼiʼ	exit
chʼéʼétiin	exit
ałtsʼąą kódzaa	expand
nijólí	expect
naʼólníh	expected
bikʼéh nidaʼiilyéhígíí	expenses
ayóo ilį́	expensive
biyiʼ hwił hoolzhiizhígíí	experience
naʼalkaahgo bee naʼíhonitaahí	experiment
yéego yee ééhosinígíí	expert
bee eʼííʼą́h	expired
hazhóʼó baa haneʼ	explain
hazhóʼó baa haneʼ	explanation
tʼáá hó bee izhdootʼįįł biniiyé áʼjiléehgo	exploit
haʼdéestʼį́į́ʼ	explore
haʼnitáh	explore
nááná łahgo bił éʼelnééh	export
ííshjání ályaa	expose
ąąʼályaago ííshjání ályaa	exposed
bee ííshjání ályaa	exposure
saad bee hajoodzííʼ	express
baa nitsíjíkeesígíí baa yájiłtiʼ	expression
náás iʼnił	extend
náás deestʼą́	extended
bighą́ąhjįʼ bináániideeʼ	extension
hazʼą́ągi bikʼéstiʼígíí	extent
tłʼóodi	external
ádaasdiid	extinct
ábiʼniidiid	extinct
łaʼ biʼąą noodahígíí	extra
nahjįʼ haatʼaah	extract
tʼáá íiyisíí nizhónígo łahgo átʼé	extraordinary
yéego	extreme
yéego	extremely
anááʼ	eye
anááʼ	eyes
naatʼą́hí	fabric
nizhóní	fabulous
aniiʼ	face
bikʼih adéestʼį́į́ʼ	facilitate
tʼáá haʼátʼííshį́į́ bił nahazʼánígíí	facilities
haʼátʼííshį́į́ bił hazʼánígíí	facility
tʼáá aníinii	fact
ádaatʼéhígíí	factor
tʼáá haʼátʼííshį́į́ ádaaneʼgo bił hazʼą́ągi	factory
tʼáá aníí haneʼ	facts
yiibaʼ	fade
chʼééh ajitʼį́h	fail
biʼoh jidineesdlį́į́ʼ	failed
chʼééh aalʼįįd	failure
bił chʼaah hazlį́į́ʼ	faint
bíighah	fair
ałhxeełtʼéego aanitsáhákees	fairly
diné yázhí nidaatʼaʼígíí	fairy
oodląʼ	faith
ajoodlą́h	faithful
tʼóó átʼé	fake
tʼóó binahjįʼ átʼé	fake
akʼee	fall
doo tʼáá aníi da	false
diné hwéédahosin	fame
tʼáá bééhoziní	familiar
hooghan hazʼą́ągi	family
hooghan hazʼánígíí	family
yéego biʼoh daazlį́į́ʼ	famine
bééhoʼdilzin	famous
bee hookʼazí	fan
nizhóní	fancy
yéego nizhóní	fantastic
nizaad	far
hágoóneeʼ	farewell
naaldlooshii shijéʼígi	farm
diné bilį́į́ʼ hólónígíí	farmer
yéego bizhneedlį́	fascinating
ééʼ bee hazhdítʼéhígíí	fashion
tsxį́įłgo	fast
ayóí áábid	fat
nitsxaaz	fat
yéego áhoodzaa	fatal
tʼáá áhoonéehgo átʼé	fate
azheʼé	father
chʼééh adeesdzáh	fatigue
akʼihodiitʼą́h	fault
hwił yáʼátʼéhígíí	favorite
bichʼihjí adlínígíí	favour
aláahdi hwaanitsáhákees	favourite
bááhádzid	fear
náhadzid	fear
chʼiyáán bee ałhíʼiildééh	feast
atʼáh	feather
atsʼos	feather
bee ííshjání alnéhígíí	feature
nidaashchʼąąʼgo ádaatʼéhígíí	features
Atsábiyáázh	february
adeʼádzaa	fed up
bą́ą́h alʼį́h bikʼéh niʼdoolyéłígíí	fee
biʼiidą́	feed
nátʼą́ą́ʼ bee ił náháneʼ	feedback
haʼátʼeʼ	feel
ajitʼéhígíí	feeling
akeeʼ	feet
jideezgoʼ	fell
adah ajiigoʼ	fell
diné	fellow
yisdzaa	felt
adzaa	felt
yidzaa	felt
biʼáád	female
anitʼiʼ	fence
kʼiʼdilyé bíighah	fertile
honeenih bił hooʼaahígíí	festival
jiiłtsood	fetch
atah honiigááh	fever
tʼáá dikwíhí	few
tʼáá díkwíhí	fewer
béeso nanideehígíí	fiance
haneʼ tʼóó alyaaígíí	fiction
hazʼą́ągi	field
atsʼájidoolnih	fierce
hatsáhoniyééʼ	fierce
ashdlaʼtsʼáadah	fifteen
ashdladiin	fifty
ahigáh	fight
ahijigą́	fighting
naashchʼąąʼígíí	figure
baaʼákohwiiniidzį́į́ʼ	figure out
naaltsoos sinilígíí	file
haʼdibin	fill
haʼdéébiid	filled
naalkidí	film
baaʼih	filthy
kʼad índa	finally
béeso nanideehígíí	finance
béeso nanideehígíí	financial
haʼdeestʼį́į́ʼ	find
haʼnitáh	find
bééhozin	find out
nizhóní	fine
alázhoozh	finger
ałtsoh ályaa	finish
ałtsoh ályaa	finished
kǫ	fire
nitłʼiz	firm
ałtsé	first
aląąjįʼ yízhí	first name
łóóʼ	fish
bíighah	fit
ashdlaʼ	five
hashtʼeelnééh	fix
hashtʼe nályaa	fixed
dah naatʼaʼí	flag
tsxį́įgo diiltłah	flash
haztłééʼ	flat
isdzih	flaw
nizhóní doo asdzih da	flawless
dah yiiteʼ	flee
atsʼíískááʼ	flesh
yitʼaʼ	flew
nanileeł	flex
naanileeł	flexible
naatsʼǫǫd	flexible
ootʼah	flight
názbaal	flip
adáhoneeníigo achʼįʼ yátiʼgo	flirt
niʼjishood	flirting
dah naaʼeeł	float
tó yiląąd	flood
neʼgóó	floor
neʼgi	floor
akʼáán	flour
yinah	flow
chʼilátah hózhǫóón	flower
atah honiigááh	flu
doo bił nanitłʼah da	fluent
tʼáá ałhxą́ą́h	fluently
yilzhóólí	fluffy
tʼáá haʼátʼííshį́į́ bitooʼ	fluid
yitʼah	fly
hazhóʼó baa nitsáhákees	focus
áhí	fog
ayóo áhí	foggy
ałghą́ą́niilyáh	fold
diné	folks
bikééʼ hootʼih	follow
ninááhodiʼnélʼį́h	follow up
bikééʼ oodááł	following
chʼyáán	food
diigis	fool
doo ahalyą́ą da	foolish
akeeʼ	foot
jooł yitalí	football
biniiyé	for
binahjįʼ haneʼígíí	For example
jó ákotéego éí	for instance
ni ná	for you
doo bee hazʼą́ą da	forbidden
bizhdigoh	force
níłchʼih átʼéhígíí	forecast
atááʼ	forehead
nááná łahdę́ę́ʼ átʼéhígíí	foreign
tsintah	forest
tʼáá hoolʼáágóó	forever
baa hoosnah	forget
baa hoonééh	forget
hwaaníʼdeetʼaah	forgive
bahayoosnah	forgot
bilaʼ dį́įʼii	fork
naaltsoos hadilnéhígíí	form
íiyisíí biniiyé hazʼánígíí	formal
íiyisíí biniiyé hooʼaah	formal
nítʼę́ę́ʼ	former
baa ił hózhǫ́ǫgo	fortunately
tʼáá haʼátʼííshį́į́ naalyéhí hweehólǫ́ǫgo	fortune
ajitʼį́h	fortune
dízdiin	forty
dízdiin dóó biʼąą naaki	forty-two
náás	forward
náasjįʼ	forward
baaʼáhayą́	foster
ahijooghą́ą́ʼ	fought
chóoztʼeʼ	found
bikʼíʼneetą́ą́ʼ	found
bee akékʼah hashchíín	foundation
dį́į́ʼ	four
dį́į́ʼtsʼáadah	fourteen
maʼiiłtsooí	fox
ditʼóódí	fragile
diltǫʼ	fragile
bibąąh názáhí	frame
hooghan bánidaazʼáhígíí binaʼanish	framework
yoochʼííd nahaadeełgo iʼdeesdloʼ	fraud
tʼóó diigis	freak
tʼáá jiikʼeh	free
tʼáá hó jinizingóó naʼadáh	freedom
yistin	freeze
tʼáá ałhxą́ą́h áhooníił	frequency
tʼáá ałhxą́ą́h	frequent
tʼáá ałhxą́ą́h	frequently
aniidí	fresh
Nidaʼiiníísh	friday
biiʼatiní	fridge
akʼis	friend
haʼáhwiinítʼį́į́ʼ	friendly
diné bił ałhééhojilzinígíí	friends
diné bił ałhééhojilzin	friendship
níjisdzííd	frightened
náhadzid	frightening
chʼał	frog
áádę́ę́ʼ	from
bilą́ąjįʼ	front
bitéél	front
yistin	frozen
chʼiyáán naniseʼ	fruit
ádahozhdeelá	frustrated
atooʼ	fuel
chidí bitooʼ	fuel
Senegambian Dineʼé Bizaad	Fulfulde
haʼdeezbin	full
bóhoneedlį́h	fun
bikʼehgo naʼanishí	function
bee akékʼeh áhooyaaígíí	fundamental
atsʼíís yóóʼalnééh	funeral
baa dloh hasin	funny
aghaaʼ	fur
háhachxįʼ	furious
honeʼí silnilí	furniture
hooghan góneʼ bee hahodítʼéhígíí	furniture
tʼáá náasdi	further
náábiláahjįʼ	furthermore
náás hoolzhishgóó	future
biniideeʼ	gain
daaneʼé	game
deeshgiizh	gap
chidí yah análbąs góneʼ	garage
tsxiilzéí	garbage
daʼakʼeh	garden
naniseʼ	garlic
daniʼditíhį́	gate
ałhxaʼádzaa	gather
ałhxąʼájiléehgo	gathering
bee íʼneelʼąąhgo yaa halneʼígíí	gauge
baazhníʼąh	gave
bee iʼiilkeedí	gear
diné doodago asdzání idlínígíí	gender
tʼóó átʼéhígíí	general
ákótʼéego	generally
hadilnééh	generate
alnééh	generate
anooséłígíí	generation
haʼáhwiinítʼį́	generous
ayóo hwił ééhozingo	genius
haneʼ ałʼąą ádaatʼéhígíí	genre
hazhóʼó	gentle
yizhǫǫh	gentle
tʼáá aniinígíí átʼé	genuine
alá bee nizhdilniihgo	gesture
nídiishaah	get
nidiiʼaah	get
nídoohaah	get
ééʼ biih niʼnééh	get dressed
nídiidááh	get up
tʼáadoo hodinaʼí hashtʼeʼ nináʼdoodááł	get well soon
nídiilyéego	getting
chʼį́įdii	ghost
doo hweenítʼį́į da	ghosting
yeʼiitsoh	giant
haaʼilyé	gift
niniseʼ	ginger
chʼikʼę́ę́h	girl
atʼééd	girl
eʼetʼééd	girlfriend
aajiléh	give
aayítʼaah	give
bizhníłniiʼ	give up
baa yitʼą́h	given
baa ił hózhǫ́	glad
bikʼíʼdeesgal	glance
tózis	glass
tózis	glasses
nákʼee sinilí	glasses
bikʼizh deezghalgo	glimpse
nahasdzáán	global
doo ił hózhǫ́ǫ da	gloomy
lágish	gloves
diltłiʼ	glow
diiltłah	glow up
bee ídaʼdiiljeehí	glue
yiwohjįʼ	go
tįʼ	go
yiwohjįʼ	go ahead
niwohjįʼ	go away
iłwosh	go to bed
ałą́ąjįʼ bee ádánihozhníʼánígíí	goal
bikáh ahátʼínígíí	goals
tłʼízí	goat
diyin	god
diyin nikʼijidlíi dooleeł	god bless you
áánííł	goes
déyá	going
deeskai	going
deeyá	going
ákǫ́ǫ́h deyá	going to
óola	gold
ádin silį́į́ʼ	gone
alnééh	gonna
dijééʼ	goo
yaʼátʼééh	good
nizhoní	good
yaʼátʼééh	good afternoon
hágoóneeʼ	good bye
nizhónígo neeʼooʼááł dooleeł	good day
yaʼátʼééh	good evening
nizhónígo íinilaa	good job
nizhóní nahalin	good looking
nikʼih hojidlíi leʼ	good luck
yaʼátʼééh abiní	good morning
yaʼátʼééh	good morning
yaʼátʼééh, shichʼooníh	good morning my love
nizhónígo íłhwosh	good night
hagoóneeʼ	goodbye
nizhónígo íłwosh	goodnight
íłwosh	goodnight
tʼáá haʼátʼííshį́į́ naadeełii	goods
béésh łichíiʼii nitsékeesí biyiʼ bił hahodítʼéhígíí	Google
Google Saad Bee Háádilʼínígíí	Google Translate
naaleełí	goose
nizhóní	gorgeous
saad chxǫ́ʼí	gossip
nizhdiiláago	got
bíighah	got it
naatʼáanii bił hazʼą́ągi	government
yizhjih	grab
anéeltʼeʼ wóltaʼígíí	grade
tʼáá hazhóóʼígo	gradually
niʼiltááh	graduate
tłʼoh	grain
béeso achʼįʼ kólyaaígíí	grant
béeso bee aahojoosbaʼígíí	grant
bee hahojoosbaʼ	granted
chʼil naʼatłʼoʼii	grapes
jizhshih	grasp
chʼil	grass
baaʼahxééhwiinidzin	grateful
ahxééhwiinidzin	gratitude
łeʼhwiiníiłgi	grave
łibá	gray
Nizhóní	great
yaʼátʼééh	great
doo hwił hadlee da	greed
doo ił hadleeʼ da	greedy
tátłʼidgo dootłʼizh	green
chʼilgo dootłʼizh	green
kʼézhnídzin	greet
kʼéhwiinidzin	greeting
kʼáhwiinidzin	greetings
łibá	grey
ałnádaʼasdzoh	grid
chʼéénáh	grief
yikʼáh	grind
jizhjih	grip
jótąʼ	grip
chʼiyáán	grocery
chʼiyáán nahaniihígíí	grocery
hastiin iiyehígíí	groom
baaʼih	gross
neʼgóó	ground
dah naazhjaaʼígíí	group
anoosééł	grow
anoosééł	growth
naʼachxǫʼ	grumpy
Paraguay Dineʼé Bizaad	Guarani
tʼáá aníí dooleełgo tʼáá anii	guarantee
haʼasídí	guard
shąʼshin	guess
diné hweegháhígíí	guest
bikʼeh adéestʼį́į́ʼ	guidance
bikʼeh áhodooníłígíí	guide
doo hazhóʼó haneʼ da	guilty
hastiin	guy
ashkii	guy
diné	guys
jooł bee nidaʼanéé góneʼ	gym
ájootʼįįįłígíí	habit
ájítʼínígíí	habit
kééhojitʼínígi	habitat
ídzaa - undergo	had
nichííł bił níiyol	hail
nilǫ́h	hail
tsiighá	hair
ałnííʼ	half
hahodiiláh	hall
alá	hand
ádoolníłígíí	handle
nizhóní	handsome
dah naalchʼąął	hang
taʼdidááh	hang out
ádzaa	happen
áhoodzaa	happened
ił hózhǫ́	happiness
hóxhǫ́	happy
Niʼdizhchínę́ęjįʼ anínáhoolzhiizhígíí baaʼáhxééhwiinidzin	happy birthday
baa hózhǫ́ǫgo niʼdizhchínéejįʼ anínááhoolzhiizh	happy birthday to you
baa hózhǫ́ǫgo nááhai	happy new year
nanitłʼah	hard
nitłʼiz	hard
doo tʼáá ałhxą́ą́h da	hardly
doo tʼáá ałhxą́ą́h da	hardly ever
atíʼjilééh	harm
bááhadzidii	harmful
hózhǫ́	harmony
tʼáá naʼnileʼdii	harsh
daʼneestʼą́h	harvest
bee hólǫ́	has
áhodoonih	hate
hólǫ́	have
nizhónígo neeʼooʼááł  dooleeł	have a good day
nizhónígo neeʼadooʼááł	have a good day
nizhónígo neeʼaʼdooʼááł	have a nice day
abínígo yidánígíí łaʼ niyą́	have breakfast
niłhoneenih	have fun
daʼ ííníyą́ą́	have you eaten
hwee hólǫ́	having
bááhadzid	hazard
áhí	haze
bí	he
bí éí	he has
bí éí	he is
atsiitsʼiin	head
atsiitsʼiin neezgai	headache
atsiitsʼiin diniih	headache
nádziih	heal
nádziihgo	healing
atsʼíístah ahootʼéhígíí	health
atsʼíístah yáʼáhootʼééh	healthy
azhdiitsʼaʼ	hear
azhdiiztʼą́ą́ʼ	heard
ajéí	heart
honeezgai	heat
deesdoi	heat
yáʼąąsh	heaven
nidaaz	heavy
tʼáá naʼnileʼdii	hectic
dego anilnééz	height
diné háíshį́į́ kéyah baa daatʼaahígíí	heir
anitʼį́į́ʼ	heist
iiltsood	held
wótąʼ	held
chʼį́įdiitah	hell
yaʼátʼééh	Hello
yaʼátʼééh, awééʼ	hello dear
yaʼátʼééh, haash nítʼé	hello how are you
yaʼátʼééh, haanítʼé	hello how are you doing
chʼah	helmet
ákaʼeʼeyeed	help
ákaʼanálwoʼ	helpful
akotéego	hence
bí	her
naakai	herd
kǫ́ǫ́h	here
óʼoolʼįįł	heritage
bichʼįʼ neʼjilį́	hesitate
Shooh	Hey
Yaʼátʼééh	Hi
yaʼátʼééh, haash nítʼé	hi how are you
yaʼátʼééh	Hi there
nanilin	hidden
nanilʼin	hide
nanitʼin	hide
atisgo nitsáhákees	hierarchy
ádíhólnííh	hierarchy
hódah	high
yitʼínígíí	highlight
nahgóó nijigháh	hike
nahgóó taʼdidááh	hiking
yéego baa dloh hasingo	hilarious
dah yiskʼid	hill
bí	him
tʼóó kʼasdą́ą́ʼ baa chʼíhootʼánígíí	hint
awoozhnííʼ	hip
atłʼaakááʼ	hips
ahoʼdooltʼeʼ	hire
naanish biniiyé ahoʼdiltʼeʼ	hiring
bí	his
nátʼą́ą́ʼ náháneʼ	history
nidooltsʼin	hit
hmmm	Hmm
bízhneedlį́įgo ájiłʼínígíí	hobby
wotąʼ	hold
ałtsé shooh	hold on
ahoodzą́h	hole
tʼáá haʼátʼííshį́į́ binahjįʼ bił nídahootʼaahígíí	holiday
biiʼhooltsʼaaʼ	hollow
hooghan	home
hooghandi naanish alʼínígíí	homework
tʼáá aníí haneʼ	honest
tʼáá anii áhaʼníigo	honestly
niłtsá bitłʼizh	Honey
bee bééhoʼdilzin	honor
baa haʼniih	honor
chʼah naatsʼǫǫdí	hood
bee náʼiilzhahí	hook
nikíhizhdighą́ą́h	hop
siih hodinidzin	hope
hajoobaʼ áhwiinidzin	hopefully
doo hasxihjįʼ da	hopeless
neʼgóó naaniigo	horizontal
adeeʼ	horn
baaʼih	horrible
yéego bááhadzid	horror
łį́į́ʼ	horse
azeeʼ ílʼį́ hotsaa	hospital
aaʼáhayą́	hospitality
diné hasʼánígíí	host
tʼáá atíʼdoolíiłgo naagháh	hostile
deesdoi	hot
sidoh	hot
tséskʼeh báhooghan	hotel
ałhééʼilkid	hour
ałhxééʼiilkeed	hours
kin	house
hooghan hazʼą́ągi	household
Haash yitʼéego	how
Haitʼéego	how
nishąʼ	how about you
haash yindzaa	how are you
haash nítʼé	how are you
Nitah haash hootʼé	how are you doing
Haash nítʼé	how are you doing
díí jį́h haash nítʼé	how are you doing today
díí jį́h haanítʼé	how are you doing today
díí jį́h haash nítʼé	how are you today
haʼátʼíish baa nininá	how do you do
haitʼéego	how is
dikwííh	how many
dikwííh bą́ą́h alį́	how much
haanéeltʼeʼ	how much
hahgo shąʼ	how often
dikwíish ninááhai	how old are you
dikwíí ninááhai	how old are you
díí jį́h haitʼéego nee iʼííʼą́h	how was your day
haitʼéego niiską́h	how was your night
akotʼée nidi	however
chidí bikeeʼ yee náálwołígíí	hub
achʼooníh	hubby
adiʼiiltsood	hug
nitsxaaz	huge
bilaʼashdlaʼii	human
hozhdisin	humble
deesdoi	humid
deesdoi	humidity
neeznádiin	hundred
dichin hasin	hungry
naʼalzheeh	hunt
níyoltsoh	hurricane
tsxį́įłgo	hurry
tsxį́įłgo	hurry up
neezgai	hurt
ahastiin	husband
tsxį́įłgo	hustle
shashoh	hut
tʼáá hó jizínígi ádaaʼáhayą́	hygiene
shí	I
shí éí	I am
shitah yáʼáhootʼééh	I am fine
doo aníshtʼéhí da	I am fine
shí éí	I can
shí éí	I can't
shí éí	I do
doo shił bééhozin da	I do not know
doo bikʼiʼdiishtįįh da	I do not understand
shí éí nida	I don't
doo shił bééhozin da	I don't know
doo bikʼiʼdiishtįįh da	I don't understand
tʼáá bidinánígíí doo bikʼiʼdiishtįįh da	I don't understand what you mean
doo nikʼiʼdiishtįįh da	I don't understand you
doo shił bééhozin da	I don’t know
doo bikʼiʼdiishtįįh da	I don’t understand
shí íiniizį́į́	i guess
shí éí	I had
shí éí	I have
shí éí	I have been
tʼáá shǫǫd yę́ę	I hope so
shił bééhozin	I know
shił nizhóní	I like
shił yáʼátʼééh	I like
shił yáʼánitʼééh	I like you
ayóóʼíínishníh	I love
ayóo shił yáʼátʼééh	I love
shinaaí ayóóʼíínishníh	I love my big brother
shádí ayóóʼíínishníh	I love my big sister
shizheʼé ayóóʼíínishníh	I love my father
shitsilí ayóóʼíínishníh	I love my little brother
shideezhí ayóóʼíínishníh	I love my little sister
shimá ayóóʼíínishníh	I love my mother
nizhónígo yáʼátʼéehgo naanitséskees	I love you
Ayóóʼaníínishníh	I love you
yéego ayóóʼíínishní	I love you so much
shí ałdóʼ ayóóʼaníínishníh	I love you too
shí tʼáá dishnígíí éí	I mean
náhásááh	I miss you
ayóo náhásááh	I miss you so much
yishį́h	I see
baa nitséskeesígíí	I think
bikʼiʼdiishtiih	I understand
nisin	I want
niideestsééł nisin	I want to see you
nininzin	I want you
shí éí	I was
shí éí	I will
shí éí	I would be
shí éí	I'm
shitah yáʼáhootʼééh	I'm fine
yaʼanishtʼééh	I'm good
shí kǫ́ǫ́h	I'm here
bee shá náhoołʼaah	I'm sorry
tin	ice
abeʼ yistiní	ice cream
tʼáá haʼátʼííshį́į́ baa nitsáhaskézígíí	idea
yéego nizhóní	ideal
bohónéedzą́h	ideal
tʼáá ałhxeeltʼé	identical
ééhoozį́į́h	identify
bee ééhozinígíí	identity
diigis	idiot
tʼáá bí yilwoł	idle
nidi	if
doo ádízhdeeltiʼ da	ignore
tsʼíís niidóóh	ill
atah hodiniih	ill
doo bee hazʼą́ą da	illegal
atah honiigááh	illness
Malayo-Polynesian Dineʼé Bizaad	Ilocano
naʼashchʼąąʼígíí	image
baa nitsáhákees	imagine
tsxį́įłgo	immediate
tʼáá áko tsxį́įłgo	immediately
nitsxaaz	immense
bideetʼiʼ	impact
ádahozhdeeláago	impatient
bee adoonishígíí	implement
tʼáá haʼátʼííshį́į́ yah iigeeh	import
yéego bóholnííh	important
tʼáadoo nidziní nidi hachʼįʼ biʼilniiʼgo	impose
doo bíighah da	impossible
hwił nizhónígo	impress
bee ííshjání ázhdiilyaaígíí	impression
bee ííshjání azhdilnééh	impression
yéego nizhóní	impressive
nizhónígo bee náás jideeyáago	improve
nizhónígo éʼélnééh	improvement
góne	in
bínáánáaʼnilgo	in addition
jó díigi átʼé	In fact
bidáahgi	in front of
bee ajilééh	in order to
doo yáʼátʼéeh da	inappropriate
tʼáá haʼátʼííshį́į́ azhdoolíiłgo binahjįʼ haʼdoodiłígíí	incentive
haashį́į́ hoodzaaígíí	incident
booltąʼ	include
bóóltąʼ	including
naanish bitsʼą́ą́dóó béeso ajiłʼínígíí	income
doo tʼáá ałtsohjįʼ bíighah da	inconvenience
łąʼí silį́į́ʼ	increase
dego kódzaa	increased
doo lá dóʼ nizhóní da	incredible
tʼáá aníí	indeed
tʼáá sáhí atʼį́	independent
India Kéyah Bił Hahoodzooígíí	India
bee ííshjání alyaaígíí	indicate
bitsįʼ yishtłizhii	indigenous
łaʼ jizį́h	individual
tʼáá haʼátʼííshį́į́ álʼį́įgo bił hazʼánígíí	industry
bitsʼąą áhatʼį́į nidi tʼáá ahotʼįįhígíí	inevitable
awééʼ	infant
łóód silį́į́ʼ	infection
tʼáá niléígóó náás hoolzhish	infinity
doo ninítʼiʼ da	infinity
atsʼíískááʼgóó neezgaigo nidanichaad	inflammation
tʼáadooleʼé ayóo daʼilį́ daaleehgo	inflation
ajitʼéhígíí	influence
bee ił haneʼ	inform
bee baa haneʼí	information
chʼiyáán bił alnéhígíí	ingredients
bił tʼáá haʼátʼííshį́į́ alnéhígíí	ingredients
hachʼįʼ biʼilniiʼígíí	inheritance
hólónígíí	initial
habiilyeedígíí	initiative
jideeznih	injured
deeznih	injured
jideeznih	injury
doo bohodiitʼiʼ da	innocent
ałkééʼ nináʼiʼnííł	innovation
bee baa haneʼí binaʼídikid	inquiry
doo yáʼátʼééhgóó nitsékees	insane
chʼosh	insect
doo adéíjódlíígóó	insecure
bikátʼah iitʼaah	insert
biih yitʼaah	insert
honeʼí	inside
jinéłʼį́įgo baa nitsáhákees	insight
ajinínígíí	insist
chʼééh ajiiłhxáásh	insomnia
hwee haʼahoníh	inspiration
saad yáʼátʼéhígíí bee yátiʼ	inspire
tʼáá haʼátʼííshį́į́ biih yiʼnííł	install
tʼáá hooshchʼįʼ ádzaa	instance
tsxį́įłgo	instant
nidago	instead
díigo shąʼ	instead of
bikʼeh ádahodooníłígíí	instructions
dilníh	instrument
saad bikʼeʼashchʼíʼígíí bee diné bichʼįʼ yátiʼ	insult
béeso áchʼą́ą́h naaʼnil	insurance
yótąʼ	intact
béshjééʼ	intact
bee jizínígíí	integrity
tʼáá ałtsohjįʼ baaʼákozhnízingo	intellectual
hwił ééhozin	intelligence
tʼáadoo hodinaʼí akʼiʼdiitįįh	intelligent
tʼáá ákonéehgo	intend
tʼáá ákóhwiinidzingo	intend
tʼáá akonéehgo	intended
niłdzil	intense
hwiinidzin	intention
ałhxił naʼaldeeh	interact
ałnádaʼooztiin	interaction
bóhoneedlį́	interest
bízhneesdliid	interested
bóhoneedlį́h	interesting
ataʼ ajiiyáago	interfere
bitaʼgi hazʼánígíí	intermediate
bitaʼgi átʼéhígíí	intermediate
biyiʼdę́ę́ʼ	internal
tʼáá náhwiizʼą́ nítʼę́ę́ʼ	international
naanish bee óhooʼaah	internship
ataʼ haneʼ	interpret
ataʼ halneʼí	interpreter
dineeskai	interrupt
naanish biniiyé nahódikidígíí	interview
yáʼátʼéehgo ałhxaah nitsáhákees	intimate
biyijįʼ	into
adééhoolzįįh	introduce
adééhojoołzįįh	introduction
yázhnizin	introvert
tʼáadoo hodinaʼí akʼizhdiitįįh	intuition
doo ílį́į da	invalid
tʼáá haʼátʼííshį́į́ ájiilaago	invent
tʼáá haʼátʼííshį́į́ hazhdiilaago	invent
tʼáadooleʼé hólónígíí nááhedzóóh	inventory
béeso ádoolnííł biniiyé tʼáá haʼátʼííshį́į́ nahaniih	invest
naʼalkaah	investigate
nihaadíínááł haʼnígíí	invitation
hagoh boʼdiʼniihgo	invite
bikʼehgo achʼįʼ naʼilyéhígíí	invoice
atah jilį́h	involve
bee atah jilį́	involved
béésh	iron
éí	is
tó siyínígíí ałníiʼgi kéyah dah sikánígíí	island
tʼáá sahdii sidá	isolated
ináhootʼiʼ	issue
bee anídahaztʼiʼígíí	issues
bi	it
tʼáá eii	it is
nítʼę́ę́ʼ	it was
eii	it's
tʼáá bíighah	it's ok
tʼáá bíighah	It's okay
tʼáadooleʼé	item
tʼáadooleʼé	items
bí	its
shí	I’m
ééʼtsoh	jacket
awáaliya	jail
Yas Niłtʼees	January
tózis	jar
ayaatsʼiin	jaw
oochxį́į́d	jealous
diigis	jerk
yooʼ	jewelry
naanish	job
joowoł	jogging
bee atah jighááh	join
ałhadaditʼánígíí	joint
haneʼ baa dloh hasinígíí	joke
naaltsoos haneʼ yee heidiłíní	journalist
jooghálígíí	journey
ił hózhǫ́	joy
aanitsáhákees	judge
ánihwiiʼaahi	judge
chʼil bitooʼ	juice
Yaʼiishjááshtsoh	july
dah neeshjį́į́d	jump
Yaʼiishjááshchilí	june
bíighahí	junk
tʼóó	just
tʼóó anilééh	just do it
tʼáá haʼátʼííshį́į́ há baa nitsáhákeesgo	justice
bééhoozį́į́h	justify
Greenland Dineʼé Bizaad	Kalaallisut
íiyisíí átʼéego	keen
tʼáá niniʼáh	keep
nááná dooleeł	keep it up
hwííʼ silį́įʼ	kept
jaaʼí	kettle
bee ąąníditínį́	key
jiztał	kick
nooséłí	kid
dloh hodichííd	kidding
achą́ʼashkʼazhí	kidney
áłchíní	kids
silyé	kill
haʼáhwiinítʼį́	kind
ákotʼééshį́į́	kinda
haʼahwiinítʼį́į́ʼ	kindly
haʼahwiinítʼį́	kindness
naatʼáanii	king
ajiztsʼǫs	kiss
aditsʼǫs	kiss
chʼiyáán alʼíní góneʼ	kitchen
naaltaʼí	kite
naaltsoos naatʼaʼí	kite
másí yázhí	kitten
agod	knee
hwi bééhozin	knew
béésh	knife
béésh ééʼ	knight
ił bééhozin	know
ił ééhozinígíí	knowledge
bééhozinii	known
Indo-European Dineʼé Bizaad	Konkani
Bilagáankʼego Saad	Krio
atʼéhígíí bikááʼ	label
yéego naʼanish	labor
yéego naʼanish	labour
tʼáá biʼoh	lack
haazéí	ladder
asdzání	lady
neʼ niilyáago	laid
tó dah siyánígíí	lake
dibé yázhí	lamb
doo bóhoneedlį́į da	lame
kǫʼ diltłiʼí	lamp
kéyah	land
kéyah hazʼą́ądi	landscape
kéyah hazʼą́ągi	landscape
saad	language
atéelgi	lap
nitsxaaz	large
akéedi	last
akéedi nidi tʼáá	last but not least
akéedi yízhí	last name
doo hah da	late
tʼáá ániidígo	lately
tʼáh nítʼę́ę́ʼ	lately
tʼáá hahgo shį́į́	later
aniidígíí	latest
ałchʼįʼ kónálnééh bichʼįʼ hoolzhish	latter
dloh	laugh
dloh hasin	laughing
dloh	laughter
dah yiiteʼ	launch
ééʼ daʼiigis	laundry
bee hazʼáanii	law
tłʼoh	lawn
aghaʼdiitʼaahii	lawyer
jiztį́	lay
ałkʼihníkaad	layer
neʼgóó niiʼniłgo	layout
ił hóyééʼ	lazy
aléą́jįʼ oodááł	lead
diné ałąąjįʼ yigáłígíí	leader
naatʼáanii	leader
atʼą́ą́ʼ	leaf
bighánilį́h	leak
naanii astíh	lean
tʼáá hódahgo dah yiiteʼ	leap
bóhooʼąąʼ	learn
óhooʼaah	learning
aʼítʼaah	lease
aʼoh	least
akał	leather
yiwohjįʼ	leave
tįʼ	leave
atʼą́ą́ʼ	leaves
ajooʼish	led
ajoolóós	led
nishtłʼahjí	left
ajáád	leg
bikʼehgo bee ééhoniihígíí	legacy
bee hazʼáanii binahjįʼ bee lą́	legal
ałkʼidą́ą́ʼ haneʼ	legend
yéego nizhóní	legit
bohónéedzą́h	legit
bee atah yáʼáhootʼéhígíí	leisure
aʼíléh	lend
aʼínil	lend
aniłnééz	length
biʼoh	less
binahjįʼ óhwiidooʼáłígíí	lesson
bíʼnidii	let
naaltsoos ilyaaí	letter
chʼił dootłʼizhí	lettuce
nidahazʼánígíí	level
tʼáá haʼátʼííshį́į́ bee wótąʼígíí	leverage
bee hazʼáanii bikʼehgo hódeetʼiʼígíí	liability
naaltsoos wóltaʼí báhooghan	library
jiłnaad	lick
ayoochʼííd	lie
yoochʼííd	lies
iiná	life
nídiitʼaah	lift
adinídíín	light
aszóólí	light
niʼdeezdínígíí	lightning
shił nizhóní	like
ákotʼéego	like
nił nizhóní	like
akotʼéego	likely
nilá ałdóʼ neʼ	likewise
ídzoh	line
Congo Dineʼé Bizaad	Lingala
béésh daʼaholzhaʼí	link
náshdóí bitsiiʼ ditłʼohígíí	lion
tó	liquid
tʼáadooleʼé nááhéesdzooígíí	list
ajíitsʼą́ą́ʼ	listen
ajíistsʼą́ą́ʼ	listening
tʼáá awołíbee	literally
naaltsoos wóltaʼígíí	literature
tsxiilzéí	litter
ałtsʼíísí	little
kééhatʼį́	live
ajéí yilzólii	liver
iiná	lives
hiiná	living
hooghan biyiʼ hazʼánígíí	living room
naʼashǫ́ʼiiłbáhí	lizard
hxééł	load
bááh	loaf
béeso aʼini	loan
tʼáá haʼátʼííshį́į́ aʼilyáago	loan
tʼáá ákweʼé hazʼánígi	local
tʼáá ákweʼé hazʼánídi	local
háadi hazʼánígíí	location
haaʼígi hazʼánígíí	location
ałdah nátʼáá bee daʼniʼdilkałígíí	lock
dádaʼdeeskaal	lockdown
tsin	log
dloh	lol
tʼáá sáhí naʼadáh	lonely
nineez	long
hádą́ą́ʼ shį́į́ tʼáá neeshʼį́į́ nítʼę́ę́ʼ	long time no see
níníłʼį́h	look
náhazbąsgo ahééhonitʼiʼ	loop
doo niłdzil da	loose
diyin	lord
yóóʼádzaa	lose
yóóʼaʼjiłdiłgo	loss
yóóʼaaltsʼid	lost
lą́ʼí	lot
ayóí íitsʼaʼ	loud
dah naʼíistání góneʼ	lounge
ayóóʼóʼóníh	love
ayóóʼáníínishníh	love you
nizhóní	lovely
hoyahgo	low
hoyahdi	lower
hoyahgo yaa kólnééh	lower
doo honaʼadloʼ da	loyal
doo yoochʼííd bił nijigháágóó	loyalty
akʼihojidlíh	luck
akʼihojidlíh	lucky
Banganda Dineʼé Bizaad	Luganda
hééł	luggage
hadzííʼáh	lump
ałníʼníʼą́ągo yistʼéí	lunch
ałníʼníʼą́ągo chʼiyáán yidánígíí	lunch
ajéí yilzólii	lungs
hózhǫ́ʼ	luxury
biyoochʼííd	lying
bee naʼanishí	machine
áhachxįʼ	mad
asdzání	madam
ályaa	made
naaltsoos wóltaʼí atseezį́h yaa halneʼí	magazine
naaltsoos wóltaʼí	magazine
tʼáá íiyisíí nizhóní	magnificent
hashtʼehósiní	maid
íiyisígíí	main
binináʼanish	maintain
binidaʼanishí	maintenance
India dóó Nepal Dineʼé Bizaad	Maithili
tʼáá íiyisíí	major
kʼasdą́ą́ʼ tʼáá átʼé	majority
anilééh	make
alnééh	make
bee áʼdilzhǫǫhí	make up
bikąʼ	male
naalyéhí bádahooghan	mall
hastiin	man
diné	man
binaʼanishígíí	manage
tʼáá haʼátʼííshį́į́ bikʼih adéestʼį́įgo binaʼanish	management
naanish yikʼih déezʼį́ʼį́	manager
tʼáá íiyidíí bee hazʼą́	mandatory
tʼáá ííshjání yitʼį́	manifest
tʼáadooleʼé jinízinígi átʼéego nijiinilgo	manipulate
haʼátʼeʼ	manner
bikʼehgo nidaʼanishí	manual
ląʼí da	many
ił hózhǫ́ bee náásgóó nááholzhish dooleeł	many many happy returns of the day
jinítʼiʼgo ałkééʼ oldah	march
bíighahjígo hazʼánígíí	margin
nidaʼiiniih bił nídahootʼaahígíí	market
agééh	marriage
asgeh	married
aniikʼééditʼáhí	mask
aniłtsooígíí	mass
nitsxaaz	massive
bilá jiiyáago	master
ałhxeełtʼéego alnééh	match
bił nijiʼaashígíí	mate
bił naʼatʼaashí	mate
naatʼą́hí	material
ałhídaʼayiidzóóh	math
ilį́	matter
hoyáanii	maturity
daatsʼí	maybe
shąʼshin	maybe
shí	me
shí ałdóʼ	me too
chʼiyáán doodíłígíí	meal
tʼáá haʼnínígíí	mean
tʼáá haʼnínígíí	meaning
tʼáá haʼnínígíí	means
tʼáá haʼnínígíí	meant
tʼáá ałhxííshghah áhoonííł	meanwhile
bíʼneelʼąąh	measure
bízhneełʼąąh	measures
atsįʼ	meat
atsʼíís nídanélʼįįh	medical
azeeʼ	medicine
ahodéesdzéelgo nitsíjikees	meditation
ałnííʼ góneʼ anitłsooígíí	medium
yaa níyáh	meet
ałah aleeh	meeting
Tibeto-Burman Dineʼé Bizaad	Meiteilon
dííłhxį́į́ʼ	melt
ééhaniih	memories
bééhaniih	memory
honitsáhákees	mental
bee haʼoodzííʼ	mention
baa haʼoodzį́į́ʼ	mentioned
naanish yá ééhozingo bił naʼanishí	mentor
tʼáadooleʼé nahaniihígíí	merchant
aahxą́ą́hwiinidzin	mercy
tʼéíyá	merely
Késhmish Baa Hózhǫ́	merry christmas
haʼoolʼáh	mess
haneʼ alyaaígíí	message
tʼóó hodichosh	messy
béésh	metal
tʼáá haashį́į́ yitʼéego alnéhígíí	method
naʼastsʼǫǫsí	mice
ałníigi	middle
ałníidi	middle
tłʼéʼííłnííʼ	midnight
daatsʼí	might
tʼáá hazhóóʼígo	mild
bitis nááʼdeesdzáh	milestone
silaołtsooí	military
abeʼ	milk
dimííltsoh	million
honitsékees	mind
nitsíjíkeesígíí	mindset
shí	mine
ałhxił naʼaldeeh	mingle
nooséłí	minor
dah alzhin	minute
dah alzhin	minutes
tʼáá haʼátʼííshį́į́ yáʼátʼéhígi áhootʼįįhgo	miracle
tsésǫʼ biyiʼ adizhnélʼínígíí	mirror
tʼáadooleʼé ałʼąą ádaatʼéhígíí	miscellaneous
hweʼadilááh	mischievous
doo hatah yáʼáhootʼéeh da	miserable
doo hwił haldingóó	misery
áhalzááh	miss
isdzih	miss
náhásááh	miss you
náhalzááh	miss you
báhalyááh	missing
naanish biká ahatʼínígíí	mission
shoh	mist
isdzih	mistake
Tibeto-Burmese Dineʼé	Mizo
naatʼáago	mobile
tʼóó aaʼoodloh	mock
tʼóó aanáhátʼįh	mock
binahjįʼ átʼéego nélʼínígíí	model
doo yéego átʼée da	moderate
kʼad hoolzhishígíí	modern
tʼáá háajįʼ shį́į́ bee hazʼánígíí	modest
ditłééʼ	moist
ditłééʼ	moisture
dláád	mold
łeʼatsoh	mole
amá	mom
haaʼíshį́į́ hoolzhishgo	moment
Damóo Biiskání	monday
béeso	money
yinaagháhígíí	monitor
mágí	monkey
nahidizídígíí	month
aʼátʼeʼ	mood
haʼátʼeʼ átʼéhígíí	moody
tłʼéhonaaʼáí	moon
binahjįʼ óhooʼaahígíí	moral
łaʼ nááná	more
łahgo anáánátʼéego	moreover
abiní	morning
hooghan bikʼéh naʼiilyéhígíí	mortgage
tʼáá átʼé	most
kʼadą́ą́ʼ tʼáá átʼé	mostly
amá	mother
nijiiʼnáago	motion
chanah jilį́	motivation
dził	mountain
naʼatsʼǫǫsí	mouse
azééʼ	mouth
nahaʼnáh	move
hidilnááh	movement
naalkidí	movie
asdzą́ą́	mrs
ayóo	much
anéeltʼeʼígíí	much
hashtłʼish	mud
bąąh haʼíizhahí	mug
adoh	muscle
tʼáadooleʼé danélʼį́h bił hazʼánídi	museum
nááʼádįįh	mushroom
dilníh	music
tʼáá íiyisíí	must
doo íitsʼaʼí da	mute
bee ałhaaʼákohwiinidzin	mutual
shi	my
sheʼawééʼ	My dear
shikʼis	my friend
shitáłkááʼ nidzitʼiiyí táłtłʼááh tłʼiizh biyiʼ haʼdeezbin	My hovercraft is full of eels
shiʼchʼooníh	my love
sheʼayóóʼóʼóníh	my love
shizhiʼ éí	my name is
íinishyéhígíí éí	my name is
shił yáʼátʼééh	my pleasure
shił bíighah	my pleasure
tʼáá shí	myself
doo bééhozin da	mysterious
doo bééhozin da	mystery
haneʼ ádaalyaaígíí	myth
bee iłdaʼalkaałí	nail
tʼáadooleʼé doo hwił bééhozin da	naive
yizhí	name
halneʼí	narrative
áhoołtsʼóózí	narrow
baaʼih	nasty
kéyah nitsaago bił hahoodzooígíí	national
kéyah bił hahoodzoh naʼadáhídę́ę́ʼ	nationality
tʼáá íiyisíí tʼáá áádóó naʼadá	native
nahasdzáán biyiʼdóó hazlį́ʼígíí	natural
tłʼóógóó bee ahootʼéhígíí	nature
tłʼóógóó bee hahodítʼéhígíí	nature
nizhdikwiih	nausea
kwiih	nausea
Naabeehó	Navajo
Diné	Navajo
ayiidí	near
tʼáá ayiidí	nearby
tʼáá ayíídígi	nearby
kʼasdą́ą́ʼ	nearly
nizhóní	neat
nidzinígíí	necessary
akʼos	neck
yooʼ	necklace
nidzin	need
haʼátʼeʼ dah doo yáʼátʼééhgóógo	negative
doo hazhóʼó baaʼáhayą́ą da	neglect
baa nikʼíyátiʼ	negotiate
hanaagóó diné bił kééhojitʼínígíí	neighbor
diné hanaagóó dabighanígíí	neighborhood
doo łaʼ da	neither
shidaʼ	nephew
shiyeʼ	nephew
shiyáázh	nephew
diné ayóo nitsékeesígíí	nerd
náhadzid	nervous
atʼoh	nest
naneesdizí	net
tʼáá ałtsohjįʼ bee oonish	network
doo ałtsázhdinidleʼgóó	neutral
tʼáhdoo da	never
doo tʼóó biʼjiłníih da	never give up
nichxǫ́ʼ shį́į́	never mind
nichǫʼ	nevermind
nidashį́į́	nevermind
azhą shį́į́ ákotʼée nidi	nevertheless
aniidí	new
haneʼ baa dahaneʼí	news
nááná ákoneʼ	next
bíighahgi	next to
bíighahdi	next to
nizhóní	nice
yaʼátʼééh	nice
yaʼátʼéehgo ałhxééhosiilzįįd	nice to meet you
shimá yázhí	niece
shicheʼé	niece
tłʼééʼ	night
nízhdiitłizh	nightmare
nízhdiilgąązh	nightmare
náhástʼéí	nine
náhástʼéítsʼáadah	nineteen
náhástʼédiin	ninety
nidigaʼ	No
dooda	No
doo bee nanitłʼaaí da	no problem
doo hazʼą́ą da	no way
dooda	no way
do háí da	nobody
hahóóʼáh	noise
hahóóʼáh	noisy
ádin	none
ałníʼniʼą́h	noon
dooda	nope
nidago	nor
tʼáá ákotée łeh	normal
náhookʼǫs	north
achį́į́h	nose
dooda dooleeł nítʼę́ę́ʼ hwiinidzingo	nostalgic
nidah	not
nidah	not at all
tʼáá yáʼátʼééh	not bad
kʼad éí nida	Not now
tʼáhdoo da	not yet
naaltsoos haneʼ bee ályaaígíí	note
haneʼ yisdzoh	noted
adin	nothing
baa ákohwiinidzin	notice
baaʼákohwiiniidzį́į́ʼ	noticed
tʼáádooleʼé naadeełii	noun
tʼáadooleʼé naadeełii dabizhiʼ	nouns
naaltsoos wóltaʼí	novel
Níłchʼihtsʼósí	november
kʼad	now
díí jį́įdi	nowadays
diné báhodoonihígíí	nuisance
doo ilį́į da	null
yitsxííʼ	numb
anéeltʼeʼígíí	number
azeeʼ neikáhí	nurse
neeshchʼííʼ	nut
chʼil binááʼ	nutmeg
chʼiyáán yáʼátʼéhígíí	nutrition
yazhdiilniiʼ	oath
ayóí áábid	obesity
bikʼeh hojilʼį́h	obey
tʼáádóoleʼé	object
bee ádáhojisʼánígíí	objective
doo áhwiinidzin da nidi bee hazʼánígíí	obligation
doo bééhozin da	obscure
haʼalzííd	observation
haalzííd	observe
adánoosnííʼ	obsessed
tʼáá íiyisíí jinízin	obsession
kʼad doo chooʼį́į da	obsolete
tʼáá haʼátʼííshį́į́ hachʼą́ą́h hólónígíí	obstacle
chóʼooztʼeʼ	obtain
nídiilyá	obtain
nízhdiilá	obtained
nídiilyá	obtained
tʼáá ííshjání átʼéhígíí	obvious
tʼáá ííshjání átʼéhígíí	obviously
łah da	occasionally
naanish	occupation
hanaanish hólǫ́ǫgo	occupied
ádzaa	occur
áhoodzaa	occur
ádzaago	occurred
adzaa	occurs
tóniteel	ocean
Ghąąjįʼ	october
haashį́į́ yitʼé	odd
dabiʼohígíí	odds
tʼáá áko	of course
asdiid	off
akʼizhdiitʼaah	offensive
bóʼoolkąąh	offer
naaltsoos binidaʼanish góneʼ	office
ilį́įgo alyaa	official
tʼáá ałhxą́ą́h	often
Ǫ́ǫ	Oh
daʼ tʼáá aníí	oh really
akʼah	oil
chidí bikʼah	oil
bíighah	ok
tʼáá áko	ok
bíighah, awééʼ	ok dear
bíighah, shichʼooníh	ok honey
tʼáá áko, shichʼooníh	ok my love
bíighah	okay
tʼáá áko	okay
bíighah, awééʼ	okay baby
tʼáá áko, awééʼ	okay dear
tʼáá áko, shichʼooníh	okay honey
tʼáá áko, shichʼooníh	okay my love
sání	old
bikáaʼgi	on
tʼááłáʼíhídi	once
tʼááłáʼí	one
tʼáá eii	one
saad tʼááłáʼígo doo bíighah da	one language is never enough
tłʼohchin	onion
béésh łichíiʼii nitsékeesí biyiʼjįʼ	online
téíyá	only
ąąʼátʼé	open
naanish biʼoonishígíí	operation
íizhnizingo bee haʼoodzíʼígíí	opinion
bee adahaztʼiʼígíí	opportunities
bił hooʼaahgo	opportunity
bikʼéhalzhishgo	opportunity
bidinínáh átʼéhígíí	opposite
hajoobaʼ íizhnizin	optimistic
łahgo átʼéego baa nááhonítʼiʼgo	option
bíighahdą́ą́ʼ	optional
doodago	or
łitsxo	orange
bikáʼéʼalnééh	order
tʼáá ákotʼéhígíí	ordinary
ałąąh nehaʼníiłgo hashtʼeelnééh	organization
ałkééʼ nehaʼníiłgo hashtʼeelnééh	organization
naanish binaʼniltin	orientation
bee hahoolzhiizhígíí	origin
ałtsé alyaaígíí	original
Ethiopia Dineʼé Bizaad	Oromo
hamá dóó hazheʼé ádingo	orphan
nááná łaʼ	other
nááná łah átʼéego	otherwise
akotéego nítʼę́ę́ʼ	ought
nihí	our
Nihinaanish íinéhígíí: dinéʼ tʼáá ałtsoh hazʼą́ą́góó díí nahasdzáán yaaʼákonízingo yikʼiʼdiitįįh dóó saad tʼáá ałʼąą ádaatʼéhígíí yee ałhxił halneʼgo ádoolnííł.	Our mission: to enable everyone, everywhere to understand the world and express themselves across languages.
Nihinaanish íilnéhígíí: nahasdzáán tʼáá náhwiizʼą́ą́ nítʼę́ę́ʼ bee baa haneʼí ałkééʼ nidooʼnił dóó tʼáá ałtsohjįʼ diné bee bichʼįʼ báʼahootʼiʼ dóó choyoołʼį́h biniiyé.	Our mission: to organize the world's information and make it universally accessible and useful.
ch'í-	out
ałtsoh ályaago	outcome
ééʼ biiʼ náʼanahígíí	outfit
ayóo báhózhǫ́	outgoing
ayóo hwáhózhǫ́ǫgo	outgoing
naalyéhí bádahooghan	outlet
bá nahasdzoh	outline
tłʼóógóó	outside
tłʼóoʼdi	outside
nizhónígo aʼjiłį́	outstanding
chʼiyáán biyiʼ yitʼeesígíí	oven
bitis	over
dząądí	over there
tʼáá átʼéénéeʼgo	overall
bilájiyá	overcome
ádił nitsáhákees	overthinking
adeʼáhoodzaa	overwhelmed
hwił yaa nináhádááh	overwhelming
adił nitsáhákees	overwhelming
tʼáá haʼátʼííshį́į́ haʼínilgo nátʼą́ą́ nináʼilyéhígíí	owe
néʼashjaaʼ	owl
bí	own
shí	own
bíhígíí	owner
béégashii ałchiní	ox
tsxį́įłgo bee hoolzhishígíí	pace
hxééł ályaa	pack
tʼáá haʼátʼííshį́į́ bił asdisgo	package
naʼilyá	paid
diniih	pain
dleesh	paint
hojidleesh	painting
naakigo	pair
yigai	pale
alátłʼááh	palm
tseeʼí	pan
nitsihodinídéélgo hooʼah	pandemic
nijildzid	panic
tłʼaajįʼééʼ	pants
naaltsoos	paper
hózhǫ́ǫgo hazʼánígíí	paradise
ałhxą́ą́h ídzoh	parallel
nanoolzheeʼ	parallel
tʼáá haʼátʼííshį́į́ naaltsoos bił yisdisgo bił éʼalnéhígíí	parcel
aaníʼdeetʼaah	pardon
amá dóó azheʼé	parents
hodootłʼizhgi	park
tsídii yáłtiʼí	parrot
chʼil	parsley
tʼáá haʼátʼííshį́į́ łahdóó átʼéhígíí	part
bee atah jilį́	participate
tʼáá haashį́į́ yitʼéé shį́į́	particular
tʼáá haashį́į́ yitʼééshį́į́	particularly
yił naaʼaashígíí	partner
yił naalnishígíí	partner
daʼadą́h	party
daʼjiyą́	party
bilááh	pass
bitis	pass
haneʼ	passage
bíighah góneʼ dahodiitʼiʼ	passed
hwił yáʼátʼééh	passion
baa ájąʼjolníh	passionate
tʼáá bíʼnidii áhooníłígíí	passive
saad bee yah ahóótʼiʼígíí	password
ałkʼidą́ą́ʼ	past
bidániʼdeetʼą	patch
atiin	path
hahojoobáʼígo	pathetic
ahwishdéeszééʼ	patience
nábidiʼnélʼįįhí	patient
ałkééʼ honiʼą́ągo bee éʼalną́hígíí	pattern
bikʼehgo áʼalʼíní	pattern
neʼ adzaa	pause
ildléézh	pavement
bikʼéh naʼilyé	pay
tʼáá haʼátʼííshį́į́ bikʼeh naʼilyá	payment
kʼé hwiinidzin	peace
hodéezyéél	peace
hodéezyéél	peaceful
didétsoh	peach
dahatsʼos	peak
chʼil łitsooí betseeʼ hólónígíí	pear
naaʼółí nimazí	peas
tʼóó haashį́į́ yitʼé	peculiar
łizh	pee
bedǫ́ǫ́s	peel
diné tʼáá ałhxąąh naniseʼígíí	peer
diné bił ałhxąąh nidazhniseʼígíí	peers
bee naʼadzooí	pen
bee akʼeʼalchíhí	pencil
tʼáhdii baa hoolzhíísh	pending
tʼáhdii bichʼįʼ oolzhish	pending
diné	people
azeeʼ díchʼííʼ łibáhí	pepper
bikʼizhdiitįįh	perceive
baa nitsíjikeesígíí	perception
nizhóní	perfect
tʼáá haʼátʼííshį́į́ ajilééh	perform
bee aʼjilééh	performance
ją́ą́shį́į́	perhaps
dah alzhin	period
tʼáá átʼéegi átʼéhígíí	permanent
bee há ląʼ adoodleełígíí wokeed	permission
naaltsoos bikʼehgo tʼáá haʼátʼííshį́į́ alnéhígíí	permit
izhą́ shį́į́ nanitłʼah nidi tʼáá ádoonííł	perseverance
bee jizínígíí bee aʼjilééh	persistent
diné	person
tʼóó hó jizínígi hodeetʼiʼígíí	personal
haʼátʼeʼ dóó ájitʼéhígíí	personality
tʼáá hó baa nitsíjikeesígíí	perspective
abijiníigo adzaa	persuade
dinéʼ tʼóó baaʼihgo nitsékeesígíí	pervert
łį́į́ʼ	pet
biyiʼ hoolzhishígíí	phase
doo ééhozingóó áhoonííł	phenomenon
haneʼ bee nidaʼnitinígíí	philosophy
béésh bee haneʼí	phone
ééʼalyaaígíí	photo
saad bee haʼoodzíiʼgo	phrase
atsʼíís bee nijigháhígíí	physical
bikʼih hodiiniiʼ	pick
nizhdiiʼaah	pick up
naʼashchʼąąʼ	picture
ééʼalyaaígíí	picture
bidooltsʼiʼgo	piece
tʼáá haʼátʼííshį́į́ ádaałtsʼíísígíí	pieces
bisóodi	pig
hisbídí	pigeon
táadooleʼé yanáaʼáh	pile
tsiiʼááł	pillow
chidí naatʼaʼí neiłtʼaʼí	pilot
iłdah nátį́hį́	pin
bilasáana diwozhí	pineapple
dinilchííʼ	pink
ahoodzą́h	pit
ajiisghan	pitch
aahojoobaʼ	pity
hazʼánídi	place
hazʼą́ądi	place
nahazʼą́ą́góó	places
naałniih	plague
doo naashchʼąąʼ da	plain
nahatʼá	plan
chidí naatʼaʼí	plane
naniseʼ	plant
chʼil	plants
asaaʼ bikááʼ adání	plate
dah náhastʼánígi	platform
naʼaʼné	play
naʼané	playing
nizhóní	pleasant
tʼáá shǫǫdí	please
hwił yáʼátʼééh	pleased
bee ił hózhǫ́	pleasure
bee ádeehazhdoodzííʼ	pledge
ląʼí dah	plenty
baa haneʼígíí	plot
baaʼiiltʼééh	plug
chʼil naʼatłʼoʼiitsoh	plum
tó bá nidaʼatsih yinaalnishí	plumber
tʼáá haʼátʼííshį́į́ ląʼígo	plural
yátiʼgo doodago sin bikʼih niiʼnííł	podcast
haneʼ yázhí	poem
haneʼ yázhí hadadilyaaígíí	poetry
dah aʼtsih	point
beʼajił	poison
silao	police
bee hazʼáanii bikʼehgo nidaʼanishígíí	policy
haʼáhwiinítʼį́	polite
tʼáá haʼátʼííshį́į́ baaʼih yileeh	pollution
tó siyį́h	pond
tó biyiʼ naʼalkǫ́ʼígíí	pool
chąąʼ	poop
tʼáá hajoobááʼí	poor
dilchosh	pop
bééhoʼdilzin	popular
diné ánéeltʼeʼígíí	population
bisóodi bitsįʼ	pork
tóshchíín	porridge
tsinaaʼeeł dah nidaaʼeełígi	port
siʼánígíí	position
niitánígíí	position
hózhǫ́	positive
hó silį́įgo	possess
tʼáá haʼátʼííshį́į́ hóhígíí	possession
hógo	possessive
tʼáá bíighah	possible
tsin iiʼáh	post
náás deestʼą́h	postpone
nimasii	potato
baaʼahodlíh	potential
dahidédloʼígíí	pound
teʼeʼį́h	poverty
adziil	power
ayóí ábóodziil	powerful
tʼáá ákotʼée łeh	practical
nabíʼnitaah	practice
aahojiniih	praise
haahaʼniih	praise
tʼóó ił naʼané	prank
tʼóó aaʼoodloh	prank
tsodizin	pray
baa hastiʼ	precious
tsʼídá tʼáá ákwii átʼéhígíí	precise
tsʼídá tʼáá ákotʼé	precisely
náasdi áhodooníłígíí baa haneʼ	predict
áájígo dooleeł	prefer
tʼáá haʼátʼííshį́į́ jinízinígíí	preference
ootsą́h	pregnant
diné jijoołá	prejudice
diné bázhdoolnih	prejudice
hazʼánígi	premises
béeso áchʼą́ą́h naaʼnil bikʼéh nahalyéhígíí	premium
hashtʼeʼ ázdólzinígíí	preparation
hashtʼeʼ ázdolzin	prepare
hashtʼeʼ ázdolzin	prepared
saad bee yátiʼgo háadi adzaaígíí baa haneʼ	preposition
ákweʼé hojilǫ́h	presence
kʼad	present
kǫ́ǫ́h	present
diné bił ííshjání eʼelnééh	presentation
baa hą́ą́h hwiinidzin	preserve
naatʼáanii aląąjįʼ dah sidáhígíí	president
yaago bizhdeelchidgo	press
níłchʼih bidziilígíí	pressure
tʼóó ahatʼį́	pretend
nizhóní	pretty
bitsʼąą áhatʼį́h	prevent
akéediígíí	previous
naaldlooshii dah biʼdoodį́łígíí	prey
bą́ą́h alʼínígíí	price
ádéíjódlíh	pride
diyin bizaad yaa halneʼí	priest
alą́ąjįʼ	primary
tsʼídá áłtsé átʼéhígíí	prime
chʼikę́ę́h nizhóní	princess
óltaʼ binaatáanii	principal
alʼą́ąjįʼ	prior
aląąjįʼ nahaaʼnilígíí	priority
awáaliyah	prison
tʼáá hó tʼéíyá hwił bééhozingo	privacy
tʼáá sahdii ajiltéhígíí	privacy
doo háída bee bił haneʼ da	private
tʼáá hótʼée yá hwil bééhozin	private
tʼáá haʼátʼííshį́į́ yéego ilį́įgo bee háʼahootʼiʼígíí	privilege
woobiihígíí	prize
shąʼshin	probably
anáhootʼiʼ	problem
bikʼehgo niʼdoonishígíí	procedure
náás hoolzhish	proceed
binaʼanish	process
ałkéé dahoniʼą́ągo binaʼanishígíí	process
naniseʼ chʼiyáán	produce
tʼáadooleʼé alyaaígíí	product
tʼáá haʼátʼííshį́į́ ałtsoh ádaayaaígíí	production
hwinaanish ájiłʼínígíí	profession
honaanish yéego bééhojisingo ájiłʼínígíí	professional
bee baa haneʼí	profile
béeso binahjįʼ ályaaígíí	profit
tʼáá íiyisíí nizhóní	profound
bohónéedzą́h	profound
náás hoolzhishígíí	progress
naanish alnéhígíí	project
yéego bóholnííh	prominent
bee ádáhwijiilʼah	promise
naanish biyiʼ náás ahoʼdooltʼeʼgo	promote
naanish biyiʼ náás ahoʼdiltʼeehígíí	promotion
binahjįʼ haneʼígíí	prompt
ayoochʼííd	prone
saad bee yátiʼgo daabíhígíí bee wójíh	pronouns
saad wóltaʼgo bee ajinínígíí	pronunciation
binahjįʼ bee ééhozinígíí	proof
tʼáá ákotʼéego bee hazʼą́	proper
shąʼshin	properly
kéyah hadahasdzooígíí	properties
daahóhígíí	property
naaltsoos bee ókeedgo hadilyaaígíí	proposal
nawolnínígíí	prospect
asah naʼadáh	prosperity
akʼihojidlíh	prosperous
baa hą́ą́h hasin	protect
hxééhwiinidzin	proud
ją́ą́shį́į́ ííshjání alnééh	prove
hólǫ́ǫgo áálzin	provide
hólǫ́ǫgo áyosin	provide
hólǫ́ǫgo alyaa	provided
kéyah bił hahoodzooígíí	province
choidooʼįįłígíí chóoztʼeʼ	provision
teʼiʼį́h	puberty
hasdlą́ągi	public
hasdlą́ądi	public
deeztsʼǫ́ǫ́d	pull
naayízíłchííʼ	pumpkin
bee nihootʼání góneʼ áadi biniiyé naʼadá	punctual
nooséłí	pupil
nahaniih	purchase
doo bąąh chxin da	pure
tsédídéehgo dootłʼizh	purple
biniiyéhígíí	purpose
biniinaaígíí	purpose
béeso bizis	purse
bizhneeshnish	pursue
jinoołchééł	pursuit
biʼdeesgil	push
dah sitįįh	put
dah silé	put
dah siʼaah	put
bee áʼadahaztʼiʼígíí	qualification
yéego atisgo átʼéhígíí	quality
anéeltʼeʼígíí	quantity
tʼáá sahdii asdáago	quarantine
ałchʼįʼ saad hojiłǫ́	quarrel
naakiyáál	quarter
South America Dineʼé	Quechua
asdzání naatʼáanii	queen
diigis	queer
naʼídikid	query
naʼídikid	question
idzoh	queue
tsxį́įłgo	quick
tʼáá tsxį́įłgo	quickly
doo íitsʼaʼí da	quiet
holchxóón	quilt
tʼóó neʼ adzaa	quit
tʼóó neʼ ajiilaa	quit
kʼasdą́ą́ʼ	quite
bee nináʼídikid	quiz
tʼáá haishį́į́ saad yee haadzíigo naasdzooígíí	quotation
haʼoodzííʼ bee ályaa	quote
saad bee hadaʼiisdzíʼígíí	quotes
gah	rabbit
ałhazhdikááh	race
ałʼąą dineʼé	race
yéego áhachxįʼ	rage
nahałtin	rain
biyaa hooʼaah	raise
dego ályaa	raise
biyaa hooʼaʼ	raised
biyaa hojiiłʼaʼ	raised
yíwod	ran
tʼáá haitʼéé shį́į́	random
haanídzahjįʼ bee hazʼą́	range
tʼóó hónishgháníjįʼ tsxį́įłgo ádzaago	rapid
tʼáá naʼnileʼdii tsxį́įlgo	rapidly
doo áłahahjįʼ da	rare
doo tʼáá ałhxą́ąh da	rarely
akááʼ niʼníkę́ę́z	rash
łeʼatsoh	rat
bą́ą́h alʼínígíí	rate
áko shį́į́	rather
haashį́į́ néeltʼeʼgo haadzooígíí	ratio
biniinaanii	rational
tʼáá łichíiʼ	raw
bíighah ájiilaa	reach
baaʼídzáh	reached
hatah áhoolaaígíí	reaction
wóltaʼ	read
naaltsoos wóltaʼ	reading
hashtʼeetʼé	ready
tʼáá anínígíí	real
tʼáá aníinii	reality
baaʼákozhniizį́į́ʼ	realize
baaʼákohwiiniidzį́į́ʼ	realized
yéego	really
bikéedi	rear
biniinaa	reason
tʼáá bíighah	reasonable
bééjiliniih	recall
naaltsoos bikʼeh niʼjiilnihígíí	receipt
nidiilyá	receive
nídiiʼnil	received
nídiilyá	received
tʼáá aniid	recent
tʼáá aniidígo	recently
daʼadą́	reception
bikʼeh chʼiyáán alʼínígíí	recipe
tʼáá naʼnileʼdii	reckless
bee hwééhoʼdoolzįįhígíí	recognition
bééhoozin	recognize
díidi shąʼ jiníigo bee hajoodzííʼ	recommend
baa haʼniihgo baa chʼóhootą́	recommended
bikʼih niiʼnííł	record
bikʼínaʼneestą́ą́ʼ	recover
hashtʼeʼ nináʼidááh	recovery
dikʼą́ągo heeneez	rectangle
łichííʼ	red
nídiiʼnííł	redeem
nídiilyé	redeem
hwaaníʼditʼaah	redemption
béé dooʼnił	reduce
nátʼą́ą́ʼ ánalyaa	reduce
tʼááłáhígi átʼéego hááhatʼééh	redundant
bichʼįʼ baa naʼnitáh	refer
binahjíʼ éédahozinígíí	reference
ninánélʼį́įgo binahjįʼ nitsáhákees	reflect
ninánéélʼį́įgo binahjįʼ baa nitsáhákeesígíí	reflection
diné tʼáá haʼátʼííshį́į́ ííléehgo neʼ ajilaago	refrain
biiʼ azkʼazí	refrigerator
biiʼ atiní	refrigerator
béesó nátʼą́ą́ʼ aanáʼníłígíí	refund
dooda hwiinidzin	refuse
doosh niizį́į da	refused
baa haneʼígíí	regard
binahjįʼ haneʼígíí	regard
baa náhátʼínígíí	regarding
izhą́shį́į́ ákotée nidi	regardless
baa yátiʼígíí	regards
baa hwiinítʼínígíí	regards
bił hahoodzooígíí	region
hadilnééh	register
doodadoo nítʼę́ę́ʼ	regret
tʼáá ákotʼéhígíí	regular
tʼáá ahooníłígi átʼéego	regularly
dooda hoʼdooʼniid	reject
hodeetʼiʼgo	relate
bideetʼiʼ	related
akʼéí	related
iiná alnééh	relationship
diné bił ałhééhojilzinígíí	relationship
hakʼéí	relative
akéí	relative
hakʼéí	relatives
hazhóʼó jizdáh	relax
biʼilniiʼ	release
biʼilniiʼ	released
bideetʼiʼígíí	relevant
baʼahódlíigo	reliable
hwiiʼhááhwiisdoh	relief
hwaahodiildoh	relieve
hwiiʼhááhwiisdzol	relieved
oodląʼ	religion
oodląʼ	religious
bichʼįʼ neʼjilį́	reluctant
baaʼahodlíh	rely
yidziih	remain
yidziihígíí	remaining
nizhóní	remarkable
azeeʼ ąąh álʼínígíí	remedy
bééhaniih	remember
bééjoolnííh	remind
bee éénihoʼdiyiilníhį́	reminder
tʼáá sahdii hazʼą́	remote
nahjįʼ kólyaa	remove
ákaʼajilyeed	render
aʼítą́ągo bikʼéh naʼiilyé	rent
hashtʼe nálnééh	repair
hashtʼéé jidlééh	repair
ánáánályaago	repeat
bitsáskʼeh anályé	replace
nátʼą́ą́ʼ hááʼoodzííʼ	reply
nátʼą́ą́ʼ náhaneʼ	reply
baa náhooneʼ	report
naaltsoos bee haʼdítʼéhígíí	report
bá jizínígíí	represent
bee jizínígíí	reputation
bee hwił áhootʼéhígíí	reputation
wókeed	request
bee hazʼą́	require
bee hazʼą́	required
nizhdinidáahgo bee ákaʼeʼeyeed	rescue
naʼalkaah	research
bináłtʼéh	resemble
doo nidzin da	resentment
bee nihootʼą́ągo	reservation
ánalzį́į́h	reserve
diné bighanígíí	resident
bitsʼá jiníyá	resign
tʼáá haʼátʼííshį́į́ bee achʼįʼ anáhatʼihgo bichʼįʼ haʼahóníh dóó bee adziilígíí	resilience
anáhootih haleego bichʼįʼ haʼahonínígíí	resilient
doo íinizin da	resist
doo áhwiinidzin da	resist
doo áhwiinidzin da	resistance
naaltsoos bee nihootʼą́ągo hadilyaaígíí	resolution
hashtʼeedzaa	resolve
daʼnijah bił hazʼą́ągi	resort
chooʼį́įgo binahjįʼ tʼáá haʼátʼííshį́į́ alnééh	resources
ił ídlį́	respect
nátʼą́ą́ʼ náháneʼ	respond
bee haneʼ ánalyaaígíí	response
bee náhooneʼígíí	response
hodeetʼiʼígíí	responsibility
hodeetʼiʼ	responsible
hááʼayį́į́	rest
hazhóʼó háánilyį́į́h	rest in peace
daʼjiyání bił hazʼánígíí	restaurant
hashtʼe nályaa	restore
baa hóchįʼ	restrict
bee ééhozinígíí	result
bikʼíʼneestą́ʼígíí	results
hanínááhalzhíísh	resume
íiyisíí bą́ą́h alʼínígíí	retail
tʼáá hweehólǫ́ǫgo	retain
béé jilniihígíí	retention
naanish woozbą́h	retired
nátʼą́ą́ʼ ádzaa	retreat
nídiilyá	retrieve
nátʼą́ą́ʼ analyaa	return
ííshjání ádzaa	reveal
ííshjání ályaa	revealed
akééʼnaʼiidá	revenge
béeso alyaaígíí	revenue
nátʼą́ą́ʼ ánályaa	reverse
ninánelʼį́h	review
ninánelʼį́h	revise
ninánéélʼį́įgo łahgo ánályaa	revision
tʼáá hooshchʼįʼ łahgo átʼįįh	revolution
bee ééhoʼdoolzįįhígíí	reward
asaaʼ diitʼaʼígíí	rhythm
íítsą́ą́ʼ	rib
alóós	rice
atʼį́	rich
biʼilnííh	rid
hwił ilwoł	ride
tʼóó nihxǫʼí	ridiculous
nishnáájí	right
tʼáá ákotʼé	right
kʼad	right now
ayóo niłdzil	rigid
yoostsah	ring
bąąh naaleeł	rinse
chʼahooshkał	riot
yizdlad	rip
neestʼą́h	ripe
dego ídzaa	rise
bee achʼįʼ anáhodootʼih nawolnígíí	risk
tʼááłáʼígíí baa ahaajiyeetʼash	rival
tooh	river
chidí beʼatiin	road
atiin	road
biiʼatʼeesí biyiʼ atʼees	roast
yéego bidziilgo	robust
tsé	rock
béésh	rod
honaanish ájiłʼínígíí	role
yimas	roll
hooghan bikáaʼgi	roof
hooghan bikáaʼdi	roof
hazʼą́h	room
chʼil bikétłʼóól	root
tłʼóół	rope
dííłdzid	rotten
dííkʼǫsh	rotten
dichʼíízh	rough
tʼáá naʼnileʼdii	roughly
nímaz	round
atiin	route
ałkééʼ dahoniʼą́ągo hoolzhishígíí	routine
ałkééʼ nitʼiʼ	row
ałkééʼ sinil	row
bizhdilnih	rub
jeeh díghází	rubber
tʼáá ádzaagóó	rubbish
doo yáʼájitʼéeh da	rude
diyogí	rug
neʼgóó sikaadígíí	rug
yichxǫʼ	ruin
bee hazʼáanii	rule
bee íʼneelʼąąhį́	ruler
bee hazʼáanii	rules
yiwoł	run
yilwoł	running
tʼáá náhwíizánídi	rural
tʼáá náhwíizánígi	rural
tsxį́įłgo	rush
azis	sack
diyin	sacred
tʼáá hó ájitʼéego	sacrifice
siʼah	safe
nizhónígo niłniʼdootʼah	safe flight
siʼah naʼadáh	safety
tsʼah	sage
dííniid	said
naatʼą́hí nibaal	sail
ooʼoł	sailing
biniiyéhígíí	sake
nináhaháago béeso alʼínígíí	salary
nahaniih	sale
łóóʼ	salmon
ashįįh	salt
ałhxeełtʼé	same
kweʼé ałdó ákotʼé	Same here
binahjįʼ átʼéhígíí	sample
łeezh	sand
Indo-European ałkʼidą́ą́ʼ saad	Sanskrit
tʼáá aaʼoodlohgo yátiʼígíí	sarcastic
tʼáá aanáhatʼį́įgo yátiʼígíí	sarcastic
hwił hózhǫ́	sassy
asdáh nítʼę́ę́ʼ	sat
hwił yáʼátʼéhígíí	satisfaction
baa hwił hóxhǫ́	satisfied
hwił yáʼátʼééh	satisfy
hwił yáʼátʼééh	satisfying
Damóo Yázhí	Saturday
achʼííʼ	sausage
doo yistiʼii	savage
ą́nasdzįįd	save
iiltsąh	saw
aní	say
bee dah áʼdiileehí	scale
inaʼadloʼ	scam
sid	scar
áádįįł	scarce
náhadzid	scared
zéédeełdoi	scarf
bááhadzid	scary
nikeelʼáago	scattered
ahootʼéhígíí	scene
nilááhgóó áhootʼéhígíí	scenery
halchiní	scent
bee nihootʼą́	schedule
óltaʼ	school
naʼalkaahgo binahjįʼ óhooʼaah	science
naʼałkaahí	scientist
nidaʼałkaahí	scientists
béésh ałhédiłí	scissors
hojishkéh	scold
hachʼįʼ hoʼdishké	scold
hazʼánígíí nélʼį́h	scope
háʼiidzohígíí	score
dabííʼohígíí	scrap
yichʼid	scratch
hazhdoolghaazh	scream
biyiʼjįʼ naʼalkidí	screen
ił adaʼagizí	screw
saad naasdzoh	script
tó niteel	sea
bidaʼdeedléézh	seal
naʼnitáh	search
ałʼąą anáhooʼníłígíí	season
bikááʼ dah asdáhí	seat
naaki góneʼ	second
tʼáá haʼátʼííshį́į́ nanilinígíí	secret
dah naazhjaaʼígíí	section
siiʼhasin	secure
aaʼáhalyání	security
aaʼáhayą́	security
nélʼį́įgo	see
jooʼį́įgo	see
neeshʼį́h	see you
hahgo shį́į́ náániideetsééł	see you later
tʼáá hahgo shį́į́ náániideestsééł	see you soon
yiską́ągo náániideestsééł	see you tomorrow
kʼeelyééh	seed
haʼnitáh	seek
haʼdéestʼííʼ	seek
nahalin	seem
nahalin	seems
néélʼį́į́ʼ	seen
yikáh deezhchid	seize
atah hoditsʼiz yileehgo	seizure
łah da	seldom
bikʼih hodiiniiʼ	select
tʼáá hó	self
tʼáá hó níjiłdziih	self healing
doo hwił hadleeʼ da	selfish
nahaniih	sell
biʼilniiʼ	send
nééʼalyaaígíí shichʼįʼ anilééh	send me your picture
ółtaʼí naakitsʼáadah yółtaʼígíí	senior
hastoí dóó sáanii náás silį́ʼígíí	senior
hatsʼíís baʼátʼeʼ	sense
hodeetʼiʼ	sensible
ahaní jizʼą́	sensitive
bił éʼalyaa	sent
saad bee haʼoodzíigo yisdzohígíí	sentence
saad bee haʼoodzííʼ naasdzogo	sentences
ałtsʼááʼnil	separate
South Africa Dineʼé Bizaad	Sepedi
Bineʼanitʼą́ą́tsoh	september
ałkééʼ honiʼą́	sequence
ałkééʼ silnilígíí	sequence
ałkééʼ dah naazhjaaʼígíí	series
ałkééʼ bee ádaʼalyaaígíí	series
tʼáá aníí áhwiinidzin	serious
tʼáá aníí ahaʼní	serious
tʼáá aníigo	seriously
bá naʼanish	serve
bee ákaʼeʼeyeed	service
bił náhootʼaahígíí	session
bee nihootʼą́	set
nijiniʼą́h	set
hahodilnééh	set up
háadi dóó hádą́ą́ʼ	setting
adił hooʼaʼ	settle
tsotsʼid	seven
tsostsʼidtsʼáadah	seventeen
tsostsʼidiin	seventy
dikwíida	several
yéego ádzaa	severe
nálkad	sew
geʼ - shh be quiet	sh
chashoh	shade
hachahaʼoh	shadow
jigháád	shake
ákoósh	shall
ałtʼą́ą́ʼí	shallow
baa yáhasin	shame
haashį́į́ yitʼéego naashchʼąąʼígíí	shape
ałhxeeltʼéego chooʼį́h	share
hááhaashchiiʼ	sharp
deení	sharp
bí	she
bí éí	she has
bí éí	she is
shashoh	shed
dibé	sheep
naaltsoos	sheet
dah azáh	shelf
yoosdísí	shell
hooghan	shelter
áchʼą́ą́h naatʼáhí	shield
hideesnááʼ	shift
disxǫs	shine
bił éʼélyaa	ship
tsinaaʼeełtsoh	ship
bił éʼélnééh	shipping
dejįʼ ééʼ	shirt
ké	shoes
adiildǫǫh	shoot
niʼjiiłniih	shop
niʼjiiłniih	shopping
tábąąh	shore
ałtsʼíísí	short
biʼoh silį́į́ʼ	shortage
adeesdǫǫh	shot
dooleeł nítʼę́ę́ʼ	should
awos	shoulder
adiwosh	shout
dilwosh	shout
ííshjání alnééh	show
shił ííshjání anilééh	show me
taʼazdigis	shower
táłtłʼááh chʼosh daadánígíí	shrimp
ałhaniníyáh	shrink
daʼdeelkaal	shut
tʼáadoo anilchxį́įdii	shut up
yáshnizin	shy
ił háájééʼ	sibling
ił háájééʼ	siblings
atah honeezgai	sick
atah hodiniih	sick
bíighahjí	side
náhizhdidziih	sigh
ajooʼínígíí	sight
nahgóó naʼagal	sightseeing
bee éédahosinígíí	sign
yizhí alyaaígíí	signature
tʼáá íiyisíí	significant
hodéezyééł	silence
doo íitsʼaí da	silence
doo íitsʼaʼí da	silent
hodéezyéél	silent
naatʼáhí	silk
adilááh	silly
béésh łigaii	silver
benáłtʼé	similar
hweʼadilááh	simp
beʼadilááh	simp
doo nanitłʼah da	simple
tʼáá ałhxąąh áhoonííł	simultaneously
íídą́ą́ʼ	since
yę́ędą́ą́ʼ	since
tʼáá anii bee íizhnizinígíí bee yájitiʼ	sincere
baa ahxééhwiinidzin	sincerely
ahxéheeʼ	sincerely
hataał	sing
hataałii	singer
tʼááłáʼí	single
biyiʼ taʼadigizí	sink
Hastiin	Sir
shádí	sister
shideezhí	sister
hwaʼayééh	sister in law
asdáh	sit
ahootʼą́hídi	site
ahootʼéhígi	site
biyiʼ ił hoolzhishígíí	situation
hastą́ą́	six
hastą́ą́tsʼáadah	sixteen
hastą́diin	sixty
aniłtsooígíí	size
honaanish ájiłʼínígíí	skill
naanish bee jilínígíí	skills
akágí	skin
ałtsʼóózí	skinny
bitis hodeeshzhiizh	skip
tłʼaakał	skirt
yá	sky
naalteʼí	slave
awosh	sleep
awosh	sleeping
bił jinízin	sleepy
agaanzis	sleeve
bidoolgizh	slice
ilzhoł	slide
tʼáá hazhóóʼígo	slightly
ałtsʼóózí	slim
deeztéél	slip
hodínéeʼą́h	slope
halgizhgo hazʼą́	slot
tʼáá hazhóóʼógo	slow
tʼáá hazhóóʼígo	slowly
ałtsʼíísí	small
ayóo hwił ééhozin	smart
ajiłchinígíí	smell
yidloh	smile
łid	smoke
dilkǫǫh	smooth
yistʼéí	snack
chʼosh	snail
naʼashǫ́ʼii	snake
tʼáá hooshchʼįʼ kʼéʼaltǫʼ	snap
zas	snow
yas	snow
ákogo	so
ayóóʼánoolnin	so cute
kʼad hoolzhishdi	so far
nástłééʼ	soak
táláwosh alá bee tánágisígíí	soap
doo bitah hoozdoh da	sober
doo adlą́ą da	sober
jooł nibéʼaleesí	soccer
diné bił naʼadáh	social
diné kééhatʼį́įgi	society
kétiil	socks
yilzhóólí	soft
dishoh	soft
béésh łichíiʼii nitsékeesí bił hadadilyaaígíí	software
łeezh	soil
nahaazniiʼ	sold
ałtsoh nahaazniiʼ	sold out
silaołtsooí	soldier
akétłʼááh	sole
nitłʼiz	solid
bee hashtʼe hodooníłígíí	solution
bee hazhóʼó ádoolníłígíí	solution
hashtʼe nályaa	solve
łaʼ	some
tʼáá háíshį́į́	somebody
haashį́į́ yitʼé	somehow
tʼáá háíshį́į́	someone
tʼáadooleʼé	something
łahda	sometimes
sin	song
hodíinaʼgo	soon
tʼáá íiyisíí bohónéedzą́	sophisticated
Iraq Dineʼé Bizaad	Sorani
nidajildoh	sore
adáyiʼ hodiniih	sore throat
doo iłhózhǫ́ǫ da	sorrow
bee shá náhoołʼaah	Sorry
ałąąh nehaʼnííł	sort
haʼdéestʼį́į́ʼ	sought
haʼnitáh	sought
hwiiʼsizíinii	soul
diné háʼátʼéhígíí	soulmate
diitsʼaʼí	sound
atooʼ	soup
dichʼííʼ	sour
tʼáá haʼátʼííshį́į́ bee ahodooníłígíí	source
shádiʼááh	south
hazʼą́ądi	space
hazʼą́ągi	space
haneʼ doo yáʼátʼéhígíí	spam
hahoozhiizh dóó niléí ałtsohjįʼ	span
Naakai	Spanish
tʼáá bilááh yidziihígíí	spare
ánásdziid	spare
yájiłtiʼ	speak
tʼáá sahdii átʼéhígíí	special
daniinánígíí	species
tʼáá sahdii átʼéhígíí	specific
hwił nizhónígo jinééłʼį́įʼ	spectacular
haneʼ bee haʼadziih	speech
chʼééh hajidziih	speechless
tsxį́įłgo yiwołígíí	speed
saad naadzoh	spell
adeeshłííł	spend
íidoolííł	spend
choozʼįįd	spent
dichííʼ	spicy
dah deeshzhah	spike
náábał	spin
waaʼ	spinach
honiłchʼih	spirit
zhééʼ	spit
nizhóní	splendid
ałtsʼááʼnil	split
dííłdzid	spoil
diikʼǫsh	spoil
dííłdzid	spoiled
dííkʼǫsh	spoiled
tʼáadoo hazhóʼó baa nitsáháskézí tʼáadooleʼé ajiłlééhgo	spontaneous
béésh adeeʼ	spoon
hazʼánígi	spot
hazʼą́ągi	spot
bił hizhdiʼnáanii	spouse
nídidzííd	spread
daan	spring
dikʼą́	square
ałchʼįʼ ajileeh	squeeze
naʼashjéʼii łóóʼ	squid
dlǫdiłgai	squirrel
atiin -  street	st
baaʼaalgeed	stab
łį́į́ʼ bighan	stable
łį́į́ʼ yiiʼ sizíní	stable
yistłʼin	stack
naalnishí	staff
ałkééʼ dah honiʼą́ągo biyiʼ hoolzhishígíí	stage
bąąh silį́į́ʼ	stain
bikááʼ háádaʼaldahígíí	stairs
tsin doodago béésh bił adaʼalkaałí	stake
atsiin	stalk
neʼadzaago	stall
bee ídaʼiiljahí	stamp
bee akʼiniʼiiʼnííł	stamp
sizį́h	stand
atʼéhígíí	standard
ádaatʼéhígíí	standard
sǫʼ	star
hahalzhíísh	start
bee hahoolzhiizh	started
dichin hwiinidzin	starving
bee haʼadziih	state
nitsaago bił hahoodzoh	state
haʼoodzííʼ	statement
bił hazʼą́ągi	station
tʼáá haʼátʼííshį́į́ tsin bee bééʼalyaago	statue
bee ił hazʼánígíí	status
tʼáá kǫ́ǫ́h	stay
ádaaʼáholyą́	stay safe
doo nahaʼnáa da	steady
béégashii bitįʼ sitʼéhígíí	steak
anitʼį́į́ʼ	steal
siil	steam
béésh	steel
niinah	steep
atsiin	stem
niʼdeeltáál	step
tsin	stick
dah nitłʼiz	stiff
tʼahdii	still
yishchʼííʼ	sting
aajíchxįʼ	stingy
bił naʼatsih	stir
béeso bąąh alʼínígíí	stock
neestʼį́į́ʼ	stolen
abid	stomach
tsé	stone
yiizįʼ	stood
bikááʼ dah asdáhí ałtsʼóózígíí	stool
neʼ adzaa	stop
tʼáadooleʼé sinilí góneʼ	storage
naalyéhí báhooghan	store
niłtsą́h	storm
haneʼ	story
bikááʼ chʼiyáán alʼíní	stove
béésh biiʼ kǫʼí	stove
kʼézdon	straight
tʼáá kʼéhasdon náasjįʼ	straightforward
bilááh áálzingo	strain
tʼóó haashį́į́ yitʼé	strange
doo adééhojilzingóó	stranger
diné doo bééhojizinígíí	stranger
haitʼéego naanish ádoolníłígíí	strategy
tó bee yidlání	straw
dahwozh	strawberry
naajin	streak
tó nilį́	stream
atiin	street
adziil	strength
hodaʼdiiłʼáhígíí	stress
naatsʼǫǫd	stretch
bee jizį́h	strict
asdzih	strike
tłʼóół ałtsʼóózígíí	string
noodǫ́ǫ́z	strip
bikáh ajitʼį́	strive
dił yiyilii atsiighaʼ yiih yigháahgo	stroke
bidziil	strong
azhdzííłtsʼin	struck
hadítʼéhígíí	structure
tʼáá haʼátʼííshį́į́ alyááígíí	structure
bee achʼįʼ nahwiiʼná	struggle
hachʼįʼ nahwiiʼnáago	struggling
doo nibíʼdidzil da	stubborn
nizhdineedzáh	stuck
ółtaʼí	student
óhooʼaah	study
naʼalkaah	study
óhooʼaah	studying
tʼáadooleʼé	stuff
bikee jideesyis	stunning
diigis	stupid
hazhdítʼéhígíí	style
baa yátiʼígíí	subject
baa hwiinítʼínígíí	subject
íizhniizįįhgo	submission
yah aaʼnil	submit
yah aaltsooz	submit
tʼáá haʼátʼííshį́į́ bee alyaaígíí	substance
tʼáá haʼátʼííshį́į́ bił alyaaígíí	substance
bitsáskʼeh iiyá	substitute
nanitłʼahgo baa honítʼiʼ	subtle
biʼąh jiyáago	succeed
naanish ályaaígíí	success
tʼáá haʼátʼííshį́į́ yáʼátʼéehgo ájooliiłígíí	successful
tʼáá haʼátʼííshį́į́ biʼązhdiigháahgo	successful
díigi ątʼéhígíí dah	such
díigi átʼé	such as
yiłtʼoʼ	suck
tʼáá hooshchʼįʼ	sudden
tʼáá hooshchʼįʼ	suddenly
tiʼhooʼnííh	suffer
achʼįʼ nahwiiʼnáh	suffering
tʼáá bíighah	sufficient
ashįįh łikan	sugar
bee haʼoodzííʼ	suggest
saad bee haʼoodzííʼ	suggestion
ééʼ	suit
beełtʼé	suitable
hxeeł biih náʼniłí	suitcase
azis hxééł biih náʼniłí	suitcase
ałhíidzoh	sum
haneʼ baa náhaneʼígíí	summary
shį́	summer
niinah bitis góʼąąh	summit
jóhonaaʼáí	sun
Damóo	sunday
adinídíín	sunny
eʼeʼaah	sunset
adinídíín	sunshine
yéego nizhóní	super
aláahdi dah sidáhígíí	superior
aláahdi átʼéhígíí	superior
diné bá nidaʼanishí	supervisor
yéego nizhóní	supper
bee áhodooníłígíí	supply
bee íighah asdzį́h	support
ákotʼéego yiʼátʼé	suppose
daatsʼíhígíí	supposed
aooʼ	sure
bikáaʼdi	surface
bikáaʼgi	surface
tʼáá naʼnileʼdii dego kódzaago	surge
atsʼíís naalgizhgo binaʼanishígíí	surgery
yizhí náás yilyą́łígíí	surname
doo hwił bééhozingóó	surprise
doo jijólíígóó ádzaa	surprised
tʼáadoo hooyání adzaa	surprised
neʼnizhníyá	surrender
anaagóó áhootʼéhígíí	surrounding
tʼáá ayídíjįʼ nélʼį́	surveillance
nidaʼídikid bee naʼalkaahígíí	survey
yisdáh jiiyá	survive
hwaaʼayohoolniiʼ	suspect
ayohoojooliiʼ	suspect
atsʼá biʼilniiʼ	suspended
atsánáltʼeʼ	suspended
tʼáá haʼátʼííshį́į́ baa nijólíh	suspicious
siiʼhasin	sustain
tʼááłáhígi átʼéego siłkidgo	sustainability
tʼááłáhígi siłkidígíí	sustainable
tʼáá haʼátʼííshį́į́ neestʼį́įgo nídiilyáhígíí	swag
ajilneeh	swallow
iiłneeh	swallow
ałnááʼooʼnil	swap
tʼáá adzaagóó tʼáá naʼnileʼdii yátiʼ	swear
tʼáá adzaagóó yátiʼ	swear
jiditłéeʼgo	sweat
tó hxąąh haatiłígíí	sweat
ééʼnaatsʼǫǫdii dintánígíí	sweater
ałhxąh nahashóóh	sweep
łikan	sweet
naʼiizeeł baa hózhónígíí baa nidiyííyił	sweet dreams
łikání tʼéíyá yidą́	sweet tooth
awééʼ	sweetheart
niichaad	swell
niichaad	swelling
naʼalkǫ́ǫ́ʼ	swim
naʼałkǫ́ǫ́ʼ	swimming
dah nalchʼąął	swing
bee nídiiltłiʼí	switch
niichaad	swollen
bééshtsoh	sword
bee íʼdiidlííd	symbol
bee ééhozinígíí	symbol
hwił haahojoobaʼgo	sympathy
bee éédahozinígíí	symptoms
ádaatʼéego bee áhootʼéhígíí	system
bikááʼ adání	table
bił ajidiłgo	tackle
naaltsoos bąąh dah siláhígíí	tag
atseeʼ	tail
nizhdiiʼaah	take
niwohjįʼ yiʼááł	take away
ádaaʼáhayą́	take care
bikʼeetʼą́h	take off
nídiilyá	taken
yátiʼ	talk
haʼdiłchʼał	talkative
nineez	tall
naniltąsh	tap
bee ałhídaʼdiiljeehí	tape
bikʼeh niitʼánígíí	target
naanish	task
ajilniihígíí	taste
jilniih	tasty
naʼneestą́ą́ʼ	taught
chʼil ahwéhí	tea
naʼnitin	teach
báʼóltaʼí	teacher
ahił dajilį́h	team
ahił dajilį́įgo	team
yizdlad	tear
nákʼeeshtoʼ	tears
dloh hwidichííd	tease
béésh łichíiʼii bee naʼanish	technology
awooʼ	teeth
baa haneʼ	tell
shił holneʼ	tell me
áhachxįʼ	temper
niłchʼih naʼałkidígíí	temperature
tʼáá haʼátʼííshį́į́ bichʼįʼ tsohodizinígíí	temple
tʼáá haʼátʼííshį́į́ biyiʼ tsohodizinígíí	temple
tʼóó hónishgháníjįʼ	temporary
neeznáá	ten
neeznáádimííl	ten thousand
diné hooghan yiiʼ bighanígíí	tenant
diné kéyah bikááʼ kééhatʼínígíí	tenant
átʼéhígi átʼéego	tend
áhootʼéego	tendency
ahoonííł	tendency
ditʼóódí	tender
dashnitłʼizgo	tense
hadoh nidaaskidígíí	tense
atah hótłʼiz	tension
tʼáá dashnitłʼiz	tension
nibaal	tent
shąʼshin dooleeł daatsʼí	tentative
bee ałghaʼdeestʼánígíí	term
bee aghaʼdeetʼánígíí	terms
baaʼih	terrible
nizhóní	terrific
kéyah	territory
bee íʼneelʼąąh	test
saad naasdzooígíí	text
ahxéheeʼ	thank
ahxéheeʼ	thank you
Bił ádaʼalyaaígíí neilkaah bibaʼ nanináhígíí baaʼahxééniidzin	Thank you for your patience while we investigate shipment
Bił ádaʼalyaaígíí neilkaah bináh nanináhígíí baaʼahxééniidzin	Thank you for your patience while we investigate shipment
nitsaago ahxéheeʼ	thank you so much
nitsaago ahxéheeʼ	thank you very much
baaʼahxééhwiinidzin	thanks
ahxéheeʼ	thanks
nihi app choiníłʼínígíí baaʼahxééhniidzin	Thanks for using our app
niléí	that
díí éí	that is
eii nizhóní	that's good
díí	the
aniʼííʼ	theft
daabí	their
bí	them
binahjįʼ nitsáhákeesígíí	theme
tʼáá bí	themselves
íídą́ą́ʼ	then
díigi áhootʼįįd shąʼshin hwiinidzinígíí	theory
díigi adzaa shąʼshin hwiinidzinígíí	theory
dząądi	there
kǫ́ǫ́h éí	there are
akǫ́ǫ́h	there is
biniinaago	therefore
díidígii	these
bi	they
bí éí	they are
ditą́	thick
aniiʼįįįhį́	thief
atłaakááʼ	thigh
ałtʼą́ą́ʼí	thin
tʼáadooleʼé	thing
tʼáadooleʼé	things
baa nitsáhákees	think
tááʼ góneʼ	third
dibááʼ hasin	thirsty
tááʼtsʼáadah	thirteen
tádiin	thirty
díí	this
díí éí	this is
tʼáá ałtsohjįʼ	thorough
yéego	thoroughly
niléí	those
ákoh	though
nitsáhaskééz	thought
ayóo nitsáhákees	thoughtful
nitsáháskééz	thoughts
dimííl	thousand
bee náʼalkadí	thread
saad bee ineeshił	threat
honeeshił	threaten
tááʼ	three
chʼéʼatiin biyaa sitánígíí	threshold
hwił hózhǫ́	thrilled
biká ajitʼį́h	thrive
azágí	throat
binikáh	through
tʼáá biyiʼ hoolzhish	throughout
eeltsʼid	throw
alátsoh	thumb
niʼdiʼníh	thunder
Damóodóó Dį́ʼí Jį́h Nidaʼanish	Thursday
Dį́ʼí Jį́h Nidaʼanish	Thursday
díígi átʼéego	thus
chʼosh	tick
tó yilkʼoł	tide
hashtʼe hólzin	tidy
beʼastłʼǫ́	tie
náshdóítsoh noodǫ́zígíí	tiger
niłdzil	tight
Ethiopia Dineʼé Bizaad	Tigrinya
oolkił	time
oolkiłí	time
doo adaijódlíi da	timid
ałyáázhí	tiny
chʼíhootʼánígíí	tip
hwił chʼíhwiitaah	tips
chidí bikeeʼ	tire
chʼééh deeyá	tired
naaltsoos bee áditʼoodí ałtʼą́ʼígíí	tissue
bee wójíhígíí	title
-dę́ę́ʼ	to
-jįʼ	to
-góó	to
atʼéego	to be
bááh yideezí	toast
díí jį́h	today
awééʼ	toddler
kézhoozh	toes
tʼáá átʼé	together
tʼáá ałhiiʼjįʼ	together
niiʼoh góneʼ bikááʼ dah naʼnidaahí	toilet
baa hóóneʼ	told
bee haʼoodzííʼ	told
tʼáá bíighah dooleeł	tolerance
bee hojisą́	tolerate
chʼil łichíʼí	tomato
yiskʼą́ągo	tomorrow
atsooʼ	tongue
díí tłʼééʼ	tonight
ałdóʼ	too
eelyá	took
bee nidaʼanishí	tool
bee nidaʼanishí	tools
awooʼ	tooth
hódahdi	top
baa yátiʼígíí	topic
baa hwiinítʼínígíí	topic
yizdlad	torn
diné tiʼbijiiłníihgo	torture
tʼáá átʼégo	total
biʼdinih	touch
yidilnih	touch
nanitłʼah	tough
nitłʼiz	tough
tʼáá haʼátʼííshį́į́ bitaaʼ adáago danélʼį́h	tour
bichʼįʼjigo	toward
bichʼįʼ	towards
beʼaditʼoodí	towel
kintah	town
bááhadzid	toxic
akékʼeh nátʼą́ą́ʼ nináʼalkaah	trace
akékʼeh naʼadzoh	trace
nijiłkaah	track
ałnááʼilyé	trade
óʼoolʼįįł	tradition
óʼoolʼįįł	traditional
chidí ałnáʼatʼį́	traffic
jáadee bee atiin	trail
kǫʼnaʼałbąąsii	train
naʼnitin	train
binaʼniltin	training
ajítʼéhígíí	trait
ajítʼéhígíí	traits
łahjigo biʼilnííh	transfer
nááná łahgo bił éʼelyaa	transition
łaʼ nááná saad bee haneʼ alʼínígíí	translate
binígháh hootʼį́	transparent
tʼáá haʼátʼííshį́į́ nááná łahgo ilnééh	transport
bee chʼaanaʼadáhí	transportation
bee ódleehí	trap
tsʼiilzéí	trash
yéego achʼįʼ anáhatʼihgo	trauma
chʼaanaʼadáh	travel
bee naʼakáhí	tray
naadeełí	treasure
tʼáadooleʼé	treat
ąąh áʼalʼį́	treatment
tʼiis	tree
gad	tree
bohónéedzánígi átʼéego alyaa	tremendous
hoolzhish bikʼeh tʼáá haʼátííshį́į́ łahgo áánííł	trend
nibíʼnitaahgo chooʼį́h	trial
inaʼadloʼ	trick
bizhneeztą́ą́ʼ	tried
habijiiswod	trigger
belzhééh	trim
chʼaanaʼadáh	trip
isdzih	trouble
nanitłʼago izdzih	trouble
tłʼaajįʼééʼ	trousers
chidí	truck
chidítsoh	truck
tʼáá anííh	true
tʼáá aníinii	true
sitsʼaaʼ	trunk
baʼahódlí	trust
tʼáá aníinii	truth
tʼáá anínígíí	truth
nabiʼnítaah	try
South Africa Dineʼé	Tsonga
bee altʼoodí	tube
Damóodóó Naaki Jį́h Nidaʼanish	Tuesday
Naaki Jį́h Nidaʼanish	Tuesday
béeso óltaʼ bikʼéh siláhígíí	tuition
tązhii	turkey
náʼoogiz	turn
chʼééhdigháhii	turtle
óhooʼaah yee ákaʼanálwoʼí	tutor
naakitsʼáadah	twelve
naadiin	twenty
naadinlaʼ	twenty-one
Ghanadi Dineʼé	Twi
naakidi	twice
ałkʼídeesdiz	twist
naaki	two
ádaatʼéhígíí	type
tʼáá haashį́į́ jitʼéego binahjįʼ bee hwééhozin	typical
baaʼih	ugly
akéedi adzaaígíí	ultimate
bee chahaʼohí	umbrella
doo bíighah da	unable
shidaʼ	uncle
shiyáázh	uncle
doo hwił ééhozin da	unconscious
biyaadi	under
biyaadi	underneath
doo ilį́įgo baa nitsáhákees da	underrated
bikʼiʼdiitįįh	understand
akʼiʼdiitįįh	understood
doo bíighah da silį́į́	unfortunately
ééʼ naanish biniiyé bee háázhdiitʼįįhígíí	uniform
tʼáá sahdii átʼé	unique
tʼááłahjįʼ átʼéego siʼą́	unit
hódahgo bidziilgo óltaʼígíí	university
doo bééhozin da	unknown
áko nidi	unless
áko índa	until
ákotʼée łeh	unusual
dego	up
tʼáá ni bee nóholnííh	up to you
háádilyaa	update
nináneelʼį́įgo bee náás anáánályaa	upgrade
baa hoolzhiizhgo	upon
naahxǫʼ	upset
kintah binaadi	urban
bee jigod	urge
tsxį́įłgo bee áhodooníłígíí	urgent
nihí	us
chooʼį́h	use
choozʼįįd	used
chooʼínígíí	useful
tʼáadoo bee chǫǫʼíní da	useless
łeh	usual
łeh	usually
tʼáá haʼátʼííshį́į́ chodaaʼínígíí	utility
chʼaanaʼadáh	vacation
azeeʼ bił aaʼadaʼatsiígíí	vaccination
azeeʼ bił aaʼadaʼatsii	vaccine
tsxiilzéí náyiiláhí	vacuum
doo hazhóʼó yitʼį́į da	vague
tʼáá anii átʼé	valid
dzigai	valley
ilį́	valuable
ilį́	value
tʼáá dikwíigo shį́į́ ałʼąą ádaatʼéego	variety
ałąąh átʼéhígíí	various
lahda ákótʼée łeh	vary
hashtłʼish ásaaʼ	vase
tʼáá kóhoniłtéelgo hazʼánígíí	vast
chʼil naniseʼ daadánígíí	vegetable
chʼil naniseʼ daadánígíí	vegetables
chidí	vehicle
baa naʼiiniihí	vendor
naʼashǫ́ʼii bizhééʼ	venom
tʼáá baa hastiʼ nidi ajilééh	venture
ałhah azlį́įgi	venue
ałhah azlį́įdi	venue
bee bééhoozįįh	verify
tʼáadooleʼé biʼnildíih	versatile
ádaatʼéhígíí	version
sizį́įgo	vertical
tʼáá íiyisíí	very
yéego nizhóní	very good
yéego yaʼátʼééh	very good
tsinaaʼeełítsoh	vessel
tsinaaʼeełí nitsxaazígíí	vessel
beego	via
hatah áhootʼéhígíí	vibe
atah áhosinígíí	vibes
doo aajistiʼ da	vicious
tiʼbiʼdilínígíí	victim
naalnidí	video
nélʼį́h	view
diné kééhatʼínígi	village
diné doo yáʼátʼéhígíí	villain
akʼah díkʼǫ́zhígíí	vinegar
ádą́ą́ʼ yihahgo wáán ályaaígíí	vintage
tʼáá tiʼjidoolíiłgo nijigháh	violence
dziil hwiinidzin	violence
tʼáá tíʼdoolníiłgo	violent
naałniih	viral
doo aadi adleehgóógo	virgin
béésh łichíiʼii biyiʼjįʼ ahxił haneʼ	virtual
hweʼoodląʼ bee jizínígíí	virtue
anááʼ bee hootʼínígíí	vision
aaʼídáh	visit
aaʼídzáh	visit
anáá bee nélʼį́	visual
tʼáá aníinii	vital
tʼáá íiyisíí yitʼį́	vivid
saad bóhooʼaahígíí	vocabulary
hwiinééʼ	voice
bikʼih iidzoh	void
tʼáá haʼátʼííshį́į́ íitsʼaʼígíí bee naagiz	volume
tʼáá ákaʼiilyeedí	volunteer
ákaʼiilyeedí	volunteer
kwiih	vomit
doo nitłahgóó haahonítʼiʼ	vulnerable
béeso naanish bitsʼą́ą́dóó alʼínígíí	wage
naanish bitsʼą́ą́dóó béeso ádaalʼínígíí	wages
awoozhnííʼ	waist
ałtsé	wait
abaʼsidáhí	waiter
abaʼjizdáh	waiting
jidéezʼį́į́ʼ	wake
chʼénádzid	wake up
jooghááł	walk
joogááł	walking
aniʼáh	wall
béeso bizis	wallet
tʼóó nahgóó nijighá	wander
jinízin	wanna
jinízin	want
nidzin	wanted
anaʼ hazlį́į́ʼ	war
bee intéhí	wardrobe
bee nidaʼanishí báhooghan	warehouse
honeezilí	warm
yilzíílí	warm
sizilí	warm
bee ił haneʼ	warn
baaʼákozhnízin biniiyé ił haneʼí	warning
naabaahii	warrior
ńtʼę́ę́ʼ	was
táájigis	wash
taʼadigis	wash
nichxǫ́ʼí	waste
nélʼį́	watch
tó	water
chʼééjiyáán	watermelon
yilkʼoł	wave
dzoołhxał	wave
hoołʼaah	way
nihi	we
nihí éí	we are
nihí éí	we can
doo niłdzil da	weak
doo bichʼįʼ haʼahónínígíí	weakness
ajitʼį	wealth
ajitʼį́h	wealthy
bee naʼadáh	wear
yee naaghá	wearing
niłchʼih ałʼąą ánaaʼníłígíí	weather
iigeh	wedding
Tágí Jį́h Nidaʼanish	Wednesday
Damóodóó Tágí Jį́h Nidaʼanish	Wednesday
chʼil deeníní	weed
damóo	week
Damóo Yázhí dóó Damóo	weekend
aniłdásígíí	weight
tʼáá haashį́į́ yitʼé	weird
yaʼátʼééh wóshdę́ę́ʼ	welcome
woshdę́ę́ʼ	welcome
bee ákaʼanídaʼawoʼí	welfare
nizhóní	Well
yaʼátʼééh	Well
nizhónígo ályaa	well done
niséyá	went
nítʼę́ę́ʼ	were
eʼeʼaah	west
ditłééʼ	wet
łóóʼtsoh	whale
haʼátʼíí	what
haʼátʼíísh	what
nishąʼ	what about you
Haʼátʼíí baa naniná	what are you doing
Haʼátʼíish baa naniná	what are you doing
kʼad haʼátʼíí baa naniná	what are you doing now
kʼad haʼátʼíish baa naniná	what are you doing now
kʼad shąʼ haʼátʼíí baa nininá	what are you doing right now
haʼátʼíish aniłį́h	what do you do
haʼátʼíish ninaanish aniłʼį́h	what do you do for a living
haʼátʼíish bee akʼinidídáh	what do you do for a living
haʼátʼíí yee tʼáá bidiníh	what do you mean
haʼátʼíish tʼáá bidiníh	what do you mean
haʼátʼíish nínínzin	what do you want
haash hoodzaah	what happened
haash hóótʼįįd	what happened
atʼéhígíí	what is
díí haʼátʼíish átʼé	what is this
haʼátʼíish ninaanish	what is your job
nizhiʼ haash yitʼé	what is your name
haash yinilyé	what is your name
haʼátʼíish	what's up
haash yinílyé	what's your name
tʼáá haʼátʼííshį́į́	whatever
dah díníisą́h	wheat
chidí bikeeʼ	wheel
akeeʼ	wheel
hahgo	when
tʼáá hahgo shį́į́	whenever
háadi	where
háadish	where
háadish naniná	where are you
Haadę́ę́ʼ nininá	where are you from
Haadę́ęsh naniná	where are you from
kʼad háadish nininá	where are you now
kʼad háadi naniná	where are you now
háadish kééhonítʼį́h	where do you live
háadish nighan	where do you live
háadi	where is
iiją́ą́shį́į́ eii	whereas
áko shį́į́	whether
háídígíí	which
-go	while
tʼáá hazhóóʼígo yátiʼ	whisper
tsisǫ́ǫ́s	whistle
łigai	white
Háísh	who
háí	who
háísh anitʼį́	who are you
háíshį́į́	who is
díí shąʼ háísh átʼį́h	who is this
tʼáá nítéénéeʼgo	whole
tʼáá siʼą́ą́ nítʼę́ę́ʼ	whole
háíshį́į́	whom
háísh	whose
haʼátʼíish biniinaa	why
haʼátʼíish biniiyé	why
haʼátʼíísh biniinaa dooda	why not
hweʼiiníziin	wicked
niteel	wide
bił hizhdiʼnáanii ádin yileehgo	widow
aniłtélígíí	width
eʼasdzáá	wife
doo yizhǫǫh da	wild
dooleeł	will
áhwiinidzinígíí	willing
oozbą́h	win
níyol	wind
tsésǫʼ	window
níyol	windy
wáán	wine
tó diłhxił siʼnaaʼiiłáhí	wine
hai	winter
yitʼood	wipe
bééshtsʼósí	wire
hwił ééhosinígíí	wisdom
yéego ił ééhozin	wise
laanaa	wish
nikʼih hojidlį́į dooleeł	wish you all the best
diné beʼiiníziin	witch
bił	with
nátʼą́ą́ʼ adzaa	withdraw
bitsʼádzoh	withdrawal
bitsʼáʼniłgo	withdrawal
biyiʼdę́ę́ʼ	within
tʼáágééd	without
bíínáłígíí	witness
maʼazhdilį́h	witty
maʼiitsoh	wolf
asdzání	woman
asdzání	women
oozbą́h	won
dooda	won't
taʼdidááh	wonder
nizhóní	wonderful
chizh	wood
tsintah	wood
dibé bighaaʼ	wool
saad	word
saad wóltaʼí	words
naanish	work
átah hodilzéí	work out
naʼádiltsʼǫǫd	work out
nidaʼanish	working
tʼáá náhwiizáán nítʼę́ę́ʼ	world
nahasdzáán	world
chʼosh	worm
tʼáá yéego neezhaazh	worn
baa haneʼ	worried
baa hóneʼ	worry
yéego doo áhodzaa da	worse
bichʼįʼ tsohodizin	worship
yéego doo ákodzaa da	worst
ilį́	worth
bíighah	worth it
ilį́	worthy
dooleeł	would
łóód	wound
sxih	Wow
bikʼíʼdeesdiz	wrap
yéego háháchxįʼgo	wrath
alátsíín	wrist
naʼadzoh	write
kweʼé	Write here
saad naadzoh	writing
naasdzoh	written
doo ákotée da	wrong
naasdzoh	wrote
hooghan bineʼdę́ę́ʼ hazʼánígíí	yard
tááʼ adéeseezgo	yard
nízhdiichʼah	yawn
bíighah	Yeah
tʼáá áko	Yeah
yihahígíí	year
nináhahááh	years
dah díníisą́h	yeast
jidilwosh	yell
łitso	yellow
Aooʼ	Yes
aooʼ, awééʼ	yes baby
aooʼ, awééʼ	yes dear
aooʼ, shichʼooníh	yes honey
aooʼ shichʼooníh	yes my love
aooʼ, tʼáá áko	yes of course
adą́ą́dą́ą́ʼ	yesterday
tʼahdii	yet
tʼóó biyó neʼ adzaa	yield
ni	you
ni éí	you are
ayóóʼáníínilnin	you are beautiful
nízhóní	you are beautiful
yéego nízhónį	you are so beautiful
ni ałdóʼ wóshdę́ę́ʼ	you are welcome
ni ałdóʼ yáʼátʼééh	you are welcome
ni éí	you can
nił bééhozin	You know
ni ałdóʼ	you too
ni ałdóʼ ahxéheeʼ	you're welcome
anii naagháh	young
ni	your
ni ałdóʼ yaʼátʼééh	your welcome
tʼáá hó	yourself
nooséłí	youth
ni ałdóʼ yáʼátééh	you’re welcome
łikan	yummy
ádin	zero
