un	a
un pauc	a little
fòrça	a lot
fòrça	a lot of
abandona	abandon
abandonar	abandon
abandonèt	abandoned
abandonat	abandoned
suportar	abide
capacitat	ability
competent	able
capable	able
aperaquí	about
a prepaus	about
al dessús de	above
a l'exterior	abroad
a l'estrangièr	abroad
abséncia	absence
absent	absent
s'absentar	absent
absoludament	absolutely
absorbir	absorb
resumit	abstract
abstrach	abstract
absurd	absurd
abondància	abundance
abondós	abundant
maltractar	abuse
injuriar	abuse
abusar	abuse
accent	accent
accentuar	accent
acceptar	accept
accedir	access
accès	access
accident	accident
albergament	accommodation
realizar	accomplish
acomplir	accomplish
complit	accomplished
segon	according
compte-rendut	account
representar	account
compte	account
precision	accuracy
precís	accurate
acusèt	accused
acusat	accused
dolor	ache
far mal	ache
acomplir	achieve
aténher	achieve
reüssida	achievement
realizacion	achievement
reconéisser	acknowledge
coneissença	acquaintance
aquesir	acquire
aquesit	acquired
aquesiguèt	acquired
aquisicion	acquisition
a travèrs de	across
agir	act
acte	act
combat	action
mecanisme	action
accion	action
actiu	active
activitats	activities
activitat	activity
actor	actor
vertadièr	actual
en realitat	actually
agut	acute
adaptar	adapt
s'adaptar	adapt
addicionar	add
apondre	add
dependent	addicted
adjoncion	addition
addicion	addition
addicional	additional
adreça	address
adequat	adequate
acceptable	adequate
adjacent	adjacent
pròche	adjacent
adjectiu	adjective
s'adaptar	adjust
ajustar	adjust
admirar	admire
admetre	admit
adoptar	adopt
adorable	adorable
avançar	advance
avança	advance
progressat	advanced
progressèt	advanced
avançat	advanced
avantatge	advantage
avantatjar	advantage
aventura	adventure
advèrbi	adverb
publicitat	advertisement
publicitari	advertising
publicitat	advertising
conselh	advice
conselhar	advise
preconizar	advocate
partisan	advocate
avocat	advocate
estetic	aesthetic
afar	affair
afectar	affect
afeccion	affection
se permetre	afford
abordable	affordable
desconsolat	afraid
espaurugat	afraid
aprèp	after
tantossada	afternoon
puèi	afterwards
tornarmai	again
contra	against
venir vièlh	age
edat	age
agéncia	agency
agent	agent
agressiu	aggressive
agil	agile
fa	ago
èsser d'acòrdi	agree
acòrdi	agreement
agricultura	agriculture
en avança	ahead
davant	ahead
ajuda	aid
ajudar	aid
objectiu	aim
amirar	aim
difusar	air
aire	air
aeropòrt	airport
corredor	aisle
alarma	alarm
alarmar	alarm
alcoòl	alcohol
alertar	alert
alèrta	alert
actiu	alert
viu	alive
tot	all
va plan	all right
tot çò melhor	all the best
autorizar	allow
permetre	allow
permés	allowed
gaireben	almost
sol	alone
lo long de	along
amb	along
ja	already
D'acòrdi	Alright
Va plan	Alright
tanben	also
alternatiu	alternative
alternativa	alternative
malgrat que	although
totjorn	always
soi	am
fantastic	amazing
ambigú	ambiguous
ambicion	ambition
ambiciós	ambitious
rectificar	amend
al mièg de	amid
demest	among
demest nosautres	among us
montant	amount
amusant	amusing
un	an
analisi	analysis
davancièrs	ancestors
ancora	anchor
ancorar	anchor
ancian	ancient
e	and
e tu	and you
àngel	angel
irritar	anger
s'embufar	anger
colèra	anger
pescar	angle
angle	angle
embufat	angry
animal	animal
cavilha	ankle
anniversari	anniversary
anóncia	announcement
embestiar	annoy
embestiat	annoyed
fastigós	annoying
embestiant	annoying
annadièr	annual
anonim	anonymous
un autre	another
responsa	answer
respondre	answer
anticipar	anticipate
s'esperar a	anticipate
anxietat	anxiety
anxiós	anxious
quin que siá	any
pas mai	anymore
qui que siá	anyone
qualqu'un	anyone
degun	anyone
tot	anything
que que siá	anything
de tot biais	anyway
de tot biais	anyways
a bocins	apart
alunhat	apart
levat	apart
apartament	apartment
s'excusar	apologize
excusar	apologize
aparent	apparent
aparentament	apparently
apelar	appeal
charme	appeal
apèl	appeal
semblar	appear
aparéisser	appear
aparéncia	appearance
aparicion	appearance
aparegut	appeared
apareguèt	appeared
apetit	appetite
poma	apple
aplicacion	application
candidatura	application
aplicar	apply
postular	apply
rendètz-vos	appointment
apreciar	appreciate
apreciacion	appreciation
aprochar	approach
apròchi	approach
apropriar	appropriate
apropriat	appropriate
aprovacion	approval
aprovar	approve
aprovat	approved
aproximativament	approximately
abril	april
arbitrari	arbitrary
arquitècte	architect
arquitectura	architecture
archiu	archive
son	are
siás	are you
sètz	are you
siás ocupat	are you busy
sètz ocupat	are you busy
sètz maridat	are you married
siás maridat	are you married
sètz maridada o celibatària	are you married or single
sètz maridat o celibatari	are you married or single
Sètz encara lai?	Are you still there?
Siás encara lai?	Are you still there?
siás aquí	are you there
sètz aquí	are you there
zòna	area
se disputar	argue
argumentar	argue
argument	argument
disputa	argument
subrevenir	arise
armar	arm
braç	arm
arma	arm
armada	army
a l'entorn	around
aperaquí	around
dispausar	arrange
organizar	arrange
disposicion	arrangement
adobament	arrangement
arribada	arrival
arribar	arrive
arribèt	arrived
arribat	arrived
arrogant	arrogant
flècha	arrow
art	art
article	article
artificial	artificial
artista	artist
coma	as
tant	as
tant que	as long as
tanben	as well
e tanben	as well as
cendre	ash
vergonhós	ashamed
avergonhat	ashamed
demandar	ask
demandèt	asked
demandat	asked
endormit	asleep
aspècte	aspect
exposicion	aspect
assamés	Assamese
assaut	assault
atacar	assault
agression	assault
assemblada	assembly
assertiu	assertive
avalorar	assess
estimar	assess
estimacion	assessment
avaloracion	assessment
atot	asset
actiu	asset
actius	assets
atots	assets
assignar	assign
afectacion	assignment
mission	assignment
ajudar	assist
assistent	assistant
associat	associate
associar	associate
associat	associated
associèt	associated
associacion	association
supausar	assume
assumir	assume
ipotèsi	assumption
suposicion	assumption
a	at
almens	at least
mangèt	ate
atlèta	athlete
estacar	attach
jónher	attach
estacat	attached
jonch	attached
çai-jonch	attached
estacament	attachment
pèça estacada	attachment
ataca	attack
atacar	attack
temptar	attempt
temptativa	attempt
s'ocupar de	attend
assistir a	attend
frequentacion	attendance
atencion	attention
actitud	attitude
atraire	attract
atraccion	attraction
atractiu	attractive
avantatjós	attractive
atribut	attribute
atribuir	attribute
public	audience
audiéncia	audience
august	august
tanta	aunt
tantina	aunty
autentic	authentic
autor	author
autoritat	authority
auton	autumn
disponible	available
mejan	average
evitar	avoid
desvelhat	awake
guerdonar	award
guerdon	award
informat	aware
conscient	aware
consciéncia	awareness
al luènh	away
luènh	away
genial	awesome
òrre	awful
maladrech	awkward
geinant	awkward
aimara	Aymara
nenon	baby
celibatari	bachelor
arrièr	back
enrè	back
esquina	back
origina	background
rèireplan	background
marrit	bad
borsa	bag
saca	bag
escar	bait
esca	bait
còire	bake
far còire	bake
fornariá	bakery
bicarbonat de soda	baking soda
equilibrar	balance
sobra	balance
equilibre	balance
balèti	ball
bala	ball
bambara	Bambara
banana	banana
s'unir	band
benda	band
grop	band
detonacion	bang
banca	bank
riba	bank
bar	bar
barra	bar
barrar	bar
justet	barely
a pena	barely
afar	bargain
negociar	bargain
lairament	bark
rusca	bark
jaupar	bark
òrdi	barley
barrièra	barrier
basar	base
se basar	base
basa	base
basat	based
situat	based
sòtol	basement
basic	basic
elementari	basic
basicament	basically
baselic	basil
bastard	bastard
paquet	batch
banh	bath
banhar	bath
banhadoira	bath
sala de banh	bathroom
batariá	battery
pila	battery
batalha	battle
combatre	battle
distància	bay
baia	bay
graneta	bay
èsser	be
far mèfi	be careful
s'encalar	beach
plaja	beach
rai	beam
biga	beam
mongetas	beans
suportar	bear
ors	bear
barba	beard
incidéncia	bearing
posicion	bearing
bèstia	beast
batre	beat
ritme	beat
batement	beat
polit	beautiful
beutat	beauty
venguèt	became
perque	because
a causa	because
venir	become
lièch	bed
cambra	bedroom
abelha	bee
buòu	beef
estat	been
anat	been
bièra	beer
abans	before
comencèt	began
començar	begin
començant	beginning
començament	beginning
nom	behalf
se comportar	behave
comportament	behavior
comportament	behaviour
darrièr	behind
essent	being
èsser	being
cresença	belief
creire	believe
ventre	belly
enflar	belly
aperténer	belong
èsser a sa plaça	belong
aimat	beloved
dejós	below
en bas	below
cencha	belt
banqueta	bench
banc	bench
plegar	bend
plec	bend
dejós	beneath
en dejós	beneath
benfach	benefit
profechar	benefit
benefici	benefit
avantatges	benefits
primas	benefits
benfachs	benefits
al costat de	beside
en mai de	besides
d'un autre costat	besides
batre	best
melhor	best
bon astre	best of luck
melhoras salutacions	best regards
melhor	better
entre	between
bevenda	beverage
enlà	beyond
bojpuri	Bhojpuri
influenciar	bias
desviament	bias
partit pres	bias
biaissat	biased
bicicleta	bicycle
far un enquant	bid
ordenar	bid
enquant	bid
grand	big
bicicleta	bike
far de bicicleta	bike
factura	bill
projècte de lei	bill
bilhet	bill
ligar	bind
aucèl	bird
anniversari	birthday
pauc	bit
tròç	bit
mossegat	bit
mossegar	bite
fissar	bite
mossegada	bite
amar	bitter
negre	black
lama	blade
blaime	blame
blaimar	blame
colpa	blame
verge	blank
blanc	blank
cobèrta	blanket
tapar	blanket
explosion	blast
destruire	blast
descolorar	bleach
aiga clorada	bleach
se mesclar	blend
mescla	blend
benesir	bless
benesit	blessed
sant	blessed
òrb	blind
persiana	blind
beatitud	bliss
blòc	block
blocar	block
sang	blood
florida	bloom
florir	bloom
buf	blow
bufar	blow
còp	blow
trist	blue
blau	blue
brusc	blunt
motut	blunt
conselh	board
montar a bòrd	board
pòst	board
batèu	boat
massa	body
còs	body
floronc	boil
bolir	boil
far bolir	boil
gras	bold
audaciós	bold
temerari	bold
ligam	bond
òs	bone
espina	bone
desossar	bone
libre	book
reservar	book
impulsion	boost
estimular	boost
amplificador	booster
bòta	boot
bòtas	boots
bòrd	border
confrontar	border
frontièra	border
enutjar	bore
forar	bore
las	bored
foratge	boring
enujós	boring
nascut	born
manlevar	borrow
cap	boss
totes dos	both
gèina	bother
geinar	bother
botelha	bottle
embotelhar	bottle
tafanari	bottom
fons	bottom
crompat	bought
rebombir	bounce
saut	bound
obligat	bound
segur	bound
limits	boundaries
s'inclinar	bow
reveréncia	bow
arc	bow
bola	bowl
bòl	bowl
boxar	box
bróstia	box
caissa	box
dròlle	boy
amiguet	boyfriend
braçalet	bracelet
del cervèl	brain
cervèl	brain
branca	branch
se ramificar	branch
estigmatizar	brand
flame	brand
marca	brand
coratjós	brave
afrontar	brave
infraccion	breach
enfrànher	breach
pan	bread
pausa	break
copar	break
dejunar	breakfast
pitre	breast
respiracion	breath
respirar	breathe
se reproduire	breed
raça	breed
far venir	breed
malon	brick
nòvia	bride
pont	bridge
palanca	bridge
dorsièr	brief
brèu	brief
brilhant	bright
brilhant	brilliant
aportar	bring
collèga	bro
general	broad
larg	broad
difusar	broadcast
emission	broadcast
ruinat	broke
copèt	broke
copat	broke
marrit	broken
copat	broken
escoba	broom
fraire	brother
conhat	brother in law
aportat	brought
brun	brown
marron	brown
brossar	brush
bròssa	brush
ferrat	bucket
camarada	buddy
budgetizar	budget
budgèt	budget
bon mercat	budget
mal	bug
virus	bug
insècte	bug
s'acumular	build
bastir	build
immòble	building
construccion	building
bastiguèt	built
bastit	built
màger part	bulk
volum	bulk
taure	bull
maltractar	bully
secutaire	bully
se dordar	bump
bombament	bump
paquet	bunch
grop	bunch
paquet	bundle
empaquetar	bundle
carga	burden
cargar	burden
enterrèt	buried
enterrat	buried
cremada	burn
gravar	burn
cremar	burn
esclatar	burst
explosion	burst
se precipitar	burst
enterrar	bury
bus	bus
transportar en bus	bus
bartàs	bush
brossa	bush
afars	business
comèrci	business
bust	bust
arrestar	bust
ocupat	busy
mas	but
burrar	butter
burre	butter
parpalhon	butterfly
boton	button
botonar	button
crompar	buy
crompa	buy
prèp	by
per	by
en	by
a prepaus	by the way
adieu	bye
caulet	cabbage
gabinet	cabinet
engabiar	cage
gàbia	cage
còca	cake
vedèl	calf
sonar	call
sona-me	call me
sonatz-me	call me
sonèt	called
sonat	called
calmar	calm
calma	calm
venguèt	came
campanha	campaign
poder	can
pòt pas	can't
Suprimir	Cancel
Anullar	Cancel
oncologic	cancer
cancèr	cancer
capable	capable
capacitat	capacity
capital	capital
capitala	capital
legenda	caption
captar	capture
capturar	capture
veitura	car
vagon	car
carrièra	career
prudent	careful
atentiu	careful
atentivament	carefully
inchalhent	careless
negligent	careless
benvolent	caring
fustièr	carpenter
moqueta	carpet
tapís	carpet
moquetar	carpet
pastenaga	carrot
transportar	carry
portar	carry
quites pas d'avançar	carry on
contunhar d'avançar	carry on
exercir	carry on
emportar	carry out
efectuar	carry out
estug	case
maleta	case
cas	case
en espècias	cash
encaissar	cash
argent	cash
distribucion	cast
plastre	cast
distribuir de ròtles	cast
torre	castle
castèl	castle
informal	casual
ocasional	casual
fortuit	casual
gat	cat
presa	catch
agantar	catch
categoria	category
bestiar	cattle
atrapat	caught
atrapèt	caught
causar	cause
causa	cause
circonspeccion	caution
avertir	caution
prudent	cautious
cauna	cave
cessar	cease
ruptura	cease
plafon	ceiling
celebrar	celebrate
cellula	cell
cellular	cell
centre	center
sègle	century
cereala	cereal
ceremonia	ceremony
cèrt	certain
segur	certain
segurament	certainly
plan segur	certainly
certificar	certificate
certificat	certificate
cadena	chain
encadenar	chain
presidir	chair
cadièra	chair
president	chair
contestacion	challenge
desfisar	challenge
desfís	challenge
escasença	chance
cambi	change
cambiar	change
caòs	chaos
personatge	character
caractèr	character
caracteristicas	characteristics
carga	charge
fraisses	charge
cargar	charge
caritat	charity
associacion caritativa	charity
embelinaire	charming
planificar	chart
carta	chart
grafic	chart
perseguir	chase
percaç	chase
conversar	chat
convèrsa	chat
avar	cheap
bon mercat	cheap
trichar	cheat
trichaire	cheat
enganar	cheat
trichar	cheating
trichant	cheating
verificar	check
chèc	check
gauta	cheek
audàcia	cheek
aclamar	cheer
encoratjar	cheer
gaujós	cheerful
santat	cheers
mercés	cheers
adieu	cheers
formatge	cheese
quimia	chemistry
presar	cherish
escacs	chess
pitre	chest
còfre	chest
mastegar	chew
coard	chicken
pol	chicken
cap	chief
principal	chief
enfant	child
enfança	childhood
enfants	children
gelar	chill
frejor	chill
relaxat	chill
chimenèias	chimneys
menton	chin
chocolat	chocolate
causida	choice
causir	choose
costèla	chop
capolar	chop
corrogada	chores
gautut	chubby
glèisa	church
canèla	cinnamon
cercle	circle
enrodar	circle
circonstàncias	circumstances
ciutadan	citizen
vila	city
ciutat	city
reivindicacion	claim
reclamar	claim
clarificar	clarify
classa	class
argila	clay
netejar	clean
net	clean
netejar	clear
clar	clear
grafièr	clerk
emplegat	clerk
intelligent	clever
client	client
bauç	cliff
climat	climate
aumentar	climb
ascension	climb
escalar	climb
pegós	clingy
èsser un tavan	clingy
relòtge	clock
prèp	close
barrar	close
armari	closet
pelha	cloth
farda	clothes
cobèrtas	clothes
vestits	clothes
s'ennivolar	cloud
embolhar	cloud
nívol	cloud
nivolós	cloudy
opac	cloudy
palhassa	clown
indici	clue
malbiaissut	clumsy
grop	cluster
autocar	coach
segonda classa	coach
entrainaire	coach
carbon	coal
còsta	coast
mantèl	coat
cobrir	coat
cafè	coffee
cognitiu	cognitive
coïncidéncia	coincidence
freg	cold
s'estavanir	collapse
s'avalir	collapse
collar	collar
collèga	colleague
collègas	colleagues
reculhir	collect
colleccionar	collect
collectar	collect
recuèlh	collection
colleccion	collection
collècta	collection
universitat	college
facultat	college
colorejar	color
color	color
d'idèas verdas sens color dormissián furiosament	colorless green ideas slept furiously
colorar	colour
color	colour
colomna	column
penche	comb
penchenar	comb
combinason	combination
combinar	combine
venir	come
veni aicí	come here
anem	come on
confòrt	comfort
conortar	comfort
confortable	comfortable
a venir	coming
arribant	coming
a venir lèu	coming soon
comandar	command
comandament	command
comentar	comment
comentari	comment
comercial	commercial
publicitat	commercial
comission, comandar, perpetracion	commission
cometre	commit
assignar	commit
far internar	commit
engatjament	commitment
cometèt	committed
engatjat	committed
comés	committed
denada	commodity
produch	commodity
comun	common
comunicar	communicate
comunicacion	communication
comunitat	community
collectivitat	community
far lo vai e veni	commute
companhon	companion
companhiá	company
comparar	compare
compara	compare
comparança	comparison
compassion	compassion
compatissent	compassionate
compatible	compatible
participar	compete
rivalizar	compete
competent	competent
competicion	competition
de competicion	competitive
competitiu	competitive
se plànher	complain
plancha	complaint
reclamacion	complaint
complement	complement
complementar	complement
complet	complete
completament	completely
complèx	complex
flexibilitat	compliance
conformitat	compliance
compliquèt	complicated
complicat	complicated
compliment	compliment
complimentar	compliment
seguir la lei	comply
èsser confòrme	comply
composicion	composition
compausar	compound
compausat	compound
compausant	compound
compreneson	comprehension
complet	comprehensive
comprensiu	comprehensive
comprometre	compromise
compromés	compromise
obligatòri	compulsory
ordenador	computer
concentrat	concentrate
concentrar	concentrate
concèpte	concept
concernir	concern
concernit	concerned
preocupat	concerned
concèrt	concert
concertar	concert
conclusion	conclusion
betum	concrete
concret	concrete
betumar	concrete
condicionar	condition
condicion	condition
condiciona	conditions
condicions	conditions
conducha	conduct
comportament	conduct
conduire	conduct
congrès	conference
conferéncia	conference
se confessar	confess
confessar	confess
confidéncia	confidence
fisança	confidence
fisançós	confident
confirmar	confirm
contradire	conflict
conflicte	conflict
confús	confused
desorientat	confused
confusion	confusion
felicitacions	congrats
felicitacion	congratulation
felicitacions	congratulations
conjoncion	conjunction
connectar	connect
conquistar	conquer
conscient	conscious
deliberat	conscious
consciéncia	consciousness
consentiment	consent
consentir	consent
consequéncias	consequences
conservacion	conservation
conservador	conservative
considerar	consider
considerat	considered
considerèt	considered
consistir	consist
consisténcia	consistency
coeréncia	consistency
omogenèu	consistent
constant	consistent
constant	constant
incessant	constant
constanta	constant
constantament	constantly
constipacion	constipation
construccion	construction
consumir	consume
consomacion	consumption
contactar	contact
contacte	contact
contagiós	contagious
contenir	contain
conten	contains
contemporanèu	contemporary
mesprètz	contempt
contengut	content
competicion	contest
contèxt	context
continent	continent
contunhar	continue
se contractar	contract
contracte	contract
s'engatjar	contract
contrastar	contrast
contrast	contrast
contribuir	contribute
contribucion	contribution
contraròtle	control
contrarotlar	control
controvertit	controversial
convenéncia	convenience
comoditat	convenience
practic	convenient
conversacion	conversation
convertir	convert
se convertir	convert
transmetre	convey
transportar	convey
convéncer	convince
persuadir	convince
convençut	convinced
convencèt	convinced
còire	cook
cosinièr	cook
cosinar	cook
cuècha	cooking
fresc	cool
refrescar	cool
tranquillon	cool
cooperacion	cooperation
far fàcia	cope
se despatolhar	cope
de coire	copper
policièr	copper
coire	copper
centre	core
còr	core
blat	corn
milh	corn
agacin	corn
canton	corner
acantonar	corner
corrècte	correct
corregir	correct
costar	cost
còst	cost
vestit	costume
ostalet de campèstre	cottage
coton	cotton
sofà	couch
redigir	couch
tossir	cough
tos	cough
podriá	could
conselh	council
comptar	count
conte	count
comptador	counter
taulièr	counter
país	country
del campèstre	country
campèstre	country
campèstre	countryside
parelh	couple
associar	couple
coratge	courage
cors	course
percors	course
cort	court
tribunal	court
sollicitar	court
cortesiá	courtesy
cosin	cousin
cobèrta	cover
cobrir	cover
intimidar	cow
vaca	cow
coard	coward
confortable	cozy
cranc	crab
fendilha	crack
falha	crack
asclar	crack
dexteritat	craft
nau	craft
art	craft
mèrda	crap
cagar	crap
s'espotir	crash
espotir	crash
accident	crash
enveja devoranta	craving
se rebalar	crawl
cròl	crawl
caluc	crazy
crear	create
creatiu	creative
atribuir	credit
credit	credit
intrar discretament	creep
se rebalar	creep
que dona la carn de galina	creepy
equipa	crew
equipatge	crew
criminalitat	crime
crim	crime
infraccion	crime
sentir una gèina	cringe
geinant	cringe
crisi	crisis
situacion critica	crisis
critèris	criteria
critic	critical
critica	criticism
recòlta	crop
cultivar	crop
recoltar	crop
recòlta	crops
copa	crops
recòltas	crops
traversar	cross
crotz	cross
embufat	cross
còrb	crow
se conflar	crow
cant	crow
monde	crowd
s'amolonar	crowd
comol de gents	crowded
coronar	crown
corona	crown
crucial	crucial
crusèl	cruel
èsser en crosièra	cruise
crosièra	cruise
esclafar	crush
cridar	cry
crit	cry
plorar	cry
cogombre	cucumber
se calinhar	cuddle
calinhada	cuddle
cultura	culture
finàs	cunning
taça	cup
copa	cup
armari	cupboard
restriccion	curb
refrenar	curb
remèdi	cure
garir	cure
cobrifuòc	curfew
curiositat	curiosity
estranh	curious
curiós	curious
anelat	curly
crespat	curly
devisa	currency
moneda	currency
actual	current
corrent	current
actualament	currently
malediccion	curse
renèc	curse
renegar	curse
encortinar	curtain
cortina	curtain
coissin	cushion
clientèla	custom
costuma	custom
client	customer
doana	customs
dreches de doana	customs
talh	cut
copar	cut
manhac	cute
bicicleta	cycle
cicle	cycle
far de bicicleta	cycle
en bicicleta	cycling
ciclisme	cycling
papà	dad
papà	daddy
quotidian	daily
cada jorn	daily
lachariá	dairy
lachièr	dairy
paissièra	dam
restancar	dam
damatge	damage
damatjar	damage
mèrda	damn
damnar	damn
umiditat	damp
moste	damp
ime	damp
dança	dance
dançar	dance
perilh	danger
perilhós	dangerous
fosc	dark
negre	dark
mon còr	darling
se precipitar	dash
vam	dash
gota	dash
donadas	data
sortir amb	date
data	date
filha	daughter
jorn	day
mòrt	dead
completament	dead
data limita	deadline
sord	deaf
pacha	deal
distribuir	deal
afar	deal
car	dear
Cars totes	Dear All
Car client	Dear Customer
Cars parents	Dear Parents
Car sénher	Dear Sir
Cars estudiants	Dear students
Cara equipa	Dear Team
mòrt	death
debatre	debate
debat	debate
debit	debit
brigalhs	debris
deute	debt
decennia	decade
se desparricar	decay
desparricament	decay
defuntat	deceased
enganar	deceive
decembre	december
onorable	decent
decent	decent
decidir	decide
decidit	decided
decision	decision
veranda	deck
pont	deck
jòc de cartas	deck
declin	decline
declinar	decline
diminucion	decrease
demesir	decrease
dedicat	dedicated
fidèl	dedicated
dediquèt	dedicated
devocion	dedication
consacracion	dedication
accion	deed
prigond	deep
prigondor	deep
cèrvi	deer
impagament	default
defautar	default
defaut	default
derrotar	defeat
desfacha	defeat
defendre	defend
definir	define
definitivament	definitely
definicion	definition
diplòma	degree
gra	degree
retardar	delay
retard	delay
retardèt	delayed
retardat	delayed
escafar	delete
suprimir	delete
deliberar	deliberate
deliberat	deliberate
delicat	delicate
deliciós	delicious
rabir	delight
delici	delight
encantat	delighted
liurar	deliver
liurat	delivered
liurèt	delivered
liurason	delivery
jasilha	delivery
exigir	demand
demandar	demand
demanda	demand
exigent	demanding
democracia	democracy
demòni	demon
manifestar	demonstrate
demostrar	demonstrate
negat	denied
neguèt	denied
densitat	density
dentista	dentist
negar	deny
refusar	deny
departament	department
partença	departure
dependre	depend
comptar	depend
desplegar	deploy
depaus	deposit
acompte	deposit
depausar	deposit
en baissa	depressed
deprimit	depressed
depression	depression
prigondor	depth
descriure	describe
descripcion	description
desèrt	desert
desertar	desert
meritar	deserve
concepcion	design
concebre	design
nom	designation
designacion	designation
desir	desire
desirar	desire
burèu	desk
desesperar	despair
desespèr	despair
desesperat	desperate
malgrat	despite
dessèrt	dessert
destinacion	destination
destin	destiny
destruire	destroy
destruccion	destruction
detalhar	detail
detalh	detail
detalhs	details
detalha	details
detectar	detect
determinacion	determination
determinar	determine
determinat	determined
devastat	devastated
desvolopar	develop
desvolopèt	developed
desvolopat	developed
evolucion	development
desvolopament	development
debanament	development
aparelh	device
mejan	device
diable	devil
èsser estagiari	devil
fidèl	devoted
abnegat	devoted
maldivian	Dhivehi
diabèta	diabetes
diarrèa	diarrhea
jornal	diary
agenda	diary
diccionari	dictionary
faguèt	did
morir	die
moriguèt	died
mòrt	died
alimentacion	diet
dièta	diet
diferéncia	difference
diferent	different
dificil	difficult
cavar	dig
comprendre	dig
dignitat	dignity
diligent	diligent
sopar	dinner
trempar	dip
dirigir	direct
dirècte	direct
direccion	direction
director	director
brutícia	dirt
brut	dirty
mutilar	disable
desactivar	disable
andicapat	disabled
desactivat	disabled
desaparéisser	disappear
decebut	disappointed
desastre	disaster
laissar de caire	discard
descargament	discharge
descargar	discharge
sancionar	discipline
disciplinar	discipline
disciplina	discipline
rebais	discount
far un rebais	discount
descobrisson	discover
descobrir	discover
discriminacion	discrimination
discutir	discuss
discussion	discussion
malautiá	disease
malautiás	diseases
desguisar	disguise
desguisament	disguise
fastigós	disgusting
plat	dish
plats	dishes
laissar partir	dismiss
fòragetar	dismiss
despacha	dispatch
expedir	dispatch
enviament	dispatch
exposicion	display
manifestacion	display
mostrar	display
disposicion	disposal
cession	disposal
disputar	dispute
disputa	dispute
s'alunhar	distance
distància	distance
distint	distinct
distinguir	distinguish
destressa	distress
distribucion	distribution
districte	district
barri	district
destorbar	disturb
inquietar	disturb
abandonar	ditch
rèc	ditch
cabussar	dive
divèrs	diverse
diversitat	diversity
diferéncia	divide
devesir	divide
divin	divine
devinar	divine
divòrci	divorce
divorciar	divorce
esterlucar	dizzy
estabosit	dizzy
fai	do
far	do
m'aimatz	do you love me
m'aimas	do you love me
modificar	doctor
doctor	doctor
document	document
fa	does
pas	doesn't
seguir de prèp	dog
gos	dog
dogri	Dogri
fasent	doing
accion	doing
peteta	doll
domeni	domain
interior	domestic
domestic	domestic
dominant	dominant
pas	don't
non	don't
Te tafures pas	Don't worry
far un don	donate
far una donacion	donate
fach	done
ase	donkey
dròga	dope
dopar	dope
piòt	dope
doble	double
doblar	double
dobte	doubt
dobtar	doubt
pasta	dough
moneda	dough
abatre	down
bas	down
engolir	down
descargar	download
corrent	draft
borrolhon	draft
conscripcion	draft
trigossar	drag
tirassar	drag
dren	drain
toat	drain
drenar	drain
drama	drama
tirar	draw
dessenhar	draw
tirador	drawer
dessenh	drawing
dessenhant	drawing
crénher	dread
crencha	dread
somiar	dream
sòmi	dream
rauba	dress
se vestir	dress
traucadoira	drill
pertusar	drill
manòbras	drill
bevenda	drink
beure	drink
unitat de disc	drive
campanha	drive
menar	drive
gota	drop
far tombar	drop
tombèt	dropped
faguèt tombar	dropped
secada	drought
bandat	drunk
secar	dry
eissugar	dry
sec	dry
evitar	duck
tiron	duck
tipe	dude
degut	due
convenent	due
çò degut	due
degut a	due to
tediós	dull
talhvirat	dull
tèrne	dull
idiòt	dumb
mut	dumb
escampar	dump
bordilhièr	dump
durada	duration
durant	during
esposcar	dust
posca	dust
servici	duty
dever	duty
obligacion	duty
abitar	dwell
morent	dying
cada	each
l'un l'autre	each other
despacient	eager
agla	eagle
aurelha	ear
ausida	ear
mai abans	earlier
mai d'ora	earlier
tre l'enfança	early
matinièr	early
d'ora	early
ganhar	earn
meritar	earn
aurelhas	ears
tèrra	earth
tèrratremol	earthquake
facilitat	ease
solatjar	ease
aisidament	easily
èst	east
tranquillament	easy
facil	easy
manjar	eat
a manjar	eating
manjar	eating
economic	economic
economia	economy
bòrd	edge
editar	edit
modificar	edit
revision	edit
ensenhament	education
educacion	education
efectuar	effect
efièch	effect
efectiu	effective
eficaç	effective
eficacitat	efficiency
eficaç	efficient
economic	efficient
esfòrç	effort
uòu	egg
aubergina	eggplant
ego	ego
uèch	eight
dètz-e-uèch	eighteen
ochanta	eighty
l'un o l'autre	either
siá	either
desvolopar	elaborate
elaborar	elaborate
coide	elbow
butar amb los coides	elbow
ainat	elder
ainat	elderly
d'edat avançada	elderly
elegant	elegant
element	element
elefant	elephant
onze	eleven
eligible	eligible
eliminar	eliminate
autre	else
autrament	else
embarrassat	embarrassed
embarrassant	embarrassing
embraçar	embrace
abraçada	embrace
emergir	emerge
urgéncia	emergency
emotiu	emotional
emocional	emotional
empatia	empathy
enfasi	emphasis
metre l'enfasi sus	emphasize
emplegat	employee
emplegats	employees
emplegaire	employer
emplec	employment
vojar	empty
vuèg	empty
activar	enable
permetre	enable
encontre	encounter
encontrar	encounter
afrontament	encounter
encoratjar	encourage
acabar	end
fin	end
en via d'extincion	endangered
s'esforçar	endeavor
temptativa	endeavor
endurança	endurance
endurar	endure
durar	endure
de l'enemic	enemy
enemic	enemy
energia	energy
engatjar	engage
passar	engage
engatjat	engaged
promés	engaged
ocupat	engaged
acordalhas	engagement
engatjament	engagement
motor	engine
organizar	engineer
engenhaire	engineer
anglés	English
melhorar	enhance
aumentar	enhance
se divertir	enjoy
profechar	enjoy
apreciar	enjoy
enòrme	enormous
pro	enough
s'assegurar de	ensure
assegurar	ensure
intrar	enter
espectacle	entertainment
divertiment	entertainment
estrambòrd	enthusiasm
entosiasta	enthusiastic
entièr	entire
abilitat	entitled
titolèt	entitled
titolat	entitled
entitat	entity
intrada	entrance
entrepreneire	entrepreneur
envolopa	envelope
environa	environment
gelosiá	envy
envejar	envy
epic	epic
epopèa	epic
epidemia	epidemic
egal	equal
egalar	equal
equipament	equipment
equitat	equity
fonses	equity
equivalent	equivalent
goma	eraser
escafaire	eraser
error	error
escapar	escape
evasion	escape
especialament	especially
ensag	essay
esséncia	essence
essencial	essential
fondar	establish
establir	establish
establit	established
proprietat	estate
estimacion	estimate
estimar	estimate
estimèt	estimated
estimat	estimated
etc	etc
eternal	eternal
etica	ethics
avalorar	evaluate
estimacion	evaluation
avaloracion	evaluation
planièr	even
egalizar	even
quitament	even
e mai se	even though
vèspre	evening
eveniment	event
puèi	eventually
finalament	eventually
constantament	ever
jamai	ever
cada	every
totes	everybody
totes	everyone
tot	everything
pròva	evidence
metre en evidéncia	evidence
evidéncia	evidence
mal	evil
marrit	evil
evolucion	evolution
evoluir	evolve
ewe	Ewe
èx	ex
exacte	exact
exactament	exactly
examèn	exam
d'examèn	exam
interrogar	examine
examinar	examine
exemple	example
excedir	exceed
excellent	excellent
exceptat	except
exclure	except
excepcion	exception
excès	excess
excedent	excess
excessiu	excessive
escambi	exchange
escambiar	exchange
estrambordat	excited
excitat	excited
agitat	excited
agitacion	excitement
excitacion	excitement
excitant	exciting
passionant	exciting
exclusivitat	exclusive
exclusiu	exclusive
excusar	excuse
excusa	excuse
excusatz-me	excuse me
executat	execute
execucion	execution
executiu	executive
quadre	executive
exercici	exercise
exercir	exercise
far d'exercici	exercise
aganir	exhaust
agotat	exhausted
abenat	exhausted
exposicion	exhibit
mostrar	exhibit
exposicion	exhibition
existir	exist
existéncia	existence
actual	existing
existent	existing
sortida	exit
s'espandir	expand
esperar	expect
esperat	expected
esperèt	expected
despensa	expenses
car	expensive
experiéncia	experience
experiéncia	experiment
experimentar	experiment
expèrt	expert
expirat	expired
explicar	explain
explicacion	explanation
esplechar	exploit
proesa	exploit
explorar	explore
exportar	export
exportacion	export
expausar	expose
expausat	exposed
exposicion	exposure
ipotermia	exposure
exprimir	express
exprès	express
expression	expression
estendre	extend
espandit	extended
prolongat	extended
prolongacion	extension
extension	extension
importància	extent
espandida	extent
extèrn	external
desaparegut	extinct
mai car	extra
suplementari	extra
figurant	extra
extraire	extract
extrach	extract
extraordinari	extraordinary
extrèm	extreme
extrèmament	extremely
uèlh	eye
uèlhs	eyes
teissut	fabric
fabulós	fabulous
far fàcia	face
fàcia	face
facilitar	facilitate
installacions	facilities
facilitats	facilities
facilitat	facility
aptitud	facility
fach	fact
factor	factor
fabrica	factory
de fabrica	factory
faches	facts
s'esfumar	fade
mancar	fail
fracàs	fail
fracassar	fail
mancat	failed
fracàs	failure
s'estavanir	faint
tèune	faint
just	fair
fièira	fair
pro	fairly
equitablament	fairly
fada	fairy
fe	faith
fisança	faith
fidèl	faithful
contrafar	fake
falsificar	fake
fals	fake
casuda	fall
davalada	fall
tombar	fall
fals	false
celebritat	fame
familiar	familiar
familha	family
de familha	family
famina	famine
celèbre	famous
ventilador	fan
fan	fan
ventalh	fan
fantasia	fancy
aver enveja de	fancy
s'imaginar	fancy
fantastic	fantastic
distant	far
luènh	far
adieusiatz	farewell
bòria	farm
far venir	farm
bordièr	farmer
fascinant	fascinating
faiçonar	fashion
modelar	fashion
mòda	fashion
rapid	fast
gròs	fat
grais	fat
fatal	fatal
destin	fate
engendrar	father
paire	father
fatiga	fatigue
fatigar	fatigue
falha	fault
fauta	fault
reprochar	fault
favorit	favorite
privilegiar	favour
favor	favour
afavorir	favour
favorit	favourite
paur	fear
aver paur de	fear
fèsta	feast
festejar	feast
festin	feast
pluma	feather
caracteristica	feature
figurar	feature
trach	feature
caracteristicas	features
traches	features
figura	features
febrièr	february
conflat	fed up
fraisses	fee
onoraris	fee
dreches	fee
alimentacion	feed
alimentar	feed
noirir	feed
retorn	feedback
sentir	feel
sentiment	feeling
sensacion	feeling
pès	feet
abatre	fell
tombèt	fell
companh	fellow
tipe	fellow
membre	fellow
sentiguèt	felt
sentit	felt
femna	female
femèla	female
far d'escrima	fence
barralhar	fence
barralha	fence
fertil	fertile
festival	festival
quèrre	fetch
fèbre	fever
pauc	few
mens de	fewer
nòvi	fiance
ficcion	fiction
camp	field
domeni	field
feròç	fierce
quinze	fifteen
cinquanta	fifty
combat	fight
se batre	fight
combatre	fight
lucha	fighting
luchant	fighting
nombre	figure
s'imaginar	figure
figura	figure
determinar	figure out
lima	file
fichièr	file
limar	file
emplenar	fill
emplenat	filled
plen	filled
filmar	film
film	film
ronhós	filthy
finalament	finally
finança	finance
financièr	financial
trobalha	find
trobar	find
descobrir	find out
multa	fine
bon	fine
ben	fine
det	finger
fin	finish
acabar	finish
acaba	finish
acabat	finished
acabèt	finished
far fòc	fire
fòc	fire
firma	firm
fèrm	firm
companhiá	firm
primièr	first
prenom	first name
peis	fish
pescar	fish
adaptat	fit
convenir	fit
en forma	fit
cinc	five
fix	fix
fixar	fix
reparar	fix
fixat	fixed
pabalhon	flag
bandièra	flag
s'aflaquir	flag
laucet	flash
planièr	flat
apartament	flat
far de defèctes	flaw
defècte	flaw
impecable	flawless
sens defècte	flawless
fugir	flee
carn	flesh
volèt	flew
plegar	flex
flexible	flexible
vòl	flight
fugida	flight
escalièr	flight
revirar	flip
bascular	flip
calinhar	flirt
calinhatge	flirt
fringant	flirting
fringar	flirting
flotar	float
flotaire	float
talòssa	float
inondacion	flood
deluvi	flood
inondar	flood
estatge	floor
sòl	floor
farina	flour
circulacion	flow
flux	flow
escórrer	flow
flor	flower
florir	flower
gripa	flu
corrent	fluent
correntament	fluently
borrilhut	fluffy
fluïd	fluid
pilotar	fly
volar	fly
mosca	fly
centre d'interès	focus
se centrar	focus
accent	focus
nèbla	fog
neblós	foggy
plegar	fold
plec	fold
gents	folks
familha	folks
seguir	follow
comprendre	follow
seguiment	follow up
susvelhar	follow up
seguent	following
manjar	food
aliment	food
enganar	fool
imbecil	fool
ridicul	foolish
pè	foot
fotbòl	football
per	for
Per exemple	For example
per exemple	for instance
per tu	for you
enebit	forbidden
forçar	force
fòrça	force
violéncia	force
preveire	forecast
prevision	forecast
front	forehead
estrangièr	foreign
bòsc	forest
per totjorn	forever
oblidar	forget
perdonar	forgive
oblidèt	forgot
forca	fork
forqueta	fork
formar	form
forma	form
formulari	form
formal	formal
precedent	former
formador	former
ancian	former
per astre	fortunately
fortuna	fortune
astre	fortune
quaranta	forty
quaranta-dos	forty-two
avant	forward
en avant	forward
prèst	forward
adoptiu	foster
abalir	foster
afavorir	foster
combatèt	fought
combatut	fought
fondar	found
trobat	found
fondacion	foundation
quatre	four
catòrze	fourteen
mandra	fox
fragil	fragile
estructura	frame
enquadrar	frame
encastre	frame
encastre	framework
frau	fraud
fraudar	fraud
mostre	freak
liberar	free
liure	free
gratuit	free
libertat	freedom
gelar	freeze
gèl	freeze
congelar	freeze
frequéncia	frequency
frequent	frequent
frequentament	frequently
fresc	fresh
doç	fresh
divendres	friday
frigò	fridge
amic	friend
amical	friendly
amics	friends
amistat	friendship
esglasiat	frightened
esglasiant	frightening
granolha	frog
de	from
davant	front
front	front
gelat	frozen
fruch	fruit
frustrat	frustrated
frustrèt	frustrated
alimentar	fuel
carburant	fuel
pulaar	Fulfulde
plen	full
amusant	fun
amusament	fun
foncion	function
fondamental	fundamental
principis	fundamental
funeralhas	funeral
estranh	funny
divertissent	funny
pèl	fur
descabestrat	furious
furiós	furious
mòbles	furniture
mai luènh	further
suplementari	further
de mai	furthermore
futur	future
profièch	gain
gasanh	gain
ganhar	gain
cacilha	game
partida	game
jòc	game
lacuna	gap
valat	gap
trauc	gap
metre al garatge	garage
garatge	garage
escobilhas	garbage
jardin	garden
jardinar	garden
alh	garlic
portal	gate
pòrta	gate
amassar	gather
deduire	gather
amassada	gathering
culhida	gathering
nivèl	gauge
estimar	gauge
donèt	gave
engranatge	gear
equipar	gear
sexe	gender
genre	gender
general	general
generalament	generally
generar	generate
generacion	generation
generós	generous
gèni	genius
genre	genre
suau	gentle
apasimar	gentle
autentic	genuine
mimar	gesture
gèst	gesture
far un signe	gesture
obténer	get
venir	get
se vestir	get dressed
levatz-vos	get up
se levar	get up
lèva-te	get up
recupèra lèu	get well soon
l'obtencion	getting
venir	getting
fantauma	ghost
ghosting	ghosting
gigant	giant
present	gift
don	gift
ofrir	gift
gengibre	ginger
ros	ginger
amigueta	girl
dròlla	girl
amigueta	girlfriend
donar	give
abandonar	give up
renonciar	give up
donat	given
content	glad
còp d'uèlh	glance
lançar un còp d'uèlh	glance
veire	glass
de veire	glass
lunetas	glasses
veires	glasses
apercebre	glimpse
apercebut	glimpse
mondial	global
global	global
trist	gloomy
lugubre	gloomy
gants	gloves
brilhar	glow
lusor	glow
se transformar	glow up
pega	glue
anar	go
anar drech	go ahead
contunhar	go ahead
vai-te'n	go away
anar al lièch	go to bed
ponch	goal
tòca	goal
objectius	goals
cabra	goat
boc	goat
dieu	god
que dieu te benesisca	god bless you
va	goes
anament	going
anant	going
anant a	going to
aur	gold
d'aur	gold
desaparegut	gone
partit	gone
a mand de	gonna
va	gonna
gelarèia	goo
bon	good
bonjorn	good afternoon
adieu	good bye
bona jornada	good day
bon vèspre	good evening
bon trabalh	good job
de bèla aparéncia	good looking
bon astre	good luck
bonjorn	good morning
bonjorn mon amor	good morning my love
bona nuèch	good night
adieussiatz	goodbye
bona nuèch	goodnight
bens	goods
Google	Google
Google Translate	Google Translate
auca	goose
magnific	gorgeous
esplendid	gorgeous
rumors	gossip
parlufejar	gossip
a obtengut	got
obtenguèt	got
l'ai	got it
l'aguèri	got it
ai comprés	got it
govèrn	government
sasir	grab
gèst viu	grab
notar	grade
grade	grade
nòta	grade
gradualament	gradually
diplomat	graduate
graduar	graduate
obtenir un diplòma	graduate
blat	grain
gran	grain
cristallizar	grain
borsa	grant
subvencion	grant
concedir	grant
acordat	granted
admetent que	granted
rasims	grapes
sasir	grasp
mestresa	grasp
encapar	grasp
èrba	grass
reconeissent	grateful
gratitud	gratitude
tomba	grave
grèu	grave
gris	gray
grand	great
genial	great
aviditat	greed
gromand	greedy
cobés	greedy
verd	green
aculhir	greet
salutacion	greeting
salutacions	greetings
gris	grey
cleda	grid
malhum	grid
pena	grief
mòlre	grind
emponha	grip
presa	grip
aderéncia	grip
especiariá	grocery
maridat	groom
preparar	groom
netejar amb suènh	groom
fastigós	gross
flagrant	gross
brut	gross
subjècte	ground
se fondamentar	ground
sòl	ground
gropar	group
grop	group
créisser	grow
cultivar	grow
creissença	growth
rondinaire	grumpy
guaraní	Guarani
garantida	guarantee
garantir	guarantee
gardar	guard
garda	guard
suposicion	guess
devinar	guess
convidat	guest
conselhs	guidance
guida	guide
guidar	guide
colpable	guilty
tipe	guy
tipes	guys
club de gim	gym
gimnasi	gym
abitud	habit
abitat	habitat
aviá	had
agut	had
aguèt	had
granissa	hail
granissar	hail
pels	hair
pel	hair
mitat	half
mièg	half
passadís	hall
intrada	hall
agulha	hand
man	hand
donar	hand
ponhada	handle
manipular	handle
bèl	handsome
elegant	handsome
penjar	hang
penjan	hang
èsser penjat	hang
longanhejar	hang out
se debanar	happen
se debanèt	happened
debanat	happened
bonaürança	happiness
aürós	happy
bon anniversari	happy birthday
bon anniversari a tu	happy birthday to you
bona annada	happy new year
dur	hard
a pena	hardly
gaireben jamai	hardly ever
daumatge	harm
far mal	harm
tòrt	harm
nociu	harmful
nosible	harmful
armonia	harmony
dur	harsh
sevèr	harsh
reculhir	harvest
culhida	harvest
a	has
asirar	hate
òdi	hate
aver	have
an	have
bona jornada	have a good day
bona jornada	have a nice day
dejunar	have breakfast
s'amusar	have fun
as manjat	have you eaten
avètz manjat	have you eaten
avent	having
risca	hazard
perilh	hazard
bruma	haze
el	he
a	he has
es	he is
cap	head
maldecap	headache
garir	heal
a se garir	healing
garison	healing
santat	health
san	healthy
en santat	healthy
ausir	hear
ausiguèt	heard
ausit	heard
còr	heart
calor	heat
calfar	heat
cèl	heaven
paradís	heaven
pesuc	heavy
trepidant	hectic
nautor	height
altitud	height
eiretièr	heir
raubatòri	heist
raubar	heist
tenguèt	held
detengut	held
infèrn	hell
Adieu	Hello
adieu, car amic	hello dear
adieu, cossí vas	hello how are you
adieu, cossí va tot	hello how are you doing
casc	helmet
ajuda	help
ajudar	help
util	helpful
serviciós	helpful
d'ont	hence
ela	her
son	her
bestiar	herd
aicí	here
eiretatge	heritage
esitar	hesitate
èp	Hey
Adieu	Hi
adieu, cossí vas	hi how are you
Adieu l'òme	Hi there
amagat	hidden
escondalha	hide
amagar	hide
pèl	hide
ierarquia	hierarchy
naut	high
soslinhar	highlight
aumentar	hike
caminada	hike
caminar	hiking
caminant	hiking
caminada	hiking
ilarant	hilarious
tuc	hill
el	him
allusion	hint
indici	hint
far allusion	hint
a la mòda	hip
maluc	hip
malucs	hips
logar	hire
emplegar	hire
a emplegar	hiring
emplec	hiring
sieu	his
d'el	his
son	his
istòria	history
tustar	hit
succès	hit
còp	hit
mmm	Hmm
passatemps	hobby
téner	hold
contraròtle	hold
presa	hold
esperar	hold on
tenir bon	hold on
trauc	hole
vacanças	holiday
fèsta	holiday
van	hollow
curat	hollow
a l'ostal	home
ostal	home
devers	homework
sincèr	honest
onèst	honest
onèstament	honestly
mon còr	Honey
distincion onorifica	honor
onorar	honor
onor	honor
capòt	hood
capucha	hood
encrancar	hook
cròc	hook
anquet	hook
bombir	hop
auberon	hop
esperar	hope
amb d'astre	hopefully
desesperat	hopeless
sens espèr	hopeless
orizontal	horizontal
bana	horn
òrre	horrible
orror	horror
caval	horse
espital	hospital
ospitalitat	hospitality
aculhir	host
òste	host
ostil	hostile
cosent	hot
caud	hot
otèl	hotel
ora	hour
oras	hours
lotjar	house
ostal	house
ostalada	household
cossí	how
e tu	how about you
cossí va	how are you
cossí vas	how are you doing
cossí vas uèi	how are you doing today
cossí va uèi	how are you today
encantat de vos conéisser	how do you do
cossí es	how is
quantes	how many
quant	how much
amb quina frequéncia	how often
quin temps as	how old are you
cossí es anada la jornada	how was your day
cossí s'es passada ta nuèch	how was your night
pasmens	however
centre	hub
òme	hubby
calinhar	hug
calinhada	hug
enòrme	huge
uman	human
umil	humble
umiliar	humble
umid	humid
umiditat	humidity
cent	hundred
afamat	hungry
caçar	hunt
auragan	hurricane
afanatz-vos	hurry
afana-te	hurry
s'afanar	hurry
afana-te	hurry up
damatge	hurt
ferir	hurt
marit	husband
butassar	hustle
se prostituir	hustle
cabana	hut
igièna	hygiene
ieu	I
soi	I am
vau plan	I am fine
pòdi	I can
pòdi pas	I can't
fau	I do
òc	I do
o sabi pas	I do not know
compreni pas	I do not understand
non	I don't
sabi pas	I don't know
Compreni pas	I don't understand
compreni pas çò que volètz dire	I don't understand what you mean
compreni pas çò que vòles dire	I don't understand what you mean
vos compreni pas	I don't understand you
sabi pas	I don’t know
compreni pas	I don’t understand
pensi	i guess
aviái	I had
ai	I have
Soi anat	I have been
Soi estat	I have been
o espèri	I hope so
sabi	I know
m'agrada	I like
m'agradas	I like you
aimi	I love
aimi mon grand fraire	I love my big brother
aimi ma granda sòrre	I love my big sister
aimi mon paire	I love my father
aimi mon frairet	I love my little brother
aimi ma sorreta	I love my little sister
aimi ma maire	I love my mother
T'aimi	I love you
t'aimi talament	I love you so much
t'aimi tanben	I love you too
vòli dire	I mean
me mancas	I miss you
Me mancatz talament	I miss you so much
Me mancas talament	I miss you so much
vesi	I see
pensi	I think
compreni	I understand
vòli	I want
vos vòli veire	I want to see you
te vòli veire	I want to see you
te vòli	I want you
foguèri	I was
èri	I was
o farai	I will
Seriái	I would be
soi	I'm
vau plan	I'm fine
vau plan	I'm good
soi aicí	I'm here
m'es de grèu	I'm sorry
gèl	ice
glacet	ice cream
idèa	idea
ideal	ideal
identic	identical
identificar	identify
identitat	identity
idiòt	idiot
van	idle
futil	idle
en arrèst	idle
se	if
ignorar	ignore
marrit	ill
malaut	ill
illegal	illegal
malautiá	illness
iloano	Ilocano
imatge	image
imaginar	imagine
immediat	immediate
immediatament	immediately
immens	immense
impacte	impact
impactar	impact
aver d'impacte	impact
impacient	impatient
metre en plaça	implement
importar	import
importacion	import
important	important
impausar	impose
impossible	impossible
impressionar	impress
impression	impression
impressionant	impressive
melhorar	improve
melhorament	improvement
dins	in
en mai	in addition
En realitat	In fact
davant	in front of
per tal de	in order to
inapropriat	inappropriate
incitacion	incentive
incident	incident
inclure	include
inclusent	including
inclús	including
renda	income
gèina	inconvenience
aumentar	increase
aumentat	increased
aumentèt	increased
incresible	incredible
efectivament	indeed
independent	independent
Índia	India
indicar	indicate
indigèna	indigenous
individu	individual
individual	individual
industria	industry
inevitable	inevitable
enfant	infant
infeccion	infection
infinitat	infinity
inflamacion	inflammation
inflacion	inflation
influéncia	influence
influenciar	influence
informar	inform
informacion	information
ingredients	ingredients
eiretatge	inheritance
inicial	initial
iniciala	initial
iniciativa	initiative
ferit	injured
ferida	injury
innocent	innocent
innovacion	innovation
demanda d'entresenhas	inquiry
enquèsta	inquiry
fòl	insane
insècte	insect
insegur	insecure
que manca d'assegurança	insecure
inserir	insert
a l'interior	inside
dins	inside
perspicacitat	insight
primièra vista	insight
insistir	insist
insistisson	insist
insomnia	insomnia
inspiracion	inspiration
inspirar	inspire
installar	install
citar un exemple	instance
exemple	instance
requèsta	instance
instantanèu	instant
instant	instant
en luòga	instead
en luòga de	instead of
instruccions	instructions
instrument	instrument
orquestrar	instrument
insult	insult
insultar	insult
assegurança	insurance
garantida	insurance
intacte	intact
integritat	integrity
intellectual	intellectual
intelligéncia	intelligence
intelligent	intelligent
aver l'intencion	intend
aguèt l'intencion	intended
previst	intended
intens	intense
intencion	intention
interagir	interact
interaccion	interaction
interessar	interest
interès	interest
interessèt	interested
interessat	interested
interessant	interesting
interferir	interfere
intermediari	intermediate
intèrn	internal
internacional	international
estagi	internship
interpretar	interpret
interprèt	interpreter
interrompre	interrupt
entrevista	interview
entrevistar	interview
intim	intimate
anonciar	intimate
dins	into
presentar	introduce
presentacion	introduction
introduccion	introduction
introvertit	introvert
intuicion	intuition
estropiar	invalid
invalid	invalid
pas valid	invalid
inventar	invent
inventari	inventory
investir	invest
far una enquèsta	investigate
investigar	investigate
convit	invitation
invitacion	invitation
convidar	invite
sollicitar	invite
factura	invoice
facturar	invoice
implicar	involve
concernir	involve
implicat	involved
alisar	iron
de fèrre	iron
fèrre	iron
es	is
isla	island
isolat	isolated
question	issue
problèma	issue
questions	issues
desliura	issues
aquò	it
aquò es	it is
èra	it was
es	it's
va plan	it's ok
Es bon	It's okay
objècte	item
article	item
articles	items
son	its
soi	I’m
jaqueta	jacket
preson	jail
genièr	January
pòt	jar
maissa	jaw
gelós	jealous
gorrin	jerk
secodre	jerk
jòias	jewelry
trabalh	job
jogging	jogging
rejónher	join
aderir	join
jónher	join
en comun	joint
articulacion	joint
rostit	joint
galejada	joke
galejar	joke
jornalista	journalist
viatjar	journey
viatge	journey
gaug	joy
jutge	judge
jutjar	judge
chuc	juice
julh	july
sautar	jump
saut	jump
junh	june
quincalha	junk
just	just
sonque	just
fai-o	just do it
justícia	justice
justificar	justify
groenlandés	Kalaallisut
passionat	keen
penetrant	keen
viu	keen
gardar	keep
garda lo ritme	keep it up
contunha aital	keep it up
gardèt	kept
gardat	kept
bolidor	kettle
clau	key
donar un còp de pè	kick
còp de pè	kick
enfant	kid
cabrit	kid
badinar	kidding
ren	kidney
enfants	kids
tuar	kill
brave	kind
puslèu	kinda
aimablament	kindly
amabilitat	kindness
mèdium	king
de granda talha	king
rei	king
poton	kiss
potonejar	kiss
de cosina	kitchen
cosina	kitchen
sèrp volanta	kite
gaton	kitten
genolh	knee
sabiá	knew
sabèt	knew
cotèl	knife
cavalièr	knight
saber	know
coneissença	knowledge
conegut	known
concani	Konkani
krio	Krio
catalogar	label
etiqueta	label
etiquetar	label
trabalh	labor
man d'òbra	labor
trabalhar dur	labor
trabalh	labour
trabalhista	labour
manca	lack
mancar	lack
escala	ladder
dòna	lady
pausèt	laid
pausat	laid
lac	lake
anhèl	lamb
garrèl	lame
trace	lame
lampa	lamp
aterrar	land
tèrra	land
paisatge	landscape
lenga	language
lengatge	language
fauda	lap
torn	lap
lipar	lap
grand	large
larg	large
darrièr	last
darrièr mas pas lo mens important	last but not least
nom d'ostal	last name
tard	late
tardièr	late
darrièrament	lately
mai tard	later
darrièr	latest
darrièr	latter
rire	laugh
risent	laughing
rire	laughter
galupa	launch
lançar	launch
lançament	launch
bugada	laundry
bugadariá	laundry
drech	law
lei	law
pelenc	lawn
avocat	lawyer
pausar	lay
pondre	lay
installar	lay
jaç	layer
mesa en pagina	layout
disposicion	layout
peresós	lazy
plomb	lead
menar	lead
menaire	leader
fuèlha	leaf
divulgar	leak
pèrdre	leak
pèrda	leak
prim	lean
s'apiejar	lean
se clinar	lean
sautar	leap
aprendre	learn
erudicion	learning
aprendissatge	learning
logar	lease
arrendament	lease
mens	least
de cuèr	leather
cuèr	leather
laissar	leave
se n'anar	leave
laissa	leaves
fuèlhas	leaves
menat	led
menèt	led
esquèrra	left
laissat	left
partiguèt	left
camba	leg
eiretatge	legacy
juridic	legal
legal	legal
legenda	legend
legitim	legit
léser	leisure
prestar	lend
longor	length
mens	less
leiçon	lesson
laissar	let
obstacle	let
letra	letter
lachuga	lettuce
planièr	level
nivelar	level
nivèl	level
influéncia	leverage
efièch	leverage
responsabilitat	liability
andicap	liability
deute	liability
bibliotèca	library
lecar	lick
mentir	lie
messorga	lie
jaire	lie
jai	lies
messorgas	lies
vida	life
levar	lift
enauçar	lift
ascensor	lift
lum	light
lamp	lightning
aimar	like
coma	like
probable	likely
semblable	likewise
linha	line
alinhar	line
lingala	Lingala
ligar	link
ligam	link
leon	lion
liquid	liquid
lista	list
far una lista	list
escotar	listen
escotant	listening
escota	listening
literalament	literally
literatura	literature
lichièra	litter
cobrir	litter
rafatum	litter
pauc	little
pichon	little
viure	live
fetge	liver
viu	lives
vidas	lives
biais de viure	living
vida	living
vivent	living
sala d'estar	living room
lusèrt	lizard
carga	load
cargar	load
pigrejar	loaf
pan	loaf
prèst	loan
prestar	loan
local	local
endrech	location
flòta	lock
clavar	lock
sarralha	lock
confinament	lockdown
soc	log
enregistrar	log
registre	log
espetat de rire	lol
solitari	lonely
long	long
fa de temps que t'ai pas vist	long time no see
agach	look
aparéncia	look
agachar	look
far una bloca	loop
bloca	loop
escapat	loose
flac	loose
liure	loose
sénher	lord
pèrdre	lose
pèrda	loss
perdut	lost
pèça	lot
grand nombre	lot
destin	lot
exuberant	loud
fòrt	loud
pigrejar	lounge
salon	lounge
aimar	love
amor	love
t'aimi	love you
adorable	lovely
agradiu	lovely
bram	low
bas	low
baissar	lower
inferior	lower
leial	loyal
leialtat	loyalty
astre	luck
astruc	lucky
luganda	Luganda
bagatges	luggage
bonha	lump
tròç	lump
dinnar	lunch
palmons	lungs
de luxe	luxury
luxe	luxury
mentir	lying
que se tròba	lying
jasent	lying
maquina	machine
furiós	mad
baug	mad
madama	madam
fach	made
faguèt	made
revista	magazine
magnific	magnificent
serviciala	maid
femna de neteja	maid
canonada	main
principal	main
manténer	maintain
entreten	maintenance
maitili	Maithili
matèria principala	major
màger	major
major	major
majoritat	majority
màger part	majority
far	make
fabricar	make
maquilhatge	make up
se maquilhar	make up
mascle	male
masculin	male
centre comercial	mall
far gerir per una persona	man
òme	man
dirigir	manage
gerir	manage
reüssir	manage
gestion	management
direccion	management
director	manager
obligatòri	mandatory
manifèst	manifest
manifestar	manifest
manipular	manipulate
manièra	manner
comportament	manner
manual	manual
mantes	many
plan polit anniversari	many many happy returns of the day
desfilar	march
marcha	march
marge	margin
mercat	market
maridatge	marriage
maridat	married
se maridèt amb	married
masqueta	mask
se masquetar	mask
massa	mass
messa	mass
de massa	mass
massís	massive
dominar	master
mèstre	master
correspondre	match
luquet	match
partida	match
s'acoblar	mate
collèga	mate
partenari	mate
documentacion	material
material	material
matematicas	math
matièra	matter
èsser important	matter
maturitat	maturity
se pòt	may
benlèu	maybe
ieu	me
ieu tanben	me too
repais	meal
marrit	mean
significar	mean
significacion	meaning
significant	meaning
significa	means
mejans	means
significat	meant
signifiquèt	meant
supausat	meant
d'aqueste temps	meanwhile
mesurar	measure
mesura	measure
mesuras	measures
carn	meat
medical	medical
medecina	medicine
medicament	medicine
meditacion	meditation
biais	medium
mejan	medium
encontrar	meet
rescontre	meeting
reünion	meeting
manipuri	Meiteilon
fondre	melt
se fondre	melt
remembres	memories
memòria	memory
mental	mental
mencion	mention
mencionar	mention
mencionat	mentioned
mencionèt	mentioned
mentor	mentor
mercadièr	merchant
pietat	mercy
mercé	mercy
purament	merely
bon Nadal	merry christmas
gastar	mess
desòrdre	mess
rambalh	mess
messatge	message
brut	messy
complicat	messy
desordenat	messy
metalh	metal
metallic	metal
metòde	method
mirgas	mice
mièg	middle
mejan	middle
mièjanuèch	midnight
poténcia	might
se poiriá	might
suau	mild
leugièr	mild
mira	milestone
militar	military
mólzer	milk
lach	milk
milion	million
opinion	mind
far atencion a	mind
esperit	mind
estat d'esperit	mindset
mieu	mine
se barrejar	mingle
menor	minor
minuta	minute
minutas	minutes
miraculós	miracle
miracle	miracle
rebatre	mirror
miralh	mirror
variat	miscellaneous
coquinòt	mischievous
miserable	miserable
malaürós	miserable
misèria	misery
madomaisèla	miss
mancar	miss
me mancas	miss you
mancant	missing
desaparegut	missing
mission	mission
bruma	mist
confondre	mistake
error	mistake
mizo	Mizo
mobil	mobile
se trufar	mock
maqueta	model
modèl	model
moderat	moderate
moderar	moderate
modèrn	modern
modèst	modest
moste	moist
umiditat	moisture
motle	mold
modelar	mold
taupa	mole
gran de beutat	mole
mamà	mom
moment	moment
diluns	monday
argent	money
observador	monitor
monitor	monitor
susvelhar	monitor
monina	monkey
mes	month
umor	mood
lunatic	moody
luna	moon
moral	moral
morala	moral
mai	more
de mai	moreover
del matin	morning
matin	morning
ipotèca	mortgage
la màger part	most
lo mai	most
principalament	mostly
maternar	mother
maire	mother
mocion	motion
movement	motion
motivacion	motivation
montanha	mountain
mirga	mouse
boca	mouth
intrada	mouth
mòure	move
bolegar	move
mudar	move
movement	movement
film	movie
dòna	mrs
fòrça	much
fanga	mud
taça	mug
muscle	muscle
musèu	museum
proliferar	mushroom
bolet	mushroom
musica	music
deure	must
mut	mute
amortir	mute
mutual	mutual
mon	my
Mon car	My dear
mon amic	my friend
Mon aerolisaire es clafit d'anguilas	My hovercraft is full of eels
mon amor	my love
mon nom es	my name is
lo plaser es mieu	my pleasure
ieu meteis	myself
misteriós	mysterious
mistèri	mystery
mite	myth
clavèl	nail
ongla	nail
arrestar	nail
innocent	naive
nom	name
citar	name
narracion	narrative
narratiu	narrative
estrech	narrow
reduire	narrow
marridàs	nasty
nacional	national
nacionalitat	nationality
nadiu	native
indigèna	native
natural	native
natural	natural
natura	nature
nausèa	nausea
prèp	near
pròche	nearby
gaireben	nearly
net	neat
sonhat	neat
necessari	necessary
còl	neck
galet	neck
collar	necklace
aver besonh de	need
besonh	need
negatiu	negative
mancament	neglect
negligir	neglect
negociar	negotiate
vesin	neighbor
vesinatge	neighborhood
barri	neighborhood
tanpauc	neither
ne	neither
nebot	nephew
intelligentàs	nerd
nerviós	nervous
nis	nest
ret	net
ret	network
neutre	neutral
jamai	never
abandones pas jamai	never give up
es pas grèu	never mind
fa pas res	nevermind
çaquelà	nevertheless
novèl	new
nòvas	news
al costat de	next
aprèp	next
venent	next
al costat de	next to
agradiu	nice
encantat de vos conéisser	nice to meet you
encantat de te conéisser	nice to meet you
neboda	niece
nuèch	night
cachavièlha	nightmare
nòu	nine
equipa	nine
dètz-e-nòu	nineteen
nonanta	ninety
Non	No
pas cap de problèma	no problem
pas ges	no way
degun	nobody
bruch	noise
brusent	noisy
cap	none
miègjorn	noon
nani	nope
ni	nor
normal	normal
nòrd	north
fosegar	nose
nas	nose
nostalgic	nostalgic
pas	not
pas ges	not at all
pas marrit	not bad
pas ara	Not now
pas encara	not yet
notar	note
nòta	note
reputat	noted
indicat	noted
res	nothing
atencion	notice
remarcar	notice
nòta	notice
remarcat	noticed
nom	noun
noms	nouns
roman	novel
original	novel
novembre	november
ara	now
a l'ora d'ara	nowadays
nosença	nuisance
nul	null
ensucat	numb
agrepit	numb
nombre	number
comptar	number
numèro	number
infirmièra	nurse
alachar	nurse
noiriça	nurse
caluc	nut
escrova	nut
notz	nut
muscada	nutmeg
nutricion	nutrition
jurament	oath
obesitat	obesity
obesir	obey
obtemperar	obey
objècte	object
far una objeccion	object
objectiu	objective
obligacion	obligation
escur	obscure
observacion	observation
susvelhança	observation
observar	observe
remarcar	observe
obsedit	obsessed
obsession	obsession
obsolet	obsolete
obstacle	obstacle
obtenir	obtain
obtenguèt	obtained
obtengut	obtained
evident	obvious
evidentament	obviously
ocasionalament	occasionally
Occitan	Occitan
profession	occupation
ocupacion	occupation
ocupat	occupied
se debanar	occur
se debanèt	occurred
se debana	occurs
ocean	ocean
octobre	october
estranh	odd
impar	odd
probabilitats	odds
de	of
de segur	of course
atudat	off
desactivat	off
ofensiu	offensive
ofensiva	offensive
ofèrta	offer
proposicion	offer
prepausar	offer
foncion	office
burèu	office
oficial	official
representant	official
sovent	often
Ò	Oh
ò, a debon	oh really
petròli	oil
òli	oil
òc ben	ok
òc ben, car amic	ok dear
òc ben, mon còr	ok honey
òc ben, mon amor	ok my love
òc ben	okay
òc ben, nenona	okay baby
òc ben, car amic	okay dear
òc ben mon amor	okay honey
òc ben mon amor	okay my love
vièlh	old
en marcha	on
sus	on
tre que	once
un còp	once
un	one
una lenga es pas jamai pro	one language is never enough
ceba	onion
en linha	online
unic	only
sonque	only
obèrt	open
torneg	open
operacion	operation
opinion	opinion
vejaire	opinion
oportunitats	opportunities
oportunitat	opportunity
escasença	opportunity
a l'opausat	opposite
opausat	opposite
optimista	optimistic
opcion	option
opcional	optional
o	or
irange	orange
òrdre	order
comandar	order
ordinari	ordinary
organizacion	organization
orientacion	orientation
origina	origin
original	original
oromo	Oromo
orfanèl	orphan
venir orfanèl	orphan
autre	other
autrament	otherwise
senon	otherwise
deuriá	ought
nòstre	our
Nòstra mission: permetre a totes, de pertot, de comprendre lo mond e de s'exprimir a travèrs de las lengas	Our mission: to enable everyone, everywhere to understand the world and express themselves across languages.
Nòstra mission: organizar las informacions mondialas e las far venir accessiblas e utilas universalament	Our mission: to organize the world's information and make it universally accessible and useful.
defòra	out
a l'exterior	out
resultat	outcome
tenguda	outfit
sortent	outgoing
sociable	outgoing
presa de corrent	outlet
botiga d'una marca	outlet
esbòç	outline
esboçar	outline
defòra	outside
exterior	outside
excepcional	outstanding
impagat	outstanding
forn	oven
sus	over
acabat	over
ailaluènh	over there
globalament	overall
global	overall
véncer	overcome
subremontar	overcome
pensar tròp	overthinking
despassat	overwhelmed
aclapant	overwhelming
deure	owe
chòt	owl
possedir	own
pròpri	own
proprietari	owner
buòu	ox
pas	pace
ritme	pace
paquet	pack
condicionar	pack
far las malas	pack
paquet	package
empaquetar	package
pagat	paid
doler	pain
dolor	pain
pena	pain
pénher	paint
pintura	paint
penhent	painting
pintura	painting
aparelhar	pair
parelh	pair
pallejar	pale
palle	pale
Rampalms	palm
palmièr	palm
palma	palm
padena	pan
caçairòla	pan
pandèmia	pandemic
panica	panic
se desvariar	panic
eslip	pants
besalena	pants
pantalon	pants
papièr	paper
dever	paper
jornal	paper
paradís	paradise
parallèl	parallel
paquet	parcel
perdonar	pardon
perdon	pardon
parents	parents
estacionar	park
pargue	park
repetir nèciament	parrot
papagai	parrot
jolverd	parsley
separar	part
part	part
ròtle	part
participar	participate
participa	participate
particular	particular
particularament	particularly
companh	partner
sòci	partner
fèsta	party
far la fèsta	party
passa	pass
passar	pass
reüssir	pass
passatge	passage
passèt	passed
reüssit	passed
passat	passed
passion	passion
passionat	passionate
passiu	passive
senhal	password
delà	past
mai de	past
passat	past
placa	patch
bendèl	patch
camin	path
trajectòria	path
patetic	pathetic
pietadós	pathetic
paciéncia	patience
pacient	patient
modelar	pattern
modèl	pattern
motiu	pattern
pausa	pause
trepador	pavement
cauçada	pavement
salari	pay
pagar	pay
paga	pay
recompensa	payment
pagament	payment
patz	peace
pacific	peaceful
pasible	peaceful
préssec	peach
pic	peak
cima	peak
aténher lo maximum	peak
pera	pear
peses	peas
peculiar	peculiar
pissar	pee
pelar	peel
agachar fixament	peer
par	peer
pars	peers
estilò	pen
gredon	pencil
en cors	pending
en espèra	pending
gents	people
poblar	people
pebre	pepper
pebrar	pepper
pebron	pepper
percebre	perceive
percepcion	perception
perfièch	perfect
complir	perfect
far un espectacle	perform
interpretar	perform
executar	perform
representacion	performance
performança	performance
bensai	perhaps
periòde	period
règlas	period
permanent	permanent
permission	permission
tolerar	permit
permís	permit
permetre	permit
perseverança	perseverance
persistent	persistent
persona	person
personal	personal
personalitat	personality
ponch de vista	perspective
perspectiva	perspective
persuadir	persuade
pervers	pervert
pervertir	pervert
deformar	pervert
animal domestic	pet
sincronizar	phase
fasa	phase
fenomèn	phenomenon
filosofia	philosophy
telefòn	phone
telefonar	phone
fòto	photo
expression	phrase
examèn medical	physical
fisic	physical
material	physical
pic	pick
causir	pick
culhir	pick
recampar	pick up
fotografia	picture
imatge	picture
representar	picture
amassaar	piece
pèça	piece
tròç	piece
tròces	pieces
pòrc	pig
colomb	pigeon
apilar	pile
pila	pile
pausar	pillow
aurelhièr	pillow
pilotar	pilot
pilòt	pilot
testar	pilot
espillar	pin
espilla	pin
ananàs	pineapple
ròsa	pink
marcar	pit
clòta	pit
mina	pit
terrenh	pitch
lançar	pitch
pega	pitch
damatge	pity
aver de compassion	pity
pietat	pity
endrech	place
plaçar	place
plaças	places
plaga	plague
pèsta	plague
simple	plain
plana	plain
ordinari	plain
planificar	plan
plan	plan
platana	plane
plan	plane
avion	plane
planta	plant
fabrica	plant
plantar	plant
plantas	plants
sieta	plate
placa	plate
plataforma	platform
cai	platform
jogar	play
jogant	playing
jogar	playing
agradiu	pleasant
aimable	pleasant
per plaser	please
content	pleased
agradèt	pleased
plaser	pleasure
engatjament	pledge
s'engatjar	pledge
plen	plenty
intriga	plot
complotar	plot
complòt	plot
presa	plug
brancar	plug
pruna	plum
plombièr	plumber
plural	plural
podcast	podcast
poèma	poem
poesia	poetry
indicar	point
ponch	point
moment	point
poison	poison
empoisonar	poison
verin	poison
polícia	police
contrarotlar	police
polícia	policy
politica	policy
cortés	polite
pollucion	pollution
pesquièr	pond
bilhard	pool
sompa	pool
piscina	pool
cagar	poop
cagada	poop
paure	poor
papà	pop
esclatar	pop
pòp	pop
popular	popular
populacion	population
de pòrc	pork
pòrc	pork
papa de civada	porridge
pòrt	port
posicionar	position
posicion	position
positiu	positive
afirmatiu	positive
possedir	possess
possession	possession
possessiu	possessive
possible	possible
pal	post
pòst	post
postar	post
ajornan	postpone
ajornar	postpone
patana	potato
potencial	potential
liura	pound
pauretat	poverty
poténcia	power
poder	power
electricitat	power
potent	powerful
practic	practical
pragmatic	practical
practica	practice
practicar	practice
burèu	practice
lausar	praise
laus	praise
farcejada	prank
pregan	pray
pregar	pray
preciós	precious
precisar	precise
precís	precise
precisament	precisely
predire	predict
preferir	prefer
preferéncia	preference
prens	pregnant
prejutjat	prejudice
prejudici	prejudice
portar prejudici	prejudice
premissas	premises
lòcs	premises
prima	premium
de primièr òrdre	premium
preparacion	preparation
preparar	prepare
preparat	prepared
preposicion	preposition
preséncia	presence
present	present
presentacion	presentation
resèrva	preserve
preservar	preserve
president	president
apiejar	press
incitar	press
premsa	press
pression	pressure
far pression	pressure
far semblant	pretend
imaginari	pretend
pretendre	pretend
polit	pretty
pro	pretty
prevenir	prevent
empachar	prevent
precedent	previous
secutar	prey
presa	prey
fixar lo prètz	price
prètz	price
supèrbia	pride
ufan	pride
prèire	priest
primari	primary
primordial	primary
primièr	prime
principal	prime
princessa	princess
director	principal
principal	principal
prealable	prior
prior	prior
prioritat	priority
carceral	prison
preson	prison
privacitat	privacy
soldat	private
privat	private
privilègi	privilege
privilegiar	privilege
prèmi	prize
probablament	probably
problèma	problem
procedura	procedure
avançar	proceed
contunhar	proceed
procedir	proceed
transformar	process
procediment	process
produire	produce
provocar	produce
produches	produce
resultat	product
produch	product
produccion	production
profession	profession
professional	professional
perfil	profile
profièch	profit
profechar	profit
prigond	profound
progrès	progress
progressar	progress
projècte	project
preveire	project
projectar	project
proeminent	prominent
eminent	prominent
promesa	promise
prometre	promise
promòure	promote
promocion	promotion
rapid	prompt
pontual	prompt
incitar	prompt
portat	prone
pronoms	pronouns
prononciacion	pronunciation
pròva	proof
espròva	proof
adequat	proper
corrèctament	properly
degudament	properly
proprietats	properties
bens personals	property
proprietat	property
proposicion	proposal
demanda de maridatge	proposal
prospectar	prospect
perspectiva	prospect
prosperitat	prosperity
prospèr	prosperous
protegir	protect
protegís	protect
ufanós	proud
altiu	proud
se revelar	prove
provar	prove
fornir	provide
fornit	provided
forniguèt	provided
a condicion que	provided
província	province
provision	provision
pubertat	puberty
public	public
tirar	pull
s'esquiçar	pull
traccion	pull
cogorla	pumpkin
pontual	punctual
pupilla	pupil
escolan	pupil
aquesir	purchase
crompa	purchase
pur	pure
violet	purple
prepaus	purpose
sac de man	purse
pòrtamoneda	purse
perseguir	pursue
percaç	pursuit
recerca	pursuit
butar	push
metre	put
qualificacion	qualification
qualitat	quality
quantitat	quantity
metre en quarantena	quarantine
quarantena	quarantine
se disputar	quarrel
disputa	quarrel
trimèstre	quarter
quart	quarter
quichoa	Quechua
reina	queen
estranh	queer
omosexual	queer
demandar	query
question	query
ponch d'interrogacion	query
questionar	question
question	question
coa	queue
fila d'espèra	queue
rapid	quick
lèu	quick
rapidament	quickly
calma	quiet
tranquillizar	quiet
plumon	quilt
abandonar	quit
pro	quite
completament	quite
questionari	quiz
citacion	quotation
cors	quotation
citar	quote
citacion	quote
fixar un prètz	quote
cita	quotes
citacions	quotes
conilh	rabbit
raça	race
corsa	race
far la corsa	race
ràbia	rage
pluèja	rain
plòure	rain
aumentar	raise
aumentacion	raise
aumentat	raised
levèt	raised
levat	raised
correguèt	ran
aleatòri	random
cadena	range
gamma	range
portada	range
rapid	rapid
rapidament	rapidly
rar	rare
rarament	rarely
temerari	rash
erupcion	rash
rat	rat
tarifa	rate
taus	rate
avalorar	rate
puslèu	rather
rapòrt	ratio
racional	rational
crus	raw
brut	raw
a prepaus	re
portada	reach
aténher	reach
atenhèt	reached
atench	reached
reaccion	reaction
lectura	read
legir	read
lectura	reading
legissent	reading
preparar	ready
prèst	ready
real	real
realitat	reality
realizar	realize
realizat	realized
realizèt	realized
vertadièrament	really
arrièr	rear
abalir	rear
tafanari	rear
rason	reason
rasonar	reason
rasonable	reasonable
demandar de tornar	recall
ramentar	recall
memòria	recall
recepcion	receipt
albaran	receipt
recebre	receive
recebut	received
recebèt	received
recent	recent
recentament	recently
recepcion	reception
acuèlh	reception
recèpta	recipe
temerari	reckless
imprudent	reckless
reconeissença	recognition
reconéisser	recognize
recomandar	recommend
recomandat	recommended
enregistrar	record
recòrd	record
recuperar	recover
garir	recover
recuperacion	recovery
represa	recovery
rectangle	rectangle
comunista	red
roge	red
rescatar	redeem
expiar	redeem
redencion	redemption
reduire	reduce
redondant	redundant
se referir	refer
referéncia	reference
far referéncia	reference
rebatre	reflect
perpensar	reflect
rebat	reflection
reflexion	reflection
s'abstenir	refrain
refrigerador	refrigerator
remborsar	refund
remborsament	refund
degalhs	refuse
refusar	refuse
refusat	refused
refusèt	refused
esgard	regard
concernissent	regarding
en çò que concernís	regarding
independentament	regardless
sens tenir compte	regardless
concernís	regards
salutacions	regards
region	region
s'inscriure	register
enregistrar	register
registre	register
pentiment	regret
plànher	regret
regular	regular
ordinari	regular
regularament	regularly
fòragetar	reject
aver un ligam amb	relate
relatar	relate
ligat	related
parent	related
aparentat	related
parentat	relationship
relacion	relationship
parent	relative
relatiu	relative
parents	relatives
relaxar	relax
relaxa-te	relax
far sortir	release
liberar	release
liberat	released
mes a la venda	released
pertinent	relevant
important	relevant
fisable	reliable
ajuda	relief
solaç	relief
relèu	relief
solaçar	relieve
solacèt	relieved
solaçat	relieved
religion	religion
religiós	religious
reticent	reluctant
dependre	rely
aver fisança	rely
demorar	remain
restant	remaining
remarcable	remarkable
remèdi	remedy
remediar	remedy
remembratz-vos	remember
remembrar	remember
remembra-te	remember
remembrar	remind
nòta	reminder
bremba-te	reminder
telecomanda	remote
a distància	remote
levar	remove
se desfar de	remove
rendre	render
logar	rent
loguièr	rent
reparacion	repair
reparar	repair
repetir	repeat
repetís	repeat
tornar plaçar	replace
remplaça	replace
remplaçar	replace
respondre	reply
responsa	reply
raportar	report
rapòrt	report
senhalar	report
representa	represent
representar	represent
reputacion	reputation
demanda	request
exigir	require
demandar	require
exigit	required
requesit	required
secórrer	rescue
salvament	rescue
recercar	research
recerca	research
retirar	resemble
ressentiment	resentment
resèrva	reservation
reservacion	reservation
resèrva	reserve
reservar	reserve
intèrn	resident
resident	resident
abandonar	resign
demissionar	resign
resisténcia	resilience
resilient	resilient
elastic	resilient
resistir	resist
resisténcia	resistance
resolucion	resolution
se resòlver	resolve
resòlver	resolve
resolucion	resolve
establiment toristic	resort
recórrer	resort
recors	resort
ressorgas	resources
respectar	respect
respècte	respect
respondre	respond
reagir	respond
responsa	response
reaccion	response
responsabilitat	responsibility
responsable	responsible
se pausar	rest
descansa en patz	rest in peace
restaurant	restaurant
restaurar	restore
restrénher	restrict
resultat	result
resultar	result
resultats	results
resumir	resume
reprendre	resume
curriculum	resume
vendre pel menut	retail
venda pel menut	retail
servar	retain
reténer	retain
retencion	retention
conservacion	retention
retirat	retired
se retirar	retreat
retirada	retreat
recuperar	retrieve
tornar	return
restitucion	return
retorn	return
revelar	reveal
revelacion	reveal
revelèt	revealed
revelat	revealed
vengança	revenge
se vengar	revenge
revengut	revenue
contrari	reverse
envèrs	reverse
inversar	reverse
examèn	review
revista	review
examinar	review
revisar	revise
revision	revision
revolucion	revolution
recompensar	reward
recompensa	reward
ritme	rhythm
costèla	rib
ris	rice
ric	rich
desbarrassar	rid
virada	ride
montar	ride
ridicul	ridiculous
drech	right
en aqueste moment	right now
sulpic	right now
rigid	rigid
tindar	ring
sonar	ring
anèl	ring
refrescar	rinse
susmauta	riot
estraçar	rip
fendascla	rip
sensual	ripe
madur	ripe
aumentar	rise
créisser	rise
aumentacion	rise
riscar	risk
risca	risk
rival	rival
flum	river
riu	river
rota	road
rostir	roast
rostit	roast
robust	robust
rocàs	rock
breçar	rock
brandir	rock
cana	rod
barra	rod
ròtle	role
rotlèu	roll
panet	roll
lançar	roll
cobèrt	roof
teulat	roof
cobrir	roof
cambra	room
espaci	room
membre	room
enrasigar	root
rasic	root
còrda	rope
ligar amb una còrda	rope
poirit	rotten
rude	rough
esbòç	rough
rufe	rough
brutalament	roughly
aproximativament	roughly
redond	round
rota	route
itinerari	route
abitual	routine
rotina	routine
brega	row
remar	row
reng	row
se fretar	rub
fretar	rub
fretament	rub
goma	rubber
caochoc	rubber
absurditats	rubbish
bordilhas	rubbish
descortés	rude
tapís	rug
roïna	ruin
roïnar	ruin
règla	rule
règla	ruler
govèrna	rules
règlas	rules
córrer	run
cors	run
en corrent	running
corsa	running
rural	rural
se precipitar	rush
ronçada	rush
sac	sack
escampar	sack
saquejar	sack
sagrat	sacred
sacrificar	sacrifice
sacrifici	sacrifice
còfre fòrt	safe
segur	safe
bon vòl	safe flight
seguretat	safety
savi	sage
sàlvia	sage
dich	said
diguèt	said
navegar	sail
vela	sail
navegacion	sailing
rason	sake
esgard	sake
salari	salary
venda	sale
salmon	salmon
sal	salt
meteis	same
exactament parièr	Same here
escapolon	sample
tastar	sample
sabla	sand
ponçar	sand
sansrit	Sanskrit
sarcastic	sarcastic
insolent	sassy
assetat	sat
s'assetèt	sat
satisfaccion	satisfaction
satisfaguèt	satisfied
satisfach	satisfied
satisfar	satisfy
satisfasent	satisfying
dissabte	Saturday
saussissa	sausage
salvatge	savage
salvar	save
levat	save
estalviar	save
vegèt	saw
sèrra	saw
dire	say
adagi	say
escala	scale
balança	scale
escata	scale
escrocariá	scam
far una cicatritz	scar
cicatritz	scar
escàs	scarce
pauruc	scared
espaurugat	scared
eissarpa	scarf
esglasiant	scary
pauruc	scary
escampilhèt	scattered
escampilhat	scattered
scèna	scene
païsatge	scenery
decòr	scenery
sentir	scent
odor	scent
preveire sus un orari	schedule
orari	schedule
escòla	school
sciéncia	science
scientific	scientist
scientifics	scientists
talhants	scissors
repotegar	scold
portada	scope
marcar	score
marca	score
ferralha	scrap
fragment	scrap
gratar	scratch
grafinhar	scratch
cridar	scream
crit	scream
ecran	screen
crivelar	screen
depistar	screen
vissar	screw
engulhar	screw
vitz	screw
escritura	script
scenari	script
mar	sea
fòca	seal
sagelar	seal
sagèl	seal
cercar	search
recerca	search
sason	season
assasonar	season
se sèire	seat
far sèire	seat
sèti	seat
segond	second
segonda	second
secret	secret
seccion	section
securizat	secure
obtenir	secure
barrar	secure
seguretat	security
veire	see
al reveire	see you
a totara	see you later
a lèu	see you soon
a deman	see you tomorrow
grana	seed
cercar	seek
semblar	seem
semblan	seem
sembla	seems
vist	seen
sasir	seize
crisi d'epilepsia	seizure
rarament	seldom
causir	select
se	self
autogarison	self healing
s'autogarir	self healing
egoista	selfish
vendre	sell
mandar	send
manda-me ta fòto	send me your picture
mandatz-me vòstra fòto	send me your picture
senior	senior
sen	sense
sentir	sense
sens	sense
senat	sensible
sensible	sensitive
enviat	sent
envièt	sent
frasa	sentence
condemnar	sentence
frasas	sentences
condemna	sentences
separar	separate
distint	separate
separat	separate
sepedi	Sepedi
setembre	september
sequéncia	sequence
seria	series
grèu	serious
seriós	serious
seriosament	seriously
servisson	serve
servir	serve
servici	serve
far una revision	service
entreten	service
servici	service
session	session
sesilha	session
ensems	set
installar	set
metre en plaça	set up
configurar	set up
reglatge	setting
paramètre	setting
reglar	settle
s'installar	settle
sèt	seven
dètz-e-sèt	seventeen
setanta	seventy
mantes	several
sevèr	severe
grèu	severe
cordurar	sew
suau	sh
matís	shade
ombra	shade
paralum	shade
ombra	shadow
seguir discretament	shadow
brandida	shake
secodre	shake
agitar	shake
superficial	shallow
vergonha	shame
far vergonha	shame
forma	shape
faiçonar	shape
partejar	share
part	share
accion	share
viu	sharp
brusc	sharp
afilat	sharp
ela	she
a	she has
es	she is
mudar	shed
cabana	shed
versar	shed
moton	sheep
fuèlh	sheet
lençòl	sheet
laissa	shelf
obús	shell
bombardar	shell
cauquilha	shell
abrigar	shelter
abric	shelter
protegir	shield
bloquièr	shield
pòst	shift
cambiar	shift
brilhar	shine
treslusor	shine
naviri	ship
expedir	ship
nau	ship
transpòrt maritim	shipping
fraisses de transpòrt	shipping
camisa	shirt
sabatas	shoes
gitèla	shoot
tirar	shoot
botiga	shop
crompant	shopping
crompas	shopping
estançonar	shore
còsta	shore
cort	short
pichon de talha	short
penuria	shortage
tir	shot
tirat	shot
tirèt	shot
deuriá	should
espatla	shoulder
cargar sus l'espatla	shoulder
cridar	shout
crit	shout
espectacle	show
mostrar	show
mòstra-me	show me
docha	shower
raissa	shower
cambaròt	shrimp
s'apichonir	shrink
psiquiatra	shrink
restrechir	shrink
clavat	shut
claure	shut
se calar	shut up
cala-te	shut up
timid	shy
fraire o sòrre	sibling
fraires e sòrres	siblings
malaut	sick
se metre del costat	side
costat	side
lateral	side
sospir	sigh
sospirar	sigh
vision	sight
vista	sight
visita toristica	sightseeing
panèl	sign
signe	sign
signar	sign
signatura	signature
significatiu	significant
silenci	silence
silenciós	silent
de seda	silk
seda	silk
nèci	silly
argent	silver
d'argent	silver
similar	similar
nèci	simp
simple	simple
simultanèament	simultaneously
dempuèi	since
sincèr	sincere
sincèrament	sincerely
cantar	sing
cantaire	singer
celibatari	single
sol	single
aiguièr	sink
s'enfonzar	sink
Sénher	Sir
sòrre	sister
conhada	sister in law
aver un sèti	sit
demorar	sit
seire	sit
site	site
situacion	situation
sièis	six
sètze	sixteen
seissanta	sixty
talha	size
abiletat	skill
competéncia	skill
competéncias	skills
pèl	skin
pelar	skin
magre	skinny
sautar	skip
gonèla	skirt
cèl	sky
trabalhar coma un esclau	slave
esclau	slave
sòm	sleep
dormir	sleep
a dormir	sleeping
dorment	sleeping
dormilhós	sleepy
marga	sleeve
talhon	slice
davalar	slide
diapositiva	slide
lisar	slide
leugièrament	slightly
feble	slim
prim	slim
mermar	slip
lisar	slip
penda	slope
fenda	slot
posicion	slot
lent	slow
alentir	slow
rotinièr	slow
lentament	slowly
petit	small
afirolat	smart
intelligent	smart
sentir	smell
odor	smell
sorrire	smile
fum	smoke
regular	smooth
doç	smooth
lis	smooth
crostilhada	snack
cagaraula	snail
sèrp	snake
serpejar	snake
subte	snap
fòto	snap
copar	snap
nèu	snow
nevar	snow
talament	so
alara	so
tan manhac	so cute
fins ara	so far
trempar	soak
sabon	soap
sabonar	soap
sòbre	sober
seriós	sober
fotbòl	soccer
social	social
societat	society
caucetas	socks
mofle	soft
mòl	soft
doç	soft
logicial	software
embrutir	soil
sòl	soil
vendut	sold
agotat	sold out
soldat	soldier
sòla	sole
unic	sole
solid	solid
solucion	solution
resòlvre	solve
qualque	some
qualqu'un	somebody
per una rason o una autra	somehow
d'un biais o d'un autre	somehow
qualqu'un	someone
quicòm	something
de còps que i a	sometimes
cançon	song
cant	song
lèu	soon
sofisticat	sophisticated
sorani	Sorani
plaga	sore
dolorós	sore
irritat	sore
garganta irritada	sore throat
pena	sorrow
Perdon	Sorry
mena	sort
recaptar	sort
cerquèt	sought
recercat	sought
soul	soul
arma	soul
meitat	soulmate
semblar	sound
son	sound
solid	sound
sopa	soup
agre	sour
agrejar	sour
origina	source
font	source
sud	south
espaci	space
plaça	space
espaçar	space
espam	spam
durada	span
s'estendre	span
espanhòl	Spanish
laissar la vida	spare
de recambi	spare
parlar	speak
especial	special
espècia	species
precís	specific
especific	specific
espectacular	spectacular
discors	speech
lengatge	speech
sens votz	speechless
se precipitar	speed
velocitat	speed
sortilègi	spell
anonciar	spell
letrejar	spell
passar	spend
despensar	spend
despensèt	spent
despensat	spent
pebrat	spicy
pujada	spike
poncha	spike
téisser	spin
far virar	spin
torn	spin
espinarc	spinach
esperit	spirit
escupinha	spit
escupir	spit
esplendid	splendid
division	split
scission	split
devesir	split
gastar	spoil
gasta	spoil
viciat	spoiled
tarat	spoiled
espontanèu	spontaneous
culhièr	spoon
servir amb un culhièr	spoon
plaça	spot
detectar	spot
taca	spot
espós	spouse
espandir	spread
font	spring
prima	spring
rajar	spring
cairat	square
categoric	square
placeta	square
pression	squeeze
quichar	squeeze
calamar	squid
esquiròl	squirrel
sant	st
escotelar	stab
estable	stable
equilibrat	stable
apilar	stack
molon	stack
personal	staff
equipa	staff
scèna	stage
etapa	stage
organizar	stage
tacar	stain
taca	stain
escalièr	stairs
participacion	stake
riscar	stake
escomesa	stake
secutar	stalk
tija	stalk
estagnar	stall
taulièr	stall
cabina	stall
sagelar	stamp
sagèl	stamp
èsser de pè	stand
se levar	stand
taulièr	stand
estandard	standard
estela	star
vedeta	star
figurar	star
començament	start
començar	start
comencèt	started
començat	started
morent de talent	starving
afamat	starving
estat	state
declaracion	statement
relevat	statement
estacion	station
estatua	statue
prestigi	status
estatut	status
demorar	stay
siá prudent	stay safe
estable	steady
regular	steady
constant	steady
bistèc	steak
se desplaçar furtivament	steal
raubar	steal
vapor	steam
de vapor	steam
còire a la vapor	steam
d'acièr	steel
siderurgic	steel
acièr	steel
abrupte	steep
restancar	stem
tija	stem
pas	step
far un pas en avant	step
mesura	step
pegar	stick
baston	stick
cadavre	stiff
rigid	stiff
encara	still
immobil	still
fiçon	sting
avar	stingy
agitar	stir
estòc	stock
estocar	stock
raubat	stolen
estomac	stomach
de pèira	stone
pèira	stone
restèt de pè	stood
restat de pè	stood
escabèl	stool
arrèst	stop
arrestar	stop
espaci d'entrepausatge	storage
entrepausatge	storage
botiga	store
resèrva	store
entrepausar	store
tempèsta	storm
assalhir	storm
tempestar	storm
istòria	story
nivèl	story
fornet	stove
drech	straight
eterosexual	straight
tot drech	straight
dirècte	straightforward
tot drech	straightforward
tension	strain
tendre fòrtament	strain
varietat	strain
estranh	strange
estrangièr	stranger
estrategia	strategy
palha	straw
de palha	straw
majofa	strawberry
majofièr	strawberry
benda	streak
zebrar	streak
corrent	stream
rajolar	stream
carrièra	street
fòrça	strength
insistir	stress
accentuar	stress
estrés	stress
espandi	stretch
s'estirar	stretch
estirar	stretch
estricte	strict
cauma	strike
tustar	strike
ataca	strike
còrda	string
seria	string
cordèl	string
despolhar	strip
benda	strip
s'esforçar	strive
ataca	stroke
nada	stroke
còp	stroke
fòrt	strong
tustèt	struck
tustat	struck
estructura	structure
lucha	struggle
luchar	struggle
que viu mal	struggling
luchant	struggling
caput	stubborn
obstinat	stubborn
pegat	stuck
blocat	stuck
estudiant	student
escolan	student
estudiar	study
estudi	study
estudiar	studying
estudiant	studying
daquòs	stuff
substància	stuff
farcir	stuff
impressionant	stunning
fantastic	stunning
estupid	stupid
estil	style
sometre	subject
subjècte	subject
somission	submission
sometre	submit
presentar	submit
substància	substance
remplaçant	substitute
remplaçar	substitute
subtil	subtle
succedir	succeed
reüssir	succeed
succès	success
reüssit	successful
tal	such
tal coma	such as
chucar	suck
subte	sudden
subtament	suddenly
patir	suffer
patiment	suffering
patissent	suffering
sufisent	sufficient
sucre	sugar
suggerir	suggest
suggestion	suggestion
anar plan	suit
costum	suit
convenir	suit
adaptat	suitable
apropriat	suitable
maleta	suitcase
soma	sum
resumit	summary
somari	summary
estiu	summer
cima	summit
somalh	summit
solelh	sun
se solelhar	sun
dimenge	sunday
radiós	sunny
assolelhat	sunny
trescòl	sunset
lutz del solelh	sunshine
supèr	super
superior	superior
supervisor	supervisor
susvelhant	supervisor
ressopet	supper
aprovisionament	supply
remplaçar	supply
fornir	supply
sosténer	support
supòrt	support
sosten	support
supausar	suppose
supausat	supposed
segur	sure
susfàcia	surface
montada	surge
afluir	surge
gabinet medical	surgery
cirurgia	surgery
nom d'ostal	surname
susprendre	surprise
suspresa	surprise
susprés	surprised
se rendre	surrender
capitulacion	surrender
rendètz-vos	surrender
a l'entorn	surrounding
susvelhança	surveillance
sondatge	survey
estudi	survey
examinar	survey
subreviure	survive
sospechar	suspect
suspècte	suspect
exclús	suspended
penjat	suspended
sospechós	suspicious
suspècte	suspicious
sosténer	sustain
patir	sustain
durabilitat	sustainability
sostenible	sustainable
durable	sustainable
rascoalha	swag
fardada	swag
ironda	swallow
engolir	swallow
escambi	swap
escambiar	swap
jurar	swear
transpiracion	sweat
susar	sweat
tricòt	sweater
percórrer	sweep
escobar	sweep
movement circular	sweep
doç	sweet
polits sòmis	sweet dreams
gromand	sweet tooth
àngel	sweetheart
amor	sweetheart
enflar	swell
enfladura	swelling
creissent	swelling
aumentacion	swelling
nadar	swim
banh	swim
natacion	swimming
nada	swimming
nadant	swimming
se balançar	swing
cambiar rapidament	swing
balancejar	swing
interruptor	switch
cambiar	switch
enfle	swollen
espasa	sword
simbòl	symbol
compassion	sympathy
simptòmas	symptoms
sistèma	system
taula	table
tablèu	table
taclar	tackle
s'atacar a	tackle
marcar	tag
etiqueta	tag
etiquetar	tag
coa	tail
seguir	tail
préner	take
emportar	take away
se trachar de	take care
enlairament	take off
quitar	take off
s'enlairar	take off
pres	taken
parlar	talk
conversacion	talk
discors	talk
charraire	talkative
grand	tall
robinet	tap
esplechar	tap
picar	tap
benda	tape
caisseta	tape
amirar	target
tòca	target
tasca	task
aver lo gost	taste
gost	taste
tastar	taste
saborós	tasty
deliciós	tasty
ensenhèt	taught
ensenhat	taught
tè	tea
ensenhar	teach
ensenhan	teach
professor	teacher
equipa	team
esquiçar	tear
lagrema	tear
lagremas	tears
esquiça	tears
picanhada	tease
picanhaire	tease
picanhar	tease
tecnologia	technology
dents	teeth
contar	tell
dire	tell
digatz-me	tell me
diga-me	tell me
trempar	temper
caractèr	temper
temperar	temper
temperatura	temperature
tempe	temple
temple	temple
temporari	temporary
dètz	ten
dètz mila	ten thousand
logatari	tenant
resident	tenant
aver tendéncia	tend
gardar	tend
tendéncia	tendency
tendre	tender
tibar	tense
tendut	tense
tension	tension
tenda	tent
indecís	tentative
provisòri	tentative
trimèstre	term
periòde	term
tèrme	term
tèrmes	terms
condicions	terms
excellent	terrible
terrible	terrible
terrible	terrific
territòri	territory
examèn	test
espròva	test
testar	test
mandar un messatge per telefòn	text
tèxt	text
que	than
mercejar	thank
merceja	thank
mercés	thank you
Mercés per vòstra paciéncia del temps que verificam l'expedicion	Thank you for your patience while we investigate shipment
mila mercés	thank you so much
mercé plan	thank you very much
mercés	thanks
Mercés d'utilizar nòstra aplicacion	Thanks for using our app
aquel	that
que	that
es a dire	that is
es	that is
aquò's bon	that's good
lo	the
raubatòri	theft
lor	their
eles	them
tèma	theme
eles meteisses	themselves
puèi	then
alara	then
teoria	theory
lai	there
i a	there are
i a	there is
doncas	therefore
aquestes	these
eles	they
son	they are
dens	thick
espés	thick
raubaire	thief
maluc	thigh
prim	thin
s'ateunir	thin
causa	thing
causas	things
pensa	think
pensar	think
tresen	third
tèrç	third
assedat	thirsty
tretze	thirteen
trenta	thirty
aqueste	this
aquò	this
es	this is
minuciós	thorough
completament	thoroughly
aqueles	those
encara que	though
pasmens	though
pensada	thought
pensat	thought
senat	thoughtful
pensiu	thoughtful
pensadas	thoughts
mila	thousand
enfilar	thread
fil	thread
menaça	threat
menaçar	threaten
tres	three
lindal	threshold
estrambordat	thrilled
interpretar	thrilled
prosperar	thrive
garganta	throat
a travèrs de	through
tot al long de	throughout
de pertot dins	throughout
lançar	throw
get	throw
tocar amb lo poce	thumb
poce	thumb
trons	thunder
dijòus	Thursday
aital	thus
alara	thus
oscar	tick
lagast	tick
far tica-taca	tick
corrent	tide
marèa	tide
recaptar	tidy
recaptat	tidy
en òrdre	tidy
ligar	tie
carvata	tie
tigre	tiger
colant	tight
sarrat	tight
tigrinha	Tigrinya
ora	time
còp	time
temps	time
timid	timid
minuscul	tiny
conselh	tip
estrena	tip
poncha	tip
estrenas	tips
dona d'informacions	tips
se cansar	tire
cansar	tire
pneumatic	tire
cansat	tired
mocador	tissue
teissut	tissue
títol	title
a	to
èsser	to be
brinde	toast
grasilhar	toast
uèi	today
fanton	toddler
artelhs	toes
amassa	together
comuns	toilet
neteja	toilet
dich	told
diguèt	told
tolerància	tolerance
tolerar	tolerate
tomata	tomato
deman	tomorrow
lenga	tongue
anuèch	tonight
tanben	too
tròp	too
prenguèt	took
aisina	tool
aisinas	tools
pua	tooth
dent	tooth
cima	top
cabucèl	top
dessús	top
subjècte	topic
esquiçat	torn
tortura	torture
torturar	torture
total	total
aténher	total
tocament	touch
tocar	touch
dur	tough
virada	tour
cap a	toward
cap a	towards
toalha	towel
s'eissugar	towel
vila	town
toxic	toxic
verins	toxic
traça	trace
traça	track
pistar	track
pista	track
profession	trade
escambiar	trade
comèrci	trade
tradicion	tradition
tradicional	traditional
circulacion	traffic
trafic	traffic
far lo trafic de	traffic
camin	trail
pista	trail
entrainar	train
formar	train
tren	train
formacion	training
entrainament	training
trach	trait
traches	traits
transferiment	transfer
transferir	transfer
transicion	transition
revirar	translate
transparent	transparent
transportar	transport
transpòrt	transportation
entrapelar	trap
trapèla	trap
escobilhas	trash
bassacar	trash
traumatisme	trauma
viatjar	travel
viatge	travel
platèu	tray
tresaur	treasure
gardar preciosament	treasure
tractar	treat
pichòt plaser	treat
tractament	treatment
arbre	tree
formidable	tremendous
tendéncia	trend
ensag	trial
procès	trial
espròva	trial
enganar	trick
astúcia	trick
còp	trick
experimentat	tried
ensajat	tried
ensagèt	tried
aviar	trigger
gisclet	trigger
provocar	trigger
copa d'entreten	trim
copar leugièrament	trim
excursion	trip
viatge	trip
trabucar	trip
inquietar	trouble
trebolament	trouble
problèma	trouble
pantalon	trousers
vagon	truck
camionar	truck
camion	truck
vertadièr	true
tronc	trunk
mala	trunk
trompa	trunk
entitat financièra	trust
fisança	trust
far fisança	trust
veritat	truth
ensajar	try
ensag	try
tsonga	Tsonga
mètro	tube
tub	tube
dimars	Tuesday
corses	tuition
fraisses d'escolaritat	tuition
piòta	turkey
curcuma	turmeric
virada	turn
virar	turn
torn	turn
tartuga	turtle
tutor	tutor
dotze	twelve
vint	twenty
vint-e-un	twenty-one
toï	Twi
dos còps	twice
deformar	twist
tòrcer	twist
dos	two
tipe	type
caractèr	type
picar	type
tipic	typical
lag	ugly
ultim	ultimate
suprèm	ultimate
parapluèja	umbrella
parasolelh	umbrella
incapable	unable
oncle	uncle
inconscient	unconscious
jos	under
jos	underneath
dejós	underneath
sosestimat	underrated
comprendre	understand
comprés	understood
malastrosament	unfortunately
unifòrme	uniform
unic	unique
unitat	unit
universitat	university
universitari	university
desconegut	unknown
levat se	unless
fins a	until
inabitual	unusual
en naut	up
a tu	up to you
mesa al jorn	update
metre al jorn	update
melhorar	upgrade
extension	upgrade
sus	upon
contrariat	upset
contrariar	upset
urban	urban
enveja	urge
butar	urge
urgent	urgent
nosautres	us
usatge	use
utilizar	use
utilizacion	use
utilizat	used
usat	used
util	useful
inutil	useless
abitual	usual
abitualament	usually
utilitat	utility
utilitari	utility
servici	utility
vacanças	vacation
partir en vacanças	vacation
vaccinacion	vaccination
vaccin	vaccine
vuèg	vacuum
aspirador	vacuum
vague	vague
valid	valid
valable	valid
val	valley
de valor	valuable
valorar	value
valor	value
varietat	variety
divèrs	various
variat	various
variar	vary
vas	vase
vast	vast
legum	vegetable
legums	vegetables
veicul	vehicle
distribuidor	vendor
vendeire	vendor
verin	venom
riscar	venture
entrepresa	venture
lòc	venue
verificar	verify
versatil	versatile
d'usatge multiple	versatile
version	version
vertical	vertical
plan	very
plan bon	very good
recipient	vessel
vaissèl	vessel
via	via
sensacion	vibe
vibracion	vibe
vibracions	vibes
ambient	vibes
viciós	vicious
victima	victim
vidèo	video
veire	view
vejaire	view
vista	view
vilatge	village
marridàs	villain
vinagre	vinegar
ancian	vintage
vendémia	vintage
millesim	vintage
violéncia	violence
violent	violent
viral	viral
verge	virgin
virtual	virtual
vertut	virtue
sagacitat	vision
vision	vision
visita	visit
visitar	visit
visual	visual
vital	vital
vivid	vivid
vocabulari	vocabulary
votz	voice
vuèg	void
nul	void
quantitat	volume
volum	volume
se portar volontari	volunteer
volontari	volunteer
racar	vomit
vulnerable	vulnerable
salari	wage
salaris	wages
talha	waist
esperar	wait
espèra	wait
garçon	waiter
a esperar	waiting
espèra	waiting
se despertar	wake
cinglada	wake
despertar	wake
se despertar	wake up
despertatz-vos	wake up
despèrta-te	wake up
passejada	walk
caminar	walk
caminant	walking
emmuralhar	wall
mur	wall
pòrtafuèlha	wallet
barrutlar	wander
voler	wanna
voler	want
recercat	wanted
volgut	wanted
volguèt	wanted
se far la guèrra	war
guèrra	war
de guèrra	war
garda-rauba	wardrobe
entrepaus	warehouse
caudet	warm
avisar	warn
alarma	warning
mesa en garda	warning
avertiment	warning
guerrièr	warrior
èra	was
lavar	wash
pèrdre	waste
degalhar	waste
degalh	waste
agachar	watch
mòstra	watch
asaigar	water
aiga	water
pastèca	watermelon
onda	wave
èrsa	wave
biais	way
via	way
nosautres	we
sèm	we are
podèm	we can
feble	weak
feblesa	weakness
riquesa	wealth
fortuna	wealth
ric	wealthy
usura	wear
portar	wear
usant	wearing
portant	wearing
usar	weather
temps	weather
maridatge	wedding
dimècres	Wednesday
bauca	weed
cannabis	weed
deserbar	weed
setmana	week
dimenjada	weekend
pes	weight
estranh	weird
benvengut	welcome
benestar	welfare
E ben	Well
plan fach	well done
anèt	went
èran	were
oèst	west
molhat	wet
molhar	wet
umid	wet
balena	whale
qué	what
e tu	what about you
qué fas	what are you doing
qué fas ara	what are you doing now
qué fas ara	what are you doing right now
qué fasètz ara	what are you doing right now
qué fas	what do you do
qué fas dins la vida	what do you do for a living
qué volètz dire	what do you mean
qué vòles dire	what do you mean
qué vòles	what do you want
qué s'es passat	what happened
qué es	what is
qu'es aquò	what is this
quin es ton mestièr	what is your job
cossí te sonas	what is your name
qué de nòu	what's up
quin es ton nom	what's your name
que que siá	whatever
aquò rai	whatever
blat	wheat
volant	wheel
rotlar	wheel
ròda	wheel
quand	when
quora	when
quand	whenever
cada còp que	whenever
ont	where
ont siás	where are you
ont sètz	where are you
d'ont sètz	where are you from
d'ont siás	where are you from
ont siás ara	where are you now
ont sètz ara	where are you now
ont demòras	where do you live
ont demoratz	where do you live
ont es	where is
mentre que	whereas
se	whether
quin	which
pendent	while
marmolhar	whisper
siblet	whistle
siblar	whistle
blanc	white
qui	who
qui siás?	who are you
qui sètz	who are you
que es	who is
qui es	who is
qui es aqueste	who is this
entièr	whole
complet	whole
totalitat	whole
que	whom
qui	whom
dont	whose
a qui	whose
perqué	why
perqué pas	why not
marrit	wicked
larg	wide
vast	wide
veusa	widow
amplor	width
largor	width
esposa	wife
salvatge	wild
natura	wild
testament	will
volontat	will
dispausat	willing
ganhar	win
victòria	win
vent	wind
serpejar	wind
envirolar	wind
moment	window
fenèstra	window
ventós	windy
vin	wine
ivèrn	winter
ivernar	winter
escafar	wipe
eissugar	wipe
toalhon	wipe
fil	wire
cablar	wire
saviesa	wisdom
savi	wise
judiciós	wise
desir	wish
desirar	wish
vos desiri tot çò de melhor	wish you all the best
te desiri tot çò de melhor	wish you all the best
escòrpi	witch
masca	witch
amb	with
retirar	withdraw
replec	withdrawal
retirament	withdrawal
dins	within
sens	without
testimòni	witness
èsser testimòni de	witness
esperitós	witty
lop	wolf
femna	woman
femnas	women
ganhèt	won
ganhat	won
pas	won't
meravilha	wonder
se demandar	wonder
meravilhós	wonderful
bòsc	wood
fusta	wood
lana	wool
de lana	wool
mot	word
paraula	word
formular	word
paraulas	words
disputa	words
trabalh	work
trabalhar	work
calcular	work out
far d'exercici	work out
obrièr	working
trabalhant	working
que trabalha	working
mond	world
marcamal	worm
vèrm	worm
s'engulhar	worm
cansat	worn
portat	worn
usat	worn
inquiet	worried
preocupat	worried
se laguiar	worry
piéger	worse
adorar	worship
practica religiosa	worship
piéger	worst
meriti	worth
de valor	worth
valor	worth
val la pena	worth it
meritant	worthy
nafrar	wound
nafra	wound
Macarèl	Wow
envolopar	wrap
envolopan	wrap
ira	wrath
ponhet	wrist
escriu	write
escriure	write
Escrivetz aicí	Write here
Escriu aicí	Write here
literatura	writing
escritura	writing
escrivent	writing
escrich	written
fals	wrong
tòrt	wrong
escriguèt	wrote
jardin	yard
iard	yard
badalhar	yawn
badalh	yawn
que òc	Yeah
annada	year
ans	years
levadura	yeast
bramar	yell
bramada	yell
jaune	yellow
Òc	Yes
òc, nenona	yes baby
òc, mon car	yes dear
òc, mon còr	yes honey
òc, mon amor	yes my love
òc, segur	yes of course
ièr	yesterday
fins aquí	yet
pasmens	yet
cedir	yield
rendement	yield
tu	you
siás	you are
sètz	you are
sètz polida	you are beautiful
sètz talament polida	you are so beautiful
siás talament polit	you are so beautiful
de res	you are welcome
podètz	you can
pòdes	you can
Sabes	You know
tu tanben	you too
sètz benvengut	you're welcome
de res	you're welcome
jove	young
ton	your
ta benvenguda	your welcome
tu meteis	yourself
jovent	youth
de res	you’re welcome
deliciós	yummy
zèro	zero
