اک	a
نکا جیا	a little
بوہت ودھ	a lot
بوہت سارا	a lot of
چھڈیا ہویا	abandon
ترک کیتا	abandoned
پابند	abide
قائم	abide
قابلیت	ability
قابل	able
دے بارے اچ	about
اتے	above
پردیس اچ	abroad
غیرحاضری	absence
غیر حاضر	absent
قطعی طور تے	absolutely
جذب کرنا	absorb
تجریدی	abstract
اول جلول	absurd
کثرت	abundance
وافر	abundant
گالاں	abuse
بدسلوکی کرو	abuse
بدسلوکی	abuse
گالاں کڈھو	abuse
لہجہ	accent
قبول کرنا	accept
رسائی کرنا	access
رسائی	access
حادثہ	accident
رہائش	accommodation
گنجائش	accommodation
پورا کیتا	accomplish
مکمل	accomplished
دے مطابق	according
اکاؤنٹ	account
قطعیت	accuracy
درستگی	accuracy
بالکل صحیح	accurate
الزام علیہ	accused
درد ہونا	ache
درد	ache
حاصل کرو	achieve
حصولیابی	achievement
تسلیم کرنا	acknowledge
جان پچھان	acquaintance
حاصل کرنا	acquire
حاصل کیتا	acquired
حصول	acquisition
آرو پارو	across
عمل کرنا	act
فعل	action
ترکھا	active
سرگرمیاں	activities
سرگرمی	activity
اداکار	actor
اصل	actual
اصل اچ	actually
شدید	acute
گود لینا	adapt
شامل کرنا	add
لت پینا	addicted
ودھ کے	addition
ودھ کے	additional
پتہ	address
مخاطب کرو	address
بوہتی	adequate
کافی	adequate
نالے ملیا	adjacent
اسم صفت	adjective
ٹھیک بنانا	adjust
مطابق بنانا	adjust
تعریف کرنا	admire
مننا	admit
اپنانا	adopt
تعریف دے قابل	adorable
دلکش	adorable
ایڈوانس	advance
اگے ودھو	advance
وادھو	advanced
فائدہ	advantage
ایڈوینچر	adventure
متعلق فعل	adverb
اشتہار	advertisement
مشہوری کرنا	advertising
مشورہ	advice
مشورہ دینا	advise
ایڈوکیٹ	advocate
وکیل	advocate
وکالت کرنا	advocate
جمالیاتی	aesthetic
معاملہ	affair
متاثر کرو	affect
محبت	affection
پچنا	afford
پج	afford
گنجائش دے قابل	affordable
ڈریا ہویا	afraid
خوفزدہ	afraid
دے بعد	after
مگروں	after
دوپہر دے بعد	afternoon
ایس توں بعد	afterwards
فیر	again
دوبارہ	again
خلاف	against
عمر	age
ایجنسی	agency
ایجنٹ	agent
جارحانہ	aggressive
پھرتیلا	agile
پہلاں	ago
اتفاق اے	agree
معاہدہ	agreement
زراعت	agriculture
اگے	ahead
امداد	aid
مقصد	aim
ہوا	air
ہوائی اڈہ	airport
ایزل	aisle
الارم	alarm
شراب	alcohol
ہوشیار کرنا	alert
زندہ	alive
سارے	all
بالکل ٹھیک	all right
اللہ بھلا کرے	all the best
اجازت دینا	allow
اجازت شدہ	allowed
تقریباً	almost
کلا	alone
نال	along
پہلاں ای	already
بالکل ٹھیک	Alright
وی	also
متبادل	alternative
بھانویں	although
ہمیشہ	always
آں	am
زبردست	amazing
مبہم	ambiguous
ایچھا	ambition
آرزو	ambition
اولوالعزم	ambitious
ترمیم شدہ	amend
وچکار اچ	amid
وچکار	among
ساڈے وچکار	among us
تعداد	amount
رقم	amount
تَفريحی	amusing
دل لگی	amusing
اک	an
تجزیہ	analysis
وڈے وڈیرے	ancestors
آنکڑہ	anchor
پرانا	ancient
تے	and
تے تسی	and you
فرشتہ	angel
غصہ	anger
زاویہ	angle
ناراض	angry
جانور	animal
گِٹا	ankle
سالگرہ	anniversary
اعلان	announcement
لیچڑ	annoy
لیچڑ	annoyed
لیچڑ	annoying
سالانہ	annual
گمنام	anonymous
اک ہور	another
جواب دیو	answer
جواب	answer
توقع کرنا	anticipate
پریشانی	anxiety
پریشان	anxious
کوئی	any
کوئی ہور	anymore
کوئی وی	anyone
کجھ وی	anything
کسے وی طرحاں	anyway
کسے وی طرحاں	anyways
وکھرا	apart
اپارٹمنٹ	apartment
معافی منگنا	apologize
ظاہر	apparent
ویکھن اچ	apparently
ظاہری	apparently
دہائی	appeal
نمودار ہوندا اے	appear
دسنا	appearance
ظاہری حلیہ	appearance
نمودار ہویا	appeared
بھک	appetite
سیپ	apple
درخواست	application
درخواست دیو	apply
ملاقات	appointment
تعریف کرو	appreciate
تعریف و توصیف	appreciation
پہنچ جانا	approach
پہنچ	approach
مناسب	appropriate
منظوری	approval
منظور کرنا	approve
منظور شدہ	approved
تقریباً	approximately
اپریل	april
من مانی	arbitrary
آرکیٹیکٹ	architect
فن تعمیر	architecture
آرکائیو کیتا	archive
نیں	are
کی تسی	are you
کی تسی مصروف او	are you busy
کی تہاڈا ویاہ ہویا اے	are you married
کی تسی شادی شدہ او یا نئیں	are you married or single
کی تسی اجے وی اوتھے موجود او؟	Are you still there?
کی تسی اوتھے او	are you there
علاقہ	area
بحث کرنا	argue
دلیل	argument
اٹھنا	arise
بانّہہ	arm
فوج	army
آلے دوالے	around
ترتیب دینا	arrange
انتظام	arrangement
پہنچ	arrival
پہنجو	arrive
اپڑو	arrive
پہنجیا	arrived
مغرور	arrogant
تیر	arrow
فن	art
آرٹیکل	article
مصنوعی	artificial
فنکار	artist
جیویں	as
جدوں تائیں	as long as
ایہدے نال	as well
ایہدے نال نال	as well as
راکھ	ash
شرمندہ	ashamed
پچھنا	ask
پچھیا	asked
سویا	asleep
پہلو	aspect
اسامی	Assamese
حملہ	assault
اسمبلی	assembly
زور دے کے	assertive
جائزہ لینا	assess
تشخیص	assessment
اندازہ	assessment
اثاثے	asset
اثاثے	assets
تفویض کرو	assign
کم	assignment
سپردگی	assignment
معاونت کرو	assist
اسسٹنٹ	assistant
سنگی	associate
ساتھی	associate
نال رلیا	associated
ایسی ایشن	association
فرض کرو	assume
مفروضہ	assumption
تے	at
گھٹ توں گھٹ	at least
کھادا	ate
کھلاڑی	athlete
نال لانا	attach
نال لایا	attached
منسلکہ	attachment
حملہ	attack
کوشش	attempt
کوشش کرو	attempt
شرکت کرو	attend
حاضری	attendance
شرکت	attendance
شرکت کر رئیا اے	attendance
توجہ	attention
آکڑ	attitude
کشش کرنا	attract
کشش	attraction
پرکشش	attractive
وصف	attribute
ناظرین	audience
اگست	august
چاچی	aunt
آنٹی	aunty
مستند	authentic
مصنف	author
اتھارٹی	authority
پت جھڑ دا موسم	autumn
دستیاب	available
اوسط	average
بچنا	avoid
جاگدا	awake
عطا کردا اے	award
آگاہ	aware
واقف	aware
آگاہی	awareness
دور	away
شاندار	awesome
رعب دار	awesome
شاندار	awful
رعب دار	awful
پھسکڑ	awkward
بے ڈھنگا	awkward
ایمارہ	Aymara
نکا بال	baby
کنوارہ	bachelor
کنڈھ	back
پچھوکڑ	background
مندا	bad
بیگ	bag
چارہ	bait
پکانا	bake
بیکری	bakery
بیکنگ سوڈا	baking soda
توازن	balance
توازن بنانا	balance
گیند	ball
بمبارا	Bambara
کیلا	banana
بینڈ	band
دھماکے	bang
بینک	bank
بار	bar
بمشکل	barely
سودا	bargain
بھونک	bark
بھونکنا	bark
جو	barley
رکاوٹ	barrier
بنیاد	base
بنیاد	based
تہہ خانہ	basement
بنیادی	basic
بنیادی طور تے	basically
تلسی	basil
حرامی	bastard
حرامدا	bastard
بیچ	batch
نہانا	bath
غسل خانہ	bathroom
بیٹری	battery
جنگ	battle
کھاڑی	bay
ہونا	be
محتاط رہوو	be careful
ساحل	beach
بیم	beam
پھلیاں	beans
ریچھ	bear
برداشت کرنا	bear
داڑھی	beard
برداشت کرنا	bearing
درندہ	beast
حیوان	beast
ہراؤنا	beat
ہراؤ	beat
پٹائی کرنا	beat
سوہنا	beautiful
خوبصورتی	beauty
بن گیا	became
تاں جے	because
بننا	become
بستر	bed
سون دا کمرہ	bedroom
شہد دی مکھی	bee
گوشت	beef
رئیا	been
بیئر	beer
پہلاں	before
شروع کیتا	began
شروع کرو	begin
شروع کر رئیا	beginning
دے ولوں	behalf
رویہ	behave
سبھاؤ	behavior
رویہ	behavior
رویہ	behaviour
پچھے	behind
ہونا	being
یقین	belief
یقین کرنا	believe
ڈھڈ	belly
ملکیت اے	belong
محبوب	beloved
تھلے	below
بیلٹ	belt
بینچ	bench
جھکو	bend
مڑو	bend
تھلے	beneath
فائدہ چکو	benefit
فائدہ	benefit
فوائد	benefits
ایہدے علاوہ	beside
ایہدے علاوہ	besides
ودھیا	best
قسمت چنگی ہووے	best of luck
نیک تمنا	best regards
بہتر	better
وچکار	between
شربت	beverage
حدوں ودھ	beyond
بھوج پوری	Bhojpuri
تعصب	bias
متعصب	biased
سائیکل	bicycle
بولی	bid
وڈا	big
بائیک	bike
بل	bill
بندھنا	bind
پنچھی	bird
سالگرہ	birthday
تھوڑا جیا	bit
کٹیا	bite
کٹ لیو	bite
کڑوا	bitter
کسیلا	bitter
کالا	black
بلیڈ	blade
الزام لاؤ	blame
الزام	blame
خالی	blank
کمبل	blanket
دھماکہ	blast
بلیچ	bleach
بلینڈ کرنا	blend
رحمت	bless
رحمتاں	blessed
انّھا	blind
مسرت	bliss
خوشی	bliss
ڈکنا	block
لہو	blood
کلی	bloom
پھونکا مارنا	blow
نیلا	blue
کھنڈا	blunt
تختہ	board
کشتی	boat
جُثہ	body
ابالنا	boil
بولڈ	bold
بانڈ	bond
ہڈی	bone
کتاب	book
بکنگ	book
بک کرو	book
فروغ دیو	boost
بوسٹ کرو	boost
فروغ	boost
بوسٹ	boost
بوسٹر	booster
بوٹ	boot
بوٹ	boots
کنارہ	border
اکتایا ہویا	bore
بور ہویا	bored
بور کرن آلا	boring
پیدا ہویا	born
جمیا	born
ادھار لینا	borrow
باس	boss
دونویں	both
سپاپا	bother
نکو نک کرنا	bother
بوتل	bottle
سبھ توں تھلے	bottom
خریدیا	bought
اچھال	bounce
مقدر ہونا	bound
حداں	boundaries
جھُکنڑا	bow
برتن	bowl
ڈبہ	box
منڈا	boy
بوائے فرینڈ	boyfriend
کنگن	bracelet
دماغ	brain
برانچ	branch
برانڈ	brand
بہادر	brave
خلاف ورزی	breach
روٹی	bread
بھن دینا	break
وقفہ	break
بھننڑو	break
ناشتہ	breakfast
چھاتی	breast
ساہ	breath
ساہ لیو	breathe
نسل ودھانا	breed
اینٹ	brick
دلہن	bride
پل	bridge
مختصر	brief
روشن	bright
شاندار	brilliant
لیانا	bring
بھرا	bro
کھلا	broad
نشریات	broadcast
ٹٹیا ہویا	broke
ٹٹیا ہویا	broken
جھاڑو	broom
بھرا	brother
سالا	brother in law
لیایا	brought
بھورا	brown
برش	brush
بالٹی	bucket
سجن	buddy
دوست	buddy
بجٹ	budget
بگ	bug
اُساری کرنا	build
اُساری	building
تعمیر کیتا	built
جسا	bulk
ودھیا	bulk
سانڈھا	bull
بدمعاش	bully
ٹکر	bump
گچھہ	bunch
پُلندا	bundle
بھار پاؤ	burden
وزن	burden
بھار	burden
دفنایا	buried
بلدا	burn
پھٹنا	burst
دفنانا	bury
بس	bus
جھاڑی	bush
کاروبار	business
ہٹا کٹا	bust
مصروف	busy
لیکن	but
پر	but
مکھن	butter
تتلی	butterfly
بٹن	button
خریدو	buy
ولوں	by
انج ای	by the way
اللہ بیلی	bye
گوبھی	cabbage
الماری	cabinet
پنجرا	cage
کیک	cake
بچھڑا	calf
بلاؤ	call
کال	call
مینوں کال کرو	call me
سدیا	called
پرسکون	calm
آیا	came
مہم	campaign
سکو	can
سکدا	can
سکی	can
سکدی	can
نئیں کر سکدا	can't
منسوخ کرو	Cancel
کینسر	cancer
قابل	capable
توفیق	capacity
پج	capacity
سرمایہ	capital
کیپشن	caption
کھچنا	capture
بنانا	capture
گڈی	car
کیرئیر	career
ہشیار	careful
احتیاط نال	carefully
لاپرواہ	careless
خیال رکھن آلا	caring
بڑھئی	carpenter
قالین	carpet
گاجر	carrot
لے جانا	carry
ودھانان	carry on
انجام دینا	carry out
کیس	case
نقدی	cash
کاسٹ	cast
قلعہ	castle
عمومی	casual
بلی	cat
پھڑنا	catch
زمرہ	category
ڈھور ڈنگر	cattle
پھڑیا	caught
وجہ	cause
کارن	cause
کارن بننا	cause
خبردار کرنا	caution
محتاط	cautious
غار	cave
مک جانا	cease
سیلنگ	ceiling
مناؤنا	celebrate
خلیہ	cell
مرکز	center
صدی	century
سیریل	cereal
تقریب	ceremony
یقینی	certain
یقیناً	certainly
سرٹیفکیٹ	certificate
چین	chain
کرسی	chair
چنوتی دیو	challenge
چیلنج	challenge
چنوتی	challenge
موقع	chance
تبدیل کرو	change
افراتفری	chaos
حرف	character
صفتاں	characteristics
چارج	charge
خیرات	charity
دلکش	charming
چارٹ	chart
پیچھا کرنا	chase
چیٹ	chat
چیٹ کرنا	chat
سستا	cheap
دھوکہ دینا	cheat
دھوکہ	cheating
جانچ	check
پڑتال کرنا	check
گلھ	cheek
خوش ہونا	cheer
خوشگوار	cheerful
دلاسا	cheers
پنیر	cheese
کیمسٹری	chemistry
پالنا	cherish
شطرنج	chess
چھاتی	chest
چبانا	chew
چکن	chicken
چیف	chief
بال	child
بچپن	childhood
بال	children
ٹھنڈا	chill
ٹھنڈ	chill
ٹھنڈا  لگنا	chill
سردی لگنا	chill
چمنیاں	chimneys
ٹھوڈی	chin
چاکلیٹ	chocolate
چُون	choice
منتخب کرنا	choose
کٹنا	chop
چھوٹے موٹے کم	chores
موٹے	chubby
چرچ	church
دار چینی	cinnamon
دائرہ	circle
حالات	circumstances
شہری	citizen
شہر	city
دعویٰ کرنا	claim
دعویٰ	claim
وضاحت کرو	clarify
کلاس	class
چکنی مٹی	clay
صاف	clean
صاف	clear
واضح	clear
صاف کرو	clear
کلرک	clerk
چالاک	clever
کلائنٹ	client
پہاڑ	cliff
موسم	climate
اتے چڑھنا	climb
چپچپا	clingy
کلاک	clock
بند کرو	close
الماری	closet
کپڑا	cloth
کپڑے	clothes
بدل	cloud
کلاؤڈ	cloud
ابرآلود	cloudy
بھانڈ	clown
کھوج	clue
اناڑی	clumsy
خوشہ	cluster
تربیت کرنا	coach
کوچ	coach
کوئلہ	coal
ساحل	coast
کوٹ	coat
کافی	coffee
عقلی	cognitive
اتفاق	coincidence
ٹھنڈ	cold
سمیٹو	collapse
کالر	collar
ساتھی	colleague
ساتھی	colleagues
جمع کرو	collect
مجموعہ	collection
کالج	college
رنگ	color
بے رنگ سارے خیال غصے نال سو گئے	colorless green ideas slept furiously
رنگ	colour
کالم	column
کنگھی	comb
میل ملاپ	combination
اکٹھیا کیتا	combine
آؤ	come
ایتھے آؤ	come here
آؤ	come on
گل سنو	come on
تسلی دینا	comfort
آرام اچ	comfortable
آنا	coming
چھیتی آ رئیا اے	coming soon
کمانڈ	command
تبصرہ	comment
تجارتی	commercial
کمیشن	commission
سپرد کرو	commit
اقرار	commitment
عہد	commitment
وقف ہویا	committed
تجارے دی شیواں	commodity
عام	common
گل بات کرنا	communicate
مواصلت	communication
وسیبی لوک	community
سفر کرنا	commute
ساتھی	companion
کمپنی	company
مقابلہ کرو	compare
نسبت	comparison
مقابلہ کرنا	comparison
دردمندی	compassion
رحم دل	compassionate
ہم آہنگ	compatible
مقابلہ کدا اے	compete
مجاز	competent
مقابلہ	competition
مسابقتی	competitive
شکایت کرنا	complain
شکایت	complaint
تکمیل	complement
مکمل کرنا	complement
تعریف	complement
تعریف کرنا	complement
پورا کرو	complete
پوری طرحاں	completely
پیچیدہ	complex
تعمیل	compliance
پیچیدہ	complicated
خراج تحسین	compliment
تعمیل کرنا	comply
بناوٹ	composition
ترکیب	composition
مرکب	compound
سجھ بوجھ	comprehension
سنبھود	comprehension
سمجھ آں آلا	comprehensive
تفصیلی	comprehensive
راجی نانواں کرو	compromise
راجی نانواں	compromise
لازمی	compulsory
کمپیوٹر	computer
سوچ وچار کردا اے	concentrate
تصور	concept
تعلق	concern
تشویش	concern
فکر کرو	concern
فکرمند	concerned
چنت اچ	concerned
کنسرٹ	concert
نتیجہ	conclusion
کنکریٹ	concrete
حقیقی	concrete
مضبوط کرنا	concrete
ٹھوس بنانا	concrete
ٹھوس	concrete
شرط	condition
شرطاں	conditions
منعقد کرو	conduct
کانفرنس	conference
اعتراف کرنا	confess
بھروسہ	confidence
اعتماد	confidence
پر اعتماد	confident
تصدیق کرنا	confirm
تنازعہ	conflict
الجھن اچ	confused
الجھن	confusion
مبارکباد	congrats
ودھائی	congratulation
ودھائیاں	congratulations
حروف عطف	conjunction
جوڑ ملاؤ	connect
منسلک کرو	connect
فتح کرنا	conquer
ہوش	conscious
شعور	consciousness
رضامندی دیو	consent
رضامندی	consent
نتیجے	consequences
تحفظ	conservation
قدامت پسند	conservative
دقیانوسی	conservative
غور کرو	consider
سوچ وچار کرو	consider
غور کیتا	considered
مشتمل اے	consist
مستقل مزاجی	consistency
متواتر	consistent
مستقل	consistent
مسلسل	constant
مستقل طور تے	constantly
قبض	constipation
تعمیر	construction
خرچ کردا اے	consume
خرچ	consumption
رابطہ	contact
رابطہ کرو	contact
متعدی	contagious
تے مشتمل	contain
سمویاں	contains
ہم عصر	contemporary
نال دا	contemporary
توہین	contempt
مواد	content
مقابلہ	contest
تناظر	context
براعظم	continent
جاری رکھو	continue
معاہدہ کرو	contract
معاہدہ	contract
مقابلہ	contrast
موازنہ کرنا	contrast
مقابلہ کرنا	contrast
موازنہ	contrast
شراکت کرنا	contribute
سانجھا	contribution
شراکت	contribution
کنٹرول کرنا	control
متنازعی	controversial
سہولت	convenience
سوکھا	convenient
گل وات	conversation
تبدیلی	convert
تبدیل کرنا	convert
پہنچانا	convey
قائل	convince
قائل	convinced
باورچی	cook
پکاؤ	cook
پکانا	cooking
سوہنڑا	cool
ٹھنڈا	cool
تعاون باہمی	cooperation
نمٹنا	cope
تانبا	copper
بنیادی	core
مکئی	corn
کونہ	corner
درست کرو	correct
لاگت کڈھو	cost
لاگت	cost
لباس	costume
کاٹیج	cottage
کپاہ	cotton
صوفہ	couch
کھانسی	cough
سکدا سی	could
کونسل	council
گنتی	count
کاؤنٹر	counter
ملک	country
پینڈ	countryside
دیہات	countryside
جوڑا	couple
حوصلہ	courage
کورس	course
عدالت	court
خوش اخلاقی	courtesy
پتریر	cousin
مسیر	cousin
ڈکو	cover
گاں	cow
بزدل	coward
آرام دہ	cozy
کیکڑا	crab
کریک	crack
رسائی ہونا	crack
ہندرمندی	craft
بکواس	crap
کریش	crash
تباہی	crash
تباہی چکنا	crash
شديد خواہش	craving
رینگنا	crawl
سنکی	crazy
سر سڑیا	crazy
بنایا	create
تخلیقی	creative
کریڈٹ	credit
سرکنا	creep
چلنا	creep
ڈراونا	creepy
عملہ	crew
جرم	crime
نک رگڑنا	cringe
فرشی سلام	cringe
پیرے پینا	cringe
عاجزی	cringe
بحران	crisis
معیار	criteria
اشد ضروری	critical
تنقید	criticism
کراپ کرو	crop
کراپ کرو	crops
عبور کرنا	cross
کراس کرنا	cross
کوا	crow
جمگھٹا	crowd
ہجوم	crowd
جمگھٹا ہونا	crowded
ہجوم	crowded
تاج	crown
لازمی	crucial
قصائی	cruel
ظالم	cruel
کروز	cruise
چاہت	crush
کچلنا	crush
رونا	cry
ککڑی	cucumber
لاڈ کرنا	cuddle
سبیتا	culture
ہوشیار	cunning
استرام	cunning
کپ	cup
الماری	cupboard
نکیل	curb
علاج	cure
علاج کرو	cure
کرفیو	curfew
تجسس	curiosity
ٹوہ لان آلا	curious
گھنگھریالا	curly
کرنسی	currency
موجودہ	current
ہونہی	currently
آفت	curse
لعنت	curse
پردہ	curtain
کشن	cushion
مخصوص	custom
صارف	customer
گراہک	customer
رواج	customs
کٹو	cut
کٹ	cut
زخم	cut
پیارا	cute
سوہنڑا	cute
چکر لانا	cycle
سائیکل چلانا	cycling
پیو	dad
پیو	daddy
روزانہ	daily
گوالمنڈی	dairy
ڈیم	dam
نقصان	damage
نقصان پہنچاؤ	damage
سواہ پینا	damn
فٹے منہ	damn
نمدار	damp
نچنا	dance
خطرہ	danger
خطرناک	dangerous
کالا	dark
چہیتی	darling
لاڈلی	darling
ڈیش	dash
کوائف	data
ڈیٹ تے جانا	date
تریخ	date
دھی	daughter
دن	day
مردہ	dead
اخیری تریخ	deadline
بہرہ	deaf
سودا	deal
نمٹنا	deal
عزیز	dear
سارے سوہنڑے لوکو	Dear All
معزز صارف	Dear Customer
عزیز والدین	Dear Parents
محترم سر	Dear Sir
پیارے طالب علموں	Dear students
پیاری ٹیم	Dear Team
موت	death
مباحثہ کرنا	debate
ڈیبٹ	debit
ملبہ	debris
قرضہ	debt
دہائی	decade
انحطاط	decay
فوت ہویا	deceased
دھوکہ دینا	deceive
دسمبر	december
باحیا	decent
معقول	decent
فیصلہ کرو	decide
فیصلہ کیتا	decided
فیصلہ	decision
ڈیک	deck
انکار کرنا	decline
گھٹانا	decrease
منسوب کیتا	dedicated
وقف	dedication
وثیقہ	deed
ڈونگھا	deep
ہرن	deer
طے شدہ	default
شکست	defeat
شکست دینا	defeat
دفاع کرنا	defend
وضاحت کرنا	define
یقینی طور تے	definitely
تعریف	definition
درجہ	degree
سند	degree
دیری	delay
دیری کرو	delay
تاخیر کیتی	delayed
مکاؤ	delete
جان بجھ کے	deliberate
نازک	delicate
مزیدار	delicious
خوشی	delight
خوش ہویا	delighted
گھلنا	deliver
پہنچایا	delivered
گھلنا	delivery
مطالبہ	demand
مطالبہ کرنا	demand
مطالبہ کرنا	demanding
جمہوریت	democracy
بھوت پریت	demon
مظاہرہ کرو	demonstrate
انکار کیتا	denied
کثافت	density
دندان ساز	dentist
انکار کرنا	deny
محکمہ	department
روانگی	departure
منحصر ہونا	depend
تعینات کیتا	deploy
ناکام ہویا	deposit
ڈیپازٹ	deposit
اداس	depressed
ذہنی دباؤ	depression
گہرائی	depth
بیان کرو	describe
دسو	describe
تفصیل	description
صحرا	desert
مستحق ہونا	deserve
ڈیزائن	design
ڈیزائن بنانا	design
عہدہ	designation
خواہش کرنا	desire
خواہش	desire
مانگ	desire
میز	desk
مایوسی	despair
لاچار	desperate
بیتاب	desperate
تنازعہ	despite
مٹھا	dessert
منزل	destination
تقدیر	destiny
تباہ کرو	destroy
تباہی	destruction
تفصیل	detail
تفصیلاں	details
گویڑلاؤ	detect
پتہ لگاؤ	detect
عزم	determination
تعین کرو	determine
پُرعزم	determined
تباہ	devastated
تیار کرو	develop
تیار شدہ	developed
ترقی	development
آلہ	device
شیطان	devil
وقف کیتا	devoted
ڈھویہی	Dhivehi
ذیابیطس	diabetes
اسہال	diarrhea
ڈائری	diary
لغت	dictionary
کیتا	did
مرنا	die
مر گیا	died
مویا	died
مریا	died
خوراک	diet
فرق	difference
وکھرا	different
اوکھا	difficult
مشکل	difficult
کھودنا	dig
شان	dignity
رُتبہ	dignity
محنتی	diligent
رات دا کھانا	dinner
ڈپ	dip
براہ راست	direct
سمت	direction
ڈائریکٹر	director
گندگی	dirt
گندہ	dirty
نااہل بناؤ	disable
نااہل بناؤ	disabled
غائب ہونا	disappear
مایوس	disappointed
تباہی	disaster
رد کرو	discard
ڈسچارج	discharge
طور طریقے	discipline
بندوبست	discipline
رعایت	discount
گویڑ لاؤ	discover
وکھرا سلوک	discrimination
گل وات کرو	discuss
گل وات	discussion
بیماری	disease
بیماریاں	diseases
بھیس بدلنا	disguise
ناگوار	disgusting
پلیٹ	dish
پلیٹاں	dishes
برخاست کرو	dismiss
روانہ کیتا	dispatch
وکھاؤ	display
تلفی	disposal
پھڈا	dispute
رپھڑ	dispute
فاصلہ	distance
منفرد	distinct
ممتاز	distinguish
دکھ	distress
تکلیف	distress
تقسیم	distribution
ضلع	district
پریشان کرنا	disturb
کھائی	ditch
غوطہ لانا	dive
بھن بھن دا	diverse
تنوع	diversity
ونڈو	divide
الہامی	divine
طلاق	divorce
طلاق دینا	divorce
چکر آنا	dizzy
کرو	do
کی تسی	do you
کی تہانوں میرے نال پیار اے	do you love me
ڈاکٹر	doctor
دستاویز	document
کرنا	does
نئیں	doesn't
کتا	dog
ڈوگری	Dogri
کرنا	doing
گڑیا	doll
ڈومین	domain
گھریلو	domestic
غالب	dominant
نہ کرو	don't
فکر نہ کرو	Don't worry
عطیہ دیو	donate
ہو گیا	done
کھوتا	donkey
نشئی	dope
دوہرا	double
دوہرا ہونا	double
شک	doubt
شبہہ	doubt
شک کرنا	doubt
پیڑا	dough
تھلے	down
ڈاؤن لوڈ کرو	download
مسودہ بناؤ	draft
مسودہ	draft
گھسیٹو	drag
نالی	drain
ڈرامہ	drama
بنانا	draw
دراز	drawer
ڈرائینگ	drawing
اندیشہ	dread
خیال	dread
شبیہہ	dread
خواب	dream
خواب ویکھنا	dream
پہناوا	dress
ڈرل	drill
ڈرنک	drink
مشروب	drink
پیو	drink
چلاؤ	drive
چھڑ دینا	drop
چھڈو	drop
سٹ دینا	drop
چھڈ دتا	dropped
خشک سالی	drought
نشے اچ	drunk
خشک	dry
بطخ	duck
دوست	dude
نفیس بندہ	dude
واجب	due
ایہدے کارن	due to
پھیکا	dull
مندا	dull
بہرہ	dumb
گونگلو	dumb
ڈھیری	dump
ذخیرہ	dump
دورانیہ	duration
وچکار	during
دھول جھاڑو	dust
فرض	duty
رہائش	dwell
مرنا	dying
ہر اک	each
ہر اک	each other
شوقين	eager
چیل	eagle
کان	ear
شروع اچ	earlier
شروع اچ	early
کماؤ	earn
کن	ears
دھرتی	earth
زلزلہ	earthquake
آسانی	ease
آسانی نال	easily
پُورب	east
آسان	easy
کھاؤ	eat
کھانا پینا	eating
معاشی	economic
معیشت	economy
کنارا	edge
تدوین کرنا	edit
تعلیم	education
اثر	effect
مؤثر	effective
کارکردگی	efficiency
فعال	efficient
کوشش	effort
انڈہ	egg
بتاؤں	eggplant
انا	ego
اٹھ	eight
اٹھارہ	eighteen
اسی	eighty
یا تے	either
تفصیل دسو	elaborate
کہنی	elbow
بزرگ	elder
وڈی عمر دے	elderly
پاکیزہ	elegant
عنصر	element
ہاتھی	elephant
یارہ	eleven
اہل	eligible
مکاؤ	eliminate
علاوہ	else
شرمندہ ہویا	embarrassed
شرمندہ ہونا	embarrassing
قبول کرنا	embrace
جبھی پاؤنا	embrace
چھاتی نال لانا	embrace
ابھر رئے نیں	emerge
ایمرجنسی	emergency
جذباتی	emotional
ہمدردی	empathy
زور دینا	emphasis
زور دینا	emphasize
ملازم	employee
ملازمین	employees
آجر	employer
ملازمت	employment
خالی	empty
اہل بناؤ	enable
سامنا	encounter
حوصلہ افزائی کرنا	encourage
مکاؤ	end
خطرے اچ	endangered
کوشش	endeavor
برداشت	endurance
برداشت کرنا	endure
دشمن	enemy
توانائی	energy
مشغول	engage
مصروف	engaged
مصروفیت	engagement
انجن	engine
انجینئر	engineer
انگریجی	English
ودھانا	enhance
موج مارو	enjoy
بہت وڈا	enormous
واوا	enough
یقینی بناؤ	ensure
داخل کرو	enter
تفریح	entertainment
جوش و جذبہ	enthusiasm
پرجوش	enthusiastic
پورا	entire
حق دار	entitled
ادارہ	entity
داخلہ	entrance
اینٹرپرینؤر	entrepreneur
منتظم	entrepreneur
لفافہ	envelope
ماحول	environment
حسد کرنا	envy
عظیم الشان	epic
وبائی	epidemic
برابر	equal
سامان	equipment
مساوات	equity
برابر	equivalent
صافی	eraser
نقص	error
چھٹکارا	escape
خاص طور تے	especially
مضمون	essay
جوہر	essence
لازمی	essential
قائم کرو	establish
قائم	established
اسٹیٹ	estate
اندازہ لانا	estimate
اندازہ لایا	estimated
وغیرہ	etc
ابدی	eternal
اخلاقیات	ethics
تشخیص کرنا	evaluate
تشخیص	evaluation
تد وی	even
یتھے تائیں کہ	even though
شام	evening
واقعہ	event
اخیر اچ	eventually
کدے وی	ever
ہر اک	every
ہر بندہ	everybody
ہر اک	everyone
ہر شے	everything
ثبوت	evidence
برائی	evil
ارتقاء	evolution
تیار ہونا	evolve
ایو	Ewe
سابقہ	ex
پہلاں دا	ex
عین صحیح	exact
بالکل اوہی	exactly
امتحان	exam
جانچ کرنا	examine
مثال	example
ودھدا اے	exceed
شاندار	excellent
دے سوا	except
رعایت	exception
اضافی	excess
بوہتی وادھا	excessive
تبادلہ	exchange
پرجوش	excited
جوش تے جذبہ	excitement
پرجوش	exciting
خصوصی	exclusive
بہانہ بنانا	excuse
مینوں معاف کرنا	excuse me
انجام دینا	execute
عملدرآمد	execution
ایگزیکٹو	executive
مشق	exercise
ورزش کرو	exercise
ورزش	exercise
تھکیا ٹٹیا	exhaust
تھکیا	exhausted
ہنبیا ہویا	exhausted
نمائش	exhibit
منسلکہ	exhibit
نمائش	exhibition
موجود اے	exist
وجود	existence
موجود اے	existing
باہر نکلو	exit
توسیع کرنا	expand
توقع کرو	expect
توقع سی	expected
خرچے	expenses
مہنگا	expensive
تجربہ	experience
تجربہ کرو	experience
تجربہ	experiment
ماہر	expert
معیاد مکی	expired
وضاحت کرو	explain
وضاحتاں	explanation
استحصال کرنا	exploit
دریافت کرنا	explore
دوجے ملک گھلو	export
گل کھلنا	expose
گل کھلنا	exposed
ظاہر ہونا	exposure
ایکسپریس	express
اظہار	expression
کھلا کرنا	extend
کھلا کیتا	extended
توسیع	extension
حد تائیں	extent
باہرلا	external
ناپیدگی	extinct
فالتو	extra
اخد کرو	extract
غیرمعمولی	extraordinary
بوہتی	extreme
انتہائی	extremely
انکھ	eye
انکھیاں	eyes
بناؤٹ	fabric
شاندار	fabulous
سمنڑا کرنا	face
منہ	face
سہولت فراہم کرنا	facilitate
سہولتاں	facilities
سہولت	facility
حقیقت	fact
عامل	factor
فیکٹری	factory
حقیقتاں	facts
دھندلا ہونا	fade
ناکام	fail
ناکام ہویا	fail
ناکام ہویا	failed
ناکامی	failure
بے ہوش	faint
منصفانہ	fair
میلہ	fair
صاف	fair
چنگا	fair
سفید جیا	fair
منصفانہ طور تے	fairly
پری	fairy
عقیدہ	faith
ایمان	faith
وفادار	faithful
جعلی	fake
پت جھڑ	fall
ڈگنا	fall
غلط	false
شہرت	fame
واقف	familiar
ٹبر	family
قحط	famine
مشہور	famous
فین	fan
پکھا	fan
فینسی	fancy
خیالی	fancy
تصوراتی	fantastic
دور	far
الوداع	farewell
کھیت	farm
کسان	farmer
دلکش	fascinating
فیشن	fashion
تیز	fast
چربی	fat
مہلک	fatal
قسمت	fate
پیو	father
تھکاوٹ	fatigue
نقص	fault
پسندیدہ	favorite
طرفداری	favour
پسندیدہ	favourite
خوف	fear
خوف کھاؤ	fear
دعوت	feast
پَر	feather
خصوصیت ہونا	feature
خصوصیت	feature
خاصیت	feature
خصوصیتاں	features
فروری	february
تنگ آیا	fed up
فیس	fee
کھانا دینا	feed
رائے	feedback
محسوس کرنا	feel
محسوس کرنا	feeling
فٹ	feet
ڈگیا	fell
ساتھی	fellow
محسوس کیتا	felt
زنانی	female
باڑھ	fence
بارآور	fertile
میلہ	festival
بھرنا	fetch
بخار	fever
تھوڑے جئے	few
تھوڑے جئے	fewer
منگ	fiance
فکشن	fiction
میدان	field
غصے اچ	fierce
پندرہ	fifteen
پنجاہ	fifty
لڑائی	fight
لڑو	fight
لڑنا	fighting
خاکہ	figure
شکل بناؤ	figure
شکل	figure
نتیجہ کڈھنا	figure out
فائل	file
پر کرنا	fill
پر کیتا	filled
فلم	film
مکروہ	filthy
آخر کار	finally
فنانس	finance
مالیاتی	financial
لبھو	find
لبھو	find out
چنگا	fine
جرمانہ کرنا	fine
کُولا	fine
انگل	finger
مکاؤ	finish
مکایا	finished
اگ	fire
مضبوط کرنا	firm
مضبوط	firm
پہلا	first
پہلا ناں	first name
مچھی	fish
فٹ	fit
پنج	five
ٹھیک بٹھاؤ	fix
ٹھیک بٹھایا	fixed
جھنڈا	flag
جلنا بجھنا	flash
فلیٹ	flat
چپٹا جیا	flat
سدھا	flat
عیب	flaw
بے عیب	flawless
فرار	flee
فلیش	flesh
اڑ گیا	flew
فلیک	flex
لچکدار	flexible
فلائٹ	flight
پرواز	flight
پلٹاؤ	flip
فلپ کرو	flip
فلرٹ کرنا	flirt
فلرٹ کرنا	flirting
تیرنا	float
سیلاب	flood
منزل	floor
آٹا	flour
وگن دیو	flow
تسلسل	flow
پھُل	flower
نزلہ	flu
رواں	fluent
روانی نال	fluently
گد گدا	fluffy
پتلا مادہ	fluid
مکھی	fly
توجہ	focus
توجہ دینا	focus
دھند	fog
کُہَر آلُود	foggy
تہہ لانا	fold
لوکی	folks
ہیٹھاں	follow
سانوں فالو کرو	follow up
ہیٹھاں دتیاں	following
کھانا	food
بیوقوف	fool
بیوقوف بنانا	fool
بھولا	fool
بیوقوف	foolish
پیر	foot
فٹ بال	football
دی لئی	for
مثال دے طور تے	For example
مثال دے طور تے	for instance
تہاڈے لئی	for you
ممانعت	forbidden
مجبور کرو	force
پیش گوئی کرو	forecast
متھا	forehead
نویلکی	foreign
اجنبی	foreign
غیرملکی	foreign
جنگل	forest
ہمیشہ لئی	forever
بھلنا	forget
معاف کرنا	forgive
بھل گیا	forgot
کانٹا	fork
تشکیل دیو	form
شکل	form
رسمی	formal
پچھلا	former
خوش قسمتی نال	fortunately
تقدیر	fortune
قسمت	fortune
چالی	forty
بیالی	forty-two
فارورڈ	forward
پالنا پوسنا	foster
لڑیا	fought
لبھیا	found
فاؤنڈیشن	foundation
چار	four
چودہ	fourteen
لومڑی	fox
نازک	fragile
فریم	frame
فریم ورک	framework
دھوکہ	fraud
پاگل	freak
مفت	free
آزادی	freedom
منجمند کرنا	freeze
کثرت	frequency
کثرت نال	frequent
اکثر	frequently
تازه	fresh
جمعہ	friday
فریج	fridge
بیلی	friend
دوست	friend
دوستانہ	friendly
بیلی	friends
دوست	friends
دوستی	friendship
خوفزدہ	frightened
خوفزدہ	frightening
مینڈک	frog
توں	from
سامنے دا حصہ	front
منجمد	frozen
پھل	fruit
مایوس ہویا	frustrated
فیول	fuel
فلفلڈے	Fulfulde
پورے	full
مزاح	fun
فعل	function
بنیادی	fundamental
جنازہ	funeral
ہساون آلا	funny
مزاحیہ	funny
کھل	fur
غصہ	furious
فرنیچر	furniture
ہور اگے	further
ایہدے علاوہ ہور	furthermore
مستقبل	future
حصول	gain
حاصل کرو	gain
کامیابی	gain
گیم	game
فاصلہ	gap
گیراج	garage
کچرا	garbage
باغ	garden
لہسن	garlic
لوسن	garlic
گیٹ	gate
جمع کرنا	gather
اکٹھ	gathering
اکٹھ ہونا	gathering
گیج	gauge
دتا	gave
گیئر	gear
جنس	gender
عمومی	general
عام طور تے	generally
بناؤ	generate
نسل	generation
سخی	generous
عقلمند	genius
قسم	genre
نرم	gentle
حقیقی	genuine
اشارے	gesture
حاصل کرو	get
لباس پاؤ	get dressed
اٹھو	get up
چھیتی صحتیاب ہوو	get well soon
حاصل کرنا	getting
بھوت پریت	ghost
بھوت پریت	ghosting
بوہتی وڈا	giant
تحفہ	gift
ادرک	ginger
کڑی	girl
گرل فرینڈ	girlfriend
دیو	give
چھڈ دینا	give up
دتا	given
خوش باش	glad
نظر پائی	glance
شیشہ	glass
شیشے	glasses
جھلک	glimpse
عالمی	global
اداس	gloomy
دستانے	gloves
چمک	glow
دمک	glow
دمکنا	glow
چمکنا	glow
چمکنا	glow up
گوند	glue
جاؤ	go
ٹر جاؤ	go
اگے ودھو	go ahead
دور ٹر جانا	go away
ڈیش بورڈ تے جاؤ	go to bed
ہدف	goal
مقصد	goals
بکری	goat
خدا	god
رب	god
اللہ بخشے	god bless you
اللہ تہاڈے تے رحمت کرے	god bless you
جاندا اے	goes
جا رئیا اے	going
جا رئیا آں	going to
سنہرا	gold
ٹر گیا	gone
کرن آلا	gonna
گوو	goo
چنگی	good
چنگا	good
دوپہر دا سلام	good afternoon
خدا حافظ	good bye
دن چنگا ہوے	good day
شامی دا سلام	good evening
چنگا کم	good job
سوہنڑا	good looking
تہاڈی قسمت چنگی ہووے!	good luck
سویر دا سلام	good morning
سویر دا سلام میری جندڑی	good morning my love
اللہ بیلی	good night
رب راکھا	good night
خدا حافظ	goodbye
شب بخیر	goodnight
شیواں	goods
گوگل	Google
Google Translate	Google Translate
ہنس	goose
شاندار	gorgeous
گپ مارنی	gossip
حاصل کیتا	got
ایہ لبھ گیا اے	got it
حکومت	government
پھڑنا	grab
گریڈ	grade
آہستہ آہستہ	gradually
گریجویٹ	graduate
دانے	grain
دینا	grant
عطا کیتا	granted
دتا	granted
جواب	grapes
پھڑنا	grasp
گھاہ	grass
شکر گزار	grateful
شکرگزاری	gratitude
قبر	grave
سرمئی	gray
عظیم	great
زبردست	great
لالچ	greed
لالچی	greedy
سبز	green
ملنا	greet
ملنا	greeting
سلام دعا	greetings
سرمئی	grey
گرڈ	grid
غم	grief
دکھ	grief
پیسنا	grind
گرفت	grip
پنساری دا سامان	grocery
دولہا	groom
مجموعی	gross
میدان	ground
گروپ	group
ودھانا	grow
اگانا	grow
بڑھوتری	growth
تیز مزاج	grumpy
گوارانی	Guarani
گارنٹی دینا	guarantee
حفاظت کرنا	guard
اندازہ لاؤ	guess
پروہناں	guest
راہنمائی	guidance
رہنما کرنا	guide
رہنما	guide
مجرم	guilty
سجن	guy
دوست	guy
لوکی	guys
جم	gym
عادت	habit
رہائش دی تھاں	habitat
سی	had
جھکڑ	hail
وال	hair
آدھا	half
ہال	hall
ہتھ	hand
ہتھی	handle
کنڈا	handle
البیلا	handsome
لٹکانا	hang
باہر ٹر جانا	hang out
واقع ہونا	happen
واقع ہویا	happened
خوشی	happiness
خوش	happy
سالگرہ مبارک	happy birthday
جنم دن دی ودھائی	happy birthday
تہانوں سالگرہ مبارک ہووے	happy birthday to you
نویں سال دی ودھائی	happy new year
سخت	hard
اوکھے ہو کے	hardly
شاید ای کدے	hardly ever
نقصان	harm
ضرر	harm
نقصان پہنچانا	harm
نقصان دہ	harmful
ہم آہنگی	harmony
سخت	harsh
فصل دی کٹائی	harvest
رکھدا اے	has
فحجکل؛'[	has
نفرت	hate
ہونا	have
تہاڈا دن بوہت چنگا گزرے!	have a good day
تہاڈا دن بہت چنگا گزرے!	have a nice day
ناشتہ کرو	have breakfast
مزے کرو	have fun
کی تسی کھا چکے او	have you eaten
ہونا	having
خطرہ	hazard
دھندکا	haze
اوہ	he
اوہدے کول اے	he has
اوہ اے	he is
سر	head
سردرد	headache
شفا دینا	heal
شفا دینا	healing
صحت	health
صحت مند	healthy
سننا	hear
سنیا	heard
دل	heart
مرکز	heart
گرمی ہونا	heat
گرمی	heat
جنت	heaven
بھاری	heavy
مصروف	hectic
قد	height
وارث	heir
منکر	heist
بے دین	heist
رکھدا اے	held
دوزخ	hell
ہیلو	Hello
سلام	Hello
ہیلو جناب	hello dear
ہیلو تہاڈا کی حال اے	hello how are you
ہیلو تہاڈا کی حال اے	hello how are you doing
ہیلمٹ	helmet
‏‏مدد	help
‏‏مدد کرنا	help
مددگار	helpful
جتھوں	hence
اگوں	hence
اوہ	her
ریوڑ	herd
ایتھے	here
ورثہ	heritage
اراں پراں کرنا	hesitate
ہچکچانا	hesitate
اوہو	Hey
ہیلو	Hi
سلام	Hi
ہیلو، تہاڈا کی حال اے	hi how are you
ہیلو جناب	Hi there
لکُیاہویا	hidden
لکانا	hide
مراتب	hierarchy
ودھ	high
نمایاں کرنا	highlight
چڑھدی اے	hike
ہائکنگ	hiking
مزاحیہ	hilarious
پہاڑی	hill
اوہ	him
اشارہ	hint
ڈھوئی	hip
کولھے	hips
کرایہ تے لینا	hire
اجرت تے لینا	hiring
اوہدا	his
تریخ	history
ہٹ	hit
مارو	hit
ہمم	Hmm
شغل	hobby
شوق	hobby
پھڑ کے رکھنا	hold
پھڑنا	hold on
موری	hole
چھٹی	holiday
خالی	hollow
گھار	home
گھر کا کم	homework
ایماندار	honest
ایمانداری نال	honestly
جندڑی	Honey
شہد	Honey
سوہنڑیے	Honey
عزت	honor
ہوڈ	hood
ہک	hook
اچھلنا	hop
امید	hope
امید کرو	hope
امید دے نال	hopefully
ناامید	hopeless
پڑے رخ	horizontal
ہارن	horn
مکروہ	horrible
دہشت	horror
گھوڑا	horse
ہسپتال	hospital
میزبانی	hospitality
ہوسٹ	host
میزبان کرو	host
مخالف	hostile
دشمن	hostile
تتا	hot
ہوٹل	hotel
گھنٹہ	hour
گھنٹے	hours
گھر	house
گھرانہ	household
گھار	household
کیویں	how
تہاڈے بارے اچ کی	how about you
تہاڈا کی حال اے	how are you
تسی کیہو جئے او	how are you doing
اج تہاڈا کی حال اے	how are you doing today
اج تہاڈا کی حال اے	how are you today
تسی کیہوجئے او	how do you do
کیویں اے	how is
کنے	how many
کنے	how much
کنی واری	how often
تہاڈی عمر کنی اے	how old are you
تہاڈا دن کیہوجیا گزریا	how was your day
تہاڈی رات کیہوجئی گزری	how was your night
تدوی	however
فیر وی	however
حب	hub
شوہر	hubby
جھپی	hug
جپھی مارو	hug
گلے ملنا	huge
انسان	human
عاجز	humble
مرطوب	humid
سلا	humid
نما	humid
تر	humidity
سینکڑہ	hundred
بھکا	hungry
شکار کھیلنا	hunt
طوفان	hurricane
چھیتی کرنا	hurry
چھیتی کرو	hurry up
زخمی کرنا	hurt
میاں	husband
ہلچل	hustle
ہلچل مچانا	hustle
ہٹ	hut
حفظان صحت	hygiene
میں	I
میں آں	I am
میں ٹھیک آں	I am fine
میں سکداں آں	I can
میں نئیں کر سکدا	I can't
میں کراں گا	I do
میںوں معلوم نئیں	I do not know
مینوں سمجھ نئیں آیا اے	I do not understand
میں نئیں کردا	I don't
مینوں ملوم نئیں	I don't know
مینوں سمجھ نئیں لگی	I don't understand
مینوں سمجھ نئیں آ رئی تہاڈا کی مطلب اے	I don't understand what you mean
مینوں تہاڈی سمجھ نئیں لگی	I don't understand you
مینوں معلوم نئیں	I don’t know
مینوں سمجھ نئیں لگی	I don’t understand
میرا اندازہ اے	i guess
میرے کول سی	I had
میرے کولے	I have
میں رئیا آں	I have been
مینوں امید اے	I hope so
مینوں پتہ اے	I know
مینوں پسند اے	I like
میں تہاںوں پسند کردار آں	I like you
مینوں محبت اے	I love
مینوں آپنے وڈے بھرا نال محبت اے	I love my big brother
مینوں آپنی وڈی بھین نال محبت اے	I love my big sister
مینوں آپنے پیو نال محبت اے	I love my father
مینوں آپنے نکے بھرا نال محبت اے	I love my little brother
مینوں آپنی نکی بھین نال محبت اے	I love my little sister
مینوں آپنی ماں نال محبت اے	I love my mother
مینوں تہاڈے نال محبت اے	I love you
میں تینوں بوہتی پیار کردا آں	I love you so much
میں وی تیرے نال محبت کردا آں	I love you too
میر امطلب اے	I mean
تہاڈی کمی محسوس ہوندی اے	I miss you
میں تینوں بوہتی یاد کردا آں	I miss you so much
میں ویکھدا آں	I see
میرا خیال اے	I think
میں سمجھ گیا آں	I understand
میں چاہندا آں	I want
میں تہانوں ملنا چاہندا آں	I want to see you
میں تہانوں چاہندا آں	I want you
میں ساں	I was
میں کراں گی	I will
میں کراں گا	I will
میں ہواں گا	I would be
میں آں	I'm
میں ٹھیک آں	I'm fine
میں چنگا آں	I'm good
میں ایتھے آں	I'm here
میں معذرت چاہنا آں	I'm sorry
برف	ice
آئس کریم	ice cream
خیال	idea
بہترین	ideal
اکو جیہا	identical
شناخت کرنا	identify
شناخت	identity
بیوقوف	idiot
الو دا پٹھا	idiot
بیکار	idle
جے	if
نظر انداز کرنا	ignore
بیمار	ill
غیرقانونی	illegal
مرض	illness
بماری	illness
ایلوکینو	Ilocano
تصویر	image
تصور کرنا	imagine
فوری	immediate
فوری طور تے	immediately
بے پایاں	immense
اثر	impact
اثر پانا	impact
بے صبرا	impatient
لاگو کرو	implement
درآمد کرنا	import
درآمد	import
اہم	important
عائد کرنا	impose
ناممکن	impossible
متاثر کرنا	impress
تاثر	impression
متاثر کن	impressive
چنگا کرنا	improve
چنگیائی کرنا	improvement
بہتری کرنا	improvement
وچ	in
ودھ کے	in addition
حقیقت اچ	In fact
دے سمنڑے	in front of
کرن لئی	in order to
نامناسب	inappropriate
ترغیب	incentive
واقعہ	incident
شامل اے	include
نال رلا کے	including
آمدنی	income
تکلیف	inconvenience
وادھا	increase
ودھاؤ	increase
ودھیا ہوئیا	increased
جیس تے یقین نہ آوے	incredible
بے شک	indeed
آزاد	independent
بھارت	India
اشارہ کرنا	indicate
دیسی	indigenous
وطنی	indigenous
کلا بندہ	individual
صنعت	industry
اٹل	inevitable
لازمی	inevitable
نکا بال	infant
انفیکشن	infection
حدوں پار	infinity
لامحدود	infinity
سوزش	inflammation
ہوا بھرنا	inflation
اثر	influence
اثر پانا	influence
دسنا	inform
جانکاری	information
جزو	ingredients
وراثت	inheritance
شروع آلے	initial
پہل	initiative
زخمی	injured
چوٹاں	injury
زخم	injury
معصوم	innocent
جدت	innovation
سوال پچھو	inquiry
پاگل	insane
مجنوں	insane
کیڑے	insect
غیر محفوظ	insecure
پاؤ	insert
اندروں	inside
بصیرتاں	insight
اصرار کرنا	insist
انسومینیا	insomnia
تاثر	inspiration
تحریک دینا	inspire
انسٹال کرو	install
مثال	instance
فوری	instant
دی تھاں تے	instead
دی تھاں تے	instead of
ہدایتاں	instructions
انسٹرومنٹ	instrument
بے عزتی کرو	insult
بیمہ	insurance
برقرار	intact
ایمانداری	integrity
دانشور	intellectual
ذہانت	intelligence
ذہین	intelligent
ارادہ ہونا	intend
چاہنا	intended
مقصود	intended
شدید	intense
ارادہ	intention
گل وات	interact
گل وات	interaction
منافع	interest
دلچسپی اے	interested
دلچسپ	interesting
مداخلت کرنا	interfere
وچکار	intermediate
داخلی	internal
بین الاقوامی	international
انٹرن شپس	internship
ترجمانی کرنا	interpret
مترجم	interpreter
مداخلت کرنا	interrupt
انٹرویو	interview
جانن آلا	intimate
وچ	into
تعارف کراؤ	introduce
جان سہیانڑ	introduction
تعارف	introduction
انترمکھی	introvert
اندر ال مڑیا	introvert
دھیان	intuition
گیان	intuition
رد	invalid
بے جواز	invalid
ایجاد کرنا	invent
انوینٹری	inventory
سرمایہ کاری کرنا	invest
تحقیق کرنا	investigate
دعوت	invitation
مدعو کرنا	invite
انوائس دیو	invoice
انوائس	invoice
شامل	involve
ملوث	involved
استری کرو	iron
استری	iron
اے	is
جزیرہ	island
تنہا	isolated
کلا	isolated
جاری کرو	issue
مسئلہ	issue
مسئلے	issues
ایہ	it
ایہہ اے	it is
ایہہ سی	it was
ایہہ اے	it's
ایہہ ٹھیک اے	it's ok
ایہ ٹھیک اے	It's okay
شے	item
شیواں	items
ایہدا	its
میں آں	I’m
جیکٹ	jacket
جیل	jail
جنوری	January
جار	jar
جبڑا	jaw
ساڑ ہونا	jealous
سڑنا	jealous
سڑیا ہویا	jealous
سڑیل	jealous
جھٹکے	jerk
زیور	jewelry
ملازمت	job
جاگنگ کرنا	jogging
نال رلو	join
سانجھے دا	joint
مذاق کرنا	joke
صحافی	journalist
سفر	journey
خوشی	joy
انصاف کرو	judge
انصاف	judge
جج کرو	judge
جج	judge
جوس	juice
جولائی	july
چھال لانا	jump
جون	june
ردی	junk
منصفانہ	just
بس	just
بس ایہہ کرو	just do it
انصاف	justice
کارن دسنا	justify
کلالیسوت	Kalaallisut
شوقین	keen
رکھو	keep
ایس نون جاری رکھو	keep it up
رکھیا	kept
کیتلی	kettle
چابی	key
کک مارنا	kick
بال	kid
بیوقوف بنانا	kidding
گردہ	kidney
بال	kids
مار دیو	kill
مہربان	kind
قسم	kind
قسم دا	kinda
مہربانی کر کے	kindly
رحمدلی	kindness
بادشاہ	king
بوسہ کرنا	kiss
باورچی خانہ	kitchen
پتنگ	kite
بلونگڑے	kitten
بلی دے بچے	kitten
گوڈا	knee
جاندا سی	knew
چاقو	knife
نائٹ	knight
جاننا	know
علم	knowledge
معلوم	known
کونکنی	Konkani
کریو	Krio
لیبل	label
لیبل لاؤ	label
مزدور	labor
وضع حمل	labour
کمی	lack
گھاٹا	lack
پوڑی	ladder
لیڈی	lady
لہندا پنجابی	Lahnda Punjabi
رکھیا	laid
جھیل	lake
لیلا	lamb
لنگڑا	lame
لیمپ	lamp
تھلے لاہو	land
دھرتی	land
زمین	land
قدرتی منظر	landscape
بولی	language
وقفہ	lap
وڈا	large
آخیرلی	last
اخیری پر نکی گل نئیں	last but not least
آخری ناں	last name
دیر	late
حال اش ای	lately
بعد اچ	later
بعد اچ	latest
بعد اچ	latter
ہنسنا	laugh
ہنسنا	laughing
ہنسی	laughter
چَلایا	launch
لانڈری	laundry
قانون	law
لان	lawn
وکیل	lawyer
انڈے دیندی اے	lay
تہہ	layer
لے آؤٹ	layout
سست	lazy
لیڈ	lead
لیڈر	leader
پتہ	leaf
وگ رئیا اے	leak
جھکنا	lean
چھال مارنا	leap
سکھنا	learn
سکھنا	learning
اجارہ	lease
گھٹوں گھٹ	least
چمڑا	leather
چھڈ دیو	leave
ٹر جاؤ	leave
چھٹی	leave
چھڈدا اے	leaves
قیادت کیتی	led
چھڈیا	left
لت	leg
میراث	legacy
وصیت	legacy
قانونی	legal
روایت	legend
کتھا	legend
قانونی	legit
ویہل	leisure
قرض دینا	lend
لمائی	length
گھٹ	less
سبق	lesson
ہوں دینا	let
خط	letter
سلاد	lettuce
لیول	level
فائدہ	leverage
ذمے واری	liability
لائبریری	library
چٹنا	lick
جھوٹ	lie
جھوٹ بولو	lie
جھوٹی گلاں	lies
حیاتی	life
لفٹ	lift
لفٹ دیو	lift
چکنا	lift
ہلکا کرنا	light
روشنی	light
ہلکا	light
بجلی کڑکنا	lightning
پسند کرو	like
امکان	likely
ایسی طرحاں	likewise
لکیر	line
لنگالا	Lingala
لنک	link
شیر	lion
مائع	liquid
فہرست	list
سننا	listen
سننا	listening
واقعی	literally
ادب	literature
کوڑا	litter
گند	litter
نکا	little
رہوو	live
لائیو	live
جگر	liver
رہندا اے	lives
رہنا	living
بیہن دا کمرہ	living room
چھپکلی	lizard
لوڈ	load
نوالہ	loaf
قرضہ	loan
وسیبی	local
تھاں	location
تالا	lock
لاک ڈاؤن	lockdown
لاگ	log
زور دی ہنسی	lol
کلی	lonely
کلا	lonely
لما	long
بہت عرصہ توں تہانوں ویکھا نئیں	long time no see
ویکھنا	look
نظر	look
لوپ	loop
ڈھلا	loose
ڈھلا کرو	loose
لارڈ	lord
کھو دینا	lose
نقصان	loss
کھو دینا	loss
گواچیا	lost
لاٹ	lot
اچی آواز	loud
بیٹھک	lounge
محبت کرو	love
محبت	love
چاہ	love
چاہت کرو	love
تہاڈے نال محبت اے	love you
پیارا	lovely
پیاری	lovely
گھٹ	low
گھٹ	lower
وفادار	loyal
وفاداری	loyalty
قسمت	luck
خوش نصیب	lucky
لوگانڈا	Luganda
سامان	luggage
ڈھیلا	lump
دوپہراں دا کھانا	lunch
پھیپھڑے	lungs
لگژری	luxury
لیٹنا	lying
مشین	machine
پاگل	mad
میڈم	madam
بنایا	made
میگزین	magazine
عالیشان	magnificent
نوکرانی	maid
بنیادی	main
دیکھ بھال کرنا	maintain
مرمت	maintenance
میتھیلی	Maithili
بوہتی اہم	major
وڈا	major
میجر	major
اکثریت	majority
بناؤ	make
میک اپ	make up
بندہ	male
مال	mall
بندہ	man
بندوبست کرتا	manage
انتظامیہ	management
مینیجر	manager
لازمی	mandatory
ظاہر کرو	manifest
جوڑتوڑ	manipulate
انداز	manner
دستی	manual
کئی	many
تہانوں ایس دن دے ہزاراں ودھائیاں	many many happy returns of the day
مارچ	march
مارجن	margin
مارکیٹ	market
ویاہ	marriage
شادی شدہ	married
ماسک	mask
عوام	mass
وڈے پیمانے اتے	massive
ماسٹر	master
میچ	match
نال ملاؤ	match
ساتھی	mate
مواد	material
ریاضی	math
اہم ہونا	matter
مسئلہ	matter
معاملہ	matter
ضروری ہونا	matter
پختگی	maturity
سکدا	may
ہو سکدا اے	may
سکدی	may
شاید	maybe
مینوں	me
میں وی	me too
کھانا	meal
ذریعہ	mean
کمینہ	mean
مطلب	meaning
ذریعے	means
مطلب	meant
ایس دوران	meanwhile
پیمائش کرنا	measure
پیمائش کرنا	measures
گوشت	meat
طبی	medical
دوائیاں	medicine
مراقبہ	meditation
درمیانہ	medium
ملاقات کردا اے	meet
ملاقات	meeting
میٹیلون	Meiteilon
پگھلاؤ	melt
یاداشتاں	memories
یاداشت	memory
ذہنی	mental
ذکر کرنا	mention
ذکر کیتا	mentioned
سکھیک	mentor
استاد	mentor
سوداگر	merchant
رحم	mercy
محض	merely
میری کرسمس	merry christmas
گند کرنا	mess
سنیہہ	message
گندا	messy
دھات	metal
طریقہ	method
چوئے	mice
مڈل	middle
ادھی رات	midnight
ہو سکدا اے	might
ہلکا	mild
سنگ میل	milestone
فوج	military
دودھ	milk
دس لاکھ	million
برا مننا	mind
دماغ	mind
بنی ہوئی سوچ	mindset
سوچ دا انداز	mindset
میری	mine
سرنگ	mine
میرا	mine
یکجا ہویا	mingle
بال	minor
منٹ	minute
منٹ	minutes
معجزہ	miracle
شیشہ	mirror
متفرق شیواں	miscellaneous
شرارتی	mischievous
دکھیاری	miserable
برے حال اچ	miserable
مصیبت	misery
یاد کرنا	miss
تسی یاد آندے او	miss you
نہ لبھنا	missing
مشن	mission
کہر	mist
غلطی	mistake
میزو	Mizo
موبائل	mobile
نقل لاہنا	mock
ماڈل	model
درمیانہ	moderate
ثالثی کرنا	moderate
جدید	modern
شرمیلی	modest
حیا آلی	modest
نمی	moist
نمی	moisture
پھُپھوندی	mold
پھپھوندی لگنا	mold
مولڈ	mold
چچھوندر	mole
بے بے	mom
ماں	mom
لمحہ	moment
پیر	monday
پیسہ	money
نگرانی	monitor
بندر	monkey
ماہ	month
موڈ	mood
تنگ مزاج	moody
چن	moon
اخلاقی سبق	moral
ہور	more
ہور ودھ کے	moreover
صبح	morning
رہن	mortgage
زیادہ تر	most
زیادہ تر	mostly
ماں	mother
حرکت	motion
حوصلہ افزائی	motivation
پہاڑی	mountain
چوہا	mouse
منہ	mouth
ودھو	move
حرکت	movement
فلم	movie
محترمہ	mrs
بہت	much
مٹی	mud
گارا	mud
پیالا	mug
پٹھا	muscle
عجائب گھر	museum
کھمبی	mushroom
موسیقی	music
پھپھوندی	must
لازمی	must
خاموش کرو	mute
آپس دی	mutual
میرا	my
میرے عزیز	My dear
میرے دوست	my friend
میرا ہوور کرافٹ ایلز نال بھریا ہویا اے	My hovercraft is full of eels
میری محبت	my love
میری جندڑی	my love
میرا ناں اے	my name is
میری خوش قسمتی	my pleasure
میں آُے	myself
بھیت بھریا	mysterious
پراسرار	mysterious
بھیت	mystery
راز	mystery
فرضی گلاں	myth
ناخن	nail
نادان	naive
بھولا	naive
ناں دینا	name
بیان	narrative
تنگ	narrow
ناپاک	nasty
گندا	nasty
قومی	national
قومیت	nationality
وسیبی	native
قدرتی	natural
فطرت	nature
متلی	nausea
بکبکا ہونا	nausea
نیڑے	near
نیڑے دا	nearby
تقریباً	nearly
صاف ستھرا	neat
ضروری	necessary
گردن	neck
کنگن	necklace
ضرورت ہونا	need
ضرورت	need
منفی	negative
غفلت	neglect
گل بات کرنا	negotiate
پڑوسی	neighbor
ہمسائیگی	neighborhood
نہ ای	neither
بھتیجا	nephew
بیوقوف	nerd
پاگل	nerd
گھابر جانا	nervous
گھونسلا	nest
نیٹ	net
نیٹ ورک	network
غیرجانبدار	neutral
کدے نئی	never
کدے امید نہ چھڈو	never give up
کوئی گل نئیں	never mind
کوئی گل نئیں	nevermind
تد وی	nevertheless
نواں	new
خبراں	news
اگلا	next
ایس توں اگلا	next to
چنگا	nice
تہاڈے نال مل کے خوشی ہوئی	nice to meet you
تہانوں مل کے چنگا لگیا	nice to meet you
بھتیجی	niece
رات	night
رات نوں ڈرنا	nightmare
نو	nine
انی	nineteen
نوے	ninety
نئیں	No
کوئی مسئلہ نئیں	no problem
بالکل وی نئی	no way
کوئی نئیں	nobody
شور	noise
پُرشور	noisy
کوئی نئی	none
دوپہر	noon
نئیں	nope
نہ ای	nor
عمومی	normal
اُتر	north
نک	nose
ماضی دی یاد	nostalgic
نئیں	not
بالکل وی نئیں	not at all
مندا نئیں اے	not bad
اجے نئیں	Not now
اجے نئیں	not yet
نوٹ	note
نوٹ کیتا	noted
کجھ نئیں	nothing
نوٹس کرنا	notice
نوٹسس کیتا	noticed
اسم	noun
اسم	nouns
ناول	novel
نومبر	november
ہونڑ	now
اج کل	nowadays
مخل	nuisance
وبال	nuisance
کالعدم	null
سن	numb
نمر	number
نرس	nurse
گری	nut
نٹ میگ	nutmeg
غذائیت	nutrition
حلف	oath
موٹاپا	obesity
اطاعت کرنا	obey
شے	object
معروضی	objective
ذمہ واری	obligation
غیر واضح	obscure
مشاہدہ	observation
مشاہدہ کرنا	observe
وہم ہونا	obsessed
جنون	obsession
متروک	obsolete
رکاوٹ	obstacle
حاصل کرنا	obtain
حاصل کیتا	obtained
صاف	obvious
واضح	obvious
واضح طور تے	obviously
کدے کدار	occasionally
پیشہ	occupation
کم دھندہ	occupation
سوچ اچ ڈبیا	occupied
ہوندا اے	occur
واقع ہویا	occurred
ہوندا اے	occurs
سمندر	ocean
اکتوبر	october
طاق	odd
طاق	odds
دا	of
دی	of
یقیناً	of course
آف	off
ناگوار	offensive
پیشکش	offer
آفر	offer
پیشکش کرنا	offer
دفتر	office
باضابطہ	official
اکثر	often
اوہ	Oh
اوہ واقعی	oh really
تیل	oil
ٹھیک اے	ok
ٹھیک اے پیارے	ok dear
ٹھیک اے سوہنڑیے	ok honey
شہد	ok honey
چنگا، میری جان	ok my love
ٹھیک اے	okay
چنگا سوہنڑے	okay baby
ٹھیک اے پیارے	okay dear
ٹھیک اے سوہنئیے	okay honey
چنگا سوہنڑِیے	okay my love
پرانا	old
آن کرو	on
آن	on
اتے	on
اک واری	once
اک	one
اک بولی کدے وی کافی نئیں اے	one language is never enough
پیاز	onion
آن لائن	online
اکو	only
کھولو	open
آپریشن	operation
چلانا	operation
رائے	opinion
موقعے	opportunities
موقع	opportunity
الٹ	opposite
الٹا	opposite
پر امید	optimistic
اختیار	option
اختیاری	optional
یا	or
نارنجی	orange
مالٹا	orange
حکم	order
آرڈر	order
حکم دینا	order
عام	ordinary
تنظیم	organization
اورئیننٹیشن	orientation
حسب نسب	origin
اصلی	original
اورومو	Oromo
یتیم	orphan
دوجے	other
نئی تے فیر	otherwise
اوداں	otherwise
چائیدا	ought
ساڈا	our
ساڈے	our
ساڈا مشن: ہر بندے نوں، ہر تھاں اتے، دنیا نوں سمجھن تے دوجیاں بولیاں اچ اپنی گل دا ظہار کرن دے قابل بنانا۔	Our mission: to enable everyone, everywhere to understand the world and express themselves across languages.
ساڈا مشن: سارے جگ دی جانکاری نوں منظم کرنا تے ایس نوں عالمی رسائی دے قابل تے مفید بنانا اے۔	Our mission: to organize the world's information and make it universally accessible and useful.
باہر	out
نتیجہ	outcome
لباس	outfit
آؤٹ گوئنگ	outgoing
آؤٹ لیٹ	outlet
خاکہ	outline
باہرلے پاسے	outside
شاندار	outstanding
اوون	oven
اتے	over
اوتھے اے	over there
سارا	overall
قابو پانا	overcome
بوہتی ودھ سوچنا	overthinking
جذباتی	overwhelmed
ہیجان اچ	overwhelmed
جذباتی	overwhelming
ہیجان اچ	overwhelming
قرض دار ہونا	owe
الو	owl
آپے	own
ملکیت ہونا	own
مالک	owner
بیل	ox
رفتار	pace
پیک کرو	pack
پیکج	package
ادا کیتا	paid
درد	pain
پینٹ	paint
پینٹنگ	painting
جوڑی	pair
پیلا ہو جان	pale
تَلی	palm
تسلہ	pan
وہائی	pandemic
دہشت	panic
پینٹ	pants
کاغذ	paper
جنت	paradise
متوازی	parallel
پارسل	parcel
معاف کرنا	pardon
ماں پے	parents
پارک	park
طوطا	parrot
اجوائن	parsley
حصہ	part
حصہ لیندا اے	participate
خاص طور تے	particular
خاص طور تے	particularly
ساجھی	partner
پارٹی	party
لنگھو	pass
رستہ	passage
لنگھ گیا	passed
لنگھیا	passed
ابال	passion
جذبہ	passion
پرجوش	passionate
سست	passive
پاس ورڈ	password
ماضی	past
پیوند	patch
راستہ	path
دلکش	pathetic
صبر	patience
برداشت	patient
مریض	patient
تحمل	patient
نمونہ	pattern
وقفہ	pause
پکی راہ	pavement
ادائیگی کرو	pay
ادائیگی	payment
امن	peace
پرامن	peaceful
آڑو	peach
چوٹی	peak
اتے	peak
ناشپاتی	pear
مٹر	peas
عجیب	peculiar
موتر	pee
موتر کرنا	pee
چھلنا	peel
ہم جھولی	peer
ساتھی	peers
پین	pen
پنسل	pencil
التواء اچ	pending
لوک	people
مرچاں	pepper
تصور کرنا	perceive
سمجھ	perception
گیان	perception
انوبھو	perception
بے عیب	perfect
انجام دینا	perform
کارکردگی	performance
خبرے	perhaps
پیریڈ	period
مستقل	permanent
اجازت	permission
اجازت دینا	permit
استحکام	perseverance
استقلال پذیر	persistent
بندہ	person
ذاتی	personal
شخصیت	personality
رائے	perspective
تناظر	perspective
پھسلاؤنا	persuade
قائل کرنا	persuade
بیہودہ	pervert
آوارہ	pervert
پالتو جانور	pet
مرحلہ	phase
انوکھی شے یا گل	phenomenon
فلسفہ	philosophy
فون کرنا	phone
تصویر	photo
جملہ	phrase
جسمانی	physical
چننا	pick
چننا	pick up
تصویر	picture
ٹکڑا	piece
ٹکڑے	pieces
سور	pig
کبوتر	pigeon
ڈھیر	pile
تکیہ	pillow
پائلٹ	pilot
پن	pin
انناس	pineapple
گلابی	pink
گڑھا	pit
سٹننا	pitch
کم شروع کرنا	pitch
ترس	pity
تھاں	place
رکھنا	place
تھاواں	places
پلیگ	plague
سادہ	plain
منصوبہ	plan
رندہ	plane
پودا	plant
بوٹا لاندا اے	plants
پلیٹ	plate
پلیٹ فارم	platform
کھیڈ	play
چلاؤ	play
چلانا	play
کھیڈ رئیا اے	playing
خوشگوار	pleasant
مہربانی کرو	please
مہربانی کر کے	please
خوش کرو	please
خوش کیتا	pleased
خوشی	pleasure
تہیہ	pledge
عہد	pledge
بوہتی	plenty
کافی	plenty
پلاٹ	plot
پلگ	plug
آلوبخارا	plum
پلمبر	plumber
جمع	plural
پوڈ کاسٹ	podcast
نظم	poem
شاعری	poetry
نقطہ	point
زہر	poison
پولیس	police
پالیسی	policy
تمیز دار	polite
منہ دا مٹھا	polite
آلودگی	pollution
حوض	pond
پول	pool
فضلہ	poop
بیکار	poor
پوپ	pop
مشہور	popular
وَسوں	population
سور	pork
دلیہ	porridge
دہانہ	port
حالت	position
مثبت	positive
مالک ہونا	possess
قبضہ	possession
قابض	possessive
ممکن	possible
پوسٹ کرو	post
پوسٹ	post
ملتوی کرنا	postpone
آلو	potato
ممکنہ	potential
پاؤنڈ	pound
غربت	poverty
طاقت	power
طاقتور	powerful
عملی	practical
عمل کرنا	practice
مشق	practice
عمل	practice
تعریف	praise
پرینک	prank
مذاق	prank
دعا کرنا	pray
قیمتی	precious
بالکل ٹھیک	precise
عین درست	precisely
پیشین گوئی کرنا	predict
ترجیح دیو	prefer
ترجیح	preference
حاملہ	pregnant
تعصب	prejudice
احاطے	premises
پریمیئم	premium
تیاری	preparation
تیاری کرنا	prepare
تیاری	prepared
حروف جار	preposition
موجودگی	presence
تحفہ	present
پیش کرنا	present
موجودہ	present
پریزنٹ	present
پریزنٹیشن	presentation
سنبھالنا	preserve
صدر	president
دبانا	press
دباؤ	press
دباؤ	pressure
وکھانا	pretend
بوہتی	pretty
سوہنی	pretty
وچانا	prevent
پجھلا	previous
شکار	prey
مُل	price
ابھمان	pride
فخر	pride
پادری	priest
پرائمری	primary
بنیادی	primary
ابتدائی	prime
شہزادی	princess
پرنسپل	principal
پہلاں	prior
ترجیح	priority
جیل	prison
رازداری	privacy
نجی	private
ذاتی	private
ادھیکار	privilege
حق	privilege
انعام	prize
شاید	probably
مسئلہ	problem
طریقے	procedure
اگے ودھانا	proceed
عمل کرنا	process
عمل	process
پراسس	process
پیدا کرنا	produce
مصنوعات	product
پیداوار	production
پیشہ	profession
پیشہ ور	professional
پروفائل	profile
منافع	profit
ڈونگا	profound
ترقی کرو	progress
ترقی	progress
پروجیکٹ	project
نمایاں	prominent
وعدہ کرنا	promise
وعدہ	promise
فروغ دینا	promote
ترقی	promotion
فوری	prompt
اوندھے منہ	prone
اسم ضمیر	pronouns
تلفظ	pronunciation
ثبوت	proof
موزوں	proper
مناسب	proper
مناسب طریقے نال	properly
جائیداداں	properties
جائیداد	property
تجویز	proposal
پروپوزل	proposal
امکان	prospect
خوشحالی	prosperity
خوشحالی	prosperous
حفاظت کرنا	protect
مغرور	proud
گھمنڈی	proud
ثابت کیتا	prove
فراہم کردا اے	provide
فراہم کیتا	provided
صوبہ	province
رسد سامان	provision
جوانی	puberty
عوام	public
کھچیا	pull
کدو	pumpkin
وقت دا پابند	punctual
پتلی	pupil
خریدو	purchase
خالص	pure
جامنی	purple
مقصد	purpose
پرس	purse
مگر ٹرو	pursue
حصول	pursuit
دھکا دینا	push
رکھو	put
کوالیفیکیشن	qualification
کوالٹی	quality
مقدار	quantity
کوارنٹائن	quarantine
جھگڑا	quarrel
لڑائی کرو	quarrel
جھگڑا کرو	quarrel
سہ ماہی	quarter
کیچوا	Quechua
ملکہ	queen
انوکھا	queer
سوال پچھنا	query
سوال	question
قطار	queue
قطار بناؤ	queue
فوراً کرنا	quick
چھیتی	quickly
خاموش	quiet
رضاعی	quilt
چھڈ دینا	quit
بالکل	quite
خاموش	quite
کوئز	quiz
کوٹیشن	quotation
اقتباس	quote
اقتباس کرو	quote
حوالہ دینا	quotes
کوٹ کرنا	quotes
اقتباس کرنا	quotes
خرگوش	rabbit
دوڑ	race
غصہ	rage
بارش	rain
اتے جانا	raise
ودھنا	raise
وادھا	raise
پالیا	raised
اتے کیتا	raised
نسیا	ran
اٹکل پچّو	random
حد	range
سلسلہ	range
تیزی	rapid
چھیتی	rapid
تیزی نال	rapidly
نایاب	rare
کدے کدار	rarely
سرخ دانے	rash
چوہا	rat
ریٹ	rate
سگوں	rather
تناسب	ratio
منطقی	rational
کچا	raw
جواب	re
پہنجو	reach
پہنجو	reached
ردعمل	reaction
پڑھو	read
پڑھ رئیا اے	reading
تیار او	ready
حقیقی	real
حقیقت	reality
احساس کرو	realize
احساس کیتا	realized
واقعی	really
پچھلا	rear
کارن	reason
معقول	reasonable
یاد کرنا	recall
وصولی	receipt
رسید	receipt
وصول کرو	receive
وصول کرو	received
حالیہ	recent
حال اچ ای	recently
وصولی	reception
ریسیپی	recipe
لاپرواہ	reckless
پہچان	recognition
پچھاننا	recognize
سفارش کرو	recommend
سفارش کیتی	recommended
ریکارڈ	record
ریکارڈ کرو	record
بحالی	recover
صحتیابی	recovery
مستطیل	rectangle
سرخ	red
ریڈیم کرو	redeem
خلاصی	redemption
مکتی	redemption
گھٹ کرنا	reduce
بے کار	redundant
ریفر	refer
حوالہ	refer
حوالہ	reference
انعکاس	reflect
یاد	reflection
گریز کرنا	refrain
ریفریجریٹر	refrigerator
واپس کرنا	refund
انکار کرنا	refuse
انکار کیتا	refused
لحاظ	regard
گوَہ	regard
ایہدے متعلق	regarding
بے پرواہ	regardless
لحاظ	regards
گوَہ	regards
خطہ	region
رجسٹر کرو	register
افسوس کرنا	regret
باقاعدہ	regular
باقاعدگی نال	regularly
مسترد کرنا	reject
متعلقہ	relate
متعلقہ	related
تعلقات	relationship
تعلق	relative
رشتہ دار	relative
قرابت	relative
رشتے دار	relatives
پرسکون رہنا	relax
جاری کرو	release
ریلیز	release
جاری کرنا	released
متعلقہ	relevant
قابل اعتماد	reliable
سہائتا	relief
ریلیف	relief
سکون دینا	relieve
سکون آیا	relieved
مذہب	religion
مذہبی	religious
اراں پراں کرنا	reluctant
ہچکچاہٹ	reluctant
بھروسہ کرنا	rely
باقی رہنا	remain
رہندا کُھندا	remaining
قابل ذکر	remarkable
تریاق	remedy
یاد کرنا	remember
چیتا کرانا	remind
چیتا کران آلا	reminder
یاد دہانی	reminder
پراں	remote
دور	remote
ہٹانا	remove
خدمت پیش کرنا	render
کرایہ	rent
مرمت کرو	repair
دوہرانا	repeat
دی تھاں بدلو	replace
جواب دیو	reply
جواب	reply
رپورٹ	report
رپورٹ کرو	report
نمائندگی کردا اے	represent
ساکھ	reputation
درخواست	request
درخواست کرو	request
لوڑ اے	require
ضرورت اے	required
بچانا	rescue
تحقیق	research
رلدا ملدا	resemble
پچھتاوہ	resentment
بکنگ	reservation
محفوظ کرنا	reserve
رہائش کنندہ	resident
استعفٰی دینا	resign
لچکداری	resilience
لوچدار	resilient
مزاحمت کیتی	resist
مقابلہ	resistance
قرارداد	resolution
سنکلپ	resolution
حل کرنا	resolve
ریزورٹ	resort
وسیلے	resources
عزت کرنا	respect
عزت	respect
جواب دیندا اے	respond
جواب	response
ذمہ داری	responsibility
ذمہ وار	responsible
باقی	rest
سکون نال آرام کرو	rest in peace
ریستوران یا ہوٹل	restaurant
بحال کرو	restore
پابندی آلا	restrict
نتیجہ	result
نتیجے	results
جاری رکھنا	resume
پرچون	retail
برقرار رکھنا	retain
برقرار رکھنا	retention
ریٹائر شدہ	retired
دستبرادری کرو	retreat
فیر حاصل کرنا	retrieve
واپس آؤ	return
وکھانا	reveal
ظاہر کیتا	revealed
بدلہ	revenge
آمدنی	revenue
پٹھا کرنا	reverse
تبدیل کرنا	reverse
جائزہ لینا	review
جائزہ	review
دوہراوے گا	revise
دوہرائی	revision
انقلاب	revolution
انعام	reward
تال	rhythm
پسلی	rib
چاول	rice
بھرپور	rich
جان چھڑانا	rid
سواری کرو	ride
سواری	ride
ہاسوہینا	ridiculous
مزاحیہ	ridiculous
حق	right
سجا	right
ایسی ویلے	right now
ہونڑی	right now
سخت	rigid
انگوٹھی	ring
مانجنا	rinse
فساد	riot
پکیا ہویا	rip
پکانا	rip
پکیا ہویا	ripe
اٹھیا ہویا	rise
اٹھنا	rise
خطرہ	risk
خطرہ مول لینا	risk
حریف	rival
دریا	river
سڑک	road
روسٹ	roast
توانا	robust
چٹان	rock
سلاخ	rod
قانون	role
رول	roll
کھوٹا	roof
تھاں	room
جڑ	root
رسی	rope
سڑنا	rotten
کھردرا	rough
اندازے نال	roughly
گول	round
روٹ	route
معمول	routine
صف	row
رگڑ	rub
ربڑ	rubber
کچرا	rubbish
اکھڑ	rude
گنوار	rude
رگ	rug
تباہ کرنا	ruin
حکومت	rule
رولر	ruler
قانون	rules
بھجو	run
نسو	run
نس ریہا اے	running
پینڈو	rural
دیہاتی	rural
بھیڑ	rush
چھیتی کرو	rush
بوری	sack
متبرک	sacred
قربانی	sacrifice
محفوظ	safe
محفوظ پرواز	safe flight
تحفظ	safety
ساج	sage
کہیا	said
آکھیا	said
کشتی چلانا	sail
کشتی بانی	sailing
کشتی چلانا	sailing
خاطر	sake
تنخواہ	salary
سیل	sale
سالمون	salmon
نمک	salt
اوہی	same
ایتھے وی اوہی	Same here
نمونہ	sample
ریت	sand
سنسکرت	Sanskrit
طنزیہ	sarcastic
سیسی	sassy
بیٹھیا ہویا	sat
اطمینان	satisfaction
تسلی	satisfied
مطمعن	satisfied
تسلی کرنا	satisfy
تسلی	satisfying
مطمعن	satisfying
ہفتہ	Saturday
ساسیج	sausage
وحشی	savage
جانگلی	savage
بچاندا اے	save
ویکھیا	saw
کہو	say
اسکیل	scale
دھوکے بازی	scam
زخم دا نشان	scar
نایاب	scarce
زخم لانا	scared
ڈوپٹہ	scarf
خوفناک	scary
بکھریا ہویا	scattered
منظر	scene
نظارہ	scenery
خوشبو	scent
شیڈول بنانا	schedule
شیڈول	schedule
اسکول	school
سائنس	science
سائنسدان	scientist
سائنسدان	scientists
سینسدان	scientists
قیچیاں	scissors
ڈانٹ ڈپٹ	scold
دائرہ کار	scope
سیما	scope
اسکور	score
اسکریپر	scrap
خراش	scratch
چیکاں مارنا	scream
اسکرین	screen
اسکرو	screw
اسکرپٹ	script
سمندر	sea
مہر	seal
دریائی بچھڑا	seal
لبھنا	search
موسم	season
سیٹ	seat
دوجا	second
راز	secret
حصہ	section
محفوظ	secure
سیکورٹی	security
ویکھنا	see
تہاڈے نال ملاں گے	see you
بعد اچ ملاں گے	see you later
تہاڈے نال چھیتی ملاقات ہووے گی	see you soon
کل ملاں گے	see you tomorrow
بیج	seed
کھوج لاؤ	seek
لبھو	seek
لگدا اے	seem
لگدا اے	seems
ویکھیا	seen
کھوہ لینا	seize
قبضہ کرنا	seize
دورے پینا	seizure
کدے کدار	seldom
منتخب کرو	select
آپے	self
آپے شفا یابی	self healing
آپو دھاپی	selfish
مطلب پرست	selfish
ویچنا	sell
گھلو	send
مینوں اپنی تصویر گھلو	send me your picture
سینئر	senior
احساس	sense
سیانا	sensible
حساس	sensitive
گھلیا	sent
سزا	sentence
سزاواں	sentences
علیحدہ ہونا	separate
سیپیڈی	Sepedi
ستمبر	september
ترتیب	sequence
سلسلہ	series
گمبیھر	serious
سنجیدگی نال	seriously
خدمت کرنا	serve
خدمت	service
سیشن	session
سیٹ کرو	set
مجموعہ	set
بنانا	set up
ترتیب	setting
بھُگتان کرنا	settle
ست	seven
سترہ	seventeen
ستر	seventy
کئی	several
شدید	severe
سینا	sew
شش	sh
چھاں	shade
سایہ	shadow
ہلانا	shake
گے	shall
گی	shall
گا	shall
اتھلا	shallow
شرم کرو	shame
شکل	shape
اشتراک	share
تیز	sharp
اوہ	she
اوہدے کول اے	she has
اوہ اے	she is
شیڈ	shed
بھیڈ	sheep
چادر	sheet
پرچھاتی	shelf
شیل	shell
پناہ	shelter
حفاظت کرو	shield
شیلڈ	shield
شفٹ	shift
چمکنا	shine
کشتی	ship
جہاز	ship
شپنگ	shipping
قمیض	shirt
جتیاں	shoes
شوٹ کرنا	shoot
دوکان	shop
خریداری	shopping
ساحل	shore
مختصر	short
قلت	shortage
شاٹ لانا	shot
شاٹ	shot
چائیدا	should
کندھا	shoulder
چیکاں مارنا	shout
شو	show
وکھاؤ	show
مینوں وکھاؤ	show me
شاور	shower
کیکڑے	shrimp
سکڑیا ہویا	shrink
بند کرنا	shut
بند کرنا	shut up
بند کرو	shut up
شرمیلی	shy
شرمیلا	shy
بھین بھرا	sibling
بھین بھرا	siblings
بیمار	sick
طرف	side
سسکی لینا	sigh
سامنے ہونا	sight
نظر	sight
سیر و تفریح	sightseeing
دستخط کرو	sign
دستخط	signature
سارتھک	significant
اہم	significant
خاموشی	silence
خاموش	silent
ریشم	silk
بونگا	silly
بدھو	silly
سلور	silver
رلداملدا	similar
سادہ	simp
سوکھا	simple
اکو ویلے اچ	simultaneously
جد توں	since
مخلص	sincere
مخلصانہ طور تے	sincerely
گانا	sing
گلوکار	singer
کلا	single
سنک	sink
ڈب جانا	sink
جناب	Sir
بھین	sister
سالی	sister in law
بہہ جاؤ	sit
تھاں	site
صورتحال	situation
چھ	six
سولہ	sixteen
سٹھ	sixty
سائز	size
مہارت	skill
مہارتاں	skills
جلد	skin
کھل	skin
دبلا	skinny
چھڈ دیو	skip
اسکرٹ	skirt
آسمان	sky
غلام	slave
سونا	sleep
سونا	sleeping
نیندر اچ	sleepy
آستین	sleeve
ٹکڑا	slice
ٹکرا ہونا	slice
سلائیڈ	slide
ہلکا جیا	slightly
پتلا	slim
سلپ	slip
ڈھال	slope
سلاٹ	slot
آہستہ	slow
آہستہ آہستہ	slowly
نکا	small
سمارٹ	smart
سونگھنا	smell
مسکرانا	smile
مسکراہٹ	smile
سگریٹ پینا	smoke
ہموار	smooth
اسنیکس	snack
گھونگا	snail
سانپ	snake
تصویر	snap
برف	snow
ایس لئی	so
بوہتی پیارا	so cute
ہون تائیں	so far
بھگوو	soak
سوپ	soap
سسکی	sober
ساکر	soccer
فٹبال	soccer
سماجی	social
سماج	society
جراباں	socks
نرم	soft
سافٹ ویئر	software
مٹی	soil
ویچیا	sold
بک گیا	sold out
سپاہی	soldier
بنیادی	sole
کلا	sole
ٹھوس	solid
حل	solution
اوپایا	solution
حل کرو	solve
کجھ	some
کوئی نئیں	somebody
کسے نہ کسے طرح	somehow
کوئی وی	someone
کوئی شے	something
کدے کدار	sometimes
گانا	song
چھیتی ای	soon
نفیس	sophisticated
سورانی	Sorani
خراب	sore
زخم	sore
پھوڑا	sore
کھٹا	sore
گلے دی سوزِش	sore throat
دکھ	sorrow
رنج	sorrow
معذرت	Sorry
قسم	sort
تلاش کیتا	sought
روح	soul
ساتھی	soulmate
آواز دینا	sound
سوپ	soup
کھٹا	sour
مڈھ	source
دکھنڑ	south
خالی تھاں	space
بے کار ڈاک	spam
وسعت	span
پھیلاؤ	span
ہسپانوی	Spanish
جان دیو	spare
فالتو	spare
گل کرنا	speak
خاص	special
نوع	species
پرجاتیاں	species
مخصوص	specific
شاندار	spectacular
بول چال	speech
لاجواب	speechless
رفتار	speed
ہجے کرنا	spell
خرچ کرنا	spend
خرچ کیتا	spent
مسالے دار	spicy
سپائیک	spike
ریڑھ	spin
پالک	spinach
روح	spirit
تھک دیو	spit
شاندار	splendid
ونڈیا ہوئیا	split
ونڈیا	split
خراب کرنا	spoil
خراب کرنا	spoiled
بے اختیار	spontaneous
چمچ	spoon
تھاں	spot
ووہٹی	spouse
پھیلاؤ	spread
بہار دا موسم	spring
مربعی	square
دباؤ	squeeze
سکویڈ	squid
گلہری	squirrel
گلی	st
گھونپنا	stab
اصطبل	stable
منڈلی	stack
عملہ	staff
مرحلہ	stage
داغ	stain
پوڑیاں	stairs
سٹیک	stake
پیچھا کرنا	stalk
سٹال	stall
ٹکٹ	stamp
کھڑے ہوو	stand
سٹینڈ	stand
معیار:	standard
ستارہ	star
شروع کرو	start
شروع کیتا	started
بھکوں مرنا	starving
بیان کرو	state
ریاست	state
بیان	statement
اسٹیشن	station
مجسمہ	statue
حالت	status
قیام	stay
رکو	stay
قیام کرو	stay
محفوظ رہوو	stay safe
مستحکم	steady
اسٹیک	steak
چوری کرنا	steal
بھاپ	steam
سٹیل	steel
ڈھلوانی	steep
تنا	stem
اُلانگھ	step
سوٹی	stick
آکڑیا	stiff
اجے وی	still
ساکن	still
ڈنک	sting
بدبودار	stingy
ہلانا	stir
اسٹاک	stock
چوری ہویا	stolen
معدہ	stomach
پتھر	stone
کھڑا ہویا	stood
اسٹول	stool
روکنا	stop
ذخیرہ	storage
اسٹور	store
طوفان	storm
کہانی	story
چلہا	stove
سدھا	straight
سدھی گل کرن آلا	straightforward
موچ	strain
تناؤ	strain
اوپرا	strange
عجیب	strange
اوپرا	stranger
عجیب	stranger
حکمت عملی	strategy
اسٹرا	straw
اسٹرابری	strawberry
دھاری دار	streak
اسٹریم	stream
گلی	street
طاقت	strength
زور دینا	stress
کھچیا	stretch
سخت	strict
ہڑتال	strike
ڈوری	string
پٹی	strip
ہتھ پیر مارنا	strive
کوشش کرنا	strive
فالج	stroke
مضبوط	strong
ماریا	struck
ڈھانچہ	structure
کوشش	struggle
کوشش کرنا	struggle
جدوجہد کرنا	struggle
جدوجہد	struggle
جدوجہد کرنا	struggling
اڑیل	stubborn
آکڑی	stubborn
آکھڑ	stubborn
پھسیا	stuck
طالب علم	student
پڑھائی کرنا	study
پڑھائی	study
پڑھائی کرنا	studying
سامان	stuff
حیرت انگیز	stunning
تعجُب آلی	stunning
بیوقوف	stupid
انداز	style
موضوع	subject
جمع کرانا	submission
جمع کراؤ	submit
مواد	substance
مادہ	substance
متبادل	substitute
نفیس	subtle
کامیاب ہونا	succeed
کامیابی	success
کامیاب	successful
ایہہ	such
جیویں کے	such as
چوسنا	suck
اکو دم	sudden
اچانک ای	suddenly
مبتلا ہونا	suffer
تکلیف کڈھنا	suffering
کافی	sufficient
خاطر خواہ	sufficient
شکر	sugar
صلاح دیو	suggest
صلاح	suggestion
مقدمہ کرو	suit
مقدمہ	suit
موزوں	suitable
مناسب	suitable
سوٹ کیس	suitcase
کل	sum
خلاصہ	summary
گرمی دا موسم	summer
نقطہ عروج	summit
سورج	sun
اتوار	sunday
دھپ	sunny
سورج غروب ہونا	sunset
دھپ	sunshine
سپر	super
برتر	superior
سپروائزر	supervisor
رات دا کھانا	supper
فراہمی	supply
فراہم کرو	supply
سپلائی	supply
حمایت کرو	support
سپورٹ	support
حمایت	support
فرض کرو	suppose
فرض کرو	supposed
یقینی	sure
وساہ	sure
سطح	surface
وادھا	surge
اضافہ	surge
سرجری	surgery
پہلا ناں	surname
حیران کرنا	surprise
حیران	surprised
ہار مننی	surrender
ہتھیار سٹنا	surrender
گھیرنا	surrounding
نگرانی	surveillance
سروے	survey
سروے کرو	survey
زندہ رہو	survive
مشکوک ہونا	suspect
ملزم	suspect
شک کرنا	suspect
مشتبہ	suspect
معطل کیتا	suspended
مشکوک	suspicious
برقرار رکھنا	sustain
پائیداری	sustainability
پائیدار	sustainable
سواگ	swag
ابابیل	swallow
سویپ	swap
قسم چکنا	swear
مٹھا	sweat
مٹھا	sweater
جھاڑو پھیرنا	sweep
مٹھا	sweet
پیارے خواب	sweet dreams
مٹھا دند	sweet tooth
جند جان	sweetheart
سوجن	swell
سوجن	swelling
تیرو	swim
تیر رئیا اے	swimming
سوئنگ	swing
سوئنگ کرنا	swing
مڑنا	swing
تبدیلی	switch
سوئچ	switch
سوئچ کرو	switch
تبدیل کرو	switch
سجیا ہویا	swollen
تلوار	sword
علامت	symbol
ہمدردی	sympathy
علامتاں	symptoms
نظام	system
میز	table
نمٹنا	tackle
ٹیگ	tag
دم	tail
لیو	take
دور کرنا	take away
اپنا خیال رکھنا	take care
لاہ دینا	take off
لے لیا اے	taken
گل وات	talk
گل کرو	talk
باتونی	talkative
لما	tall
ٹیپ	tap
ٹیپ کرو	tap
ٹیپ کرو	tape
ہدف	target
نشانہ	target
ہدف بناؤ	target
کم	task
چکھو	taste
ذائقہ	taste
مزیدار	tasty
سکھایا	taught
چا	tea
پڑھانا	teach
استاد	teacher
ٹیم	team
آنسو بہانا	tear
آہنجو کڈھنا	tears
تنگ کرنا	tease
ٹیکنالوجی	technology
داند	teeth
دسو	tell
مینوں دسو	tell me
مزاج	temper
درجہ حرارت	temperature
مندر	temple
عارضی	temporary
دس	ten
دس ہزار	ten thousand
کرایہ دار	tenant
رحجان اے	tend
رجحان	tendency
کچا	tender
نرم	tender
تناؤ	tense
تناؤ	tension
خیمہ	tent
آزمائشی	tentative
شرط	term
اصطلاح	terms
خوفناک	terrible
شاندار	terrific
لاجواب	terrific
خطہ	territory
ٹیسٹ	test
ٹیسٹ کرنا	test
متن	text
تے	than
شکریہ کہنا	thank
تہاڈا شکریہ	thank you
ساڈی شپمنٹ دی تحقیق کرن تائیں، صبر کرن لئی تہاڈا شکریہ	Thank you for your patience while we investigate shipment
جدوں اسی شپمنٹ دی تحقیق کر رئے آں، تہاڈے صبر لئی تہاڈا شکریہ	Thank you for your patience while we investigate shipment
تہاڈا بوہتی شکریہ	thank you so much
تہاڈا بوہتی شکریہ	thank you very much
شکریہ	thanks
ساڈی ایپ ورتن دا شکریہ	Thanks for using our app
کہ	that
اوہ اے	that is
ایہہ چنگا اے	that's good
دی	the
چوری	theft
اونہاں دا	their
اوہ	them
خیال	theme
موضوع	theme
اوہ آپے	themselves
فیر	then
نظریہ	theory
ایتھے	there
اوتھے نیں	there are
ایتھے اے	there is
تاں جے	therefore
ایہ	these
اوہ	they
اوہ نیں	they are
موٹا	thick
چور	thief
ران	thigh
پتلا	thin
شے	thing
شیواں	things
سوچو	think
تیجا	third
پیاسا	thirsty
تیرہ	thirteen
تیہ	thirty
ایہ	this
ایہہ اے	this is
مکمل	thorough
چنگی طرح	thoroughly
اوہ	those
بھانویں	though
اگرچے	though
سوچ	thought
سوچیا	thought
سوچ وچار نال	thoughtful
خیالات	thoughts
ہزاراں	thousand
تھاگہ	thread
خطرہ	threat
دھمکی دینا	threaten
تن	three
دہلیز	threshold
سنسنی خیز	thrilled
پھلنا پھولنا	thrive
گل	throat
ولوں	through
وچوں	through
پوری طرح	throughout
سٹ دینا	throw
انگوٹھا	thumb
طوفان	thunder
جمعرات	Thursday
اس طرح	thus
چچڑ	tick
موج	tide
صاف	tidy
ٹائی	tie
بندھو	tie
چیتا	tiger
سخت	tight
ٹگرینیا	Tigrinya
ویلا	time
ڈرپوک	timid
نکا جیا	tiny
تجویز	tip
توٹکے	tips
تجویزاں	tips
تھکیا	tire
تھکیا	tired
بافت	tissue
سرنانواں	title
نوں	to
ہونا	to be
ٹوسٹ	toast
آج	today
نکال بال	toddler
پیر دا انگوٹھا	toes
اکٹھیا	together
ٹوائلٹ	toilet
دسیا	told
برداشت	tolerance
برداشت کرنا	tolerate
ٹماٹر	tomato
کل	tomorrow
بولی	tongue
اج رات	tonight
بھی	too
لتا	took
اوزار	tool
اوزار	tools
دند	tooth
اُتے	top
موضوع	topic
پھٹا ہویا	torn
تشدد	torture
کل	total
چھونا	touch
اوکھا	tough
ٹور	tour
دے ول	toward
اوہدے ول	towards
تولیہ	towel
قصبہ	town
زہریلا	toxic
سراغ	trace
سراغ لاؤ	track
تجارت کرو	trade
تجارت	trade
کاروبار	trade
روایت	tradition
روایتی	traditional
ٹریفک	traffic
کھرا	trail
مگرے	trail
سکھلانا	train
سکھلائی	training
خاصیت	trait
خاصیتاں	traits
منتقل کرنا	transfer
تبدیلی	transition
ترجمہ کرنا	translate
شفاف	transparent
ٹرانسپورٹ	transport
نقل و حمل	transportation
پھندہ	trap
چنگل	trap
کوڑا	trash
ٹراما	trauma
سفر	travel
ٹرے	tray
خزانہ	treasure
دعوت	treat
علاج	treatment
رُکھ	tree
ہولناک	tremendous
رحجان	trend
آزمائش	trial
بیوقوف بنانا	trick
کوشش کیتی	tried
محرک	trigger
کارن	trigger
کارن ہونا	trigger
محرک بننا	trigger
تراشنا	trim
دورہ	trip
مشکل	trouble
پتلون	trousers
ٹرک	truck
سچ	true
ٹرنک	trunk
اعتماد کرو	trust
اعتماد	trust
سچ	truth
کوشش کرو	try
سونگا	Tsonga
نلکی	tube
منگل	Tuesday
ٹیوشن	tuition
ترکی	turkey
ٹرمیرک	turmeric
مڑنا	turn
کچھوا	turtle
ٹیوٹر	tutor
وارہ	twelve
ویہ	twenty
اکی	twenty-one
ٹوئی	Twi
دو واری	twice
موڑنا	twist
دو	two
ٹائپ کرو	type
اوسی ورگی	typical
کوہجا	ugly
اخیری	ultimate
چھتری	umbrella
لاچار	unable
چچا	uncle
بے ہوش	unconscious
تھلے	under
تھلے	underneath
گھٹ درجہ بندی	underrated
سمجھو	understand
سمجھیا ہوا	understood
بدقسمتی نال	unfortunately
یونیفارم	uniform
منفرد	unique
اکائی	unit
یونیورسٹی	university
نامعلوم	unknown
جدوں تائیں	unless
اودوں تائیں	until
غیر معمولی	unusual
اتے	up
تہاڈے تے منحصر	up to you
تازہ کرو	update
اپ ڈیٹ	update
اپ گریڈ	upgrade
اپ گریڈ کرنا	upgrade
اتے	upon
پریشان	upset
اپ سیٹ	upset
پریشان ہونا	upset
شہری	urban
صلاح دینا	urge
اکسانا	urge
صلاح	urge
فوری	urgent
اسی	us
استعمال	use
ورتو	use
ورتارا	use
ورتیا	used
مفید	useful
بیکار	useless
عام	usual
بہوتا ای	usually
یوٹیلیٹی	utility
تعطیل	vacation
ویکسینیشن	vaccination
ویکسین	vaccine
خلا	vacuum
مبہم	vague
درست	valid
وادی	valley
قیمتی	valuable
قابل قدر	valuable
قدر کرنا	value
قدر	value
ورائٹی	variety
کئی	various
بدلو	vary
گلدان	vase
وسیع	vast
سبزی	vegetable
سبزیاں	vegetables
گڈی	vehicle
ٹھیکدار	vendor
زہر	venom
وینچر	venture
وینیو	venue
تصدیق کرو	verify
ہمہ گیری	versatile
گناں آلا	versatile
ورژن	version
کھڑے رخ	vertical
بوہتی	very
بوہتی چنگا	very good
برتن	vessel
کونڈا	vessel
ولوں	via
لہر	vibe
وائب	vibe
لہراں	vibes
وائبز	vibes
شیطانی	vicious
بری	vicious
شکار	victim
ویڈيو	video
نظارہ	view
پنڈ	village
ویلن	villain
سرکہ	vinegar
انگور دی فصل	vintage
تشدد	violence
تشدد	violent
دنگا	violent
وائرل	viral
کنواری	virgin
کنیہا	virgin
مجازی	virtual
نیکی	virtue
نظر	vision
دورہ کرو	visit
ویکھو	visit
دورہ	visit
بصری	visual
لازمی	vital
شوخ تے تیز	vivid
ذخیرہ الفاظ	vocabulary
آواز	voice
کالعدم	void
والیم	volume
رضاکار	volunteer
ابکائی	vomit
ابکائی لینا	vomit
الٹی کرنا	vomit
الٹی	vomit
غیر محفوظ	vulnerable
کمزور	vulnerable
اگوائی	wage
اگوائی	wages
لک	waist
اڈیک کرنا	wait
ویٹر	waiter
اڈیک کرنا	waiting
جاگو	wake
جاگو	wake up
واک کرو	walk
سیر	walk
واک	walk
واک کر رئیا اے	walking
کند	wall
بٹوہ	wallet
آوارہ پضرنا	wander
گھمنا	wander
چاہت	wanna
چاہندا اے	want
چاہندا سی	wanted
جنگ	war
الماری	wardrobe
ویئرہاؤس	warehouse
گرم	warm
گرم کرنا	warm
خبردار کرنا	warn
خبردار کرنا	warning
جنگجو	warrior
سی	was
دھونا	wash
کوڑا	waste
ضائع کرنا	waste
گھڑی	watch
پانی	water
تربوز	watermelon
لہر	wave
رستہ	way
اسی	we
اسی آں	we are
اسی کر سکدے آں	we can
کمزور	weak
کمزوری	weakness
دولت	wealth
امیر	wealthy
پاندا اے	wear
پانا	wearing
موسم	weather
ویاہ	wedding
بدھ	Wednesday
گھاہ	weed
جھاڑیاں	weed
ہفتہ	week
ہفتے دا اخیر	weekend
وزن	weight
وزن کرو	weight
عجیب	weird
جی آیاں نوں کہنا	welcome
کلیان	welfare
بہبود	welfare
چنگا	Well
بوہتی چنگا	well done
گیا	went
سی	were
پچّھم	west
گلا	wet
وہیل	whale
کی	what
تہاڈے بارے اچ کی	what about you
تسی کی کر رئے او	what are you doing
تسی ایس ویلے کی کر رئے او	what are you doing now
تسی ایس ویلے کی کر رئے او	what are you doing right now
تسی کی کردے او	what do you do
تسی زندہ رہن دے لئی کی کردے او	what do you do for a living
تہاڈا کی مطلب اے	what do you mean
تسی کی چاہندے او	what do you want
کی ہویا	what happened
کی اے	what is
ایہہ کی اے	what is this
تہاڈی کی ملازمت اے	what is your job
تہاڈا ناں کی اے	what is your name
کی ہو رئیا اے	what's up
تہاڈا ناں کی اے	what's your name
جو کجھ وی	whatever
کنک	wheat
پہیہ	wheel
کدوں	when
جدوں	when
جدوں وی	whenever
جتھے	where
کتھے	where
تسی کتھے او	where are you
تسی کیہڑی تھاں توں او	where are you from
تسی ایس ویلے کتھے او	where are you now
تسی کتھے رہندے او	where do you live
کتھے اے	where is
جدوں کے	whereas
بھانویں	whether
جیہڑا	which
کیہڑا	which
جدوں	while
سوگوشی کرنا	whisper
سیٹی	whistle
سفید	white
کون	who
تسی کون او	who are you
کون اے	who is
ایہہ کون اے	who is this
سارا	whole
کیس نوں	whom
کنہاں دا	whose
کیوں	why
کیوں نی	why not
بدکار	wicked
کھلا	wide
بیوہ	widow
چوڑائی	width
ووہٹی	wife
جنگلی	wild
گے	will
گی	will
گا	will
وصیت	will
رضامند	willing
تیار	willing
جیتنا	win
ہوا	wind
باری	window
ہوا دار	windy
شراب	wine
سردی دا موسم	winter
وائپس	wipe
تار	wire
وائر	wire
حکمت	wisdom
سپان پت	wisdom
سیانا	wise
خواہش کرو	wish
خواہش	wish
تہاڈے لئی نیک تمناواں	wish you all the best
ڈائن	witch
دے نال	with
پچھے ہٹنا	withdraw
رقم کڈھوانا	withdrawal
وچ	within
بغیر	without
گواہ	witness
گواہی دینا	witness
مخولی	witty
بھیڑیا	wolf
زنانی	woman
زنانیاں	women
جیتیا	won
نہ کرو	won't
حیران کرنا	wonder
انوکھا	wonderful
لکڑی	wood
اون	wool
لفظ	word
لفظ	words
کم کرنا	work
کم کاج	work
ورزش کرو	work out
کم کر رئیا	working
جگ	world
کیڑا	worm
پہناوا	worn
فکرمند	worried
فکرمند ہونا	worry
بوہتی بھیڑا	worse
عبادت کرنا	worship
بوہتی مندا	worst
قدر	worth
قدر	worth it
قابل	worthy
گے	would
گی	would
گا	would
زخم	wound
واہ جی	Wow
لپیٹنا	wrap
غضب	wrath
وینی	wrist
لکھو	write
ایتھے لکھو	Write here
لکھنا	writing
لکھت اچ	written
غلط	wrong
لکھیا	wrote
صحن	yard
جمائی	yawn
جمائی لینا	yawn
آہو	Yeah
سال	year
ورھے	years
خمیر	yeast
چیکاں مارنا	yell
پیلا	yellow
آہو	Yes
آہو میری جان	yes baby
آہو جی	yes dear
آہو سوہنڑیے	yes honey
آہو، میری سوہنڑیے	yes my love
آہو، یقیناً	yes of course
کل	yesterday
اجے تائیں	yet
منظور	yield
قبول کرنا	yield
تسی	you
تسی او	you are
تسی سوہنڑے او	you are beautiful
تسی بوہتی خوبصورت او	you are so beautiful
تہانوں جی آیاں نوں	you are welcome
تسی کر سکدے او	you can
تسی جاندے او	You know
تسی وی	you too
تہانوں جی آیاں نوں	you're welcome
جوان	young
تہاڈا	your
تہاڈا سواگت اے	your welcome
تسی آپے	yourself
گھبرو	youth
تہانوں جی آیاں نوں	you’re welcome
خوش آمدید	you’re welcome
لذیذ	yummy
صفر	zero
