jekh	a
zalaga	a little
but	a lot
but	a lot of
mukhel	abandon
mukhlo	abandoned
beśel	abide
śajnipen	ability
kapàbilo	able
palal	about
opral	above
ande aver thema	abroad
absènca	absence
absènto	absent
absolùto	absolutely
piel	absorb
abstràkto	abstract
rezumàto	abstract
absùrdo	absurd
abundènca	abundance
but	abundant
abuzizel	abuse
tratisarel nasul	abuse
akcènto	accent
akceptisarel	accept
akcèso	access
akcidènto	accident
beśipen	accommodation
agorisarel	accomplish
kerdo	accomplished
konfòrmo	according
deskrìpcia	account
kònto	account
precìzia	accuracy
korèkto	accurate
doślărdo	accused
dukhal	ache
dukh	ache
azbal	achieve
realizàcia	achievement
prinзarel	acknowledge
prinзardo manuś	acquaintance
liel	acquire
kinel	acquire
lino	acquired
akizìcia	acquisition
kidipen	acquisition
opral	across
dokumènto	act
khelel jekh ròlo	act
phiravel pes	act
àkcia	action
kerel àkcia	action
aktìvo	active
aktivimata	activities
aktivipen	activity
aktòro	actor
ćaćo	actual
ćaćipnasөe	actually
rostărdo	acute
akùto	acute
adaptisarel	adapt
kidel	add
dependènto	addicted
kideripen	addition
adicionàlo	additional
adrèsa	address
adresizel	address
adekvàto	adequate
adiacènto	adjacent
paśnavni	adjective
adaptisarel	adjust
kamlărel	admire
mukhel	admit
prinзarel	admit
adoptisarel	adopt
but śukar	adorable
avànso	advance
зal angle	advance
modèrno	advanced
ućo nivèlo	advanced
spidindo	advanced
avantàźo	advantage
aventùra	adventure
advèrbo	adverb
reklàma	advertisement
reklàma	advertising
svàto	advice
svàto	advise
partizàno	advocate
del vast	advocate
estètiko	aesthetic
butĭ	affair
azbal nasul	affect
kamipen	affection
śajarel	afford
akcesìbilo	affordable
traśavdo	afraid
palal	after
palomezimèri	afternoon
maj palal	afterwards
palem	again
mamuj	against
berśipen	age
agencìa	agency
agènto	agent
agresìvo	aggressive
godălo	agile
akana	ago
si de akòrdo	agree
kontràkto	agreement
akòrdo	agreement
agrikultùra	agriculture
anglal	ahead
del vast	aid
vastdinipen	aid
res	aim
kamel	aim
àero	air
nemărel	air
bićhael po ràdio	air
aeropòrto	airport
intervàlo	aisle
alarmizel	alarm
alàrma	alarm
alkoòlo	alcohol
enèrgiko	alert
alèrta	alert
зivdo	alive
savorre	all
śukar	all right
kamav tuqe so si maj laćho	all the best
mukhel	allow
mukhlem	allowed
mekhlo	allowed
paśal	almost
korkorro	alone
po dїlgipen	along
Miśto	Alright
vi	also
alternatìva	alternative
sathaj	although
savaxt	always
sem	am
ćudipnasqo	amazing
biklàro	ambiguous
ambìcia	ambition
ambiciòso	ambitious
laćharel	amend
maśkar	amid
maśkar	among
maśkar amenөe	among us
koboripen	amount
asavno	amusing
jekh	an
analìza	analysis
ćirlatutne	ancestors
beriphand	anchor
purano	ancient
thaj	and
thaj tu	and you
їnзero	angel
xoli	anger
kunз	angle
xolăriko	angry
зivutro	animal
koć	ankle
berśisaripen	anniversary
nevipen	announcement
xolărel	annoy
xolăme	annoyed
enervànto	annoying
berśutno	annual
anonìmo	anonymous
aver	another
angledinipen	answer
kerel anticipàcia	anticipate
grìźa	anxiety
biśando	anxious
orso	any
maj	anymore
sarkon	anyone
orso	anything
orsar	anyway
orsar	anyways
ulavdo	apart
apartamènto	apartment
jertisarel	apologize
dikhlŏver	apparent
dikhlŏl	apparently
apèlo	appeal
atràkcia	appeal
mangel	appeal
inklel	appear
inklipen	appearance
inklisto	appeared
falas so	appeared
bokh	appetite
phabaj	apple
aplikàcia	application
aplikisarel	apply
anavăripen	appointment
programàcia	appointment
prinзarel	appreciate
mol	appreciate
prinзaripen	appreciation
barăripen	appreciation
paśovel	approach
azbalipen	approach
laćho	appropriate
liel	appropriate
ćorel	appropriate
aprobisaripen	approval
aprobisarel	approve
aprobisardo	approved
opre tele	approximately
aprìlo	april
arbitràro	arbitrary
arhitèkto	architect
arhitektùra	architecture
arhìva	archive
sam	are
tu san	are you
san okupime	are you busy
san prandime	are you married
san prandizme vaj korkorro	are you married or single
Maj san kothe	Are you still there?
tu san kothe	are you there
ària	area
xal pes	argue
argumènto	argument
ćingar	argument
anklel	arise
uśtel	arise
del àrme	arm
àrma	arm
vast	arm
àrmia	army
trujal	around
aranźizel	arrange
aranźamènto	arrangement
avilipen	arrival
aresel	arrive
areslem	arrived
arogànto	arrogant
drun	arrow
àrta	art
artìkulo	article
artificiàlo	artificial
artìsto	artist
sar	as
kobor vrjama	as long as
sa kadja	as well
vi	as well as
ućhar	ash
laзavdo	ashamed
pućhel	ask
pućhlem	asked
sovlărdo	asleep
aspèkto	aspect
Asamezikani ćhib	Assamese
atakizel	assault
atàko	assault
malavipen	assembly
ansàmblo	assembly
asertìvo	assertive
kerel evaluàcia	assess
evaluàcia	assessment
molipen	asset
kapitàlo	asset
mandĭn	assets
abilitèto	assets
bićhalel	assign
del	assign
tèma	assignment
dutĭ	assignment
del vast	assist
asistènto	assistant
asociàto	associate
kerel asociàcia	associate
phandavdo	associated
asociàcia	association
kerel supozìcia	assume
supozìcia	assumption
k-o	at
po zalaga	at least
xalem	ate
atlèto	athlete
umblavel	attach
umblavdo	attached
anèksa	attachment
kamipen	attachment
atakizel	attack
atàko	attack
zumavipen	attempt
zumavel	attempt
liel kotor	attend
frecvènca	attendance
prezènca	attendance
atència	attention
phiravipen	attitude
cirdel	attract
atràkcia	attraction
atraktìvo	attractive
atribùto	attribute
audiènca	audience
àugusto	august
bibi	aunt
bibŏrri	aunty
autèntiko	authentic
autòro	author
autoritèto	authority
angloivend	autumn
disponìbilo	available
mèdia	average
kerel mèdia	average
ferizel pes	avoid
nerno	awake
del prèmio	award
prèmio	award
godărdo	aware
somgodĭpen	awareness
dur	away
but śukar	awesome
darano	awful
laзavdo	awkward
pharo	awkward
Aimarikani ćhib	Aymara
piramni	baby
xurdorro	baby
korkorro manuś	bachelor
palal	back
зanimata	background
kondìcie	background
fundàlo	background
nasul	bad
gonorro	bag
thol ando gonorro	bag
зungali зuvli	bag
momeàla	bait
xolărel	bait
pekel	bake
brutärìa	bakery
bikarbonàto	baking soda
inkerel ekilìbro	balance
balànca	balance
tòpa	ball
Bambarikani ćhib	Bambara
banàna	banana
muzikaqi formàcia	band
grùpo	band
baro dab	bang
del baro dab	bang
depòzito	bank
bànka	bank
kotor	bar
bàro	bar
bàra	bar
kinipen	bargain
kerel fòros	bargain
koàźa	bark
baśipen	bark
śodĭ	barley
barièra	barrier
bàza	base
bazikano	based
pìvnica	basement
bazikano	basic
generalosөe	basically
busuiòko	basil
ćorrikano	bastard
grùpo	batch
najaripen	bath
nanărlin	bathroom
baterìa	battery
maripen	battle
gòlfo	bay
baśel	bay
si	be
te oves atènto	be careful
plàźa	beach
berand	beam
phraj	beam
fasuj	beans
ingerel	bear
akceptisarel	bear
rićhino	bear
ćhor	beard
rulmènto	bearing
supòrto	bearing
dìvio зivutro	beast
marel	beat
śukar	beautiful
śukaripen	beauty
avilo	became
kodolesqe	because
avel	become
sovthan	bed
sovipnasqi livni	bedroom
birovli	bee
rovel pes	beef
guruvnăqo mas	beef
sas	been
bira	beer
anglal	before
astardăs	began
astarel	begin
śirdipen	beginning
interèso	behalf
phiravel pes	behave
phiravipen	behavior
phiravipen	behaviour
palal	behind
isindoj	being
patăipen	belief
patăl	believe
perr	belly
si	belong
зal miśto	belong
kamli	beloved
telal	below
sirìmi	belt
bànka	bench
bandăripen	bend
bandărel	bend
telal	beneath
liel benefìciură	benefit
benefìcio	benefit
avantàźură	benefits
paśal	beside
thaj maj but	besides
o maj laćho	best
te oves tut baxt	best of luck
te aven baxtale	best regards
maj laćho	better
maśkar	between
pimos	beverage
prdal	beyond
Bhoзpurikani ćhib	Bhojpuri
preferìnca	bias
pi diagonàla	bias
kerel preferìnca	bias
kaj inkerel varekaça	biased
bićiklèta	bicycle
salutizel	bid
ofèrta	bid
baro	big
bicìkla	bike
pokinipnasqo nòta	bill
banknòta	bill
krisaqo projèkto	bill
suvel khethanes	bind
pansamènto	bind
ćirikli	bird
biandipnasqo dĭves	birthday
tikno kotor	bit
jagalo	bite
dandarel	bite
dandaripen	bite
kerko	bitter
kalo	black
śukar murś	blade
patrin	blade
làma	blade
dośalărel	blame
doś	blame
ćućo	blank
biekspresìvo	blank
kuri	blanket
eksplòzia	blast
kritikisarel	blast
parnărel	bleach
їnälbitòri	bleach
xamisarel	blend
baxtărel	bless
baxtărdo	blessed
koro	blind
baxt	bliss
blòkos	block
grùpo	block
blokizel	block
rat	blood
luludărel	bloom
phurdel	blow
sìnio	blue
birostărdo	blunt
bi sentimèntură	blunt
vazdel pes k-o bòrdo	board
tàbla	board
bero	boat
kòrpo	body
kiravel	boil
thulărdo	bold
ilvaз	bold
phandlipen	bond
garancìa	bond
kòkalo	bone
lil	book
barărel	boost
barăripen	boost
vastdinipen	booster
portbagàźo	boot
ćìzma	boot
bokànko	boot
kheră	boots
grànica	border
pliktisizel	bore
xїvărel	bore
pliktisime	bored
bi interesànto	boring
biando	born
vunзarel	borrow
śerutno	boss
s-ol duj	both
deranźizel pes	bother
efòrto	bother
tuśni	bottle
telutni rig	bottom
kindem	bought
kindo	bought
xutipen	bounce
xutel	bounce
dutisardo	bound
xutipen	bound
phandlo	bound
grànice	boundaries
fùnda	bow
serben	bow
bandărel pes	bow
kaśtaqi tòpa	bowl
bazìno	bowl
ćaro	bowl
moxton	box
ćhavo	boy
piramno	boyfriend
bricàra	bracelet
godĭ	brain
ranik	branch
ulavel pes dujenөe	branch
sektòro	branch
màrka	brand
tromalo	brave
phagipen	breach
manro	bread
phagel	break
pàuza	break
texarinăqo xaben	breakfast
ćući	breast
phurdipen	breath
phurdel	breathe
phurdipen	breathe
spèćia	breed
kerel reprodùkcia	breed
kärämìda	brick
bori	bride
phurt	bridge
phenel xarnes	brief
xarno	brief
dudalo	bright
straftinălo	brilliant
geniàlo	brilliant
anel	bring
phral	bro
bilaćho	broad
buxlo	broad
emìsia po ràdio	broadcast
bilovenqo	broke
phaglem	broke
phaglo	broken
śulav	broom
phral	brother
salo	brother in law
andăs	brought
maronìo	brown
brung	brush
makhni	brush
azbal lokhes	brush
kїkavi	bucket
amal	buddy
buзèto	budget
problèma	bug
baktèria	bug
зundro	bug
vazdel	build
konstrùkcia	building
vazdino	built
but	bulk
tàuros	bull
marno	bully
śuvlipen	bump
malavel zorales	bump
dab	bump
klònko	bunch
grùpo	bunch
ćhivel	bundle
phandlipen	bundle
kerel pharipen	burden
pharipen	burden
praxome	buried
thabarel	burn
eksplòzia	burst
praxonel	bury
autobùzo	bus
brung	bush
bìzniso	business
bùsto	bust
okupime	busy
liel pes	busy
ama	but
khil	butter
paparùda	butterfly
koćak	button
kinel	buy
paśal	by
adalave	by the way
devleça	bye
śax	cabbage
dulàpo	cabinet
rajipen	cabinet
luvorro	cage
guldipen	cake
guruvorro	calf
gàmba	calf
sunizel	call
del muj	call
anavărel	call
phen manqe	call me
sunize man	call me
anavărdo	called
dino muj	called
sunizdăs	called
kàlmo	calm
avilo	came
kampània	campaign
konsèrva	can
śaj	can
me n-aśti	can't
Anulisarel	Cancel
kànćero	cancer
śajarel	capable
kapacitèto	capacity
bari grafèma	capital
śerutno fòros	capital
kapitàlo	capital
tìtulo	caption
astarel	capture
maśìna	car
karièra	career
atènto	careful
e atenciàça	carefully
biatènto	careless
laćho	caring
kaśtalo	carpenter
kovòri	carpet
morkoj	carrot
ingerel	carry
kerel maj dur	carry on
kerel	carry out
moxton	case
kàzo	case
pokinel	cash
love	cash
ćhudel	cast
matrìca	cast
aktòrură	cast
filatin	castle
bioficiàlo xurăvipen	casual
temporàro	casual
mùca	cat
astarel	catch
kategorìa	category
guruva	cattle
astardo	caught
kàuza	cause
atència	caution
avertizàcia	caution
atènto	cautious
pèśtera	cave
aćhavel	cease
plafòno	ceiling
barodivesarel	celebrate
ćelùla	cell
ćhel and-o maśkar	center
maśkar	center
śeliberś	century
germo	cereal
ceremonìa	ceremony
nesave	certain
sìguro	certain
sìguro	certainly
certifikàto	certificate
thol and-o зanзir	chain
зanзir	chain
skamin	chair
provokàcia	challenge
śànsa	chance
paruvipen	change
paruvel	change
hàoso	chaos
personàźo	character
karakterìstike	characteristics
dośalărel	charge
mangel love	charge
karitèto	charity
śukar	charming
gràfiko	chart
zumavel te liel	chase
naśel palal varekon	chase
borizel	chat
bikuć	cheap
atharipen	cheat
atharel	cheat
atharipen	cheating
kerel verifikàcia	check
ćham	cheek
lośŏl	cheer
lośalo	cheerful
baxt	cheers
kiral	cheese
kimìa	chemistry
kamel	cherish
śàho	chess
kolin	chest
motxon	chest
ćambel	chew
pùios	chicken
traśavno	chicken
śerutno	chief
xurdo	child
ćhavorripen	childhood
xurdorre	children
śudripen	chill
śudrărel	chill
hòrno	chimneys
ćhorvit	chin
ćokolàta	chocolate
alosaripen	choice
alosarel	choose
ćhinel	chop
bută and-o kher	chores
thulorro	chubby
khangeri	church
skorciśoàra	cinnamon
trujarel	circle
truj	circle
trujalimata	circumstances
themutno	citizen
diz	city
afirmàcia	claim
phenel	claim
kerel klàro	clarify
ankalavel o pani andar o khil	clarify
klàsa	class
òra	class
ćik	clay
uźo	clean
klàro	clear
bikinitòri	clerk
funkcionàro	clerk
godăver	clever
kliènto	client
barrutno blòko paśal o pani	cliff
klimàto	climate
vazdipen	climb
vazdel pes	climb
ćatro	clingy
lośalipen	clock
ćàso	clock
phandavel	close
śifonièro	closet
garavdo	closet
poxtan	cloth
dїrza	cloth
xurăvimata	clothes
maruth	cloud
maruthalo	cloudy
klòvno	clown
del indikàcie	clue
indikàcia	clue
biśajno	clumsy
grùpo	cluster
kidel pes	cluster
autokàro	coach
antrenòro	coach
angar	coal
grànica	coast
koàsta	coast
zubùno	coat
kafava	coffee
kognitìvo	cognitive
koinćidènca	coincidence
śudro	cold
śil	cold
kòlapso	collapse
gùlero	collar
zgàrda	collar
kolièro	collar
kolègo	colleague
kolègură	colleagues
kidel	collect
rugisaripen	collect
kolèkcia	collection
kolèзo	college
rang	color
rangărel	color
birangaqe zelena idèe sute e xolăça	colorless green ideas slept furiously
rang	colour
rangărel	colour
kolùmna	column
phagel pes	comb
kangli	comb
kombinàcia	combination
kombinisarel	combine
avel	come
av orde	come here
mangav tut	come on
śirdel	come on
inklel opro sćèna	come on
konfòrto	comfort
azbal kovles	comfort
komfortàbilo	comfortable
avav	coming
kaj avela sigo	coming soon
komànda	command
зanipen	command
kerel komentàrio	comment
komentàrio	comment
komerciàlo	commercial
komìsia	commission
kerel	commit
angaźamènto	commitment
dedikime	committed
butĭ	commodity
khethano	common
vakărel	communicate
vakăripen	communication
khetanipen	community
navèta	commute
kerel i navèta	commute
paruvel	commute
partenèro	companion
kompanìa	company
kerel komparàcia	compare
komparàcia	comparison
mìla	compassion
kaj si les mìla	compassionate
kompatìbilo	compatible
liel kotor and-i kompetìcia	compete
kompetènto	competent
kompetìcia	competition
kompetitìvo	competitive
rovel pes	complain
reklamàcia	complaint
kompletisarel	complement
komplemènto	complement
kompletisarel	complete
sastes	completely
komplèkso	complex
respektisaripen	compliance
pharo	complicated
komplimènto	compliment
respektizel	comply
kompozìcia	composition
kompùso	compound
xatăripen	comprehension
komprehensìvo	comprehensive
kerel kompromìso	compromise
kompromìso	compromise
musajutno	compulsory
kalkulatòri	computer
concentrisarel	concentrate
koncèpto	concept
grìźa	concern
interesizel	concern
dikhel	concern
interesime	concerned
koncèrto	concert
konklùzia	conclusion
betòno	concrete
konkrèto	concrete
kondìcia	condition
kondìcie	conditions
tradel	conduct
phiravipen	conduct
konfirència	conference
phenel	confess
patĭv	confidence
їnkrezome	confident
konfirmisarel	confirm
konflìkto	conflict
konfùzo	confused
konfùzia	confusion
phandlipen	conjunction
konźùnkcia	conjunction
konektizel	connect
viзarel	conquer
зangavdo	conscious
somзanipen	consciousness
mukhipen	consent
konsećìnce	consequences
brakhipen	conservation
konservatìvo	conservative
godisarel	consider
godisardo	considered
kerdo andar	consist
konsistènca	consistency
konsistènto	consistent
konstànto	constant
konstànto	constantly
konstipàcia	constipation
konstrùkcia	construction
konsumisarel	consume
konsùmo	consumption
kontàkto	contact
kontaktizel	contact
kontaзiòso	contagious
anderărel	contain
anderărel	contains
kontemporàno	contemporary
prasavipen	contempt
ander	content
naisardo	content
naisarel	content
kompetìcia	contest
kerel kontestàcia	contest
kontèksto	context
kontinènto	continent
kerel maj dur	continue
tangărel pes	contract
kerel kontràkto	contract
kontràkto	contract
kerel komparàcia	contrast
kontràsto	contrast
anel kontribùcia	contribute
kontribùcia	contribution
kerel kontròlo	control
kontròlo	control
kontroversàto	controversial
avantàźo	convenience
xїndelin	convenience
konvenàbilo	convenient
vakăripen	conversation
paruvel	convert
bićhalel	convey
phenel	convey
paćavel	convince
paćavdem	convinced
paćavdo	convinced
kiravno	cook
kerel xaben	cook
kerel xaben	cooking
śukar	cool
śudro	cool
śando	cool
kooperàcia	cooperation
marel pes	cope
xarkum	copper
ankalavel o maśkar	core
esènca	core
maśkar	core
kukurùzo	corn
kunз	corner
korèkto	correct
molipen	cost
mol	cost
kostùmo	costume
kher	cottage
bumbàko	cotton
mothovel	couch
kanapea	couch
xasal	cough
xas	cough
aśtizelas	could
konsìlo	council
ginavipen	count
ginel	count
patăl	count
kalkulatòri	counter
giśeo	counter
them	country
gavutni zòna	countryside
duj	couple
kùplo	couple
kuràźo	courage
kùrso	course
tratamènto	course
bar	court
tribunàlo	court
respèkto	courtesy
veriśoro	cousin
ućharel	cover
ućharni	cover
guruvni	cow
traśalo	coward
konfortàbilo	cozy
kràbo	crab
pheras	crack
phagel	crack
kerel meśteśùgo	craft
meśteśùgo	craft
khul	crap
akcidènto	crash
perel zorales	crash
pòfta	craving
tikni vitèza	crawl
зa pe ćanga	crawl
dilo	crazy
kerel	create
kreatìvo	creative
krèdito	credit
patĭv	credit
зal ćoral	creep
traśavno	creepy
ekìpa	crew
mudaripen	crime
laзal	cringe
del pes palal	cringe
krìza	crisis
kritèrie	criteria
importànto	critical
krìtiko	critical
krìtika	criticism
rekòlta	crop
rekòlta	crops
truśul	cross
nakhel	cross
kurung	crow
butanipen	crowd
pherdo	crowded
koròna	crown
esenciàlo	crucial
bimilaqo	cruel
phiripen and-o bero	cruise
phagel	crush
xolărel	crush
rovipen	cry
rovel	cry
del muj	cry
krestevèco	cucumber
del angali	cuddle
kultùra	culture
ćorno	cunning
ćàśka	cup
kùpa	cup
dulàpo	cupboard
lìmita	curb
bordùra	curb
kontrolisarel	curb
tratamènto	cure
tratisarel	cure
interdìkcia te зal avri	curfew
kuriozitèto	curiosity
kuriòso	curious
krecome	curly
valùta	currency
akanutno	current
kurènto	current
akana	currently
del armană	curse
arman	curse
perdĭ	curtain
śerand	cushion
aćar	custom
kliènto	customer
vàma	customs
ćhinel	cut
kućorro	cute
ćiklo	cycle
ciklìsmo	cycling
dad	dad
dadorro	daddy
divesutno	daily
thudesqi fèrma	dairy
grastni	dam
dìgo	dam
vazdel jekh dìgo	dam
rimosaripen	damage
del armană	damn
arman	damn
kritikisarel	damn
kingărdo	damp
kehlipen	dance
khelel	dance
perìkulo	danger
traśorno	dangerous
tamlo	dark
dràgo	darling
zorali dab	dash
del dab	dash
naśel sigo	dash
dàte	data
dàta	date
malavipen	date
xramosarel i dàta	date
ćhaj	daughter
dĭves	day
mulo	dead
tèrmeno	deadline
kaśuko	deaf
kerel fòros	deal
xatăripen	deal
kuć	dear
Kuć Manuśa	Dear All
Kuć Kliènto	Dear Customer
Kuć Dadalen thaj Dajalen	Dear Parents
Kuć Raja	Dear Sir
Kuć Studèntură	Dear students
Kuć Ekìpa	Dear Team
meripen	death
del duma	debate
vakăripen	debate
debitizel	debit
dèbito	debit
kotora phagle	debris
dutĭ	debt
deśberś	decade
rimosarel	decay
mulo	deceased
atharel	deceive
decèmbro	december
decènto	decent
kerel decìzia	decide
kerdem i decìzia	decided
decìzia	decision
berosqi pùntea	deck
teràsa	deck
dekorizel	deck
na kamel	decline
tiknărel	decline
tiknărel	decrease
dedikime	dedicated
didikàcia	dedication
keripen	deed
xor	deep
ćèrbo	deer
pokinel butpalal	default
viзavel	defeat
marel	defeat
rakhel	defend
xalărel	define
sìguro	definitely
definìcia	definition
gràdo	degree
avel butpalal	delay
avilo butpalal	delayed
ćhinel	delete
liel jekh decìzia	deliberate
delikàto	delicate
but laćho	delicious
satisfàkcia	delight
but naisardo	delighted
tradel	deliver
bianel	deliver
tradino	delivered
tradipen e butĕnqo	delivery
mangel	demand
mangipen	demand
kaj mangel baro efòrto	demanding
demokràcia	democracy
dèmono	demon
demonstrisarel	demonstrate
bićaćardo	denied
densitèta	density
dentìsto	dentist
bićaćarel	deny
departamènto	department
telăripen	departure
umblal	depend
bićhalel	deploy
sikavel	deploy
ćhel	deposit
lovenqo depòzito	deposit
xolăme	depressed
tiknărdo	depressed
xїv	depression
deprèsia	depression
xoripen	depth
kerel deskrìpcia	describe
deskrìpcia	description
deśèrto	desert
mukhel	desert
si man o drèpto	deserve
dizàino	design
anavăripen	designation
kamipen	desire
bànka	desk
niraś	despair
niraśdo	desperate
mamuj	despite
desèrto	dessert
destinàcia	destination
destìno	destiny
xarravel	destroy
rimosaripen	destruction
detaj	detail
detaja	details
arakhel	detect
dikhel	detect
determinàcia	determination
determinisarel	determine
determinisardo	determined
but xolăme	devastated
komplèto rimosardo	devastated
buxlărel	develop
buxlărdo	developed
buxlăripen	development
divaiso	device
beng	devil
dedikime	devoted
Dhivehikani ćhib	Dhivehi
diabèto	diabetes
diarèa	diarrhea
źurnàlo	diary
dikcionàro	dictionary
kerdem	did
merel	die
mulo	died
dièta	diet
diferènca	difference
diferime	different
pharo	difficult
xunavipen	dig
xunavel	dig
dignipen	dignity
butărno	diligent
rătaqo xaben	dinner
ćhivel and-o pani	dip
śudro sòso	dip
xulel pes	dip
dirèkto	direct
dirèkcia	direction
dirèktoro	director
melalipen	dirt
melalo	dirty
kerel handikàpo	disable
aćhavel	disable
e dizabilitetoça	disabled
xasavel pes	disappear
dezamägime	disappointed
bari bibaxt	disaster
ćhudel	discard
mukhel te зal	discharge
disciplìna	discipline
tiknărel	discount
arakhel	discover
diskriminàcia	discrimination
del duma	discuss
vakăripen	discussion
nasvalipen	disease
nasvalimata	diseases
màska	disguise
garavel	disguise
зungalo	disgusting
xaben	dish
ćaro	dish
tiàră	dishes
mukhel te зal	dismiss
del avri	dismiss
mudarel	dispatch
tradipen	dispatch
ekspozìcia	display
sikavel	display
ćhudipen	disposal
bikinipen	disposal
sikavel pes mamuj	dispute
ćingar	dispute
distànca	distance
distìnkto	distinct
dikhel phares	distinguish
kerel diferènca	distinguish
bari dukh	distress
dukhavel	distress
distribùcia	distribution
distrìkto	district
deranźizel	disturb
śànco	ditch
natisarel telal o pani	dive
mekhel and-o pani	dive
verver	diverse
ververipen	diversity
ulavel	divide
devlikano	divine
divòrco	divorce
baldime	dizzy
bigodăqo	dizzy
kerel	do
dukhas tu manqe	do you love me
dòktoro	doctor
dokumènto	document
kerel	does
vov na	doesn't
зukel	dog
Dogrikani ćhib	Dogri
kerindoj	doing
papùśa	doll
umal	domain
kheresqo	domestic
dominànto	dominant
na	don't
Te na keres tuqe grìźa	Don't worry
del	donate
kerdo	done
xer	donkey
drògo	dope
bigodăver	dope
dublùra	double
dujvarno	double
na patăl	doubt
xumer	dough
tele	down
ćućărel	download
aerosqo thavdipen	draft
plàno	draft
pokinipnasqo òrdino	draft
ligărel tele	drag
aćhavni	drag
thavdel	drain
khinŏl	drain
piel	drain
teàtro	drama
teatrosqi pièsa	drama
dràma	drama
cirdel	draw
ćitrel	draw
ćitrărno	drawer
sirtàri	drawer
ćitro	drawing
kerel pesqe bari grìźa	dread
kaj kerel bari grìźa	dread
bari grìźa	dread
suno	dream
ròkia	dress
urăvel pes	dress
pusavni	drill
pimos	drink
zor	drive
tradel i maśina	drive
ćuli	drop
ingerdo e maśinaça	dropped
pelo	dropped
śutipen	drought
mato	drunk
śuko	dry
raćni	duck
snòbo	dude
aźukerdo	due
tèrmeno	due
andar	due to
bi interesànto	dull
bidudalo	dull
lalo	dumb
ćhudel	dump
bikinel bikuć	dump
inkeripen	duration
ando vaxt kaj	during
pràxo	dust
dutĭ	duty
beśel	dwell
cidel po dĭ	dying
svako	each
jekh avres	each other
kaj kamel	eager
phakhvaзvalo	eagle
kan	ear
maj anglal	earlier
but anglal	early
kerel love	earn
kana	ears
phuv	earth
kutrèmuro	earthquake
lokhărel	ease
lokhes	easily
èsto	east
lokho	easy
xal	eat
xaben	eating
ekonòmiko	economic
ekonomìa	economy
rostăripen	edge
editizel	edit
edukàcia	education
efèko	effect
eficiènto	effective
aktìvo	effective
eficiència	efficiency
eficiènto	efficient
efòrto	effort
vanro	egg
vùnoto	eggplant
ego	ego
oxto	eight
deśuoxto	eighteen
oxtovardeś	eighty
nić	either
kerel	elaborate
kuni	elbow
maj phuro	elder
phuro	elderly
elegànto	elegant
elemènto	element
elefànto	elephant
deśujekh	eleven
eligìbilo	eligible
del avri	eliminate
aver	else
laзavdo	embarrassed
laзavipnasqo	embarrassing
angalipen	embrace
akceptizel	embrace
anklel	emerge
urзènca	emergency
emotìvo	emotional
empatìa	empathy
akcènto	emphasis
ćhel o akcènto	emphasize
angaźàto	employee
angaźàtură	employees
angaźatòro	employer
butăqo than	employment
ćućo	empty
lokhărel	enable
malavel	encounter
del vast	encourage
agorisarel	end
agor	end
phardo	endangered
efòrto	endeavor
kerel efòrtură	endeavor
rezistènca	endurance
terpinel	endure
inkerel	endure
biamal	enemy
energìa	energy
implikisarel pes	engage
cirdel atència	engage
angaźìzel	engage
manglărdo	engaged
implikàcia	engagement
manglăripen	engagement
motòro	engine
inginèro	engineer
Anglikani ćhib	English
barărel	enhance
plaćol	enjoy
but baro	enormous
dòsta	enough
ristărel	ensure
зal andre	enter
divertismènto	entertainment
entuziàsmo	enthusiasm
entuziasmime	enthusiastic
sasto	entire
kaj patăl so si les o xakaj	entitled
entitèta	entity
giripen	entrance
udar	entrance
antreprenòro	entrepreneur
plìko	envelope
trujalo mèdio	environment
mèdio	environment
avel zilăno	envy
zili	envy
but baro	epic
lùngo poèmo	epic
epidemìa	epidemic
epidèmiko	epidemic
barabar	equal
ekipamènto	equipment
barabaripen	equity
ekivalènto	equivalent
gùma	eraser
doś	error
naśavipen	escape
naśel avri	escape
speciàlo	especially
esèos	essay
esènca	essence
esenciàlo	essential
demonstrisarel	establish
kerel	establish
stabilisarel	establish
prinзardo	established
stabilime	established
mandĭn	estate
proprietèta	estate
estimisarel	estimate
estimisardo	estimated
thaj aver	etc
etèrno	eternal
ètika	ethics
kerel evaluàcia	evaluate
evaluàcia	evaluation
nètedo	even
sathaj	even though
răt	evening
evnimènto	event
k-o agor	eventually
khajekhvar	ever
svako	every
savorre	everybody
savorre	everyone
sa	everything
prùva	evidence
beng	evil
bibaxt	evil
nasul	evil
evolùcia	evolution
barărel	evolve
Ewikani ćhib	Ewe
sas	ex
ekzàkto	exact
ekzàkto	exactly
ekzàmeno	exam
ekzaminisarel	examine
ekzèmplo	example
nakhel prdal	exceed
but śukar	excellent
e ekscepciaça	except
ekscèpcia	exception
ekscèso	excess
po but	excessive
paruvipen	exchange
ilărdo	excited
entuziàsmo	excitement
emocionànto	exciting
eksklusìvo	exclusive
jertisarel	excuse
jartize man	excuse me
mudarel	execute
kerel	execute
ekzekùcia	execution
śerutno	executive
ekzekutìvo	executive
kerel spòrto	exercise
butĭ	exercise
agorisarel	exhaust
khinărel but	exhaust
but khino	exhausted
sikavel pùbliko	exhibit
ekspozìcia	exhibition
si	exist
isipen	existence
kaj si	existing
inklel	exit
avrutno udar	exit
barărel	expand
aźukerel	expect
aźukerdo	expected
pokinimata	expenses
kuć	expensive
eksperiènca	experience
eksperimènto	experiment
ekspèrto	expert
nakhavdo	expired
xalărel	explain
xalăripen	explanation
labărel	exploit
rodel	explore
ekspòrto	export
eksportizel	export
biućharel	expose
biućardo	exposed
pozìcia	exposure
eksprèso	express
sikavel	express
eksprèsia	expression
del	extend
zinzărel	extend
lùngo	extended
ekstènsia	extension
zinzaripen	extent
dimènsia	extent
avrikano	external
mudardo	extinct
xasavdo	extinct
maj but	extra
esènca	extract
ankalavel	extract
ekstraordinàro	extraordinary
ekstrèmo	extreme
but	extremely
jakh	eye
jakha	eyes
materiàlo	fabric
fabulòso	fabulous
muj	face
marel pes	face
lokhăripen	facilitate
lokhărimata	facilities
lokhăripen	facility
fàkto	fact
fàktoro	factor
fàbrika	factory
fàktură	facts
khosel pes	fade
bibaxtagor	fail
n-aśtisardăs	failed
bibaxtagor	failure
lokho	faint
baldivel	faint
fòros	fair
blòndo	fair
ćaćo	fair
dòsta	fairly
zїna	fairy
patăipen	faith
patĭvalo	faithful
fàlso	fake
peripen	fall
angloivend	fall
perel	fall
FÀLSO	false
fàima	fame
familiàro	familiar
famìlia	family
bokh	famine
prinзardo	famous
evantàio	fan
fàno	fan
modèrno	fancy
kamel	fancy
dikhel pes	fancy
fantàstiko	fantastic
dur	far
devleça	farewell
fèrma	farm
fermièro	farmer
ćudipnasqo	fascinating
mòda	fashion
sigo	fast
thulo	fat
fatàlo	fatal
ursìta	fate
dad	father
khinipen	fatigue
avària	fault
doś	fault
defèkto	fault
kamlo	favorite
dàro	favour
avantàźo	favour
preferizel	favour
favorime	favourite
traś	fear
bankèto	feast
por	feather
karakterìstika	feature
karakterìstike	features
februàro	february
xolărdo	fed up
tàksa	fee
pravarel	feed
opìnia	feedback
xatărel	feel
sentimènto	feeling
punre	feet
pelo	fell
ćhinel	fell
ćhavo	fellow
koćumni	felt
xatărdo	felt
зuvli	female
bar	fence
fertìlo	fertile
festivàlo	festival
del dab	fetch
bikinel pes	fetch
anel	fetch
temperatùra	fever
nesave	few
maj zalaga	fewer
manglărdi	fiance
fikciùnea	fiction
kїmpo	field
umal	field
daravno	fierce
pharo	fierce
deśupanз	fifteen
peinda	fifty
marel pes	fight
maripen	fight
maripen	fighting
зeno	figure
godisarel	figure
gin	figure
xatărel	figure out
ćhivel andoo dosàri	file
dosàri	file
pherel	fill
pherdo	filled
filmizel	film
fìlmo	film
melalo	filthy
k-o agor	finally
finànce	finance
del love	finance
financiàro	financial
arakhipen	find
arakhel	find
arakhel	find out
śukar	fine
amènda	fine
del amènda	fine
naj	finger
agorisarel	finish
finisizel	finish
agorisaripen	finish
agorisardo	finished
jag	fire
karfinărel	firm
zoralo	firm
jekhto	first
maj anglal	first
anav	first name
maćho	fish
зal śukar	fit
sasto vesto	fit
panз	five
laćharel	fix
karfinărel	fix
laćhardo	fixed
fìkso	fixed
bajrako	flag
markizel	flag
strafin	flash
pekel strafină	flash
dikhel sigo	flash
nètedo	flat
apartamènto	flat
perś	flaw
doś	flaw
perfèkto	flawless
naśel	flee
mas	flesh
urăjlăs	flew
bandărel	flex
paruvel	flex
fleksìbilo	flexible
urăipen	flight
boldel nesave var	flip
flirtizel	flirt
flirtizel	flirting
beśel po pani	float
plùta	float
tasavipen	flood
tasavel	flood
etàźo	floor
podeaua	floor
aro	flour
thavdel	flow
luludĭ	flower
nasvalipen	flu
fluènto	fluent
fluènto	fluently
kovlo	fluffy
superficiàlo	fluffy
fluìdo	fluid
urăl	fly
fòkuso	focus
atència	focus
koncentrisarel pes	focus
muxli	fog
muxlălo	foggy
bandăripen	fold
bandărel	fold
manuśa	folks
зal palal	follow
arakhel maj but	follow up
rezultàto	follow up
avutno	following
palal	following
xaben	food
dilo	fool
bigodăver	fool
bigodărdo	foolish
punro	foot
fòtbalo	football
vaś	for
Misalăqe	For example
misalăqe	for instance
andar tuөe	for you
rokhlo	forbidden
zor	force
prognòza	forecast
ćikat	forehead
avrutno	foreign
veś	forest
etèrno	forever
bistrel	forget
jertisarel	forgive
bisterdem	forgot
bifurkàcia	fork
fùrka	fork
śtarfin	fork
fòrma	form
formisarel	form
oficiàlo	formal
nakhlo	former
sas	former
jekhto	former
baxtalimasөar	fortunately
mandĭn	fortune
baxt	fortune
saranda	forty
saranda thaj duj	forty-two
bićhalel	forward
anglal	forward
barărel	foster
lokhărel	foster
mardem	fought
arakhlem	found
arakhlo	found
fundamento	foundation
śtar	four
deśuśtar	fourteen
resutni	fox
fraзìlo	fragile
struktùra	frame
ràma	frame
kàdro	framework
atharno	fraud
fràuda	fraud
mònstro	freak
bilovenqo	free
vesto	free
vestipen	freedom
paxol	freeze
frekvènca	frequency
frekvènto	frequent
butvar	frequently
pròspeto	fresh
paraśtuj	friday
friзidèro	fridge
amal	friend
amalikano	friendly
amala	friends
amalipen	friendship
daravdo	frightened
traśavno	frightening
źàmba	frog
katar	from
i anglutni rig	front
frònto	front
paxome	frozen
frùkto	fruit
frustràto	frustrated
kombustìbilo	fuel
del kombustìbilo	fuel
Fulfuldikani ćhib	Fulfulde
pherdo	full
distràkcia	fun
kerel butĭ	function
fùnkcia	function
fundamentàlo	fundamental
praxisaripen	funeral
asavno	funny
pośtin	fur
xolăriko	furious
mòbila	furniture
maj dur	further
maj but	furthermore
avutnipen	future
liel	gain
khelipen	game
xїv	gap
diferènca	gap
garàźo	garage
gunòjo	garbage
bar	garden
kerel butĭ and-i bar	garden
sir	garlic
vudar	gate
kidel	gather
kidipen	gathering
mapinasqo aparàto	gauge
dias	gave
ekipamènto	gear
gèndero	gender
generàlo	general
generalosөe	generally
kerel	generate
generàcia	generation
bareilesqo	generous
gènio	genius
spècia	genre
laćho	gentle
originàlo	genuine
зèsto	gesture
aresel	get
liel	get
xatărel	get
urăv tut	get dressed
uśtel	get up
sastăr tut sigo	get well soon
liindoj	getting
fantòma	ghost
xramosarel andar varekasөe	ghosting
зigànto	giant
dàro	gift
kerel dàro	gift
gimbìro	ginger
ćhaj	girl
amalin	girlfriend
piramni	girlfriend
del	give
mukhel	give up
dino	given
lośalo	glad
dikhel sigo	glance
valin	glass
taxtaj	glass
jakhvalină	glasses
dikhel	glimpse
globàlo	global
bibaxtalo	gloomy
tamlo	gloomy
mänuśes	gloves
baro tatipen	glow
straftinel	glow
te ovel maj śukar	glow up
ćatrin	glue
зal	go
hajde	go ahead
зa	go away
зa te soves	go to bed
gòlos	goal
res	goal
resa	goals
gòlură	goals
buzni	goat
devel	god
te oves sasto-vesto	god bless you
зal	goes
зandoj	going
ośte	going to
sumnakaj	gold
gelo	gone
ośte	gonna
ćatrinăqi substànca	goo
śukar	good
butĭ	good
laćho gĕs	good afternoon
devleça	good bye
laćho dĭves	good day
laćhi răt	good evening
laćhi butĭ	good job
śukar	good looking
te avel tut baxt	good luck
laćhi texarin	good morning
laćhi texarin, mi piramni	good morning my love
laćhi răt	good night
devleça	goodbye
laćhi răt	goodnight
bută	goods
Google	Google
Google Translate	Google Translate
raćni	goose
bigodăver manuś	goose
but śukar	gorgeous
bїrfa	gossip
bїrfizel	gossip
lias	got
xatărdem	got it
rajipen	government
astarel	grab
astaripen	grab
ulavel and-e kategorìe	grade
klàsa	grade
nòta	grade
graduàlo	gradually
absolvènto	graduate
si absolvènto	graduate
germo	grain
del	grant
grànto	grant
dino	granted
drakha	grapes
astarel	grasp
astaripen	grasp
ćar	grass
naisaripen	gratitude
gràvo	grave
limòri	grave
grìo	gray
baro	great
xanзvalipen	greed
xanзvalo	greedy
zèleno	green
salutizel	greet
baxtăripen	greeting
baxtărimata	greetings
grìo	grey
grilàźo	grid
baro xolăripen	grief
piśipen	grind
piśel	grind
astarel zorales	grip
alimentàro magazìno	grocery
uźărel	groom
зamutro	groom
grastàri	groom
brùto	gross
thulo	gross
modoranesqo	gross
motìvo	ground
sportosqo terèno	ground
phuv	ground
kidel pes and-o grùpo	group
grùpo	group
barărel	grow
barăripen	growth
xolăme	grumpy
Guaranikani ćhib	Guarani
garancìa	guarantee
garantizel	guarantee
rakhel	guard
pàzniko	guard
gićil	guess
akhardo	guest
gidàźo	guidance
gìdo	guide
sikavel	guide
dośalo	guilty
ćhavo	guy
murśa	guys
sportosqi sàla	gym
aćar	habit
habitàto	habitat
sas man	had
kukudĭ	hail
del muj	hail
bala	hair
paś	half
sàla	hall
hòlo	hall
vast	hand
tradel	handle
mїnèro	handle
śukar	handsome
umblavel	hang
mośal	hang out
si	happen
sas	happened
baxtalipen	happiness
lośalo	happy
but berśa angle	happy birthday
but berśa angle	happy birthday to you
baxtalo nevo berś	happy new year
zoralo	hard
pharo	hard
pharipnaça	hardly
paśal nijekhvar	hardly ever
resaripen	harm
resarel	harm
bilaćho	harmful
armonìa	harmony
bikovlo	harsh
rekòlta	harvest
si les	has
si lan	has
sikavel xolipen	hate
xolipen	hate
man si man	have
te oves tut laćho dĭves	have a good day
te ovel tut laćho dĭves	have a nice day
liel i javin	have breakfast
distrozel pes	have fun
tu xalăn	have you eaten
man si man	having
rìsko	hazard
riskizel	hazard
muxli	haze
vov	he
les si les	he has
vov si	he is
śero	head
sastărel	heal
sastăripen	healing
sastăripnasqo	healing
sastipen	health
sasto vesto	healthy
aśunel	hear
aśundem	heard
ilo	heart
tatipen	heat
devlikani bar	heaven
pharo	heavy
pherdo	hectic
ućipen	height
mośtenitòri	heir
ćoripen	heist
inkerdo	held
bengipen	hell
So keres	Hello
so keres, mirri kuć	hello dear
so keres	hello how are you
so keres	hello how are you doing
kàska	helmet
del vast	help
utìlo	helpful
kadja	hence
laqo	her
lan	her
laqe	her
ćhund	herd
kathe	here
tradìcia	heritage
patrimònios	heritage
na avel sìguro	hesitate
Hei	Hey
So keres	Hi
so keres	hi how are you
So keres	Hi there
garavdo	hidden
garavel	hide
ierarhìa	hierarchy
ućo	high
ankalavel anglal	highlight
o maj laćho kotor	highlight
barăripen	hike
phiravipen	hike
phiravel pes	hiking
asapnasqo	hilarious
plàjo	hill
les	him
lesqe	him
sikavel indikàcia	hint
indikàcia	hint
śòldo	hip
k-i mòda	hip
śòldură	hips
angaźàto	hire
angaźizel	hire
angaźàcia	hiring
lesqo	his
història	history
marel	hit
maripen	hit
Hmm	Hmm
hòbi	hobby
inkerel	hold
inkeripen	hold
aźukerel	hold on
inkerel	hold on
xїv	hole
vakànca	holiday
зal and-i vakànca	holiday
xїvărdo	hollow
khere	home
tèma	homework
patĭvalo	honest
bi te xoxavel	honestly
Avdĭn	Honey
Piramni	Honey
patĭv	honor
glùga	hood
kapòta	hood
kaśter	hook
xutipen	hop
xutel	hop
sperànca	hope
speriau ke	hopefully
niraślo	hopeless
orizontàlo	horizontal
klaksòno	horn
śing	horn
orìbilo	horrible
bari traś	horror
grast	horse
spitàlo	hospital
ospitalitèto	hospitality
gàzda	host
biamalikano	hostile
xaćando	hot
hotèlo	hotel
òra	hour
òre	hours
kher	house
kher	household
sar	how
tha' tu	how about you
so keres	how are you
so maj keres	how are you doing
sar san adĕs	how are you doing today
sar san adĕs	how are you today
fal man miśto te prinзarav tut	how do you do
sar si	how is
kozom	how many
kozom	how much
kozom var	how often
kozom berśa si tut	how old are you
sar sas tiro gĕs	how was your day
sar sas tiri răt	how was your night
sathaj	however
cèntro	hub
murśorro	hubby
angalipen	hug
but baro	huge
manuśikano	human
manuś	human
umìlo	humble
kingărdo	humid
panăripen	humidity
jekh śel	hundred
bokhalo	hungry
xaśaj	hunt
зal xaśajesөe	hunt
rodel	hunt
uragàno	hurricane
sigărel pes	hurry
sigăr tut	hurry up
dukhavel	hurt
murś	husband
kerel kontrabànda	hustle
sigărel pes	hustle
spidel pes	hustle
luv	hut
higièna	hygiene
me	I
Me sem	I am
Me som śukar	I am fine
Me aśtizav	I can
Me na aśtizav	I can't
Me kerav	I do
Me na зanav	I do not know
Me na xatărav	I do not understand
me na	I don't
Me na зanav	I don't know
Me na xatărav	I don't understand
Me na xatărav so kames te phenes	I don't understand what you mean
Me na xatărav tut	I don't understand you
Me na зanav	I don’t know
Me na xatărav	I don’t understand
patăv	i guess
Man sas man	I had
Man si man	I have
Me somas	I have been
Me speriau	I hope so
Me зanav	I know
Manqe del mo dĭ	I like
Manqe plaćol manqe tuөar	I like you
Me dukhav	I love
Me dukhav me bare phralesqe	I love my big brother
Me dukhav me bare phenăqe	I love my big sister
Me dukhav me dadesqe	I love my father
Me dukhav me tikne phralesqe	I love my little brother
Me dukhav me tikne phenăqe	I love my little sister
Me dukhav me dajaqe	I love my mother
Dukhav tuqe	I love you
Dukhav tuqe but	I love you so much
Vi me dukhav tuqe	I love you too
Kamav te phenav	I mean
Si manqe dòros tuөar	I miss you
Si manqe baro dòro tuөar	I miss you so much
Me dikhav	I see
Me patăv	I think
Me xatărav	I understand
Me kamav	I want
Kamav te dikhav tut	I want to see you
Kamav tut	I want you
Me somas	I was
Me ośte	I will
Me somas	I would be
Me sem	I'm
Me som śukar	I'm fine
Me som śukar	I'm good
Me som kathe	I'm here
Fal man nasul	I'm sorry
paxoj	ice
śudri	ice cream
idèa	idea
ideàlo	ideal
idèntiko	identical
arakhel	identify
identitèta	identity
idiòto	idiot
bilabărdo	idle
khandino	idle
te	if
nana  ćhel samaөe	ignore
nasvalo	ill
ilegàlo	illegal
nasvalipen	illness
Ilokanikani ćhib	Ilocano
imàgina	image
kerel pesqe imàgina	imagine
sigutno	immediate
sigo	immediately
but baro	immense
impàkto	impact
ruśando	impatient
implementisarel	implement
importizel	import
impòrto	import
importànto	important
imponisarel	impose
biśajutno	impossible
kerel imprèsia	impress
imprèsia	impression
inpresionànto	impressive
laćharel	improve
laćharipen	improvement
anda	in
maj but	in addition
Faktosөe	In fact
anglal	in front of
te	in order to
biadekvàto	inappropriate
stimulènto	incentive
incidènto	incident
ćhivel	include
anderărindoj	including
love	income
pharipen	inconvenience
barărel	increase
barăripen	increase
barărdem	increased
bipatăipnasqo	incredible
ćaćipnasөe	indeed
independènto	independent
Ìndia	India
sikavel	indicate
indigèno	indigenous
individuàlo	individual
indùstria	industry
inevitàbilo	inevitable
xurdorro	infant
infèkcia	infection
infinìto	infinity
śuvlipen	inflammation
inflàcia	inflation
influènca	influence
informisarel	inform
informàcia	information
ingredièntură	ingredients
mośtenìrea	inheritance
iniciàlo	initial
iniciatìva	initiative
resardo	injured
traumatìsmo	injury
inocènto	innocent
inovàcia	innovation
ankèta	inquiry
dilo	insane
insèkta	insect
bisìguro	insecure
ćhivel	insert
andre	inside
xatăripen	insight
insistizel	insist
insomnìa	insomnia
inspiràcia	inspiration
del inspiràcia	inspire
instalizel	install
del ekzèmplo	instance
ekzèmplo	instance
sigutno	instant
mić	instant
paruvipnasөe	instead
sikavimata	instructions
instrumènto	instrument
kuś	insult
ristăripen	insurance
intàkto	intact
integritèto	integrity
intelektuàlo	intellectual
godĭ	intelligence
godăver	intelligent
kamel	intend
bori	intended
planifikisardo	intended
intènso	intense
intència	intention
kerel interàkcia	interact
interàkcia	interaction
interèso	interest
dobїnda	interest
interesizel	interest
interesime	interested
interesànto	interesting
ćhel pes anda	interfere
intermediàro	intermediate
andrutno	internal
maśkarutno	international
praktikànto	internship
interpretizel	interpret
interprèto	interpreter
aćhavel	interrupt
intervìo	interview
ìntimo	intimate
ando	into
ćhivel andre	introduce
kerel prinзaripen	introduce
giravipen	introduction
anglolav	introduction
introvèrto	introvert
intuìcia	intuition
invalìdo	invalid
bilaćho	invalid
inventisarel	invent
inventàro	inventory
kerel investìcia	invest
kerel investigàcia	investigate
akharipen	invitation
akharel	invite
faktùra	invoice
implikisarel	involve
implikisardo	involved
sastri	iron
si	is
ìnsula	island
izolàto	isolated
del	issue
problèma	issue
problèmură	issues
vov	it
voj	it
si	it is
sas	it was
vov si	it's
si miśto	it's ok
Si miśto	It's okay
artìkulo	item
bută	items
nevimata	items
lesqo	its
Me som	I’m
зeàka	jacket
phandavipen	jail
Januàro	January
valin	jar
del duma	jaw
ćamolax	jaw
zilăno	jealous
зalărel pes	jerk
bigodăver manuś	jerk
biźuterìes	jewelry
butăqo than	job
naśel	jogging
kidel	join
liel kotor	join
avel somdasno	join
khethano	joint
artikulàcia	joint
pherăs	joke
źurnalìsto	journalist
phiripen	journey
lośalipen	joy
krisarel	judge
xum	juice
jùlio	july
xutel	jump
jùnio	june
ćhudel bitrebutne bută	junk
bitrebutne bută	junk
tòko	just
ćaćo	just
tòko ker	just do it
ćaćipen	justice
xalărel	justify
Groenlandikani ćhib	Kalaallisut
entuziasmime	keen
but zoralo	keen
inkerel	keep
keren vi maj dur ajakha	keep it up
rakhlo	kept
ćàiniko	kettle
klidin	key
marel e punreça	kick
buznorro	kid
xurdorro	kid
kerav pherăs	kidding
gud	kidney
xurdorre	kids
mudarel	kill
laćho	kind
tìpo	kind
kam	kinda
śukar	kindly
laćhipen	kindness
thagar	king
ćumidi	kiss
kiravlin	kitchen
zmèo	kite
xramosarel ilegàlo jekh ćekos	kite
ùliu	kite
tikni pisìka	kitten
ćang	knee
marel e ćangaça	knee
me зanglem	knew
ćhuri	knife
grast	knight
kavalèro	knight
зanel	know
зanipen	knowledge
зando	known
Konkani ćhib	Konkani
Krikani ćhib	Krio
ćhel etikèta	label
màrka	label
etikèta	label
kerel butĭ	labor
butĭ	labor
kerel butĭ	labour
butĭ	labour
nanaipen	lack
na si man	lack
xїv	ladder
śopni	ladder
rajni	lady
ćhilăs	laid
talo	lake
bakrorro	lamb
bango	lame
làmpa	lamp
aterizizel	land
phuv	land
peizàźo	landscape
ćhib	language
ćanga	lap
marel lokhes	lap
tùra	lap
buxlo	large
inkerel	last
palutno	last
o palutno, ama na o maj zalaga importànto	last but not least
familiaqo anav	last name
butpalal	late
and-i palutni vrjama	lately
maj palal	later
palutno	latest
dujto	latter
palutno	latter
asal	laugh
kaj asal	laughing
asavipen	laughter
lansizel	launch
thovipnasqe bulăndre	laundry
kris	law
pato	lawn
avokàto	lawyer
kerel parìo	lay
kerel anre	lay
zinzarel	lay
pato	layer
skèma	layout
khandino	lazy
tradel	lead
lìdero	leader
patrin	leaf
thavdipen	leak
thadel	leak
bandărel pes rigaөe	lean
sano	lean
barăripen	leap
xutel	leap
siklŏvel	learn
siklŏvipen	learning
del andi arènda	lease
arènda	lease
o maj zalaga	least
зivutresqi mortĭ	leather
telărel	leave
mekhel	leave
patrină	leaves
lèdos	led
tradino	led
gelo	left
zervo	left
punro	leg
mośtenìre	legacy
legàlo	legal
legènda	legend
legàlo	legit
vesto vaxt	leisure
vunзarel	lend
dїlgipen	length
maj zalaga	less
lèkcia	lesson
mukhel	let
lil	letter
zèleno salàta	lettuce
nivèlo	level
influènca	leverage
responsabilitèto	liability
dutĭ	liability
pharipen	liability
bibliotèka	library
ćarrel	lick
pato	lick
xoxavipen	lie
xoxavel	lie
zinzarel	lie
xoxavimata	lies
zinzarel	lies
зivipen	life
vazdel	lift
ćorel	lift
lìfto	lift
lokho	light
dudărel	light
dud	light
strafin	lightning
del mo dĭ	like
sar	like
probàbilo	likely
sa kadja	likewise
lìnia	line
Lingalikani ćhib	Lingala
phandlipen	link
lìnko	link
lèvo	lion
likìdo	liquid
kerel lìsta	list
lìsta	list
aśunel	listen
aśunel	listening
literàlo	literally
literatùra	literature
gunòjo	litter
kerel gunòjo	litter
tikno	little
traisarel	live
зivdo	live
buko	liver
зivimata	lives
enèrgiko	living
зivipen	living
sufraзerìa	living room
śopїrla	lizard
ladavel	load
ladavipen	load
manro	loaf
mośal	loaf
krèdito	loan
vunзarel	loan
thanutno	local
lokàcia	location
eklùza	lock
klidipen	lock
karantìna	lockdown
kaśt	log
ha ha	lol
korkorro	lonely
lùngo	long
na maj dikhlăm amen de but	long time no see
dikhipen	look
dikhel	look
truj	loop
del drom	loose
putardo	loose
umblavdo	loose
lòrdo	lord
xasarel	lose
xasaripen	loss
xasardo	lost
but	lot
zorales	loud
dinglŏvipnasqi livni	lounge
dinglŏl	lounge
kamipen	love
dukhav tuqe	love you
mїndro	lovely
tikno	low
xolăme	low
tamlipen	lower
bandărel o śero	lower
loiàlo	loyal
patĭv	loyalty
baxt	luck
baxtalo	lucky
Lugandikani ćhib	Luganda
bagàźo	luggage
kotor	lump
kidel	lump
phugni	lump
xaben and-o mesmèri	lunch
parne buke	lungs
lùkso	luxury
xoxavindoj	lying
xoxavno	lying
maśìna	machine
dilo	mad
rajni	madam
kerdo	made
rivìsta	magazine
but śukar	magnificent
bari ćhaj	maid
sevni	maid
principàlo	main
inkerel	maintain
inkeripen	maintenance
Maithilikani ćhib	Maithili
maiòro	major
importànto	major
maźòro	major
maźoritèta	majority
kerel	make
inventizel	make up
anglekerel	make up
murśikano	male
ćhavo	male
murś	male
mòlo	mall
murś	man
tradel	manage
aśti	manage
manàgemento	management
manàgero	manager
musajutno	mandatory
sikavel	manifest
evidènto	manifest
manipulisarel	manipulate
ćhand	manner
pustik	manual
vastesqo	manual
but	many
baxtalo tiro dĭves	many many happy returns of the day
màrto	march
màrśo	march
agor	margin
pazàri	market
prandizipen	marriage
prandizme	married
màska	mask
garavel	mask
màsa	mass
religiaqi ceremonìa	mass
but baro	massive
зanel śukar	master
xulaj	master
maèstro	master
jagali	match
mèćo	match
зal	match
amal	mate
asistènto	mate
materiàlo	material
matemàtika	math
si importànto	matter
problèma	matter
maturitèto	maturity
aśti	may
o maj	may
aśti	maybe
manqe	me
man	me
vi me	me too
xaben	meal
зungalo	mean
mandavel	mean
mandaj	meaning
metòda	means
love	means
kamlem te phenav	meant
maśkaral	meanwhile
mapinel	measure
mezùre	measures
mapinel	measures
mas	meat
medikàlo	medical
medicìna	medicine
drab	medicine
meditàcia	meditation
maśkarutno	medium
metòda	medium
malavel	meet
malavipen	meeting
beśipen	meeting
Meiteilonikani ćhib	Meiteilon
bilŏvel	melt
liparimata	memories
memòria	memory
mentàlo	mental
liparel	mention
liparipen	mention
lipardo	mentioned
mèntoro	mentor
komersànto	merchant
mìla	mercy
tòko	merely
baxatalo kräćùno	merry christmas
melalipen	mess
mesàźo	message
melalo	messy
metàlo	metal
metòda	method
kermuse	mice
maśkar	middle
o maśkar e rătăqo	midnight
aśtizelas	might
kovlo	mild
kilomètriko bòrna	milestone
importànto evenimènto	milestone
militàro	military
thud	milk
jekh miliòno	million
godĭ	mind
mentalitèto	mindset
mirro	mine
xamisarel	mingle
minòro	minor
bi importànto	minor
tikno	minute
minùto	minute
momènto	minute
verbàlo procèso	minutes
ćudipen	miracle
gledànos	mirror
verver	miscellaneous
nasul	mischievous
bibaxtalo	miserable
nasul	miserable
dukhipen	misery
ćorripen	misery
si manqe dòros	miss
xasarel	miss
si manqe dòros tuөar	miss you
xasavdo	missing
mìsia	mission
muxli	mist
doś	mistake
Mizikani ćhib	Mizo
mobìlo	mobile
asal varekasөar	mock
modèlo	model
kerel moderàto	moderate
moderàto	moderate
modèrno	modern
modèsto	modest
kingăripen	moist
kingăripen	moisture
matrìca	mold
kїrtica	mole
alunìca	mole
daj	mom
momènto	moment
lujdĭves	monday
love	money
monitòro	monitor
majmùca	monkey
ćhon	month
ruśvalo	moody
ćhon	moon
moràlo	moral
maj but	more
maj but	moreover
texarin	morning
ipotèka	mortgage
but	most
maj but	mostly
daj	mother
miśkipen	motion
mociùne	motion
motivàcia	motivation
plain	mountain
kermuso	mouse
muj	mouth
paruvel o than	move
del emòcie	move
miśkipen	movement
fìlmo	movie
rajni	mrs
but	much
ćik	mud
kàna	mug
mùśkio	muscle
muzèo	museum
xuxurr	mushroom
mùzika	music
trebul	must
del poxàlă	mute
lalo	mute
mutuàlo	mutual
mirro	my
Mirri kuć	My dear
mirro amal	my friend
Mirro hoverkràfto si pherdo sapale maćhença	My hovercraft is full of eels
mi piramni	my love
mirro anav si	my name is
mi loś	my pleasure
manqe	myself
korkorro	myself
misteriòso	mysterious
mistèro	mystery
mìto	myth
karfin	nail
vùngia	nail
kerel laćhes	nail
naìvo	naive
anav	name
naratìvo	narrative
paramisi	narrative
tang	narrow
зungalo	nasty
themutno	national
nacionalitèta	nationality
natìvo	native
naturàlo	natural
natùra	nature
зung	nausea
paśal	near
paśal	nearby
paśal	nearly
ordonisardo	neat
trebutno	necessary
men	neck
kolièro	necklace
trebul	need
trebaipen	need
negatìvo	negative
te na prinзarel	neglect
kerel negociàcia	negotiate
perutno	neighbor
perutnipen	neighborhood
nić	neither
nepòto	nephew
but godăver	nerd
biśando	nervous
kùjbo	nest
poxtan	net
internèto	net
nèto	net
sistèmo	network
konektizel e kalkulatòră maśkar lenөe	network
neùtro	neutral
nijekhvar	never
nikana te ne aćhaves tut	never give up
na-i nìśto	never mind
na-i nìśto	nevermind
sathaj	nevertheless
nevo	new
nevimata	news
palutno	next
paśal	next to
kućorro	nice
fal man miśto te prinзarav tut	nice to meet you
nepòta	niece
răt	night
kośmàro	nightmare
enă	nine
deśuenă	nineteen
enăvardeś	ninety
Na	No
na-i sosqe	no problem
na	no way
nikon	nobody
baśibaś	noise
baśibaśalo	noisy
konik	none
mezimèri	noon
na	nope
nić	nor
normàlo	normal
nòrdo	north
nakh	nose
nostàlgiko	nostalgic
na	not
na-i tut andar sosөe	not at all
si laćho	not bad
Na akana	Not now
na зi akana	not yet
notìca	note
dikhel	note
nòta	note
prinзardo	noted
khanć	nothing
dikhel	notice
nòta	notice
dikhlem	noticed
navni	noun
substantìvură	nouns
nevo	novel
lil	novel
novèmbro	november
akana	now
akana	nowadays
buklùci	nuisance
enervànto manuś	nuisance
zèro	null
bimolipnasqo	null
paxome	numb
paxol	numb
ginel	number
gin	number
ovel grìźa varekastar	nurse
infirmièra	nurse
feli	nut
akhor	nut
nukśoàra	nutmeg
nutrìcia	nutrition
kuśipen	oath
solax	oath
obezitèta	obesity
aśunel	obey
obièkto	object
obiektìvo	objective
obligàcia	obligation
tamlo	obscure
observàcia	observation
dikhel	observe
obsedàto	obsessed
obsèsia	obsession
purano	obsolete
obstàkulo	obstacle
liel	obtain
lino	obtained
evidènto	obvious
klàro	obviously
okazionàlo	occasionally
okupàcia	occupation
bimesto	occupied
inklel	occur
inklel	occurred
inklel	occurs
okeàno	ocean
oktòbro	october
biaźukerdo	odd
probabilitèto	odds
sìguro	of course
mesto	off
atàko	offensive
ruśavno	offensive
ofèrta	offer
del	offer
biròvo	office
oficiàlo	official
butvar	often
O	Oh
va	oh really
ulej	oil
petròlo	oil
śukar	ok
miśto, mirri kuć	ok dear
miśto, mi piramni	ok honey
miśto, mirri piramni	ok my love
śukar	okay
śukar, mi piramni	okay baby
miśto, mirri kuć	okay dear
miśto, mi piramni	okay honey
miśto, mi piramni	okay my love
phuro	old
pa	on
jekhvar	once
jekh var	once
jekh	one
jekh ćhib si dòsta	one language is never enough
purum	onion
online	online
tòko	only
putardo	open
operàcia	operation
opìnia	opinion
oportunitètură	opportunities
oportunitèto	opportunity
mamujutno	opposite
optimìsto	optimistic
alosaripen	option
opcionàlo	optional
vaj	or
portokàla	orange
portokalìo	orange
kerel komànda	order
komànda	order
òrdina	order
aćarutno	ordinary
organizàcia	organization
orientàcia	orientation
orìgina	origin
originàlo	original
Oromikani ćhib	Oromo
orfàno	orphan
aver	other
ke	otherwise
trebul	ought
amaro	our
Amari mìsia: te das vast savorren, sathanesөe, te xatăren i lùmja thaj te den duma maśkar lenөe e źutipnaça e ćhibĕnqo	Our mission: to enable everyone, everywhere to understand the world and express themselves across languages.
Amari mìsia: te organizisaras e lumjaqi informàcia thaj te keras lan akcesìbilo thaj utìlo sathanesөe	Our mission: to organize the world's information and make it universally accessible and useful.
avri	out
rezultàto	outcome
del ekipamènto	outfit
kostùmo	outfit
amalikano	outgoing
savo del pesqe demìsia	outgoing
evakuaciaqo xїv	outlet
rezumàto	outline
kontùro	outline
avri	outside
remarkàbilo	outstanding
bov	oven
opral	over
kothe	over there
generàlo	overall
salopèta	overall
viзavel	overcome
godisarel but	overthinking
but impresime	overwhelmed
but baro	overwhelming
si man i dutĭ	owe
bùfnica	owl
si man	own
mirro	own
xulaj	owner
guruv	ox
phird	pace
зal	pace
vitèza	pace
їmpaketizel	pack
pakèto	package
pokindo	paid
dukh	pain
rangli	paint
rangărel	paint
tablòos	painting
makhipen	painting
зuto	pair
parno	pale
vast	palm
piri	pan
kritikisarel	pan
pandemìa	pandemic
traśal pes but	panic
bari traś	panic
pantalùna	pants
sostenă	pants
hїrtia	paper
paradìso	paradise
paralèla	parallel
paralèlo	parallel
kolèto	parcel
phuvăqo kotor	parcel
jertisaripen	pardon
jertisarel	pardon
o dad thaj i daj	parents
parkizel	park
pàrko	park
papagàlo	parrot
pàtrunźèlo	parsley
kotor	part
ulavel	part
liel kotor	participate
speciàlo	particular
śeral	particularly
partenèro	partner
grùpo	party
partìdo	party
nakhavipen	party
del	pass
nakhel	pass
pasàźo	passage
nakhle	passed
kamipen	passion
pasionàto	passionate
pasìvo	passive
paròla	password
nakhlo	past
paśal	past
o nakhlo vaxt	past
perś	patch
plàsturo	patch
dromorro	path
patètiko	pathetic
bir	patience
paciènto	patient
biruśando	patient
śablòno	pattern
mòdo	pattern
pàuza	pause
aćhavel	pause
trotoàro	pavement
pokinel	pay
pokinipen	payment
śandipen	peace
śando	peaceful
bombòna	peach
pièrsika	peach
vїrfo	peak
ambrol	pear
xirxil	peas
bizàro	peculiar
mutrel	pee
muter	pee
del tele i koàźa	peel
kolègo	peer
dikhel e atenciàça	peer
dikhel phares	peers
stiloos	pen
xramosarel	pen
càrko	pen
angarno	pencil
ando aźukeripen	pending
manuśa	people
icali	pepper
pipèri	pepper
dikhel	perceive
xatăripen	perception
perfèkto	perfect
kerel	perform
performànca	performance
śaj	perhaps
periòda	period
permanènto	permanent
mukhipen	permission
mukhel	permit
permìso	permit
perseverànca	perseverance
persistènto	persistent
зeno	person
personàlo	personal
personalitèto	personality
perspektìva	perspective
paćavel	persuade
rimosarel pes	pervert
kamlo зivutro	pet
azbal lokhes	pet
fàza	phase
fenomèno	phenomenon
filosòfia	philosophy
telefòno	phone
del telefòno	phone
fotografìa	photo
eksprèsia	phrase
fìziko	physical
kidel	pick
alosarel	pick
kinel bikuć	pick up
siklŏvel	pick up
vazdel	pick up
kerel pesqe imàgina	picture
kerel fotografìes	picture
fotografìa	picture
kotor	piece
kotora	pieces
balo	pig
pelistro	pigeon
muruśoj	pile
tĭlo	pile
śerand	pillow
pilòto	pilot
karfin	pin
astarel e karfinăça	pin
punro	pin
ananàso	pineapple
garoàfa	pink
ròzo	pink
xїv	pit
smoàla	pitch
nivèlo	pitch
paćavel	pitch
mìla	pity
ćhivel	place
than	place
thana	places
dukhal	plague
ćùma	plague
xolărel	plague
kїmpo	plain
klàro	plain
sado	plain
plàno	plan
planifikisarel	plan
zinzardo	plane
aviòno	plane
plantizel	plant
votană	plants
fàbrika	plants
gravùra	plate
imàgina	plate
ćaro	plate
platfòrma	platform
baśavel	play
khelel pes	play
khelipen	play
khelipnasqo	playing
khelel	playing
ćajlo	pleasant
mangav tut	please
naisarel	please
naisardo	pleased
laćhipen	pleasure
angaźamènto	pledge
del pesqo lav	pledge
but	plenty
kerel jekh garavdo plàno	plot
phuvăqo kotor	plot
garavdo plàno	plot
prìza	plug
bùnзo	plug
kilav	plum
instalatòro	plumber
pluràlo	plural
pòdkasto	podcast
poèmo	poem
poezìa	poetry
viram	point
sikavel	point
viś	poison
śingalipen	police
polìtika	policy
pòlica	policy
politikòso	polite
melăripen	pollution
talo	pond
pisćìna	pool
khino	poop
khul	poop
ćororro	poor
pimo e spumaça	pop
mùzika pop	pop
zoralo baś	pop
xarno	pop
but prinзardo	popular
populàcia	population
balano mas	pork
xaborro	porridge
pòrto	port
mol andar o Pòrto	port
pozìcia	position
pozitìvo	positive
man si man	possess
posèsia	possession
posesìvo	possessive
śajutno	possible
pòsto	post
pòśta	post
korespondènca	post
kerel maj palal	postpone
pićoka	potato
śajutno	potential
potenciàlo	potential
pàundo	pound
ćorripen	poverty
zor	power
zoralo	powerful
pràktiko	practical
kerel pràktika	practice
pràktika	practice
aśarel	praise
aśaripen	praise
pherăs	prank
rugisarel pes	pray
preciòso	precious
precìso	precise
precìso	precisely
angledikhel	predict
preferisel	prefer
preferìnca	preference
khamni	pregnant
atăripen	prejudice
bàza	premises
laćhe kalitetaqo	premium
pokinipen	premium
anglekeripen	preparation
anglekerel	prepare
khonз	prepared
prepozìcia	preposition
prezènca	presence
akanutno	present
kadoos	present
o akanutno vaxt	present
prezentàcia	presentation
rakhel	preserve
kerel konsèrve	preserve
prezidènto	president
spidel zorales	press
prèsa	press
zumavel te paćavel	press
zor	pressure
kerel pes	pretend
imaginàro	pretend
kućorro	pretty
kerel prevència	prevent
anglutno	previous
pràda	prey
molipen	price
barikanipen	pride
raśaj	priest
śerutno	primary
primàro	primary
śerutno	prime
thagarni	princess
dirèktoro	principal
principàlo	principal
stàreco	prior
anglutno	prior
prioritèto	priority
phandavipen	prison
intimitèto	privacy
privàto	private
privilègio	privilege
prèmio	prize
śaj	probably
problèma	problem
procedùra	procedure
kerel maj dur	proceed
procèso	process
kerel	process
kerel	produce
ankalavel	produce
prodùso	product
prodùkcia	production
profèsia	profession
profesionàlo	professional
profìlo	profile
profìto	profit
profùndo	profound
kere progrèso	progress
progrèso	progress
projèkto	project
ankalavdo avri	prominent
but prinзardo	prominent
del o lav	promise
promovisarel	promote
promòcia	promotion
sigutno	prompt
e mujeça tele	prone
pronòmbrură	pronouns
pronùncia	pronunciation
kerel impermeàbilo	proof
prùva	proof
laćho	proper
korèkto	properly
proprietètură	properties
proprietèto	property
propozàlo	proposal
mangipen te prandizel pes	proposal
rodel	prospect
perspektìva	prospect
barvalipen	prosperity
prospèro	prosperous
arakhel	protect
barikano	proud
sikavel	prove
del	provide
sikavel	provide
dino	provided
provìncia	province
plàno	provision
provìzia	provision
pubertèta	puberty
pùbliko	public
cirdel	pull
dudum	pumpkin
punktuàlo	punctual
pupìla	pupil
siklŏvno	pupil
kinel	purchase
uźo	pure
mòvo	purple
res	purpose
pośeta	purse
portmonèo	purse
fòndură	purse
kerel maj dur	pursue
зal palal	pursue
aktivipen	pursuit
res	pursuit
rodipen	pursuit
spidel	push
ćhivel	put
kalifikàcia	qualification
kalitèto	quality
koboripen	quantity
karantìna	quarantine
xal pes	quarrel
firtàri	quarter
kartièro	quarter
Kećuakani ćhib	Quechua
thagarni	queen
biheteroseksuàlo	queer
pućhipen	query
pućhipen	question
rèndo	queue
sigo	quick
sigo	quickly
śando	quiet
śandărel	quiet
kuri	quilt
mukhel	quit
but	quite
pućhel	quiz
pućhimatenqo konkùrso	quiz
ćitato	quotation
liparel	quote
molipen	quote
del molipen	quote
gilimèle	quotes
śośoj	rabbit
konkùrso	race
ràsa	race
liel kotor ando konkùrso	race
xoli	rage
briśind	rain
barărel	raise
vazdel	raise
barărdo	raised
vazdino	raised
naślem	ran
biprinзardo manuś	random
arbitràro	random
sèria	range
intervàlo	range
sigo	rapid
sigo	rapidly
nabutivarutno	rare
nabutvar	rarely
sigărdo	rash
alergìa	rash
gurmuso	rat
bilaćho manuś	rat
krisarel	rate
ràta	rate
but	rather
rapòrto	ratio
racionàlo	rational
brùto	raw
śilalo	raw
bikiravdo	raw
re	re
distànca	reach
aresel	reach
areslo	reached
reàkcia	reaction
drabarel	read
drabarindoj	reading
pregätime	ready
ćaćo	real
realipen	reality
kerel	realize
xatărel	realize
kerdo	realized
xakărdăs	realized
ćaćipnasөe	really
ćaćes	really
barărel xurdorren	rear
bul	rear
palal	rear
motìvo	reason
rezonàbilo	reasonable
anel pes godăөe	recall
kitànca	receipt
liel	receive
lino	received
zabado	recent
na but anglal	recently
recèpcia	reception
recèta	recipe
riskànto	reckless
indiferènto	reckless
prinзaripen	recognition
prinзarel	recognize
rekomedisarel	recommend
rekomendisarel	recommended
informàcie	record
rekòrdo	record
registrisarel	record
sastărel pes	recover
liel pale	recover
sastăripen	recovery
liipen palem	recovery
vortiglo	rectangle
lolo	red
laćharel	redeem
liel pale	redeem
paruvipen	redemption
jertisaripen e bezexenqo	redemption
pokinipen	redemption
tiknărel	reduce
binecesàro	redundant
bićhalel	refer
adresizel	refer
referìnca	reference
godisarel	reflect
sikavel	reflect
godisaripen	reflection
reflèksia	reflection
refrèno	refrain
friзidèro	refrigerator
del love palpale	refund
na kamel	refuse
phendem so na kamav	refused
dikhel	regard
patĭv	regard
anda so dikhel	regarding
mamuj	regardless
dikhel	regards
regiòno	region
registrisarel	register
źalisarel	regret
prinзardo	regular
regulàto	regular
regulàto	regularly
na akceptisarel	reject
mothovel	relate
phandel	relate
phandlo	related
relàcia	relationship
relatìvo	relative
paśutne ratesqe	relatives
relaksizel pes	relax
del drom	release
vestăripen	release
mestărdo	released
relevànto	relevant
sìguro	reliable
lokhăripen	relief
vastdinipen	relief
paruvel varekas k-i butĭ	relieve
tiknărel	relieve
baxtalo	relieved
relìgia	religion
religiòso	religious
na kamav	reluctant
bazisarel pes	rely
aćhel	remain
aćhel	remaining
mukhipen	remaining
remarkàbilo	remarkable
drab	remedy
anel pes godăөe	remember
anel godăөe	remind
mesàźo	reminder
izolàto	remote
katar o duripen	remote
del rigal	remove
kerel	render
kirìa	rent
del and-i kirìa	rent
laćharel	repair
palemphenel	repeat
palemkeripen	repeat
ćhel thanesөe	replace
paruvel	replace
del anglal	reply
rapòrto	report
del rapòrto	report
reprezentisarel	represent
reputàcia	reputation
mangel	request
mangipen	request
mangel	require
manglo	required
xastral	rescue
rodipen	research
miazel	resemble
xolipen	resentment
kerele rezervàcia	reservation
rezervàcia	reservation
kerel rezervàcia	reserve
rezèrva	reserve
rezervàcia	reserve
themutno manuś	resident
del pesqe demìsia	resign
reziliènca	resilience
reziliènto	resilient
rezistizel	resist
maripen mamuj	resistance
rezolùcia	resolution
rezolvisarel	resolve
staciùne	resort
resùrses	resources
patĭv	respect
del patĭv	respect
del anglal	respond
angledinipen	response
responsabilitèto	responsibility
responsìblo	responsible
dinglŏl	rest
te ovel lokhi lesqi phuv	rest in peace
restaurànto	restaurant
laćharel	restore
limitisarel	restrict
rezultàto	result
rezultàtură	results
astarel palem	resume
kinbikin k-o kotor	retail
bikinel k-o kotor	retail
inkerel	retain
retència	retention
k-i pènsia	retired
gelo	retired
tiknărel pes	retreat
del pes pale	retreat
liel palpale	retrieve
avel palpale	return
sikavel	reveal
mothol	revealed
ćhel i xoli varekasө	revenge
line love	revenue
boldel	reverse
palemdikhel	review
evaluàcia	review
kerel revìzia	revise
revìzia	revision
revolùcia	revolution
del rekompènsa	reward
rekompènsa	reward
rìtmo	rhythm
tĭlo	rib
paśvro	rib
ćaval	rice
barvalo	rich
mestărel	rid
зal anklisto	ride
phiripen	ride
asaipnasqo	ridiculous
korèkto	right
akana	right now
zoralo	rigid
angrustik	ring
xalavel	rinse
ćingar	riot
liel kotor k-i ćingar	riot
phagipen	rip
phagel	rip
te ovel lokhi lesqi phuv	rip
peko	ripe
barărel	rise
vazdel	rise
rìsko	risk
rivàlo	rival
len	river
drom	road
pekel	roast
zoralo	robust
barr	rock
ròko	rock
dolalinavel	rock
rovli	rod
ròlo	role
del pes dea dùra	roll
Rromani ćhib	Romani
ćhatlo	roof
livni	room
darin	root
śelo	rope
nasul	rotten
rimome	rotten
bikovlo	rough
aproksimatìvo	roughly
violènto	roughly
trujalo	round
rùta	route
tradel	route
rutìna	routine
śìro	row
ćingar	row
moripen	rub
morel	rub
kaućuko	rubber
gùma	rubber
gunòjo	rubbish
kritikisarel	rubbish
bilaзando	rude
tikno kovòri	rug
xarravel	ruin
xarravipen	ruin
règula	rule
rajarel	rule
lìnia	rule
śerutno	ruler
vortorin	ruler
règule	rules
naśel	run
naśavipen	running
ruràlo	rural
sigărel	rush
gono	sack
atàko	sack
del avri katar e butăqo than	sack
svùnto	sacred
sakrifìćio	sacrifice
kerel sakrifìćio	sacrifice
seìfo	safe
andi sigurànca	safe
laćho zbòro	safe flight
sigurànca	safety
godăver	sage
sàlvia	sage
phendem	said
зa po pani	sail
navigàcia	sailing
naùtiko spòrto	sailing
andar	sake
pokinipen	salary
aukciòno	sale
bikinipen	sale
somòno	salmon
lon	salt
ćhel lon	salt
sajekh	same
Kadja si vi kathe	Same here
modèlo	sample
kiśaj	sand
Sanskritikani ćhib	Sanskrit
sarkàstiko	sarcastic
bilaзando	sassy
beślăs	sat
satisfàkcia	satisfaction
naisardo	satisfied
naisarel	satisfy
laćho	satisfying
Savato	Saturday
goj	sausage
dìvio	savage
inkerel	save
xastral	save
dikhlem	saw
phenel	say
gàma	scale
śopni	scale
taraz	scale
atharipen	scam
atharel	scam
mukhel ùrme	scar
sèmno	scar
bidòsta	scarce
daravdo	scared
eśàrfa	scarf
traśavno	scary
ćhudino bute rigenөe	scattered
sćèna	scene
peisàźo	scenery
laćhi sung	scent
sungal	scent
programisarel	schedule
progràmo	schedule
śkòla	school
зanglipen	science
зanipnasqo manuś	scientist
зanipnasqe manuśa	scientists
kat	scissors
ćingardel	scold
oportunitèto	scope
ekzaminisarel	scope
umal	scope
liel pùnktură	score
ćhudel	scrap
purani sastri	scrap
kotor	scrap
xramosarel nasul	scratch
xanзal	scratch
del avri	scratch
cipizel	scream
vićinipen	scream
ekràno	screen
ćhivel jekh suć	screw
suć	screw
xramosaripen	script
scenàrio	script
baro pani	sea
sigìlo	seal
fòka	seal
rodipen	search
rodel	search
berśivaxt	season
than	seat
dujto	second
sekùnda	second
sekrèto	secret
sèkcia	section
sìguro	secure
sekuritèta	security
dikhel	see
devleça	see you
dikhasa amen maj palal	see you later
dikhas amen sigo	see you soon
dikhas amen rano	see you tomorrow
sumb	seed
rodel	seek
fal pes	seem
fal pes so	seems
dikhlo	seen
astarel	seize
viзavel	seize
konvùlsia	seizure
liipen	seizure
nabutivarutno	seldom
selèkto	select
alosarel	select
ègo	self
sastărel pes korkorro	self healing
egoìsto	selfish
bikinel	sell
bićhalel	send
bićhal manqe tiri fotografìa	send me your picture
seniòro	senior
maj baro	senior
manaj	sense
xatărel	sense
xatăripen	sense
godăver	sensible
xaćarno	sensible
xaćarno	sensitive
bićhaldo	sent
sentìnca	sentence
propozìcia	sentence
del sentìnca	sentence
propozìcie	sentences
independènto	separate
ulavdo	separate
Sepedikani ćhib	Sepedi
septèmbro	september
sekvènca	sequence
sèria	series
seriàlo	series
seriòso	serious
seriòso	seriously
sevel	serve
kerel butĭ	serve
sèrviso	service
laćharel maśìna	service
beśipen	session
sèsiune	session
ćhivel	set
sètos	set
del	set up
kerel	set up
dekòro	setting
ćhilipen	setting
beśel	settle
stabilisarel	settle
efta	seven
deśuefta	seventeen
eftavardeś	seventy
nesave	several
bilaćho	severe
pharo	severe
suvel	sew
śt	sh
ućhal	shade
ućhalin	shadow
tinăzel	shake
izdral	shake
ośte	shall
biseriòso	shallow
naxor	shallow
laзal	shame
laзipen	shame
fòrma	shape
ulavel	share
rostărdo	sharp
godăver	sharp
voj	she
lan si lan	she has
voj si	she is
khaselin	shed
bakri	sheep
ćarćàfo	sheet
hїrtia	sheet
etaźèra	shelf
koaźa	shell
phagel	shell
del beślin	shelter
beślin	shelter
rakhel	shield
skùto	shield
paruvipen	shift
paruvel	shift
straftinel	shine
bero	ship
nàve	shipping
marìtimo transpòrto	shipping
gad	shirt
tiraxa	shoes
liel drògură	shoot
filmisarel	shoot
puśkisarel	shoot
kerel kinimata	shop
magazìno	shop
kinipen	shopping
màlo	shore
xarno	short
krìza	shortage
zumavipen	shot
cirdipen	shot
dab	shot
trebulas	should
phiko	shoulder
del muj	shout
spektàkulo	show
sikavel	show
sikav manqe	show me
dùśo	shower
krevèto	shrimp
psihiàtro	shrink
tiknărel pes	shrink
phandel	shut
phandlo	shut
taize	shut up
traśalo	shy
phral	sibling
phrala	siblings
nasvalo	sick
rig	side
paśrovel	sigh
paśrovipen	sigh
dikhipen	sight
dikhel	sight
dikhel interesànto thana	sightseeing
telalxramosarel	sign
telalxramosaripen	signature
vastno	significant
śandipen	silence
śando	silent
taizalo	silent
keź	silk
bigodăqo	silly
rup	silver
miazutno	similar
bigodăver	simp
kamlărel	simp
sado	simple
simultàno	simultaneously
de atunć	since
kodolesqe	since
bixoxavno	sincere
bi te xoxavel	sincerely
gilabel	sing
gilavno	singer
korkorro	single
tasavel pes	sink
xunavel	sink
balani	sink
Raja	Sir
phen	sister
sali	sister in law
beśel tele	sit
si	site
sàito	site
than	site
situàcia	situation
śov	six
deśuśov	sixteen
śovardeś	sixty
baripen	size
ćatrin	size
abilitèto	skill
abilitètură	skills
mortĭ	skin
kiślo	skinny
xutel	skip
kontàinero	skip
coxa	skirt
devel	sky
sklàvo	slave
sovel	sleep
sovipen	sleep
sovel	sleeping
sovipnasqo	sleeping
lindralo	sleepy
baj	sleeve
felìa	slice
puzgalipen	slide
puzgal	slide
zalaga	slightly
sano	slim
hїrtiaqo kotor	slip
puzgal	slip
зal k-i xarr	slope
xarr	slope
tang xїv	slot
dїlgo	slot
kerel jekh tang xїv	slot
lokhes	slow
lokhes	slowly
tikno	small
godăver	smart
muś	smell
del muś	smell
paśasal	smile
piel thuv	smoke
thuv	smoke
kovlo	smooth
xaben	snack
gonrov	snail
sap	snake
xolărel pes	snap
phagel	snap
iv	snow
kadja	so
deć	so
ajakha mїndro	so cute
зi akana	so far
kingărel	soak
kingăripen	soak
sapùno	soap
te ovel seriòso	sober
seriòso	sober
bimato	sober
fòtbalo	soccer
sociàlo	social
societèta	society
ćorape	socks
kovlo	soft
sòftueiro	software
phuv	soil
bikindo	sold
bikindăs să	sold out
xelavdo	soldier
korkorro	sole
tàlpa	sole
sasto	sole
zoralo	solid
solìdo	solid
solùcia	solution
rezolvisarel	solve
niśte	some
varekon	somebody
varesar	somehow
varekon	someone
vareso	something
varekana	sometimes
gili	song
sigo	soon
pharo	sophisticated
Soranikani ćhib	Sorani
xolăriko	sore
dukhalo	sore
dukh and-i men	sore throat
bari xoli	sorrow
Jertisar man	Sorry
Fal man nasul	Sorry
laćharel	sort
tìpo	sort
alosarel	sort
rodindo	sought
gĭ	soul
okaś	soulmate
baś	sound
zumi	soup
śuklo	sour
sùrsa	source
sùdo	south
than	space
bikamlo emailo	spam
bićhalel bikamle emailură	spam
buxlipen	span
nakhel opral i phurt	span
Spanikani ćhib	Spanish
xastral	spare
vesto	spare
vakărel	speak
speciàlo	special
spècia	species
specìfiko	specific
spektakulòso	spectacular
vakăripen	speech
lalo	speechless
vitèza	speed
śuk	spell
phenel pe grafème	spell
xarno intervàlo	spell
pokinel	spend
nakhavel	spend
pokindo	spent
nakhavdo	spent
jagalo	spicy
kanro	spike
pusavel	spike
kerel o pimos maj zoralo	spike
boldel	spin
spanàko	spinach
spìrito	spirit
ćhungardel	spit
rovli	spit
del briśind lokhes	spit
splèndido	splendid
ulavel	split
ekskavàcia	spoil
tratizel miśto	spoil
rimosarel	spoil
rimome	spoiled
spontàno	spontaneous
rroj	spoon
perś	spot
dikhel	spot
phukni	spot
зuvli	spouse
buxlărel	spread
anglomilaj	spring
pazàri	square
śtariglano	square
tasavel	squeeze
kalmàro	squid
veverìca	squirrel
svunto	st
spidel i ćhuri varekonesөe	stab
stabìlo	stable
grastelin	stable
muruśoj	stack
rovli	staff
personàlo	staff
ćhel pi sćèna	stage
etàpa	stage
sćèna	stage
perś	stain
śopni	stairs
mìza	stake
kilo	stake
riskizel love	stake
зal ćoral	stalk
koćaj	stalk
kiòśko	stall
grastelin	stall
munri	stamp
tìmbro	stamp
tribùna	stand
akceptisarel	stand
beśel opre	stand
stàdardo	standard
ćerxaj	star
stàrto	start
astardem	started
avel bokhalo	starving
them	state
kondìcia	state
ekstràso	statement
deklaràcia	statement
stàcia	station
statùia	statue
stàtuso	status
beśel	stay
inker tut sasto-vesto	stay safe
stabìlo	steady
regulàto	steady
peko mas	steak
bikuć butĭ	steal
ćorel	steal
vras	steam
aspin	steel
xoxoj	steep
aćhavel	stem
koćaj	stem
punro	stem
phirdel	step
phird	step
rovli	stick
zoralo	stiff
pànda	still
bitragalo	still
pusavel	sting
pusavipen	sting
kikidino	stingy
xamisarel	stir
del emòcia	stir
зivutre	stock
stòko	stock
buliòno	stock
ćordo	stolen
stomàko	stomach
barr	stone
beślem opre	stood
khul	stool
skamin	stool
aćhavel	stop
depòzito	storage
magazìno	store
bari balval	storm
paramisi	story
bov	stove
aragàzo	stove
dirèkto	straight
patĭvalo	straight
klàro	straightforward
zor	strain
thavdel	strain
ràsa	strain
biaćarutno	strange
avrutno	stranger
strategìa	strategy
phus	straw
käpśùna	strawberry
paśavro	streak
thavdel	stream
pani	stream
drom	street
zor	strength
akcènto	stress
strèso	stress
zor	stress
zinzaripen	stretch
zinzarel	stretch
strìkto	strict
dab	strike
grèva	strike
ćhinel	strike
śelo	string
bànda	strip
perel	strip
zumavel but	strive
azbal kovles	stroke
cerebràlo atàko	stroke
maripen	stroke
zoralo	strong
mardăs	struck
struktùra	structure
marel pes	struggle
maripen	struggle
savo marel pes	struggling
śeralo	stubborn
astardo	stuck
studènto	student
siklŏvel	study
stùdio	study
siklŏvel	studying
bută	stuff
pherel	stuff
ćudipnasqo	stunning
bigodăqo	stupid
stìlo	style
subijèkto	subject
ćhivipen	submission
tradel	submit
substànca	substance
importànto butĭ	substance
paruvel	substitute
subtìlo	subtle
avel palal	succeed
te avel les baxtagor	succeed
sukcèso	success
baxtagoresqo	successful
kasavo	such
sar	such as
piel	suck
biaźukerdo	sudden
jekhal	suddenly
dukhal	suffer
dukh	suffering
dòsta	sufficient
zahàro	sugar
kerel propozàlo	suggest
propozàlo	suggestion
si laćho	suit
kostùmo	suit
laćho	suitable
valìza	suitcase
kidel	sum
sùma	sum
xarni prezentàcia	summary
milaj	summer
malavipen	summit
vїrfo	summit
kham	sun
kurko	sunday
khamalo	sunny
rătăripen	sunset
khamesqi dud	sunshine
but laćho	super
superiòro	superior
supervizòro	supervisor
rătăqo xaben	supper
ristărel bută	supply
del vast	support
vastdinipen	support
kerel supozìcia	suppose
paćavdo	supposed
sìguro	sure
suprafàca	surface
barărel	surge
biaźukerdo barăripen	surge
kirurзia	surgery
familiaqo anav	surname
kerel surprìza	surprise
surprìza	surprise
ćudutno	surprised
perel	surrender
kaj si paśal	surrounding
brakhipen	surveillance
ankèta	survey
dikhel e atenciaça	survey
aćhel ando зivipen	survive
na patăl	suspect
suspèkto	suspect
aćhavdo	suspended
umblavdo	suspended
suspićòso	suspicious
terpinel	sustain
inkerel	sustain
sustenabilitèto	sustainability
duràbilo	sustainable
ćorde bută	swag
del bùka	swallow
paruvipen	swap
paruvel	swap
kuśel	swear
solaxal	swear
khamlel	sweat
khamlipen	sweat
flanèla	sweater
dab	sweep
śulavipen	sweep
śulavel	sweep
guldo	sweet
laćhe sune	sweet dreams
plaćol pesqe te xal guldimata	sweet tooth
piramno	sweetheart
barărel	swell
śuvlipen	swelling
natisarel	swim
natisaripen	swimming
dolalinavel	swing
dolalin	swing
їntrerupätòro	switch
paruvipen	switch
paruvel	switch
phuklo	swollen
xanro	sword
simbòlo	symbol
simpatìa	sympathy
simptòme	symptoms
sistèmo	system
sìnia	table
ekipamènto	tackle
azbal jekh problèma	tackle
etikèta	tag
зal po ùrma	tail
pori	tail
liel	take
love	take
liel	take away
si man grìźa	take care
зal opre	take off
del tele	take off
lino	taken
del duma	talk
mujalo	talkative
ućo	tall
del lokho dab	tap
robinèto	tap
bànda	tape
cїrdel	target
cìnta	target
butĭ	task
gunз	taste
gunзarel	taste
laćho	tasty
siklărdem	taught
ćaio	tea
siklărel	teach
siklărno	teacher
ekìpa	team
phagipen	tear
asvin	tear
phagal	tear
asvină	tears
xolărel	tease
tehnològia	technology
danda	teeth
phenel	tell
phen manqe	tell me
xolărel pes sigo	temper
tiknărel	temper
temperatùra	temperature
tèmplo	temple
korri	temple
temporàro	temporary
deś	ten
deś mìes	ten thousand
kiriàśo	tenant
te dikhel varekasөar	tend
te ovel les tendìnca	tend
tendència	tendency
dukhalo	tender
kerel ofèrta	tender
delikàto	tender
stresàto	tense
vaxt	tense
tensiùnă	tension
càxra	tent
zumavipen	tentative
tèrmeno	term
anavărel	term
relàcie	terms
kondìcie	terms
terìbilo	terrible
terìfiko	terrific
teritòro	territory
tèsto	test
kerel tèsto	test
tèksto	text
bićhalel mesàźo po telefòno	text
sar	than
naisarel	thank
nais tuqe	thank you
Naisaras tumenqe so aźukeren amen te keras i investigàcia pal-e beresqo ladavipen	Thank you for your patience while we investigate shipment
nais tuqe but	thank you so much
nais tuqe but	thank you very much
nais tuqe	thanks
Naisaras tumenqe so utilizisaren amari aplikàcia	Thanks for using our app
kodova	that
kadava si	that is
si miśto	that's good
o	the
ćoripen	theft
lenqo	their
len	them
lenqe	them
tèma	theme
pen	themselves
palal	then
teorìa	theory
kothe	there
si	there are
si	there is
kadja so	therefore
kadala	these
von	they
von si	they are
thulo	thick
ćor	thief
xeroj	thigh
sano	thin
butĭ	thing
bută	things
godisarel	think
trinto	third
truśalo	thirsty
deśutrin	thirteen
trianda	thirty
kadava	this
kadava si	this is
komplèto	thorough
e atenciàça	thoroughly
but	thoroughly
kodola	those
mamuj so	though
gїndo	thought
godisardem	thought
atènto	thoughtful
godă	thoughts
jekh mìa	thousand
filèto	thread
thav	thread
nakhavel	thread
phardipen	threat
phardel	threaten
trin	three
nivèlo	threshold
pridvòro	threshold
but impresime	thrilled
barărel	thrive
korr	throat
anda	through
sasto	throughout
ćhudel	throw
baro naj	thumb
tùneto	thunder
Màrci	Thursday
kadja	thus
xarno vaxt	tick
ćhel bìfa	tick
marèa	tide
ordonisardo	tidy
phandel	tie
kravàta	tie
tìgros	tiger
tang	tight
phandlo zorales	tight
Tigrinikani ćhib	Tigrinya
vrjama	time
daralo	timid
tiknorro	tiny
bakśìśo	tip
ćhorel	tip
del bakśìśo	tip
bakśìśoja	tips
anvelòpa	tire
khinŏl	tire
khino	tired
cesùto	tissue
śervecèlo	tissue
del tìtulo	title
tìtulo	title
k-o	to
te	to
si	to be
manro peko	toast
avdĭves	today
xurdo	toddler
punresqe naja	toes
khethanes	together
xїndelin	toilet
phendo	told
tolerànca	tolerance
tolerizel	tolerate
loli	tomato
rano	tomorrow
ćhib	tongue
and-i kadaja răt	tonight
vi	too
but	too
lias	took
instrumènto	tool
instrumèntură	tools
dand	tooth
blùza	top
ućharno	top
tèma	topic
ćhinărdo	torn
tortùra	torture
totàlo	total
azbal	touch
azbalipen	touch
zoralo	tough
pharo	tough
phiripen	tour
karing	toward
karing	towards
prosòpo	towel
diz	town
tòksiko	toxic
ùrma	trace
arakhel	trace
drom	track
зal palal ùrme	track
komèrco	trade
bikinel	trade
tradìcia	tradition
tradicionàlo	traditional
tràfiko	traffic
зal lokhes	trail
dromorro	trail
trèna	train
siklărel	train
trìno	train
antrenamènto	training
karakterìstika	trait
karakterìstike	traits
kerel transfèro	transfer
transfèro	transfer
tranzìcia	transition
amboldel	translate
transparènto	transparent
transportizel	transport
transpòrto	transport
transpòrto	transportation
feli	trap
vurdon	trap
astarel jekh зivutro	trap
ćhudel	trash
gunòjo	trash
tràuma	trauma
phirel	travel
tàva	tray
mandĭn	treasure
mol	treasure
phiravel	treat
tratisarel	treat
tratamènto	treatment
rukh	tree
but baro	tremendous
tendìnca	trend
procèso	trial
zumavipen	trial
kerel trùko	trick
trùko	trick
testisardo	tried
aranźizel	trim
tiknărel	trim
phiripen	trip
kerel problèmură	trouble
problèma	trouble
kàlca	trousers
kamiòno	truck
ĆAĆO	true
moxton	trunk
murukli	trunk
tròmpa	trunk
patăipen	trust
patăl pes	trust
ćaćipen	truth
zumavel	try
Songanikani ćhib	Tsonga
tùba	tube
Marci	Tuesday
siklăripen	tuition
śkolarizaciaqi tàksa	tuition
lutuno	turkey
turmeriko	turmeric
boldel	turn
paruvel	turn
cestòsa	turtle
meditatòri	tutor
deśuduj	twelve
biś	twenty
biś thaj jekh	twenty-one
Twikani ćhib	Twi
duj var	twice
boldel trujal	twist
duj	two
tìpo	type
tìpikano	typical
зungalo	ugly
o maj but vastno	ultimate
umbrèla	umbrella
bikapàbilo	unable
kak	uncle
bigodărdo	unconscious
telal	under
telal	underneath
bi dòsta molărdo	underrated
xatărel	understand
xatărdo	understood
bezexenөar	unfortunately
unifòrmo	uniform
unifòrma	uniform
ùniko	unique
kotor	unit
universitèto	university
biprinзardo	unknown
e ekscepciaça	unless
зi kana	until
biaćarutno	unusual
opre	up
tu alosares	up to you
aktualizàcia	update
laćharel	upgrade
pa	upon
xolăme	upset
forosqo	urban
baro kamipen	urge
mangel	urge
sigalo	urgent
amenqe	us
amen	us
labărel	use
labărdo	used
utìlo	useful
biutìlo	useless
aćarutno	usual
aćaral	usually
utilitèto	utility
vakànca	vacation
vakcinàcia	vaccination
vakcìno	vaccine
vàkuumo	vacuum
biprecìzo	vague
valìdo	valid
xarr	valley
molalo	valuable
molipen	value
ververipen	variety
verver	various
si verver	vary
vàza	vase
but baro	vast
legùme	vegetable
legùmes	vegetables
vehìkulo	vehicle
bikinitòri	vendor
velìno	venom
rìsko	venture
riskizel	venture
malavipnasqo than	venue
kerel verifikàcia	verify
versatìlo	versatile
vèrsia	version
vertikàlo	vertical
but	very
but laćho	very good
bero	vessel
vàso	vessel
andar	via
vibràcia	vibe
xatărimata	vibes
bilaćho	vicious
vìktima	victim
vìdeo	video
dikhipen	view
gav	village
ćorrikano	villain
śut	vinegar
purano	vintage
violènca	violence
violènca	violent
viràlo	viral
ćhaj bari	virgin
virtuàlo	virtual
kalitèta	virtue
dikhipen	vision
kerel vìzita	visit
vizuàlo	visual
vitàlo	vital
зivdo	vivid
vokabulàro	vocabulary
vak	voice
vesto than	void
nùlo	void
volùmo	volume
voluntàro	volunteer
ćhadel	vomit
ćhadipen	vomit
vulneràbilo	vulnerable
marel	wage
pokinipen	wage
pokinimata	wages
maśkar	waist
aźukerel	wait
kèlnero	waiter
aźukerindoj	waiting
uśtel	wake
uśtel	wake up
phiravel pes	walk
зal	walking
barand	wall
portmonèo	wallet
phirel	wander
kamav te	wanna
nanaipen	want
kamel	want
kamlo	wanted
maripen	war
dulàpo	wardrobe
depòzito	warehouse
tato	warm
tatărel	warm
kerel avertizàcia	warn
avertizàcia	warning
xelavdo	warrior
sas	was
thovel	wash
deśeură	waste
xasaripen	waste
dikhel	watch
pani	water
herbuzo	watermelon
phund	wave
drom	way
ame	we
ame sam	we are
ame aśti	we can
bizoralo	weak
defèkto	weakness
barvalipen	wealth
barvalo	wealthy
phiravel	wear
xurăvipen	wear
rimosaripen	wearing
vrjama	weather
abăv	wedding
Tetradĭ	Wednesday
ankalavel i ćar	weed
ćar	weed
kurko	week
kurkesqo agor	weekend
pharipen	weight
ćudato	weird
miśto avilăn	welcome
laćhipen	welfare
sociàlo asistènca	welfare
Xaning	Well
Inklel	Well
Śukar	Well
but śukar	well done
gelo	went
sas	were
vèsto	west
kingărdo	wet
balèna	whale
so	what
thaj tu	what about you
so keres	what are you doing
so keres akana	what are you doing now
so keres akana	what are you doing right now
so okupàcia si tut	what do you do
so okupàcia si tut	what do you do for a living
so kames te phenes	what do you mean
so kames	what do you want
so sas	what happened
so si	what is
so si kadava	what is this
so okupàcia si tut	what is your job
sar bućhos	what is your name
so keres	what's up
so si	what's up
sar si tiro anav	what's your name
indiferènto so	whatever
orso	whatever
gĭv	wheat
truj	wheel
kana	when
varekana	whenever
kaj	where
kaj san	where are you
katar san	where are you from
kaj san akana	where are you now
kaj beśes	where do you live
kaj si	where is
and-o vaxt so	whereas
te	whether
kaj	which
kana	while
del duma lokhes	whisper
abaźùro	whisper
śoldipen	whistle
parno	white
kon	who
kon san tu	who are you
kon si	who is
kon si kadava	who is this
sasto	whole
kaj	whom
kasqorro	whose
sosqe	why
sosqe na	why not
bilaćho	wicked
buxlo	wide
aćhel phivlo	widow
phivli	widow
buxlipen	width
зuvli	wife
dìvio	wild
ośte	will
kamipen	will
kamav	willing
resel maj anglal	win
balval	wind
felăstra	window
balvalo	windy
mol	wine
ivend	winter
khosel	wipe
kàblo	wire
godăveripen	wisdom
godăver	wise
kamel	wish
mangipen	wish
kamav tuqe so si maj laćho	wish you all the best
drabarni	witch
liel palpale	withdraw
ankalavel	withdraw
ankalavipen	withdrawal
ando	within
bi	without
màrtoro	witness
dikhel	witness
godălo	witty
ruv	wolf
зuvli	woman
зuvlă	women
line	won
na ośte	won't
pućhel pes	wonder
ćudipen	wonder
but laćho	wonderful
kaśt	wood
veś	wood
pośom	wool
alav	word
alava	words
kerel butĭ	work
butĭ	work
ginel	work out
planifikisarel	work out
laćho	working
butăqo	working
lùmja	world
kermo	worm
rimosardo	worn
kaj kerel pesqe grìźa	worried
kerel pesqe grìźa	worry
grìźa	worry
maj nasul	worse
slùźba	worship
o maj nasul	worst
molipen	worth
mol	worth
mol	worth it
molălo	worthy
prinзardo manuś	worthy
ośte	would
phugni	wound
kerel phugni	wound
Uau	Wow
ućharel	wrap
ućharipen	wrap
bari xoli	wrath
vastesqo phandavipen	wrist
xramosarel	write
Xramosar kathe	Write here
xramosaripen	writing
xramosardo	written
dośalo	wrong
xramosardem	wrote
iàrdo	yard
xaśtil	yawn
xaśtipen	yawn
Va	Yeah
berś	year
berśa	years
dròźdia	yeast
cipil	yell
źїlto	yellow
Ova	Yes
va, mirri piramni	yes baby
va, mirri kuć	yes dear
va, mi piramni	yes honey
va, mi piramni	yes my love
va, va	yes of course
iз	yesterday
їnkä	yet
profìto	yield
kerel	yield
anel	yield
tu	you
tu san	you are
san śukar	you are beautiful
tu san ajakha mїndro	you are so beautiful
e lośaça	you are welcome
tu aśtizes	you can
Tu зanes	You know
vi tu	you too
e lośaça	you're welcome
terno	young
tirro	your
e lośaça	your welcome
tu korkorro	yourself
e terne	youth
e lośaça	you’re welcome
mmm	yummy
zèro	zero
