кыратык	a little
элбэх	a lot
элбэх	a lot of
бырах	abandon
быраҕыллыбыт	abandoned
тутус	abide
сатабыл	ability
сатыыр	able
туһунан	about
үрдүгэр	above
тас дойдуга	abroad
суох буолуу	absence
суох буол	absent
букатын	absolutely
иҥэр	absorb
абстрактнай	abstract
абсурднай	absurd
дэлэйии	abundance
элбэх	abundant
наһаа туһан	abuse
акцент	accent
ылын	accept
киирии	access
түбэлтэ	accident
олохтооһун	accommodation
ситис	accomplish
ситистэ	accomplished
быһыытынан	according
усчуот	account
туочунас	accuracy
сөптөөх	accurate
буруйдаммыт	accused
ыарыы	ache
ыалдьар	ache
ситис	achieve
ситиһии	achievement
өйдөө	acknowledge
билсиһии	acquaintance
ылын	acquire
ылла	acquired
ылыы	acquisition
нөҥүө	across
дьай	act
дьайыы	action
активнай	active
тэрээһиннэр	activities
көх	activity
актер	actor
дьиҥнээх	actual
дьиҥинэн	actually
сытыы	acute
үөрэн	adapt
эбии	add
тутулуктаах	addicted
толоруу	addition
эбии	additional
сыһыаннас	address
аадырыс	address
адекватнай	adequate
быысаһа	adjacent
даҕааһын	adjective
бэрээдэктээ	adjust
астын	admire
билин	admit
иит	adopt
сөҕүмэр үчүгэй	adorable
сыҕарый	advance
сыҕарытыы	advance
бастыҥ	advanced
ордуга	advantage
быһылаан	adventure
сыһыат	adverb
реклама	advertisement
реклама	advertising
сүбэ	advice
сүбэ	advise
адвокат	advocate
көмүскээ	advocate
эстетическай	aesthetic
дьыала	affair
сабыдыал	affect
убаныы	affection
биэр	afford
ылыахха син	affordable
куттан	afraid
кэнниттэн	after
күнүс	afternoon
ол кэннэ	afterwards
эмиэ	again
утары	against
саас	age
агентство	agency
агент	agent
кырыктаах	aggressive
хомоҕой	agile
анараа өттүгэр	ago
сөбүлэс	agree
сөбүлэһии	agreement
тыа хаһаайыстыбата	agriculture
иннигэр	ahead
көмө	aid
сорук	aim
салгыс	air
аэропорт	airport
эрээт	aisle
аймалҕан	alarm
аргы	alcohol
аймалҕан	alert
тыыннаах	alive
бары	all
биир саастаахтар	all right
бары үчүгэйи	all the best
көҥүллээ	allow
көҥүллэммит	allowed
сыһа	almost
соҕотох	alone
кытта	along
бэлиэр	already
Сөп	Alright
эмиэ	also
альтернативнай	alternative
иһин	although
наар	always
бэрт	amazing
таамах	ambiguous
амбиция	ambition
амбициялаах	ambitious
уларыт	amend
ортотугар	amid
ортотугар	among
биһиги ортобутугар	among us
сумма	amount
көрүдьүөс	amusing
анализ	analysis
өбүгэлэр	ancestors
дьаакыр	anchor
былыргы	ancient
уонна	and
оттон эн	and you
аанньал	angel
уордайыы	anger
муннук	angle
кыыһырбыт	angry
харамай	animal
бэрбээкэй	ankle
үбүлүөй	anniversary
биллэрии	announcement
кыыһырт	annoy
кыыһырбыт	annoyed
ниэрбэ	annoying
сыллааҕы	annual
анонимнай	anonymous
атын	another
хоруй	answer
хоруйдаа	answer
өтө көр	anticipate
долгуйуу	anxiety
кыһалҕаламмыт	anxious
ханнык да	any
аны	anymore
ким эмит	anyone
туох даҕаны	anything
хайдах да буоллар	anyway
хайдах да буоллар	anyways
туспа	apart
квартира	apartment
буруйгун билин	apologize
чахчы	apparent
быһыылаах	apparently
сыһыаннас	appeal
көһүн	appear
тас көрүҥ	appearance
үөскээтэ	appeared
аһыыр баҕа	appetite
дьаабылака	apple
туһаныы	application
туһан	apply
көрсүһүү	appointment
сыаналаа	appreciate
махтаныы	appreciation
сыһыаннас	approach
сыһыан	approach
сөптөөх	appropriate
биһирээһин	approval
биһирээ	approve
биһирэммит	approved
кэриҥэ	approximately
муус утар	april
көҥүл	arbitrary
архитектор	architect
архитектура	architecture
архыып	archive
буол	are
эн	are you
сололооххун дуо	are you busy
кэргэннээххин дуо	are you married
эн кэргэннээххин дуу хайдах дуу	are you married or single
Бааргын дуо?	Are you still there?
бааргын дуо	are you there
уобалас	area
мөккүөр	argue
аргумент	argument
тур	arise
илии	arm
армия	army
аттыгар	around
тэрий	arrange
тэрийии	arrangement
кэлии	arrival
кэл	arrive
кэллэ	arrived
улахамсык	arrogant
ох	arrow
искусство	art
ыстатыйа	article
сымыйа	artificial
худуоһунньук	artist
дылы	as
диэри	as long as
эмиэ	as well
курдук	as well as
күл	ash
кыбыстар	ashamed
ыйыт	ask
ыйытта	asked
утуйбут	asleep
өрүт	aspect
Ассамскай	Assamese
саба түһүү	assault
муһун	assembly
дьүккүөрдээх	assertive
сыаналаа	assess
сыаналааһын	assessment
объект	asset
актыыптар	assets
анаа	assign
сорудах	assignment
көмөлөс	assist
көмөлөһөөччү	assistant
бодорус	associate
ситимнээх	associated
ассоциация	association
сабаҕалаа	assume
сабаҕалааһын	assumption
саатар	at least
сиэтэ	ate
спортсмен	athlete
сыһыар	attach
сыһыарыллыбыт	attached
сыһыарыы	attachment
саба түһүү	attack
буоруоба	attempt
боруобалаа	attempt
сырыт	attend
сылдьыы	attendance
болҕомто	attention
сыһыан	attitude
умсугут	attract
аттракцион	attraction
кыраһыабай	attractive
сыһыарыы	attribute
аудитория	audience
атырдьах ыйа	august
эдьиий	aunt
эдьиий	aunty
дьиҥнээх	authentic
ааптар	author
былаас	authority
күһүн	autumn
баар	available
орто	average
тумун	avoid
уһуктубут	awake
наҕараада	award
бил	aware
билии	awareness
ыраах	away
бэрт	awesome
дьаабы	awful
кыбыстыылаах	awkward
Аймара	Aymara
ньирэй оҕо	baby
сулумах	bachelor
кэтэх	back
фон	background
куһаҕан	bad
суумка	bag
мэҥиэ	bait
буһар	bake
пекарня	bakery
ас содата	baking soda
ыйааһыҥҥын тэҥнээ	balance
баланс	balance
мээчик	ball
Бамбара	Bambara
банан	banana
бөлөх	band
тоҥсуй	bang
баан	bank
буруус	bar
арыычча	barely
түһэрис	bargain
хатырык	bark
үр	bark
нэчимиэн	barley
мэһэй	barrier
база	base
базатыгар	based
оҥкучах	basement
сүрүн	basic
сүнньүнэн	basically
базилик	basil
көрсүү оҕото	bastard
баартыйа	batch
ванна	bath
суунар сир	bathroom
батарея	battery
кыргыһыы	battle
порт	bay
буол	be
сэрэхтээх буол	be careful
пляж	beach
сардаҥа	beam
горох	beans
эһэ	bear
тулуй	bear
бытык	beard
тирэх	bearing
кыыл	beast
оҕус	beat
ритм	beat
кэрэ	beautiful
кэрэ	beauty
буолбут	became
тоҕо диэтэххинэ	because
буол	become
орон	bed
утуйар хос	bedroom
тигээйи	bee
эт	beef
сылдьыбыта	been
пиибэ	beer
иннинэ	before
саҕалаата	began
саҕалаа	begin
саҕалааһын	beginning
аатыттан	behalf
тутта сырыт	behave
быһыы-майгы	behavior
быһыы	behaviour
кэннигэр	behind
буол	being
итэҕэл	belief
итэҕэй	believe
ис	belly
киэнэ буол	belong
тапталлаах	beloved
аллараа	below
кур	belt
ыскамыайка	bench
токурут	bend
анныгар	beneath
туһата таһаарын	benefit
барыс	benefit
барыстар	benefits
таһыгар	beside
ураты	besides
саамай ордук	best
ситиһиини	best of luck
бары үтүөнү кытта	best regards
ордук	better
икки ардыгар	between
утах	beverage
таһыгар	beyond
Бходжпури	Bhojpuri
эрдэттэн санаммыт	bias
соруйан хасыһар	biased
велосипед	bicycle
туруоруу	bid
улахан	big
велосипед	bike
усчуот	bill
баай	bind
көтөр	bird
төрөөбүт күн	birthday
кыратык	bit
ытыр	bite
ытырыы	bite
аһыы	bitter
хара	black
бии	blade
буруйдаа	blame
буруй	blame
ичитэх	blank
сабыы	blanket
эстии	blast
туртат	bleach
булкуй	blend
алгыс	bless
алгыстаах	blessed
көрбөт	blind
дьол	bliss
блоктаа	block
хаан	blood
тылын	bloom
үр	blow
халлаан күөх	blue
сыппах	blunt
тахта	board
тыы	boat
эт-хаан	body
буһар	boil
хорсун	bold
ситим	bond
уҥуох	bone
сайаапка хааллар	book
кинигэ	book
түргэтэтии	boost
түргэтэт	boost
күүһүрдээччи	booster
бачыыҥка	boot
бачыыҥкалар	boots
кыраныысса	border
үүттээ	bore
чуҥкуйбут	bored
чуҥкук	boring
төрөөбүт	born
уларыс	borrow
тойон	boss
иккиэн	both
мэһэйдээ	bother
бытыылка	bottle
түгэх	bottom
атыыласта	bought
өрүтэ көт	bounce
быыс	bound
кыраныыссалар	boundaries
тоҥхос	bow
хабах	bowl
дьааһык	box
уол оҕо	boy
уол	boyfriend
бырасылыат	bracelet
мэйии	brain
салаа	branch
бренд	brand
хорсут	brave
кэһии	breach
килиэп	bread
алдьат	break
туормас	break
сарсыардааҥҥы ас	breakfast
түөс	breast
тыын	breath
тыын	breathe
боруода	breed
кирпиичэ	brick
кийиит	bride
көпүрө	bridge
кылгас	brief
сырдык	bright
бриллиант	brilliant
аҕал	bring
нохоо	bro
киэҥ	broad
көрдөр	broadcast
алдьаммыт	broke
алдьаммыт	broken
сиппиир	broom
быраат	brother
уол кылын	brother in law
аҕалла	brought
хороҥ	brown
суокка	brush
солуур	bucket
доҕор	buddy
бюджет	budget
хамырдыас	bug
тут	build
тутуу	building
тутуллубут	built
масса	bulk
оҕус	bull
атаҕастаа	bully
саайын	bump
баайыы	bunch
тутум	bundle
сүгэһэрдээ	burden
ыарык	burden
көмүллүбүт	buried
умай	burn
тэһин	burst
көм	bury
автобус	bus
ук	bush
бизнес	business
бюст	bust
иллэҥэ суох	busy
ол эрээри	but
арыы	butter
лыах	butterfly
тимэх	button
атыылас	buy
устун	by
арба	by the way
бакаа	bye
хапыыста	cabbage
кабинет	cabinet
килиэккэ	cage
бөрүөк	cake
торбос	calf
ыҥыр	call
ыҥырыы	call
миэхэ эрий	call me
ыҥырда	called
чуумпу	calm
кэллэ	came
хампаанньа	campaign
кыах	can
боллуон	can
сатаммат	can't
Соттор	Cancel
раак	cancer
сатыыр	capable
киэли	capacity
киин	capital
сурук	caption
тут	capture
массыына	car
карьера	career
сэрэхтээх	careful
сэрэнэн	carefully
ээл-дээл	careless
кыһамньылаах	caring
болуотунньук	carpenter
көбүөр	carpet
моркуоп	carrot
сүк	carry
салҕаа	carry on
оҥорр	carry out
дьыала	case
харчы	cash
бырах	cast
замок	castle
күннээҕи	casual
куоска	cat
тут	catch
категория	category
сүөһү	cattle
тутта	caught
аҕал	cause
сылтах	cause
болҕомто	caution
сэрэхтээх	cautious
хайа хаспаҕа	cave
тохтот	cease
үрүт	ceiling
бырааһынньыктаа	celebrate
клетка	cell
киин	center
үйэ	century
хлопья	cereal
церемония	ceremony
чахчылаах	certain
чопчу	certainly
туоһу сурук	certificate
сыап	chain
олоппос	chair
бэрэбиэркэлээ	challenge
бэрэбиэркэ	challenge
тоҕоос	chance
уларыт	change
бутумах	chaos
персонаж	character
характеристика	characteristics
иит	charge
үтүөнү оҥоруу	charity
абылыыр	charming
чарт	chart
сырыс	chase
кэпсэтии	chat
кэпсэт	chat
чэпчэки	cheap
албыннаа	cheat
албыннааһын	cheating
бэрэбиэркэлээ	check
бэрэбиэркэ	check
сыҥаах	cheek
үөр	cheer
үөрбүт-көппүт	cheerful
уруй айхал	cheers
сыыр	cheese
химия	chemistry
сыаналаа	cherish
дуобат	chess
түөс	chest
ыстаа	chew
куурусса	chicken
кылаабынай	chief
оҕо	child
оҕо саас	childhood
оҕолор	children
тымныт	chill
тымныы	chill
үөлэс	chimneys
иэдэс	chin
шоколад	chocolate
талыы	choice
тал	choose
быс	chop
дьиэтээҕи үлэ	chores
эмиччээхэй	chubby
таҥара дьиэтэ	church
корица	cinnamon
төгүрүмтэ	circle
өрүттэр	circumstances
олохтоох	citizen
куорат	city
бэрэтиэнсийэ	claim
эрэй	claim
чуолкайдаа	clarify
кылаас	class
туой	clay
ыраас	clean
ыраастаа	clear
ыраас	clear
клерк	clerk
өйдөөх	clever
клиент	client
очуос	cliff
климат	climate
ытын	climb
сыстыган	clingy
чаһыы	clock
сап	close
ыскаап	closet
таҥас	cloth
таҥас	clothes
былыт	cloud
былыттаах	cloudy
клоун	clown
сылтах	clue
көнтөрүк	clumsy
кластер	cluster
тренер	coach
тренировкалаа	coach
чох	coal
биэрэк	coast
сон	coat
кофе	coffee
когнитивнай	cognitive
түбэһии	coincidence
тымныы	cold
эстии	collapse
саҕа	collar
колледж	colleague
бииргэ үлэлээччилэр	colleagues
хомуй	collect
коллекция	collection
колледж	college
өҥ	color
өҥө суох от күөх идеялар	colorless green ideas slept furiously
өҥ	colour
колоннка	column
тараах	comb
комбинация	combination
холбоо	combine
кэл	come
кэл манна	come here
чэ эрэ	come on
көнньүөр	comfort
тоҕостоох	comfortable
сотору	coming
сотору	coming soon
хамаандалаа	command
комментарий	comment
эргиэн	commercial
комиссия	commission
оҥор	commit
эбэһээтэлистибэ	commitment
бэриниилээх	committed
табаар	commodity
уопсай	common
кэпсэт	communicate
сибээстэһии	communication
уопсастыба	community
тиий	commute
аргыс	companion
компания	company
тэҥнээн көр	compare
тэҥнээһин	comparison
аһыныгас буолуу	compassion
аһыныгас	compassionate
дьүөрэлэһэр	compatible
бүппүт	compete
компетентнай	competent
күрэх	competition
кыайан куотуһар	competitive
үҥүс	complain
үҥсүү	complaint
эбии	complement
эп	complement
бүтэр	complete
бүтүннүү	completely
комплекс	complex
дьүөрэлээһин	compliance
ыарахан	complicated
хайҕааһын	compliment
тутус	comply
композиция	composition
холбооһун	compound
өйдөөһүн	comprehension
бары өттүнэн	comprehensive
компромисс	compromise
булгуччулаах	compulsory
компьютер	computer
түм	concentrate
концепт	concept
дьиксинии	concern
дьиксий	concern
долгуйар	concerned
концерт	concert
түмүк	conclusion
быһаччы	concrete
бетоннаа	concrete
бетон	concrete
турук	condition
усулуобуйалар	conditions
ыыт	conduct
конференция	conference
билин	confess
эрэнии	confidence
эрэллээх	confident
бигэргэт	confirm
иирсээн	conflict
булкуллубут	confused
бутуллуу	confusion
эҕэрдэ	congrats
эҕэрдэ	congratulation
эҕэрдэ	congratulations
холбоһуу	conjunction
холбоо	connect
сэриилээн ыл	conquer
өйдөөх	conscious
өй-санаа	consciousness
сөбүлэс	consent
сөбүлэһии	consent
содул	consequences
кэпсэтии	conservation
консервативнай	conservative
аах	consider
ааҕыллыбыт	considered
лаах буол	consist
тутуу	consistency
утумнаах	consistent
куруук	constant
наар	constantly
хапчаттарыы	constipation
тутуу	construction
туһан	consume
туттуу	consumption
сибээстэс	contact
ситим	contact
сыстыганнаах	contagious
киллэр	contain
киллэрэр	contains
билиҥҥи	contemporary
сэнээһин	contempt
контент	content
күрэх	contest
контекст	context
континент	continent
салҕаа	continue
дуогабар	contract
сарбылын	contract
утарылаһыннар	contrast
контраст	contrast
көмөлөс	contribute
кылаат	contribution
хонтуруол	control
мөккүөрдээх	controversial
табыгас	convenience
табыгастаах	convenient
кэпсэтии	conversation
кубулут	convert
итэҕэли ылыммыт	convert
ыыт	convey
итэҕэт	convince
итэҕэбиллээх	convinced
астаа	cook
асчыт	cook
астааһын	cooking
олус бэрт	cool
ычча	cool
үлэлээһин	cooperation
толор	cope
алтан	copper
киин	core
кукуруза	corn
муннук	corner
сөп	correct
сыанаҕа тур	cost
сыана	cost
көстүүм	costume
коттедж	cottage
хлопок	cotton
дьыбаан	couch
сөтөллөө	cough
сүбэ	council
аах	count
счетчик	counter
дойду	country
дэриэбинэ	countryside
хос	couple
хорсун буолуу	courage
курс	course
суут	court
эйэҕэс быһыы	courtesy
сыган	cousin
сап	cover
ынах	cow
куттас	coward
тоҕостоох	cozy
краб	crab
хайдыы	crack
хайын	crack
идэ	craft
саах	crap
саахал	crash
саахаланыы	crash
баҕарар	craving
сыыл	crawl
иирбит	crazy
ай	create
айымньылаах	creative
кредит	credit
сыыл	creep
дьулаан	creepy
хамаанда	crew
буруй	crime
саат	cringe
кризис	crisis
критерий	criteria
мүлчүргэннээх	critical
кириитикэ	criticism
быс	crop
үүнүү	crops
кириэс	cross
быһыта охсус	cross
тураах	crow
көй дьон	crowd
элбэх дьонноох	crowded
корона	crown
дьүүктэ	crucial
сүрдээх	cruel
круиз	cruise
үтүрүйүү	crush
алдьат	crush
ытаа	cry
оҕурсуу	cucumber
куус	cuddle
култуура	culture
албастаах	cunning
чааскы	cup
ыскаап	cupboard
хаймыы	curb
эмп	cure
эмтээ	cure
комендантскай чаас	curfew
барыны билэ сатааһын	curiosity
кэрэхсэбиллээх	curious
будьурхай	curly
харчы	currency
сүүрүк	current
билиҥҥи туругунан	currently
кырыыс	curse
остуора	curtain
сыттык	cushion
үгэс	custom
клиент	customer
таможня	customs
быһыы	cut
быс	cut
ис киирбэх	cute
цикл	cycle
велосипедынан сүүрдүү	cycling
аҕа	dad
паапа	daddy
күннээҕи	daily
үүттээх	dairy
даамба	dam
буорту	damage
буортулаа	damage
кырыыс	damn
сииктээх	damp
үҥкүү	dance
куттал	danger
сэрэхтээх	dangerous
хараҥа	dark
күндү	darling
элээр	dash
күнэ	data
күн	date
көрсүһүү	date
кыыс оҕо	daughter
күн	day
өлбүт	dead
уһук болдьох	deadline
дүлэй	deaf
быһаап	deal
дьыала	deal
күндү	dear
Күндү доҕоттор	Dear All
Ытыктабыллаах туһанааччы	Dear Customer
Күндү төрөппүттэр	Dear Parents
Күндү	Dear Sir
Күндү устудьуоннар	Dear students
Күндү хамаанда	Dear Team
өлүү	death
дебат	debate
дебет	debit
сиҥнигэстэрэ	debris
иэс	debt
уон сыл	decade
үрэллии	decay
өлбүт	deceased
албыннаа	deceive
ахсынньы	december
сиэрдээх	decent
быһаар	decide
быһаарда	decided
быһаарыы	decision
остуол	deck
аккаастаа	decline
кыччаа	decrease
бэриниилээх	dedicated
бэринии	dedication
быһыы	deed
дириҥ	deep
таба	deer
куолутунан	default
хотуу	defeat
хот	defeat
көмүскээ	defend
быһаар	define
чопчу	definitely
быһаарыы	definition
истиэпэн	degree
уһатыы	delay
уһат	delay
хойутаабыт	delayed
соттор	delete
соруйан	deliberate
эйэҕэс	delicate
амтаннаах	delicious
дуоһуйуу	delight
астыммыт	delighted
тириэрт	deliver
туттарыллыбыт	delivered
тириэрдии	delivery
ирдээ	demand
ирдэбил	demand
ирдэнэр	demanding
демократия	democracy
абааһы	demon
көрдөр	demonstrate
аккаастаммыт	denied
хойуута	density
тиис бырааһа	dentist
мэлдьэс	deny
бөлөх	department
барыы	departure
тутулуктаах	depend
тэҥит	deploy
депозит	deposit
хараастыбыт	depressed
депрессия	depression
дириҥэ	depth
ойуулаа	describe
ойуулааһын	description
кумах куйаар	desert
тоҕоос	deserve
дизайн	design
оҥор	design
бэлиэтээһин	designation
баҕа	desire
баҕар	desire
остуол	desk
муҥур	despair
ыксаабыт	desperate
ол да буоллар	despite
десерт	dessert
анаммыт сир	destination
дьылҕа	destiny
алдьат	destroy
алдьатыы	destruction
дэтээл	detail
сиһилии	details
бул	detect
быһаарыы	determination
быһаарын	determine
тустаах	determined
буорайбыт	devastated
сайыннар	develop
сайдыылаах	developed
сайдыы	development
тэрил	device
абааһы	devil
бэриниилээх	devoted
Мальдивскай	Dhivehi
диабет	diabetes
диаррея	diarrhea
дневник	diary
тылдьыт	dictionary
гынна	did
өл	die
өлбүт	died
диета	diet
ураты	difference
атын	different
ыар	difficult
хас	dig
чиэс	dignity
кичэллээх	diligent
киэһээҥҥи ас	dinner
умсаран ыл	dip
көнө	direct
туһаайыы	direction
директор	director
кир	dirt
кирдээх	dirty
боп	disable
инбэлиит	disabled
сүи	disappear
салҕыбыт	disappointed
иэдээн	disaster
ылыныма	discard
үүр	discharge
дьиссипилиинэ	discipline
түһэрии	discount
ас	discover
дискриминация	discrimination
дьүүллээ	discuss
ырытыы	discussion
ыарыы	disease
ыарыылар	diseases
кистэбил	disguise
быдьар	disgusting
иһит	dish
иһиттэр	dishes
тарҕат	dismiss
ыыт	dispatch
көрдөр	display
ыраастааһын	disposal
мөккүөр	dispute
ыраах	distance
ырылхай	distinct
араар	distinguish
үлүгэр	distress
түҥэтии	distribution
оройуон	district
мэһэйдээ	disturb
хаспах	ditch
умсун	dive
араас	diverse
эгэлгэ	diversity
араар	divide
айыы	divine
арахсыы	divorce
араҕыс	divorce
мэйии эргийэр	dizzy
оҥор	do
эн	do you
эн миигин таптыыгын дуо	do you love me
эмчит	doctor
докумуон	document
гынар	does
ыт	dog
Догри	Dogri
гын	doing
куукула	doll
домен	domain
дьиэтээҕи	domestic
баһылыыр	dominant
Кыһаллыма	Don't worry
сиэртибэлээ	donate
оҥоһуллубут	done
осел	donkey
наркотик	dope
икки төгүл улаатыннар	double
атыылыы киһи	double
саарбаҕалаа	doubt
саарбаҕалааһын	doubt
тиэстэ	dough
аллараа	down
хачайдаа	download
черновик	draft
ойуулаа	draft
тарт	drag
хатар	drain
драма	drama
ойуулаа	draw
хомуот	drawer
уруһуй	drawing
куттал	dread
түүл	dream
түһээ	dream
былаачча	dress
үүттээ	drill
утах	drink
ис	drink
ыыт	drive
таммах	drop
охтор	drop
түүһэрдэ	dropped
кураанах	drought
итирик	drunk
кураанах	dry
кус	duck
нохоо	dude
иһин	due
сылтаан	due to
аҥала	dull
аҥала	dumb
сыбаалка	dump
салгыыта	duration
саҕана	during
быыл	dust
эбээһиннэс	duty
олохсуй	dwell
өлүү	dying
хас биирдии	each
бэйэ бэйэни	each other
күүскэ баҕар	eager
хотой	eagle
кулгаах	ear
эрдэ соҕус	earlier
эрдэ	early
үлэлээн ыл	earn
кулгаахтар	ears
сир	earth
сир хамсааһына	earthquake
чэпчэт	ease
чэпчэкитик	easily
илин	east
чэпчэки	easy
сиэ	eat
аһаа	eating
экономическай	economic
экономия	economy
муннук	edge
көннөр	edit
үөрэх	education
эффект	effect
көдьүүстээх	effective
эффективность	efficiency
көдьүүстээх	efficient
кыһамньы	effort
сымыыт	egg
баклажан	eggplant
бэйэ	ego
аҕыс	eight
уон аҕыс	eighteen
аҕыс уон	eighty
хайата да	either
оҥор	elaborate
тоҥолох	elbow
улахан	elder
кырдьаҕас	elderly
мааны	elegant
элемент	element
слон	elephant
уон биир	eleven
бырааптаах	eligible
суох гыныы	eliminate
өссө	else
кыбыстыбыт	embarrassed
кыбыһыннарар	embarrassing
куус	embrace
үөскээ	emerge
суһал	emergency
эмоциональнай	emotional
аһыныгас буолуу	empathy
болҕомто	emphasis
бэлиэтээ	emphasize
үлэһит	employee
үлэһиттэр	employees
үлэни бирээччи	employer
үлэ	employment
ичитэх	empty
холбоо	enable
хабырыйыс	encounter
биһирэбил	encourage
бүтүү	end
сүтэн эрэр	endangered
кыһаллыы	endeavor
тулуйуу	endurance
тулуй	endure
өстөөх	enemy
энергия	energy
тарт	engage
кэргэн кэпсэппит	engaged
холбоhуу	engagement
мотор	engine
инженер	engineer
Ааҥгыл	English
күүһүрт	enhance
астын	enjoy
баараҕай	enormous
түксү	enough
хааччый	ensure
киир	enter
аралдьыйыы	entertainment
энтузиазм	enthusiasm
күүрээннээх	enthusiastic
бүтүн	entire
боломуочунай	entitled
айылҕа	entity
киирии	entrance
урбаанньыт	entrepreneur
конверт	envelope
тулалыыр эйгэ	environment
ымсыыр	envy
эпическэй	epic
эпидемия	epidemic
тэҥ	equal
тэрил	equipment
кырдьык	equity
тэҥнээх	equivalent
сотор	eraser
сыыһа	error
куот	escape
ордук	especially
эссе	essay
айылҕа	essence
сүрүн	essential
төрүттээ	establish
тэрийбит	established
үп-мал	estate
сыаналаа	estimate
барыллааһын	estimated
уо.д.а.	etc
мэҥэ	eternal
этика	ethics
сыаналаа	evaluate
сыанабыл	evaluation
бэл	even
даҕаны	even though
киэһээ	evening
түбэлтэ	event
кэмниэ кэнэҕэс	eventually
хаһан эмэ	ever
хас биирдии	every
бары	everybody
бары	everyone
барыта	everything
туоһу	evidence
куһаҕан	evil
эволюция	evolution
сайын	evolve
Эве	Ewe
урукку	ex
чопчу	exact
адьас	exactly
экзээмэн	exam
бэрэбиэркэ	examine
холобур	example
баһый	exceed
бэртээхэй	excellent
ураты	except
туорааһын	exception
дэлэйии	excess
ордук	excessive
уларытыы	exchange
долгуйбут	excited
долгуйуу	excitement
долгутуулах	exciting
эксклюзивнай	exclusive
бырастыы гын	excuse
алҕас	excuse me
толор	execute
өлөрүү	execution
ситэриилээх	executive
эрчиллии	exercise
эрчилл	exercise
сылай	exhaust
сылайбыт	exhausted
быыстапка	exhibit
быыстапка	exhibition
баар	exist
баар буолуу	existence
баар	existing
тахсыы	exit
улаатыннар	expand
күүт	expect
күүтүллүбүт	expected
ороскуоттар	expenses
ыарахан	expensive
бил	experience
үөрүйэх	experience
эксперимент	experiment
эксперт	expert
соруога ааспыт	expired
быһаар	explain
быһаарыы	explanation
көлөһүннээ	exploit
чинчий	explore
экспорт	export
көрдөр	expose
көстүбүт	exposed
сабыдыал	exposure
быһаар	express
этии	expression
улаатыыннар	extend
кэҥэтиллибит	extended
кэҥэтии	extension
улаа	extent
тас	external
өлөн быстыы	extinct
элбэх	extra
сүмэ	extract
уһулуччулаах	extraordinary
сүрдээх	extreme
сүрдээх	extremely
харах	eye
харахтар	eyes
таҥас	fabric
сөҕүмэр	fabulous
көрсүс	face
сирэй	face
көмөлөс	facilitate
тэриллэр	facilities
объект	facility
факт	fact
фактор	factor
собуот	factory
фактар	facts
өлбөөр	fade
сатаныма	fail
сатанымыы	fail
сатамматах	failed
сатанымыы	failure
мөлтөх	faint
чиэһинэй	fair
сырдык	fair
чиэһинэйдик	fairly
фея	fairy
итэҕэл	faith
эрэллээх	faithful
сымыйа	fake
күһүн	fall
оҕут	fall
сымыйа	false
аатырыы	fame
билэр	familiar
дьиэ кэргэн	family
аччыктааһын	famine
биллиилээх	famous
фанат	fan
фэн	fan
силээхтэ	fancy
дьиктилээх	fantastic
ыраах	far
быраһаайдаһыы	farewell
ферма	farm
фермер	farmer
абылыыр	fascinating
муода	fashion
түргэн	fast
эмис	fat
төлөрүйбэт	fatal
дьылҕа	fate
аҕа	father
сылайыы	fatigue
буруй	fault
сөбүлүүр	favorite
өҥө	favour
сөбүлүүр	favourite
куттан	fear
куттал	fear
малааһын	feast
түү	feather
уруһуйдаа	feature
ураты	feature
быһыылар	features
олунньу	february
тот	fed up
төлөбүр	fee
аһат	feed
сыанабыл	feedback
бил	feel
билии	feeling
атах	feet
оҕутта	fell
атас	fellow
биллэ	felt
дьахтар	female
күрүө	fence
үүнүүлээх	fertile
фестиваль	festival
аҕал	fetch
тымныйыы	fever
аҕыйах	few
аҕыйах	fewer
күтүөт	fiance
фикция	fiction
хонуу	field
кыырыктаах	fierce
уон биэс	fifteen
биэс уон	fifty
охсус	fight
охсуһуу	fight
охсуһуу	fighting
фигура	figure
толкуйдаа	figure
толкуйдаа	figure out
файл	file
толор	fill
толоруллубут	filled
киинэ	film
кирдээх	filthy
дьэ хата	finally
үп-харчы	finance
үп	financial
бул	find
билии	find out
үчүгэй	fine
штраф	fine
тарбах	finger
бүтүү	finish
бүтэрбит	finished
уот	fire
фирма	firm
кытаанах	firm
бастакы	first
аат	first name
балык	fish
бат	fit
биэс	five
көннөр	fix
көннөрүллүбүт	fixed
былаах	flag
сырдык	flash
квартира	flat
хаптаҕай	flat
итэҕэс	flaw
эҥкилэ суох	flawless
куот	flee
эт	flesh
көттө	flew
токурут	flex
хомоҕой	flexible
көтүү	flight
бырах	flip
эрийсэр	flirt
эрийсии	flirting
уһун	float
халаан	flood
этээс	floor
бурдук	flour
сүүрүк	flow
сүүр	flow
сибэкки	flower
тымныйыы	flu
түргэн	fluent
түргэнник	fluently
көп	fluffy
убаҕас	fluid
сахсырҕа	fly
сомоҕолоо	focus
болҕомто	focus
туман	fog
туманнаах	foggy
бүк тут	fold
доҕоттор	folks
батыс	follow
батыс	follow up
нөҥүө	following
ас	food
акаары	fool
албыннаа	fool
акаары	foolish
атах	foot
футбол	football
туһугар	for
Холобур	For example
холобур	for instance
эйиэхэ	for you
бобуулаах	forbidden
күүс	force
билгэлээһин	forecast
сүүс	forehead
тас дойду	foreign
тыа	forest
куруутун	forever
умун	forget
бырастыы гын	forgive
умнубут	forgot
биилкэ	fork
форма	form
формальнай	formal
урукку	former
хата	fortunately
табыллыы	fortune
түөрт уон	forty
түөрт уон икки	forty-two
иннигэр	forward
иит	foster
охсуспут	fought
булла	found
оломто	foundation
түөрт	four
уон түөрт	fourteen
саһыл	fox
үлтүркэй	fragile
рамка	frame
араамка	framework
албыннааһын	fraud
дьиибэ киһи	freak
босхо	free
көҥүл	freedom
тоҥор	freeze
түргэнэ	frequency
субул	frequent
субу-субу	frequently
сибиэһэй	fresh
бээтинсэ	friday
холодильник	fridge
доҕор	friend
доҕордуҥу	friendly
доҕоттор	friends
доҕордоһуу	friendship
куттаммыт	frightened
кутталлаах	frightening
баҕа	frog
шрифт	front
тоҥ	frozen
фрукта	fruit
санаата алдьаммыт	frustrated
оттук	fuel
Фулфулде	Fulfulde
толору	full
көрдөөх	fun
функция	function
сүрүн	fundamental
киһини көмүү	funeral
көрүдьүөс	funny
түү	fur
уордаах	furious
миэбэл	furniture
сиһилии	further
ону таһынан	furthermore
кэскил	future
ыл	gain
оонньуу	game
быыс	gap
гараж	garage
бөх	garbage
саат	garden
чочунаах	garlic
олбуор аан	gate
илбээ	gather
мустуһуу	gathering
кэмнээ	gauge
биэрдэ	gave
тэрил	gear
эр киһитэ-дьахтара	gender
уопсай	general
уопсайынан	generally
оҥорон таһаар	generate
удьуор	generation
дьэллэм	generous
гений	genius
жанр	genre
сымнаҕас	gentle
дьиҥнээх	genuine
быһыы	gesture
ыл	get
таҥын	get dressed
тур	get up
түргэнник үтүөр	get well soon
ылыы	getting
абааһы	ghost
сибиэн	ghosting
бөдөҥ	giant
бэлэх	gift
кугас	ginger
кыыс	girl
кыыс	girlfriend
биэр	give
бэрин	give up
биэриллибит	given
үөрбүт	glad
көрөн аһарыы	glance
өстүөкүлэ	glass
ачыкы	glasses
көрөн аһарыы	glimpse
аан дойду	global
мунчаарбыт	gloomy
бэрчээккэлэр	gloves
сырдаа	glow
сырдааһын	glow
сырдаа	glow up
килиэй	glue
бар	go
чэ эрэ	go ahead
бар	go away
утуй	go to bed
сорук	goal
сыаллар	goals
козел	goat
таҥара	god
таҥара алҕаатын	god bless you
барар	goes
бар	going
көмүс	gold
барбыт	gone
гынар	gonna
үтүө	good
үчүгэй	good
үтүө күнүнэн	good afternoon
көрсүөххэ диэри	good bye
үчүгэй күн	good day
үтүө киэһэнэн	good evening
маладьыас	good job
үчүгэйкээн	good looking
ситиһиини баҕарабын	good luck
үтүө сарсыарданнан	good morning
үтүө сарсыарданан, тапталым	good morning my love
үтүө түүнүнэн	good night
көрсүөххэ диэри	goodbye
үтүө түүнүнэн	goodnight
табаардар	goods
Гуугл	Google
Гугл Тылбаасчыт	Google Translate
хаас	goose
олус кэрэ	gorgeous
хоп	gossip
ылла	got
өйдөөтүм	got it
бырабыытылстыба	government
тарт	grab
сыана	grade
улам	gradually
бүтэр	graduate
бурдук	grain
биэр	grant
бэриллибит	granted
виноград	grapes
өйдөө	grasp
от	grass
махталлаах	grateful
махтаныы	gratitude
иин	grave
бороҥ	gray
улахан	great
ымсыы	greed
харааҥкы	greedy
от күөх	green
дорооболос	greet
дорооболоһуу	greeting
дорооболоһуу	greetings
бороҥ	grey
кыра илим	grid
кутурҕан	grief
кээмэй	grind
тутус	grip
ас маҕаһыына	grocery
күтүөт	groom
дьаабы	gross
сир	ground
бөлөх	group
улаат	grow
улаатыы	growth
дьаҥса	grumpy
Гуарани	Guarani
гарантия	guarantee
харабыл	guard
таай	guess
ыалдьыт	guest
салайыы	guidance
сирдьиттээ	guide
сирдьит	guide
буруйдаах	guilty
уол	guy
уолаттар	guys
спортзал	gym
идэ	habit
олорор эйгэтэ	habitat
баар этэ	had
тобурах	hail
баттах	hair
аҥаар	half
саала	hall
илии	hand
толор	handle
кыраһыабай	handsome
ыйаа	hang
күүлэйдээ	hang out
буол	happen
буолбут	happened
дьол	happiness
дьоллоох	happy
төрөөбүт күҥҥүнэн	happy birthday
төрөөбүт күҥҥүнэн	happy birthday to you
саҥа дьылынан	happy new year
ыарахан	hard
нэһиилэ	hardly
хаһан эмэ	hardly ever
буорту	harm
буортулаа	harm
буортулаах	harmful
гармония	harmony
кытаанах	harsh
үүнүү	harvest
баар	has
абаары көрүү	hate
баар	have
үчүгэй күн буоллун	have a good day
үчүгэй күн аастын	have a nice day
сарсыардааҥҥы аһы сиэ	have breakfast
көрүлээ	have fun
аһаатыҥ дуо	have you eaten
баар	having
куттал	hazard
туман	haze
кини	he
киниэхэ баар	he has
кини	he is
төбө	head
төбө ыарыыта	headache
эмтээ	heal
эмтэнии	healing
доруобуйа	health
чэбдик	healthy
иһит	hear
иһиттэ	heard
сүрэх	heart
итит	heat
итии	heat
халлаан	heaven
ыар	heavy
айдааннаах	hectic
үрдүк	height
нэһилиэнньик	heir
халабыр	heist
тэрий	held
аат	hell
Эҕэрдэ	Hello
дорообо күндү	hello dear
дорообо хайдаххыный	hello how are you
дорообо хайдаххыный	hello how are you doing
шлем	helmet
көмө	help
туһалаах	helpful
онон	hence
киниэнэ	her
үөр	herd
манна	here
нэсилиэстибэ	heritage
саарбаҕалаа	hesitate
Ээ	Hey
Эҕэрдэ	Hi
дорообо хайдаххыный	hi how are you
Дорообо	Hi there
кистэлэҥ	hidden
сас	hide
иерархия	hierarchy
үрдүк	high
бэлиэтээ	highlight
хаамыы	hike
хаамыы	hiking
күлүүлээх	hilarious
томтор	hill
кинини	him
таайтар	hint
буут	hip
буутта	hips
үлэҕэ ыл	hire
үлэҕэ ылыы	hiring
киниэнэ	his
история	history
оҕус	hit
Хм	Hmm
хобби	hobby
тут	hold
кэтэс	hold on
хайаҕас	hole
бырааһынньык	holiday
ичитэх	hollow
дьиэ	home
дьиэ үлэтэ	homework
чиэһинэй	honest
кырдьыгынан эттэххэ	honestly
мүөт	Honey
күндү	Honey
чиэс	honor
үлдьү бэргэһэ	hood
дэгиэ	hook
ыстан	hop
эрэл	hope
эрэн	hope
диэн эрэнэбин	hopefully
эрэлэх суох	hopeless
сытыары	horizontal
муос	horn
дьаабы	horrible
хоррор	horror
ат	horse
балыыһа	hospital
ыалдьытымсах быһыы	hospitality
хаһаайын	host
өстөөх	hostile
итии	hot
отель	hotel
чаас	hour
чаас	hours
дьиэ	house
дьиэ хаһаайыстыбата	household
хайдах	how
оттон эн	how about you
хайдаххыный	how are you
хайдаххыный	how are you doing
бүгүн тугу гынаҕын	how are you doing today
бүгүн хайдаххыный	how are you today
хайдаххыный	how do you do
хайдаҕый	how is
хас	how many
хас	how much
хаста	how often
хас саастааххыный	how old are you
күнүҥ хайдах ааста	how was your day
түүнүҥ хайдах ааста	how was your night
ол гынан баран	however
киин	hub
оҕонньор	hubby
куустуһуу	hug
куус	hug
сүдү	huge
киһи	human
сэмэй	humble
сииктээх	humid
сииктээҕэ	humidity
сүүс	hundred
аччык	hungry
булт	hunt
ураган	hurricane
ыксаа	hurry
ыксаа	hurry up
атаҕастаа	hurt
эр	husband
түбүгүр	hustle
үүтээн	hut
ыраас буолуу	hygiene
Мин	I
Мин	I am
Мин аҕайбын	I am fine
Сатаабаппын	I can't
Мин гынабын	I do
Билбэппин	I do not know
Мин өйдөөбөппүн	I do not understand
Мин	I don't
Билбэппин	I don't know
Өйдөөбөтүм	I don't understand
Тугу этэргин өйдөөбөппүн	I don't understand what you mean
Мин эйиигин өйдөөбөппүн	I don't understand you
Билбэппин	I don’t know
Өйдөөбөтүм	I don’t understand
дии саныыбын	i guess
Миэхэ баар этэ	I had
миэхэ баар	I have
Мин баар буолбутум	I have been
Оннук диэн эрэнэбин	I hope so
Билэбин	I know
Мин сөбүлүүбүн	I like
Мин эйиигин сөбүлүүбүн	I like you
Мин таптыыбын	I love
мин убайбын таптыыбын	I love my big brother
мин эдьиийбин таптыыбын	I love my big sister
мин аҕабын таптыыбын	I love my father
мин инибин таптыыбын	I love my little brother
мин балтыбын таптыыбын	I love my little sister
мин ийэбин таптыыбын	I love my mother
Мин эйигин таптыыбын	I love you
Мин эйиигин олус да күүскэ таптыыбын	I love you so much
Мин эйиигин эмиэ таптыыбын	I love you too
диибин	I mean
Мин эйиигин ахтабын	I miss you
Мин эйиигин олус да ахтабын	I miss you so much
Өйдөөтүм	I see
Дии саныыбын	I think
Мин өйдүүбүн	I understand
баҕарабын	I want
Мин эйиигин көрүөхпүн баҕарабын	I want to see you
мин эйиигин баҕарабын	I want you
Мин	I'm
Мин үчүгэйбин	I'm fine
Мин аҕайбын	I'm good
Мин манна баарбын	I'm here
Алҕас	I'm sorry
муус	ice
мороженай	ice cream
идея	idea
эҥкилэ суох	ideal
биир	identical
бил	identify
личность	identity
акаары	idiot
көлчүүр	idle
өскөтүн	if
ахсарыма	ignore
ыалдьар	ill
сокуона суох	illegal
ыарыы	illness
Илокано	Ilocano
ойуу	image
санаан көр	imagine
түргэн	immediate
субу	immediately
баараҕай	immense
сабыдыаллаа	impact
сабыдыал	impact
тулуура суох	impatient
олохтоо	implement
импорт	import
тиэй	import
дьоһуннаах	important
сыҥалаа	impose
сатаммат	impossible
ымытыннар	impress
санаа	impression
кэрэхсэбиллээх	impressive
тупсар	improve
тупсарыы	improvement
иһигэр	in
эбиитинэн	in addition
Дьиҥинэн	In fact
иннигэр	in front of
ол туһугар	in order to
сүөргү	inappropriate
стимул	incentive
түбэлтэ	incident
киллэр	include
кытта	including
дохуот	income
табыгаһа суох	inconvenience
улаатыы	increase
улаатыннар	increase
улааппыт	increased
сөҕүмэр	incredible
чахчы	indeed
тутулуга суох	independent
Индия	India
ый	indicate
төрүт	indigenous
түө	individual
индустрия	industry
мүлчүрүйбэт	inevitable
кыһыл оҕо	infant
инфекция	infection
муҥура суох	infinity
сүһүрүү	inflammation
инфляция	inflation
сабыдыаллаа	influence
сабыдыал	influence
биллэр	inform
информация	information
ингредиеннар	ingredients
нэһилиэстибэ	inheritance
саҕаланыы	initial
инициатива	initiative
оһолломмут	injured
оһол	injury
буруйа суох	innocent
инновация	innovation
ирдээн көрүү	inquiry
иирбит	insane
үөн-көйүүр	insect
эрэлэ суох	insecure
ук	insert
иһигэр	inside
өйдөөһүн	insight
модьуй	insist
утуйбат буолуу	insomnia
күүрээн	inspiration
көҕүлээ	inspire
туруор	install
холобур	instance
түргэн	instant
оннугар	instead
оннугар	instead of
инструкция	instructions
тэрил	instrument
үөҕүү	insult
страховка	insurance
тыытыллыбатах	intact
чиэһинэй буолуу	integrity
өйдөөх	intellectual
өй	intelligence
өйдөөх	intelligent
баҕар	intend
санаммыт	intended
тэтимнээх	intense
сорунуу	intention
хардарыта дьайсыс	interact
дьайсыы	interaction
кэрэхсэбил	interest
кэрэхсэбиллиир	interested
кэрэхсэбиллээх	interesting
дьүккүс	interfere
орто	intermediate
иһинээҕи	internal
норуоттар икки ардынааҕы	international
практика	internship
тылбаастаа	interpret
тылбаасчыт	interpreter
быс	interrupt
интервью	interview
чугас	intimate
иһигэр	into
билиһиннэр	introduce
киллэрии	introduction
интроверт	introvert
интуиция	intuition
сыыһа	invalid
ай	invent
инвентарь	inventory
ук	invest
силиэстийэлээ	investigate
ыҥырыы	invitation
ыҥыр	invite
усчуот	invoice
усчуоту биэр	invoice
кытыар	involve
кыттыбыт	involved
тимир	iron
үтүүктээ	iron
буол	is
арыы	island
соҕотох	isolated
таһаар	issue
боппуруос	issue
боппуруостар	issues
бу	it
бу	it is
буолбута	it was
барыта үчүгэй	it's ok
Кыһанымаҥ	It's okay
мал	item
предметтэр	items
киниэнэ	its
Мин	I’m
кууртка	jacket
хаайыы	jail
Тохсунньу	January
баанка	jar
сыҥаах	jaw
күнүүһүт	jealous
обургу	jerk
ювелирнай оҥоһуктар	jewelry
үлэ	job
сүүрүү	jogging
кыттыс	join
сүһүөх	joint
дьээбэ	joke
журналист	journalist
айан	journey
үөрүү	joy
судьуйа	judge
дьүүллээ	judge
сок	juice
от ыйа	july
ыстан	jump
бэс ыйа	june
бөх	junk
кырдьыктаах	just
эрэ	just
ону оҥорон кэбис	just do it
кырдьык	justice
көмүскээ	justify
Калааллисут	Kalaallisut
умсугуй	keen
тут	keep
салгыы тур	keep it up
туппут	kept
чаанньык	kettle
күлүүс	key
тэп	kick
оҕо	kid
оонньоон этии	kidding
бүөр	kidney
оҕолор	kids
өлөр	kill
амарах	kind
курдук	kinda
үтүөтүк	kindly
үтүө	kindness
ыраахтааҕы	king
уураһыы	kiss
куухунньа	kitchen
көтөр моҕой	kite
куоска оҕото	kitten
тобук	knee
билбит	knew
быһах	knife
боотур	knight
бил	know
билии	knowledge
биллэр	known
Конкани	Konkani
Крио	Krio
этикетка	label
үлэ	labor
үлэ	labour
итэҕэс	lack
кирилиэс	ladder
дьахтар	lady
ууруллубут	laid
күөл	lake
хой оҕото	lamb
доҕолоҥ	lame
лаампа	lamp
түс	land
сир	land
пейзаж	landscape
тыл	language
тобук	lap
улахан	large
бүтэһик	last
бүтэһик да буоллар дьоһуннаах	last but not least
араспаанньа	last name
хойут	late
соторутааҕыта	lately
хойут	later
бүтэһик	latest
тиһэх	latter
күл	laugh
күлүү	laughing
күлүү	laughter
холбоо	launch
таҥас сууйуу	laundry
ыйаах	law
түөлбэ	lawn
юрист	lawyer
уур	lay
араҥа	layer
макет	layout
сүрэҕэ суох	lazy
сирдээ	lead
басхан	leader
сэбирдэх	leaf
тохтуу	leak
өйөн	lean
ыстан	leap
үөрэт	learn
үөрэнии	learning
куортамнас	lease
саамай аҕыйах	least
тирии	leather
хааллар	leave
уоппуска	leave
сэбирдэхтэр	leaves
сирдээ	led
хаҥас	left
атах	leg
нэһилиэстибэ	legacy
сокуоннай	legal
номох	legend
сокуоннай	legit
иллэҥ кэм	leisure
уларыс	lend
уһун	length
аҕыйах	less
уруок	lesson
көҥүллээ	let
сурук	letter
салат	lettuce
таһым	level
төһүү	leverage
эппиэтинэс	liability
библиотека	library
салаа	lick
сымыйалаа	lie
сымыйа	lie
сымыйалар	lies
олох	life
көтөҕүү	lift
көтөх	lift
сырдат	light
сырдык	light
чаҕылҕан	lightning
сөбүлээ	like
курдук	likely
эмиэ	likewise
линия	line
Лингала	Lingala
сыылка	link
хахай	lion
убаҕас	liquid
испиэһэк	list
иһит	listen
истии	listening
тылыттан тылыгар	literally
литэрэтиирэ	literature
сыыс	litter
кыра	little
олор	live
тыыннаах	live
бүөр	liver
олохтор	lives
олоруу	living
ыалдьыт хоһо	living room
ящерица	lizard
толор	load
уххан	loaf
иэс	loan
маннааҕы	local
миэстэ	location
хаай	lock
локдаун	lockdown
дүлүҥ	log
быара суох	lol
соҕотох	lonely
уһун	long
көрсүбэтэх ыраатта	long time no see
көр	look
көстүү	look
туһах	loop
көҥүл	loose
ыыт	loose
тойон	lord
сүтэр	lose
сүтэрии	loss
сүппүт	lost
элбэх	lot
улаханнык	loud
лаундж	lounge
таптал	love
таптаа	love
таптыыбын эйиигин	love you
үчүгэйкээн	lovely
намыһах	low
аллараа	lower
бэриниилээх	loyal
бэринии	loyalty
табыллыы	luck
соргулаах	lucky
Луганда	Luganda
таһаҕас	luggage
кырбас	lump
күнүскү ас	lunch
тыҥа	lungs
дэлэй	luxury
сытар	lying
массыына	machine
иирбит	mad
хотун	madam
оҥоһуллубут	made
сурунаал	magazine
үтүөкэн	magnificent
хамначчыт кыыс	maid
сүрүн	main
өйөө	maintain
үлэлэтии	maintenance
Майтхили	Maithili
мэр	major
сүрүн	major
үгүс өттө	majority
гын	make
толкуйдаа	make up
эр	male
эргиэн киинэ	mall
киһи	man
салай	manage
салайыы	management
салайааччы	manager
болгуччулаах	mandatory
манифест	manifest
манипуляциялаа	manipulate
майгы	manner
илииннэн	manual
элбэх	many
бу күн элбэх дьолу аҕаллын	many many happy returns of the day
марш	march
кытыы	margin
ырыынак	market
кэргэн	marriage
кэргэннээх	married
мааска	mask
масса	mass
массивнай	massive
тойон	master
испиискэ	match
сөп түбэс	match
атас	mate
матырыйаал	material
математика	math
суолтата баар	matter
дьыала	matter
ситии	maturity
ыам ыйа	may
баҕар	maybe
миэхэ	me
мин эмиэ	me too
ас	meal
орто	mean
көрдөр	mean
суолта	meaning
ньымалар	means
бэлиэтээтэ	meant
ол кэмҥэ	meanwhile
кээмэй	measure
кээмэйдэр	measures
эт	meat
медицинскэй	medical
эмп	medicine
медитация	meditation
орто	medium
көрүс	meet
мунньах	meeting
Мейтейлон	Meiteilon
ууллар	melt
ахтыылар	memories
өй	memory
өй-санаа	mental
санат	mention
санатыллыбыт	mentioned
үөрэтээччи	mentor
урбаанньыт	merchant
аһыныы	mercy
көннөрү	merely
ороһуоспанан	merry christmas
бэрээдэк суоҕа	mess
сурук	message
дьабара	messy
металл	metal
ньыма	method
кутуйахтар	mice
орто	middle
түүн ортото	midnight
күүстээх	might
сымнаҕас	mild
миэтэ	milestone
байыаннай	military
үүт	milk
мөлүйүөн	million
өй	mind
утарар	mind
өй-санаа	mindset
миэнэ	mine
шахта	mine
булкулун	mingle
кыра	minor
мүнүүтэ	minute
мүнүүтэлэр	minutes
дьикти	miracle
сиэркилэ	mirror
эҥин араас	miscellaneous
дьээбэлээх	mischievous
киһи көрө аһыныах	miserable
эрэй	misery
аҕын	miss
ахтабын эйиигин	miss you
көтүллүбүт	missing
сорудах	mission
туман	mist
сыыһа	mistake
Мизо	Mizo
мобильнай	mobile
күлүү гын	mock
модель	model
аҕырат	moderate
сымнаһыар	moderate
билиҥҥи	modern
сэмэй	modest
сииктээх	moist
сиик	moisture
түүнүк	mold
түүнүгүр	mold
крот	mole
ийэ	mom
түгэн	moment
бэнидиэнник	monday
харчы	money
монитор	monitor
эбисийээнэ	monkey
ый	month
уйулҕа	mood
атаах	moody
ыйдаҥа	moon
моральнай	moral
өссө	more
ону таһынан	moreover
сарсыарда	morning
ипотека	mortgage
саамай	most
сүнньүнэн	mostly
ийэ	mother
хамнаныы	motion
мотивация	motivation
хайа	mountain
кутуйах	mouse
айах	mouth
хамнаа	move
хамсааһын	movement
киинэ	movie
миссис	mrs
элбэх	much
чалбах	mud
чааскы	mug
былчыҥ	muscle
түмэл	museum
тэллэй	mushroom
музыка	music
таах	must
тыла суох	mute
хардарыта	mutual
миэнэ	my
Күндү	My dear
доҕорум	my friend
Мин вертолеппар угорь толору	My hovercraft is full of eels
мин тапталым	my love
мин аатым	my name is
үөрүүнү кытта	my pleasure
бэйэм	myself
биллибэт	mysterious
кистэлэҥ	mystery
номох	myth
тоһоҕо	nail
кэнэн	naive
аат	name
кэпсээн	narrative
кыараҕас	narrow
сидьиҥ	nasty
национальнай	national
омук	nationality
төрүт	native
айылҕа	natural
айылҕа	nature
хотуо	nausea
чугас	near
чугас	nearby
сыһа	nearly
сэбэр	neat
наадалаах	necessary
моойун	neck
оҕуруо симэх	necklace
наадый	need
наада	need
негативнай	negative
аахайыма	neglect
кэпсэтии	negotiate
дьукаах	neighbor
ыаллаһыы	neighborhood
ханнык да	neither
быраат	nephew
ботаник	nerd
ниэрбинэй	nervous
уйа	nest
ситим	net
ситим	network
нейтральнай	neutral
хаһан да	never
хаһан да бэринимэ	never give up
кыһаныма	never mind
кыһаныма	nevermind
ол да буоллар	nevertheless
саҥа	new
сонун	news
аныгыскы	next
кэккэлэһэ	next to
үчүгэй	nice
билсиспиппиттэн үөрэбин	nice to meet you
балыс	niece
түүн	night
баттатыы	nightmare
тоҕус	nine
уон тоҕус	nineteen
тоҕус уон	ninety
Суох	No
проблемата суох	no problem
буолбат	no way
ким да буолбатах	nobody
тыас	noise
тыастаах	noisy
суох	none
күн ортото	noon
суох	nope
сөптөөх	normal
хоту	north
мурун	nose
ностальгическэй	nostalgic
буолбатах	not
оннук буолбатах	not at all
куһаҕана суох	not bad
Билигин буолбатах	Not now
илик	not yet
бэлиэ	note
бэлиэтэммит	noted
туох да суох	nothing
бэлиэтээ	notice
бэлиэтэннэ	noticed
туохтуур	noun
аат тыллар	nouns
ырамаан	novel
сэтинньи	november
билигин	now
билигин	nowadays
мачай	nuisance
нуул	null
дүлэй	numb
нүөмэр	number
медсиэстирэ	nurse
эриэхэ	nut
мускат эриэхэтэ	nutmeg
аһылык	nutrition
андаҕар	oath
уойуу	obesity
иһит	obey
предмет	object
объективнай	objective
эбэһээтилистибэтэ	obligation
бүдүк-бадык	obscure
кэтээһин	observation
көр	observe
иирбит	obsessed
ылларыы	obsession
эргэрбит	obsolete
мэһэй	obstacle
ыл	obtain
ылбыт	obtained
илэ	obvious
мөккүөрэ суох	obviously
дэҥҥэ	occasionally
идэ	occupation
иллэҥэ суох	occupied
буол	occur
буолбут	occurred
буолар	occurs
акыйаан	ocean
алтынньы	october
дьикти	odd
кыах	odds
биллэн турар	of course
арахсыбыт	off
кырыктаах	offensive
этии	offer
этии киллэр	offer
офис	office
официальнай	official
субул	often
Оо	Oh
ээ кырдьык дуо	oh really
арыы	oil
сөп	ok
сөп, сэгэриэм	ok dear
сөп сэгэриэм	ok honey
сөп тапталым	ok my love
үчүгэй	okay
сөп чыычаах	okay baby
сөп сэгэриэм	okay dear
сөп чыычаах	okay honey
сөп тапталым	okay my love
эргэ	old
үрдүгэр	on
биирдэ	once
биир	one
биир тыл хаһан да тиийбэт	one language is never enough
лук	onion
онлайн	online
эрэ	only
аһаҕас	open
операция	operation
санаа	opinion
тоҕоостор	opportunities
кыах	opportunity
утары	opposite
оптимистичнай	optimistic
талыы	option
талыахха син	optional
эбэтэр	or
апельсин	orange
сырдык саарыл	orange
сакаастаа	order
бирикээс	order
көннөрү	ordinary
тэрилтэ	organization
ориентация	orientation
төрүт	origin
дьиҥнээх	original
Оромо	Oromo
тулаайах	orphan
атын	other
эбэтэр	otherwise
хайыахтаах	ought
биһиэнэ	our
Биһиги миссиябыт: ханна баҕарар, хас биирдии киһиэхэ аан дойдуну өйдүүр уонна тыл нөҥүө бэйэлэрин быһаарар кыаҕы биэрии.	Our mission: to enable everyone, everywhere to understand the world and express themselves across languages.
Биһиги миссиябыт: аан дойду информациятын тэрийии уонна ону барыларыгар тоҕоостоох уонна туһалаах оҥоруу.	Our mission: to organize the world's information and make it universally accessible and useful.
таһыгар	out
түмүк	outcome
таҥас	outfit
билиҥҥи	outgoing
тахсыы	outlet
контур	outline
тас	outside
уһулуччулаах	outstanding
оһох	oven
быһа	over
онно	over there
уопсай	overall
кыай	overcome
наһаа элбэҕи санааһын	overthinking
туолбут	overwhelmed
хам баттыыр	overwhelming
иэстээх буол	owe
мэкчиргэ	owl
бэйэ киэнэ	own
лаах буол	own
хаһаайын	owner
оҕус	ox
тэтим	pace
ук	pack
суу	package
төлөөтө	paid
ыарыы	pain
ойуулаа	paint
ойуу	painting
икки	pair
кубархай	pale
ытыс	palm
хобордоох	pan
пандемия	pandemic
айманыы	panic
ыстаан	pants
кумааҕы	paper
ырай	paradise
параллельнай	parallel
баһыылка	parcel
бырастыы гыныы	pardon
төрөппүттэр	parents
паарка	park
попугай	parrot
петрушка	parsley
чаас	part
кытын	participate
ураты	particular
чуолаан	particularly
кыттыгас	partner
бэчэриинкэ	party
аас	pass
ааһыы	passage
ааста	passed
үлүһүйүү	passion
имэҥнээх	passionate
пассивнай	passive
пароль	password
урукку	past
былаастыр	patch
суол	path
буорайбыт	pathetic
тулуур	patience
тулуурдаах	patient
эмтэнээччи	patient
шаблон	pattern
тохтобул	pause
тротуар	pavement
төлөө	pay
төлөбүр	payment
эйэ	peace
эйэлээх	peaceful
персик	peach
чыпчаал	peak
груша	pear
горох	peas
ураты	peculiar
ииктээ	pee
иик	pee
ыраастаа	peel
биир саастыылаах	peer
биир саастыылаахтар	peers
уруучука	pen
харандаас	pencil
күүтүү	pending
дьон	people
перец	pepper
ылын	perceive
ылыныы	perception
эҥкилэ суох	perfect
толор	perform
толоруу	performance
баҕар да	perhaps
кэм	period
олохтоох	permanent
көҥүл	permission
көҥүл	permit
дьаныар	perseverance
дьаныардаах	persistent
киһи	person
тус	personal
личность	personality
кэскил	perspective
итэҕэт	persuade
дьиэтээҕи харамай	pet
фаза	phase
көстүү	phenomenon
философия	philosophy
телефон	phone
хаартыска	photo
этии	phrase
эт-хаан	physical
тал	pick
ыл	pick up
ойуу	picture
быһыы	piece
кырбастар	pieces
сибиинньэ	pig
барабыай	pigeon
чөмөх	pile
сыттын	pillow
летчик	pilot
сыһыар	pin
ананас	pineapple
тэтэркэй	pink
иин	pit
үрдүк	pitch
киһи кэлэйиэх	pity
уур	place
миэстэ	place
миэстэлэр	places
чумаа	plague
ньуур	plain
былаан	plan
самолет	plane
үүнээйи	plant
үүнээйилэр	plants
тэриэлкэ	plate
платформа	platform
спектакль	play
оонньоо	play
оонньуу	playing
үчүгэй	pleasant
үөрдэр	please
бука диэн	please
дуоһуйбут	pleased
дуоһуйуу	pleasure
андаҕайыы	pledge
элбэх	plenty
ис хоһооно	plot
бүө	plug
слива	plum
сантехник	plumber
элбэх	plural
подкаст	podcast
хоһоон	poem
поэзия	poetry
ый	point
дьаат	poison
полиция	police
политика	policy
эйэҕэс	polite
киртиции	pollution
ньамах	pond
бассейн	pool
саахтаа	poop
дьадаҥы	poor
таһын	pop
киэҥник биллэр	popular
нэһилиэнньэ	population
сибиинньэ этэ	pork
хааһы	porridge
порт	port
кирбии	position
позитивнай	positive
баһылаа	possess
бас билии	possession
тардыылаах	possessive
сатанар	possible
таһаар	post
почта	post
көһөр	postpone
хортуоска	potato
потенциал	potential
көлүйэ	pound
дьадаҥы буолуу	poverty
күүс	power
күүстээх	powerful
практичнай	practical
тутун	practice
практика	practice
хайҕаа	praise
күлүү	prank
үҥ	pray
күндү	precious
сөптөөх	precise
оннук	precisely
билгэлээ	predict
ордор	prefer
ордоруу	preference
ыарахан	pregnant
хаалынньаҥ үгэс	prejudice
тутуу	premises
премиум	premium
бэлэмнэнии	preparation
бэлэмнээ	prepare
бэлэм	prepared
предлог	preposition
баар буолуу	presence
дьиңнээх	present
кэһии	present
билиҥҥи	present
презентация	presentation
харай	preserve
президент	president
баттаа	press
пресса	press
баттааһын	pressure
буолбута буол	pretend
кэрэ	pretty
син	pretty
эрдэттэн тохтот	prevent
инники	previous
булт	prey
сыана	price
киэн туттуу	pride
аҕабыыт	priest
бастакы	primary
cүрүн	prime
принцесса	princess
директор	principal
инники	prior
приоритет	priority
хаайыы	prison
приватность	privacy
чааһынай	private
привилегия	privilege
пириис	prize
баҕар	probably
проблема	problem
бэрээдэк	procedure
саҕалаа	proceed
процесс	process
чочуй	process
оҥор	produce
продукт	product
продукция	production
идэ	profession
идэлээх	professional
профиль	profile
барыс	profit
дириҥ	profound
сайдыы	progress
сайын	progress
бырайыак	project
көстүүлээх	prominent
андаҕай	promise
андаҕар	promise
хамсат	promote
үрдэтии	promotion
түргэн	prompt
дакаастаа	prone
солбуйар ааттар	pronouns
саҥарыы	pronunciation
дакаастабыл	proof
сөптөөх	proper
сүгүн	properly
уратылар	properties
бас билии	property
этии	proposal
перспектива	prospect
тупсуу	prosperity
чэчирии турар	prosperous
көмүскээ	protect
киэн тутун	proud
дакаастаа	prove
хааччый	provide
туруоруллубут	provided
бырабыынсыйа	province
хааччыйыы	provision
сааһы ситии	puberty
аһаҕас	public
тарт	pull
тыква	pumpkin
пунктуальнай	punctual
үөрэнээччи	pupil
атыылас	purchase
ыраас	pure
хара саарыл	purple
туттулуута	purpose
суумка	purse
эккирэт	pursue
эккирэтии	pursuit
баттаа	push
ук	put
квалификация	qualification
хаачыстыба	quality
ахсаан	quantity
карантин	quarantine
этис	quarrel
этиһии	quarrel
чиэппэр	quarter
Кечуа	Quechua
ыраахтааҕы	queen
дьикти	queer
ыйытынньык	query
ыйытыы	question
уочаракка тур	queue
уочарат	queue
түргэн	quick
түргэнник	quickly
чуумпу	quiet
суорҕан	quilt
тохтоо	quit
толору	quite
балачча	quite
биктэриинэ	quiz
цитата	quotation
цитаталаа	quote
цитата	quote
цитаталар	quotes
куобах	rabbit
раса	race
уор	rage
самыыр	rain
үрдэтии	raise
үрдэт	raise
улаатыннарбыт	raised
сүүрдэ	ran
түбэспиччэ	random
тайааһын	range
түргэн	rapid
түргэнник	rapidly
сэдэх	rare
сэдэхтик	rarely
итиик	rash
кырыыса	rat
сыаналаа	rate
хата	rather
хабааннаһыы	ratio
рациональнай	rational
сиикэй	raw
тиий	reach
тиийдэ	reached
реакция	reaction
аах	read
ааҕыы	reading
бэлэмнээ	ready
дьиҥнээх	real
баар чахчы	reality
өйдөө	realize
өйдөөтө	realized
чахчы	really
кэнники	rear
сылтах	reason
өйдөөх	reasonable
өйдөө	recall
рецепт	receipt
ыл	receive
ылла	received
соторутааҕы	recent
соторутааҕыта	recently
ресепшен	reception
рецепт	recipe
өйө суох	reckless
билинии	recognition
бил	recognize
сүбэлээ	recommend
рекомендацияланар	recommended
рекорд	record
үтүөр	recover
чөлгө түһүү	recovery
көнө муннук	rectangle
кыһыл	red
атыылас	redeem
боруостаныы	redemption
аҕыйат	reduce
ордуктаах	redundant
сигэн	refer
сыылка	reference
килэй	reflect
күлүк	reflection
туттун	refrain
холодильник	refrigerator
төннөр	refund
аккаастаа	refuse
аккаастаата	refused
болҕомто	regard
туһунан	regarding
төһө да	regardless
убаастабыл	regards
регион	region
регистрациялаа	register
кэмсин	regret
тиһигэ быстыбат	regular
утумнаахтык	regularly
аккаастаа	reject
сыһыан	relate
уруу	related
сыһыан	relationship
холоонноох	relative
аймах	relative
аймахтар	relatives
сынньан	relax
таһаар	release
тахсыы	release
таһаарыллыбыт	released
сөптөөх	relevant
эрэллээх	reliable
чэпчэтии	relief
чэпчээ	relieve
чэпчээбит	relieved
итэҕэл	religion
итэҕэл	religious
баҕата суох	reluctant
өйөн	rely
хаал	remain
хаалбыт	remaining
бэртээхэй	remarkable
эмп	remedy
өйдөө	remember
өйдөтүү	remind
санатыы	reminder
ыраах	remote
соттор	remove
толоруу	render
аренда	rent
өрөмүөн	repair
хатылаа	repeat
солбуй	replace
хоруй	reply
хоруйдаа	reply
даклыыттаа	report
дакылаат	report
сирэйдээн көрдөр	represent
аат-суол	reputation
ыйытык	request
ирдэбиллэр	require
ирдэбиллээх	required
быыһаа	rescue
чинчийии	research
санат	resemble
утарсыы	resentment
бронялааһын	reservation
бронялаа	reserve
олохтоох	resident
уурайыы	resign
туруктаах буолуу	resilience
туруктаах	resilient
утар	resist
утарсыы	resistance
көҥүллээһин	resolution
быһаар	resolve
сынньанар сир	resort
ресурстар	resources
убаастабыл	respect
убаастаа	respect
эппиэт	respond
хоруй	response
эппиэтинэс	responsibility
эппиэтинэстээх	responsible
сынньан	rest
быдаҥ сылларга быраһаай	rest in peace
ресторан	restaurant
көннөр	restore
кыччат	restrict
түмүк	result
түмүктэр	results
резюме	resume
бытархай атыы	retail
тохтот	retain
тутан хаалыы	retention
пенсионер	retired
чугуйуу	retreat
быыһаа	retrieve
төнүн	return
арый	reveal
аһыллыбыт	revealed
иэстэһии	revenge
дохуот	revenue
төттөрү	reverse
түмэн көрүү	review
көннөр	revise
ревизия	revision
өрөбөлүүссүйэ	revolution
манньа	reward
ритм	rhythm
ойоҕос	rib
ириис	rice
баай	rich
суох гын	rid
миин	ride
айан	ride
түктэри	ridiculous
уҥа	right
сөп	right
субу билигин	right now
кытаанай	rigid
бэһилэх	ring
сайҕаа	rinse
буун	riot
хайдыы	rip
хайыт	rip
буспут	ripe
көтөҕүү	rise
көтөх	rise
кутталга киир	risk
куттал	risk
куотуһааччы	rival
өрүс	river
суол	road
ыһаар	roast
бөҕө	robust
таас	rock
сүрүн	rod
оруол	role
эргит	roll
хоруобуйа	roof
хос	room
силис	root
быа	rope
сытыйбыт	rotten
хадаар	rough
хадаардык	roughly
төгүрүк	round
суол	route
рутина	routine
эрээт	row
аал	rub
эрэһиинэ	rubber
бөх	rubbish
хадаар	rude
көбүөр	rug
алдьат	ruin
быраабыла	rule
линейка	ruler
быраабылалар	rules
сүүр	run
сүрүү	running
дэриэбинэ	rural
ыксаа	rush
ыксабыл	rush
мөһөөччүк	sack
ытык	sacred
сиэртибэ	sacrifice
сэрэҕэ суох	safe
дьоллоох айаны	safe flight
куттал суох буолуута	safety
муударай киһи	sage
эттэ	said
уһун	sail
парус спорда	sailing
туһугар	sake
хамнас	salary
атыы	sale
лосось	salmon
туус	salt
оннук	same
Манна да оннук	Same here
холобур	sample
кумах	sand
Санскрит	Sanskrit
саркастическай	sarcastic
баламат	sassy
олорбут	sat
астыныы	satisfaction
астыммыт	satisfied
ханнар	satisfy
астыннарар	satisfying
Субуота	Saturday
халбаһыы	sausage
дьиикэй	savage
быыһаа	save
көрдө	saw
эт	say
шкала	scale
сымыйа	scam
чэр	scar
кэмчи	scarce
куттаммыт	scared
саарт	scarf
кутталлаах	scary
ыһыллыбыт	scattered
сыана	scene
пейзаж	scenery
сыт	scent
былааннаа	schedule
былаан	schedule
оскуола	school
наука	science
учуноай	scientist
учуонайдар	scientists
кыптыый	scissors
мөх	scold
кээмэй	scope
баал	score
лоскуй	scrap
хайа тардыы баас	scratch
часкый	scream
экран	screen
биинтэ	screw
сурук	script
муора	sea
уор	seal
көрдөө	search
дьыл кэмэ	season
олоппос	seat
сөкүүндэ	second
кистэлэҥ	secret
секция	section
куттала суох	secure
куттал суох буолуута	security
көр	see
көрсүөххэ дылы	see you
кэлин көрсүөхпүт	see you later
сотору көрсүөхпүт	see you soon
сарсын көрсүөхпүт	see you tomorrow
сиэмэ	seed
көрдөө	seek
көһүн	seem
көстөр	seems
көрбүт	seen
былдьаа	seize
таарымта	seizure
дэҥҥэ	seldom
тал	select
бэйэ	self
бэйэ эмтэнии	self healing
бэйэмсэх	selfish
атыылаа	sell
ыыт	send
хаартыскаҕын ыыт	send me your picture
үрдүк	senior
билии	sense
өйдөөх	sensible
уйан	sensitive
ыытта	sent
этии	sentence
этиилэр	sentences
туспа	separate
Сепеди	Sepedi
балаҕан ыйа	september
утума-ситимэ	sequence
сериялар	series
дьоһуннаах	serious
кырдьык	seriously
сулууспалаа	serve
сервис	service
сессия	session
туруор	set
настраивать	set up
параметр	setting
олохтоо	settle
сэтээ	seven
уон сэттэ	seventeen
сэттэ уон	seventy
хас да	several
кытаанах	severe
тиктэ	sew
күлүк	shade
күлүк	shadow
сахсый	shake
чычаас	shallow
саатыы	shame
форма	shape
үллэс	share
сытыы	sharp
кини	she
киниэхэ баар	she has
кини	she is
бырах	shed
хой	sheep
илиис	sheet
долбуур	shelf
хаа	shell
хахха	shelter
кунах	shield
көһөр	shift
сырдаа	shine
хараабыл	ship
ыытыы	shipping
ырбаахы	shirt
бачыыҥкалар	shoes
ыт	shoot
маҕаһыын	shop
атыылаһыы	shopping
кытыл	shore
кылгас	short
тиийбэтэ	shortage
ытыы	shot
сарын	shoulder
часкый	shout
шоу	show
көрдөр	show
көрдөр	show me
душ	shower
креветка	shrimp
кыччат	shrink
сап	shut
аргыый	shut up
килбик	shy
бииргэ төрөөбүт	sibling
бииргэ төрөөбүттэр	siblings
ыалдьар	sick
өрүт	side
өрө тыын	sigh
көстүү	sight
кэрэхсэбиллээх сир	sightseeing
илии баттаа	sign
илии баттааһына	signature
суолталаах	significant
уу чуумпу	silence
чуумпу	silent
солко	silk
акаары	silly
үрүҥ көмүс	silver
майгынныыр	similar
акаарыччай	simp
көннөрү	simple
тэҥҥэ	simultaneously
ыла	since
чиэһинэй	sincere
истиҥник	sincerely
ыллаа	sing
ырыаһыт	singer
соҕотох	single
раковина	sink
тимир	sink
Убаастабыллаах	Sir
эдьиий	sister
аҕас кылын	sister in law
олор	sit
сайт	site
ситуация	situation
алта	six
уон алта	sixteen
алта уон	sixty
кээмэй	size
сатамньы	skill
сатабыллар	skills
тирии	skin
ырыган	skinny
көтөр	skip
юбка	skirt
халлаан	sky
кулут	slave
утуй	sleep
утуйуу	sleeping
утуктаабыт	sleepy
сиэх	sleeve
кырбаа	slice
кырбас	slice
халый	slide
кыратык	slightly
ырыган	slim
халый	slip
эниэ	slope
слот	slot
бытаан	slow
бытааннык	slowly
кыра	small
өйдөөх	smart
сыт	smell
мичээр	smile
мичээрдээ	smile
буруо	smoke
дэхси	smooth
сокууска	snack
улитка	snail
моҕой	snake
тыгыы	snap
хаар	snow
оннук	so
наһаа минньигэс	so cute
билиҥээҥҥэ дылы	so far
илит	soak
мыыла	soap
өйдөөх	sober
футбол	soccer
социальнай	social
уопсастыба	society
наскылар	socks
сымнаҕас	soft
программа	software
буор	soil
атыыламмыт	sold
барыта атыыланна	sold out
саллаат	soldier
соҕотох	sole
кытаанах	solid
быһаарыы	solution
быһаар	solve
сорох	some
ким эрэ	somebody
хайдах эрэ	somehow
ким эрэ	someone
туох эрэ	something
сороҕор	sometimes
ырыа	song
сотору	soon
уустук	sophisticated
Сорани	Sorani
ыалдьар	sore
баас	sore
ыалдьар күөмэй	sore throat
санаарҕааһын	sorrow
Алҕас	Sorry
көрүҥ	sort
көрдөөтө	sought
кут	soul
уруу дууһа	soulmate
тыас	sound
миин	soup
аһыы	sour
дьүүктэ	source
соҕуруу	south
куйаар	space
спам	spam
уһуна	span
Испанныы	Spanish
аһын	spare
ордук	spare
саҥар	speak
оһуобай	special
көрүҥ	species
ураты	specific
көрдөөх	spectacular
этии	speech
тыла суох	speechless
түргэнэ	speed
алгыс	spell
барат	spend
бараппыт	spent
аһыы	spicy
үҥүү	spike
эргий	spin
шпинат	spinach
кут	spirit
силлээ	spit
үтүөкэн	splendid
хайдыһыы	split
хайыт	split
буортулаа	spoil
буорту буолбут	spoiled
эмискэ	spontaneous
хамыйах	spoon
сир	spot
кэргэн	spouse
тарҕат	spread
саас	spring
квадрат	square
ытырт	squeeze
кальмар	squid
тииҥ	squirrel
уул.	st
быһаҕынан ас	stab
бигэ	stable
чөмөх	stack
мал	staff
сыана	stage
туһахта	stain
кирилиэс	stairs
туруоруу	stake
сырыс	stalk
ларёк	stall
марка	stamp
туруорук	stand
тур	stand
стандарт	standard
сулус	star
саҕалаа	start
саҕалаата	started
аччыктааһын	starving
штат	state
бигэргэт	state
бигэргэтии	statement
ыстаансыйа	station
ыстаатыйа	statue
турук	status
хаал	stay
хаалыы	stay
сэрэнэн сырыт	stay safe
туруктаах	steady
стейк	steak
уор	steal
паар	steam
ыстаал	steel
туруору	steep
силис	stem
хардыы	step
мас	stick
хоччорхой	stiff
өссө	still
хамсаабат	still
тик	sting
харааҥкы	stingy
булкуй	stir
хаһаас	stock
уоруллубут	stolen
ис	stomach
таас	stone
турда	stood
саах	stool
тохтоо	stop
ууруу	storage
маҕаһыын	store
буурҕа	storm
кэпсээн	story
оһох	stove
көнө	straight
судургу	straightforward
күүрүү	strain
дьикти	strange
киһи билбэт киһитэ	stranger
стратегия	strategy
солуома	straw
клубника	strawberry
балаһа	streak
сүүрүк	stream
уулусса	street
күүс	strength
стресс	stress
тардын	stretch
кытаанах	strict
оҕус	strike
сап	string
уһул	strip
дьулус	strive
охсуу	stroke
күүстээх	strong
оҕус	struck
тутула	structure
охсус	struggle
охсуһуу	struggle
ыарахаттары көрсүү	struggling
өһөс	stubborn
хааттар	stuck
устудьуон	student
үөрэн	study
үөрэх	study
үөрэх	studying
мал	stuff
соһумар	stunning
акаары	stupid
стиль	style
субъект	subject
бас бэринии	submission
туттар	submit
һэк	substance
солбуй	substitute
уран	subtle
ситис	succeed
ситиһии	success
ситиһиилээх	successful
оннук	such
курдук	such as
эм	suck
эмискэ	sudden
эмискэ	suddenly
эрэйдэн	suffer
эрэйдэнии	suffering
тиийэр	sufficient
саахар	sugar
этии киллэр	suggest
этии	suggestion
көстүүм	suit
сөп түбэс	suit
сөптөөх	suitable
чемодан	suitcase
сумма	sum
кылгас түмүк	summary
сайын	summer
саммит	summit
күн	sun
баскыһыанньа	sunday
күннээх	sunny
күн кииритэ	sunset
күн уота	sunshine
супер	super
дьаһалта	superior
салайааччы	supervisor
киэһээҥҥи ас	supper
хааччый	supply
хааччыйыы	supply
өйөө	support
өйөбүл	support
сабаҕалаа	suppose
сабаҕаланар	supposed
биллэн турар	sure
ньуур	surface
чалым	surge
хирургия	surgery
араспаанньа	surname
сюрприз	surprise
соһуйбут	surprised
бэрин	surrender
тулалыыр	surrounding
кэтээһин	surveillance
ыйыт	survey
ыйытык	survey
тыыннаах хаал	survive
уорбаланныбыт	suspect
уорбалан	suspect
тохтотуллубут	suspended
саарбах	suspicious
өйөө	sustain
бигэ	sustainability
туруктаах	sustainable
булумньу	swag
ыйыһын	swallow
уларыт	swap
андаҕай	swear
тиритии	sweat
сибиитэрэ	sweater
харбаа	sweep
минньигэс	sweet
минньигэс түүллэри	sweet dreams
минньигэһи таптыыр	sweet tooth
тапталлаах	sweetheart
иһии	swell
иһии	swelling
харбаа	swim
сөтүөлээһин	swimming
хачайдаа	swing
хачыала	swing
выключатель	switch
холбоо	switch
испит	swollen
кылыс	sword
символ	symbol
аһыныы	sympathy
cибикилэр	symptoms
система	system
остуол	table
охсус	tackle
бэлиэтээ	tag
кутурук	tail
ыл	take
илдьэ бар	take away
сэрэх буол	take care
уһул	take off
ылыллыбыт	taken
кэпсэтии	talk
кэпсэт	talk
кэпсэтинньэҥ	talkative
үрдүк	tall
кран	tap
записьтаа	tape
сыал	target
сыаллаа	target
сорудах	task
амтан	taste
амсай	taste
амтаннаах	tasty
үөрэттэ	taught
чэй	tea
үөрэт	teach
учуутал	teacher
бөлөх	team
харах уута	tear
харах уута	tears
элэхтээ	tease
технология	technology
тиистэр	teeth
кэпсээ	tell
эт миэхэ	tell me
майгы	temper
температура	temperature
айыы дьиэтэ	temple
быстах	temporary
уон	ten
уон тыһыынча	ten thousand
куортам биэрээччии	tenant
дьоҕурдаах	tend
тенденция	tendency
нарын	tender
кэм	tense
күүрдүү	tension
балаакка	tent
боруоба	tentative
термин	term
усулуобуйалар	terms
дьаабы	terrible
бэрт	terrific
сир	territory
тест	test
холоон көр	test
текст	text
оннугар	than
махтал	thank
махтанабын	thank you
Ыытыыны бэрэбиэркэлиэхпитигэр диэри, күүтэн тулуйаргын иһин махтанабыт	Thank you for your patience while we investigate shipment
улахан махтал	thank you so much
улахан махтал	thank you very much
махтал	thanks
Биһиги сыһыарыыбытын туттаргыт иһин махтал	Thanks for using our app
туох	that
ол диэн	that is
ол үчүгэй	that's good
уору	theft
кинилэр киэннэрэ	their
кинилэри	them
тема	theme
бэйэлэрэ	themselves
онтон	then
теория	theory
онно	there
баар	there are
баар	there is
ол иһин	therefore
балар	these
кинилэр	they
кинилэр	they are
суон	thick
уоруйах	thief
буут	thigh
синньигэс	thin
мал	thing
маллар	things
толкуйдаа	think
үһүс	third
утаппыт	thirsty
уон үс	thirteen
отут	thirty
бу	this
бу	this is
кичэл	thorough
кичэйэн	thoroughly
олор	those
буолан баран	though
толкуйдаа	thought
санаа	thought
оттомноох	thoughtful
санаалан	thoughts
тыһыынча	thousand
сап	thread
куттал	threat
куттаа	threaten
үс	three
модьоҕо	threshold
куттаммыт	thrilled
чэлгий	thrive
күөмэй	throat
нөҥүө	through
курдары	throughout
бырах	throw
эрбэх	thumb
этиҥ	thunder
Чэппиэр	Thursday
балар	thus
бэлиэ	tick
үллүү	tide
кичэл	tidy
хаалыстык	tie
баай	tie
баабыр	tiger
кытаанах	tight
Тингринья	Tigrinya
бириэмэ	time
хоргус	timid
кыракый	tiny
чаевый	tip
сүбэлэр	tips
шина	tire
сылайбыт	tired
соттор	tissue
аат	title
баар буолуу	to be
тост	toast
бүгүн	today
кыра оҕо	toddler
атах тарбахтара	toes
бииргэ	together
туалет	toilet
эттэ	told
тулуйуу	tolerance
тулуй	tolerate
томат	tomato
сарсын	tomorrow
тыл	tongue
бүгүн түүн	tonight
эмиэ	too
ылла	took
сэп	tool
сэптэр	tools
тиис	tooth
үөһээҥи	top
тема	topic
хайдыбыт	torn
эрэйдээ	torture
барыта	total
таарый	touch
кытаанах	tough
тур	tour
диэки	toward
диэки	towards
соттор	towel
куорат	town
дьааттаах	toxic
суол	trace
сирдээ	track
атыылаа	trade
атыы	trade
үгэс	tradition
үгэс буолбут	traditional
хамсааһын	traffic
суол	trail
поезд	train
эрчиллии	training
быһыы	trait
быһыылар	traits
ыыт	transfer
көһүү	transition
тылбаас	translate
дьэҥкир	transparent
транспорт	transport
тиэйии	transportation
сохсо	trap
бөх	trash
оһол	trauma
айан	travel
бодунуос	tray
күндү баай	treasure
эмтээ	treat
эмтэнии	treatment
мас	tree
баараҕай	tremendous
тренд	trend
суут	trial
албас	trick
боруобалаата	tried
саа элбэрээгэ	trigger
хорун	trim
айан	trip
уустук	trouble
ыстаан	trousers
грузовик	truck
кырдьык	true
умнас	trunk
эрэл	trust
эрэнии	trust
кырдьык	truth
боруобалаа	try
Тсонга	Tsonga
турба	tube
Оптуорунньук	Tuesday
төлөбүр	tuition
индейка	turkey
куркума	turmeric
хайыс	turn
черепаха	turtle
репетитор	tutor
уон икки	twelve
сүүрбэ	twenty
сүүрбэ биир	twenty-one
Тви	Twi
иккитэ	twice
эргит	twist
икки	two
бэчээт	type
типичнэй	typical
мара	ugly
бүтэһик	ultimate
зонтик	umbrella
сатаммат	unable
таай	uncle
өйө суох	unconscious
анныгар	under
аннынан	underneath
ситэ сыаналамматах	underrated
өйдөө	understand
өйдөөбүт	understood
хомойуох иһин	unfortunately
униформа	uniform
баар соҕотох	unique
чаас	unit
университет	university
биллибэт	unknown
илигинэ	unless
диэри	until
ураты	unusual
үөһэ	up
бэйэҥ бил	up to you
саҥардытыы	update
саҥарт	update
тупсарыы	upgrade
тупсар	upgrade
хомойбут	upset
куорат	urban
ыксат	urge
ыксабыл	urge
суһал	urgent
биһигини	us
туһаныы	use
туһан	use
туһаныллыбыт	used
туһалаах	useful
туһата суох	useless
көннөрү	usual
үксүн	usually
туһа	utility
уоппуска	vacation
вакцинация	vaccination
вакцина	vaccine
вакуум	vacuum
чуолкайа суох	vague
дьиҥнээх	valid
хочо	valley
сыаналаах	valuable
сыаналаа	value
сыана	value
эгэлгэ	variety
араас	various
уларый	vary
ваза	vase
киэҥ	vast
оҕуруот аһа	vegetable
оҕуруот аһа	vegetables
көлөһө	vehicle
атыыһыт	vendor
дьаат	venom
куттал	venture
буолар сирэ	venue
бигэргэт	verify
универсальнай	versatile
версия	version
туруору	vertical
олус	very
олус үчүгэй	very good
иһит	vessel
нөҥүө	via
салгын	vibe
кут	vibes
уордаах	vicious
эмсэҕэлээччи	victim
видео	video
көстүү	view
дэриэбинэ	village
сиэхсит	villain
уксус	vinegar
винтажнай	vintage
күүһүлээһин	violence
күүһүлэҥнээх	violent
биллиилээх	viral
виртуальнай	virtual
үтүө	virtue
көстүү	vision
сырыт	visit
сылдьыы	visit
көрөр	visual
тыын суолталаах	vital
чаҕылхай	vivid
тылдьыт	vocabulary
куолас	voice
ичитэх	void
сабардам	volume
волонтер	volunteer
хотуо	vomit
хотуолаа	vomit
кэбирэх	vulnerable
хамнас	wage
хамнас	wages
бэл	waist
күүт	wait
официант	waiter
күүтүү	waiting
уһугун	wake
уһугун	wake up
хаам	walk
хаамыы	walk
хаамыы	walking
эркин	wall
кумааһынньык	wallet
күүлэйдээ	wander
баҕарабын	wanna
баҕар	want
ирдэбилгэ сылдьар	wanted
сэрии	war
таҥас ыскааба	wardrobe
ыскылаат	warehouse
итит	warm
итии	warm
сэрэт	warn
cэрэтии	warning
буойун	warrior
этэ	was
сууй	wash
бөх	waste
бараа	waste
көр	watch
уу	water
арбуз	watermelon
долгун	wave
суол	way
биһиги	we
биһиги	we are
биһиги сатыыбыт	we can
мөлтөх	weak
мөлтөҕө	weakness
баай	wealth
баай	wealthy
кэт	wear
кэт	wearing
халлаан туруга	weather
сыбаайба	wedding
Сэрэдэ	Wednesday
от	weed
нэдиэлэ	week
өрөбүл	weekend
ыйаа	weight
ыйааһын	weight
дьиибэ	weird
нөрүөн нөргүй	welcome
уйгу	welfare
Үчүгэйдик	Well
маладьыас	well done
барда	went
этилэр	were
арҕаа	west
инчэҕэй	wet
кит	whale
туох	what
оттон эн	what about you
тугу гынаҕын	what are you doing
билигин тугу гынаҕын	what are you doing now
эн тугу гынаҕын	what are you doing right now
тугунан дьарыктанаҕын	what do you do
тугунан дьарыктанаҕын олоххор	what do you do for a living
тугу этэҕин	what do you mean
туох нааданый эйиэхэ	what do you want
туох буолла	what happened
туох	what is
бу тугуй	what is this
эн тугу үлэлиигин	what is your job
аатыҥ ким диэний	what is your name
туох сонун	what's up
аатыҥ ким диэний	what's your name
туох да	whatever
сэлиэһинэй	wheat
көлүөһэ	wheel
хаһан	when
хаһан баҕар	whenever
ханна	where
эн ханна бааргыный	where are you
хантан сылдьаҕын	where are you from
ханна бааргыный билигин	where are you now
эн ханна олороҕун	where do you live
ханнаный	where is
оттон	whereas
дуо	whether
ханнык	which
кэмигэр	while
сибигинэй	whisper
иһиир	whistle
үрүҥ	white
ким	who
эн кимҥиний	who are you
ким	who is
бу кимий	who is this
бүтүн	whole
кимиэхэ	whom
кимиэнэ	whose
тоҕо	why
тоҕо суох	why not
өһүөннээх	wicked
киэҥ	wide
огдообо	widow
кэтитэ	width
эмээхсин	wife
дьиикэй	wild
санаа күүһэ	will
завещание	willing
кыай	win
тыал	wind
түннүк	window
тыаллаах	windy
вино	wine
кыһын	winter
сот	wipe
боруобат	wire
муударас	wisdom
муударай	wise
баҕа санаа	wish
баҕар	wish
эйиэхэ бары саамай үчүгэйи баҕарабын	wish you all the best
абааһы дьахтар	witch
кытта	with
таһаар	withdraw
таһаарыы	withdrawal
иһигэр	within
суох	without
туоһулаа	witness
туоһу	witness
кэпсэтиилэр	witty
бөрө	wolf
дьахтар	woman
дьахталлар	women
кыайда	won
баҕарбаппын	won't
дьикти	wonder
дьикти үчүгэй	wonderful
мас	wood
түү	wool
аан дойду	word
тыллар	words
үлэ	work
үлэлээ	work
дьарыктан	work out
үлэлиир	working
аан дойду	world
үөн	worm
эргэрбит	worn
долгуйбут	worried
долгуй	worry
өссө куһаҕан	worse
үҥ	worship
саамай куһаҕан	worst
сыанаҕа тур	worth
сөп	worth it
дьоһун	worthy
буолуо этэ	would
баас	wound
Оо	Wow
суулаа	wrap
уор	wrath
бэгэччэк	wrist
суруй	write
Манна суруйуҥ	Write here
сурук	writing
суруллубут	written
сыыһа	wrong
суруйда	wrote
Саха	Yakut
олбуор	yard
дьааһыйыы	yawn
дьааһый	yawn
Сыл	Yeah
тыл	year
сыллар	years
доруоһа	yeast
ыһытаа	yell
саһархай	yellow
Ээх	Yes
сөп чыычаах	yes baby
сөп чыычаах	yes dear
сөп чыычаах	yes honey
сөп тапталым	yes my love
ээ биллэн турар	yes of course
бэҕэһээ	yesterday
илик	yet
үүнүү	yield
эн	you
эн	you are
эн кэрэҕин	you are beautiful
эн наһаа да кэрэҕин	you are so beautiful
баһаалыста	you are welcome
Эн билэҕин	You know
эн эмиэ	you too
баһаалыста	you're welcome
эдэр	young
эйиэнэ	your
баһаалыста	your welcome
бэйэтэ	yourself
ыччат	youth
баһаалыста	you’re welcome
минньигэс	yummy
нуул	zero
