kerin	a
yörè	a little
gbegbé	a lot
gbégbé	a lot of
gbilénfé fé fora	abandon
abaralouna	abandoned
ikhi sa akèyama	abide
nofé	ability
yelé	able
micé afé	about
afari ma	above
ikèna nkhanounteyi	abroad
mouna	absence
mounä	absent
na lèri birin	absolutely
abindounfé	absorb
nakhan fakhamou fé khörökhö	abstract
nakhan moun nondira	absurd
a gbé gbé	abundance
nakhan gbo	abundant
ara danguè	abuse
tonkhouma khouri	accent
tinfé	accept
marafoulounyi	access
gbaloé	accident
yiguia	accommodation
aguèra	accomplish
abara raba	accomplished
tanbè	according
Conti	account
nakhara	accuracy
na yati	accurate
woulé sä khoun	accused
khönè	ache
nalifé	achieve
A ra ba fé	achievement
gbelin akolon na	acknowledge
kolonyi	acquaintance
findifé igbéra	acquire
sötè	acquired
abara sotö	acquisition
acetma	across
sariya	act
fé	action
nakhan walifé	active
waley	activities
wali	activity
akhounyi	actor
yakôsi	actual
na kouï	actually
Cé gnöra méloun khi	acute
deri	adapt
asa fari	add
deri a ra	addicted
safé ä fari	addition
nakhan samä fari	additional
adrèssi	address
alankha ma	adequate
cé nakhé na iboré fèma	adjacent
matokhocé	adjective
ara tingui	adjust
arafan	admire
tinfé ama	admit
fé sougandi fé	adopt
Nakhan tofan anoun böyè fanyi	adorable
ima sikha	advance
imasiga yaré	advanced
mounanfanyi	advantage
minifé gnamanè gbètèma	adventure
cèbèli nakhan marabè kia massarama	adverb
cema fanfé	advertisement
masén'gni	advertising
marasi	advice
rasi	advise
piya	advocate
ara tofan	aesthetic
fé nakhan mikhima to khi	affair
Ma ra sambè ti fé	affect
Cé kha fé fanyi ma yökhoun fé	affection
sagoé	afford
saré mou khörökhö	affordable
bognèmini	afraid
nanoun bara	after
midi dangui khanbi	afternoon
na khanbira	afterwards
man	again
dökhöfé a bè	against
gnè	age
walidé nakhan mikhé khayi fan ma	agency
mighi nakhan walifé lankhoundè dé	agent
gueréguiri	aggressive
nakhan ma foura kha maramakhè koui	agile
nan iya	ago
tinfé	agree
lan'gni	agreement
boghira walifé	agriculture
ayara	ahead
mali	aid
akhounyi	aim
foé	air
aéropori	airport
khörökhè	aisle
marakolonyi tifé	alarm
béré	alcohol
rakolon	alert
baloukhi	alive
ebirin	all
awa	all right
ala khi ratanga	all the best
sagoé	allow
tikhin ma	allowed
faïda	almost
kerényi	alone
akha koua han	along
noun	already
afan	Alright
nafan	also
kèya gbètè	alternative
allo ato fan	although
koudèï	always
ki	am
ma kabè	amazing
Nakhan kiya gbo	ambiguous
wafé findifé ara	ambition
nakhan wama fé khön ma tékou	ambitious
rafan	amend
a tagui	amid
netagui	among
won yama	among us
khassabi	amount
Nakhan miki ra yélé ma	amusing
kerin	an
feya fenfé	analysis
bembey	ancestors
anga	anchor
a fori	ancient
anoun	and
ifan go	and you
malakè	angel
khonè	anger
Tounkhoun yi	angle
khonokhi	angry
dalisé	animal
sankon yi	ankle
gnènènè	anniversary
A fala fé	announcement
törè	annoy
bögnè ragnakhoui	annoyed
yagba	annoying
gnè dakhi	annual
Nakhan ma khili falama	anonymous
fé gbètè	another
yabi	answer
fé tofé nakhan fama	anticipate
kontofili	anxiety
kontofilifé ama gakhoukhira	anxious
afindi cécéra	any
sönö	anymore
n'déndé	anyone
anifindi nakhan yora	anything
kèya birin	anyway
awa	anyways
bafé ara	apart
banghi	apartment
wo dignè wo boré ma	apologize
nya todera	apparent
aloukhi	apparently
khili	appeal
minifé	appear
tokima	appearance
mininè	appeared
doncé kha gnkhoumè	appetite
pommou	apple
Fé safé Ama kènèn khira	application
asama	apply
naralanyi	appointment
amatökhofé	appreciate
ma tökhöfé	appreciation
amakôrè	approach
nakhan fabè	appropriate
tinfé ä ma	approval
tin a ma	approve
bara tin a ma	approved
ama sokhi ara	approximately
avrili kiké	april
Nakhan mou lan ma a kha raba imposer Cèmbè dokho fé mikhi ma a kha tin fé ra	arbitrary
Mikhi Nakhan bankhi tiki yalan ma	architect
mikhi nakhan bankhi tiki yalan ma	architecture
cé fori ragatakhi	archive
é	are
ina na	are you
i na wölifé nè	are you busy
imarié khi	are you married
ifoutighi anama ra imou foutikhi	are you married or single
Han ya wo nâ bé?	Are you still there?
inabé	are you there
yiré dé	area
Khoun ma falè	argue
woyènyi Nakhan nondi ma cénkhi	argument
minifé afouréra	arise
bèlèkhè	arm
sörey	army
afèma	around
yaalän	arrange
ceyi safé	arrangement
fäfé	arrival
kouya	arrive
fa	arrived
yètè gboyi	arrogant
tambè	arrow
cé yalanfé nakhan singué mounana	art
cée khounkhouri	article
cé yalankhi	artificial
sigui sa	artist
allo	as
ki nakhè	as long as
fän	as well
fan	as well as
khoubé	ash
yagui	ashamed
makhorinty	ask
bara makhörin	asked
akhikhi	asleep
kèya	aspect
Assamisikhoui	Assamese
Guéré guiri fé	assault
malanyi	assembly
fera bakhi kha nondi makénènma	assertive
amato	assess
matokhi	assessment
nakhan moura kharakhi	asset
nakhan fan aman ma foura	assets
a so ayi	assign
Siguè	assignment
mali	assist
malimikhi	assistant
malanfé	associate
agbakou ara	associated
lankhoundè	association
Magnökhoun yi nakhan moura bakhi	assume
wöyènyi mèni falakhi	assumption
mèni	at
hali	at least
a donnè	ate
guila	athlete
khiri	attach
a gbakou khara	attached
khirifé	attachment
A soukhou fé guérré dakhi	attack
matoï	attempt
Lanfé ama	attend
a ya khori	attendance
döyin döyin	attention
louki	attitude
bèndoufé	attract
bindoufé ama	attraction
Nakhan a ma söma	attractive
kha wali masénfé ibè	attribute
yama	audience
kiké solomassakha yan dé	august
ntenin	aunt
ntènèn	aunty
alankhama	authentic
nakha arabakhi	author
saria	authority
wakhati na khan na khimbéli tèmoui noun kéfouré tèmoui tagui	autumn
sago	available
fèrè	average
ama tanga	avoid
khounoun	awake
so ayi	award
kolonnyi	aware
Khakhili ma	awareness
amakouya	away
afan	awesome
a ma gakhoui	awful
agbélèkhé moun tinkhin	awkward
Aymarakhoui	Aymara
douyèrè	baby
Nakhan mou fouti khi	bachelor
ifari	back
khanbi biriki	background
amoufan	bad
cé sacé	bag
doncé nakhan sa ma gantan yi	bait
gayo yalanfé	bake
gato yalan'gni	bakery
nakhan sama don céma ani gnin ma alako kha borokhö	baking soda
marakharè	balance
baalon	ball
Bambarakhoui	Bambara
banani	banana
Cé nakhé malankhi	band
Khoui ra mini fé	bang
Köbiri ragata banghi	bank
kâfé	bar
abakhi	barely
imagnin fé féfanyira	bargain
wonwon fé	bark
sanssi nakhan boghi cé nouè ra melounkhi	barley
Tatè	barrier
dökhödé	base
sabatikhi	based
bokhi boun'ma	basement
afolodé	basic
Nakhan fé khöri	basically
chrétien yé kha salidé khoungbé	basil
gnangamadi	bastard
ama lan fé	batch
khä	bath
makhadé	bathroom
batéri	battery
gueré	battle
Ba yé dèn nè khè na kharéma	bay
iyètè	be
a gnè doyi	be careful
sougandi	beach
cé nekhé malankhi	beam
togué	beans
woula baré	bear
dè khabé	beard
kènè nakhan na tédé tagui	bearing
khakhilitaré	beast
bomboè	beat
tofan	beautiful
tofan'gni	beauty
findinè	became
barima	because
findy fera	become
aborokhö	bed
banghi	bedroom
koumi	bee
ningué	beef
a findinkhi	been
béré	beer
singué	before
fölönè	began
afolofé	begin
afolè	beginning
khili ra	behalf
yètè tongo	behave
aratifé	behavior
gnougué	behaviour
akhanbi	behind
kiya	being
dinkhèniya	belief
lafé fera	believe
fouri	belly
gui fora	belong
Mikhi Nakhan na fankhi a fanyi ra	beloved
a bounma	below
sènture	belt
dokhöcé kouyé	bench
makountan fé	bend
aboun	beneath
Mali khi	benefit
matéfé	benefits
afèma	beside
gbètè	besides
toki	best
ratanga fan'gni	best of luck
n'ni khèbouma	best regards
fissè	better
etagui	between
cé mindakhi	beverage
nafari	beyond
Bhoiputikhoui	Bhojpuri
a khafé	bias
kèya masarakhi	biased
kourè	bicycle
yanigué	bid
khoungbé	big
kourè	bike
Bouki Saré sèbèma nakhan koui	bill
nekhé na iboréra	bind
khoni	bird
gnènènè	birthday
sokhodi	bit
khiïn	bite
akhono	bitter
a forè	black
finè	blade
Fé mayökhoun fé a Kobi kra ya ma	blame
fikhè	blank
cé ma koto cé	blanket
bö	blast
eau de javel yé	bleach
ama sounbou	blend
Douba fé	bless
abarikakhi	blessed
dankhoui	blind
khèri	bliss
mikhi fouri rabodé	block
wouli	blood
woury fogué minima tèmouï nakhan ma	bloom
börökhöyi	blow
Boulé	blue
a dè bara tori	blunt
amaga wou	board
kounki bélébélé	boat
faté	body
gnin	boil
a khörökhökhi	bold
agbakoukhi	bond
khöri	bone
bouki	book
safé afari	boost
nakhan à khourabiyama	booster
bouti	boot
bouti	boots
gnamanè dandé	border
yili	bore
bognè ma wa	bored
tounan khonè	boring
bari	born
yefouiti	borrow
mènguè	boss
efirin	both
gbé	bother
bitèrè	bottle
labé	bottom
a sarafé	bought
Tougan yi	bounce
tougan afari	bound
a dan yi	boundaries
tambè walicé	bow
pani	bowl
poti	box
khamè	boy
gnènguè khamè	boyfriend
bèlèkhè rasoé	bracelet
binkhèyi	brain
ayi tankhoufé firin na	branch
marki	brand
bèlèkhèraté	brave
saria bindia taria	breach
tami	bread
abofé	break
déba	breakfast
khignè	breast
khiri	breath
yéngui fé	breathe
boncè	breed
briki	brick
fouti guinè	bride
falé	bridge
ayi fourera	brief
adèkhéma	bright
fan'nyi	brilliant
arafafé	bring
m'barin	bro
ayi gboki	broad
araminifé	broadcast
guiranè	broke
böfé	broken
sakhati	broom
ntara	brother
ma khamè oundia khamèma anama ma kvamètara khamèma	brother in law
akhani	brought
Yara förökhi	brown
brochi	brush
Siyon	bucket
nboré	buddy
Kobiri ma lankhi	budget
lagui	bug
tîî	build
bankhi	building
tî	built
ama lankhi	bulk
ningué khamè	bull
mayélé	bully
kounkourounbè	bump
kourpè	bunch
A ma balan fé cé koui	bundle
côté binyé	burden
aragaté	buried
ganfé	burn
boulafé	burst
aragata	bury
busu	bus
wouri bili khounkhouri malankhi	bush
lankhoundè	business
kerén toun	bust
ngbèlèhè soukhi gnaoukhi	busy
könö	but
Donny	butter
togo togoya	butterfly
boutongui	button
sareti	buy
nan	by
khoui	by the way
gnoungouî	bye
sansi nakhan kha bogui cé na khorira	cabbage
douguira gatédé	cabinet
koulè	cage
gateau	cake
ningué yörè	calf
khili	call
n'khili	call me
khiliti	called
doundouï	calm
afakhi	came
Kharé ra	campaign
noma	can
mou nöma	can't
abama	Cancel
cancèri	cancer
anoma	capable
nofé	capacity
manankounyi	capital
mikhi khoungbé kha wali rabakhi	caption
soukhou	capture
Woto	car
akha guinè	career
fé ma khounkhouri	careful
döyi	carefully
nakhan ma gnökhö sakhi akan khon ma	careless
gnökhösafé	caring
Kamou dèri	carpenter
dagui	carpet
carroti	carrot
khaninfé	carry
khanin	carry on
ara bafé	carry out
fé	case
cé yabakhi	cash
wolè	cast
bankhi bélé bélé tofanyi	castle
ra kéli fé	casual
gnari	cat
soukhoufé	catch
fé yabakhi	category
dalicé nakhan na möma mekhé yira gorè koui	cattle
soughoui	caught
a khonyi	cause
racolon fé	caution
kontofili	cautious
Gouloun Ba	cave
danfé	cease
koui fougué	ceiling
gnalakhin macén	celebrate
djelimani sama dèn nèkhè	cell
tägui	center
gnè kèmè	century
Nakhan boguicé khöri ara	cereal
khoulounyi	ceremony
andé	certain
nondi kiraya khoma	certainly
kèdi	certificate
dökhi a borera	chain
gogni	chair
tèguèfé mikhi yi a mou nö ma fén dé ra badé	challenge
lok	chance
massarè	change
fé ya i sokhi	chaos
bankhi	character
nakhan ma cèn ma ana kiya nakhè	characteristics
Cé tongokhi	charge
mikhé malifé	charity
ara yabout	charming
nakhan ma cenkhi printi ra	chart
coindé	chase
wöyèn ara	chat
saréfanyi	cheap
mounyè	cheat
tögnèguè	cheating
ya fenyi	check
beré	cheek
bèlèkhè bonbonfé	cheer
gnalakhin	cheerful
Cèwè ra ba fé	cheers
fènè	cheese
londi nakhan céé kha fé kharan ma	chemistry
mayoto	cherish
foulafé	chess
kanké	chest
bara khin	chew
tökhè	chicken
khountigui	chief
dumedi	child
diyorèya	childhood
Dimèdi	children
makhigbelifé	chill
gnèrèfé donyi	chimneys
kénkényi	chin
chocola	chocolate
iragué	choice
ama yegueti	choose
Ama cèguèfé a khouri ra	chop
walié	chores
nakhan kharè bélé bélé	chubby
chrétiens kha salidé	church
wouri koui guékhi	cinnamon
diguilin yi	circle
wakhati	circumstances
yamana di	citizen
ta	city
amakhorifé	claim
ara fikhè	clarify
kharanyi bankhi	class
bora kharé	clay
A ma khébou yalanyi bè	clean
afikhè	clear
mikhi nakhan kha wali na birafé kiti bankhi kèdi khafé fora	clerk
khakhili fan	clever
kiliyan	client
badè nakhan gorokhi a cetima	cliff
wakhati ma sarè	climate
téfé	climb
A ragata bè	clingy
tèmouin macénfé	clock
abalan	close
armoiri lan madi	closet
dom'ma	cloth
douguée	clothes
koré	cloud
raförökhi	cloudy
Mikhé ra yélé fé	clown
siguirè	clue
a bèlèkhè moun tinkhin	clumsy
Wouri bogué gbégbé malankhi salongni Kérén ma	cluster
mikhi ma tinkanyi	coach
tigué	coal
ba khon yi	coast
dougui Nakhan soma dougui gbètè fari	coat
käfé	coffee
nakhan noma kolondé	cognitive
arabafé khounyi khounyi ma	coincidence
khingbeli	cold
guirafé ara	collapse
boucé	collar
waliboré	colleague
borey	colleagues
amalanfé	collect
cé ma lankhi	collection
walidé boro	college
koulèri	color
doncé matidé nara anou gnogué ndé findima dénénkhè doncéra	colorless green ideas slept furiously
coulèri	colour
fari tagui khori	column
santi	comb
a gbakou aboréra	combination
soumbou	combine
fafé	come
fâ bé	come here
Na louna	come on
nakhan dounougnè ragnon ma ibè	comfort
ayiréfaï nama	comfortable
fafé	coming
faamaya	coming soon
faamä yäkösi	coming soon
cé commandi fé	command
wöyèn	comment
saradakhi	commercial
khèra	commission
arabafé	commit
khouyifouradè	commitment
yètèba	committed
wo nabilinyi nature cé	commodity
ékerin	common
wöyèn boré bè	communicate
woyèn na danguifé	communication
khabilè	community
siga nou fa	commute
ignèrè boré	companion
ana mamètifé	company
safé aboréma	compare
sa boré ma	comparison
itörö mikhi föra	compassion
boré kha khonè sentifé yètèkan ma	compassionate
Nakhan noun cé gbètè noma walidé	compatible
safé mikhi kha fé contre	compete
ikha wali kolonfé	competent
gnè	competition
findi fé a fanyira a birin bè	competitive
yecé masa	complain
yamasén	complaint
ara kamali	complement
aralankhi	complete
fewou	completely
agnamikhi	complex
a ra tin mè	compliance
ayayi sokhe	complicated
matokhè	compliment
ikhi sa akèyama	comply
gbata	composition
cour koui	compound
A fakha mou fé	comprehension
nakhan kerin ra	comprehensive
ayakhisokhi	compromise
tekou fé	compulsory
ordinatèri	computer
tii	concentrate
banban	concentrate
khakhili	concept
bèlèkhè soukhouidé	concern
anayama	concerned
khouliyi faré	concert
A ra yongui	conclusion
cimon ma sounbosounboukhi guèmè khorira	concrete
A ma saré	condition
A ma saré	conditions
auto	conduct
waliké kha malanyi	conference
nondi fala	confess
yigui	confidence
lankan nan	confident
sabati	confirm
gueré	conflict
minifé	confused
yayiso	confusion
i nouwali	congrats
Nakhan na Gnamanè gbégbé ma	congratulation
mou kha gnalakhin na woma	congratulations
naralanyi	conjunction
Sa fé ra a boré ma	connect
ikata han i cémasötö	conquer
khakhilima	conscious
khakhili maya	consciousness
khakhili kha tinyi	consent
yabi kobi	consequences
Ragata fé	conservation
nakhan cera gatama	conservative
soukhouï	consider
a findifé	considered
nakhan na binya	consist
cénakhé cigama eboréra	consistency
alankhi ama	consistent
ara kharakhi	constant
nakhan moura tima	constantly
fourou khara	constipation
atifé	construction
don	consume
dônyi	consumption
masotoki	contact
fouré nakhan noma radanguidé mikhi gbètè ma	contagious
nakhan na koui	contain
anayama	contains
yakössi cé	contemporary
mikhi ma yo fé	contempt
a kouicé	content
Gbatâ	contest
khakhili nakhan mä	context
cintinan	continent
aman kharaba	continue
ma tonkhoï	contract
fé ma souboufé	contrast
igbésafé	contribute
ndé fii	contribution
soukhou	control
féma guéfé	controversial
nakhan naba fé mou khörökhö	convenience
arabakhi	convenient
wöyènyi	conversation
masara	convert
falafé abè	convey
mikhi ratinfé fera	convince
tinfé féra	convinced
cé gninfé	cook
gninfé	cooking
afan	cool
ferabafé wonou gnamana gbètè	cooperation
kata fé	cope
bafata nerifounyi	copper
bognè	core
kabè	corn
dounkhi ra	corner
a tinkhinyi	correct
a cèti	cost
dom'ma	costume
bankhi wouri dakhi	cottage
guèssè fouté	cotton
sacé khourdi	couch
aramèfé	cough
nomanè	could
maraci	council
contifé	count
yirédi yanlankhi köbiri sama dèn'nèkhè walidé	counter
gnamanè	country
khaaré	countryside
iné eboréra	couple
dignè tongo	courage
kharanyi	course
gbelin afénfé	court
khouroui noun bingnè	courtesy
itenin khadi anamara iba khoundia khadi	cousin
felényi	cover
ningué guinè	cow
bognè gbé mou mikhi nakhan bè	coward
louki fanyi	cozy
guémba	crab
böfé a lan ma ra	crack
cé yalan fé bèlèkhè ra	craft
loufé bognè ma gnakhoui	crap
bombo ara	crash
doncé kholi mawafé	craving
yé ma safé fouri ma	crawl
dakhouï	crazy
fé yalanfé	create
cé nènè raminifé	creative
doni	credit
cé nakhan mighi fatéma	creep
ama gakhou	creepy
kounkui khoun gbé wali kèé	crew
fäkhè	crime
serinfé	cringe
Wakhati kha	crisis
critèri	criteria
maguefé	critical
khilikana	criticism
namounyi	crop
namouyé	crops
ama galanboukhi	cross
khöni förè	crow
yama	crowd
a ra fé	crowded
céra diguilinkhi nakhan sama khounyima	crown
gnakhoumè wakhati	crucial
bognèkhoroya	cruel
biyassi fé kounki bélébélé koui	cruise
yinsényi	crush
wafé	cry
kakoumbossi	cucumber
woboré ma soukhifé	cuddle
namounyi	culture
fèrè nakha a niyè ma i kha céndé sötö	cunning
poti	cup
dougui sa cé khoungbé	cupboard
sankaï danguidé	curb
dandan	cure
mikhé ma gaoufé fikari khoui ra	curfew
kounfa fé	curiosity
kounfa	curious
khoun sèkhè filincé	curly
köbiri khili	currency
gui lerima	current
yakössi	currently
dankè	curse
dougui nakhan sama nadèra	curtain
nsôkhö anamara ntenin kha di djinée anamara kha di khamè	cushion
namounyi	custom
i magnakhoun	customer
khossibili nakhé gnamanè nanin yi ma kantama	customs
mafintancé	cut
arayabou	cute
fé nékhé gbélin ma rabara	cycle
kourè ragui	cycling
nba	dad
m'baba	daddy
inakhan nabama lokho lokho	daily
khignè cé mati	dairy
cé nakhan a gnèma imou dangui	dam
Nakhan mou lankhi sawa bè ma	damage
Kiti ra kana fé	damn
aboundakhi	damp
faré	dance
ma gakhoui	danger
ama gaou	dangerous
ayi forèkhi	dark
nkhanounteyi	darling
Gbata fé	dash
khibari	data
lanlè	date
abè	daughter
lokhè	day
fakhè	dead
lokhö ragnonyi	deadline
tiulikhori	deaf
lan mafé	deal
a khori	dear
N'ga kérén'gney	Dear All
walikè boré khori	Dear Customer
Demnaya kangney	Dear Parents
N'ga kéréngney	Dear Sir
Kharandey	Dear students
Lankhoundè	Dear Team
saya	death
nyonkhonsösè	debate
yé khassabi nakhan goroma	debit
gnogué	debris
nökhè	debris
doni	debt
gnè fou	decade
gnin yi fouré	decay
fâkhi	deceased
Ma dakhoui	deceive
decebrou kiké	december
goro	decent
Natè ton go fé	decide
natè tongo fé	decided
loufé fekerén khanbira	decision
falé	deck
ndé bakhara	decline
rakhourounfé	decrease
agneningué	dedicated
nakhan wakili khi mikhi mali fé ma	dedication
wölifökhè	deed
tilin	deep
dalicé féri bélébélé kan yi	deer
kiya kobi	default
bombo	defeat
ratanga	defend
ayabafé	define
nondi kirayama	definitely
woyèn khoui	definition
kasabi	degree
walikècé	delay
magbilén khambi	delayed
éfacé	delete
Yètè ba	deliberate
khörökhö	delicate
gnökhonyi	delicious
Marafoulounyi	delight
gnalakhin	delighted
cé khaninfé mikhi khön ma	deliver
Khakhili tidé mou na khèmbè	delivered
a khanin fé	delivery
makhorinti	demand
makhörinfé	demanding
démocaci	democracy
yin'nè	demon
amacénfé	demonstrate
ya bä ara	denied
akha gboï	density
Mikhi Nakhan Yingui dandan ma	dentist
tondi fé	deny
khoundè	department
afolè	departure
minimä	depend
Ara lantan fé	deploy
asadé	deposit
dakhoui	depressed
dakhouiya	depression
a kha tilin yi	depth
A ma tonkhouma fé	describe
anakiènèkhè	description
Mèyèn yi gbé gbé na dèn nè khè	desert
a lama ma	deserve
khakhili dé	design
soukhandi	designation
wakhonyi	desire
wali bankhi	desk
khakhili tidé mouna	despair
yiguitèguè	desperate
hali ali	despite
ményi ta	dessert
sigadé	destination
maraguiri	destiny
känä	destroy
kanafé	destruction
détayi	detail
détayei	details
to	detect
wakiliya	determination
natè tongofé	determine
Kélifé i ti i khayi kha fan	determined
tagan'nè	devastated
ara yiriwa	develop
sigua yaré	developed
Yaré ma siguè	development
Soumouyi	device
gnin'nè	devil
fé khörökhö rabafé	devoted
Dhivehikhoui	Dhivehi
diyabèti	diabetes
fouri raguéré	diarrhea
kouki lan ma rendez- vous sèbama nahan koui	diary
bouki nakhan sèbèli kia falama	dictionary
araba	did
fäkhä	die
afakha	died
dari donsé	diet
nakhan ey bama ey boré ma	difference
keren mara	different
a khörökhö	difficult
gué	dig
khörè ya	dignity
Cèmbè sötö fé ikha wali ma	diligent
dègué	dinner
gorofé a khora	dip
tinkhinyi	direct
sigadé	direction
sigädé	director
nökhè	dirt
Nokhè	dirty
rakhoubén	disable
rakhoubén	disabled
louèfé	disappear
donyi donyi	disappointed
kanari	disaster
bâ koui	discard
bâ ä khoun	discharge
khouroufé	discipline
ce saré ra gorofé	discount
sengué a tofé	discover
cé khouroun fé	discrimination
woyèn yi masarè	discuss
dèmasara	discussion
fouré	disease
fourey	diseases
Nakhan sama wo noun cé gbètè kha ma niè	disguise
amakhilici	disgusting
paaney	dish
cé nakhan fari ma salakhounkhi	dishes
bä a yama	dismiss
ra sanbè	dispatch
ama kèni fé	display
kiraya	disposal
gnôkhôn sôssô	dispute
makouyè	distance
abafé ayama	distinct
ayeguetifé	distinguish
bögnèmini kobi	distress
takhounyi	distribution
khaaré	district
yi din fé ara	disturb
yé nokhè danguima yeli nakhan koui	ditch
Goro fé a khoun ma	dive
möli gbégbé	diverse
cé wouya yi	diversity
täkhoun	divide
nakhan kéli khi Allah ma	divine
fatanyi	divorce
khouma gui fé	dizzy
araba	do
ibara	do you
eské n'nafan ima	do you love me
mikhi dandan	doctor
kèdi	document
araba	does
mou	doesn't
baré	dog
Dogrikhoui	Dogri
rabafé	doing
bébédi	doll
mikhi kha bokhi	domain
nakhan na moma bankhi	domestic
Nakhan nokhi ara	dominant
inakha raba	don't
ali nakha kontofili	Don't worry
fi	donate
maraba	done
khié fanyi	donkey
yèmbègnakhi	dope
agnondon firin	double
sika	doubt
farin fougni	dough
aboum ma	down
A sötö fè ordinateur koui	download
walima todé	draft
Salakhoun fé	drag
Yé gnèrèma Nakhan koui sigafé lakoè	drain
fé nakhan ma kinikini	drama
a tongomaraba	draw
cé sacé nakhan fatoukhi sadéra	drawer
dessèn naba	drawing
gakhou	dread
khié	dream
donma kouyé	dress
gué	drill
yeminfé	drink
khaninfé	drive
aya	drop
bara birâ	dropped
sogué fouré	drought
bara sisi	drunk
akharé	dry
doki	duck
sèguètala	dude
makhilifé	due
guifé n'a gné	due to
Nakhan mou ma yanba ma	dull
khakhili taré	dumb
aragorodé	dump
bouu	duration
lèèri	during
khougbé	dust
nakhan lan araba	duty
Loufé yiré aibada	dwell
fäkhäfé	dying
nakhan yo	each
ey boré	each other
ma guinè nou ma khamè	eager
Khoni khoun gbé	eagle
touli	ear
sin'nè	earlier
sin nè	early
gueni	earn
touley	ears
bokhi	earth
bpokhi sèrèn	earthquake
ara sonya	ease
döyi	easily
kiya nakhè	east
amou khörökhö	easy
a donfé	eat
nakhan donma	eating
saré masarafé	economic
sötösé	economy
a cèti	edge
masara	edit
iyo nkhanounteyi	education
a wali	effect
fé nakhan yabi tokhi	effective
yabi fanyi sötöfé céra nakhan nou mamèkhi	efficiency
Fé nakhan yabi tokhi	efficient
wakili	effort
tokholè	egg
köbö köböï	eggplant
ikérén kha khèri ma gnökhounfé	ego
solomasakhan	eight
foun noun solomasakhan	eighteen
tongo solomasakhan	eighty
nakhan yora	either
a yaba fé	elaborate
bèlèkhè khimbi	elbow
tära	elder
gnè	elderly
tofan	elegant
sé	element
Sili	elephant
fou noun kérén	eleven
tinfé ama	eligible
bä a yama	eliminate
khatin	else
khatinkhi	embarrassed
yiguitèguè	embarrassing
tofanyi	embrace
Kélifé yiré lan ma siga fé yiré khoun gbé	emerge
nakhan laman araba yakossi	emergency
nakhan fama kinikini ra ima	emotional
yètè kan safé mikhi gbètè loudé	empathy
Fé fakhamou ki	empathy
woyèn ki	emphasis
Ligne sa fé cé boun ma	emphasize
Na khan walifé Lan khoun dè ndé bè	employee
walikey	employees
wölidé	employer
rawalifé	employment
cemakoui	empty
aradèkhè	enable
ara lanyi fé	encounter
bognèfifé mikhima	encourage
ranyon'yi	end
nakhan na louè fé kirafari	endangered
wakili	endeavor
Kosso kassa	endurance
torè	endure
gnakhoui	enemy
sèmbè	energy
yètèba	engage
yètèba	engaged
yètèba	engagement
motèri	engine
mikhi nakhan kha wali na yamakotafera	engineer
anglais khoui	English
safé khouma	enhance
amatökhofé	enjoy
agbé	enormous
agbégbé	enough
ara fikhè fé	ensure
so	enter
béré	entertainment
ira yalakhin fé	enthusiasm
sèwakoui	enthusiastic
a birin	entire
khili sofé céyi inakhan yalankhi	entitled
nakhan cé ma cén khi	entity
sodè	entrance
sarémati lankhoundè khounyi	entrepreneur
envelöpou	envelope
wo na bilinyi	environment
kholi	envy
fé falafé imou nakhan ma gnökhoun	epic
fouré ralantankhi	epidemic
alan	equal
walikècé	equipment
takhounyi lankhi	equity
kérén	equivalent
lan	equivalent
chifon	eraser
tantanyi	error
a gui mekhé ma	escape
agbéngbényi	especially
sèbèli	essay
yé nakhan sama macini cé koui	essence
agbéngbényi	essential
ma banbanfé	establish
ama banban	established
ikha bokhi	estate
féma khasabikhi	estimate
bara yaté	estimated
anoun	etc
koundè	eternal
khakhimayey	ethics
gbata	evaluate
gbata	evaluation
hali	even
khali	even though
noun maré	evening
fé	event
donghöra	eventually
sonon	ever
nakhan yo	every
birin	everybody
sigadé	everyone
abirin	everything
cedé	evidence
amoufan	evil
Siyon	evolution
ma sara fé	evolve
Ewekhiui	Ewe
fori	ex
nanara	exact
naki yati	exactly
gbata	exam
mato	examine
amisali	example
danghi ara	exceed
A fan yi a gbéra	excellent
fo	except
fo	exception
dangui a ra	excess
nakhan gbo	excessive
masara	exchange
ama khoyifé	excited
gbätäfé	excitement
marafanyi kirama	exciting
cé nakhan na gatakhi mikhi bè	exclusive
dignè	excuse
dignèn ma	excuse me
fäkhä	execute
arabafé	execution
khoui soukhoui	executive
arawali	exercise
tagangni	exhaust
taganyi	exhausted
cé dèntèguè fé	exhibit
cé ma kèninfé	exhibition
kerén	exist
nakhan na	existence
nâ na	existing
minidé	exit
yarémasiguè	expand
mamèti fé	expect
abara mè	expected
kobiri ra wali fé	expenses
a khori	expensive
khakhili sotöï	experience
mato	experiment
nakhan londikhi féndema	expert
bara fori	expired
alankhama	explain
yamasén	explanation
arawali fé	exploit
aya fén	explore
khanin fé ta gbètè	export
masén	expose
masén	exposed
abö ara	exposure
wèyénfé	express
falè	expression
kènè	extend
rakouyakhi	extended
ayigbofé	extension
mayi talè	extent
a fari	external
arakhoubén	extinct
gbètè	extra
tongo è bä koui	extract
nakhan möli mouna	extraordinary
dangui fé limite	extreme
a khörökhè ra	extremely
ya	eye
ya	eyes
dougui dèguètaré	fabric
fanyira	fabulous
gbakoufera	face
rasönèya	facilitate
sabatifé yiré	facilities
sönèya	facility
arabat	fact
mikhi nakhan kèdi cèbèkhi takhoun ma	factor
uzini	factory
nondi	facts
louè fé	fade
loufé ima sotö	fail
Lossi fé	failed
danguitö	failure
ayelifou	faint
abirin lan	fair
agbé agbé	fairly
dali guinèma nakhan mouna	fairy
bögnè	faith
Nakhan birakhi cé Kérén fökhöra	faithful
woulé	fake
tèmoui nakhan na khimbeli tèmoui noun kefouré tèmou tagui	fall
woulé	FALSE
Colon fé	fame
baria	familiar
dembaya	family
kamè	famine
saré	famous
mafintancé	fan
beré béréya	fancy
anakhan gnökhon	fantastic
kouya	far
gnounkhoui donkhè	farewell
sansi cifé	farm
khèsaa	farmer
makhoyi	fascinating
daki	fashion
ama froi	fast
touŕé	fat
fäkhè	fatal
maraguiri	fate
Nba	father
khoungbé ki	fatigue
kiya kobi	fault
ara fama	favorite
malifé	favour
rafanfé	favourite
gakhouï	fear
dègué khoulounyi	feast
khoni khabé	feather
fé ragnèrèkima	feature
A da ki	features
Fevrier kiké	february
bara lan m'bè	fed up
asaré	fee
donyicé	feed
gbelinyi	feedback
yètèkoloyi	feel
maranfanyi fafé bögnè ma	feeling
sènyi	feet
arabira fé	fell
n'gakérén'nyey	fellow
kalé	felt
guinè	female
sansanyi	fence
mô rafoura	fertile
malanyi sigui fé ma	festival
siga a féndé	fetch
dègué	fever
Siya	few
dondoroti	fewer
köbitifé	fiance
nakhan mouna nondira	fiction
khè	field
khagnè	fierce
fou noun souli	fifteen
tongo souli	fifty
Gueré ma soé	fight
guéréfé	fighting
contié	figure
wakilifé	figure out
kèdi	file
arafé	fill
ara fé	filled
filimou	film
nökhi	filthy
guelimani	finally
köbiri fé	finance
nafouli é	financial
tofé	find
kolon	find out
to	find out
afan	fine
bèlèkhè	finger
dièfé	finish
gnon'nè	finished
tê	fire
lankhoundè	firm
cindé	first
bari khili	first name
yèkhè	fish
akhalama	fit
souli	five
yalanfé	fix
ratî	fixed
drpo	flag
céma koinyi	flash
gbata	flat
cé kha fékobi	flaw
Nakhan fan	flawless
guii	flee
khèndè	flesh
a mougnè	flew
ayètè ragbilén	flex
börökhö	flexible
aviyon	flight
ragbélén fé	flip
marafanyi nakhan mou bouma	flirt
mayotofé	flirting
lou a fari	float
yé din tama	flood
guéni	floor
farin	flour
filifé	flow
fleuri	flower
magué	flu
fätä faladé	fluent
a fangnira	fluently
cé nakhan khabé tikhama	fluffy
nakhan goro ma sonèya ra	fluid
mougnè	fly
wakilifé	focus
kounda	fog
Yé khöri Kérén Kérén	foggy
föghi nakhan louma douguima ina isa	fold
mikhé	folks
birafé a fora	follow
bira fökhöra	follow up
nanou dangui	following
baloé	food
däkhoui	fool
dakhoui	foolish
Sanyi	foot
balon	football
bè	for
misali	For example
i na mato	for instance
i gbé	for you
ara tongnikhi	forbidden
sembé	force
tofé sin naï ma	forecast
tigui	forehead
khognè	foreign
woula	forest
Koudèyi	forever
nèmoufé	forget
dignè	forgive
nèmounè	forgot
frousèti	fork
fikhèyama	form
nakhan kelikhi yaréra tiyé ma	formal
forima	former
Allah bara i ma li	fortunately
köbiri gbégbé	fortune
ton naanin	forty
tongo naanin noun féré	forty-two
singuéra	forward
sonèya fifé mikhima	foster
a guerénè	fought
abara to	found
a folè	foundation
nani	four
fou noun naani	fourteen
dalicé nakhan maniè khi baréra woulakoui	fox
ayelefou	fragile
nakhan cerabilin ma	frame
nakhan walèkhè khoun gbé rabilinkhi	framework
fé ra tonfé	fraud
cegnè	freak
asarémou fima	free
sagoya	freedom
yé findi a gkhoutira khinbeli ra	freeze
ra bafé tèmoui gbégbé	frequency
wakhati birin	frequent
lèri birin	frequently
khindé	fresh
youmè	friday
yé khinbelicé	fridge
boré	friend
beré béré ya	friendly
borée	friends
boréya	friendship
gakhou khi	frightened
guéréfé	frightening
khougnè	frog
kabi	from
yaré	front
gninghi	frozen
youri bogui	fruit
khonofé	frustrated
karacil	fuel
Doulèkhoui	Fulfulde
A birin	full
amabéré	fun
kha wali	function
agbéngbényi	fundamental
maragatèï	funeral
mahelikhi	funny
dalicé ndé faté kiri	fur
magakhui	furious
bangui cé	furniture
ama kouyakhira	further
gbètèman	furthermore
douniara guiri	future
guéni	gain
béré sé	game
kouyè nakhan na cé firin tagui	gap
woto nou moto yalandé	garage
nogué	garbage
jardin	garden
sansi nakhan khönö	garlic
nadè khoungbé	gate
amalanfé	gather
malangni	gathering
mésuré	gauge
fii	gave
cé nakhan mouma tangama	gear
kiya	gender
ara lankhi	general
ara lankhi	generally
Nakha ara mini ma	generate
nekhé barikhi gnè kerén	generation
fanyi	generous
khakhlifanghi	genius
céé kiya	genre
doyi	gentle
alankhima	genuine
mara makhè	gesture
sötè	get
dom'ma so	get dressed
keli	get up
allah kha sönèya fii ima sin'nèma	get well soon
ama sötö fé	getting
yin'nè	ghost
toubari	ghosting
bélébélé	giant
fiman	gift
gnönkhomi	ginger
guinè demédi	girl
n'gnènguè	girlfriend
finma	give
gbelin afora	give up
bara fi	given
gnalakhin	glad
iya wölè ina mato	glance
tonbili	glass
lunètey	glasses
to	glimpse
dounouya	global
ayi forè	gloomy
gan	gloves
A ma dèkhè fé	glow
dekhè fé	glow up
cé Fatou cé	glue
siga	go
wonkhai	go ahead
i makouya	go away
i masiga	go away
siga i sa	go to bed
akhounyi	goal
khayi	goals
mori	goat
allah	god
ala khi ratanga	god bless you
sigamä	goes
sigafé	going
sigafé	going to
khèma	gold
abara louè	gone
mänè	gonna
karafé	goo
fan	good
wofègnè	good afternoon
won djèsèguè	good bye
lökhè fan'yi	good day
wo nounmaré	good evening
wali fan'yi	good job
tofan'yi	good looking
Fé fanyi	good luck
tanàmoufègnê	good morning
i kèna m'bögnè	good morning my love
allah kha won khi khèri	good night
wo na tèmou	goodbye
allah kha wo khi	goodnight
sey	goods
Google	Google
google translate	Google Translate
khoni fikhè nakhan na möma	goose
a tofanyira	gorgeous
sonkhè	gossip
nakhan sotö	got
fakhamou	got it
sötö	got it
kolon	got it
mènguè sanyi	government
famoufé	grab
matéya	grade
kérén kérén	gradually
guè kharandé	graduate
khöri	grain
fi sé	grant
fiinè	granted
rézèn	grapes
tongo fé	grasp
sekhè	grass
fécolonyi	grateful
fé kolonyi	gratitude
gabouri	grave
nakhan khoubé daghi	gray
afanyi	great
körökörö	greed
khakhili khörökhö cefara	greedy
bourakhè khindé	green
khèbou	greet
khèboufé	greeting
khèboui	greetings
förè	grey
sansanyi	grid
gnon yi	grief
findi fé afouyira	grind
bèlèkhè konyi	grip
döncé matidé	grocery
khamè fouikhi	groom
nakhan mou khourou khi	gross
bökhi	ground
gnama malankhi	group
awama nakhan khonma	grow
khoungboey	growth
nakhan kha yakhaseri ma sa mou gnön ma	grumpy
Guaranikhoui	Guarani
fé khori	guarantee
ara gata	guard
iyètè makhorifé	guess
khili binyè koui	guest
marasiyé	guidance
yarati	guide
nakha ara bakhi	guilty
khamè	guy
sèguètala	guys
béré ra bama dèn nèkhé koui	gym
deri	habit
banghi	habitat
anouna	had
yé khouti khounkhouri	hail
akelidé	hair
atagui	half
sodè	hall
bèlèkhè	hand
nakhoun yi	handle
tofangni	handsome
gbakou	hang
magnèrè tandé	hang out
rabä	happen
a rabanè	happened
khèri	happiness
sèwè	happy
ignè nènè	happy birthday
i gnè nènè	happy birthday to you
gnènèné	happy new year
a khörökhö	hard
saria safé ama	hardly
a tokhonö	hardly ever
mikhi kha fegnakhi magnokhifé	harm
moufan	harmful
lanyi koui	harmony
fé ma khörökhè	harsh
ba	harvest
yira	has
ara gnakhou ama	hate
moun	have
ala khi kha lökhè sönèya	have a good day
wo fègnè	have a nice day
dèbâ	have breakfast
béré	have fun
i bara idègué	have you eaten
yira	having
nakhan magawou	hazard
nakhan na kounda dakhi	haze
ä	he
nâ yira	he has
atan	he is
ara gnèrèfé	head
nkhounyi nkhonoma	headache
yalanhi	heal
yalankhi	healing
n'a fikhè	health
nbara tantan	healthy
a kharamè	hear
mounafanyi	heard
sondonyi	heart
kéfouré	heat
ardiana	heaven
binya	heavy
mikhi nakhan khounyi fouradè	hectic
akha kouya	height
kè	heir
sofé mikhi khonyi a khanbi yakha cé mougnè	heist
guelimani	held
biyaci	hell
inou wali	Hello
ikèna nkhanounteyi	hello dear
wo kèna tanayo mou na woma	hello how are you
I kèna tana moukhi	hello how are you doing
khounyi magagacé	helmet
malifé	help
mounanfanyi	helpful
iti imou tin	hence
akha	her
dalicé gnama nakhé ra mokhi ta koui	herd
bé	here
gnamanè koui cé	heritage
sikèfé	hesitate
hé	Hey
inou wali	Hi
ä rabakhi di	hi how are you
wo nouwali	Hi there
nökhounkhi	hidden
A nakhoun	hide
mikhé sougandi ki ikha walima	hierarchy
koré	high
Korin fé	highlight
ma gnèrè fé a khon koué	hike
yiré rabilinfé	hiking
yéléma fé	hilarious
gueya	hill
ä	him
tongoma	hint
tagui	hip
tagué yé	hips
atongo walidé	hire
tongofé akha wali	hiring
agbé	his
féfori	history
bomboè	hit
Hmm	Hmm
tan na dangui	hobby
soukhoui	hold
mamèti	hold on
yili	hole
malaboui tèmoui	holiday
cé mou na nakhan koui	hollow
bankhi	home
banghi wali	homework
tinkhinyi	honest
nondi koui	honestly
nkhan nounté	Honey
khoun na keli	honor
woto dèra coté	hood
gbakoufé	hook
cé nakhan samaa bérée khoun ma a yalandé	hop
khakhili didé	hope
ala makhandi	hopefully
yiguitèguè	hopeless
nakhan italakhi	horizontal
féri	horn
Cé Nakhan ma gakhou	horrible
bögnèmini noun gakhoui	horror
choé	horse
labitani	hospital
mikhi yiguiafé	hospitality
coté	host
gnakhouï	hostile
afourakhi	hot
wotèli	hotel
lèri	hour
lèri	hours
Fé ma gnökhoundji	house
dembaya	household
di	how
itan go	how about you
tanàmoufègnê	how are you
arabaxi di	how are you doing
tanayo mou oma to	how are you doing today
i nâ di to	how are you today
â nâ di	how do you do
nâdi	how is
yéri	how many
yeri	how much
ya yeri	how often
ignè yerara	how old are you
yangui danki di	how was your day
ikha kouwè nou nadi	how was your night
natan	however
tökhè khèlè dèn nèkhè na nèrfoui dakhi	hub
fouti khamè	hubby
a koui	hug
agbo	huge
mikhi	human
Börökhè sonèya	humble
boundakhi	humid
Khimbélii	humidity
kèmè	hundred
kamètoyè	hungry
koïn	hunt
Foé khoun gbé noun tounè khoun gbé	hurricane
gbatakhi	hurry
i mafoura	hurry up
makhonè	hurt
Nma mori	husband
gnanprou yén yi	hustle
bankhi khouri Nakhan tikhi wouri ra	hut
mènifé santéyama	hygiene
N'tan	I
ntana iki	I am
sésé mou n'ma	I am fine
n'fankhi	I am fine
a mou nä ki yo ki	I am fine
n'nouma	I can
nmou noma	I can't
n'na rabama	I do
m'ma kolon	I do not know
m'ma fakhamou	I do not understand
m'mou	I don't
ma kolon	I don't know
n'ma famoukhi	I don't understand
i nakhan falafé m'ma fakhamoukhi	I don't understand what you mean
m'mou i fakhamoukhi	I don't understand you
m'ma kolon	I don’t know
m'a fakhamoukhi	I don’t understand
â loukhi m'bè	i guess
sötönè	I had
ntan	I have
m'bara li	I have been
n'nala makhadima	I hope so
n'nakolon	I know
a rafan m'ma	I like
irafaman han	I like you
rafan m'ma	I love
n'târa khamèma rafan m'ma	I love my big brother
n'târa djinèma rafan m'ma	I love my big sister
m'ba rafan m'ma	I love my father
n'khoundja khamèma rafan m'ma	I love my little brother
n'khoundja djinèma rafan m'ma	I love my little sister
n'ga rafan m'ma	I love my mother
I rafan ma	I love you
I ra fan nma han	I love you so much
i fan nafan m'ma	I love you too
wama a falafé	I mean
ikholinan ma	I miss you
i khöli nä m'ma yaati	I miss you so much
na tokhî	I see
ntan bè	I think
nbara afamou	I understand
nwama	I want
n'wama i tofé	I want to see you
n'wama i khon'ma	I want you
guifé	I was
sobè	I will
N'nou findima	I would be
n'na kiya nèkhè	I'm
nkèndeyakhi	I'm fine
tana yo moun ma	I'm good
n'nâ bé	I'm here
Nbara tantan	I'm sorry
gläci	ice
crèmoun	ice cream
khakhili	idea
nakhan fan	ideal
kérén	identical
ikolon maki	identify
lambé	identity
khakhili taré	idiot
rakharakhi	idle
iyo	if
nemoufé ama	ignore
nsiga fé	ill
mouna sariya koui	illegal
fouré	illness
llocanokhoui	Ilocano
prin ti	image
magnönyi	imagine
yaya	immediate
yaya	immediately
bélébélé	immense
Fökhi	impact
Hawouyè	impatient
safé walidèma	implement
arafafé	import
mounanfanyi	important
mikhi ratinfé cera tékou	impose
mou nöma rabadé	impossible
dèyikhara	impress
toki	impression
makhéboui	impressive
akhoumasafé	improve
amasara	improvement
kui	in
sä fari	in addition
bafé na ra	in addition
Nakhara	In fact
ya ra	in front of
alako	in order to
Ma sarè	inappropriate
säré	incentive
gnokhon sösö	incident
alou ayama	include
ya mâ	including
sötö köbiri	income
nakhan mou fan	inconvenience
akhoun masafé	increase
bara maté	increased
kabananfé	incredible
nakoui	indeed
Loufé iyètè kha nini boun ma	independent
Indi	India
macénfé	indicate
bökhi kangney	indigenous
kerenyira	individual
céyalan bankhi	industry
amounoma matangadé	inevitable
diyörè	infant
nokhè kha yaré masiguè faté koui	infection
Cé Nakhan mou yon ma	infinity
fountounfé	inflammation
Saré khoun ma sa fé	inflation
mirinyi	influence
rakolon	inform
ara gbelinfé ma	information
cénakhé sougandima céyalanféma	ingredients
kè sötöfé	inheritance
afourimaki	initial
férakelifé	initiative
makhönö	injured
makhönè	injury
loufé	innocent
fé nènè	innovation
makhonriyi	inquiry
dakhoui	insane
dalicé khounkhouri nekhé tougan ma	insect
makhantakhi taréya	insecure
araso akoui fé	insert
a koui	inside
abara to	insight
insisité	insist
khî khöli taria	insomnia
foyé ratéfé	inspiration
foyé bindouné	inspire
sabatifé	install
missali	instance
fé nakhan na bama yakössi	instant
gui sakhanyi	instead
bénoun	instead of
masén'gni	instructions
béré sé	instrument
kombi	insult
lan kan na	insurance
A na kinakhè	intact
belèkhè fokhè	integrity
khakhilima	intellectual
khakhilima ya	intelligence
khakhili fan	intelligent
waamä	intend
waanè	intended
agbo	intense
ya nigué	intention
woyènfé a bè	interact
wöyèn boré bè	interaction
mounafanyi	interest
nakhan wama	interested
tidénana	interesting
sofé etagui	interfere
nakhan na tagui	intermediate
A koui	internal
gnamanè gbé gbé nakhan kolon	international
Tèmoui Nakhan na bama walidé ikha	internship
khoui ma dangifé	interpret
kouiuï radangui	interpreter
rati	interrupt
soumoukhi	interview
yiré yi khoutoukhi	intimate
A koui	into
rasofé akoui	introduce
afölè	introduction
a ma balankhi a yètè ma	introvert
fé kolon fé ama kènènkhira	intuition
moufan	invalid
Cé yalan fé Nakhan mou na	invent
Cée khili cèbèkhi kèdi ma	inventory
kobiri rawalifé féndé dekoui	invest
yafén	investigate
khili	invitation
khognè khilikhi	invite
saré cèbèma bouki nakhan koui	invoice
nayamafé	involve
anayama	involved
ouré	iron
na	is
ile	island
lou a kérén na	isolated
mantöröli	issue
makhorin	issues
atan	it
guinara	it is
nou nä	it was
nara	it's
a fan naki	it's ok
a fan naki	It's okay
sésé mara	It's okay
sé	item
sey	items
a kha	its
nan n'na	I’m
n'nä	I’m
koti	jacket
guéli	jail
janvier kiké	January
fleuri sacé	jar
bangan yi	jaw
tönè	jealous
ra tagan khi	jerk
toulirasé	jewelry
wali	job
maguifé	jogging
Siga fé i sa alina	join
Ra dökhö dé	joint
béréfé	joke
khibari finyi	journalist
biyaci	journey
gnalakhin	joy
kitila	judge
ju	juice
juillé kiké	july
tougan	jump
gnè kiké sén ni yandé	june
chinoué kha namoui kounki dougui khirikhi ama	junk
toun	just
itan kha raba toun	just do it
kiti sadé	justice
ara fikhè	justify
Kalaallisutkhoui	Kalaallisut
rafanféma	keen
donjon	keep
lou a rabara	keep it up
bara ragata	kept
kitili	kettle
sabi	key
fi sangnira	kick
dimè	kid
baréfé	kidding
rein	kidney
dimey	kids
fäghä	kill
gui mikhi	kind
akiandé	kinda
yandi	kindly
fan'gni	kindness
manguè	king
soumbou	kiss
khouri	kitchen
dimé kha bérécé yalankhi foyé nakhan natéma koré	kite
gnari yorè	kitten
khinbi	knee
kolon noun	knew
finè	knife
shouéragui	knight
kolonyi	know
kolonyi sötofé ama	knowledge
kolon	known
Konkanikhoui	Konkani
Kriokhoui	Krio
kèdi kha sama	label
wôli	labor
wali	labour
a lougue	lack
samè	ladder
guiney	lady
a dokhö	laid
khouré	lake
yèkhè lan ma	lamb
agoroma sanyi ma	lame
lampou	lamp
gorofé piste ma	land
ya milè	landscape
nènyi	language
Dèn nèkhè a niè ma san yi kha no kountan dé	lap
khoungbé	large
ara gnonyi	last
aragnonyi anou agbéngbényi	last but not least
i lambé	last name
khambi	late
donkhöéra	lately
danguikhambi	later
nènè	latest
donghouwè	latter
ragnon'yi	latter
yeléfé	laugh
inou yéléma	laughing
mayélé	laughter
khilisotè	launch
dom'ma kha yiré	laundry
saria	law
ballon bonboiè beredé	lawn
kita ça	lawyer
a dokhö	lay
sa	layer
asa page ma	layout
tounna khonoè	lazy
a khaninfé	lead
mènguè	leader
bourakhè	leaf
gui fé	leak
khàré	lean
touganfé	leap
tinkanyi	learn
kolonfé	learning
cé yefoufé ikha sarefi	lease
khatinyi	least
faté	leather
siga	leave
kèdié	leaves
yara khan	led
a kola	left
sanyi	leg
kè	legacy
säriya koui	legal
mikhi khoungbé kha wali rabakhi	legend
Nakhan na kira khoun ma	legit
dondoroti	leisure
yefoufé	lend
kouyè	length
Cé nakhan mou gbö	less
karanfé ikha fé dé matinkan	lesson
A lou na	let
Kèdi youngoui	letter
khignènama	lettuce
dandé	level
nivo	level
mai té cé kha yabi	leverage
kountigui	liability
bouki malan dé	library
iyi inènyi ra dangui céfari	lick
woulé	lie
woulé	lies
dounignè	life
técé	lift
tèdèkhè	light
galènyi	lightning
allo	like
tèmoundé	likely
abirin kerén	likewise
linyin	line
Lingalakhoui	Lingala
gbakou	link
bartè	lion
yé	liquid
khiley	list
aramèfé	listen
ramèfé	listening
afèma	literally
cèbéli tié kha fé cèbè khi	literature
litri	litter
khourinyi	little
iki	live
bognè	liver
dökhi	lives
dökhi	living
banghi	living room
kassa	lizard
ma sarafé	load
tamira diguilinkhi khoungbé	loaf
na khan wama férabafé	loan
khonyi cé	local
asadé	location
balan	lock
balan	lockdown
aragatafé	log
mdr	lol
kérin	lonely
a koué	long
a bara bou m'mi to	long time no see
amatofé	look
tagui khiricé balancé	loop
Nakhan mou faatou ma	loose
allah	lord
a ba iyi	lose
perdi	loss
louè	lost
bokhi	lot
sinbé	loud
khoun ma khaba dé	lounge
arafan	love
irafama	love you
tofanyi	lovely
yelefoui	low
magoro	lower
saria mikhia	loyal
Rakhara fé cé Kérén ma	loyalty
yabi fanyi anamou kobi	luck
sotofanyi	lucky
Lugandakhoui	Luganda
coté	luggage
cé donkhè nakhan louma cé bèrakhi ya ma	lump
dèguéfé	lunch
yöfõ	lungs
cé nakhan kèya tofan nakhan saré khörökhö	luxury
sakhi	lying
machini	machine
dakhoui	mad
guinè foutikhi	madam
raba	made
ara so akoui	magazine
A tofan yira	magnificent
guinè cegninyi	maid
agbéngbényi	main
dinkhèï	maintain
Soumouyi	maintenance
Maithilikhoui	Maithili
a khoungbé	major
ey gbégbé	majority
araba	make
ira tonfa fé	make up
khamè	male
sarématidé khoungbé	mall
khamè	man
a ra yèrè fé	manage
ara yèrè fé	management
walidé kountigui	manager
itin imou tin	mandatory
fälä	manifest
Ara yèrè fé	manipulate
arabaki	manner
bèlèkhè ra	manual
agbé agbé	many
gbélén ma gbé gbé kha gnalakhin to	many many happy returns of the day
marsi kiké	march
kèdi dèn nèkhè mou cèbè ma	margin
Makiti	market
fouti	marriage
fouti khamè	married
A ma koto fé	mask
gnama	mass
bélébélé	massive
karamokhè	master
a lama	match
dèfa boré	mate
cé	material
Kontié kha kharan yi	math
cé	matter
Khakhili kha moè	maturity
noma	may
temouindé	maybe
ntan	me
anoun fan	me too
donyi	meal
fèrè	mean
nanan naki	meaning
fèrè	means
n'naiyinè	meant
na wakhati boun ma	meanwhile
A ma niyè fé	measure
maniè	measures
soubé	meat
céridakhi	medical
seri kharan yi	medicine
khakhili rafouloun	meditation
fèrè	medium
wo aranlanfé	meet
malanyi	meeting
Meiteilonkhoui	Meiteilon
arakhounoun fé	melt
khakhiley	memories
aratoufé	memory
khakhili	mental
walifanyi youssi	mention
ama tinkhè	mentioned
karamökhè	mentor
sarémati	merchant
Allah kha dignè	mercy
rasonèyakhi	merely
Issa barigné gnalakhin yi	merry christmas
gnakhasi	mess
gnounkhoui	message
agnakhacikhi	messy
wouré	metal
akèya	method
gnènè	mice
tagui	middle
kouwè	midnight
anoma	might
benin	mild
fé singué folofé	milestone
sörri	military
khinyè	milk
million	million
khakhili	mind
Khakhili kiya	mindset
amafén	mine
ama soumboufé	mingle
nakhan tidé mou gbo	minor
miniti	minute
minitey	minutes
kabanako	miracle
kiké	mirror
masoumboui	miscellaneous
mikhi nakhan khounyalan amafan kota	mischievous
ama kinikini	miserable
torè	misery
amou kamalikhi	miss
i kholi nan ma	miss you
louwèkhi	missing
khèra	mission
Yé Nakhan bira Kélifé koré ma	mist
tantanyi	mistake
Mizokhoui	Mizo
cé nakhan na makha	mobile
mäyélé	mock
amaniè	model
langhi a ma	moderate
nènè	modern
nakhan mou a yètè yi falama falama	modest
boundakhi	moist
khingbeli	moisture
cé sa cé nakhan a kiya ma sara ma	mold
dalicé lanma nakhan na böghi boun ma	mole
nga	mom
tèmoui	moment
wakhati	moment
lèri	moment
tenin lökhè	monday
kobiri	money
Mikhi Nakhan mikhé ra kharan ma béré kha fé ra	monitor
bouboudi	monkey
kiké	month
ikha bögnèma fé	mood
Nakhan louki ma sara ma	moody
kiké	moon
khakhilifé	moral
ndé	more
man	moreover
djècèkhè	morning
saria nakhan na bankhi tigui fari	mortgage
agbé agbé	most
Nakhan yati ara	mostly
fé sougandikhi	mother
litanyi	motion
nakhan agnèma ibögnè kha té ferabafé ma	motivation
gueya	mountain
gnènè	mouse
dè	mouth
asadé masara	move
ramakhè	movement
Fé pècè dakhi Nakhan ma toma ma to cé koui	movie
Guinè Nakhan fouti khi	mrs
agbébé	much
bora	mud
Poti	mug
soubé	muscle
mikhé kha ceyanlankhi ragatadé	museum
sanssi nakhan bouraghè mouna	mushroom
sigui	music
ilaman inakhan ba	must
radoundou	mute
moutagui	mutual
oun	my
nboré khori	My dear
m'boré	my friend
ma kounkoui nakhan gnèrèma boghima anou yéma nara fékhi yèkhè boghimassé dakhi	My hovercraft is full of eels
n'khanountenyi	my love
khilinè	my name is
m'bögnè rafan fé	my pleasure
yètè kangni	myself
nakhan koui mou kolon	mysterious
Cé nakhan yaba fé khörökhö	mystery
fé fori fanyi	myth
wouré lan ma nakhan tima cé fatou a ma	nail
dougoula	naive
khili	name
cé falafé nakhan bara dangui	narrative
khouroun	narrow
irafan ma yate	nasty
ta gbé	national
yamanè	nationality
loufé ibaridé	native
fé nakhan kèya mouma sarakhi	natural
moura bilinyi	nature
bökhoun khöli	nausea
a cetma	near
sètima	nearby
faïda	nearly
wafé khon	neat
nakhan lan	necessary
kôgni	neck
bouncé nakhan sama konyira	necklace
khayi	need
nakhan mou fan	negative
fé botèrabafé	neglect
lanfé féma	negotiate
Dökhö boré	neighbor
quartier	neighborhood
mènfanant	neither
sokhödi	nephew
mikhi nakhan amagnökhouma a gbéra	nerd
khonokhi	nervous
Khönié khèlèsa dé	nest
yèlè	net
kiraya fèrè boré massotöki	network
Nakhan mou kioki	neutral
sönon	never
nama ara tii	never give up
amou gnakhouï	never mind
khali imou köntöfili	nevermind
afalou kioki	nevertheless
nènè	new
maséngni	news
yaré	next
sètima	next to
fanyi	nice
ounbara gnalakhin itoféra	nice to meet you
sokhodi	niece
koyè	night
khiyo gnakhi	nightmare
solomanani	nine
foun noun solomanaanin	nineteen
tongo solomanaanin	ninety
adé	No
kontofili yo	no problem
ädé	no way
kéra mouna	no way
mikhi yo	nobody
sonkhè	noise
nakhan sön khö ma	noisy
mikhi yo	none
nou'maré	noon
adé	nope
mara	nor
Nakhan na alo boroé	normal
nöri	north
nouè	nose
khölima wa	nostalgic
namara	not
mara fewou	not at all
mou gnakhou	not bad
yakösi mara	Not now
sindé	not yet
sèbè	note
sèbè	noted
yaté	noted
cécé	nothing
rakörössi	notice
bara rakörösi	noticed
khili	noun
khiley	nouns
Fé Dangui khi cèbè ma bouki Nakhan koui	novel
novembou kiké	november
yakoss	now
yakösi	nowadays
kânâfé	nuisance
cécé	null
tounankhonofé	numb
khassabi	number
guinè nakha walifé labitani	nurse
akhori	nut
töla khöri	nutmeg
donsé	nutrition
kalifé	oath
nakhan fouri khoungbo	obesity
khouméï fé	obey
cé	object
akhounyi	objective
tékou ra	obligation
ayi förökhi	obscure
matofé	observation
ayi gbèfé	observe
Nakhan khirikhi fé kérén na	obsessed
magnökhoun yi nakhan khakhili birin tongo khi	obsession
cé fori	obsolete
Cé Nakhan ara tima	obstacle
sotofé	obtain
abara sötö	obtained
na fikhè	obvious
fikhèyama	obviously
wakhati kerén kéren	occasionally
ikha wali	occupation
soukhounè	occupied
A ra Kélifé	occur
rabanè	occurred
raba	occurs
ba	ocean
octobrou kiké	october
kerénma	odd
Yabi fanyi mamèkhi	odds
kha	of
iyokhè	of course
dounougna	off
guéré folofé	offensive
agnaningué	offer
walidé bankhi	office
nakhan kéli khi yaré ratié ma	official
lèr birin	often
oh	Oh
ah bon	oh really
touré	oil
Tin	ok
nbara tin nkhanounteyi	ok dear
iyo m'ma koumi	ok honey
iyo nkhanounteyi	ok my love
Tin	okay
awa m'bögbè	okay baby
iyo nkhanounteyi	okay dear
awa nkhanounteyi	okay honey
awa nkhanounteyi	okay my love
khèmokhi	old
afari	on
kerén toun	once
kerén	one
nènyi kérén ma ralima abadan	one language is never enough
yèbè	onion
lignema	online
kerényi	only
rabifé	open
fé danguifé afanyira	operation
khakhili	opinion
chanci	opportunities
sabouï	opportunity
nakhan kerén mara	opposite
lafé fera	optimistic
kéra gbètè	option
Tékou mou Nakhan na	optional
khanamou	or
lefouré	orange
ara gnèrèfé	order
anakianakhè	ordinary
malanfé féndé khoun ma	organization
khountidé	orientation
a kelidhé	origin
yètè yètè	original
Oromokhoui	Oromo
kiridi	orphan
gbètè	other
anamara	otherwise
alaman	ought
mou	our
Moun ma khèraya: nakha niè ma Kérén Kérén na ma birin, yéré birin Douniè fakha mou fé khèrèè ma ma cén fé khoué kha fé ma.	Our mission: to enable everyone, everywhere to understand the world and express themselves across languages.
Moun ma khèra ya:  Douniè taroukhé falafé ra anoun a findifé douniè khoun khon yi fé ra a sötö fé ra anoun a kha mounanfan yi.	Our mission: to organize the world's information and make it universally accessible and useful.
tandé	out
näkhan minima a koui	outcome
dom'ma	outfit
minifé rafanghi mikhi ma	outgoing
mini	outlet
ara bilin yi	outline
tandé	outside
agnondon mounana	outstanding
tami gan dé	oven
afari	over
mèni	over there
aralankhi	overall
aratefé	overcome
magnonkhoun fé gbé	overthinking
abara dangui	overwhelmed
fé nakhé tin khörökhö	overwhelming
nakhan lan ma araba allo wali	owe
khoundoui	owl
alouféyira	own
akagni	owner
ningué khamè	ox
birafé a fökhö ra	pace
sä bèki koui	pack
amakhiri fé	package
asara	paid
khonè	pain
peinti fé	paint
cé peinti cé	painting
firin	pair
ma khoulou kha	pale
tougui bili	palm
macini cé nakhan cé fourama	pan
Fouré nakhan din ma Gnamanè ra	pandemic
gakhoui	panic
wontenyi kouyé	pants
kèdi	paper
ardiana	paradise
sigama kérinyira	parallel
cotée	parcel
diyè	pardon
bariboré	parents
tiidé	park
kaloé	parrot
persil	parsley
yiré n'dé	part
loufé ayama	participate
akhatima	particular
nagnant	particularly
borémayi	partner
khouloun yi ra ba fé	party
Dangui fé yiré ra	pass
kéra	passage
dangui yiré	passage
bara dangui	passed
rafanfé	passion
khöli	passionate
nakhan na bama ayifourera	passive
mot de passi	password
dangui	past
nakhan à sama a kèya	patch
kira	path
magnönyi findi fé nondi ra	pathetic
forè	patience
fouréma	patient
lanfé ama	pattern
ratî	pause
labéra	pavement
sarafé	pay
köbiri fii	payment
bogñè sa	peace
lan'gni	peaceful
yèkhè soukhoui	peach
seyi téfé	peak
woury bogui	pear
togué bourakhè khindé dakhi	peas
akhatima	peculiar
kholi	pee
doncé nakhan lagui bakhama	peel
boré	peer
Findifé Kérén na	peers
kalé	pen
crayon	pencil
ana mamètifé	pending
mikhé	people
gbèngbè	pepper
toki	perceive
a nèbè ki ya nakhè	perception
a ba iyi	perfect
arabat	perform
Waliki Fanyi	performance
temoundé	perhaps
wakhati	period
wakhati birin	permanent
sagosafé	permission
sagoé sa	permit
douloukhötö	perseverance
yikhiri	persistent
mikhi yo	person
yètèkan	personal
nyougué	personality
sondoyi	personality
fé ma cén fé a kiya	perspective
gnakhasi	persuade
nakhan fé kobi rabama	pervert
dalicé nakhan na mikhi fora	pet
wakhati ndé	phase
sé	phenomenon
kharanyi nakhan nondi kha fé falama	philosophy
teleföni	phone
foto	photo
cèbèli ma lankhi	phrase
faté bindè	physical
Togonfé	pick
à ma tongokhi	pick up
printi	picture
khori	piece
khorié	pieces
khösè	pig
djèmbè	pigeon
Cée sa fé ra e boré fari	pile
khounyi sacé	pillow
chofèri	pilot
Soubé soti Nakhan na i kha gan	pin
fougnè	pineapple
cé ragbéli khi	pink
yili guékhi bokhima	pit
bökhi	pitch
kinikini	pity
yiré	place
yitey	places
fouré ma gakhoukhi	plague
Yiré yi talakhi	plain
amissalia	plan
koréma khoni	plane
cé yalandé	plant
wouribilié ma lankhi	plants
léfa	plate
kènè yalankhi	platform
béré	play
béréfé	playing
agnôkhoun	pleasant
nbari khandi	please
gnalakhounyi	pleased
Marafoulounyi	pleasure
yètèba fé	pledge
aradanguè	plenty
bokhi	plot
söti fé	plug
Cé khara fé tami gan dé koui kanamou soguéra	plum
nékhé tiyau yalan ma	plumber
A gbégbé	plural
podcast	podcast
cèbèli nakhan na sigui dakhi	poem
sigui gnokhonmè	poetry
ama sén	point
yèkhè	poison
polici	police
nakhan bokhi yaré ratié ma tokhi	policy
khouri	polite
yi ré khiri minikhi	pollution
Étang baa yé gbégbé yi talakhi	pond
makhadé	pool
gbi	poop
cetaria	poor
mikhé nakhan makhanoukhi	pop
yama kagni	popular
ta mikhé	population
khösè	pork
yéfouré	porridge
Kounkoui tima dèn nèkhè	port
tiki	position
Nakhan fan	positive
gnèrèki	possess
anayira	possession
nakhan wama cé ragata fé a yètè kan bè	possessive
nöfé	possible
coté rasambadé	post
amasigafé	postpone
pomme de terre	potato
Cèmbè noun Fatè	potential
ayi khinfé	pound
cetaria	poverty
nofé	power
sèmbèma	powerful
arabakhi	practical
arabakhi	practice
yefoui	praise
béré	prank
salifé	pray
mounanfanyi	precious
nakhara	precise
nayati	precisely
fé falafé nakhan fama rabadé	predict
arafanféma	prefer
Cé rafan fé	preference
fourou	pregnant
iyo fé mikhima	prejudice
yirée	premises
Wali kè kha kobiri	premium
preparéfé	preparation
atokhono	prepare
prèkhi	prepared
Fé Nakhan na cé finrin kha gboé tagui	preposition
iya khori	presence
finma	present
amacénfé	presentation
imèyi ama	preserve
manguè	president
dèng'ghè	press
ya gba	pressure
wamafé	pretend
arayabou	pretty
ma tankhè	prevent
mayelikhi	previous
dalicé nakhan findima doncé ra	prey
Saré	price
khoun na Keli	pride
chrétien yé kha imamou	priest
doumékha kharan yi	primary
sindjé	prime
mènguè kha diguinè	princess
akhori	principal
singué	prior
Sougandi	priority
guéli	prison
goundo ragatafé	privacy
goundoé	private
mounanfanyi	privilege
saré	prize
tèmtèmoundé	probably
kontofili	problem
a kiraya	procedure
arabafé	proceed
féra bafé aboré khambira	process
a ya lan fé	produce
seri	product
ayalanfé	production
wali	profession
waliraba makèninkhi	professional
yatagui	profile
gueni	profit
nakhan tilin	profound
sabati	progress
projè	project
nakhan tidé gbo	prominent
lardi	promise
makèninfé	promote
masén'yi	promotion
khouliyi	prompt
mikhi nakhan na mikhé sago	prone
ikhili	pronouns
fäläki	pronunciation
cedé	proof
Fera ki fanyi	proper
ginkhiya kiraya	properly
banghey	properties
Nakhan sötö khi	property
tifé a yè	proposal
gbilenfé ama	prospect
Ban'naya	prosperity
yiriwafé	prosperous
matanga fé	protect
sewa	proud
amasén	prove
bènhi	provide
fii	provided
tä	province
nakhan fima	provision
bara mô	puberty
yama	public
a boun	pull
Boguisé khoun gbé nakhan loukhi alo léfouré	pumpkin
nakhan fama lèrma	punctual
kharandi	pupil
sarésso	purchase
föyen	pure
tonkhou ma nakhan na tonkhou ma gbeli noun a förè tagui	purple
akhounyi	purpose
bédoui	purse
bira afora	pursue
bira a fökhöra	pursuit
radinfé	push
asafé	put
féfalafé anaki nakhè	qualification
biyaci	quality
kassabi	quantity
Ba fé ra mikhé ya ma	quarantine
sonkhoè	quarrel
kartier	quarter
Quechuakhoui	Quechua
mänguè guinè	queen
nakhan mou dari	queer
makhöri	query
makhorin	question
fikhè	queue
ama foura	quick
mafouré	quickly
doundouï	quiet
blankiti	quilt
aratifé	quit
agbégbé	quite
makhonriyi malankhi bouki nakhan koui	quiz
säré faläfé	quotation
mikhi gbètè khoui	quote
saré nakhan fi ma wali rabakhi khaféra	quotes
yéré	rabbit
gui concour	race
féra bafé khonèdakhi	rage
tunè	rain
a khouma safé	raise
ramokhi	raised
guiinè	ran
ana eboré nan khanbira	random
abirin	range
mafoura	rapid
mafouré	rapidly
atokhono	rare
atofé khörökhö	rarely
cé minifé fatéma	rash
gnènè	rat
wakilifé	rate
gui sakhanyi	rather
Bariboré ya	ratio
Nakhan na nondira	rational
nakhan mou khouroukhi	raw
matokhi	re
alifé	reach
soto	reached
yabira gbilénfé	reaction
kharanyi	read
kharanfé	reading
Nöfé fera	ready
cén cenyi	real
nondi	reality
maraba tifé	realize
kolon	realized
ngnè	really
khanbi	rear
a ra kéli	reason
fan	reasonable
gbilén ä khilira	recall
abarama sotèi	receipt
akha masötö	receive
sötö	received
abakhi rabadé	recent
abakhi rabakhi	recently
rasènè	reception
köbiri na khan sötö ma fèyènyi sarémati koui	recipe
soucè gbé gbé	reckless
kolon'yi	recognition
Kolonyi sötö fé	recognize
gbelinfé amakhilira	recommend
cé sa mikhi sago	recommended
ara gatafé	record
rasoukhoui fé	recover
yala	recovery
gni	recovery
cé nakhan cèti nani ara anou tounkhounyi nani tinkhinkhi	rectangle
gbeli	red
gbilénfé asarafé ma	redeem
Gbilénfé a sara ra	redemption
ara khouroun	reduce
a yabiti	redundant
ikhi sama	refer
tonkhoma	reference
masén	reflect
khakhili ragnèrèfé	reflection
tî	refrain
frigo	refrigerator
a gnokhè fi	refund
tondifé	refuse
tondi	refused
abè	regard
gui kha fera	regarding
amoura kelikhama	regardless
khèbou	regards
gnamanè ceti	region
aragatafé	register
nimisè	regret
temouî birin	regular
Tèmoui birin	regularly
tondi a ma	reject
makörè	relate
enou nakhan na eboréra	related
wakhati	relationship
na khan a ma to khi	relative
kha mikhey	relatives
ra foulounfé	relax
binyifé	release
bara bèn'gni	released
agbéngbényi	relevant
amakènèkhira	reliable
bökhi dökhö ki	relief
mikhi bafé fé khörökhè koui	relieve
wassa fé	relieved
gnamanè ceti dé	religion
Nakhan na batou fé	religious
yètè soukhouï	reluctant
ignokhö sa	rely
loufé	remain
loufé	remaining
nakhan ma kèninkhi	remarkable
a seri	remedy
i magnakhoun	remember
gbîlénfé a khilira	remind
ratoun'gni	reminder
télé kha commande	remote
aba yama	remove
ara gbilénfé	render
yefoufé	rent
yalankhifé	repair
gbelinfé ama	repeat
amasarafé	replace
yabifé	reply
Bariboré ya	report
gnokhö rasafé	represent
khili	reputation
amakhorin fé	request
tékou	require
Nakhan tidé gbo	required
aratanga	rescue
fényi	research
mini éboréma fé	resemble
mgnon fé torè nakhan barassa ifari	resentment
maso yètèra	reservation
céra gatakhi	reserve
nakhan dokhi yiré	resident
minifé ayama	resign
dandji sa fé ra fé ma	resilience
a khara dan	resilient
ikhörökhö fé	resist
khörökhö féma	resistance
yabakhi	resolution
ya län	resolve
guicée tidé nakhan na ba khonyi	resort
yamanè kha tönè	resources
binya	respect
yaabi	respond
yabi	response
kountigui	responsibility
kountigui	responsible
malaboui	rest
ala kha bèndè yelefou a boun'ma	rest in peace
dègué bangui	restaurant
aragbilénfé	restore
dan fé	restrict
fé yabi	result
yabi	results
Londi kha céedé	resume
yaba	retail
douroussi	retain
soukhou	retention
Nakhan na dökhi walidé	retired
walikè radokhöfé walidé	retreat
ara soukhi fé	retrieve
gbelin	return
aramini kènèma	reveal
fé ma kolon khi ma kènèn fé	revealed
gbé gnökhè	revenge
gbelinyi	revenue
kiya ma sarè	reverse
gbata khoumbé	review
gbilén a ma	revise
gbelinfé amatora	revision
ma sarè	revolution
saré	reward
a sigaki	rhythm
guiya	rib
bandé	rice
kobiri kangni	rich
Cé bafé na	rid
raguifé	ride
mayelikhi	ridiculous
yiréfan	right
yäkösi	right now
nakhan mou tin ma a kiya kha ma sara	rigid
cé ra diguilinkhi	ring
amalntanfé	rinse
mirimintinyi kha soukhi	riot
böfé	rip
briques dokhi cimon na	ripe
sa fari	rise
karingni	risk
rivali	rival
khouré	river
kira	road
a gankhi tè ra	roast
gbangbanlan yi	robust
litanfé	rock
yèkhè soukhoui wouri	rod
iwali	role
cé ma findikhi	roll
loudé	roof
bankhi	room
sanké	root
louti	rope
börökhi	rotten
cé nakhan ma soukhoufé mou gnakhoun	rough
faïda	roughly
arabilin	round
kira	route
deri wali	routine
Korinyi	row
froukou	rub
foré	rubber
gnogué	rubbish
gböé	rude
dagui	rug
bankhi tombolonyi	ruin
säriyè	rule
sariyä sa mikhi	ruler
säriyei	rules
I gui	run
guifé	running
khaaré	rural
Ma ra makhè Ma fouré	rush
cé sacé	sack
nakhan lan ma akha binyè	sacred
sarakhè	sacrifice
amou kanama	safe
ala khi so khèri	safe flight
latanguè	safety
nakha a toulimadima	sage
a falanè	said
gnèrè fé yéma	sail
Bèla kounkoui	sailing
kha fé	sake
kiké gnonyi saré	salary
sarémati	sale
yèkhè denan khilira	salmon
fokhè	salt
hali	same
abirin kérén bé	Same here
anèmou nèmoufé	sample
minyi	sand
Sanskritkhoui	Sanskrit
mikhi mayelé amanfa gnakhou	sarcastic
konbila	sassy
dökhönè	sat
bougnèra fanféma	satisfaction
mara wacè	satisfied
lougan	satisfy
louganfé	satisfying
simiti lokhè	Saturday
soubé yalan fé a koué ra	sausage
layiriwafé	savage
A khoun ma gaga fé	save
scie	saw
falèfé	say
téfé cema	scale
mafalafé	scam
fokhi	scar
a tokhonö	scarce
Bognè kanè	scared
khounkhouri	scarf
amagakhoutima	scary
ara yencé	scattered
pèssè yiréndé	scene
wourédi nakhan cé seréma	scenery
dalicé cé khirimèfè	scent
temoui konticé	schedule
kharandérabadé	school
ara yiriwa	science
nakhan kharanyi kha kolonyi matokhi	scientist
scientifikey	scientists
cizo	scissors
sonkhoè ratefé	scold
togoé	scope
guéni kha conti	score
ara bolofé	scrap
khorin	scratch
sonkhouwè	scream
écran	screen
cé seréma wouré nakhan na	screw
sèbèli nakhan pèssè kha fé sèbè ma	script
fokhè yé	sea
tinfé ama	seal
fenfé	search
Gnè Wakhati ndé	season
dökhödé	seat
friyandé	second
makoutoui	secret
ayi takhounkhi	section
ratanga	secure
makantè	security
toé	see
won na tèmou	see you
won narala'ma	see you later
won na tèmoui	see you soon
won tina	see you tomorrow
cé khori	seed
guinè demédi	seek
loufé nbè	seem
loukhi	seems
to	seen
A soukhou fé	seize
soukhoufé	seizure
nakhan tokhoni	seldom
Sougandi fé	select
yètè	self
yètè dandan	self healing
bincé khonanté	selfish
matifé	sell
akhaninfé	send
fa foto ra	send me your picture
fori	senior
ya kerén	sense
cé mafoura mikhi nakhan ilîdé	sensible
fé ra ba fama nakhan ma cèmbè	sensitive
rasamba	sent
cèbèli ma lankhi	sentence
wöyen'yey	sentences
fatanyi	separate
Sepedikhoui	Sepedi
septambrou kiké	september
fée	sequence
cé nakhan dökhi aboré yara	series
Söbè	serious
sobè	seriously
mikhi mounanfanfé	serve
walidé	service
ma lan yi	session
cé nakhan dökhi aboré yara	set
sabarifé	set up
a folodé	setting
yabafé	settle
solofirin	seven
fou noun soroféré	seventeen
tongo soroféré	seventy
agbo	several
anayama	severe
dèguè fé	sew
sh	sh
nini	shade
kouwè	shadow
ramäkhä	shake
nakhan lan ma araba allo wali	shall
a tilin dondoroti	shallow
yagui	shame
akeya	shape
takhounyi	share
anouè ra meloukhi	sharp
guinèma	she
ä na yira	she has
guinèma na kiya	she is
paka	shed
yèkhè	sheep
kèdi	sheet
cé dokhi aboré fari	shelf
a khalé	shell
sabatidé	shelter
cé nakhan mikhi ma gagama	shield
masarè	shift
briyéfé	shine
kounkoui khoungbé	ship
arasiga	shipping
chemisi	shirt
sankirée	shoes
fifé	shoot
boutiki	shop
saré so	shopping
khouré dè	shore
dounké	short
Cé Nakhan na a khouroun fé kanamou ara a gnon	shortage
fi	shot
alanma	should
tounki	shoulder
khui yité	shout
amasén	show
a masén m'bè	show me
khandè	shower
sanfoui	shrimp
Ra khouroun fé	shrink
balan	shut
wa balan	shut up
madoundouï	shy
ma khamè nou ma guinè	sibling
ma guinè nou ma khamè	siblings
fourema	sick
ceti	side
Yéngui fé à Khoun Gbéra	sigh
Toé	sight
nakhan biyassi mikhé ma tokhi	sightseeing
Tonkhou ma	sign
bèlèkhè fökhi	signature
mounanfanyi	significant
madoundoui	silence
madoundou	silent
dougui déguè taré	silk
khakhili taré	silly
kobiri	silver
amaniè	similar
nakhan céé batoma	simp
nakhan fakhamou fè mou khörökhö	simple
nakhé arabakhi tèmouikeren	simultaneously
arakouya	since
tinkhin'yi koui	sincere
bindja koui	sincerely
sigisafé	sing
siguisa	singer
kerén	single
filifé	sink
karamakhö	Sir
nkhounya guinèma	sister
makha oundia guinèma anamara makha tara guinèma	sister in law
dökhöfé	sit
yiré	site
akèya	situation
sén'ni	six
fou noun sén'ni	sixteen
tongo seni	sixty
a kha khoungboey	size
fatè	skill
aya kolonféma	skills
faté	skin
khàré	skinny
touganfé	skip
guinè dougui kouyé	skirt
koré	sky
kongni	slave
khifé	sleep
khifé	sleeping
khi khöli	sleepy
donma dèn nèkhè balakhè ma kotoma	sleeve
doncé khouti	slice
salakhounfé	slide
ara foulakhi ara	slightly
makhosikhi	slim
kèdi	slip
gorogoroma	slope
böè koué	slot
makhigbeli	slow
donyi donyi	slowly
akhouri	small
amanièfé	smart
a khiri	smell
yeléfé	smile
yèmbè min	smoke
börökhöyi	smooth
donyi nakhan moura binya	snack
boé	snail
bökhmasé	snake
foto tongo	snap
glace khouti	snow
aloko	so
tofan ki fangni	so cute
hanya	so far
a bounda	soak
safounyi	soap
nakhan mou beré miman agbéra	sober
bâlon bonbwè	soccer
mikhiya	social
adamaya	social
gnama nakhan a kha dounignè khaninfé yiré kerén	society
chaussetti	socks
gnökhonyi	soft
logicièli	software
bokhi	soil
abara mati	sold
bara matî	sold out
söri	soldier
kérén	sole
khörökhö	solid
Yaba fé	solution
yabafé	solve
nan dé	some
mikhi n'dey	somebody
a gnè ki yo ki	somehow
mikhi dé	someone
séndé	something
lèrindé	sometimes
sigui	song
amoubouma	soon
ayalanki fanyi	sophisticated
Soranikhoui	Sorani
khoñofé	sore
kolé kha khönè	sore throat
lou fé kinikini koui	sorrow
diyƐ	Sorry
mayeguetifé	sort
khon na fénfé	sought
A ma saré	soul
nafan mikhi	soulmate
agbé	sound
Börè	soup
Cé Nakhan mou fan	sour
Abili	source
yiré fanyi biriki	south
yiréma bakhi	space
cekobi rasamkhi	spam
loufé sago	span
Espagnölkhoui	Spanish
Cé ma sarè	spare
woyénfé	speak
sougandi	special
cée ndé	species
fé sougandikhi	specific
féma toyi gnakhoun mè	spectacular
woyèn na danguifé yamama	speech
doundoui	speechless
mafourè	speed
mini	spell
kobiri bafé	spend
rabanè	spent
gbèn gbè na ma	spicy
cé nakhan tikhin khi téfé koré ma	spike
masarè	spin
Sanci Nakhan bourèkhè khindé ra	spinach
khakhili	spirit
dè yé bökhoun	spit
nakhan tofan	splendid
takhounyi	split
kanafé	spoil
bara kana	spoiled
mafoura	spontaneous
kefouï	spoon
dokhödé	spot
arabafé	spouse
amacénfé	spread
sogué fouré	spring
forima	square
gbata fé	squeeze
Sabari	squid
khoriyé	squirrel
khèbou	st
sökhö	stab
tii yiré kérén	stable
rafé fée	stack
sèmbè	staff
malanfé	stage
Tombi	stain
escalier	stairs
kobiri sa fè Béré ndé koui	stake
Wouri bili bourèkhè na dèn nè khè	stalk
A ba fé a boré ra	stall
Kèdi khouri di	stamp
loufé bé	stand
kiya kerén	standard
tounbouï	star
A folè	start
afölo	started
kaamè	starving
akèya	state
toulobèndoun fé	statement
Guicé koué timi dèn nèkhè	station
tifé yirékerin	statue
tonyi ya yèrèki	status
louna	stay
ala khi ra tanga	stay safe
arakharakhi	steady
steak	steak
mougnè	steal
yèmbèminfé	steam
youré khörökhé	steel
Cé Nakhan cèti mou kountan ma	steep
Wouri bili bourèkhè na dèn nè khè	stem
gnèrè fé	step
gui	stick
nakhan mou tin ma a kiya kha ma sara	stiff
koudèi	still
mikhi sokhö ceri sambèra	sting
a kori bènyi khönö	stingy
aramakha fé	stir
ragatè	stock
mougnè	stolen
fouri koui touli cé	stomach
guèmè	stone
anoun nana	stood
gbi	stool
tifé	stop
ragatadé	storage
bili	store
Foyé Nakhan kanari ra bama	storm
fé fori	story
Macini cé Nakhan cé doncé foura ma	stove
tinkhinyi	straight
kéren'na	straightforward
youri khountoun yi	strain
Fé singué	strange
Khöyè	stranger
kiraya nou fèrè ikhayi kha fan	strategy
sèkhè	straw
yé ma safé	strawberry
cé fokhi yiréma	streak
ra lintan fé	stream
kira	street
sèmbè	strength
bögnè ma gnakhoui	stress
dèn'ghè	stretch
fé makhokhokhi	strict
bombofé	strike
Cèni	string
faté ma khirima nakhan iyiré dén nou khouloukhoun	strip
Bèndou fé gnöè ra	strive
Facè kha gbaloé	stroke
Cèmbè	strong
bombö fé	struck
fé fanyi malankhi	structure
guéré	struggle
katafé	struggling
khakhili taré	stubborn
danyi	stuck
kharandi	student
kharanyi	study
kharanfé	studying
céndé	stuff
safé khouma	stunning
ama yelé	stupid
Wali ki tongo fé waliki gbètè ma	style
fée	subject
rasofé	submission
kala akörö	submit
cera soumbouï	substance
masärä	substitute
khakhili fanyi	subtle
siga yaré	succeed
khilisotè	success
gueni	successful
moli	such
alo ina fala	such as
maçon fé	suck
Yaa yaa	sudden
toun	suddenly
torofé	suffer
tôrè	suffering
alan naki	sufficient
souka	sugar
fé gnaningué	suggest
sougandi	suggestion
tinkhi	suit
alankhama	suitable
valizi	suitcase
sâ boré khoun	sum
ara langui	summary
anouna	summer
guiya kom ma	summit
sogué	sun
sandé	sunday
sogué khönè	sunny
sogué magorodé	sunset
sogué	sunshine
afan	super
gbo	superior
anakhan a khouma toma ra	supervisor
noumaré dègué tongo fé	supper
akha fi	supply
mali	support
Magnökhoun yi nakhan moura bakhi	suppose
lan'ma nou	supposed
iyokhè	sure
yiŕé koui	surface
téfé	surge
dandantiyé kha mikhi raboyè	surgery
bari khili	surname
magnin fé fera	surprise
magninfé	surprised
sigafé na	surrender
rabilinfé	surrounding
makantafé	surveillance
féfén	survey
balofé	survive
sika	suspect
ratikhi	suspended
sikèi tikhi nakhan ma	suspicious
malifé	sustain
boufé	sustainability
abouma	sustainable
Sosokhui	Susu
flo	swag
aragueroun	swallow
amasara fé	swap
kali	swear
ké fouré	sweat
kourou kouroufé	sweater
yiré ma kö fé	sweep
gnökhonyi	sweet
khié fanyi	sweet dreams
fourabi	sweet tooth
marafanyi	sweetheart
fountou	swell
fountou	swelling
yema safé	swim
yéma sa	swimming
lintan cé gbakou khi	swing
amasara	switch
Fountoui	swollen
déguèma	sword
nakhan cén dé ma cén khi nakhan kolon fé khörökhö	symbol
Mikhi kha fé fan yi loufé i bögnè ma	sympathy
fouré kha lamatoun yi	symptoms
arabaki	system
walèkhè khoungbé	table
rabira	tackle
fokhi safé ama	tag
akhouli	tail
tongoï	take
a khanin	take away
iyèma sokhouï afanyira	take care
yaba cole ma	take off
tongo	taken
woyènyifé	talk
woyen là gbé	talkative
khoungbé	tall
pompi	tap
ara gatéfé céma	tape
anakhan matokhi	target
waliée	task
name name	taste
gnökhoun	tasty
ara kharan	taught
ataya	tea
lakharanfé	teach
mikhi ra kharanyi	teacher
gnama malankhi féndé khounma	team
yayé	tear
yayé	tears
mikhira taganfé béré béré yakoui	tease
walicé afé kharanfé nakhé cé yalama	technology
gnin yé	teeth
falafé	tell
afalabè	tell me
bögnè	temper
khinbéli noun kéfouré kiya	temperature
Allah nou wali sa ma bankhi Nakhan koui	temple
Wakhati na fé Nakhan ma	temporary
foû	ten
woulou fou	ten thousand
lokatèri	tenant
dadanfé	tend
Fé Nakhan mikhi ra tountoun ma a kha fé raba	tendency
yanigué	tender
a bèndou khi akhörökhè	tense
khönè kiya	tension
tente	tent
mato	tentative
ara gnon dé	term
A ma sarè	terms
amagakhou	terrible
nakhan fan	terrific
khoundè	territory
wali ki ma toé	test
sèbèli	text
ah	than
nouwalisa fé	thank
wonou wali	thank you
wo nouwali woto mamètikhi han moukha yakerin sôtoö akhanin féma	Thank you for your patience while we investigate shipment
inouwali gbén gbén	thank you so much
inouwali kifanyi	thank you very much
wonou wali	thanks
i nouwali ito mou kha app rawamikhi	Thanks for using our app
na	that
na nan nâ	that is
na fan	that's good
falin	theft
é	their
etan	them
a khoungni na nakhan na	theme
ey yètè	themselves
awa	then
Fé raba fé wöyèn yi ra	theory
bé	there
nan nâ	there are
nara	there are
ana	there is
nanan naki	therefore
gué	these
etan	they
ey tan nan na	they are
Cé lènfètènkhi	thick
mougnèti	thief
tabé	thigh
makhöcikhi	thin
cé	thing
cée	things
magnönyi	think
sakhayandé	third
yé kholi na nakhan ma	thirsty
fou nou sakhan	thirteen
tongo sakhan	thirty
dji	this
nara	this is
dangui a koui	thorough
Fé rabaki fan yi	thoroughly
né	those
könö	though
Ma gnökhonhi	thought
magnonkhi	thoughtful
maynökhounnyey	thoughts
woulou kérén	thousand
louti	thread
ma gaoufé nara	threat
magakhou	threaten
serinfé	three
na dè ra	threshold
gnalakhin	thrilled
cesotofé	thrive
kôgni	throat
ma	through
na lèri birin	throughout
A yoli	throw
bèlèkhè soulé khounbé	thumb
cé cèrin yi	thunder
alkhamousèï	Thursday
nakinara	thus
Tombi dökhö fé	tick
fökhöyé kha siguè anou kha fa	tide
ayalan	tidy
Khoun ma cé nakhan sa ma konyi ma	tie
bartè	tiger
dèn khèn yi	tight
Tigrinyakhoui	Tigrinya
tèèmoui	time
ma doundoukhi	timid
akhouri di	tiny
maraci	tip
marasiyé	tips
caravati	tire
taganhi	tired
dougui dèguè taré	tissue
khou yi	title
minden	to
findifé	to be
a gan	toast
too	today
di yörè	toddler
san'nouyè	toes
wo birin	together
khandè	toilet
falanè	told
Tin fé Borée khoui ra	tolerance
kinikininfé	tolerate
tomatï	tomato
tina	tomorrow
khouï	tongue
kouwè	tonight
nafan	too
afari	took
wali sé	tool
wali dé	tools
gnin'ghi	tooth
koré	top
walada	topic
a bö	torn
gnakhankata	torture
malankhi	total
din ara	touch
a khorokhö	tough
matoé	tour
mènin biri	toward
Fé singué	towards
sèviyèti	towel
ta	town
A ma khébou yalanyi bè	toxic
fokhè	trace
koréma khoni gorodé	track
saré mati	trade
namoui	tradition
namounyi fé	traditional
wotoey	traffic
koré ma khoni gorodé	trail
fé yalan	train
matinka	training
korinyi	trait
kèya	traits
ara dangui	transfer
kelifé khakhili ma sigafé khakhili gbètè	transition
ara danguifé khou gbètè	translate
A tincé	transparent
transpöri	transport
cé tongo yiré	transportation
soukhoui	trap
nogué sacé	trash
khounyi ma tongo ara	trauma
biyaci	travel
gbata	tray
fé ma tourakhi	treasure
ayabafé	treat
adandanfé	treatment
wouri	tree
cé fanyi	tremendous
kiraganyi sougandifé	trend
Kiti bankhi kha kiti ya ba fé	trial
walifé khakhilira	trick
amato	tried
arakilifé	trigger
doncéra yaboucé	trim
biyaci	trip
kontofili	trouble
wontègni	trousers
woto khoungbé	truck
nondi	TRUE
wouri bili ma cèguè khi	trunk
yigui	trust
nondi	truth
mato	try
Tsongakhoui	Tsonga
pani ra diguilinkhi	tube
talata lokhè	Tuesday
kharandé saré	tuition
döki	turkey
indouyé kha sanssi nakhan founyi nèrifounyi ara	turmeric
firifirin yi	turn
yema kourè	turtle
karamökhè	tutor
fou noun firin	twelve
moukhè	twenty
moukhè noun kérén	twenty-one
Twikhoui	Twi
firiyandé	twice
Cé tolin fé	twist
firin	two
a bombo	type
yètè	typical
tognakhi	ugly
donkhè	ultimate
niini	umbrella
mou nöma	unable
soghö	uncle
khakhili taré	unconscious
aboun	under
aboun ma	underneath
tèguèfé cé	underrated
fakhamoui	understand
fakhamou	understood
khounayakhouï	unfortunately
tenu	uniform
nakhan keran ara	unique
kérén ma	unit
kharandé khoungbé	university
mou kolon	unknown
fo fén	unless
han	until
nakhan mou deri rabara	unusual
koré	up
ita nan a matoma	up to you
a sa lokhoma	update
akhoumasafé	upgrade
afari	upon
ayayeso	upset
takoui	urban
a kholi	urge
khaï khörökhö	urgent
mou tan	us
ara wali	use
abara lawali	used
mounanfanyi	useful
fouyanté	useless
nakhan deri rabara	usual
ara lankhira	usually
nakhan tidé gbo	utility
Ma laboui tè moui	vacation
Boè tifé	vaccination
Seri Nakhan Mikhi ratanga ma fouré ma	vaccine
céyi guéli	vacuum
moronyi	vague
nakhan noma walidé	valid
ta nakhan na guiya firin tagui	valley
cé khori	valuable
namounyi	value
adèkhéma	variety
cégbètèï	various
ba ey boré  ma	vary
yé sacé	vase
agbo	vast
bögui cée	vegetable
sanssi raboulakhi nakhan don ma	vegetables
woto	vehicle
sarémati	vendor
khönè	venom
lankhoundè	venture
rabadé	venue
ä yigbè	verify
Nakhan kha wali gbo	versatile
Fé falaki Évolution fé ma siguè ya ré ma	version
nakhan tikhi	vertical
yate	very
afanyi dira	very good
kounki bélébélé	vessel
nakha anièma	via
gnakhai gnakhai	vibe
serin serin	vibes
fé kobi ndéna nakhan yi	vicious
fé masoto mikhi	victim
video	video
tofé	view
khaaré	village
gnakhoui	villain
vinaiguiri	vinegar
forima	vintage
yakhankatè	violence
törè	violence
nakhan kha ferabaki na guéré dakhi	violent
ce nakhan ma fouré litandé	viral
dimè	virgin
mou sésé kolon	virgin
yama toma	virtual
mikhi nakhan mou a yètè kan ma cén ma	virtue
khakhili	vision
ama to	visit
tofé	visual
nakahan mou danguima simayakhanbi	vital
cé Nakhan ma foura	vivid
khoui kha cèbèli ma lankhi	vocabulary
khoui	voice
abama	void
kha khoungbé	volume
nakhan walirabama asaré mou fima	volunteer
bökhoun	vomit
anoma isoughidé	vulnerable
säré	wage
walikè saré	wages
kouyè	waist
wo mamèti	wait
nakhan takhoui tima	waiter
mèmfé	waiting
khounoun	wake
wo khounoun	wake up
gnèrè	walk
gnèrèfé	walking
banghi kaké	wall
kobiri sacé	wallet
yèrè fé toun	wander
waamä	wanna
wakhonyi	want
afénfé	wanted
gueré	war
témouré ra gata dé	wardrobe
bankhi makiti sama dèn nèkhè	warehouse
afourakhi	warm
yécéma safé	warn
mara colonyi	warning
guérésoey	warrior
anou	was
makha	wash
nokhè	waste
wakhati macenfé	watch
yé	water
pastèki	watermelon
moronyi	wave
kira	way
mou tan	we
moukhou tan nan nâ	we are
moukhou nöma	we can
a yelifoukhi	weak
fouyantéya	weakness
banaya	wealth
kobiri kanyi	wealthy
tongoé	wear
sofé	wearing
wakhati	weather
fouti	wedding
araba lokhè	Wednesday
sèkhè	weed
lökhounyi	week
semaine na gnonkhi	weekend
cé binyé sa fé cé koui	weight
ayahi sokhi	weird
ara lanfé	welcome
Louki fan yi	welfare
a fan ɲira	Well
beré fanyi	well done
siganè	went
atanan nou nara	were
soguétédé	west
boundakhi	wet
balèni	whale
nansé	what
ifan	what about you
wo nansé rabafé	what are you doing
ina micérabafé gui lèri	what are you doing now
ina micéra bafé guilèri	what are you doing right now
ina nancé rabafé	what do you do
i na wöli moundou	what do you do for a living
iwa micé falafé	what do you mean
i wama mounsé khon	what do you want
karamakhö	what happened
micéya	what is
moun sé iya	what is this
ikha wali na mounséra	what is your job
ikhilidi	what is your name
mousé rabakhi	what's up
â rabakhi di	what's up
ä nâdi	what's up
i khilidi	what's your name
anifindi nakhan yora	whatever
malé	wheat
pinè	wheel
wakhati moundoun	when
tèmou yo	whenever
mindé	where
ina mindé	where are you
wo kelixi mindé	where are you from
ina mindé gui lèri	where are you now
i logékhi mindé	where do you live
nâ mindé	where is
a fä lii	whereas
an	whether
ndé	which
awa a	while
wöyèn a touli boun	whisper
Kolin fé	whistle
fikhè	white
OMS	who
Ndé na i tan na	who are you
n'dé nä	who is
n'dey iya	who is this
kerinyira	whole
ndé	whom
Ki fé	whose
nanfera	why
mounsé ma a mou nôma rabadé	why not
gnakhoui	wicked
ara gboyi	wide
windali	widow
khoungbé	width
kha guinè	wife
wouladakhi	wild
findimanara	will
louè nama	willing
guenifé	win
foyé	wind
windäli	window
foé gbé gbé na dèn nèkhè	windy
béré	wine
Khimbéli tè moui	winter
ma froukou fé	wipe
louti	wire
khoun na Keli	wisdom
binyè	wise
wakhon fé	wish
ala kha hèri fi ima	wish you all the best
körömikhi guinè dakhi	witch
anoun	with
firifirin yi	withdraw
bä a yama	withdrawal
bä koui	withdrawal
akoui	within
tamara	without
cedé	witness
khakhili sémbè	witty
nakhan céra khoungboma	wolf
guiné	woman
guinée	women
guéninè	won
mou	won't
fema kabakhi	wonder
arayabou	wonderful
yegué	wood
guèssè	wool
woyènyi	word
wöyèn khöri	words
wali	work
matikanfé	work out
walifé	working
dounougna	world
soundi	worm
alou isago	worn
bognè mini	worried
kontofili	worry
a gnakhoui dé	worse
batoey	worship
nakhan gnakhoui	worst
safè	worth
nalan ma akharaba	worth it
Nakhan lan ma a kha cén dé sötö	worthy
findima	would
makhonofé	wound
ouah	Wow
ama filin	wrap
khönè	wrath
bèlèkhè kon yi	wrist
sebèlitifé	write
sèbèli tii bé	Write here
sèbèfé	writing
sèbèkhi	written
cécemara	wrong
sèbènè	wrote
tàtè	yard
kakounyi	yawn
iyo	Yeah
gnè	year
gnèey	years
ayi técé	yeast
sonkhö	yell
nèri fouinyi	yellow
iyoo	Yes
iyo m'bögnè	yes baby
iyo m'barin	yes dear
yanyi	yes honey
iyo nkhanounteyi	yes my love
iyon'khè	yes of course
khoro	yesterday
man	yet
kountigui	yield
wotan	you
ina mindé	you are
i tofan	you are beautiful
i tofan yati	you are so beautiful
wo khakèto	you are welcome
anoulou kioki	you can
iya kolon	You know
ifan	you too
ibarima khari	you're welcome
sékhètala	young
i	your
nbara imadignè	your welcome
i yètè	yourself
sèguètala	youth
i rasènèkhi	you’re welcome
A gnökhoun mè	yummy
sé sé	zero
