hō'ē	a
te	a
te tahi	a
iti'iti	a little
Rava	a little
Ei 'a maha	a lot
tei roa	a lot
e mea rahi	a lot of
tō'iri'iri	abandon
tō'iri'iri	abandoned
fa'a'ahurura'a	abide
fa'aherehere	ability
fa'ahoi	able
i	about
i ni'a	above
Raromataʻi	abroad
Āpo'ora'a	absence
ātia	absent
mā'ohi roa	absolutely
inaha	absorb
horomi'i	absorb
ha'api'ira'a	abstract
Fa'aterehia	abstract
Tarata'a	absurd
parautia	abundance
Fa'ahere	abundance
tauturu	abundant
maha	abundant
fa'aterehia	abuse
Re'o	accent
Tūtaki	accept
Tae	accept
parau	access
Tuku atu	access
tū'ō'ō	accident
tūtū	accommodation
fa'ahouhia	accomplish
Tae atu	accomplished
i roto i	according
Aka'ōraga	account
Tau	accuracy
tō'ere	accuracy
Tāpaʻo	accurate
pūpūtai	accurate
Fa'a'amio	accused
Afa	ache
pāhono	achieve
Haere i te parau	achieve
fa'aea	achievement
ti'a	acknowledge
tā'atira'a	acquaintance
Ha'apopo	acquire
fa'ahouhia	acquire
Rave'a	acquired
tā'atira'a	acquisition
I tua	across
i tō‘ou	across
Ha'amana	act
tā'uru	act
tā'uru	action
Haka	action
a'ora'i	active
Fa'ahoromatā'ara'a	activities
Fa'ahoro	activity
ta'ata ha'uti	actor
tumu	actual
inaha	actually
ina'a	actually
maha'a	acute
tohaina	acute
toa	acute
fa'atāma'i	adapt
Tātou	adapt
māuruuru nō te fa'a'oroma'i	add
e hi'opo'a mātou i te fa'autara'a	add
Apoapoa	addicted
ta'iraa	addition
Tāmata hō'ē	additional
taui	address
Tuʻaʻana	address
nui	adequate
rahi	adequate
Fa'a'ire'ire	adjacent
Fa'ahou	adjective
tohu'āpi'ira'a	adjective
fa'ahouito	adjust
āmanaki	admire
maitata'i	admit
hotohoto	admit
fa'ahiahia	admit
Fa'aamu	adopt
Fa'ahiahia	adorable
tārava	advance
mātou	advanced
rave	advantage
fa'a'iri'iri	adventure
parau tānere	adverb
piri ihoparau	adverb
ha'apori ta'o ha'a	adverb
ā'ā'ati'ira'a	advertisement
Ta'ata	advertisement
Ho'a'ina	advertising
parauta'a	advertising
a'o	advice
ta'aro	advise
Taioro'	advocate
ha'api'ira'a	aesthetic
Fa'ahou	aesthetic
‘Aita‘i	affair
Fa'ahou'ā	affair
fa'aape'ape'a	affect
Here'	affection
Tāpaʻo	afford
Ā'ite	affordable
pōpō riro	affordable
Tāuru	affordable
ri'ari'a	afraid
mehameha	afraid
mata'u	afraid
i muri iho	after
i muri mai	after
tā 'oe	afternoon
tō 'oe	afternoon
I muri iho	afterwards
i muri	afterwards
hō'ē	again
Ananahi	again
I te tutu	against
i muri i	against
Matahitia	age
ti'a	agency
Āpure'a	agency
Tōtini	agent
Ririnui	aggressive
fa'ahiti'ira'a	aggressive
matatika	agile
I muri'	ago
ʻĀmui	agree
Āvana	agree
Āha'o'ā	agreement
fa'a'apu	agriculture
rautea	agriculture
i mua	ahead
roa'a	ahead
pūnaha	aid
mārō	aim
Ārera'a	air
mata'i'oa	air
taura'a manureva	airport
Huri	aisle
ta'i pū	alarm
ta'iri	alarm
ava	alcohol
Tu'aro'ara'a	alert
faatauhi	alert
ora	alive
pā'āto'a	all
pauroa	all
tā'āto'a	all
Maita'i roa	all right
e mea maita'i a'e	all the best
fa'ahouriu	allow
Tae	allowed
ā'aito	allowed
te tahi mau	almost
Fenua	alone
‘elemi	alone
i roto	along
tē	already
maita'i	Alright
ē	Alright
ato'a	also
hērū	alternative
tīa'i	alternative
terā rā	although
āre'a	although
i teie taime	always
uā	am
maita'i	amazing
fa'ahiahia	amazing
to'era'a	ambiguous
Fa'atupu	ambition
fa'aro'o	ambitious
faaapupu	amend
Fa'ahou	amend
I roto i te	amid
I te moana	amid
O te vaʻa	among
i roto	among us
moni	amount
Nui	amount
fānaura	amusing
mārama	amusing
te hō'ē	an
te tahi	an
ha'afaufa'a	analysis
tupuna	ancestors
Tā'ata'i	anchor
tahito	ancient
e	and
e 'oe	and you
anahera	angel
Aute'a	anger
poro	angle
Mataku	angry
manu	animal
ānimara	animal
ti'ati'a	ankle
ā'au'au	anniversary
Re'o fa'atere	announcement
fa'atiti'i	annoy
ha'amanino	annoyed
ʻInuʻinu	annoying
mahanafa'ahoro	annual
Tātae	anonymous
ētahi atu	another
I tua	another
‘ōmāramarama	answer
Vānaʻa	answer
Hāhā	anticipate
faauta	anticipate
hepohepo	anxiety
tūtāperepere	anxiety
tapitapi	anxiety
pāruru	anxious
Mataku	anxious
nui	any
rahi	any
ua	any
Ē	anymore
Ei'a	anyone
Mea ʻē	anything
I te hoʻeʻāmui	anyway
I te mea fa'ahou	anyway
oia mau	anyways
oia nei	anyways
Tāpū	apart
Ma teata	apart
Fare ta'a'ura'a	apartment
māuruuru	apologize
'Āmāru	apologize
fa‘aapāra‘a	apparent
ri'ari'a	apparently
mehameha	apparently
mata'u	apparently
Tū'ura	appeal
Haʻamata	appear
Tū'āroraa	appearance
Tuhaʻa	appearance
Ha'api'i	appeared
pāpārue	appeared
Aro'a	appetite
noa'a	apple
roa'a	apple
rae'a	apple
ha'amata'ihia	application
Tāʻiri	apply
Aroha	apply
‘ae‘āmui	appointment
Tānaʻe	appointment
au	appreciate
poihere	appreciate
here	appreciate
Fa'aitoito	appreciation
fāfā	approach
piri	approach
fātata	approach
noa'a	appropriate
roa'a	appropriate
rae'a	appropriate
Fa'a'aputo'ō	approval
tapo'i	approve
Fa'a'aputo'ō	approved
faaite	approved
oia mau	approximately
oia nei	approximately
ēperēra	april
tūpā'ina	arbitrary
fāruea	arbitrary
Teie tāpōrōno'ō	architect
Mahani	architecture
fa'ahorohoro	archive
Ta'ata	archive
ee	are
Oe	are you
o teie 'oe	are you
e hea 'oe e fa'ahou	are you busy
E hoa'api'i 'oe?	are you married
e mā'u ha'a kōea nei 'oe?	are you married or single
e fa'aea ānei 'oe i'ō?	Are you still there?
Ua oti?	are you there
Ou teie i teie nei?	are you there
ōpū	area
tū'au'au	argue
uha'a	argument
'Āmari'i	argument
ā'ī	arise
rima	arm
farauta	army
nu'u	army
I tāpati	around
Hā‘apapa‘i	arrange
Ho'ē'a	arrange
tauturu	arrangement
Fa'ahou	arrangement
Ta'ahia	arrival
Tupu mai	arrival
Tae	arrival
Ta'iti'a mai	arrive
Taʻu	arrive
fārerei	arrived
ma'i	arrogant
pēpe	arrogant
Pūtō	arrow
tā'atira'a	art
putuputu	article
Fa'apōrearea	artificial
To'erau	artist
rahu'a	artist
i	as
oia nei	as long as
aito	as well
Tō'oe i teie nei	as well
Tō'oe i teie nei	as well as
rehu	ash
haamata	ashamed
Purō	ashamed
Ui	ask
Vā'ī	ask
Pehe?	asked
moe	asleep
Parau	aspect
fa'ahiti'ira'a	aspect
Assamese	Assamese
hā'ati'a	assault
Nao	assault
putuputu	assembly
Tāhuri	assertive
Ha'ari	assess
hoa	assess
Ta'uru	assessment
Tāpaʻo	assessment
mō'ere	asset
Moni 'oe noa	assets
Ta'a'i	assign
tāna'i	assign
‘āpi‘i‘anga	assignment
Hōʻāvana	assignment
Fa'atere	assist
Tauturu	assist
Ohipa	assistant
ōfa'i	associate
tā'atira'a	associated
Fū'āra'a	association
Fare haapii	association
Fa'apoipoi	assume
Faʻaipoipo	assume
fararirari	assumption
i	at
īa roa	at least
ape	ate
ta'ato'era'a	athlete
ma'ona	athlete
tū'ati	attach
firi	attach
hono	attach
tūtaki	attached
Tāpe'a	attached
Fa'aito'ira'a	attachment
ha'ati'a	attack
Ui'ui	attack
Faʻaherehia	attempt
Tāpiri	attend
Faahou	attendance
Atiʻi	attention
Mana'o	attention
peu	attitude
ha'apeu	attitude
fa'ati'a	attract
teha'a	attraction
pupuhi	attraction
mārō'iro'i	attractive
Tā'ito'ito	attribute
Fa'aro'i	attribute
Tāpa'ina	attribute
Tauira	audience
fa'ahere'iti'a	audience
Aukātea	august
ātete	august
Tamahine	aunt
pātea 'ino	aunty
metua vahine	aunty
māmā iti	aunty
tino'ā	authentic
tātou	author
tā'atira'a	authority
tapa'au	autumn
ti'a	available
vata	available
fāito	average
ape	avoid
fa'ahoui'	awake
Huuti'a	award
Farii	aware
mā'iti'iti	awareness
I te tahi tua	away
maitata'i	awesome
hotohoto	awesome
fa'ahiahia	awesome
horohia	awful
Eta	awful
Haʻurumaʻi	awkward
paahia	awkward
Aymara	Aymara
tama	baby
pēpe	baby
mahana pōro'a	bachelor
I muri	back
pū'ōfa'i	background
Tu'ihorehore	background
ino	bad
tete	bag
tuatini	bait
Pōre'ire'i	bait
Apu	bake
toro'a	bake
fare 'eura'a faraoa	bakery
hōpue 'ava'ava	baking soda
tō'u	balance
nā'u	balance
tā'u	balance
poi	ball
Bambara	Bambara
mai'a	banana
mei'a	banana
Manahune'	band
Para'i	bang
Fare Moni	bank
fare tama'a	bar
ōmai'ōmai	barely
tauruma'a	bargain
O'oro	bark
pāere	barley
Maruā	barrier
fare pāpa'o	base
Papau	base
Fa'a'ite	based
I roto i	based
Fare pō	basement
matamua	basic
papa	basically
faapu	basil
Tahuri	bastard
tō'era'a	batch
papai	bath
Fa'apopo'i	bath
Fa'amaru	bath
fare o'o	bathroom
paraiora	battery
putu uira	battery
Tu'aro	battle
tāma'i	battle
aro	battle
Tere	bay
ei	be
vai	be
tāviri piti	be careful
E māuruuru	be careful
Ono	beach
Patu	beam
āpo'ora'a	beam
Ma'a	beans
pea	bear
pā'āto'a	beard
pauroa	beard
tā'āto'a	beard
Mau	bearing
manu 'ō'u	beast
Parau	beast
te tapa	beat
Vahine	beat
hāviti	beautiful
nehenehe	beautiful
a'ia'i	beautiful
mā'ohiee	beauty
Ua haere	became
nō te mea	because
fa‘aora‘a	become
Oia	become
Moenga	bed
piha ta'otora'a	bedroom
manu meri	bee
moa	beef
i te tahi	been
Ua	been
Pia	beer
i mua	before
ha'amata	began
tīmata	begin
tīmatatā	beginning
Fa'atupu'ā'iti	behalf
Fa'ahoho	behalf
Fa'aau	behalf
fa'ahou	behave
fa'ahorohorotia	behavior
Tā'ere'ere	behaviour
parau tahataha	behaviour
i muri	behind
te 'oa	being
Tau i teie	being
peu	belief
ti'aturi	belief
Manatu	believe
Māuruuru	believe
Vaevae	belly
tāna'i	belong
Aita'a	beloved
Fatu i te 'āmo'a	beloved
Mahana	beloved
i raro	below
Hānau	belt
Aupū	bench
Nihoniho	bench
hīrere	bend
vaharaha	bend
parau	beneath
Amari'i	beneath
fa'ahau	benefit
Fa'atoro'	benefits
i te tua	beside
roa	besides
maitai eraio	best
pea	best of luck
manuia	best of luck
Te ha'ari noa	best regards
maita'i a'e	better
i roto	between
i roto pū	between
Pia ravarava	beverage
ātea	beyond
Bhojpuri	Bhojpuri
tāmau	bias
i teie nei	bias
pūnohu	biased
pere'o'o tāta'ahi	bicycle
tarai	bid
Nui	big
pātia	bike
pia	bill
Vā'ana	bill
taui	bind
manu	bird
uru'uru	birthday
Tāpaʻo	bit
ope'ope	bite
pape	bitter
Totoa	black
mataoa	blade
ape	blame
ta'utini	blank
Fa'ahou	blank
ta'urima'a	blanket
puhi	blast
Tītara	bleach
peretāne	bleach
purutu	bleach
Fata'o	blend
pāto'era'a	blend
tapuhia	bless
Tapu	bless
ma'ite	blessed
Manava	blessed
tarara'a	blind
Maruhi	bliss
pape	block
toto	blood
tiare	bloom
Fāʻea	blow
Turi	blue
uriuri	blue
Maru	blunt
tā'iti'iti	blunt
Papai	board
Pape'ara'a	board
va'a	boat
Tinana	body
tino	body
ā'ite	boil
Māmu	boil
Haumaru	bold
taure'a	bond
ivi	bone
Tātou	book
Puka	book
pū'i'ōfa'i	boost
Ha'amata	boost
tūtaki	booster
Apura'i	booster
Tupu	boot
Pāpū	boots
Afa	border
Fara'arai	bore
pāruru	bored
ʻInuʻinu	bored
ha'umani	boring
Tama	born
hō'ē'ē	born
Amu'ai	borrow
Faʻaʻatā	borrow
Haka	boss
pītia	boss
piti	both
rua	both
Tiri	bother
Faʻaherehia	bother
Pārau	bottle
Pōti	bottle
Tāpa'ō	bottom
Tiʻa	bottom
hana	bought
Pōnuhipi	bounce
tūtaki	bound
Tūturu	bound
Tu'uhia	boundaries
Tu'a'i	boundaries
Pārurū	boundaries
i'ei'e	bow
nave	bow
ruperupe	bow
Tārā'ura'u	bowl
pā'ara'a	bowl
Pouāpū	box
rātou	boy
tāne	boyfriend
tāpe'a rima	bracelet
ihu	brain
te tahi mau	branch
ha'amana	brand
ma‘ohi	brave
Tāpou	brave
Tari'a	breach
pā'ea	breach
Faraoa	bread
pararī	break
fati	break
pa'a'ina	break
Paru'a	breakfast
rima'i	breast
ma'ū'ū	breath
Hanu	breathe
tā'ava'ava'a	breathe
Matahiti	breed
tātara'a	breed
porotini	brick
Kave	brick
pa'ōhau	brick
ahine tāne	bride
vahine ta'ata	bride
āpu	bridge
Ō'otu	bridge
i roto	brief
Mara'amu	bright
Maʻa	bright
parautia	brilliant
āfa'i	bring
tari	bring
Tō'outāne	bro
fa'atere	broad
Ta'ata	broadcast
Raro'i	broke
Pōro‘iho	broke
ta'ape'ape'a	broken
purūmu	broom
porōmu	broom
teina	brother
tū'ane	brother
tua'ana	brother
fa'aturehia	brother in law
Hana	brought
A mai	brought
Pae	brown
puraunu	brown
fare 'ō'ara	brush
pātete	bucket
Tū	buddy
i roto	buddy
moni here	budget
ino	bug
Nōnō	bug
ātea	build
nei	building
oi'oi	building
vave	building
patu	built
fa'ati'a	built
āmuiae	bulk
Tauraa	bull
matu'a	bully
Pu'ea	bump
Punarua	bunch
Pūāru	bunch
Pū	bundle
Tā'ā i te fārau	bundle
pu'e	bundle
ta'apāpū	burden
ta'atahi	buried
Tāpī	buried
tō'iri'iri	burn
fa'ata'uri	burst
Tūtū	burst
hō'iti	bury
tāneva	bury
mīra'a	bus
Aute	bush
aihere	bush
Faʻahana	business
Tatau	bust
ohipa rahi	busy
vata 'ore	busy
terā rā	but
āre'a rā	but
puaka	butter
Mōno'i	butter
Pī'ihirere	butterfly
Pūtōni	button
Hana	buy
i	by
I te aha	by the way
pārahi	bye
Ta'e	cabbage
taputapu	cabinet
piha	cabinet
Pu'āina	cage
parai	cake
mō'ō	calf
ha'ere	call
Tāhiti	call
Tā'ū iā'u	call me
ki'i'a	called
Māuruuru	calm
Moemoeā	calm
tae	came
ohipa	campaign
nehenehe	can
Aita	can't
Tautea	Cancel
Pau	Cancel
rēma'i	cancer
Kaina	cancer
Marautaki	capable
ōfa'i	capable
Pūnaha	capacity
ōhipa	capacity
pū'ōfa'i	capital
Fa'ahou	capital
to'a i te tumu	caption
Pepa'ōni'a	caption
Pāpā'ōni'a	caption
aito	capture
E hia	capture
Vehi	car
Va'a	car
Haereere	career
ohi'ohi	careful
Hōhonu	careful
Rima	carefully
Fa'a'ito	careless
Fa'atere	careless
Fa'atiti'a	careless
A'au	caring
Tino fā'aiteraa	carpenter
vauvau	carpet
karotā	carrot
Karoté	carrot
Tōʻu	carry
fa'ahō'iti'iti	carry on
Ātete	carry on
Tā'ā i roto i	carry out
amo	carry out
Hō'ā	carry out
ato	case
Pūtea	cash
tauturu	cast
Tu'ara'ara	cast
Vaitata	cast
pare nui	castle
aora'i	castle
nei	casual
taunei	casual
Pōpōne	cat
paka	cat
Taro	catch
Tā'ere'ere	category
hōrā	category
Taro	cattle
Fa'aro'o	caught
Hūhū	caught
parau	cause
Nohoʻana	cause
Fa'ama'arohi	caution
Fa'atere	cautious
Tauturu	cautious
Tevā	cautious
Ana	cave
fa'ahurura'a	cease
Fa'amahana	cease
tua'ōfa'i	ceiling
Ha'ati'a	celebrate
fa'ati'a	celebrate
pirae	cell
Farefenua	cell
Ōfa'a	center
āputea	center
Fa'a'aputo'ō	century
matahiti	century
Moe	cereal
orometua	ceremony
te tahi mau	certain
E manaʻonaʻo	certainly
ārāpō	certificate
upoo	chain
noho'iti	chair
tāuru'uru	challenge
Ti'aturi	challenge
Tu‘uātea	chance
āmui'ōfa'i	chance
taui	change
Auē	chaos
fa'aheuea	chaos
Tuhaʻa	character
ā'ora'a	characteristics
Tauturu	charge
Tahua	charge
ha'api'i tāvana	charity
to'o	charming
Tu'uru	chart
Tā'ā pūrere	chart
Mahere	chart
mōrī	chase
rama	chase
ori	chat
Ōrero	chat
Itiiti	cheap
manako	cheat
Tauhiti	cheating
Tiaki	check
tiàna	check
Ti'aporo	cheek
maru	cheer
ma'ohi	cheerful
'Amaru	cheerful
Manuia	cheers
varaoa	cheese
Fa'aterehia	chemistry
Aroha	cherish
Kirihimete	chess
pu'are	chess
paruāvārua	chest
Pōroʻī	chest
mōkihi	chew
kai	chew
moa	chicken
Tāvana	chief
oia	child
ōna	child
Tamari'i	childhood
Tamarii	children
maita'i	chill
fa'atauaroha	chill
ha'apūpūra'a auahi	chimneys
fa'anunu	chin
Teatea	chocolate
hō'ē	choice
Ha'amana'o	choose
Tāmataʻi	choose
haka'uru'uru	chop
tō	chop
ha'uti	chores
Moenoa	chubby
Fare Pure	church
atitia	cinnamon
tā'atira'a	circle
Pō'e	circle
parau fa'a'ōfa'i	circumstances
tino huira'atira	citizen
Ta'ata	citizen
hōpi'ipi'i	city
fa'ahiahia	city
aniani	claim
ani	claim
ha'amāramarama	clarify
Tāpete	clarify
fare ha'api'ira'a	class
Rā'au	class
Ma'a	clay
rauu	clean
Pūai	clear
Tōtini	clerk
Mārohirohi	clever
ʻĀpī	clever
Auro'	client
Nohohiti	cliff
Ora'a	climate
matie'ā	climate
Kake	climb
ho'ē'ē	climb
Putē	clingy
tau	clock
uāti	clock
hora	clock
Fa'aitoito	close
Tautea	close
puni	closet
pātia	closet
A'au	cloth
paruā	clothes
Pareu	clothes
ao	cloud
Aurara'a	cloudy
ta'ata fa'a'ata	clown
Tumu	clue
ta'ito'o	clue
Tu'urū	clue
ti'a'āpa	clumsy
hui	cluster
vai	coach
pape	coach
kōru	coal
Tai	coast
Tipa'a	coat
Kafe'	coffee
Mā'ohi'ā	cognitive
Mahi ‘ohie	cognitive
Aho noa	coincidence
ma'ariri	cold
anuanu	cold
to'eto'e	cold
pa'aro	collapse
maoro	collar
hoa'ōhipa	colleague
hoa pīkona	colleague
Hōa tāne	colleagues
tā'atira'a	collect
Huira'a	collection
fare ha'api'i tāvana	college
Ta'ere fārāni	college
Tae	color
Te mau faatere i te matāvai tāpura e rave pūnohu	colorless green ideas slept furiously
Tā'ata'utea	colour
tae	colour
Pū'āvai	column
ōmura'a	column
Ti'a	comb
hō'iraa	combination
Fa'ahou	combination
tā'ahia	combine
haere mai	come
a haere mai	come here
haere mai	come on
mā'ohi wio	comfort
Maʻa	comfortable
Haere mai	coming
parahi	coming
Amuiraa	coming soon
Āfa'i	command
Ānana	command
Āpī	command
Taua	comment
Tuha'a	comment
ōfa'i	commercial
Ture	commission
tā'ore'a	commit
Taʻu	commitment
tā'ōhipa	committed
pape	commodity
mā'ohi	common
Tā'atira'a	communicate
maita'i	communication
ē	communication
fa'a'ōno'o	community
Ha'amoe	commute
haere i te ta'ata'a	commute
hoa	companion
ta'ata	companion
ʻĀmui	company
tū'era'a	compare
Ta'ati'a	compare
Hō'ere	comparison
aroha	compassion
arofa	compassionate
aroha	compassionate
tauru'a	compatible
tata'u	compete
aravihi	competent
Tū'āiti'iti	competent
ʻĀmuiʻaga	competition
Taura'a	competitive
parau tahiri	competitive
ohipa	complain
rave	complain
tātara'a	complaint
toro	complement
Taʻu	complete
Ta‘ata‘i	completely
Tā'ora'ora	completely
ha'api'ira'a	complex
ha'apa'ape'ōfa'i	compliance
ite	complicated
ha'amana	compliment
Ta'ere	compliment
Fa'aharuru	comply
fa'ahoro'ā	composition
fare faufa'a	compound
fa'a'ōfa'ihia	comprehension
mana'o	comprehensive
uira'a	comprehensive
ta'ati'ati	compromise
Tōmipara'a	compromise
ta'ato'era'a	compulsory
Aita e ārahitia	compulsory
ta'atārere	computer
pae'ōra'a	concentrate
Nohoraa	concept
fa'ahiti'ira'a	concept
fa'a'ite	concern
tuhi	concern
Manaʻonaʻo	concerned
Āpo'ora'a	concert
'Ātamu'ohi	concert
Pārurū	concert
tā'ei	conclusion
Pape'ō	concrete
pape'amu	concrete
Tuhaʻa	condition
nā'āra'a	conditions
Haʻamanaʻo	conduct
Aito'iti	conference
Ohipa'a	conference
Ātamu'ohi	conference
Āha'i	confess
riro	confidence
Matamatahīnihi	confident
fa‘a‘ora‘a	confirm
Vānaʻa	confirm
fa'aro'o	conflict
ʻAteaʻe	confused
ahopu	confusion
Tāmā'ara'a	confusion
Nānāra'a	congrats
Mauruuru	congratulation
pōpō	congratulations
Fa'ahiti	conjunction
mātūtū	conjunction
tū'ati	connect
nape	connect
firi	connect
Tia'i	conquer
inaha	conscious
ina'a	conscious
Papau	consciousness
fare mā'ohi	consent
pū'āro'a	consequences
Fa'ahouraa	conservation
Mauhū	conservative
tohu	consider
tūhia	considered
Mau	consist
Tāhito	consistency
Tā'ito'o	consistency
matamata'i	consistency
pāpū	consistent
ihoā	consistent
Taimi pū	constant
māra'a'ōfa'i	constant
Tāmata	constantly
Manāmanātōtō	constipation
aito	construction
Fa'ahou	construction
‘Arahu	consume
Ē'ē	consume
pā'apu	consumption
Hō'o	consumption
auē ho'i ē	contact
Fa'aterehia	contagious
Tūturu	contain
pū'ai	contain
faarue	contains
ta'irāpāpā	contemporary
U'i'a	contempt
Faufaa	content
orometua	contest
pūai	context
fenua ra'ituāta'a	continent
Oaoa	continent
ha'ere	continue
Āraa	contract
aito'a	contract
fa'a'ōhipa	contrast
fa'ahō'ē	contribute
Tau	contribution
āmura	control
Fa'aito'ito'ira'a	controversial
pā'ū'ū	convenience
Tano	convenient
ōrero'āni'a	conversation
Fa'aāpure	convert
fa'a'amu	convert
fa‘ahiti	convey
fa'atoro	convey
mahuti	convince
ti'amā	convince
matara	convince
fa'atino	convinced
tunu	cook
Fa'aru'uru	cooking
tunura'a	cooking
maita'i	cool
nave	cool
Ōha'i	cooperation
Tāpa'opa'o'	cope
kōpā	copper
uru'uru	core
Pūrera'a	core
tō papa'ā	corn
Rima	corner
Tika	correct
‘Ātoa	correct
Faʻahou	cost
perēue	costume
ra'atira	costume
ahu	costume
Fare pae	cottage
Kōtona	cotton
koniti	cotton
haavare	couch
Hāʻau	cough
ha'amaitai	could
hui	council
fāito	count
pūhoro	counter
Fenua	country
Fa'ahoro	countryside
fenua ma'ohi	countryside
Aīna	couple
ta'ata piti	couple
fa'ahoro	courage
Ara	course
matahiti	course
arata'i	court
avei'a	court
Maru	courtesy
Manava	courtesy
taea'e	cousin
fēti'i	cousin
vaitaea'e	cousin
maita'i	cover
fa'ahiahia	cover
Ahi	cow
pu'a'ā	cow
Tau	coward
pape'ore	cozy
pāpa'a	crab
Pōneke	crack
Hiro'a	craft
Mahani	craft
Ni'o	crap
fa'ato'ofa	crash
tae'i	craving
Tepa	crawl
Faaheuea	crazy
fa'ahono	create
fa'aro'i'a	creative
Tā'ō'a'o	creative
here	credit
Apoapoa	creep
peapea	creepy
puna‘oa	crew
tiaturi	crew
Afa	crime
hararaa	crime
Haʻuruʻuru	cringe
Pīni	crisis
to'etoe	criteria
ōpere	critical
hōro'a	critical
Pa'ea'ati'a	criticism
māutinitini	criticism
Mahina	crop
rau‘araa	crops
ti'aturi	cross
Tāpao	crow
taure'a	crowd
Tau'au	crowd
ite'ite	crowded
Pauru	crown
ōta'uta'a	crucial
āpipī	cruel
Tere'a	cruise
here	crush
auē	cry
kūkoma	cucumber
ha'ama'aiti	cuddle
nihinihi	culture
nehenehe	culture
purotu a'ia'i	culture
Tō'u'ā	cunning
Taravaraa	cunning
kōpapa	cup
tiuti'a	cupboard
Tūtū	cupboard
tefa	curb
kara	curb
fa'ato'atoa	cure
fare rahu	curfew
Tāhito'āina	curiosity
Faʻahiti	curious
Nānā	curious
Ririnui	curly
moenui's	currency
tāmau	current
i teie nei	current
I teie matahiti	currently
I teianei	currently
vaitata'a	curse
Pakapaka	curtain
fa'arari'i	cushion
Tapa	custom
Fanaua	customer
Tā'āporo	customs
Kati	cut
i'ei'e	cute
nave	cute
ruperupe	cute
Āfa'i tere	cycle
Tarava'a	cycling
pāpā	dad
pāpā	daddy
metua tāne	daddy
Matua	daddy
Ia'ore	daily
mahana tātou	daily
Fāre taro	dairy
toa	dam
Ti‘a‘i	damage
Tauraa	damage
Ē	damn
au'au	damp
Ori	dance
‘Ori	dance
paruru	danger
Ma'ohi	danger
pū'ava'e	dangerous
fa'ahiahia	dark
Pūaiarii	darling
mama‘u	darling
Ha'amaitai rahi	dash
ha'afaufa'a	data
Ātea	date
Mahana	date
tamāhine	daughter
tamahine	daughter
Mahana	day
au	dead
here	dead
tāpa'au	deadline
fa'ate'a	deaf
ōpere	deal
ōhopa	deal
e hoa 'ino mā ē	dear
Hoihoi Te Oe	Dear All
ta'ata hōani	Dear Customer
hōani	Dear Customer
e te mau metua	Dear Parents
e te 'Orometua	Dear Sir
e te mau pīahi ē	Dear students
e te pupu ē	Dear Team
amu	death
ai	death
tāmā'a	death
Tī'ā'āra'a	debate
Tahi	debit
Rahi	debris
to'a	debt
Matahiti ‘ahuru	decade
Pae'āro'a	decade
Tō'eto'e	decay
Mā'ea	decay
Ānau	decay
matetahi	deceased
farehau	deceased
Aro'ara'a	deceive
tītema	december
mārōto	decent
Tū	decide
tūhia	decided
Taea	decided
Hōʻihiihi	decision
mana‘o	decision
Ōtara	deck
Taʻeʻe	decline
tō'ere'ere	decrease
fāfā	dedicated
piri	dedicated
fātata	dedicated
Fa'atino	dedication
fare ha'api'i	deed
Pape	deep
Hohonu	deep
Nono	deer
pāpāho'i	deer
Tumu'iti	default
Tautea	default
ha'erepe'a	defeat
fa'ateniteni	defend
Fa'a'ite	defend
fa'a'āra'a	define
Fa'ahou	define
pāpū	definitely
ihoā	definitely
Tūturu	definition
pahono	definition
putu	degree
Taʻere	delay
Ho'iho'i'a	delayed
tūmā	delete
fa'a'ore	delete
fāhaamio	deliberate
fa'a-here'a	deliberate
ā'ao'a	delicate
Menemene	delicious
Mahana	delicious
Orara'a	delight
ma'ohi'ohi	delighted
Tā'ata	deliver
Fa'a'ōpu	delivered
Tā'ata'a	delivery
Tāparu	delivery
ʻUiʻui	demand
āpōpō	demanding
faanatura	demanding
ti'amāra'a	democracy
tēmoni	demon
tiaporo	demon
fa'a'ore'a	demonstrate
tō'u	denied
Fa'a'itehia	denied
Ti'aturi	density
taote niho	dentist
tapahi	deny
fare to'a	department
fa'aitoito	departure
māra'a	depend
fa'ahou	deploy
Haere i roto i te mātini	deploy
ti'a	deposit
vata	deposit
Fa'uru	depressed
pāpā'amu	depression
Rārārā	depth
Ta'u i te ta'ata	describe
Tuʻaroʻa	description
Tuhinga	description
Atōra'a	desert
hauhauru	deserve
Hōhonu	deserve
mātāmua	design
mātāmeha'i	design
a tahi	design
ī'oa	designation
Hiahia	desire
haapiiraa	desire
e'ere	desk
aita	desk
Ino	despair
noho	desperate
fa'aea	desperate
noa atu	despite
nui	dessert
rahi	dessert
Toʻerau	destination
ha'amata	destiny
horoi	destroy
Rāviri'a	destruction
Riri'i	destruction
Fa'ari'i	destruction
faahiti	detail
mā'ohi	detail
nō teie	details
fa'ahiti	detect
Tu'aro'a	detect
a'ahiti'ira'a	determination
Hōʻoia	determine
Taʻu	determined
vāvahihia	devastated
fa'a'orehia	devastated
Faʻaaito	develop
Tuatinitini	developed
fa'atūtū	developed
Fa'ahau	development
Faʻaaito	development
Īmara'a	device
Rārue	device
Ino	devil
ma'ohi	devoted
Ātuparau	devoted
Dhivehi	Dhivehi
pāpera'i maha	diabetes
ma'i poria	diabetes
ma'i hī	diarrhea
pōpōpōhuna	diarrhea
puta moeānihi	diary
puta fa'atoro	dictionary
titionare	dictionary
fa'atoro parau	dictionary
Ua	did
Ō	did
mate	die
pohe	die
mate	died
pohe	died
arohaehae	diet
Fa'aito'ira'a	difference
ta'a'ē	different
māere	different
māuruuru	difficult
Riri	difficult
fetu	dig
heri	dig
Ua tāvana'a	dignity
mā'ea'ea	dignity
ha'amāa	diligent
Tīnā	dinner
Tāhuna	dinner
Hō'ai	dip
fa'atūtū	direct
aratai	direction
tamari'i	director
tumuāra'a	director
mana'apu	director
repo	dirt
ne'one'o	dirt
Pahaʻa	dirty
fa'a'aehia	disable
Fa'atoro	disable
Tu'iro'o	disabled
tō'iri'iri	disappear
Faʻaherehia	disappointed
fa'au'u	disaster
Fa'ahou	disaster
Ha'api'i	discard
ta'ape'ape'a	discard
Faamamau	discharge
Fa'ato'a	discharge
aore rā	discipline
Tā'ere'ere	discount
fa'ahou	discover
Tā'ā	discover
Fa'ahotu	discrimination
i mua	discuss
Tuha'a'āra'a	discussion
Ma'i	disease
Ora	disease
Ohirohi	diseases
tāpapau	disguise
mā'ea'ea	disgusting
fa'ahina	dish
Fara	dishes
tapa'i	dismiss
Tāpapa	dismiss
Fa'atāviri	dispatch
āpōpō	display
ananahi	display
mautinitini	disposal
Farerei'a	dispute
fa'a'au'au	dispute
Tā'ō'ū'ū	distance
tō'a	distance
fa'a'ōhipa	distinct
i teie mahana	distinguish
i teie nei	distinguish
Pīpītū	distress
tā'atira'a	distribution
Fa'atupu'ā'iti	distribution
Fenua	district
ra'ā'ōfa'i	district
Haumaru	disturb
a'au'au	disturb
Ape'ai	ditch
Fa'ahouraa	dive
varirata	diverse
Fa'aite	diverse
Fa'aro'i	diverse
mātāmua	diversity
Fa'aiteraa	diversity
Tātūtū	divide
Raiā	divine
Riro	divorce
'Ōpu'ū	divorce
fa'ata'a	divorce
rūhiehie	dizzy
Tāvini	dizzy
fa'a	do
ha'a	do
rave	do
E aha 'oe	do you
e aha nei 'oe?	do you
e here ānei 'oe iā'u	do you love me
Taote	doctor
parau	document
Tuha'a tupu	document
pu'eparau	document
fa'ahoro	does
Ua	does
Aita	doesn't
ʻŪrī	dog
Ūrī	dog
Dogri	Dogri
ha'api'ira'a	doing
Vahine	doll
rohi	domain
Fareātea	domain
rahi	domestic
haumana	dominant
Rā'au 'Ōrā	dominant
Fa'ahou	dominant
aita	don't
Aita e hōhā iā 'oe	Don't worry
aere mai	Don't worry
Hauhau	donate
hopehia	done
ravehia	done
otihia	done
ūrīta'ata	donkey
Tā'ora'ora	dope
tāta'ipiti	double
tarariri	doubt
Haereōrā	doubt
Pū'	dough
I raro	down
ta'ata'e	download
huri mai	download
Tapuni	draft
pahono	draft
Ha'a	drag
tō'iri'iri	drain
Pāpāri	drain
ta'ere	drama
Fare 'ōrara'a	drama
Tāpaina	draw
tatau	draw
huri'āni	drawer
Fara pātia	drawer
fa'atoro	drawing
taparahi	dread
tu'u	dream
aute	dress
Tē'ē	drill
ua feruri au iā 'oe	drink
tē mihi nei au iā 'oe	drink
au	drive
poihere	drive
here	drive
Hoʻoarii	drop
rēkareka	drop
ta'oto	dropped
Tūhono	drought
tū'ere	drought
Reva	drunk
inu	drunk
Mate	dry
pā'iri	duck
pāpū	dude
mau	dude
Tūtaki	due
aroha	due
no te reira	due to
No te fa'atoro	due to
Faufaʻa	dull
mata'iti'i	dumb
te tahi mau	dump
taime	duration
nā roto	during
raveroa	dust
fa'a'ōfa'i	duty
noho	dwell
No'ano'a	dwell
Mate	dying
tāta'itahi	each
Ia 'orua	each other
āpērā	each other
tahito'o	eager
āeto	eagle
taringa	ear
i mua	earlier
Mahana mua	early
te anani	early
hīrī	earn
tari'a	ears
taringa	ears
enua	earth
Fa'ahou	earth
āueuera'a fenua	earthquake
tāmarū	earthquake
Tanoa	ease
maitai	ease
ōhie	easily
fa‘a‘itiiti	easily
rārue	east
Rima'i	east
Māuruuru	easy
Tino faʻaora	easy
amu	eat
ai	eat
tāmā'a	eat
Inu	eating
ai	eating
fa'arava'ira'a faufa'a	economic
fa'anava'ira'a faufa'a	economic
fa'ahotura'a faufa'a	economic
Ufi	economy
Raʻi	edge
Fārito	edit
ʻOra	education
tāpe'ape'a	effect
Ha'amana	effective
ma'ohi	effective
faatupuuruuru	efficiency
Mau	efficiency
Tere	efficiency
Mau	efficient
Fa'atere	efficient
ha'apa'ape	efficient
Tau	effort
hauhauraa	effort
oe	egg
hua pua'aniho	eggplant
Aroha mai	ego
va'u	eight
ahuru ma va'u	eighteen
va'u 'ahuru	eighty
e'ere	either
aita	either
fa'a'ōhia	elaborate
‘ōno‘ono‘o	elaborate
pūpū	elbow
ruhiruhiā	elder
tupuna	elder
Ōpu'ā	elderly
Mata'ora'ora	elegant
Mata'iti'iti	elegant
fare'ehau	elegant
ī	element
mea	element
erefani	elephant
ahuru ma hō'ē	eleven
ana	eligible
tōna	eligible
tāna	eligible
tango	eliminate
Ētahi atu	else
Rē	else
Tāpū	embarrassed
haapiiraa	embarrassing
Taʻu	embrace
Ēma'ohi	emerge
Fa'aitera'a	emerge
tu'ura'a	emerge
tei'a iti	emergency
Moehāhā	emotional
āhuru	empathy
Tau'a	emphasis
fa'ati'a	emphasis
Tāpiti	emphasize
tāvana	employee
Tavana	employees
tōtahi parau	employees
tātou	employer
Ohipa	employment
Puai	empty
Tāuru	enable
Hau	enable
hete	encounter
huru	encounter
fa'aitoito	encourage
mutu	end
Tātāne	endangered
haururu	endeavor
to'ura'a	endurance
fa'a'ōfa'i	endure
Mauhū	enemy
Mana	energy
tā'amu'amu	engage
āmui	engaged
Aha'otepo	engaged
fa'a'ohipahia	engagement
ravehia	engagement
ha'api'ira'a	engine
ta'ito'ito	engineer
Anglais	English
Faʻaaito	enhance
ha'amaita'i	enjoy
ata'ata	enjoy
oa'oa	enjoy
nui'āmu'amu	enormous
nava'i	enough
rava'i	enough
tiaturi	ensure
tae atu	enter
ha'umani	entertainment
ha'ari'ari	enthusiasm
ma'ohi	enthusiastic
Fa'ahiamoe	enthusiastic
āmui etao	entire
tētahi	entitled
Tupu'ā	entity
Fa'a'ū	entrance
ārea	entrepreneur
tuha'a fenua	entrepreneur
fa'a'apu	entrepreneur
tūmau'a	envelope
heipuni	environment
arutaimāreva	environment
tere	envy
Tapapoto	epic
Āmui'ē	epidemic
tia'iri	equal
Tā'ō'a'ō	equal
Faufaaʻi	equipment
Rarahu	equipment
purapura'āmara'a	equity
piti'i noa	equivalent
pahere	eraser
Māuruuru	error
Tukinoinoi	error
tatau	escape
A te mea	especially
nui atu	especially
parau tahiti	essay
rā'ā	essence
Ta'ata'a	essence
ī	essential
mau	essential
faufa'a	essential
fa‘ahiti	establish
fa'a'ōfa'i	establish
māfatu	established
hutu	established
hata	established
Ārue'ura	estate
ia maita'i te 'āru'i	estimate
ia maita'i te ru'i	estimate
ia maita'i te pō	estimate
Tefarere	estimated
e tē vai atura	etc
Ta'ata tātou	eternal
fa'aturehia	ethics
fa'auehia	ethics
ta'a'ati	evaluate
ta'a'ati	evaluation
ā	even
oia e	even though
Pō	evening
tū'ātura	event
‘ātea‘a	eventually
I te mutu	eventually
Tae atu i teie	ever
aoti'a	every
Ei'a	everybody
Ia mea	everyone
Te mau mea	everything
Te mea 'āmui	everything
Tāpaʻo	evidence
aio	evil
ha'apa'arira'a	evolution
nu'ura'a	evolution
fa'ahou'ia	evolve
ōtiraa	evolve
Ewe	Ewe
i mua i	ex
māna'o māro'o	exact
ihoā	exactly
mau	exactly
parau tāpa'a	exam
Tāuru tā'ito'o	exam
Tahiti	examine
Tauā'ā'iti	example
tū'ā'āhuru	example
Anaea'	exceed
Maitai roa	excellent
Teatea	excellent
e'ere	except
Putuputu	exception
parautia	excess
Fa'ahou	excess
taumaha	excessive
ā'ore	exchange
hōpi'ipi'i	excited
fa'ahiahia	excited
Fa'aipoipo	excitement
Fa'atere	excitement
Aito	excitement
ma‘ohi	exciting
ʻĀrearea	exciting
tahataha	exclusive
Ha'apape	exclusive
Mauri	excuse
āviri mai	excuse me
Fa'a'ōtia	execute
haapapa	execution
tāta'itahi	executive
Tāmā	exercise
‘ōrero‘anga	exercise
ha'amu'ora'a	exhaust
Roa'ara'a	exhaust
Ua taparahi	exhausted
Hō'ē	exhibit
tapaharaa	exhibit
ha'amāmā'ā	exhibition
fa'ato'ito'i	exist
Ora	existence
Oe	existing
mau	existing
Parepare	exit
nōno'a	expand
hi'opo'a	expect
Tuatā	expected
fa'ato'atoa	expected
Ēperesi	expenses
Pūai	expensive
moni	expensive
ohipa	experience
hi'ora'a	experience
tahitias	experiment
tauraa	expert
ta'oto	expired
Haʻamanaʻo	explain
Tuha'a'āra'a	explanation
Fa'ahou'ai	exploit
Fa'a'itehia	exploit
Fa'ahou	exploit
ha'api'ie	explore
Fa'ahouhia	export
hō'ē'ē	export
Fa'atupu	expose
Riro	exposed
tōro'a	exposure
ohipa	exposure
terā rā	express
āre'a	express
i roto	expression
i roto pū	expression
Fa'a'ō	extend
fa'atātou	extend
Tūte'a	extended
fa'a'ite'a	extension
āmuious	extent
tōmotu	external
tahito	external
Tā'iti	extinct
ē	extra
Ho'ē'ē	extract
pōrīnitia	extraordinary
pahefā	extreme
Parau	extreme
maitai roa	extremely
Tino fa‘atupu	extremely
Mata	eye
mata	eyes
Tō'oraa	fabric
ma'ohi'ohi	fabulous
Fa'ahou	fabulous
aore roa atu	face
aita roa atu	face
Tārava'a	facilitate
Fare	facilities
fare ha'api'i	facilities
fare ha'ere	facility
āite	fact
Fa'ahoro'ā	factor
Fare hānau	factory
ohipa tupuhia	facts
Fehuehu	fade
Mā'u	fade
i	fail
tohe	fail
faahiti	failed
putu	failed
Maʻaehara	failure
ti'a'āpa	faint
Pāpū	faint
hanahana	fair
pa'iatua	fair
ōro'a	fair
Tōtō	fairly
Pahupahu	fairy
manumana	fairy
Farii	faith
tā'aito	faithful
Tāvana	faithful
parautia	fake
hi'a	fall
tape	fall
topa	fall
ino	FALSE
Fa'aro'i	fame
Taputapu	fame
Fatu	fame
ite	familiar
ōrama'ohu	family
o'e	famine
āmui	famous
Fanaua	fan
Atā	fancy
rahi	fantastic
Roa	far
mamao	far
Nā manuia	farewell
ha'amana	farewell
Āina	farm
ta'ata fa'a'amu	farmer
āpo'o'a	farmer
fa'a'oti	fascinating
Fa'atere	fashion
Mau	fast
Vīvī	fast
Momoe	fat
mō‘ere	fat
puhiraroa	fatal
Mate	fatal
pae'āmui	fate
metua tāne	father
Faʻarepo	fatigue
Faute	fault
ohie'ohie	fault
mī'iti'iti	favorite
ā'ara	favour
Āmi	favour
ite	favourite
Mataku	fear
Tamaaraa	feast
Poe	feather
Ata	feature
‘āpiti	features
Ata	features
Fepuari	february
fēpuare	february
fa'aitiiti'i	fed up
moni ha'ere	fee
Ura	fee
ho‘o	feed
Haʻamataʻu	feed
Taunu'u i te mau fa'a'ite	feedback
e mea	feel
Matapuna	feel
ma'au	feeling
uru	feet
mai te peu	fell
mai te mea	fell
tāne ta'u	fellow
ohipa	felt
Vahine	female
papa'ā	fence
hotu	fertile
Ōrotava	festival
heiva	festival
fa'a'ite'itera'a	festival
tā'ati	fetch
Tā'ā	fetch
Apeʻape	fever
ʻĀite	few
Piti	few
aita roa	fewer
ipo	fiance
Tapā'oro	fiction
ārea	field
tuha'a fenua	field
fa'a'apu	field
riri	fierce
ahuru ma pae	fifteen
a tā hō'ē 'ā-tahi	fifteen
a tā hō'ē 'ā-'īmī	fifty
pae 'ahuru	fifty
tūtau'iti'i	fight
Tātāhi	fighting
rohirohi	figure
fenefene'a	figure
fiu	figure
Tūtau	figure out
tatara'ara	figure out
Pū'āra'a	file
tapū	fill
ho'ē'ē	fill
tapure	filled
hōho'a tāviri	film
Ōrama	film
toetoetā	filthy
ra'ira'i	filthy
ʻIa	finally
Fa'ahora'a moni	finance
moni etei'e	financial
ite	find
heheu	find
Tūtau	find out
tano	fine
maita'i	fine
ia	fine
rima'ōfa'i	finger
manimani	finger
ha'amata'i'iri'iri	finish
Taeake	finish
I tahi ta'u	finished
ahi	fire
tino'iti'iti	firm
mātāmua	first
mātāmeha'i	first
a tahi	first
i'oa matāmu'a	first name
i'a	fish
Tapū	fit
Tā'amu'a	fit
Rima	five
fa'ahou	fix
Tāpa'ō	fix
fa'ahō'iti'iti	fixed
Tiaturi	fixed
Ānere	flag
Tino	flag
ānapanapa	flash
Tu'atā	flash
tūrama	flash
pārahurahu	flat
vaha'a	flaw
Ētita'ita	flawless
A'ani	flee
iri	flesh
ha'avi'i	flew
Tu'are'a	flex
parau parau	flexible
tere ai'a	flight
Fano'i	flip
ta'aviri	flirt
hanihani	flirting
ōrama	flirting
rere	float
Tata'iti	float
inaha	flood
ina'a	flood
Papai	floor
Faraoa	flour
pu'amā	flour
Tuhaʻa	flow
Tiare	flower
maki ho'oatira	flu
Ōri'ā	fluent
i te re'oraa rahi	fluently
ōhie	fluently
Pu'apu'a	fluffy
vaihiti	fluid
manu tere	fly
ha'a	focus
mea	focus
mārō'a	fog
rūpehu	fog
Tātara'a	foggy
pureraa	foggy
Fāre	fold
to'etahi	folks
tamarii	folks
ārai	follow
tauturu i te ha'amata anei	follow up
āpe'e	follow up
Tā'āmui	following
i muri i	following
Aito	food
Ma'a	food
i raro	fool
Hōhā	foolish
Vae	foot
taparaa	foot
Ēte'e	football
futopolo	football
ia	for
nō	for
nā	for
Moekara	For example
tēnei tuatua	For example
ei hi'ora'a	for instance
No te oe	for you
Aore	forbidden
ta'ape	forbidden
ma'ono	force
hō'iti'iti	forecast
Ōpu'apu'a	forehead
Farāni	foreign
rāhiri	foreign
āmane	forest
nā	forever
Pōfiri	forget
Aore ra'e	forget
Fa'aito'o	forgive
mōi'a	forgot
mo'e	forgot
aramōina	forgot
ō'one	fork
Tōʻere	form
Tā'ata ōfa'i	formal
fa'a'ōfa'i	former
nā reira	fortunately
Taime marie	fortunately
haapape	fortune
a tā 'ā-'īmī	forty
maha 'ahuru	forty
a tā 'ā-'īmī 'e	forty-two
maha 'ahuru ma piti	forty-two
I mua	forward
Fa'apea	foster
ha'apahapaha	fought
kitea	found
Oe	found
Tu'apāpū	foundation
fare pūtahi	foundation
maha	four
Piti	four
ahuru ma maha	fourteen
a tahi 'ā-'īmī	fourteen
pē'au	fox
Pehipehi	fragile
a'au	fragile
fa'ai'uga	frame
Ori tahito'a	framework
purutia	fraud
Ririnui	freak
ino	freak
Purotu	free
Manuia	free
Āmui	freedom
pū'a'ite'ite	freedom
pa'ari	freeze
riri	freeze
Fa'anaho	frequency
pinepine	frequent
pa'ari	frequently
e'ere i te mea 'ōhie	frequently
mārō'iro'i	fresh
Farerei	friday
Ture'ara'a	fridge
tahuare'a	fridge
Hoa	friend
ārepurepu	friendly
ānau	friendly
'āueue	friendly
hoa	friends
tō'ere	friendship
aurima'ohi	friendship
penei a'e	frightened
māru'uru'u	frightening
Tīa	frightening
rana	frog
nō	from
Mua	front
āmura	front
pa'ari	frozen
to'eto'e	frozen
ōra'a	fruit
Ōpu	fruit
tia'iro'i	frustrated
tātae	fuel
Hau	fuel
Fulfulde	Fulfulde
pāpū	full
Amaru	fun
Manihini	fun
fa'ahou	function
pae pūtahi	fundamental
Tatara'ara'a	fundamental
no'ana	funeral
Hīmene	funny
rau moa	fur
paraupepe	furious
ta'one'āti'a	furniture
ātea	further
Ia pa'ato'a	furthermore
roa	furthermore
Ahitia	future
Tātou nei	future
Faʻahoʻe	gain
Āfa'i	game
Āpo'opo'o	gap
fa'aite'a	gap
Fare tā'ō	garage
fare'āpipi'a	garbage
Pape 'āina	garden
fare uteute	garden
vaihī	garlic
pātia	gate
ti'a	gather
parau mau	gather
Atu'ara'a	gathering
Fa'atātira'a	gauge
Ūpa'upa	gave
Ūrā	gear
fenua	gender
fa'anava'i	general
fa'arava'i	general
I roto i te ta'ato'era'a	generally
Rā'au 'Ōrā	generally
I te 'āmui	generally
Fa'ato'ura	generate
u'i	generation
Mahana	generous
fa'aitoito	generous
Fa'ahiti'iti	genius
Ra'ā	genre
āfa'i	gentle
Tōmua	genuine
Tō'era'a	genuine
Tu'aro'ara'a	gesture
Teatea	gesture
roa'a	get
nae'a	get
noa'a	get
ō'omohia	get dressed
ōmonohia	get dressed
tū	get up
Tā'	get well soon
Aroha mai	getting
tūpapa'u	ghost
ua uruhia e te vārua	ghosting
hira'a	giant
ā'au	gift
ahere	ginger
Vahine	girl
Vahine tane	girlfriend
tāneivahine	girlfriend
ōpere	give
hōro'a	give
taumahara	give up
a'ite iā 'oe	give up
Tātou	given
Maʻuruuru roa	glad
Mā'i'i	glance
āru	glass
Mata to'u	glasses
Pā'ōri'i	glimpse
Fa'arara'a	glimpse
Fa'atoro	glimpse
Mata'ora'a	global
ohipa	global
Fā'ōri	gloomy
Pūreora	gloves
haavare	gloves
rūru'ī	glow
tuanui i te ra'ā	glow up
Vaiana	glue
piri	glue
reva	go
haere	go
tere	go
haere atu	go ahead
Ha'apape	go ahead
haere atu	go away
haere i te moe	go to bed
ā'ite'ira'a	goal
tino	goal
Oro'a	goals
fā	goals
Pīpī	goat
ʻEhere	goat
Atua	god
to tatou Atua e haruru iā 'oe	god bless you
Haere	goes
tūtaki	going
Tu'aro	going
e haere mai nei	going to
Orā	gold
uri	gone
E tae noa atu au'	gonna
Vai tahiti	goo
maita’i	good
Mahana maeva	good afternoon
ia ora na i te ahoru	good afternoon
nānā	good bye
mahana maitai	good day
ia maita'i te 'āru'i	good evening
ia maita'i te ru'i	good evening
ia maita'i te pō	good evening
mau tino toa	good job
maita'i 'ārahi	good looking
māmāroa maitai	good looking
māuruuru roa	good luck
Monoi aroha	good luck
Monoi ha'amaitai	good luck
Ia ora na	good morning
Maeva te ata e te aroha	good morning my love
ia maita'i te 'āru'i	good night
ia maita'i te ru'i	good night
ia maita'i te pō	good night
nānā	goodbye
Aita i te parau	goodbye
Pō mārie	goodnight
po māuruuru	goodnight
ūra'a	goods
tūara	Google
rāve'a rorouira hurira'a parau	Google Translate
Nu'u	goose
hōtaratara	gorgeous
fa'ahiahia	gorgeous
ōrero pōnau	gossip
oti	got
Tahiti	got
ua haamana	got it
ōhipa	government
tā'uru	grab
Pā'ārarua	grade
pā'ōfa'i	grade
fa'aite	gradually
Fāmanamana	gradually
Fāna'oana	gradually
Parau'	graduate
Varu	grain
taatau	grant
ha'amana	granted
Pūrautai	grapes
Puai	grapes
Opu	grapes
Pīrī	grasp
pā'ōfa'i	grass
Auraa	grass
paha	grateful
penei a'e	grateful
ite	gratitude
heheu	gratitude
Pātītī	grave
fare hōpū	grave
Māmā	gray
Kekeu	gray
Tūtā	gray
nui	great
rahi	great
Fa'ahoro	greed
inaha	greedy
terā rā	greedy
ina'a	greedy
matie	green
E manava	greet
manava	greet
āmene	greeting
Kaore i te ohooho	greeting
Āro'a	greetings
Tauraoi	grey
Pae	grid
parahii	grief
ohie'ohie	grief
tīhō'ura'a	grind
Tū'aro	grip
to'una'u rōhoi	grocery
Mehani	groom
ihoā	gross
mau	gross
fenua	ground
Anana	group
Haʻamanava	grow
Tiatura	growth
tūpāpaku	grumpy
Puoro	grumpy
Guarani	Guarani
Fa'ana'ana'a	guarantee
Pa'epa'e	guard
Tu'uru	guard
Parataito	guard
tu'upiri	guess
Tū'aro	guest
haere mai	guest
Fa'ahou'ura'a	guidance
ino roa	guide
Hāmene	guilty
tāne	guy
vahine	guy
tā'ata	guys
Tā'ato'era'a	guys
Fare tā'ito'o	gym
to'ere	habit
Fa'atō'ofa'a	habitat
No'ano'a	habitat
Tō'eto'e	habitat
Ua	had
i te	had
hinaaro	hail
Ō'ore	hair
Rouru	hair
mātai'āmu'i	half
Tāpa'ō	half
fare pā'ati	hall
Rima	hand
Tāpiri	handle
Fa'ahou	handle
Ma'ohi	handsome
tā'e'e	hang
Aito	hang out
fa'a'ōfa'i	happen
haere atu	happened
pārahi	happiness
oa'oa	happy
ia 'oa'oa i tō 'oe mahana fānaura'a 'āpī	happy birthday
ia 'oa'oa i tō 'oe mahana fānaura'a 'āpī	happy birthday to you
Ia 'oa'oa te matahiti api	happy new year
pa'ari	hard
pa'ari	hardly
taata rahi e	hardly ever
'aore roa	hardly ever
nohora'a	harm
vāhi	harm
fa'aari'i	harmful
tano	harmony
Riri	harsh
aio	harsh
inaina	harvest
Eiaha	has
fa'aterehia	hate
noa'a	have
roa'a	have
Nā te aroha iā te huru rāiā	have a good day
e ia ora na	have a nice day
aihia te 'ina'e	have breakfast
e tano i te afiafi tahi	have breakfast
Haere mārūru	have fun
Ua 'ai 'oe?	have you eaten
Tahiri	having
Faufaa	hazard
Tu'uru'uru	haze
Fa'ararō	haze
Mārō'iro'i	haze
'oia	he
ōna	he
eia na	he has
ia 'ōna	he has
ōtahi	he is
Rima	head
ua pūhā	headache
fa'ato'atoa	heal
Hauhau	heal
rā'au	healing
maitai	health
maitaious	healthy
Tuku	hear
tāuru	hear
pā'oti	heard
māfatu	heart
hutu	heart
hata	heart
Maevae	heat
fa'a'ite	heaven
tuhi	heaven
mārō‘iro‘i	heavy
Tuʻutuʻu	heavy
taraioro	hectic
Po'iri'a	hectic
Maʻa	height
teitei	height
uri	heir
Oro	heist
Tauturu	held
Tari	held
ʻĀpai	hell
ia ora na	Hello
ʻIa ora naʻoe e te ʻāmama	hello dear
'Ia ora na, e aha te huru?	hello how are you
Ia ora na, eaha te huru?	hello how are you
Ia orāna, eaha te huru nei?	hello how are you doing
pae taote	helmet
Tauturu	help
ma'ohi'ohi	helpful
Tā'ō'a'ō	helpful
No te mea	hence
ana	her
tōna	her
tāna	her
Pou'a	herd
i reira	here
i'ō	here
māta'ira'a	heritage
vahine	hesitate
tapeiru	hesitate
ia ora na	Hey
ia ora na	Hi
ia ora na e hoa	hi how are you
ia orāna, 'eaha te huru	hi how are you
Īa ora na	Hi there
taparahi	hidden
Hō'ē	hidden
Tari	hide
va'amata'eina'a	hierarchy
āpapara'a	hierarchy
teitei	high
ha'atietie	highlight
fa'ateitei	highlight
ha'afaufa'a	highlight
ta'uma	hike
pa'uma	hike
pi'i	hike
mātote	hiking
Amaru	hilarious
fa'aro'o	hilarious
pu'ura'a	hill
Ia	him
hō'ai	hint
ia ora	hip
maeva	hip
manava	hip
ao'ao	hips
Pōheva	hips
Fa'ahou	hips
to'ere	hire
‘ohi	hire
te taumata'āvana	hiring
ōna	his
Ona	his
ōna'ō	history
ʻĀhara	hit
Ē	Hmm
Mahani	hobby
tāmau	hold
tāpe'a	hold
mau	hold
pūtō'ō	hold on
ta'ava	hole
ve'ave'a	holiday
veravera	holiday
mahana	holiday
Pahono	hollow
Fare	home
Mahana rorotahi	homework
Mārō'a	honest
Tōtika	honest
e'ere i te ha'avare	honestly
mau	honestly
meri	Honey
Ha'amana'o	honor
mana'o	honor
peapea	hood
Oho	hook
Pio	hop
ti'aturi	hope
āfa'i	hopefully
Mea hopea	hopefully
a'ano	hopeless
faaoro	hopeless
Pae'ō'ō	horizontal
tītārava	horizontal
Pū'ere	horn
māmaru	horrible
Ōrotea	horror
moa	horse
Fare Ma'i	hospital
māeva	hospitality
Taitoʻototo	host
Ha'uru	hostile
ve'ave'a	hot
vera	hot
puahi	hot
hōtera	hotel
Hotera	hotel
Haora	hour
tau	hours
hora	hours
Fare	house
fare	household
nā hea	how
aha	how
E aha iā 'oe	how about you
E aha ‘oe	how about you
e aha tō ‘oe huru	how are you
e aha tō ‘oe huru	how are you doing
e aha tā 'oe e ha'a nei	how are you doing today
E aha te huru o'ou i teie nei ra	how are you today
eaha te mea	how do you do
eaha e parau	how do you do
E haamaitai teie	how is
E haamaitai	how is
Eaha te mea	how is
Ei 'a maha	how many
hia roa	how many
I te hia	how much
E hia	how much
pehea roa	how often
e aha faaruru	how often
e hia matahiti tō 'oe	how old are you
E haere mai roa i te 'āmui?	how was your day
E haere e te pō?	how was your night
āre'a	however
matahiti	hub
Motu	hub
māre'a	hubby
tāne rahi	hubby
Taʻu	hug
Tautai	hug
itirahi	huge
nūnui	huge
ra'ituāta'a	huge
ta'ata	human
Māmāhira'a	humble
Mahana	humble
haumi	humid
Vā'ehi	humid
Pārau	humidity
Tāneva'eva'e	humidity
haumi	humidity
Rau	hundred
hānere	hundred
o vai tō 'oe i'oa	hungry
o vai tō 'oe i'oa pi'i	hungry
Mānava'a	hunt
haka'uru'uru	hunt
Tāea	hurricane
fa'ahiti'ira'a	hurry
a ha'aviti	hurry up
ma'i	hurt
pēpe	hurt
Tāne	husband
fa'ato'atoa	hustle
Fa'ahiri'i	hustle
Fare pōroa	hut
vai mā	hygiene
huru mā	hygiene
pure	hygiene
au	I
‘u	I
vau	I
o vau	I am
Ua ma'iti'i au	I am fine
aere mai au	I am fine
Ua haamaitai au	I am fine
e fa'ahō'ē	I can
a'ite i'a vau	I can't
Aita e au	I can't
E haere	I do
aita vau e 'ite	I do not know
Aita au e 'ite	I do not understand
aita au e mārama	I do not understand
Aita iau'	I don't
aita vau e 'ite	I don't know
e'ita vau e 'ite	I don't know
aita vau i māramarama	I don't understand
aita vau i ta'a	I don't understand
aita vau i ta'a i tō 'oe mana'o	I don't understand what you mean
aita vau i ta'a i tā 'oe parau	I don't understand what you mean
'aita e mō'ina'a iā koe	I don't understand you
Aita au e māuruuru iā 'oe	I don't understand you
Aita au e mōhio	I don’t know
aita vau i 'ite	I don’t know
Aita i roto i te mōhio	I don’t understand
āhiri au	i guess
ua 'itehia	i guess
Ua roa'a	I had
pararī	I have
fati	I have
pa'a'ina	I have
ua rave a'ena	I have been
e ti'aturi au	I hope so
ua 'ite au	I know
Paru	I like
ua fa'apeapea mai au iā 'oe	I like you
Ua here au	I love
Ua here vau i toku tuakana rahi	I love my big brother
Ua here vau i toku taina rahi	I love my big sister
Ua here vau i toku pāpā	I love my father
Ua here vau i toku tuakana iti	I love my little brother
Ua here vau i toku taina iti	I love my little sister
Ua here vau i toku māmā	I love my mother
ua here au iā 'oe	I love you
Ua here roa ia 'oe	I love you so much
Ua māuruuru roa iāʻoe	I love you so much
āroha 'oe nei	I love you too
nui	I mean
rahi	I mean
ua	I mean
ua feruri au iā 'oe	I miss you
tē mihi nei au iā 'oe	I miss you
Ua maita'i te ho'i iā 'oe nui	I miss you so much
E kite au	I see
āha'u e	I see
E mea mauā	I think
Ua māuruuru i te faʻaorometua	I understand
E vāna'a i au	I want
te fiha'u	I want
Te vāvā iā 'oe	I want to see you
Ori 'oe ia'u	I want you
Ua noho au	I was
ʻO au i	I was
E naʻau	I will
e hina'aro vau	I would be
e tiàna	I'm
Ua naʻaue au	I'm
Ua maʻoaʻoa atu au	I'm fine
Ua māuruuru	I'm fine
maitai au	I'm good
teie au	I'm here
ʻE māuruuru roa	I'm sorry
Ua māuruuru roa	I'm sorry
Hau	ice
ū tirīmu	ice cream
ū pa'ari mona	ice cream
inaha	idea
tū'ia	ideal
fareātua	identical
Tō'a'ita	identical
ta'o'ino'i	identify
Mana'	identity
ta'ata fa'aheuea	idiot
a'a	idle
mai te peu	if
mai te mea	if
ta'ō	ignore
Māmaru	ill
Tauturu	ill
Atea'ia	illegal
ta'ata mā'eha'a	illness
Ilocano	Ilocano
ata	image
hōho'a	image
ā'ati'ati	imagine
Mana'o	imagine
opāpā	immediate
ātoa	immediate
Tōmāoho	immediately
faaitehia	immediately
pa'ari	immense
Matamata	immense
ʻUmeʻume	impact
pā'ō'ō	impact
fa'a-'ōhi'a	impatient
onoono	impatient
fa'ahouhia	implement
Tāpū'ia	import
faufa'a	important
faaite	impose
fa'a'ite'ite	impose
fa'ahou'a'ina	impossible
fari'ira'a	impress
ta'ere'ere	impression
Mārō'a	impressive
fa'afaite	impressive
ha'amaita'i	improve
fa'ahōhonu	improve
fa'ati'a	improve
hō'iti'iti	improvement
māhina	improvement
i	in
i roto	in
I te horo'a i roto i	in addition
I roto i te fa'ahou	In fact
i mua	in front of
i te ōhipa	in order to
hōno	inappropriate
haururu	incentive
arata'iraa	incident
ite	include
āmui	including
Moni'	income
ino'ino	inconvenience
māra'a	increase
ha’amata	increased
ōrometua	incredible
inaha	indeed
ina'a	indeed
Tō'ura	independent
Mahana	independent
īnītia	India
tūtara'a	indicate
Mā'ohi	indigenous
‘Ora‘āina	indigenous
Tātou	individual
hō'ai'a	industry
Mahana'ō	industry
tāmau	inevitable
tāpe'a	inevitable
tamarii o te mau oire	infant
Moe vāna'a	infection
mahuira'i	infinity
urahia	inflammation
Tā'i'ini'ini	inflammation
ma'ero	inflammation
iniflēsion	inflation
Tauhōhō	influence
ʻĀrearea	influence
fa'ahōhie	inform
Ma'ohi	information
mea fa'ahiti	ingredients
tupuna	inheritance
ha'ari'a	inheritance
pa'ari	initial
fa'ato'a'ite'ite	initiative
Fa'ahou	initiative
Mo'ohono	injured
papahi	injured
Riri	injury
Māmanava	innocent
faaitoito	innovation
Fa'aterehia	innovation
roto'ara'a	inquiry
faaheuea	insane
manumanu	insect
nono	insect
mō'ere	insecure
Amari'i	insecure
Tefa'atura	insert
arofa	inside
aroha	inside
mihi	inside
ha'ari'ari	insight
hohoa	insist
Tō'ē'ē	insomnia
moe'a'amara'a	insomnia
faaueraa	inspiration
Fa‘amaramarama	inspire
Fa'aterehia	inspire
tā'amu	install
tāpa'apū	install
faaora	instance
Tu'aru'aru	instant
āre'a	instead
Tūpāpā	instead of
To'aro'o	instructions
parau fa'ahou	instructions
Rima'ā	instrument
ta'iri	instrument
Tu'ihia	insult
aite'a	insurance
Vau	insurance
Tāpa'ohia	intact
māramarama	intact
ta'irira'a	integrity
'Ite'ite	intellectual
'Iteite	intellectual
Tōmārūrū	intellectual
Mā'ohi'ohi	intelligence
mārama	intelligence
aravehi	intelligence
mātau	intelligent
Āvara'i	intend
fa'ahāhā	intended
mā'ea'ea	intense
ōhira'a	intention
fa'atere	interact
Tupuna	interact
Hoa	interaction
Hauʻuru	interest
tauturu	interested
fa'ahiahia	interesting
Tā'apapa	interfere
ha'ari'i	intermediate
ōtia	internal
ōrā i te 'āruaroa	international
te ara	international
Tahi i te fa'a'ūra'a	internship
Taratara	interpret
Tuha'a'āra'a	interpret
ta'ito'o	interpreter
auvaha parau	interpreter
Tā'a'ite	interrupt
fa'atere	interview
Here	intimate
I roto	into
taea'e	introduce
fēti'i	introduce
vaitaea'e	introduce
fa‘ate‘araa	introduction
tūtara'a	introduction
tama	introvert
pēpe	introvert
Fānaura'a	intuition
rīhi	invalid
Tō'outāne māuruuru	invalid
Hakaohi	invent
invetorio	inventory
tāpa'ō	invest
Tū'ura'a	investigate
pō'ihipa	invitation
Pā'ātia	invitation
tāpō'i	invite
Tā'ā	invite
aito'a	invoice
fa'a'ōhia	involve
āmui	involved
hōtaratara	iron
fa'ahiahia	iron
vai	is
Motu	island
tāpati	isolated
fa'aāteahia	isolated
mana'o	issue
uira'a	issue
nōnō	issues
oia	it
teie	it is
tenā	it is
terā	it is
Ia oe	it was
E 'ia	it's
maita'i	it's ok
e maita'i	it's ok
E mā'ohi	It's okay
ōniuni	item
mea	items
Nā'au	items
Tōna	its
ona	its
O'u	I’m
Ti'a	jacket
Pahū	jail
Ēnāra	January
Mō	jar
uaua	jaw
hū'uti	jaw
māmāhoihoi	jealous
Haʻarii	jealous
arō'ā'ina	jerk
Heiā	jewelry
ōhipa	job
oma'oma'o	jogging
tā'irea	join
fa'atere	joint
Tau'a	joint
pehea	joke
Ōte'a	joke
ta'ata pāpa'i ve'a	journalist
tohitika	journalist
Hōʻere	journey
mā'ea'ea	joy
'Amaru	joy
Tumu'uru	judge
Ta‘ato‘era‘a	judge
Moa	juice
tiurai	july
A'atoa	jump
Pi'i	jump
hopu	jump
Iune	june
tiunu	june
Ārahi	june
puta'a	junk
piti	just
a rave noa	just do it
Fā'aora	justice
fa‘aite	justify
ha'apāpū	justify
Kalaallisut	Kalaallisut
manahau	keen
tāmau	keep
tāpe'a	keep
Tauturu i te faahou	keep it up
tāmau	kept
Noho	kept
tāpe'a	kept
kētara	kettle
avaimoana	key
Kiki	kick
Tamaiti	kid
Ēre'ere	kidding
Teie nei te pehe i roto i teie	kidding
poipoi	kidding
Titi	kidney
tama	kids
tamari'i	kids
ta'e	kill
tāviri	kill
ētene	kind
Tārima'a	kinda
Faaitoito	kindly
māuruuru	kindness
Riri'i	kindness
Aroha	kindness
Ari'i	king
Pōvai	kiss
aroha	kiss
Iri	kiss
tua	kitchen
Manu te'ara	kite
tā'iri	kite
Tō'eto'e	kite
fanau'a mīmī	kitten
Tauturu	knee
pūhono	knee
I te 'īa	knew
mata	knife
Kaiti'i	knight
ite	know
āmui'a	knowledge
Maʻataʻi	knowledge
ite	known
Konkani	Konkani
Krio	Krio
ā'ā'ati	label
Fana'au	labor
Ohipa	labour
hā'api'i	labour
ʻAita	lack
hāni	ladder
vahine	lady
Ā'ati'a	laid
roto pape	lake
Vai	lake
ti'aporo	lamb
Aho'o	lamb
lame	lame
Tāvini	lamp
Fenua	land
oneone	landscape
Reo	language
Ūpa'upa'	lap
Nui	large
Roa	last
na roa	last
ei parau hope'a	last but not least
i'a hō'ē	last name
Nohinohi	late
I hō'ai	lately
Mahana 'ē	later
I muri	later
Apī	latest
I muri	latter
Hīmene	laugh
Haehae	laugh
Iriti	laughing
ata	laughter
Taʻutaʻu	launch
ha'amate	laundry
raro	law
fare'ara	lawn
Fenua pape	lawn
āre'a	lawyer
ohipa	lay
hi'ora'a	lay
Rima'ā	layer
pa'epae	layer
fa'aharaha'a	layout
Haʻurumaʻi	lazy
mōhio	lazy
arata'i	lead
avei'a	lead
Ūpūri'i	leader
ra'u	leaf
Pape	leak
taautira	leak
tano	lean
ti'a	lean
Hopohopo	leap
Aʻo	learn
ako	learn
Aha'o	learning
A'o	learning
Āi'a	learning
ha'amana	lease
tā'uru'uru	lease
Iti noa	least
Iti iti	least
ō'ā	leather
Vai mā'a	leather
rao'ere	leave
rau'ere	leave
rau	leave
rau	leaves
ohipa	led
aui	left
Vaevae	leg
māra'a	legacy
Ture	legal
ta'ata tipuna	legend
tāpae	legit
Tika	legit
Faʻamoemoe	leisure
Tauturu	lend
hō'ai	lend
Raʻa	length
Roroa	less
ʻĀite roa	less
Āi'a	lesson
tapū	let
Faʻahoro	let
reta	letter
Tuhuka	letter
Pape	letter
Raurau	lettuce
rau parau	lettuce
Ta'ato'era'a	level
Tāuru	level
Ha'avare	level
Tūtaki	leverage
fa'ato'a'ite'ite	leverage
mana'o	liability
pā'ōfa'i	library
Moo	lick
Uʻi	lie
pātini	lie
Tuatua ha'afa'ari	lies
ora	life
fa'atau	lift
mōrī	light
rama	light
Marama	lightning
au	like
here	like
tē atā	likely
fa'atere'ere	likewise
rā'ā	line
Lingala	Lingala
Pae'ōmama'o	link
Nīonīo	lion
ra'iā	lion
vai	liquid
Varu	liquid
pape	liquid
Rārā	list
Tātou	listen
Tūtū	listen
tauturu	listening
Ha'amaitai	listening
Ta'atira	literally
I te tino	literally
Oe hau	literature
matahiti	literature
Tōtara	litter
piti'i	little
Iti	little
noho	live
fa'aea	live
māra'a	liver
Ati	liver
tā'u	lives
mātāmu'a	living
piha fa'afa'aeara'a	living room
moko	lizard
mo'o	lizard
Poro	load
pua'ama	loaf
pōtia	loaf
moni ha'ere	loan
Fa'amu	loan
fenua	local
tā'ata'amu	location
Pūhā	lock
fa'aata'ita'i	lockdown
mā'a'a	log
Firiʻura	lol
Amaru'i o te hāhā	lol
ātea	lonely
Roa	long
e mea maoro tā tāua i 'ore e fārerei	long time no see
afsdf	look
Tahiti'	loop
tahataha	loose
‘ariki	lord
Maumau	lose
A'au	loss
matara'a	loss
Hōʻitiʻiti	lost
rari	lost
nōna	lot
riri	loud
Fare noanoa	lounge
hani	love
hina'aro	love
here	love
ua here vau ia 'oe	love you
Mārō'a	lovely
Maʻa	lovely
Iho	low
Hō'ai	low
amu	lower
tō'ona	loyal
Tauturu'	loyalty
ta'atāne	luck
ma'ohi'ohi	lucky
Luganda	Luganda
Ti'ati'a	luggage
pae'amu	luggage
Tūpū	lump
ate‘a mahana	lunch
ʻAita	lunch
puare	lungs
māraa	lungs
matini	luxury
tia	lying
Tu'ava'ava	lying
Ma'ani	machine
Papā'ō	mad
Eta	mad
tamā'ita'i	madam
Tane	madam
Ho'i	made
Purepure	magazine
parau ve'a	magazine
Manahune'	magnificent
Vahine toa	maid
vahine hō'ē'ē	maid
Pūaiarii	main
matā‘itu‘u	main
tiaki	maintain
Tapuʻi	maintain
Tauturu	maintenance
Tāuru	maintenance
Maithili	Maithili
Nui	major
matamua	major
Tā'ō'ōra'a	majority
Tumu ‘ore	majority
poiete	make
hāmani	make
rahu	make
Fa'atutu	make up
tāne	male
ōtāne	male
pae'oro	mall
tāne	man
e aha tenā	manage
e aha teie	manage
e aha terā	manage
fa'ahouio	management
piaho'i	manager
māngara	manager
Tuʻaroʻa	mandatory
Aita e ārahitia	mandatory
pārahi	manifest
hohoa	manipulate
Tu'ātau	manner
fa'ahou	manner
Tiaturi	manual
Roa	many
Faʻatupu	many
Fa'ati'a maha roa roa i teie mahana	many many happy returns of the day
Roa roa te fa'ati'a i teie mahana	many many happy returns of the day
Ti‘a‘i	march
Māti	march
tupuhi	margin
Vāvā	market
Mahana	market
Pū'a'ero'ero	marriage
ha'api'ira'a	married
hōto	mask
Māihi	mask
ma'ū	mass
Pātata'i	massive
fa'aro'o	master
Tāvana	master
mitihio	match
Mātāmua	match
taote	mate
i hea 'oe	material
Matematika	math
mātemātita	math
tai'o nūmera	math
ōhipa	matter
pa'ari	maturity
oraora	maturity
ha'amaitaioi	may
penei a'e	maybe
a'u	me
u	me
vau	me
o vau ato'a	me too
nō'u ato'a	me too
nā'u ato'a	me too
Kāi kai	meal
Tarai'ono	meal
fa'a'ite	mean
Tau	meaning
ōhipa	meaning
i ni'a	means
fa'aitoito	meant
I te mea fa'ahou	meanwhile
i te mea 'e	meanwhile
Tuʻaroʻa	measure
Tu'aro'a	measure
Pōroa	measures
Kīnā	meat
fa'ahoro	medical
maori	medicine
aua'a	medicine
maoti	medicine
fa'aa'a iā 'oe iho	meditation
Tahitoa	medium
fārerei	meet
tahi	meeting
hui	meeting
Meiteilon	Meiteilon
puhi	melt
Rauti	melt
fare'ara'a	memories
Oro'a	memories
ha'amana'o	memory
mēharo	memory
māhara	memory
Ite'ite	mental
hinapōro'a	mental
āmaramarama	mention
Tā'ito	mentioned
Fāhani	mentioned
Tuhia	mentioned
Ōma'i	mentor
tūtā	merchant
Atira'a	mercy
parau noa	merely
ia 'oa'oa i te noera	merry christmas
Haʻapaʻapa	mess
tā'uru	message
Nīnau	message
fa'aea	messy
Metara	metal
āna'ana	method
Fa'ahou	method
me'e	mice
mua	middle
tu'ira'a pō	midnight
ha'amaitai	might
Farahei	mild
pouaraa	milestone
fa'ehau	military
mā	milk
iu	million
mirioni	million
feruri	mind
ōpape	mind
mana'o	mind
mana'o	mindset
tō'u	mine
nā'u	mine
tā'u	mine
Tāneva'eva'e	mingle
Ē'a	mingle
Tō'eto'e	mingle
ha'atai	minor
Tio	minor
minuti	minute
miniti	minute
meneti	minutes
miniti	minutes
Mana	miracle
Moeava	miracle
Ra'ara'a	miracle
Aito	mirror
toto'a	mirror
faa'ōrotu	miscellaneous
Tātari	miscellaneous
ato‘ato‘a	mischievous
i	miserable
paraore	miserable
ōvere	misery
auahi	misery
ōere	misery
vahine	miss
tapeiru	miss
māuruuru vau	miss you
i hō'ē	missing
hauono, tūtū	mission
Aute'a	mist
pa'ā'au'au	mistake
Īmene	mistake
Mizo	Mizo
Firi	mobile
haapopohu	mock
Ti'ahohoa	mock
mā'ohii	model
fa'ata'ere	moderate
tahito	modern
Pō'iri	modest
Ma'ohi	modest
parau parau	modest
haumi	moist
rimu	moisture
haumi	moisture
Ō'ore	mold
Fafie	mole
Mo'o	mole
Mo'era'a	mole
mā'mā	mom
tohora	moment
Mane	monday
moni	money
Paeahi	monitor
ūrīta'ata	monkey
Manuhi'i	monkey
itirahi	month
nūnui	month
ra'ituāta'a	month
mana'o	mood
Roroa	moody
Avae	moon
ta'ato'era'a	moral
nui	more
rahi	more
tamāhine	moreover
Poipoi	morning
moni 'āvai	mortgage
I roto	most
I roto i te	mostly
Rā'au 'Ōrā	mostly
Nui atu i te	mostly
Matuahine	mother
here	motion
ta'atira	motivation
Aha'otepo	motivation
Tō'eto'e	motivation
ma'ōhi	mountain
Rūhi	mouse
pea	mouth
hina'aro	move
hia'ai	move
Tere'a	movement
hōho'a tāviri	movie
Puha'ihia	mrs
roa	much
Apo'	mud
Mōkai	mug
Mata'a niuniu	mug
Tīni	mug
uaua	muscle
fare pīpī	museum
Fare parau	museum
pōpōehu	mushroom
pua	mushroom
merehune	mushroom
Hīmene	music
E haʻamanaʻo	must
Ū	mute
Tā'ō'a'ō	mutual
tū'era'a	mutual
tō'u	my
tā'u	my
tō'u ha'api'i	My dear
taku hoa	my friend
tō'u hoa	my friend
e mea rahi te puhi i roto i tā'u manureva fa'ahe'e	My hovercraft is full of eels
tō'u here iti ē	my love
tā'u ta'ata	my love
O taku i'o te	my name is
O te to'ina'a o'u	my name is
ā'ere iau	my pleasure
O vau	myself
Oia iā'u	myself
Pahono	mysterious
Fa'a'iri	mystery
ā'ai tumu	myth
parau vāna'a	myth
Tō'ere	nail
a'ano	naive
maita'i a'e	name
rārā	narrative
Poto	narrow
Manava	narrow
Puhi	nasty
Hōʻaʻano	nasty
va'a'āi'a	national
Mana'o tupuna	nationality
ia 'oa'oa i tō 'oe mahana fānaura'a 'āpī	native
mā'ea'ea	natural
Fa'ahou	natural
āro'a	nature
ho'eha	nausea
Tāpa'ō	near
Tāpapa	near
aito	nearby
A roto o	nearby
Piti'a	nearly
Ma'ohi	neat
Maʻa	neat
Mea hoʻohana	necessary
pārahi	neck
fifi 'arapo'a	necklace
tāpe'a 'arapo'a	necklace
hei	necklace
E hiahia	need
ua 'ite au	negative
Tauturu'ia	neglect
raru	neglect
Fa'ate'a	neglect
Fa'a'ohipa	negotiate
hoa 'āmui	neighbor
mahana fare	neighborhood
E hōʻino	neither
‘ē‘e atu	neither
Tama taua	nephew
tamahine tamā'ohu	nephew
Tā'ohi	nerd
Vehinehine	nervous
Matahiti	nervous
ōfa'ara'a	nest
Ōni'a	net
Tuna	net
mā'ea	net
Rino	network
Amau	neutral
fa'a'ite'ite	neutral
aore roa atu	never
aita roa atu	never
Āita e 'ahuruhuru	never give up
Āita e tāpepe	never give up
aita e ha'api'i i muri	never give up
feruri	never mind
ōpape	never mind
mana'o	never mind
e hō'ē atu	nevermind
Aita e fa'atia iho	nevermind
Ia faatōfā	nevertheless
Hou	new
hōu	new
Ari'i	news
hepohepo	next
tūtāperepere	next
tapitapi	next
Pūai	next to
arava	nice
nehenehe	nice
māuruuru nō te fārereira'a	nice to meet you
pārahi	nice to meet you
Tamahine tāne	niece
pō	night
Moeava	nightmare
Riri'i	nightmare
Ino'ino	nightmare
Ivahere	nine
ahuru ma iva	nineteen
iva 'ahuru	ninety
aita	No
ʻĀita pehea	no problem
Aita pe'a	no problem
a'au 'aere	no way
Āita	no way
'Āita	no way
Ei'a	nobody
aita e ia	nobody
pa'ū'ū	noise
Riri	noise
puohuohu	noisy
Riri	noisy
aito	none
‘Ētahi ‘ā	none
Fa'ata'āviri	noon
ao mā'ohi	noon
ita	nope
aito	nor
Aita	nor
Purata	normal
matu'a	north
Imu	nose
ūru	nose
mihi	nostalgic
aita	not
Aita i te mea	not at all
tano	not bad
maita'i	not bad
e'ere i te mea 'ino	not bad
e'ere i teie nei	Not now
'aita	not yet
Ē	not yet
parau	note
Tā'ito	note
Ētahi	note
Ē'a'ore	noted
aore	nothing
Mōʻina	notice
tirotiro	notice
mātau	noticed
a'ara	noticed
tā'i'ōfa'i	noun
i'oa noa	nouns
Pēraehia'	novel
novema	november
i teie mahana	now
i teie nei	now
i teie nei mahana	nowadays
māniania	nuisance
rāhui	null
pahī	numb
nōera'a	number
Nūmēro	number
Nūra'iti	nurse
taote	nurse
Nū	nut
matiti	nutmeg
Aito'a	nutrition
here	nutrition
Ture	oath
Tate'a nui	obesity
Tauturu	obey
ta'ati'a	obey
Tūturu	object
ōna'ō	object
āfa'i'ite	objective
Tau	objective
Aita e ārahitia	obligation
ha'afaufa'a	obligation
uriuri	obscure
pōiri	obscure
ta'ota'o	obscure
āfareira'a	observation
Ta'iraa'i	observation
Tuha'a	observe
tūtara'a	observe
‘Apa‘i	obsessed
Ino'ino	obsessed
Hīmene'i	obsession
mataara'a	obsession
Fa'atupu'ura	obsolete
'urupā	obsolete
auhune	obstacle
tae	obtain
Tahiti	obtained
fa'anui	obvious
īa tu'a'ā	obviously
faufa'a	occasionally
tōro'a	occupation
ohipa	occupation
Tano‘i	occupied
Ta'ape	occupied
Haere	occur
Hāmene	occur
Hō'āte'a	occurred
fa'a'ite mai	occurs
rave	occurs
Moana	ocean
ātopa	october
Hōtia	odd
hō'ē'ē	odd
taimea	odds
Ture'a	odds
i	of
oia mau	of course
oia nei	of course
Tāʻitaʻi	off
inaha'a	offensive
Faʻahou	offer
Ta'uru	offer
ōfisa	office
tamā'ā	official
pinepine	often
ō	Oh
Eaha tō haere mai nei	oh really
eaha noa	oh really
Miti	oil
Ōi	oil
Mōno'i	oil
e	ok
Maitai roa, e te tamā'ohie	ok dear
Maitai roa, e te tamā'iti	ok dear
Maeva māuruuru	ok honey
Maitai roa, e toku here	ok my love
Maita'i e te aroha	ok my love
e	okay
Maita'i 'oe tama	okay baby
māuruuru aroha	okay dear
Ua roa	okay honey
Ua roa te mau mea	okay my love
‘Okē mama‘u au	okay my love
ōrero	old
Vahi tōmua	old
i	on
i ni'a	on
I te hoʻeʻāmui	once
Tētahi mahana	once
hō'ē	one
tahi	one
Te reo 'ētahi 'ē 'āmui mai teie i roto i teianei.	one language is never enough
Huero'	onion
Ā'au rahi	online
ʻĀita	only
Ananahi	only
e'ere	open
tāpa'ōfa'i	operation
Tātāro'a	opinion
fa'aharara'a	opportunities
Fatu'āina	opportunities
tano	opportunity
ti'a	opportunity
ōhipa	opposite
I te tua	opposite
ma'ohi'ohi	optimistic
Oro‘ā	option
Ture	option
Hōma'iti	optional
mā'iti	optional
Tōmātai	optional
aore rā	or
kāpā	orange
Tu'ura'a	order
te peretiteni	order
mā'ohiu	ordinary
ōhipa	organization
Arohānui	orientation
tā'ere	origin
tā'ātira'a	original
Oromo	Oromo
tama 'ōtare	orphan
ʻētahi atu	other
Ma te tahi	otherwise
‘ē‘e atu	otherwise
e hō'ē	ought
tā mātou	our
tō mātou	our
O tatou ha'api'i: te fa'ahia'a i te ho'ē'o'e'i i te hoe to'a nei i te ho'ē'o'e'i i te fenua e tae atu i te ho'ē'o'e'i i te mau mau o te reira i te reira atu i roto i te mau reo.	Our mission: to enable everyone, everywhere to understand the world and express themselves across languages.
O tatou ha'api'i: te fa'aitoito o te mau mau o te fenua i roto i te ho'ē'o'e'i i te mau mau i te mea fa'ahitia i te reira i te reira atu.	Our mission: to organize the world's information and make it universally accessible and useful.
Tahoʻe	out
Taho'i	out
Fā'ahorara'a	outcome
parau	outfit
Rima	outfit
tatau	outgoing
parau	outlet
Pae'āpae	outlet
Pārau	outline
Tā'ā pārau	outline
Āhua	outline
rā'i	outside
ta'ito'a	outstanding
Umuahi	oven
i roto	over
i reira	over there
pū'i'ōfa'i	overall
tia'iro'i	overcome
mana'ohia	overthinking
Tāne'āi'a	overwhelmed
‘Ōfa‘i	overwhelmed
ma'ohi'ohi	overwhelming
rātou	owe
rāua	owe
mahiri'i	owl
iho	own
fa'ahouhia	owner
Tāvana	owner
pua'atoro	ox
pā'otea	pace
Hē	pace
Ō'ū	pack
Pū'i	package
tāpa'ōfa'i	paid
Auahi	pain
Tātou	paint
tā'era'a	paint
Rangi	painting
pā'ari	pair
ma'ū'ū	pale
Fāna'o	pale
Pūtītī	palm
Aute	palm
Ra'au niu	palm
tāpa'ōfa'i	pan
Huru	pan
taua herehere	pandemic
Mata'iti'i	panic
Rahi	panic
Fa'ahuruhuru	panic
putaeraa	pants
pēpa	paper
parataito	paradise
rōhotu no'ano'a	paradise
paralela	parallel
parau	parcel
Pepa	parcel
māuruuru	pardon
tohora	pardon
mātua	parents
fare pāruru	park
manu paraparau	parrot
Marō	parsley
fare	part
tūtaki	participate
Pā'ārarua	participate
Faufaʻa	particular
tā'ito'o	particular
fa'ata'amu	particularly
Fa'ahou	particularly
Hoa	partner
āmui	party
Aito i te tau'ā'ā	party
Haere	pass
Pāpū	pass
Apae	passage
ua parau	passed
pae	passed
Faufaʻa	passion
rū‘au‘au	passion
fia pūai	passionate
'Ōfa'ina	passionate
Riri'i	passionate
Fa'aoti	passive
Hō'ē parau	password
mua	past
Fatu	patch
ara	path
ha'apeapea	pathetic
Amari'i	pathetic
Manava	patience
Aroha	patience
mū'ōfa'i	patient
tīa'i	patient
fa'a'oroma'i	patient
Tau	pattern
taure'a	pause
Tāne'i	pause
Tāmati	pavement
paraha'a	pavement
tai'āmuri	pavement
tāmau	pay
tāpe'a	pay
mau	pay
aufau	payment
Faitoʻo	peace
rā‘au	peace
Mā'iti'i'	peaceful
pi'i	peach
ōrometua	peak
pia	pear
mīhini	peas
pe'a	peas
fana	peculiar
Fa'a'ire'ire	peculiar
mimi	pee
ōmaha	pee
ha'ama'u	peel
Hoa	peer
tō'era'a	peers
pepa	pen
Pāpī'	pencil
Tāʻei	pending
Tagata	people
Pēpē	pepper
Maramarama	perceive
faa'oreore	perception
erado'ae	perfect
mū	perform
Hōʻailona	performance
aparima	performance
paha	perhaps
penei a'e	perhaps
Tā'ure'a	period
Taime	period
fa'ahe'eitiiti	permanent
noa atu	permission
Tāpa'a	permit
Fa'atete'ira'a	perseverance
marama	persistent
tamā'ī	person
ta'ato'a	personal
ta'ata tipaerari'i	personality
ī	perspective
mau	perspective
faufa'a	perspective
Faʻateuina	persuade
Tā'ape	pervert
rima'ere	pet
Tō'eto'e	phase
Tu'atu'a	phase
Faasea	phase
Fa'ahī	phenomenon
Ōte'a	philosophy
firotofo	philosophy
pae	phone
hōho'a pata	photo
Ape	phrase
parau tāpa'u	phrase
hina'aro	physical
hia'ai	physical
tā'uru	pick
'Oro	pick
tāne'i	pick up
teina	picture
tū'ane	picture
tua'ana	picture
parau	piece
tuha'a	pieces
mau tā'ito'a	pieces
Pua'a	pig
Pua‘a	pig
ū'ū'aira'o	pigeon
Tu'uru	pile
Pūrere	pile
pu'ara	pillow
tāva'ine	pilot
Pūrere	pilot
Kafe	pin
anana	pineapple
Ōpūmeha'a	pineapple
Tauturu'	pink
Puhi	pit
Ōpū	pit
Fatu	pit
Noho	pitch
i muri iho	pity
i muri mai	pity
nohora'a	place
vāhi	place
fare	places
rā'a	places
Pepa	plague
rauo	plain
ha'amaita'i	plan
fa'ahōhonu	plan
fa'ati'a	plan
pahi	plane
Tu'a'iti	plane
tā rātou	plant
tō rātou	plant
mōtini	plants
rā'au	plants
Tiatia	plate
pā'ara'a	plate
Fare 'ōfa'i	platform
ha'uti	play
ta'ora'ora	playing
hopehia	pleasant
ravehia	pleasant
otihia	pleasant
na	please
farerei'i	pleased
Amaru	pleasure
Maʻohi	pleasure
rahitahi	pledge
ha'apa'o	plenty
rave	plenty
piti	plot
rua	plot
tu'ura'a paura'a	plug
Rautini	plum
Ti'aturu	plumber
Fatu	plural
purao pā'oro	podcast
pere'au	podcast
pehepehe	poem
pehepehe	poetry
to'etū	point
pōito	poison
Ara'a	poison
mūto'i	police
tīa'i	police
Ture	policy
Māuruuru	polite
mārō'iro'i	polite
Tōfā'i	pollution
pūrua'ite	pollution
Taioro	pond
pū'ātea	pool
Fa'ahere	pool
fa'apupū	poop
Riri	poor
Maita'i	poor
pop	pop
Pōpō	pop
tano	popular
maita'i	popular
ia	popular
tā'ata'amu	population
Pua'a	pork
tunu taro	porridge
āmotu	port
To'atāne	port
Pōtitia	position
māru'uru'u	positive
Fa'afa'ahou	possess
hoa	possession
Tōna mea	possessive
fenua	possessive
fa'apea	possible
pōto	post
tā'ore'a	postpone
Ua here mai au	potato
ūmara pūtete	potato
Tōtika	potential
Pāruru	potential
pauna	pound
paua	pound
ha'api'iea	poverty
mana	power
Ma'ohi	powerful
Tō'era'a	practical
ta'iri	practical
Hāmene	practice
Tāmā'ara'a	practice
peu	praise
ha'apeu	praise
hehu	prank
ha'api'i	pray
mana'ona'o	precious
Maʻohi	precious
fa'aho'iho'i	precise
pāpū	precisely
tiaturi	predict
pīra'āmu	prefer
tē atā	preference
tinito	pregnant
mō'ere	prejudice
Tā'ō'a'ō	prejudice
Fare	premises
Prīmeha	premium
To'etū'ira'a	preparation
Tuhaʻa	prepare
ta’ata’a	prepared
aparātō	preposition
ānape'ape'a	presence
nei	present
taunei	present
fa'atūturu	presentation
Fa'ahouhia	preserve
tia'iro'i	preserve
peretiteni	president
ari'i	president
taerere	press
Pouhōʻā	pressure
Fa'atere	pretend
fa'amu	pretend
Tū'ātea	pretend
nihinihi	pretty
nehenehe	pretty
purotu a'ia'i	pretty
Fafaga	prevent
fa'atoro	prevent
Mua	previous
Paripari	prey
utu	price
Moni	price
Haʻamāuru	pride
Tahito'o	priest
perepitero	priest
tahu'a	priest
mātāmua	primary
Tumu	primary
Tu'ura	prime
Tā'ahine	princess
pū'āro'a	principal
pahono	prior
māra'a ta'ito'a	priority
Fare here	prison
fa'ata'ata'a	privacy
mai	private
nō	private
tā'ore'a	privilege
parau	prize
parau tā'ito	prize
paha	probably
penei	probably
ōhira'a	problem
Fatigā	problem
fa'ahouhia	procedure
fa'ata'ita'i	proceed
Haʻamataʻu	process
Tumu	produce
hāmara'a	produce
hoa	product
Mea	product
Farereira'a	production
Mahi	profession
fa'ato'a'ite'ite	professional
ōhi	profile
ma'ohi	profit
Tōtika	profound
Fa'ahou	progress
hō'ē'ē	progress
prohe	project
mātāmua	prominent
iho	promise
fa'ahouhia	promote
Fa'ahau	promote
tahua	promotion
Ha'amaramarama	prompt
ma'iti	prompt
āmuiou	prone
mono i'oa	pronouns
Re'o	pronunciation
Tūtaki	proof
pā'itau	proof
tika	proper
ti'aturihia	properly
Fa'ahotiraa	properties
Atiʻi	property
Āina	property
to‘o‘o	proposal
ta'atoha	proposal
Tahuaroa	prospect
ha'apopoi	prosperity
mārō'iro'i	prosperous
Nūna'a	prosperous
Tiaki	protect
ho'ē'ē	protect
mārohirohi	proud
Metua	proud
ha'atu'a	prove
fa'anava'i	provide
fa'arava'i	provide
Tēta'i	provided
poropiti	province
purōvīno	provision
tama	puberty
taure'are'a	puberty
ōpū ha'api'ira'a	public
tāne	pull
ōtāne	pull
mā'oa	pumpkin
mātiti	punctual
Hōpūtu	punctual
Ti'a'āra'a	pupil
Hana i te hō'ai	purchase
Ōfa'i	pure
ma'ōhi	pure
āre'a	purple
parau	purpose
mana'o	purpose
pāmama	purse
Pōniu	purse
tāhara'a	pursue
Hīmene	pursuit
fa'atahitihiti	push
tu'u	put
papai	qualification
mati'āra'a	quality
hō'ē	quantity
tahi	quantity
āfare puhihau	quarantine
Tā'atā'ina	quarrel
ta'ata'a	quarter
Keu	Quechua
vahine mā'ohi	queen
Ari'i wahine	queen
Tau'ā'ā	queer
Ē'a'ē	query
pā'aito	question
Papaʻatari	queue
mātou	quick
Tōmū	quickly
mā'ohi	quickly
mū	quiet
pūrau	quilt
Māhia	quit
Tāpaʻo	quit
pāpū	quite
mau	quite
pehea'ore'a	quiz
pepa pāruru	quiz
Tohi	quotation
pepa	quote
Tārara'a	quotes
Tarape	rabbit
ōtū	race
tūtū	rage
Hō'ere'ere	rage
ua	rain
taurea	raise
Tuʻe	raise
tei	raised
horo	ran
ohie'ohie	random
Tūturu	range
Roa	range
Tere	rapid
Pātata'i	rapid
vitiviti	rapidly
oi'oi	rapidly
vave	rapidly
Manava	rare
Anuanua	rare
ōfa'ifa'i	rarely
Aho'o	rash
Patu	rat
'Ōra'a	rate
ʻUtu	rate
maori	rather
aua'a	rather
maoti	rather
Ho'ē'ē	ratio
nui no te ara	ratio
Rāhī	rational
ōpu'upu'u	raw
fa'aro'o	re
Tae atu	reach
tae	reached
Oro'a	reaction
tai'o	read
ha'amata	reading
pūai	ready
i reira	real
i'ō	real
ōhotu	reality
fa'a'ōfa'i	realize
tōtika	realized
mau	realized
mau	really
ā	really
Tūtū	rear
tū'aura'a	rear
Atea	reason
Tau	reason
mā'ana	reasonable
Tā'ō'ōra'a	recall
Pārau	receipt
Taki	receive
Tae	receive
tūtū	received
Ua taki	received
fa'anatura	recent
Fa'ata'ita'i	recent
I roto i te matahiti	recently
Tā'ē'ē	reception
to'ona'i	recipe
Tauturuahi	recipe
ti'a'āpa	reckless
'Amari'i	reckless
farearii	recognition
Faʻahiti	recognize
i muri	recommend
fa'atumu	recommended
tohari'i	recommended
pā'itohu	record
tā‘atira	record
Haere tōmuri	recover
Fa'ato'era'a	recovery
ahiao	rectangle
oehā	rectangle
Ura	red
tāpe'a	redeem
Tetia'orera'a	redemption
Tumau	reduce
maitai	reduce
Fa'a'ohi'ohi	redundant
Ta'atira	refer
tūtara'a	refer
Tuʻaroʻa	reference
Tuhinga	reference
Tō'u'ā	reflect
tauhere	reflection
mā'ene'ene	reflection
roru	refrain
Pahi mā	refrigerator
Ha'apapa	refund
ho'ē'ē moni	refund
ta'ī	refuse
Tā'a'ī	refused
tūtaki	regard
ha‘amana‘a	regard
i roto i te	regarding
aui	regardless
ha'amana	regards
āfareira'a	region
rēhiti	register
arofa	regret
aroha	regret
mihi	regret
fa'ahouios	regular
Ia toru nei	regularly
fa'a'ōhara	reject
fa'atauhia	relate
ohipa rahi	related
vata 'ore	related
Haapii	relationship
īno'i	relative
Tu'aro	relative
Oe'ore	relatives
fa'ahouria	relax
mahuti	release
ti'amā	release
matara	release
Fātea	released
tapaohia	released
Faʻatau	relevant
ti'aturihia	reliable
i teie mahana	relief
i teie nei	relief
Fafano'i	relieve
‘Āfa‘iho‘iho	relieved
Fa'ateho	relieved
orometua	religion
fa'aro'o	religious
mā'ohi	religious
pūrara	reluctant
parare	reluctant
mani'i	reluctant
tūtaki	rely
Tauturu	rely
Noʻo	remain
pū	remain
faaora	remaining
aitoto	remarkable
Fa'a'ite	remedy
fa'ato'ito'i	remedy
Haʻamanaʻo	remember
Tā'āmui	remember
ha'amata	remind
faatereraa	reminder
tēra'a	remote
āfa'i	remove
tari	remove
tia	render
ha'ari'ari	rent
Uira'a	rent
tūtaki	repair
Tauturu	repair
ta'ata'a	repeat
hō'ē'ē	replace
vāhi	reply
Rōpū	report
Tūturu	represent
tūtara'a	represent
mana'o'iti'iti	reputation
Ta'ere fa'a'amu	reputation
niau	request
Tiriti	request
teitei	require
‘ākono	required
Pōʻia	required
tāmā'ini'ini	rescue
Āta ti'aturi	research
Rima‘ira‘a	research
fa'aitera'a	resemble
ohipa	resemble
parau tītorotorora'a	resentment
Fa'aro'o	reservation
ōtea	reservation
fare tauhiti	reserve
Opu'umi	resident
ta'uahi	resident
tē'iti'iti	resign
Fa'ahou	resign
tō'tō	resilience
Ma'ohi	resilient
pa'aro	resist
Vaiuru	resistance
pahono'ōfa'i	resolution
Fa'aitoito	resolve
fa'aho'oipo'i	resolve
hō'ē'ē	resort
Pae ta'ata'a	resort
ra'ārā	resources
mana'ona'o	respect
Mahalo	respect
fa'aitoito	respond
Tāura'a	response
pū'āro'a	responsibility
Tā'ō'a'o	responsibility
Tūturu	responsible
te rima	rest
Fa'aora	rest
ua hau	rest in peace
huru o te reva	restaurant
fa'ahou	restore
Ho'ē'ē	restore
ta'ato'era'a	restrict
Fārito	restrict
hō'ē'ē	result
ārā'ara	results
hō'ē'ē	results
Tāʻiri hōʻē	resume
Vāvāta'a	retail
ōfa'i taure'a	retail
Tauturu	retain
tia'iro'i	retain
fa'aherehere	retention
hakaiki	retired
hāpū	retreat
Fa'aro'i	retrieve
ho'ohe	retrieve
haere mai	return
‘ōno‘ono	reveal
Tahua	reveal
Ta'iraa	revealed
farehoi	revenge
poiete	revenue
hāmani	revenue
rahu	revenue
Rari	reverse
fa'ahou	review
Aravihi	review
ho'ea i muri	revise
ha'api'ira'a	revision
tāhanahana	revision
Reva'atia	revolution
Ho'ē'a	reward
fa'aea	reward
Rūtīmu	rhythm
nota fa'arōtahi	rhythm
nota tano	rhythm
ao'aotahi	rib
te hō'ē	rice
te tahi	rice
haere mai	rich
tapu'a	rid
Tiaki	ride
āti‘ati‘a	ride
nā roto	ridiculous
tano	right
ti'a	right
I teie nei	right now
Tā'ure'ure	rigid
heipuni	ring
arutaimāreva	ring
tātara'a	rinse
ohirohi	riot
Fa'apāpū	rip
Tu'ehau	rip
hi'ia	rip
ma'ohi	ripe
Parau	ripe
tū‘ē‘ē	rise
Tuʻu	rise
fa'ahou	risk
'Amaru	risk
Tauhiti	rival
āvana	river
Ava	river
Ara	road
ārua	road
Tarona	roast
Ōpū	robust
Ora	robust
Matahiti	robust
ōfa'i	rock
ōrometua	rod
tārava'a	role
Fa'a'ōrere	roll
Tūrua	roll
Kato	roll
pū'āfa'i	roof
Papa'ā'iti	roof
fare	room
ra'ā	root
tapuhi	rope
Aho	rope
tunupa'a	rotten
rauarii	rough
Fara	rough
Taurea	roughly
piti	round
haere	route
Mārō'ura'a	routine
Tā'ato'a	row
pureraa	row
ōmire	rub
e'e	rub
ōmira	rub
pere	rubber
Pōro	rubber
Tu'epu	rubbish
vaitata'a	rubbish
Parapara'a	rubbish
pa'ari	rude
e'ere i te mea 'ōhie	rude
tūpenu	rug
Tatau	rug
tō'iri'iri	ruin
Pāpū	ruin
ture	rule
Tata	ruler
Ture	rules
Haere	run
Tahiti	running
henua vānana	rural
ohie	rush
tōmara'a	sack
ra'a	sacred
mo'a	sacred
tapu	sacred
'Aita'itea	sacrifice
fa'a'ite'ite	sacrifice
Maʻa	safe
Ha'a māuruuru	safe
revara'a manureva pāruruhia	safe flight
Fārere'	safety
Ta'uru	sage
‘īmene‘ia	said
I tuʻu	said
Tara	sail
vela	sail
Hoe vai	sailing
a'ōrā'a	sailing
noa	sake
pū'e'ōfa'i	salary
ho'ēmi	sale
tāmono	salmon
parau	salt
E vāna'a i au	salt
hō'ē ā	same
Na teie nei	Same here
i teie nei	Same here
Ā'ite	sample
amu	sample
one	sand
Sanskrit	Sanskrit
peresitene	sarcastic
Hinavai	sassy
tū	sat
Ma'ehaa	satisfaction
pa'ari	satisfied
tahiraa	satisfy
nava'i	satisfying
rava'i	satisfying
oa'oa	satisfying
Farereira'a	Saturday
ʻĪmītīra	sausage
Maʻe	savage
fa'aho'o	save
Vāʻai	saw
Vā'ī	saw
‘īmene	say
ʻĀmui	say
ta'ata	scale
Tūpe'e	scam
ha'afaufa'a	scam
pupu	scar
Pauraa	scarce
taparahi	scared
Putū	scarf
pū'ohu	scary
Ririnui	scary
Fa'ahouhia	scattered
fa'atere	scene
ta'ata mā'ohi	scenery
Fa'aterehia	scenery
Putaina	scent
ruatau	schedule
tārena	schedule
farehau	school
ʻĀfaʻi	science
to'ere'iti'i	scientist
Tātou rima	scientist
aivāna'a	scientists
i'oa	scissors
pare	scold
māhorahora	scope
Noho	score
Papa rārā	scrap
tā'e'e	scratch
Ōpū	scream
ūī	scream
Fare'e'e	screen
Tapoa	screw
parepe	screw
parau	script
tāuru	script
ma'ariri	sea
anuanu	sea
to'eto'e	sea
pērau	seal
tūtaki	search
Pareu	search
Ōhipa	season
noho	seat
ha'iti	second
Ānara	second
upu mā'ohi	secret
tupu	section
Māuruuru'	secure
ha'amanuira'a	security
ite	see
ā'a 'oe	see you
Aita	see you later
A tō'ō	see you soon
ananahi tā tāua e fārerei ai	see you tomorrow
huero	seed
To'o	seed
Rauru	seed
Tāpiri	seek
fa'apeapea	seem
pāruru	seems
pārahu	seems
Vave	seen
ite	seen
Fa'aro'i	seen
Atahei	seize
Hehe	seizure
ōfa'ifa'i	seldom
Hō'ē'ā	select
Tō'na	self
ea maita'i	self healing
tino fa'anatu	selfish
tāpū	sell
Tuku	send
Tarai	send me your picture
ta'ato'era'a	senior
parau tutu'u	sense
hina'aro	sense
Tā'ati'a	sensible
fa'a'ahu	sensitive
ō'omo	sensitive
ōmono	sensitive
tātō	sent
īoa pa'ari	sentence
pereota	sentences
īrava	sentences
uri'uri	separate
Sepedi	Sepedi
tetepa	september
tāhū'īra'a	sequence
faahoro	series
Riri	serious
Manaʻonaʻo	serious
o'ote	seriously
Āfa'i	serve
tātira'a	serve
ha'api'iraa	service
Tuha'a tapura'a	session
Tauturu	set
hohoa	set
ta'uru	set up
faatere	setting
Fa'ahou	setting
tūtaki	settle
Tūtau	settle
Fitu	seven
ahuru ma hitu	seventeen
hitu 'ahuru	seventy
taata nui	several
Maʻata	several
tapu'ārahu	severe
au	sew
nira	sew
Sā	sh
Pae	shade
mata'iti'i	shade
Rahi	shadow
āto'a	shake
e tā	shall
Ānane	shallow
‘Āito	shallow
hau	shame
Hō'ē'a	shape
Haere	share
pārau	share
ta'a'ē	sharp
māere	sharp
oia	she
ōna	she
eia 'ōna	she has
e roa'a 'ō	she has
Oia	she is
ōna	she is
Tāvini	shed
hō'ē'ē	shed
pūpū'i'a	sheep
Papī	sheet
pape	sheet
pae	shelf
opu	shell
maita'i	shelter
fa'atauaroha	shelter
Āparū	shield
tohu	shift
Ho'ē'ē	shine
mā'ohi	shine
va'aae	ship
Tere	shipping
ahu	shirt
ha'ūra'a	shoes
Tātini	shoes
pehea	shoot
Ta'ata	shoot
a'au	shop
ho'oho'ora'a	shopping
Taha'iti	shore
Poto	short
Fa'a'ūra'a'ehu	shortage
tāpe'ape'a	shot
fa'ahou's	should
tūtaki	shoulder
Tūpāpā	shoulder
pī'i	shout
Tuʻaroʻa	show
parau	show
a fa'a'ite mai	show me
ava'e	shower
Tūtū	shower
Kō'umi	shrimp
Tiatura'	shrink
Fati	shut
ti'iti'i	shut up
Mataku	shy
tuāne'e	sibling
Tamāʻa	siblings
Taeao	siblings
ma'i	sick
tūtaki	side
Tu'aro	side
Ho'ohohi	sigh
tūtū	sight
Ōpu'u tere	sightseeing
Tuʻaroʻa	sign
parau ha'ati'ira'a	signature
matahioi	significant
Nui	significant
mū	silence
turituri 'ore	silence
Tauaiti	silent
Aho'i	silk
Hīmene	silly
Tupa'i	silly
Hau	silver
ōhipa	similar
Rā	simp
Rū	simp
fareata	simp
mārō'iro'i	simple
fa'atau i te tu'era'a	simultaneously
mai	since
nō	since
marari'a	sincere
ta'ata mārō	sincere
meitaki	sincerely
himene	sing
tārekareka	singer
Mānono	single
Pape	sink
Tama	Sir
Taina	sister
hoa tāne vahine	sister in law
fa'aturehia	sister in law
tūtaki	sit
Tū	sit
fare oire	site
Tā'ure'a	situation
Tuhaʻa	situation
Ono	six
ahuru ma ono	sixteen
ono-'aha-'uru	sixteen
ono-'ahuru	sixty
ono 'ahuru	sixty
Ātea	size
mā'ohie	skill
mārohirohi	skills
Ava	skills
vaevae	skin
mea'iti	skinny
ta'ati'ati	skip
Māoro	skip
pā'ū	skirt
Pareu	skirt
Rangi'	sky
Tātao	slave
tauhiti	slave
Tā'aro	slave
Moemoe	sleep
Moemoeā	sleep
moe	sleeping
ta'oto	sleeping
Pō'ue'ue	sleepy
moe	sleepy
tefare	sleeve
Patu	sleeve
ama'a	slice
Vahine huru	slice
api'ō	slide
ti'ai	slightly
marere	slim
Tārave	slip
Tūpāpaku	slope
haaparau	slot
tūtaki	slow
Tanoa	slow
marū	slowly
fa'a-'ō'ō	slowly
Mō	small
Iti	small
Ha'apa'apa'a	smart
Maʻa	smart
Hāhā	smell
pō'a	smell
Ni'a	smile
hōhia	smile
puhipuhi i te 'ava'ava	smoke
pīno'ino'i	smooth
Farereira'a	snack
puni'uru	snack
au 'apu	snail
namu	snake
Mo'o	snake
hamani	snap
hi'o	snow
paha ho'i	so
oia ho'i	so
Te āito	so cute
Pū'i'a	so far
pūai	so far
Tare	soak
Punu	soap
ite'a	sober
Tapati	soccer
fa'atō'ohia	social
ta'ata mau	society
fenua mau	society
Otā	socks
putu	socks
meraso'ede	soft
ahu ta'ata	software
Tūtūra'a	software
pōpō	soil
tūtaki	sold
Tā'amu	sold
taoti	sold out
Pouhono	soldier
mā'oie	sole
ti'a	solid
tauatini	solution
fa'ahouhia	solve
nui	some
rahi	some
Eiā	somebody
e 'ō'ura	somehow
i te faaopoopo	somehow
paha	someone
penei	someone
Tēʻāpū	something
tēta'i mea	something
Eaha	sometimes
ia taime	sometimes
Himene	song
nei	soon
oi'oi	soon
vave	soon
oa'oa	sophisticated
Sorani	Sorani
aita vau e 'ite	sore
e'ita vau e 'ite	sore
Roroa mōnō	sore throat
hāmani	sorrow
a tātarahapa mai	Sorry
ta'ata'amu	sort
tā'atira'a	sought
ʻAnuanua	soul
tāne vahine hoa	soulmate
Ānauhia	soulmate
parau	sound
Manava	sound
tihōpu	soup
Ama'ama	sour
Fānau	source
raro	south
pā'āto'a	space
pauroa	space
tā'āto'a	space
Tārā	spam
fa'ahouhia	spam
tere'āra'a	span
pāniora	Spanish
fa'anui	spare
parau	speak
māuruuru roa	special
rahi	species
Tōtika	specific
Ū'īra'a	spectacular
fa'atere	speech
Ū'umu	speechless
Ra'ā	speed
tere	speed
tā'ū'ū	spell
tu‘a‘ita‘i	spell
oti	spend
Faʻahou	spend
Ia tumu	spent
Moemoe	spicy
Ka'ape	spike
ōpūhau	spin
fāfā	spinach
pina	spinach
ōpu'upu'u	spirit
heke	spit
pe'e	spit
ta'a'ē	splendid
aravaitaio	splendid
fa'ahiahia	splendid
Raerae	split
Ti'a'ā	split
tā'iti'iti	spoil
Īmene	spoil
fa'a-'ura'ura	spoiled
Aita	spoiled
Fa'atūturu	spontaneous
umu	spoon
to'etū	spot
Vahine tāne	spouse
Tāne tāne	spouse
pūrara	spread
parare	spread
mani'i	spread
Tapitoru	spring
Paeʻāmui	square
Pīriri	squeeze
mau	squeeze
He'e	squid
pūpū'i'a	squirrel
Ura	squirrel
Sānito	st
tāpea	stab
Tāpiti	stab
Fāna'ito'ito	stable
noanoa	stable
Pūrere	stack
Tōtō	staff
taure'a	stage
A'ina	stage
Tu'ura	stain
etahi	stairs
tūti'a	stake
tia'i	stake
Tā'amu	stalk
Māne'a	stall
tāpe'a	stamp
Ti'atama	stamp
ha'amaita'i	stand
ata'ata	stand
oa'oa	stand
ha'api'ira'a	standard
Fatia	star
Tīmata	start
Tīmatatia	start
a'atoa	started
Tā'ō'a'ō	starving
pō'ia	starving
Vahi	starving
hete	state
huru	state
Tuʻaroʻa	statement
pā‘au‘au	statement
Marae	station
fareara'a	station
mōtete	statue
Ru'e	statue
Tātāra'a	status
Fāʻā	stay
noho	stay
Noa i te haere ‘āpōpō	stay safe
mārō'ura'ura	steady
Ameti	steak
ha'ape'e	steal
ma'ōri	steam
Ōtai	steel
Fāhōtea	steep
āpi'i	stem
tā'amu	step
Rāpā	stick
faahiti	stiff
Tā'ure'ure	stiff
noa	still
ta'ake	sting
Mafatu	stingy
tā'ave	stir
ōpere	stock
ōhopa	stock
eiāhia	stolen
Tāpū'ia	stolen
eiā	stolen
pu'epu'e	stomach
Ōpū	stone
Tu'urui	stood
tu'ura'i	stood
Apa'a	stool
Tāpaʻo	stop
Fa'anaho'	storage
ma'i	store
Putē'	storm
Īstory	story
Ahimaa	stove
ti'a	straight
noa	straightforward
mau	straightforward
tapū	strain
ti'amaramarama	strain
Haumaru	strange
Tāpaʻo	strange
Tūpakarua	stranger
Mahani	strategy
pue	straw
Āveri'era	strawberry
Māpu	streak
Fa'arere	streak
Tō'eto'e	streak
taioraa	stream
tātara	street
Mana	strength
Fenua	strength
a'o	stress
api'ō	stretch
faatino	strict
aniani	strike
ani	strike
tā'iti'iti	string
Fa'ahouhia	strip
āpiti	strip
ōfa'i	strive
pā'iro	stroke
Maʻa	strong
Matatā	strong
tupaia	struck
Fa'āre'are	struck
pārahurahu	structure
Haʻapu	struggle
ari'i	struggle
Ha'apape	struggling
Taua	stubborn
taerua	stubborn
Amuri	stuck
Tauira	student
tamaiti ha'api'i	student
Aʻo	study
Ha'ere i te tā'ura'a	study
ha'api'ire	studying
ha'a	stuff
mea	stuff
Māmānoa	stunning
pōkahu	stupid
ōropa'a	style
faaipoipoga	subject
Tāvana	subject
pūnohu	submission
Tuʻaroʻa	submit
tu‘u‘ira‘a	submit
ta'ata'a	substance
Mana	substitute
tūtara'a	subtle
Ī'ina	succeed
rū'au	success
parau	successful
mana'o	successful
ma te faʻa	such
Tā'ore'a	such as
Tāna ‘ore	such as
ote	suck
Ha’afe’e	suck
tere'o	sudden
Ti'aturi	sudden
I te pohe	suddenly
tu‘a‘ine‘ine	suddenly
riri	suffer
Taute	suffering
ōfa'ifa'i	sufficient
saka	sugar
Tāpiri	suggest
Tuhi	suggest
ōrero	suggestion
orie	suit
Faʻaite	suitable
Puiri	suitcase
Tōmē	sum
pū'ohu	sum
māra'a	summary
tā'atā	summer
Tū'a'ō	summit
tāne	sun
Mahana Tapu	sunday
rārā	sunny
Aurā	sunset
Ma'eha'a	sunshine
Matamua	super
mahana	super
Tauraa	superior
upo'o fa'atere	supervisor
ra'atira	supervisor
api'ina	supper
ho'ēmi	supply
Tauturu	support
ato'a	support
āmaramarama	suppose
faanaoraa	supposed
pāpū	sure
ihoā	sure
māere	surface
tapiri	surge
tia ohipa	surgery
ato	surname
Haere mai	surprise
ha'ere 'āmui	surprise
pureraa	surprised
fa'ahiahia	surprised
āmui	surrender
fa'a'atihia	surrounding
mau faaheihei	surrounding
Tauhō'ēve'a	surveillance
Heʻere	survey
Tāuru	survey
tino'ōra'a	survive
tahua	suspect
hāhū	suspended
a'au	suspicious
Ō'ū	sustain
faahea	sustain
Fa’ahei	sustainability
tau roa	sustainability
māra'a'ōfa'i	sustainable
Fa'ahoro'ā	sustainable
Tāuru	swag
Ti'aturi	swag
Tō'eto'e	swag
Taro	swallow
ho'ē'ē	swallow
hura	swap
ta'o	swear
Fau	sweat
Tapao	sweater
U'umu	sweep
fa'aipoipoga	sweet
Mahana	sweet
moemoeā maita'i	sweet dreams
niho marū	sweet tooth
Pāti mānava mā’ea	sweet tooth
tamā'ine'iti	sweetheart
Pare	swell
Turea	swelling
Au	swim
Tere faremoana	swimming
tai'o	swing
tā'ora'a	switch
Hō'ē	switch
taumaha	swollen
'au'au	swollen
o'e	sword
Tika	symbol
tohu	symbol
Aroha	sympathy
manava	sympathy
ārā'ara	symptoms
pūnaha	system
parau	system
reo	system
taputapu	table
Fāna'i	tackle
Ti'a to'u	tag
Reo Tahiti	Tahitian
Tahiti	Tahitian
Rima	tail
ūpa'upa'a	tail
tāpe'a	take
rave	take
Ture parau	take away
Tauturu i te hoʻomanaʻo	take care
Tā'ō'ō	take off
tā'u'ī	take off
Turi	taken
Parau	talk
Tauhiti'iti	talkative
Maʻa	tall
teitei	tall
Papapue	tap
pāfaufau	tap
Ti'āpa	tape
ta'ona	tape
tō'u here iti ē	target
tā'u ta'ata	target
teie	task
tenā	task
terā	task
tā mātou	taste
tō mātou	taste
Maita‘i	tasty
Mahana	tasty
Aʻo	taught
tī	tea
fa'aea	teach
tumu	teacher
Fanaʻo	teacher
hoa	team
tā'e'e	tear
Kani	tear
rū'i	tears
Onero'o	tears
Ape	tease
hōhō	tease
ihianoha'a	technology
ihimata'ī	technology
niho	teeth
Tuatua	tell
Tu'aro'i	tell
ruatau	tell me
tārena	tell me
huru	temper
aro'a	temper
rārā‘u	temperature
mā'i'i	temperature
hiero	temple
fare pure	temple
aora'i	temple
Tau'āra'a	temporary
ahuru	ten
hānere 'ahuru	ten thousand
ahuru tauatini	ten thousand
Opo'a	tenant
Fa'atere	tenant
Ōta'ata	tenant
ūmara'a	tend
huru nei	tendency
hete	tendency
Tā'ape'ape	tender
Tamā'iti	tender
Tere	tense
ino'ino	tension
Fare hune	tent
Fa'atōtō	tentative
‘ōmārama	term
pā'uru'uru	term
Tāvini	terms
Ma'ohi	terrible
Moekore	terrible
aitotoi	terrific
teritore	territory
hō'iti'iti	test
Tātai	test
Tu'atā	text
O te	than
Ta'i	than
teie mau mea	thank
terā mau mea	thank
māuruuru	thank you
māuruuru nō te fa'a'oroma'i, e hi'opo'a mātou i te fa'autara'a	Thank you for your patience while we investigate shipment
Maʻuruuru roa ia outou	thank you so much
mai te peu	thank you very much
mai te mea	thank you very much
māuruuru	thanks
māuruuru nō te fa'a'ohipa i teie rāve'a roruira	Thanks for using our app
tenā	that
terā	that
oia na	that is
Eiaha	that is
E maita'i'	that's good
te	the
ta'ata'ai	theft
tā rātou	their
tō rātou	their
rātou	them
Pū	theme
Tō'outāne	themselves
i muri	then
Mahere	theory
tē vai nei	there
tē vai ra	there
E 'ā	there are
e 'ite	there is
āre'a	therefore
teie mau mea	these
terā mau mea	these
rātou	they
rāua	they
te rātou	they are
o rātou	they are
pāruru	thick
Matie	thick
orometua	thief
taha'iti	thigh
Pare	thigh
Pato	thin
Mea	thing
tu'upiri	things
Mana'o	think
Tahiri	think
Tātou	third
ha'ai	thirsty
ahuru ma toru	thirteen
e toru 'aha	thirteen
toru 'ā	thirty
toru 'ahuru	thirty
teie	this
tenā	this
o ia	this is
O teie	this is
Īa'ite	thorough
Ma'eha'a'	thoroughly
Oia	those
terā rā	though
feruri	thought
mana'o	thought
Tau'ā'ā i te fa'ahiti	thoughtful
ta'ata'amu	thoughtful
Ō'opa	thoughts
‘Ōna‘i	thoughts
tauatini	thousand
hānere	thousand
a'au	thread
ta'aroa	threat
tapahi	threaten
hāmani 'ino	threaten
Toru	three
Ō	threshold
ōfa'i	threshold
mata'ora	thrilled
Manava	thrive
i raro	thrive
Tūtū	throat
ōfa'i	throat
nā roto	through
I roto i te hō'e'e	throughout
I roto i te hōʻeʻāmui	throughout
Hoʻoarii	throw
Ho'i	throw
Tātari	thumb
Re'ure'u	thunder
Ta'ata	Thursday
a iti	thus
O teie nei	thus
Tā'ura'a	tick
ahe	tide
tai	tide
ōfa'i	tidy
Ta'u'a	tie
tāita	tiger
Tīgere	tiger
Tino tapu	tight
Tigrinya	Tigrinya
Mahana	time
Ti'aturi	timid
Iti'iti	tiny
tāuru	tip
Tauiira	tips
Moni	tips
pa'ea	tire
rohirohi	tired
fenefene'a	tired
fiu	tired
Fa'anaho'	tissue
Tino	title
to'urara'a	title
atu	to
a	to
E fa'ahou	to be
vai	to be
E hō'ē	to be
faraoa tunupa'a	toast
i teie mahana	today
i teie nei	today
Tamari'i noanoa	toddler
Mata'iri'i	toes
Fitiavana	together
i te mana'o noa	together
Fa'atoro'	toilet
inoino	told
Aroha'ā	tolerance
Tahuti'i	tolerate
tōmāti	tomato
āpōpō	tomorrow
ananahi	tomorrow
ōhiti	tongue
Tōnei	tonight
I te roa	too
Rahi	too
Tāʻitaʻi	took
Fare rā	tool
rāve'a	tools
niho	tooth
ino	top
ū'upa'a	topic
Tu'ihia	torn
Parapara'a	torn
Ā'ati'a	torn
Fa'ari'i	torture
Pō'a'iti'i	torture
Ta'atafa'ari'i	torture
Ō'oe	total
tā'uru	touch
Tāpiri	touch
pa'ari	tough
Tere	tour
i te 'āmui	toward
I roto i	towards
taura	towel
ōrotā	town
Fa'arō	toxic
Taʻu	toxic
ōpū'upū	trace
taratara	track
hoa	trade
peu	tradition
ta'ere	tradition
hīro'a tumu	tradition
mātāmua	traditional
Fa'ati'a	traditional
tipaerari'i	traffic
Hu'a	trail
aratini	trail
Paruru	trail
Maro	train
Paʻa	train
pārahi	training
Aha‘ōfa‘i	training
mā'itia	trait
Ō'opa'a	trait
hō'ē	traits
Fa'a'ite	traits
tā'ere	transfer
fariiraa	transition
Tataura'a	translate
reru	transparent
tarapape	transparent
fāura'o	transport
Āti'a	transport
tauturu mau	transportation
fa'atoro	transportation
Fārere'	trap
tūtaki	trash
Rā'au	trash
Fa'aterehia	trauma
Haere	travel
Haere i te hō'e'e	travel
pu'ere	tray
pae'are'a	tray
hō'ai	treasure
ha'apa'o	treat
rave	treat
o vau ato'a	treatment
nō'u ato'a	treatment
nā'u ato'a	treatment
'Ū 'ātahi	tree
ārā'i	tree
Ma'ihia	tremendous
ho'e	trend
tāuru'uru	trial
Ma'iti'i	trick
tinihaga	trick
tā'ōhipa	tried
Ato'a	tried
hō'ē ā	trigger
tapa'a	trim
pae	trim
Haereere	trip
Ūrī	trouble
tarava	trousers
tārāma'i	truck
toruka	truck
tiruka	truck
ti'a	TRUE
parau mau	TRUE
ōpū'ari'i	trunk
Atiʻi	trust
tūhonohono	trust
ōhira'a	truth
Āvana	truth
Haaparau	try
Tahiti'i	try
Tsonga	Tsonga
Pipi	tube
tupa'a	tube
Mahana Mātiniti	Tuesday
Mahana Tūrei	Tuesday
Fa'ahau	tuition
Pūraho	turkey
amukiri	turmeric
tamārō	turmeric
Hoʻeʻāmui	turn
honu	turtle
Tutohia	tutor
‘Iva tekau ma ‘rua	twelve
Roahā	twelve
Ivahatini	twenty
e hā'iti	twenty-one
piti 'ahuru ma hō'ē	twenty-one
Twi	Twi
Aore	twice
piti'i	twice
E rua	twice
Fa'atupu'ā'iti	twist
Ti'atu'ati'a	twist
Tahuri	twist
piti	two
tino	type
tino'ā	typical
Mānea'a	ugly
Haʻurumaʻi	ugly
ta'ito'ito	ultimate
Ēpela	umbrella
āpīrē	unable
Tamaina	uncle
orometua'i	unconscious
Pū'i	unconscious
raro	under
I raro iho nei	underneath
i raro i te	underneath
Tātā'o	underrated
ma'uti'a	underrated
Hōʻike	understand
Mātau	understand
Manava	understood
E mārama	understood
Tauturu	understood
Tano ia	unfortunately
perēue	uniform
ōtahi	unique
faaora	unit
Mahana	unit
Are Pōrīnē	university
a'o'ore	unknown
parau ta'e mō'ōre	unknown
aore	unless
Ina	unless
haere atu	until
tae atu	until
mā'ea'ea	unusual
I runga	up
tei iā 'oe te mana	up to you
i to 'oe	up to you
tāmata'u	update
Ho'āpī	upgrade
I te	upon
ārepurepu	upset
ānau	upset
'āueue	upset
pape	urban
o vau	urge
hi'a	urgent
tape	urgent
topa	urgent
tatou	us
Mātou	us
Tāʻiri	use
fa'ahou	use
Fa'a'apū	used
tā'ore'a	used
fa'ahouhia	useful
Fa'ahou	useful
Tōhe	useless
i te mārō'a	usual
fa'a'ohipahia	usually
ravehia	usually
Ti'a'ite	utility
Mahana tā'ō'a'o	vacation
Pō i roto	vacation
Ta'atahaa fa'aharatau	vaccination
ha'apūmui'o	vaccination
faaora	vaccine
Vaikaomata'i	vacuum
ti'a'āpa	vague
hi'opo'a	valid
Mata'ire'a	valley
pūai	valuable
Nui	value
Faʻaipoipo	variety
‘ē‘e atu	various
Faʻatere	various
fa'ahau	vary
pāpātaratara	vase
ha'apape	vast
matie	vegetable
rā'au	vegetable
Ō'umaru	vegetables
Vehi'ara'a	vehicle
vāhine	vehicle
Taote	vendor
tevini	vendor
Pipi	venom
ta'ero	venom
ha'api'iou	venture
Fa'ahou'	venue
tatara'ā	verify
Manavahe	versatile
Vārīti	version
tūti'a	vertical
Nui roa	very
maitai roa	very good
Mārō'a roa	very good
va'a	vessel
Mai	via
pū'e'e	vibe
‘orometua	vibes
Ata	vibes
hi'ō	vicious
māpū	victim
Fare'āviri'a	video
vāhirahirahia	view
Fa'ato'ito'i	village
ōrotā	village
ta'ata 'ino	villain
uiri	vinegar
Māo'o	vinegar
Pīmare	vintage
tiamaraa	violence
Fa'amu	violent
viri'a	viral
Vīra'a	viral
hinanui	virgin
hanahana	virtual
pa'iatua	virtual
ōro'a	virtual
Mā'ohi	virtue
maru	virtue
tupu	vision
tae	visit
Fa'atumu	visual
maha	vital
ma'ohi	vivid
Parau fa'ari'i	vocabulary
fa'ahiti'ira'a	vocabulary
reo	voice
Ā'ā	void
fa'aite'a	void
pahī	volume
fare fa'a'amuraa	volunteer
rūa'i	vomit
Tei roto	vulnerable
parau	wage
fa'atanetane	wages
pa'epa'e	wages
Mataʻu	waist
hērū	wait
tīa'i	wait
taitai	waiter
ha'aviri	waiting
Fa'atere	wake
fa'atanu	wake
tūtū	wake up
Tūtā	wake up
Haere	walk
Haere	walking
oriori	walking
ārā	wall
pa'uniuni	wallet
haere parau	wander
Tau'ā'ā	wander
Vehivahi	wanna
hina'aro	want
hia'ai	want
tā'atira'a	wanted
tū'ara'a	war
āpi'ira'a 'ōpū	wardrobe
Tūtū'ā'iti	wardrobe
Fa'anaho	warehouse
ve'ave'a	warm
veravera	warm
mahana	warm
Tu'uroa	warn
Tu'u	warning
aito	warrior
toa	warrior
i teie	was
hura	wash
parau	waste
Matapuna	waste
māta'ita'i	watch
vai	water
pape	water
merēni	watermelon
Meloni vaipū	watermelon
āmara'a	wave
Ara	way
mātou	we
tātou	we
Mātou ‘ātoro	we are
o mātou	we are
e nehenehe tā mātou	we can
mohio	weak
Mahana	weak
paruaparu	weakness
e hoa 'ino mā ē	wealth
Rava	wealthy
fa'a'ahu	wear
ō'omo	wear
ōmono	wear
Ā'ati	wearing
huru o te reva	weather
tū'ā'āpi'ira'a	wedding
Mahana Pō'a	Wednesday
Mahana Pōpō	Wednesday
Pū'i'a	weed
mau'u	weed
mū'ōfa'i	week
tīa'i	week
fa'a'oroma'i	week
āpo'irā	weekend
Manawa	weight
māere	weird
ia ora	welcome
maeva	welcome
manava	welcome
Rima haavare'	welfare
maita'i	Well
ā	Well
mātou ma te ma'ohi	well done
Ua haere	went
Haere	went
i teiei	were
Raro'i	west
raro	west
Totoa	wet
māmā	wet
māmā	whale
e aha	what
Eaha to'oe?	what about you
e aha tā 'oe e rave	what are you doing
e aha tā 'oe e ha'a	what are you doing
e aha tā 'oe e rave nei	what are you doing now
E aha 'oe e fa'ahou noa i teie mahana?	what are you doing right now
Rima	what do you do
tino'ōra'a	what do you do
E aha te huru i to'u fa'ahoro'ia?	what do you do for a living
i te aha koe e tāna'u nei	what do you mean
E aha te taime	what do you mean
E aha ana ‘oe	what do you want
e aha tō 'oe e hina'aro	what do you want
E aha i haere i ai	what happened
e aha tenā	what is
e aha teie	what is
e aha terā	what is
E aha tēnei	what is this
E aha te fa'ahora'a na'u?	what is your job
o vai tō 'oe i'oa	what is your name
o vai tō 'oe i'oa pi'i	what is your name
Eaha te huru	what's up
o vai tō 'oe i'oa	what's your name
E ha'amāri'i	whatever
Aita e taʻaʻina	whatever
Fa'arāpū	wheat
pū'ara'a	wheat
ta'ata'a	wheel
a hea	when
a fea	when
ia 'ao'ao	whenever
i hea	where
i hea 'oe	where are you
nō hea mai 'oe	where are you from
I hia 'oe i teie mahana	where are you now
i te tahi 'āpi'ira'a 'oe e noho nei?	where do you live
E noho i tei?	where do you live
i fea	where is
oia	whereas
mai te peu	whether
mai te mea	whether
tē	which
te hea	which
āre'a	while
Oa	whisper
tiu	whistle
whītara	whistle
Papape	white
o vai	who
O wai 'oe	who are you
O vai 'oe	who are you
ko wai	who is
E hia	who is
O wai tēnei	who is this
o vai teie	who is this
pā'āto'a	whole
pauroa	whole
tā'āto'a	whole
Ia	whom
i 'o	whom
No hea	whose
nō te aha	why
Eaha i te haere 'o'ona	why not
ohie	wicked
Roa	wide
Lātū	wide
Vahine tane tāne	widow
tāvana'arai	widow
hohoa	width
Vahine tāne	wife
Vahine	wife
fa'anui	wild
parau tutu'u	will
hina'aro	will
fa'ahoui	willing
Ha'ari	win
fa'aea	win
Matangi	wind
Tūpāpā	window
Ā'au	window
Tūtū	window
Tāmā'ara'a	windy
maru	windy
Vaina	wine
ū	wine
māhiti	winter
Fārito	wipe
Taura	wire
'īra'a	wire
Maʻa	wisdom
'Aita'a	wisdom
‘ōmārama	wise
Mataurauraʻa	wise
Tāne	wish
Māuruuru	wish
Te anana ia outou i te mau fa’ahei e tahi	wish you all the best
Māpōti	witch
e	with
Haʻatu	withdraw
utuao	withdrawal
i roto i	within
I roto	within
I te faʻaipoipo	without
Aore	without
tūtara'a	witness
Ha'amaitai	witty
Varua	wolf
ruto	wolf
Upokī	wolf
Vahine	woman
vahine	women
Ī'ī	won
Aita	won't
Mārohirohi	wonder
Pāruru	wonder
Mārō'a	wonderful
Maʻohi	wonderful
Aito	wood
ātoro	wood
Pūtea	wool
uru	wool
Fāfairea	wool
īoa	word
Re'o	words
ohipa	work
rave	work
ha'api'i 'ātete	work out
Tātari	working
Ao	world
Rūmi	worm
Ho'ē'ē	worn
ta'ata	worn
taui	worried
mō'ere	worry
āmui'ī'ī	worse
ta'ā'ō'ia	worship
Maitai roa	worst
ino roa	worth
farii atu	worth it
Tō'ō'ā	worthy
hina'aro	would
hia'ai	would
ino	wound
Vaevae	wound
auē ho'i ē	Wow
ta'e'e	wrap
Utu'ā	wrath
Pōiri	wrath
Ū 'ātahi	wrist
pūpūniho'i	wrist
Tuhia	write
a pāpa'i i'ō nei	Write here
tu'ura'a	writing
pāpa'ihia	written
Tuhi	written
parau	wrong
Āmui	wrong
pāpa'ihia	wrote
Tupu	wrote
Paepae	yard
hāmama	yawn
auē	Yeah
matahiti	year
matahitis	years
Pō'iti	yeast
maoa	yeast
Pi'o'i	yell
ō'ō	yellow
'ē	Yes
ae	Yes
'oia	Yes
Pā'amu	yes baby
ae tamā'ita'i	yes baby
Aita e haapopo vau	yes dear
ʻIa e te matahiti	yes honey
Eaha e te aroha	yes my love
ʻE māuruuru iāʻoe e tātou	yes my love
E, e tōtahi	yes of course
ʻApaʻau	yesterday
anei	yesterday
inaha	yet
terā rā	yet
ina'a	yet
Haʻapaʻa	yield
‘outou	you
‘oe	you
haere atu	you are
tae atu	you are
oe teie nei 'āvana	you are beautiful
oe 'e ma'ohi	you are beautiful
e rave i te metua roa	you are so beautiful
maeva	you are welcome
Manava e	you are welcome
E taea e oe	you can
E taea 'oe	you can
Ua 'ō	You know
oe ho'i	you too
māta'ita'i	you're welcome
tamaroa (for males)	young
tamahine (for females)	young
tā 'oe	your
tō 'oe	your
e maeva	your welcome
iā 'outou	yourself
ia 'oe	yourself
tamariti	youth
aita e pe'ape'a	you’re welcome
aita e fifi	you’re welcome
Maruhi	yummy
mā’ea	zero
aore	zero
