бичииле	a little
хөй	a lot
дыка хөй	a lot of
кагдынган	abandon
кагдынган	abandoned
сагыыр	abide
чаяанныы	ability
шыдаар	able
ол дугайында	about
кырында	above
соңгаар	abroad
чогу	absence
чок болур	absent
көнгүс	absolutely
сиңирер	absorb
абстрактылыг	abstract
утка чок чүүл	absurd
чедер-артар	abundance
элбек	abundant
дорамчылал	abuse
акцент	accent
хүлээп алыр	accept
кирери	access
озал-ондактыг таварылга	accident
таарыштыр тургузары	accommodation
күүседир	accomplish
доозупкан	accomplished
ёзугаар	according
счёт	account
ылаптыы	accuracy
ылаптыг	accurate
буруудаттырган	accused
аарыыр	ache
чедип алыр	achieve
чедиишкин	achievement
деп көөр	acknowledge
таныжылга	acquaintance
апаар	acquire
алган	acquired
тып алыры	acquisition
кежилдир	across
үүлгедиг	act
үүлгедиг	action
идепкейлиг	active
ажыл-чорудулга	activities
ажыл-чорудулга	activity
актёр	actor
херек кырында	actual
шыны-дизе	actually
шынап болза	actually
чидиг	acute
чаңчыгар	adapt
немээр	add
хамааржыры	addicted
немелде	addition
немелде	additional
адрес	address
дүүшкек	adequate
кожаландыр	adjacent
демдек ады	adjective
таарыштырар	adjust
магадаар	admire
хүлээп алыр	admit
азырап алыр	adopt
чаптанчыг	adorable
бурунгаарладыыр	advance
мурнакчы	advanced
ажыы	advantage
онза таварылга	adventure
наречие	adverb
реклама	advertisement
рекламалаан	advertising
сүме	advice
сүмелээр	advise
болчукчу	advocate
эстетиктиг	aesthetic
болуушкун	affair
чалдар чедирер	affect
хандыкканы	affection
чөпшээрээр	afford
таарымчалыг	affordable
коргар	afraid
ооң соонда	after
соонда	after
дүүш соо	afternoon
сөөлүнде	afterwards
катап	again
удур	against
назын	age
агентство	agency
агент	agent
халдакчы	aggressive
кашпагай	agile
бурунгаар	ago
чөпшээрээр	agree
дугуржулга	agreement
Көдээ ажыл-агый	agriculture
мурнунда	ahead
дузаламчы	aid
шыгаашкын	aim
агаар	air
аэропорт	airport
эртер чер	aisle
дүвүрээзин	alarm
арага	alcohol
дүвүрээзин	alert
дириг	alive
шупту	all
шупту чүве анаа	all right
эң эки чүвелерни кузээр	all the best
чөшпээрээр	allow
чөпшээрээн	allowed
барык-ла	almost
чааскаан	alone
дургаар	along
шагда-ла	already
шын	Alright
ынчаарга	Alright
ынчангаш	also
өске янзылыг	alternative
болза	although
үргүлчү	always
черле	always
кайгамчыктыг	amazing
хөй уткалыг	ambiguous
бодун тогдунары	ambition
бодун тогдунар	ambitious
частырыгны эдер	amend
ортузунда	amid
аразында	among
аравыста	among us
сан	amount
түң	amount
хөктүг	amusing
анализ	analysis
өгбелер	ancestors
өртэг	anchor
эрте-бурунгу	ancient
биле	and
сен база	and you
силер база	and you
ангел	angel
килең	anger
азыг	angle
хорадаан	angry
мал	animal
көкерек	ankle
ой	anniversary
чарлаары	announcement
шаптыктаар	annoy
бужурганган	annoyed
анчыг	annoying
чылдын	annual
ат салбаан	anonymous
өске	another
харыы	answer
даап билир	anticipate
сагыш човаар	anxiety
дүүрээшкин	anxiety
сагыш човаар	anxious
кандыг-даа	any
каттап кылбас	anymore
кым-даа болза	anyone
чүү-даа болза	anything
канчаан-даа болза	anyway
канчаан даа болза	anyways
аңгыда	apart
квартира	apartment
өршээл дилээр	apologize
илдең	apparent
чадапчок	apparently
хуулары	appeal
тыптыр	appear
даштыкы хевири	appearance
тыптып келген	appeared
аппетит	appetite
яблок	apple
капсырылга	application
ажыглаар	apply
ужуражылга	appointment
үнелээр	appreciate
өөрүп четтиргени	appreciation
чоогаар	approach
чоокшулап алыр	approach
таарымчалыг	appropriate
тургузары	approval
чүүлдүгзүнер	approve
чүүлдүгзүттунген	approved
барык-ла	approximately
дөрт ай	april
доктаамал эвес	arbitrary
архитектор	architect
архитектура	architecture
архив	archive
сен	are you
силер	are you
чай чок силер бе	are you busy
чай чок сен бе	are you busy
сен өгленген сен бэ	are you married
Силер өгленген силер бэ	are you married
силер өгленип алган силер бе азы чааскан	are you married or single
сен өгленип алган сен бе азы чааскан	are you married or single
сен ам-даа мында сен бе	Are you still there?
сен ында сен бе	are you there
силер ында силер бе	are you there
девискээр	area
маргыжар	argue
барымдаа	argument
тыптыр	arise
хол	arm
шериг	army
долгандыр	around
чурумчудар	arrange
таарыштыр тургузары	arrangement
келири	arrival
келир	arrive
келген	arrived
улуургак	arrogant
согун	arrow
уран-чүүл	art
чүүл	article
кылымал	artificial
артист	artist
аразында	as long as
база	as well
база ышкаш	as well as
хүл	ash
ыяттырган	ashamed
айтырар	ask
айтырган	asked
удуп чыдар	asleep
тала	aspect
Асаам	Assamese
халдаашкын	assault
хурал	assembly
бадыткалдыг	assertive
өртээн доктаадыр	assess
үнелээр	assessment
хөреңги	asset
активтер	assets
айтыр	assign
сорулга	assignment
дузалажыр	assist
дузалакчы	assistant
холбаар	associate
хамаарылган	associated
ассоциация	association
деп бодаар	assume
даап бодаары	assumption
бети дизе	at least
чипкен	ate
спортсмен	athlete
чыпшырар	attach
быжыглаткан	attached
ижиккени	attachment
халдаар	attack
шенелде	attempt
олуржуп турар	attend
барып турары	attendance
кичээнгей	attention
харылзаа	attitude
сонуургадыр	attract
хаара тудары	attraction
сонуурганчыг	attractive
атрибут	attribute
аудитория	audience
сес ай	august
даай-авай	aunt
угба	aunty
боду	authentic
чогаадыкчы	author
эрге-чагырга	authority
күс	autumn
чайлыг	available
хостуг	available
ортун	average
частырар	avoid
одуг	awake
шаңнал	award
билиглиг	aware
билири	awareness
өскээр	away
кайгамчык	awesome
кайгамчыктыг	awesome
аажок коргончуг	awful
эпчок	awkward
Аймара	Aymara
өпея	baby
бакалавр	bachelor
дээдир	back
аткаар	back
фон	background
багай	bad
барба	bag
чемиш	bait
быжырар	bake
пекарня	bakery
чемге ажыглаар сода	baking soda
баланс	balance
бөмбүк	ball
Бамбара	Bambara
банан	banana
группа	band
согар	bang
банк	bank
бар	bar
арай деп	barely
дугуржулга	bargain
ээрер	bark
арбай	barley
барьер	barrier
үндезин	base
үндезилеттинген	based
подвал	basement
үндезин	basic
колдуунда	basically
базилик	basil
бастард	bastard
партия	batch
ванна	bath
ванная	bathroom
батарея	battery
дайын	battle
мугулдур	bay
бар болур	be
оваарымчалыг бол	be careful
эрик кыдыы	beach
херел	beam
чочак-тараа аймаа	beans
чүктээр	bear
ап чоруур	bear
сал	beard
көдүрүп алган	bearing
араатан	beast
согар	beat
каас-чараш	beautiful
чараш	beautiful
чаражы	beauty
апарган	became
чүге дээрге	because
чүге дизе	because
апаар	become
орун	bed
удуур өрээл	bedroom
ары	bee
инек эъди	beef
турган	been
пиво	beer
беттинде	before
баары	before
эгелээн	began
эгелээр	begin
эге	beginning
адындан	behalf
бодун ап чоруур	behave
аажы-чаңы	behavior
аажы-чаңы	behaviour
артында	behind
болур	being
бүзүрел	belief
бузурээр	believe
ижин	belly
хамааржыр	belong
ынак кижизи	beloved
куду	below
кур	belt
узун сандай	bench
ыргайтыр	bend
адаанда	beneath
ажыктыы	benefit
ажыктыы	benefits
кожа	beside
оон аңгыда	besides
эң эки	best
чедимчелиг болурун күзедим	best of luck
хүндүлел-биле	best regards
эки	better
аразында	between
суксун	beverage
ажыр	beyond
Бхожпури	Bhojpuri
чөптүг эвес	bias
чѳптүг эвес	biased
чадаг терге	bicycle
чагыг	bid
улуг	big
чадаг-терге	bike
счёт	bill
улаар	bind
кушкаш	bird
төрүттүнген хүн	birthday
хензиг	bit
ызырар	bite
ажыг	bitter
кара	black
бис	blade
буруудадыр	blame
куруг	blank
чоорган	blanket
частыышкын	blast
белизна	bleach
холуур	blend
йөрээр	bless
йөрээлдиг	blessed
согур	blind
чыргал	bliss
бүзээлээр	block
хан	blood
чечектелиир	bloom
үрер	blow
көк	blue
шапты	blunt
самбыра	board
хеме	boat
эът-бот	body
хайындырар	boil
тас	bold
харылзаа	bond
сөөк	bone
ном	book
өстүрер	boost
күштелдирикчи	booster
идик	boot
идиктер	boots
кызыгаар	border
чалгаараары	bore
чалгаараар	bored
чалгааранчыг	boring
төрүтүнген	born
чээр	borrow
дарга	boss
иелээ	both
саадарыыр	bother
шил	bottle
адаа	bottom
садып алган	bought
өрү халыгылаар	bounce
улатынган	bound
кызыгаарлары	boundaries
ча	bow
аяк	bowl
хааржак	box
оол	boy
эр таныш	boyfriend
билектээш	bracelet
мээ	brain
будук	branch
таңма	brand
эрес-дидим	brave
чаза шавары	breach
хлеб	bread
бустуур	break
үрелиир	break
эртенги чем	breakfast
эмиг	breast
тынар	breath
тынар	breathe
азыраар	breed
кирпич	brick
душтук	bride
көвүрүг	bridge
кыска	brief
чырык	bright
бриллиант	brilliant
чедирер	bring
экээр	bring
ака	bro
калбак	broad
теледамчыдылга	broadcast
үреп калган	broke
сыйылган	broken
ширбииш	broom
акый	brother
акы	brother
чуржу	brother in law
экелген	brought
хүрең	brown
щётка	brush
хууң	bucket
эш	buddy
бюджет	budget
доос-кара	bug
тудар	build
бажың	building
туттунган	built
улуг кезии	bulk
буга	bull
дүржок кижи	bully
үзер	bump
оваа	bunch
комплект	bundle
аар чүък	burden
хөөп калган	buried
өрттедир	burn
частыышкын	burst
хөөр	bury
автобус	bus
чокпак үнүш	bush
ажыл-херек	business
сыгар	bust
чай чок	busy
ынчалза-даа	but
ак саржаг	butter
ховаган	butterfly
кнопка	button
садып алыр	buy
ооң кадында	by the way
байырлыг	bye
капуста	cabbage
кабинет	cabinet
клетка	cage
торт	cake
бызаа	calf
кыйгырар	call
долгаар	call
менче долгаар	call me
адатынган	called
оожум	calm
келген	came
кампания	campaign
шыдаар	can
шыдавас	can't
Узуткаар	Cancel
рак	cancer
шыдаар	capable
ишкири	capacity
найысылал	capital
бижик	caption
тудуп алыр	capture
чычаан	car
ажыл-үүле	career
оваарымчалыг	careful
кичээнгейлиг	carefully
сагыш амыр	careless
сагыш човаңгыр	caring
бызаңчы	carpenter
хевис	carpet
морковь	carrot
ажаал	carry
улаштырар	carry on
эттирер	carry out
херек	case
бар акша	cash
октаар	cast
шивээ	castle
бөдүүн	casual
моортай	cat
диис	cat
тудар	catch
категория	category
мал	cattle
тутурткан	caught
чылдагаан	cause
оваарымчалыы	caution
оваарымчалыг	cautious
куй	cave
соксадыры	cease
дээвиир	ceiling
байырлаар	celebrate
клетка	cell
орзузу	center
век	century
тараалыг	cereal
ёзулал	ceremony
кезек	certain
ынчанмайн канчаар	certainly
сертификат	certificate
илчирбе	chain
сандай	chair
кыйгырары	challenge
шанс	chance
солур	change
сандараашкын	chaos
киржикчи	character
характеристикалар	characteristics
октаар	charge
ядыыларга дуза	charity
магаданчыг	charming
диаграмма	chart
сүрер	chase
шуугаар	chat
өртээ чиик	cheap
мегелээр	cheat
меге	cheating
хынаар	check
чаак	cheek
сергедиир	cheer
хөглүг	cheerful
чазамыктаар	cheers
быштак	cheese
химия	chemistry
хайыралаар	cherish
шыдыраа	chess
аптара	chest
дайнаар	chew
дагаа	chicken
баштыңчы	chief
чаш уруг	child
чаш назын	childhood
ажы-төл	children
сериин	chill
яңданнар	chimneys
сегел	chin
шоколад	chocolate
шилип алыры	choice
шилиир	choose
чарар	chop
бажыңда ажыл	chores
семис	chubby
хүрээ	church
корица	cinnamon
төгерик	circle
байдалдар	circumstances
хамааты	citizen
хоорай	city
негелде	claim
тодарадыр	clarify
класс	class
дой	clay
арыг	clean
арыг-силиг	clear
албан-хаакчы	clerk
угаанныг	clever
клиент	client
чалым	cliff
агаар-бойдус	climate
халбактанып үнер	climb
чыпшынчак	clingy
шак	clock
хаар	close
шкаф	closet
хеп	cloth
хептер	clothes
булут	cloud
булуттуг	cloudy
клоун	clown
буруудадыр барымдаа	clue
каңдай	clumsy
чыылганы	cluster
башкы	coach
хөмүр	coal
эрик чоогу	coast
тон	coat
кофе	coffee
угаан	cognitive
дүгжүрү	coincidence
соок	cold
коллапс	collapse
моюндурук	collar
коллега	colleague
коллегалар	colleagues
чыыр	collect
коллекция	collection
колледж	college
өң	color
өң чок ногаан бодалдар дыка удуп чыткан	colorless green ideas slept furiously
өң	colour
столбец	column
дыргак	comb
каттыштырары	combination
каттыштырар	combine
кээр	come
келир	come
бээр кел	come here
чоокшуладыр кээр	come on
комфорт	comfort
эптиг	comfortable
кел чыдар	coming
удавас кээр	coming soon
бөлүк	command
комментарий	comment
коммерцияның	commercial
комиссия	commission
күүседиир	commit
хүлээлге	commitment
шынчы	committed
бараан	commodity
ниити	common
харылзажыр	communicate
харылзаа	communication
бөлүк	community
солуур	commute
өңнүк	companion
компания	company
дөмейлээр	compare
деңнелге	comparison
кады качыгдаары	compassion
кээргээчел	compassionate
тааржыр	compatible
чаржыр	compete
эки билир	competent
чарыш	competition
маргыштыг	competitive
хомудаар	complain
хомудал	complaint
немелде	complement
доозар	complete
бүрүнү-биле	completely
нарын	complex
тааржыры	compliance
нарын	complicated
мактаары	compliment
сагыыр	comply
композиция	composition
улажыры	compound
билип алыры	comprehension
хөй талалыг	comprehensive
чөпшээрежилге	compromise
албан ужурлуг	compulsory
компьютер	computer
мөөңнээр	concentrate
концепция	concept
дүвүрээзин	concern
дүвүрээн	concerned
концерт	concert
түңнел	conclusion
бетон	concrete
байдал	condition
байдал	conditions
дамчыдар	conduct
конференция	conference
ажыы-биле минниир	confess
бүзүрээри	confidence
бүзүрелдиг	confident
шынзыдар	confirm
маргыжары	conflict
эгенир	confused
будулгаазын	confusion
байыр чедирери	congrats
байыр чедирери	congratulation
байыр чедирер	congratulations
улажыры	conjunction
кожар	connect
чаалап алыр	conquer
медерелдиг	conscious
миннири	consciousness
чөпшээрел	consent
уржуктары	consequences
кадагалаары	conservation
хожудаңгай	conservative
топтап көөр	consider
манап көөр	consider
санатынган	considered
тургустунар	consist
чөпшээрежилге	consistency
туруштуг	consistent
үргүлчү	constant
черле	constantly
тырык	constipation
тудуушкун	construction
хереглээр	consume
хереглээри	consumption
харылзаа	contact
халдавырлыг	contagious
тудар	contain
хандырар	contains
онза чугула	contemporary
тоо бодавазы	contempt
допчузу	content
конкурс	contest
контекст	context
дип	continent
улаштырар	continue
керээ	contract
контраст	contrast
дузалаар	contribute
салган акша	contribution
контроль	control
маргыштыг	controversial
эптии	convenience
эптиг	convenient
чугаа	conversation
чаартыр	convert
дамчыдар	convey
бүзүредир	convince
бүзүрээн	convinced
чем кылыр	cook
чем кылыр	cooking
азаартыг	cool
сериин	cool
угжок	cool
кады ажылдажылга	cooperation
күш чедер	cope
чес	copper
үрүң	core
кукуруза	corn
азыг	corner
шын	correct
өртек	cost
костюм	costume
коттедж	cottage
хөвең	cotton
диван	couch
чөдүрер	cough
болур	could
шыдаар	could
чөвүлел	council
санаар	count
счётчик	counter
чурт	country
суур	countryside
эжеш	couple
эрес-дидим	courage
уг-шиг	course
шүүгү	court
хүндүлээчели	courtesy
шаны	cousin
шывар	cover
инек	cow
кортук кижи	coward
таарымчалыг	cozy
краб	crab
дарс дээн	crack
ус ажыл	craft
мыяк	crap
үрелиишкин	crash
чүткүлде	craving
соястаар	crawl
четпес	crazy
чаяар	create
чогаадыкчы	creative
кредит	credit
үңгээр	creep
коргунчуг	creepy
бөлүк	crew
кем-херек	crime
чыырлыыр	cringe
чыырлы бээр	cringe
кризис	crisis
критерий	criteria
ондактыг	critical
критика	criticism
дүжүт	crop
тараа культуралары	crops
кежер	cross
каарган	crow
мөөң кижилер	crowd
кижи долдур	crowded
хаанның бөргү	crown
ондактыг	crucial
дерзии	cruel
круиз	cruise
чуура шавар	crush
чуура базар	crush
ыглаар	cry
огурец	cucumber
куспактаныыр	cuddle
культура	culture
кажары	cunning
тудалыг аяк	cup
чем шкавы	cupboard
узда	curb
эмнээри	cure
хорупкаан шак	curfew
сонуургал	curiosity
сонуургаар	curious
дыдыраш	curly
валюта	currency
амгы	current
амгы	currently
каргыш	curse
көжеге	curtain
сыртык	cushion
таарыштырган	custom
садып алыкчы	customer
каайлы чери	customs
кезер	cut
чаптанчыг	cute
цикл	cycle
терге мунар	cycling
ачай	dad
ача	daddy
хүн бүрүде	daily
сүттен кылган	dairy
чал	dam
урелиишкин	damage
ойт	damn
өл	damp
таанзы	dance
айыыл	danger
айыылдыг	dangerous
караңгы	dark
эргим	darling
хап кирер	dash
медээлер	data
үе	date
уруу	daughter
хүн	day
өлүг	dead
cөөлгү срогу	deadline
дүлей	deaf
херек	deal
эргим	dear
эргим шупту	Dear All
Эргим садып алыкчы	Dear Customer
эргим ада-ие	Dear Parents
эргим сэр	Dear Sir
эргим студентилер	Dear students
эргим бөлүк	Dear Team
өлүм	death
дискуссия	debate
дебет	debit
бузундулар	debris
өре	debt
он чыл	decade
будулары	decay
өлген	deceased
мегелээр	deceive
он ийи ай	december
топтуг	decent
шиитпирлээр	decide
шиитпирлээн	decided
шиитпир	decision
түү	deck
кудуладыыр	decline
эвээжедир	decrease
бараан болдурган	dedicated
бердингени	dedication
чорук	deed
хандыр	deep
иви	deer
өйлээни-биле	default
аштырыышкын	defeat
камгалаар	defend
тодарадыр	define
чүс хуу	definitely
тодарадылга	definition
чада	degree
саадаашкын	delay
соңгаарладыр	delayed
аштаар	delete
сагыштыг кылгаң	deliberate
ээлдек	delicate
чаагай	delicious
улуг өөрүшкү	delight
магадаан	delighted
чедирер	deliver
чедирген	delivered
чедирери	delivery
негээр	demand
негелделиг	demanding
демократия	democracy
аза	demon
көргүзер	demonstrate
ойталаан	denied
сырыйы	density
диш эмчизи	dentist
хүлээвес	deny
килдис	department
чорудары	departure
идегээр	depend
чада тудар	deploy
депозит	deposit
муңгаргай	depressed
депрессия	depression
тереңи	depth
тодарадып бижиир	describe
тодарадып бижиири	description
куруг хову	desert
чедип алыр	deserve
дизайн	design
хүлээлге	designation
күзел	desire
ажыл ширээзи	desk
идегелин ышкынары	despair
идегел чок янзылыг	desperate
ынчалза-даа	despite
турза-даа	despite
десерт	dessert
чедер чери	destination
салым-чол	destiny
үрегдээр	destroy
бузары	destruction
деталь	detail
тодаргайы	details
тывар	detect
тодарадылга	determination
тодарадыр	determine
тодараткан	determined
хорадыр	devastated
сайзыраар	develop
сайзыраңгай	developed
хөгжүлде	development
тургузуг	device
херексел	device
аза	devil
тураскааткан	devoted
Дивехи	Dhivehi
чигир аарыы	diabetes
ижин долгап аарыыры	diarrhea
дневник	diary
сөстүк	dictionary
турган	did
өлүрер	die
өлүп калган	died
диета	diet
ылгал	difference
аңгы	different
берге	difficult
казар	dig
мөзүлүү	dignity
чүткүлдүг	diligent
кежээки чем	dinner
сугар	dip
доорт	direct
уг	direction
директор	director
хир	dirt
хирлиг	dirty
өжүрер	disable
харыысалга онаап болбас	disabled
чиде бээр	disappear
чөгенген	disappointed
катастрофа	disaster
каар	discard
эмгежок	discharge
чурум	discipline
чиигелде	discount
илередир	discover
кызагдаашкын	discrimination
чугаалажыыр	discuss
чугаалажыыры	discussion
аарыг	disease
аарыг	diseases
маскировкалаар	disguise
кончуг багай	disgusting
калбак тавак	dish
калбак тавактар	dishes
чөпшээревес	dismiss
чоргузар	dispatch
дисплей	display
чайладыры	disposal
чаргы	dispute
аразы	distance
илдең	distinct
ылгаар	distinguish
муңгагдал	distress
хуваалда	distribution
район	district
дүвүредир	disturb
оңгар	ditch
шымныр	dive
янзы-бүрү	diverse
янзы-бүрү	diversity
үлээр	divide
ыдыктыг	divine
чарлыры	divorce
баш дескинги дег	dizzy
кылыр	do
сен	do you
силер	do you
сен меңээ ынак сен бе	do you love me
эмчи	doctor
документ	document
бар	does
ыт	dog
Догри	Dogri
кылып турар	doing
ойнаар-кыс	doll
домен	domain
бажыңның	domestic
тергиидкен	dominant
чок	don't
дүвүреве	Don't worry
өргүүр	donate
дооскан	done
кылган	done
элчиген	donkey
кара-таапкы	dope
ийи дакпыр	double
чинзиниг	doubt
далган	dough
куду	down
бижиттирер	download
болбаазырадыр	draft
сөөртүр	drag
харыксырадыр	drain
драма	drama
чуруур	draw
дыртар карак	drawer
чурук	drawing
коргунчуг	dread
дүш	dream
платье	dress
мергежиири	drill
суксун	drink
мунар	drive
оскунар	drop
барып ушкан	dropped
каңдаашкын	drought
эзирик	drunk
кургаг	dry
өдүрек	duck
ашак	dude
чогуур	due
мооң хараазы-биле	due to
чалгааранчыг	dull
мелегей	dumb
бок төгер чер	dump
үүрү	duration
үезинде	during
үеде	during
доозун	dust
хулээлге	duty
чуртаар	dwell
өлүп чыдар	dying
бүрү	each
бот-боттарын	each other
аажок күзээр	eager
эзир	eagle
кулак	ear
ооң мурнунда	earlier
эрте	early
ажылдап алыр	earn
кулактар	ears
чер	earth
чер шимчээшкини	earthquake
бөдүүнү	ease
бөдүүнү-биле	easily
чөөн чүк	east
белен	easy
чиир	eat
чип турар	eating
экономика	economic
экономика	economy
кыдыг	edge
редакторлаар	edit
өөредилге	education
магадал	effect
үре-түңнелдиг	effective
ажылгыры	efficiency
эффектилиг	efficient
күжениишкин	effort
чуурга	egg
баклажан	eggplant
эго	ego
сес	eight
он сес	eighteen
сезен	eighty
чүү-даа	either
кандыг-даа	either
ажылдап кылыр	elaborate
шенек	elbow
улуг	elder
кырыксай берген	elderly
аянныг	elegant
элемент	element
чаан	elephant
он бир	eleven
чөпшээреп болур	eligible
узуткаар	eliminate
өске	else
ыяткан	embarrassed
ыядынчыг	embarrassing
куспактаар	embrace
көстү бээр	emerge
онза байдал	emergency
сеткил-сагыжы хайынган	emotional
сеткил каттыштырары	empathy
ударение	emphasis
акцент салыр	emphasize
ажылдакчы	employee
ажылчыннар	employees
ажыл берикчизи	employer
ажылга киирери	employment
хос	empty
куруг	empty
кыпсыр	enable
үскүлежиишкин	encounter
сергедир	encourage
дедкиир	encourage
төнчүзү	end
айыыл адаанда	endangered
чүткүл	endeavor
шыдамыы	endurance
шыдажып эртер	endure
дайзын	enemy
энергия	energy
киириштирер	engage
дүгдеттинген	engaged
дүгдээри	engagement
шимчедикчси	engine
инженер	engineer
англий дыл	English
экижидер	enhance
таалаар	enjoy
аажок улуг	enormous
чедер	enough
чедип тур	enough
четчир	enough
магадаар	ensure
кирер	enter
хөглээшкин	entertainment
сорук кириишкин	enthusiasm
магадаан	enthusiastic
бүдүнге	entire
адатынган	entitled
алыс ужуру	entity
кирер чер	entrance
бүдүрүлге ээзи	entrepreneur
чагаа	envelope
хүрээлээшкин	environment
адааргал	envy
маадырлыг	epic
эпидемия	epidemic
дең	equal
дериг-херексел	equipment
чөптүг чорук	equity
эквивалент	equivalent
балааш	eraser
чазыг	error
дезер	escape
онза	especially
чогаал	essay
алыс ужуру	essence
чугула	essential
тургузар	establish
тургустунган	established
хөреңги	estate
үнелээр	estimate
даап бодаан	estimated
оон-даа ыңай	etc
мөңге	eternal
этика	ethics
үнелээр	evaluate
үнелээри	evaluation
безин	even
оода	even
даа болза	even though
кежээ	evening
болуушкун	event
түңнелинде	eventually
кажан-бир шагда	ever
бүрү	every
шупту	everybody
шупту	everyone
шупту чүве	everything
өчүк	evidence
багай чүүл	evil
эволюция	evolution
сайзыраар	evolve
Эве	Ewe
шагдагы	ex
ылап шын	exact
ылап	exactly
ылап-ла	exactly
шалгалда	exam
шинчилээр	examine
чижек	example
көвүдей немээр	exceed
дыка эки	excellent
аңгыдан	except
тускай чуве	exception
артыкшыл	excess
эмин эрттир	excessive
солуушкун	exchange
девидээр	excited
девидээри	excitement
сеткил хөлзээр	exciting
онзагай	exclusive
өршээр	excuse
бурулуг болдум	excuse me
күүседир	execute
күүседир	execution
күүседикчи	executive
мергежилге	exercise
харыксырадыр	exhaust
шылап калган	exhausted
көргүзер	exhibit
делгелге	exhibition
амыдыраар	exist
амыдыраары	existence
бар	existing
үнер	exit
алгыдар	expand
идегээр	expect
манаан	expected
чарыгдалдар	expenses
аар	expensive
дуржулга	experience
эксперимент	experiment
эксперт	expert
эрткен	expired
тайлбырлаар	explain
тайылбыр	explanation
мөлчүүр	exploit
шинчилээр	explore
экспорт	export
сойгалаар	expose
делгээр	exposed
салдар	exposure
илередир	express
илерээшкин	expression
делгемчидер	extend
калбарткан	extended
алгыдары	extension
хемчээл	extent
даштыкы	external
кырлыр	extinct
немей	extra
уштур	extract
анаа эвес	extraordinary
сан чок	extreme
дыка	extremely
карак	eye
карактар	eyes
пөс	fabric
дүвүренчиг	fabulous
арын	face
деткиир	facilitate
дериг-херекселдер	facilities
бүдүрүлге	facility
барымдаа	fact
фактор	factor
завод	factory
фактылар	facts
оңар	fade
чедимче чок болур	fail
чедимче чок	failed
чедимче чок	failure
сула	faint
чөптүг	fair
ам болзун	fairly
фея	fairy
чүдүлге	faith
бүзүрелдиг	faithful
меге чүүл	fake
барып дүжер	fall
бадар	fall
аңдарылыыр	fall
меге чүүл	FALSE
ат-алдар	fame
таныыр	familiar
өг-бүле	family
аш-чут	famine
алдарлыг	famous
вентилятор	fan
тывызык	fancy
нарын	fancy
фантастиктиг	fantastic
ыракта	far
чарлып байырлажыры	farewell
ферма	farm
фермер	farmer
магаданчыг	fascinating
мода	fashion
дүрген	fast
семис	fat
халаптыг	fatal
салым	fate
ада	father
шагзырааны	fatigue
частырыг	fault
ынак	favorite
дуза	favour
ынак	favourite
коргуш	fear
найыр	feast
чүг	feather
чүүлү	feature
онза чүүлдери	features
ийи ай	february
чемгерип турган	fed up
давыдыр	fee
чемгерер	feed
дедир харылзаа	feedback
минниир	feel
минниишкин	feeling
буттар	feet
барып ушкан	fell
эш	fellow
минген	felt
кыс кижи	female
кажаа	fence
дүжүткүр	fertile
фестиваль	festival
уштур	fetch
халыын	fever
эвээш	few
биче	fewer
душтук	fiance
бодап тыпкан чүүл	fiction
шөл	field
араатанзыг	fierce
он беш	fifteen
бежен	fifty
чогуш	fight
чогуш	fighting
дүрзү	figure
билип алган	figure out
файл	file
долдурар	fill
долдур	filled
кино	film
ческинчиг	filthy
ам на	finally
саң-хөө	finance
саң-хөө	financial
тып алыр	find
тывар	find
илередир	find out
чүгээр	fine
ажырбас	fine
салаа	finger
төнчүзү	finish
доозупкан	finished
от	fire
быжыг	firm
бир дугаар	first
ат	first name
балык	fish
тааржыыр	fit
беш	five
эдер	fix
кылдынган	fixed
тук	flag
кывыышкын	flash
калбак	flat
дески	flat
четпес чүүл	flaw
кончуг эки	flawless
дезер	flee
эът-бот	flesh
ужуп турган	flew
ыргайтыр	flex
эглиичел	flexible
ужугары	flight
аңдарар	flip
ылчыңнажыр	flirt
ылчыңнашкан	flirting
салдаар	float
үер	flood
шала	floor
далган	flour
агар	flow
чечек	flower
грипп	flu
илдик чок	fluent
хостуг	fluently
чымчак	fluffy
суук чүүл	fluid
ужар	fly
хаара тудар	focus
туман	fog
туманныг	foggy
сыга тудар	fold
кижилер	folks
эдерер	follow
көрүп турар	follow up
соонда	following
чем	food
мелегей	fool
мелегей	foolish
буттар	foot
футбол	football
чижээлээрге	For example
чижелээрге	for instance
сеңээ	for you
хоруглуг	forbidden
күш	force
медээ	forecast
хавак	forehead
даштыкы	foreign
арга	forest
кезээде	forever
уттуптар	forget
өршээр	forgive
утупкан	forgot
серээ	fork
хевир	form
хевирниң	formal
шаандагы	former
Аас-кежии болуп	fortunately
аас-кежик	fortune
дөртен	forty
дөртен ийи	forty-two
буруңгаар	forward
мурнунче	forward
дузалаар	foster
чокшуп турган	fought
тыпкан	found
үндезин	foundation
дөрт	four
он дөрт	fourteen
дилги	fox
бустуучал	fragile
рамка	frame
рамки	framework
бузурукчу чорук	fraud
элдептиг кижи	freak
хостуг	free
хосталга	freedom
доңар	freeze
частота	frequency
бо-ла	frequent
бо-ла	frequently
чаа	fresh
пятница	friday
соодукчу	fridge
эш	friend
эп-найыралдыг	friendly
эштер	friends
найырал	friendship
корткан	frightened
коргунчуг	frightening
пага	frog
-дон (төнчү)	from
-дан	from
-ден	from
мурнуку	front
доңурган	frozen
чимис	fruit
чөгели төнген	frustrated
түлер чүүл	fuel
Фулфульде	Fulfulde
долдур	full
хөглүг	fun
хүлээлге	function
ханы	fundamental
хөөржүдери	funeral
хөглүг	funny
дүк	fur
килеңниг	furious
эт-сеп	furniture
дараазында	further
оон туржук	furthermore
келир үе	future
алыр	gain
оюн	game
үзүлген чер	gap
гараж	garage
бок	garbage
сесерлик	garden
чеснок	garlic
хаалга	gate
чыыр	gather
чыылда	gathering
калибр	gauge
бердинген	gave
механизм	gear
эри-кызы	gender
кол	general
анаада	generally
үндүрер	generate
салгал	generation
экииргек	generous
шылгараңгай угаанныг кижи	genius
жанр	genre
чымчак	gentle
ёзулуг	genuine
шимчээшкин	gesture
алыр	get
ап алыр	get
кеттинип алыр	get dressed
турар	get up
дурген экирер	get well soon
алыры	getting
сүнезин	ghost
хей чүве	ghosting
кайгамчык улуг	giant
белек	gift
имбирь	ginger
уруг	girl
кыс таныжы	girlfriend
бээр	give
дүжүп бээр	give up
бердинген	given
өөрүнчүг	glad
көрүш	glance
шил	glass
карак-шили	glasses
чырыш дээри	glimpse
бүдүн делегейниң	global
муңгаргай	gloomy
хол-хаптары	gloves
чырыыр	glow
чырыыр	glow up
хырба	glue
баар	go
чоруур (баар)	go
эгелээр	go ahead
чоруур	go away
удуп чыдар	go to bed
сорулга	goal
сорулгалар	goals
өшкү	goat
бурган	god
кадык бол	god bless you
чоруур	goes
чоруптурар	going
кылыр деп бодап турар	going to
алдын	gold
чораан	gone
деп турар	gonna
шара	goo
эки	good
дүштекиниң мендизи-биле	good afternoon
байырлыг	good bye
эки хүн	good day
кежээкиниң мендизи-биле	good evening
эки ажыл	good job
эки көстүр	good looking
олчалыг бол	good luck
эртенгиниң мендизи-биле	good morning
эртенгиниң мендизи-биле мээң ынакшылым	good morning my love
кежээкиниң мендизи-биле	good night
байырлыг	goodbye
менди-чаагай удуп хонуңар	goodnight
барааннар	goods
Гугл	Google
Гугл очулдурулга	Google Translate
кас	goose
чараш	gorgeous
онза-чараш	gorgeous
хоп-хочу	gossip
алган	got
билип алдым	got it
күрүне	government
тудар	grab
класс	grade
чоорту	gradually
доозукчу	graduate
үрезин	grain
грант	grant
бердинген	granted
виноград	grapes
салдыкпазы	grasp
оът	grass
өөрүп четтирген	grateful
өөрүп четтирери	gratitude
хөөр	grave
куу	gray
кончуг эки	great
онза	great
чазыйы	greed
чазый	greedy
ногаан	green
мендилээр	greet
мендилээри	greeting
амыр-менди	greetings
куу	grey
решетка	grid
муңгагдал	grief
хоюду тыртар	grind
сегирип алыр	grip
бакалея	grocery
душтук	groom
ниити	gross
чер	ground
бөлүк	group
өзер	grow
өзери	growth
дүндүгүр	grumpy
Гуарани	Guarani
гарантия	guarantee
таңныылдар	guard
угаа бодаар	guess
алыныр	guess
аалчы	guest
удуртулга	guidance
удуртулга	guide
буруулуг	guilty
аныяк кижи	guy
оолдар	guys
тренажёрка	gym
чаңчыл	habit
чурттаар чери	habitat
турган	had
мендилээр	hail
дүк	hair
чартык	half
зал	hall
хол	hand
күүседип шыдаптар	handle
чараш (эр кижи)	handsome
азар	hang
азар	hang out
болур	happen
болган	happened
аас-кежик	happiness
өөрүшкүлүг	happy
аас-кежик	happy
төрүттүнген хүнүң-биле	happy birthday
төррүтүнген хүнүң-биле	happy birthday to you
чаа чыл-биле	happy new year
кадыг	hard
арай деп	hardly
барык кажан-даа эвес	hardly ever
хора	harm
хоралыг	harmful
аяннажылга	harmony
кадыг-дошкун	harsh
дүжүт ажаалдазы	harvest
бар	has
көрбестээр	hate
бар	have
хүнүң эки болзун	have a good day
хүнүң эки болзун	have a nice day
чемненип ал	have breakfast
солун ойнаар	have fun
чемнендиңер бе	have you eaten
чемнендиң бе	have you eaten
бар	having
айыыл	hazard
туман	haze
ол (эр кижи)	he
ол кижи	he has
ол эр кижи	he is
баш	head
баш аарыы	headache
эмнээр	heal
эмнээр	healing
кадык	health
кадык	healthy
дыңнаар	hear
дыңнаан	heard
чүрек	heart
чылыдар	heat
шамбыла ораны	heaven
аар	heavy
халыын	hectic
бедии	height
салгакчы	heir
дээрбедээри	heist
туткан	held
эрлик ораны	hell
Экии	Hello
Амыр менди	Hello
экии эргимим	hello dear
экии кандыг тур силер	hello how are you
экии кандыг тур сен	hello how are you
экии кандыг тур силер	hello how are you doing
экии кандыг тур сен	hello how are you doing
шлем	helmet
дузалажыыр	help
дузалыг	helpful
ынчангаш	hence
ол (кыс кижи)	her
өөр мал	herd
мында	here
дамчыыр салгал	heritage
чайгылар	hesitate
Эй	Hey
Эть	Hey
Экии	Hi
экии кандыг тур силер	hi how are you
экии	Hi there
чажыт	hidden
чажырар	hide
иерархия	hierarchy
бедик	high
онзалап демдеглээр	highlight
агаарлаар	hike
чадаг туризм	hiking
каттырынчыг	hilarious
дөң	hill
ол эр кижиниң	him
айтып бээри	hint
дөңмек	hip
дөңмектер	hips
хөлезилээр	hire
хөлезилел	hiring
ол (эр кижи)	his
төөгү	history
согар	hit
хмммм	Hmm
хобби	hobby
тудар	hold
манаар	hold on
үт	hole
байырлал	holiday
ишти хос	hollow
бажың	home
онаалга	homework
шынчы	honest
ак сеткил-биле	honestly
сарыым	Honey
алдар	honor
капюшон	hood
илбек	hook
шураар	hop
идегел	hope
идегел-биле	hopefully
идегел чок	hopeless
горизонтальдыг	horizontal
мыйыс	horn
аажок коргунчуг	horrible
коргунчуг чүве	horror
аът	horse
эмнелге	hospital
хүндүлээчели	hospitality
ээ	host
өжээнниг	hostile
изиг	hot
аалчылар бажыы	hotel
шак	hour
шактар	hours
бажың	house
бажың ажыл-агыйы	household
канчалдыр	how
канчаан	how
а сен	how about you
а силер	how about you
Кандыг тур силер	how are you
кандыг чоруп тур силер	how are you doing
кайы-хире чоруп тур сен	how are you doing
бо хүн кандыг тур силер	how are you doing today
бо хүн кандыг тур сен	how are you doing today
бо хүн кандыг тур силер	how are you today
бо хүн кандыг тур сен	how are you today
кандыг тур сен	how do you do
канчаан	how is
каш	how many
каш	how much
кайы-хире болгаш	how often
харың кааш	how old are you
каш харлыг сен	how old are you
бо хүн кандыг болду	how was your day
кандыг хондуң	how was your night
кандыг хондуңар	how was your night
ынчаарга	however
чогум	however
ортузу	hub
ашакоой	hubby
куспактаар	hug
дыка улуг	huge
эң-не улуг	huge
кижи	human
биче сеткилдиг	humble
шык	humid
шыгы	humidity
чүс	hundred
аш	hungry
аңнаашкын	hunt
шуурган	hurricane
далажыр	hurry
далажыр	hurry up
аашкылыг	hurt
ашак	husband
иткилежиишкин	hustle
казанак бажың	hut
арыг-силиг байдал	hygiene
мен	I
Мен	I am
мен анаа мен	I am fine
мен шыдаар	I can
мен шыдавас	I can't
мен кылыр	I do
билбес мен	I do not know
мен билбейн тур мен	I do not understand
мен эвес	I don't
Мен билбес мен	I don't know
Мен билбейн тур мен	I don't understand
мен сени билбейн тур мен	I don't understand what you mean
мен силерни билбейн тур мен	I don't understand you
мен сени билбейн тур мен	I don't understand you
мен билбес мен	I don’t know
мен билбейн тур мен	I don’t understand
мен бодаарымга	i guess
меңээ турган	I had
менде бар	I have
мен	I have been
мен база ынчалдыр идегеп тур мен	I hope so
мен билир мен	I know
мен аянсынар	I like
мен сени сонуургап тур мен	I like you
мен ынак	I love
мен акымга ынак мен	I love my big brother
мен улуг угбамга ынак мен	I love my big sister
мен ачамга ынак мен	I love my father
мен эр дуңмамга ынак мен	I love my little brother
мен кыс дуңмамга ынак мен	I love my little sister
мен авамга ынак мен	I love my mother
мен сеңээ ынак мен	I love you
Мен сеңээ дыка ынак мен	I love you so much
мен база сеңээ ынак мен	I love you too
мен бодаарымга	I mean
мен силерни сактып тур мен	I miss you
мен сени сактып тур мен	I miss you
мен сени дыка сактып тур мен	I miss you so much
билдим	I see
мен бодарымга	I think
мен билип тур мен	I understand
мен күзеп	I want
мен сени көрүксеп тур мен	I want to see you
мен силерни күзеп тур мен	I want you
мен сени күзеп тур мен	I want you
мен турган	I was
мен (ынчаар	I will
мынчаар)	I will
мен	I would be
мен	I'm
анаа мен	I'm fine
мен анаа мен	I'm good
мен мында мен	I'm here
Мен буруулуг болдум	I'm sorry
дош	ice
мороженое	ice-cream
идея	idea
тергиин	ideal
дөмейлешкек	identical
тодарадыр	identify
дөмейлешкээ	identity
мугулай	idiot
анаа турар	idle
болза	if
ындыг болза	if
барымдаалавас	ignore
аарыр	ill
дүрүмге удур	illegal
аарыг	illness
Илокано	Ilocano
чурук	image
сагышка бодаар	imagine
доп-дораан	immediate
дораан	immediately
кайгамчык улуг	immense
салдар	impact
четтикпес	impatient
боттандырар	implement
импорт	import
чугула	important
онаар	impose
болдунмас	impossible
магадыр	impress
сактыышкын	impression
кайгамчык	impressive
экижидер	improve
экижидилге	improvement
немере кылдыр	in addition
херек кырында	In fact
мурнурда	in front of
кылдыр	in order to
таарышпас	inappropriate
сеткил	incentive
таварылга	incident
киирер	include
кады санавышаан	including
орулга	income
эпчогу	inconvenience
улгадыыр	increase
улгатырган	increased
бүзүрээр аргажок	incredible
шын-дыр	indeed
шынап-ла	indeed
хамаарышпас	independent
Индия	India
айтыр	indicate
үндезин	indigenous
хуу	individual
үлетпүр	industry
чайлаш чок	inevitable
чаш уруг	infant
аарыг-ажык	infection
кызыгаар чоогу	infinity
хуулуушкун	inflammation
инфляция	inflation
салдар	influence
медээлээр	inform
медегдел	information
киритингеннер	ingredients
салгап алыры	inheritance
баштайгы	initial
эгелекчи санал	initiative
балыглаткан	injured
кемдээри	injury
кем чок	innocent
чаартылга	innovation
хыналда	inquiry
угааны солуу	insane
курт-кымыскаяк	insect
айыыл чок эвес	insecure
сугар	insert
иштинде	inside
чүве эндевези	insight
негеп тургаш чедип алыр	insist
удувастаары	insomnia
сорук кириишкин	inspiration
сургаар	inspire
тургузары	install
болуушкун	instance
доп-дораан	instant
орнунга	instead
ооң орнуңга	instead
орнунга	instead of
айтыышкын	instructions
херексел	instrument
дорамчылал	insult
камгаладылга	insurance
бүдүн	intact
шынчызы	integrity
угаан	intellectual
интеллект	intelligence
угааныг	intelligent
сагыштыг болур	intend
санап калган	intended
күжениишкинниг	intense
бодал	intention
демниг хөделиир	interact
удур-дедир харылзаа	interaction
сонуургал	interest
сонуургаан	interested
солун	interesting
аразынче кирер	interfere
аразында	intermediate
иштики	internal
интернационал	international
интернатура	internship
утказын тайылбырлаар	interpret
очулдурукчу	interpreter
үзе кирер	interrupt
интервью	interview
хууда	intimate
иштинче	into
киирер	introduce
киирилде	introduction
интроверт	introvert
сагыжы эндевези	intuition
күш чок	invalid
чогаадып кылыр	invent
инвентарь	inventory
акша киирер	invest
шинчилээр	investigate
чалалга	invitation
чалаар	invite
счет-фактура	invoice
киириштирер	involve
киириштирген	involved
темир	iron
ортулук	island
аңгылаттынган	isolated
айтырыг	issue
айтырыглар	issues
бо	it
Бо болза	it is
Бо дээрде	it is
ол турган	it was
ол	it's
ол анаа чүве диинь	it's ok
анаа-анаа	It's okay
пункт	item
чүвелер	items
бо	its
мен	I’m
куртка	jacket
кара-бажың	jail
бир ай	January
шил банка	jar
чаак	jaw
адааргаачал	jealous
аамай кижи	jerk
ювелирлиг каасталга	jewelry
ажыл	job
маңнаар	jogging
катыжар	join
тудушкан кезек	joint
баштак	joke
журналист	journalist
аян-чорук	journey
хөглүг	joy
шииткекчи	judge
сок	juice
чеди ай	july
шураар	jump
алды ай	june
бок	junk
чугле	just
анаа кылывыт	just do it
чөптүү	justice
агартыр	justify
Калалисут	Kalaallisut
өткүт	keen
арттырар	keep
улаштырар	keep it up
дудуп турган	kept
бызаа	kettle
дүлгүүр	key
тегер	kick
бичии уруг	kid
баштактаныыр	kidding
бөөрек	kidney
уруглар	kids
өлүрер	kill
ак-сеткилдиг	kind
эки	kind
ышкаш	kinda
эвилең-биле	kindly
экизи	kindness
хаан	king
чыттаар	kiss
кухня	kitchen
ужар-саазын	kite
диис оглу	kitten
дискек	knee
билир турган	knew
бижек	knife
рыцарь	knight
билир	know
билиг	knowledge
билген	known
Конкани	Konkani
Крио	Krio
этикетка	label
күш-ажыл	labor
күш-ажыл	labour
чедишпес	lack
чада	ladder
аныяк уруг	lady
чаткан	laid
хөл	lake
хураган	lamb
өөрүшкү	lame
лампа	lamp
чер	land
пейзаж	landscape
дыл	language
круг	lap
дыка улуг	large
сөөлгү	last
сөөлгү, чогум эң сөөлгү эвес	last but not least
фамилия	last name
орай	late
чоокта чаа	lately
соонда	later
сөөлгү	latest
сөөлгү	latter
каткы	laugh
катырып турар	laughing
каткы	laughter
эгелээр	launch
хеп чуур чер	laundry
хоойлу	law
аяң	lawn
хоойлучу	lawyer
салыр	lay
каът	layer
таарыштыр салыр	layout
чалгаа	lazy
удуртукчулаар	lead
баштаар	lead
баштаңчы	leader
бүрү	leaf
төктүрү	leak
чөлениир	lean
халыыр	leap
өөрениир	learn
өөредилге	learning
хөлези	lease
эң эвээш	least
кеш	leather
чоруур	leave
каар	leave
бүрүлер	leaves
эдерткен	led
солагай	left
бут	leg
салгал	legacy
хоойлуга дүүшкек	legal
легенда	legend
хоойлу ёзугаар	legit
хостуг үе	leisure
чегдирер	lend
узуну	length
эвээш	less
кичээл	lesson
чөпшээрээр	let
чагаа	letter
ногаа бүрүзү	lettuce
деңнел	level
быра	leverage
харыысалгалыы	liability
библиотека	library
чылгаар	lick
мегелээр	lie
меге	lies
чурталга	life
көдүрер	lift
чырык	light
чаңнык	lightning
таарымчалыг	like
дөмей	like
харын-даа	likely
база	likewise
шыйыг	line
Лингала	Lingala
улаары	link
арзылаң	lion
суук чүүл	liquid
даңзы	list
дыңнаар	listen
дыгнаар	listening
сөс сүрүп	literally
чогаал	literature
бок	litter
бичии	little
чуртаар	live
баар	liver
чурттап турар	lives
дириг	living
зал	living room
селеске	lizard
долдурар	load
буханка	loaf
чээли	loan
тус черниң	local
турар чер	location
шоочалаар	lock
блокада	lockdown
чудук	log
лол	lol
чаңгыс	lonely
узун	long
үүр үе иштинде көрүшбээдивис	long time no see
көөр	look
кайгаар	look
цикл	loop
хостуг	loose
хаан	lord
чидирер	lose
чидириг	loss
читкен	lost
хөй кезии	lot
шимээнниг	loud
аалчылар өрээли	lounge
ынакшыл	love
сеңээ ынак	love you
кайгамчык чараш	lovely
чавыс	low
чавыс	lower
бүзүрелдиг	loyal
лоялдыы	loyalty
чедимче	luck
олчалыг	lucky
Луганда	Luganda
чүък	luggage
кезек	lump
дүштеки чем	lunch
өкпелер	lungs
аас-коя амыдырал	luxury
чыдар	lying
машина	machine
албыстыг	mad
мадам	madam
кылган	made
журнал	magazine
каас-чараш	magnificent
хеделдер	maid
кол	main
хандырар	maintain
хандырылга	maintenance
Майтхили	Maithili
чугула	major
кол	major
улуг нуруузу	majority
кылыр	make
бүдүрер	make
макияж	make up
эр	male
улуг садыг	mall
кижи	man
башкарар	manage
башкарары	management
менеджер	manager
албан	mandatory
манифест	manifest
манипуляция кылыр	manipulate
аажы-чаң	manner
инструкция	manual
хөй	many
хөй хөй катап бо хөглег хүнче эглир	many many happy returns of the day
үш ай	march
немелде өртек	margin
рынок	market
өглениири	marriage
өглүг болур	married
маска	mask
масса	mass
аар	massive
мастер	master
дүгжүрү	match
өңнүк	mate
материал	material
математика	math
херек	matter
ужур утка	matter
назы чедери	maturity
болур	may
чадавас	maybe
бооп болур	maybe
мен	me
Мен база	me too
чем	meal
уткалыг	mean
утка	meaning
илередир	means
деп билдинген	meant
ол үеде	meanwhile
хемчээл	measure
хемчээлдер	measures
эът	meat
эмнелгениң	medical
эм	medicine
медитация	meditation
ортун	medium
ужуражыр	meet
ужуражылга	meeting
Мейтейлон	Meiteilon
эриир	melt
сактыышкыннар	memories
чүве утпазы	memory
угаанга хамаарышкан	mental
демделгээр	mention
демдеглээн	mentioned
дагдыныкчы	mentor
садыгжы	merchant
кээргээр	mercy
чүгле	merely
хөглүг рождество-биле	merry christmas
корум-чурум чогу	mess
дыңнадыг	message
корум-чурум чок	messy
металл	metal
арга	method
күскелер	mice
ортуку	middle
дүн ортузу	midnight
чадавас	might
чымчак	mild
чада	milestone
шериг	military
сүт	milk
миллион	million
угаан	mind
боданыр аайы	mindset
мээң	mine
холуштурар	mingle
улуг эвес	minor
минуталар	minute
минуталар	minutes
хуулгаазын чүве	miracle
көрүнчүк	mirror
янзы-янзы	miscellaneous
өжү ханып амыраар	mischievous
хөөкүй	miserable
ядарал	misery
даңгына	miss
сактып тур мен сени	miss you
чиде берген	missing
хүлээлге	mission
туман	mist
чазыг	mistake
Мизо	Mizo
мобильник	mobile
дорамчылап кочулаар	mock
модель	model
өй-тап	moderate
амгы үениң	modern
биче сеткилдиг	modest
өл-шык	moist
өл-шыгы	moisture
дүдүк	mold
мең	mole
авай	mom
үе	moment
понедельник	monday
акша	money
монитор	monitor
сарбашкын	monkey
ай	month
хөөн	mood
дүндүгүр	moody
ай	moon
моральдыг	moral
амда	more
ам-даа	more
оон туржук	moreover
эртенгиниң	morning
ипотека	mortgage
эң-не	most
Улуг нуруузунда	mostly
ие	mother
шимчээшкин	motion
мотивация	motivation
даг	mountain
күске	mouse
аас	mouth
шимченир	move
шимчээшкин	movement
кино	movie
миссис	mrs
хөй	much
малгаш	mud
кружка	mug
шынган	muscle
музей	museum
мөөгү	mushroom
аялга	music
албан-биле	must
шимээн чок	mute
бот-боттарынга	mutual
мээң	my
мээң эргимим	My dear
мээң эжим	my friend
мээң хемем угорьлар долдур	My hovercraft is full of eels
мээң ынакшылым	my love
мээң адым	my name is
амырап-ла	my pleasure
мен бодум	myself
ужуру билдинмес	mysterious
чажыт	mystery
чогаадыг	myth
дыргак	nail
кенен	naive
ат	name
тоожулал	narrative
кызаа	narrow
чүдек	nasty
үндезин	national
национал	nationality
төрээн	native
чайгаар	natural
бойдус	nature
куску келири	nausea
чоокта	near
чанында	near
чанында	nearby
чижеглеп алырга	nearly
силиг	neat
эргежок чугула	necessary
моюн	neck
моюн шимелдези	necklace
херек	need
чок дээн	negative
херексевес	neglect
чугаалажыышкын кылыр	negotiate
кожазы	neighbor
кожа турары	neighborhood
база эвес	neither
чээн дуңма	nephew
чалгааранчыг кижи	nerd
шугул	nervous
уя	nest
четки	net
сеть	network
нейтралдыг	neutral
кажа-даа	never
кажандаа дүжүп бербе	never give up
хамаанчок	never mind
херек чок	nevermind
ынчалза-даа	nevertheless
чаа	new
медээлер	news
дараазында	next
чанында	next to
аянныг	nice
эки	nice
таныжып алганымда өөрүп тур мен	nice to meet you
таныжып алганывыс эки болду	nice to meet you
чээн кыс дуңма	niece
дүн	night
коргунчуг дүш	nightmare
тос	nine
он тос	nineteen
тозан	ninety
Чок	No
берге айтырыг чок	no problem
дуза чок	no way
кым-даа эвес	nobody
дааш	noise
шимээнниг	noisy
кым-даа эвес	none
дүъш	noon
чок	nope
даа	nor
анаа	normal
соңгу чүк	north
думчук	nose
эрткен үелерни сагындырар	nostalgic
эвес	not
чангыс-даа эвес	not at all
багай эвес	not bad
ам эвес	Not now
ам эвес	not yet
темдеглел	note
айыткан	noted
чүү даа чок	nothing
чүү-даа эвес	nothing
эскерер	notice
эскертинген	noticed
чүве ады	noun
чуве адылар	nouns
роман	novel
он бир ай	november
ам	now
Амгы шагда	nowadays
багай чорук	nuisance
тик	null
үнү читкен	numb
дугаар	number
эмчи сестразы	nurse
тоорук	nut
мускат тооруу	nutmeg
чемненилге	nutrition
даңгырак	oath
чагланыры	obesity
чагыртыр	obey
объект	object
кара	objective
хүлээлге	obligation
тода эвес	obscure
хайгаарал	observation
хайгаараар	observe
алыскан	obsessed
алысканы	obsession
эргижирээн	obsolete
моондак	obstacle
алыр	obtain
алдынган	obtained
илдең	obvious
боор	obviously
өйлеп-өйлеп	occasionally
ажыл-мергежил	occupation
ажыл	occupation
эжелеп алган	occupied
болур	occur
болган	occurred
болу берген	occurs
далай	ocean
он ай	october
анаа эвес	odd
ынаныштар	odds
ынчанмайн канчаар	of course
ынчанмайн	of course
өжүрген	off
халдакчы	offensive
санал	offer
офис	office
официалдыг	official
үргүлчү	often
бо-ла	often
Оо	Oh
О	Oh
шынап бе	oh really
үс	oil
чаа	ok
ок	ok
чаа эргимим	ok dear
чаа эргимим	ok honey
чаа мээң ынакшылым	ok my love
чаа	okay
окей	okay
чаа ынаам	okay baby
чаа эргимим	okay dear
чаа сарыым	okay honey
чаа мээң ынакшылым	okay my love
кырган	old
он	on
олче	on
бир катап	once
бир	one
чаңгыс дыл кажан-даа четпес	one language is never enough
согуна	onion
онлайн	online
чүгле	only
ажыдар	open
операция	operation
бодал	opinion
аргалар	opportunities
арга	opportunity
удур	opposite
омак-сергек	optimistic
вариант	option
немелде	optional
азы	or
апельсин	orange
чагыг	order
бөдүүн	ordinary
организация	organization
уг-шигни тывары	orientation
дөзү	origin
оригинал	original
Оромо	Oromo
өскүс	orphan
өске	other
оон башка	otherwise
ужурлуг	ought
бистиң	our
бистиң даалгавыс: кижи бүрүзүнге, турар черинден хамаарышпайн, делегейни билип алыр болгаш янзы-бүрү дылдарга бодун илередип шыдаар кылдыр аргазын бээр	Our mission: to enable everyone, everywhere to understand the world and express themselves across languages.
бистиң даалгавыс: бүдүн делегейниң медээлерин аалап-баштааш кижи бүрүзүнге чедер болгаш ажыктыг кылдыр кылыр	Our mission: to organize the world's information and make it universally accessible and useful.
даштыгаар	out
түңнел	outcome
херексел	outfit
өскээр баар	outgoing
үнери	outlet
бараан	outline
даштын	outside
шылгараңгай	outstanding
духовка	oven
ажыр	over
ында	over there
колдуунда	overall
эжып эрткен	overcome
хөй чүве бодап алыр	overthinking
аажок кайгаткан	overwhelmed
хөй кезии	overwhelming
эдилээр	owe
үгү	owl
бодунуң хууда	own
ээ	owner
шары	ox
темп	pace
хап	pack
хап	package
төлээн	paid
аарыг	pain
аарышкылыг	pain
будук	paint
чурук	painting
эжеш	pair
бүлүргей	pale
адыш	palm
паш	pan
пандемия	pandemic
девидээри	panic
чүгүр	pants
саазын	paper
дываажаң	paradise
параллельдиг	parallel
посылка	parcel
өршээл	pardon
ада-ие	parents
парк	park
дойду	parrot
петрушка	parsley
кезик	part
киржир	participate
тодаргай	particular
ылаңгыя	particularly
партнёр	partner
кежээки шайлалга	party
эртер	pass
эртер чер	passage
эрткен	passed
күштүг хандыкшыл	passion
изиг	passionate
идепкей чок	passive
чажыт сөс	password
эрткен үе	past
чамашкы	patch
орук	path
чөгенчиг	pathetic
шыдажыры	patience
аарыг-аржыктыг	patient
шаблон	pattern
доктаашкын	pause
оруктуң шывыы	pavement
төлээр	pay
төлээри	payment
тайбың	peace
тайбың	peaceful
персик	peach
сүүр	peak
груша	pear
чочак-тараа	peas
онзагай	peculiar
сидиктээр	pee
карттаар	peel
дең эргелиг	peer
чажыттар	peers
демир-үжүк	pen
карандаш	pencil
амда шиитпирде	pending
кижилер	people
перец	pepper
шиңгээдип алыр	perceive
шиңгээдип алыры	perception
тергиин	perfect
күүседир	perform
көргүзүг	performance
болуп болур	perhaps
шаг	period
доктаамал	permanent
чөпшээрел	permission
чөпшээрээр	permit
кызымаккайы	perseverance
дек үрелбес	persistent
кижи	person
хууда	personal
кижи	personality
перспектива	perspective
бүзүредир	persuade
орта эвес кижи	pervert
азырал амытан	pet
фаза	phase
феномен	phenomenon
философия	philosophy
телефон	phone
чурук	photo
фраза	phrase
физиктиг	physical
шилиир	pick
көдүрүп алыр	pick up
чурук	picture
кезек	piece
кезектер	pieces
хаван	pig
көге-буга	pigeon
оваа	pile
сыртык	pillow
ужудукчу	pilot
кызыткы	pin
ананас	pineapple
ягаан	pink
өңгар	pit
шымчыыр	pitch
кээргенчиг	pity
чер	place
черлер	places
чума	plague
бөдүүн	plain
план	plan
самолёт	plane
үнүш	plant
үнүш	plants
тавак	plate
платформа	platform
ойнаар	play
ойнап турар	playing
тааланчыг	pleasant
көрүңер	please
көрем	please
таарзынган	pleased
сеткил ханары	pleasure
долаа	pledge
дыка хөй	plenty
сюжет	plot
сугар үдү	plug
слива	plum
сантехник	plumber
хөйнүң саны	plural
подкаст	podcast
шүлүк	poem
чогаадыг	poetry
точка	point
хоран	poison
шагдаа	police
политика	policy
хүндүлээчел	polite
хирледиишкин	pollution
кылымал хөөлбек	pond
кылымал хөөлбек	pool
мыяктаар	poop
ядыы	poor
часкаашкын	pop
алдарлыг	popular
чон	population
хаван эъди	pork
каша	porridge
порт	port
туруш	position
телепиг	positive
ээзи болур	possess
ээлээр	possession
хамаарылга	possessive
болдунар	possible
таңныыл	post
соңгаарладыр	postpone
хартыышка	potato
күчү	potential
фунт	pound
ядыызы	poverty
күш	power
күштүг	powerful
практиктиг	practical
практика	practice
мактаар	praise
опчок чорук	prank
тейлээр	pray
өртектиг	precious
ылап шын	precise
ылап	precisely
баш бурунгаар айтыр	predict
дээре	prefer
дээре деп санаары	preference
иштиг	pregnant
хырынныг	pregnant
шын эвес көөрү	prejudice
баштайгы негелделер	premises
тергиин	premium
белеткениири	preparation
белеткээр	prepare
белеткээн	prepared
бадылаары	preposition
бар болуру	presence
амгы	present
презентация	presentation
кадагалаар	preserve
президент	president
базар	press
базыышкын	pressure
мегелетинер	pretend
чараш	pretty
чайладыр	prevent
мурнуку	previous
олча	prey
өртек	price
чоргаарал	pride
священник	priest
баштайгы	primary
үндезин	prime
даңгына	princess
баштыңчы	principal
предварительный	prior
эң чугула	priority
кара-бажың	prison
конфиденциал	privacy
хууда	private
ямбы	privilege
шаңнал	prize
болур	probably
проблема	problem
процедура	procedure
улаштырар	proceed
процесс	process
бүдүрер	produce
үре-түңнел	product
бүдүрүлге	production
профессия	profession
профессионал	professional
профиль	profile
орулга	profit
хандыр	profound
депшилге	progress
проект	project
көскү	prominent
аазаар	promise
деткиир	promote
бурунгаарладыры	promotion
далаштыг	prompt
хөөннүг	prone
ат орну	pronouns
адаары	pronunciation
барымдаа	proof
чогуур	proper
чогууру-биле	properly
шынарлар	properties
өнчү-хөреңги	property
саналдаары	proposal
перспектива	prospect
менди-чаагай	prosperity
хөгжеп турар	prosperous
камгалаар	protect
чоргаар	proud
шынзыдар	prove
хандырар	provide
бердинген	provided
можу	province
дериири	provision
аайы-биле четчир үези	puberty
ниитилел	public
дыртар	pull
тыква	pumpkin
ылап	punctual
өөреникчи	pupil
садып алыр	purchase
арыг	pure
ягаан-көк	purple
сорулга	purpose
сорулгазы	purpose
кошелек	purse
сүрер	pursue
истээшкин	pursuit
идер	push
салыр	put
квалификация	qualification
шынар	quality
сан	quantity
карантин	quarantine
алгыш-кырыш	quarrel
дөрттүң бири	quarter
Кечуа	Quechua
кадын	queen
элдеп чүве	queer
дилег	query
айтырыг	question
оочур	queue
дүрген	quick
дүрген	quickly
оожум	quiet
аяар	quiet
хөвеңнээр	quilt
үнер	quit
элээн	quite
айтырыглар	quiz
цитата	quotation
цитата	quote
цитаталар	quotes
койгун	rabbit
чарыш	race
килең	rage
чаъс	rain
көдүрер	raise
көдүрткен	raised
маңнап турган	ran
доктаамал эвес	random
хемчээл	range
дүрген	rapid
дүрген	rapidly
дыка ховар	rare
ховар	rarely
шивишкилер	rash
улуг күске	rat
өртээн доктаадыр	rate
орнунга	rather
хамааржылга	ratio
чөптүг	rational
чиг	raw
каттап	re
чедер	reach
четкен	reached
реакция	reaction
номчуур	read
номчулга	reading
белен	ready
боттуг	real
боттуг чүүл	reality
медереп билир	realize
билип калган	realized
шынап-ла	really
шынап	really
артыкы	rear
чылдагаан	reason
медерелдиг	reasonable
сактыышкын	recall
чек	receipt
алыр	receive
алган	received
чоокку	recent
сөөлгү үеде	recently
хүлээп алыр чер	reception
рецепт	recipe
сагыш амыр	reckless
танып алыры	recognition
Танып алыр	recognize
сүмелээр	recommend
сүмелээн	recommended
бижиири	record
катап тургустунар	recover
катап тургузуушкун	recovery
дорт-булуңчук	rectangle
кызыл	red
дедир садып алыр	redeem
арылдырышкын	redemption
эвээжедиир	reduce
артыкшылдыг	redundant
хамааржыр	refer
айтыг	reference
чайыннандырар	reflect
дүрзү	reflection
кызыгаарлаар	refrain
соодукчу	refrigerator
акша эгидери	refund
хандырбас	refuse
чөшпээревээн	refused
хүндүлээри	regard
дугайында	regarding
турза-даа	regardless
хүндүлел-биле	regards
регион	region
бүрүткээр	register
хараадаар	regret
хомудаар	regret
доктаамал	regular
үе саанда	regularly
чөпшээревес	reject
хамааржыр	relate
хамаарышкан	related
харылзаа	relationship
төрели	relative
төрелдер	relatives
дыштаныр	relax
салыр	release
үндүрүпкен	released
тааржыр	relevant
бүзүрелдиг	reliable
чиигээри	relief
хостаар	relieve
чиигээн	relieved
шажын	religion
шажынчы	religious
күзел чокка	reluctant
идегээр	rely
артар	remain
чыдып калган	remaining
кайгамчык	remarkable
чепсек-херексел	remedy
сактып чоруур	remember
сагындырар	remind
сагындырары	reminder
ырактан	remote
арылдадыр	remove
чедирер	render
хөлезилээр	rent
септелге	repair
каттаптаар	repeat
солуур	replace
харыылаар	reply
илеткел	report
таныштырар	represent
ат-алдар	reputation
дилэг	request
негелде	request
хереглээр	require
негелде	required
амы-тынын алыры	rescue
шинчилел	research
дөмейлежир	resemble
килең	resentment
бронялаар	reservation
резерв	reserve
чурттакчы	resident
халажыр	resign
шөйлүүчели	resilience
дыгый	resilient
удурланыр	resist
удурланыышкын	resistance
доктаал	resolution
шиитпирлээр	resolve
курорт	resort
курлавыр	resources
хүндүткел	respect
харылаар	respond
харылаар	response
харыысалгалыы	responsibility
харыысаалгалыг	responsible
дыштаныр	rest
чыдар чери чымчак болзун	rest in peace
ресторан	restaurant
катап тургузар	restore
кызыгаарлаар	restrict
түңнел	result
түңнелдер	results
дүңнээр	resume
үүрмектей садар	retail
тудар	retain
тудары	retention
халажкан	retired
аткаарлаар	retreat
эгидер	retrieve
эглир	return
ажыдар	reveal
илереткен	revealed
өжээн	revenge
орулга	revenue
дедир	reverse
допчулал	review
эде көөр	revise
эде көөрү	revision
революция	revolution
шаңнал	reward
ритм	rhythm
ээги	rib
рис	rice
бай	rich
хосталыр	rid
мунар	ride
утка чок	ridiculous
шын	right
оң	right
ам дораан	right now
кадыг	rigid
билзек	ring
былгаар	rinse
үймээн	riot
үзүлген чер	rip
бышкан	ripe
кодүрлур	rise
айыылдыг чүве кылыр	risk
адаанныг кижизи	rival
хем	river
орук	road
быжырар	roast
быжыг	robust
даш	rock
өзек	rod
роль	role
чуктаар	roll
крыша	roof
өрээл	room
дазыл	root
хендир	rope
ирик	rotten
бөзүргей	rough
хире	roughly
борбак	round
эртер орук	route
рутина	routine
чиг	row
дүрбүүр	rub
резина	rubber
бок	rubbish
ааспырак	rude
хевис	rug
бузар	ruin
дүрүм	rule
чагырыкчы	ruler
дүрүмнер	rules
маңнаар	run
маңнап турар	running
көдээниң	rural
далажыыр	rush
шоодай	sack
ыдыктыг	sacred
хайыралавас	sacrifice
айыыл чок	safe
эки ужар	safe flight
айыыл чогу	safety
шалфей	sage
чугалаан	said
эжиндирери	sail
хемелээри	sailing
дээш	sake
шалың	salary
садар	sale
лосось	salmon
дус	salt
дөмей	same
база ындыг	Same here
үлегер	sample
элезин	sand
санскрит	Sanskrit
сарказмныг	sarcastic
бардам	sassy
олурган	sat
күзел ханары	satisfaction
сеткили канган	satisfied
хандырар	satisfy
элээн эки	satisfying
суббота	Saturday
сосиска	sausage
каржы	savage
камгалаар	save
көрген	saw
чугаалаар	say
хемчээл	scale
бузурукчу чорук	scam
сорбу	scar
чедишпес	scarce
корткан	scared
ораашкын	scarf
коргунчуг	scary
тарадыр октаткан	scattered
сцена	scene
пейзаж	scenery
чыт	scent
хуваарь	schedule
школа	school
эртем	science
эртемдээн	scientist
эртемдээннер	scientists
хачы	scissors
бак сөглээр	scold
туран	scope
санаары	score
артыңчы	scrap
шыйбак	scratch
алгы	scream
экран	screen
ээриил	screw
сценарий	script
далай	sea
таңма	seal
дилээр	search
үе	season
олурар	seat
ийи дугаар	second
чажыт	secret
хуваажыры	section
айыыл чогун хандырар	secure
айыыл чогу	security
көөр	see
байырлыг	see you
дараазыңга чедир	see you later
ужурашкыже	see you soon
даарта ужуражыр бис	see you tomorrow
үрезин	seed
дилээр	seek
көстүр	seem
көстүр	seems
көрген	seen
тудуп алыр	seize
эжелеп алыры	seizure
ховар	seldom
шилиир	select
бот	self
бодун эмнээр	self healing
дужун хараары	selfish
садар	sell
чоргузар	send
менче бодуңнуң чурууң чоргузуп берем	send me your picture
Менче бодуңарның чурууңар чоргузуңар	send me your picture
үстүкү	senior
минниишкин	sense
чүвени шын бодаар	sensible
миниичел	sensitive
чоргускан	sent
домак	sentence
домактар	sentences
чарар	separate
Сепеди	Sepedi
тос ай	september
туруштуу	sequence
серия	series
шыңгыы	serious
шынап-ла	seriously
бараан болур	serve
хандырылга	service
сессия	session
тургузар	set
өрүлге	set
тургузар	set up
тургузары	setting
кээп чурттаар	settle
чеди	seven
он чеди	seventeen
чеден	seventy
чамдык	several
кадыг-дошкун	severe
даараар	sew
ш	sh
хөлеге	shade
хөлеге	shadow
силгиир	shake
ужурлуг	shall
сыык	shallow
бак ат	shame
хевир	shape
үлежир	share
чидиг	sharp
ол (кыс кижи)	she
ол кыс кижи	she has
ол кыс кижи	she is
сери	shed
хой	sheep
арын	sheet
полка	shelf
курт хавы	shell
чаштынар чер	shelter
щит	shield
шимчедири	shift
чырыыр	shine
далай хемези	ship
чедирери	shipping
хөйлең	shirt
идиктер	shoes
адар	shoot
садыг	shop
садыгланыыры	shopping
далай эрии	shore
чолдак	short
чедишпези	shortage
адар	shot
ужурлуг	should
эгин	shoulder
алгы	shout
көргүзер	show
меңээ көргүс	show me
душ	shower
креветка	shrimp
кызырлыр	shrink
хаар	shut
аскың хаап ал	shut up
ыядар	shy
төрел	sibling
төрелдер	siblings
аарыг	sick
тала	side
улуг тынар	sigh
көрүш	sight
экскурсия	sightseeing
ат салыр	sign
хол үжүү	signature
чугула	significant
шыпшың	silence
аяар	silent
торгу	silk
аамай	silly
мөнгүн	silver
дөмей	similar
бөдүүн сеткилдиг кижи	simp
бөдүүн	simple
чангыс угда	simultaneously
ол үеден бээр	since
чүректиң ханызындан	sincere
шын сеткили-биле	sincerely
ырылаар	sing
ыраажы	singer
чаңгыс	single
раковина	sink
Ноян	Sir
угбай	sister
кунчуу	sister in law
олурар	sit
сайт	site
байдал	situation
алды	six
он алды	sixteen
алдан	sixty
размер	size
арга-мергежил	skill
арга-мергежилдер	skills
кеш	skin
арган	skinny
этирер	skip
юбка	skirt
дээр	sky
кул	slave
удуур	sleep
удуп чыдар	sleeping
уйгузураан	sleepy
хеңчең	sleeve
кескинди	slice
таяр	slide
аяар	slightly
хөнү	slim
таяр	slip
бел	slope
ойнаар автоматтар	slot
оожум	slow
оожум	slowly
хензиг	small
угааныг	smart
чыттаар	smell
хүлүмзүрүг	smile
ыш	smoke
дески	smooth
чем	snack
улитка	snail
чылан	snake
таккыладыр	snap
хар	snow
ынчаарга	so
ынчангаш	so
дыка чаптанчыг	so cute
ам мөрүнде	so far
сиңирер	soak
саваң	soap
бодамчалыг	sober
футбол	soccer
ниитилел	social
ниитилел	society
уктар	socks
чымчак	soft
программа	software
хөрзүн	soil
саттынган	sold
саттынган	sold out
шериг кижи	soldier
чаңгыс	sole
кадыг	solid
шиитпир	solution
бодаар	solve
чамдык	some
бир-ле кижи	somebody
бир канчаан	somehow
бир-ле кижи	someone
бир-ле чүве	something
чамдыкта	sometimes
ыры	song
удавас	soon
дүрген	soon
нарын	sophisticated
Сорани	Sorani
язва	sore
боостаа аарыр	sore throat
муңгарал	sorrow
буруулуг болдум	Sorry
ылгаар	sort
дилээр	sought
сеткил	soul
төрел сеткилдиг кижи	soulmate
ыыт	sound
мүн	soup
ажыг	sour
үндезин	source
мурну чүк	south
делгем	space
спам	spam
аразы	span
испан	Spanish
курлавыр	spare
чугаалаар	speak
тускай	special
хевирлер	species
онзагай	specific
кайгамчыктыг	spectacular
чугаа	speech
ыыт чок	speechless
дүргени	speed
үжүктеп адаар	spell
чарар	spend
чарыпкан	spent
ажыг	spicy
тен	spike
дескинери	spin
шпинат	spinach
сеткил-сорук	spirit
дукурер	spit
кончуг эки	splendid
адырар	split
үрээр	spoil
үрегдетинген	spoiled
хенертен	spontaneous
омааш	spoon
былчак	spot
өөнүң-ишти	spouse
тарадыр	spread
час	spring
дөрбелчин	square
чыырар	squeeze
кальмар	squid
дииң	squirrel
ст	st
шанчар	stab
доктаамал	stable
оваа	stack
персонал	staff
уе-чада	stage
былчак	stain
чада	stairs
кезек	stake
кедеп чоруур	stalk
мал турар чер	stall
тамга	stamp
турар	stand
стандарт	standard
сылдыс	star
эгелээр	start
эгелепкен	started
аштап турар	starving
аймак	state
медеглел	statement
билдириишкин	statement
станция	station
тураскаал	statue
байдал	status
артып каар	stay
айыыл чок бол	stay safe
турум	steady
стейк	steak
оорлаар	steal
агым	steam
каң	steel
кадыр	steep
үндезин	stem
базым	step
чышпырар	stick
көжүй берген	stiff
амдыызында	still
амда	still
шагар	sting
харам	stingy
былгаар	stir
склад	stock
оорлапкан	stolen
хырын	stomach
даш	stone
турган	stood
сандай	stool
тур	stop
шыгжаар чер	storage
садыг	store
шуурган	storm
солун-чугаа	story
плита	stove
дорт	straight
бөдүүн	straightforward
хере дыртыышкын	strain
чиктиг	strange
танывазы кижи	stranger
стратегия	strategy
саваң	straw
честек-кат	strawberry
дилиндек	streak
агым	stream
кудумчу	street
күш	strength
күжениишкин	stress
дурту	stretch
шыңгыы	strict
согары	strike
одуруг	string
дилиндек	strip
оралдажыр	strive
кагары	stroke
күштүг	strong
магадаан	struck
тургузуг	structure
демисел	struggle
демисежип турар	struggling
дедир	stubborn
чыдыпкан	stuck
студент	student
өөренир	study
өөредилге	studying
чүүлдер	stuff
аажок кайганыр	stunning
аамай	stupid
аян	style
чүүл	subject
чүве	subject
чагырары	submission
чоргузар	submit
бүдүмел	substance
солуур	substitute
нарын	subtle
чедиишкинниг	succeed
чедиишкин	success
чедиишкинниг	successful
мындыг	such
чижээлээрге	such as
сорар	suck
хенертен	sudden
хенертен	suddenly
хикчектенир	suffer
түреп турар	suffering
четчир	sufficient
чигир	sugar
саналдаар	suggest
сүме	suggestion
костюм	suit
таарымчалыг	suitable
чемодан	suitcase
ниитизи	sum
эдертиг	summary
чай	summer
саммит	summit
хүн	sun
улуг-хүн	sunday
хүннүг	sunny
кызыл хүн	sunset
хүн чырыы	sunshine
супер	super
ажып турар	superior
супервайзер	supervisor
кежээки чем	supper
хандырары	supply
деткимче	support
деп бодаар	suppose
деп бодаан	supposed
ынчанмайн канчаар	sure
кыры	surface
чалгыг	surge
хирургия	surgery
фамилия	surname
хенертен болган чүүл	surprise
магадаан	surprised
дүжүп бээр	surrender
долгандыр турар	surrounding
хайгаарал	surveillance
айтырары	survey
дириг артар	survive
каразыыр	suspect
тургузупкан	suspended
караданчыг	suspicious
хевээр тудар	sustain
чурталга доктаамалы	sustainability
туруштуг	sustainable
үп-саап	swag
ажырар	swallow
орнун солур	swap
даңгырак	swear
деридер	sweat
свитер	sweater
ширбиир	sweep
чигирсиг	sweet
эки дүштерни күзедим	sweet dreams
чигирзиг чем чиксээр кижи	sweet tooth
ынак кижизи	sweetheart
хөөр	swell
бичии ыжа бергени	swelling
эштиир	swim
эштири	swimming
чайгаар	swing
солукчу	switch
дөгдегер	swollen
селеме	sword
демдек	symbol
сонуургал	sympathy
симптомнар	symptoms
система	system
ширээ	table
херекселдер	tackle
демдек	tag
кудурук	tail
алыр	take
ап алыр	take
апаар	take away
човаар	take care
ужуга бээр	take off
алдынган	taken
чугаалажыыр	talk
чугаакыр	talkative
бедик	tall
кран	tap
лента	tape
кара	target
сорулга	task
амдан	taste
амданныг	tasty
өөредип турган	taught
шай	tea
өөредир	teach
башкы	teacher
команда	team
ора дыртар	tear
чаштар	tears
хорададыр	tease
технология	technology
диштер	teeth
чугаалаар	tell
меңээ чугаала	tell me
аажы-чаң	temper
температура	temperature
хүрээ	temple
түр	temporary
он	ten
он муң	ten thousand
хөлезилекчи	tenant
адакталыр	tend
тенденция	tendency
чассыг	tender
күженген	tense
күжениишкин	tension
майгын	tent
баштайгы	tentative
хуусаа	term
дугуржулгалар	terms
дыка коргунчуг	terrible
коргунчуг	terrific
девискээр	territory
тест	test
текст	text
өөрүп четтирер	thank
Четтирдим	thank you
Чедирерин тодарадып турувуста манааныңар дээш четтирдивис	Thank you for your patience while we investigate shipment
улуу биле четтирдим	thank you so much
улуу-биле четтирдим	thank you very much
четтирдим	thanks
четтирдивис бистиң приложение ажыглааны дээш	Thanks for using our app
ол	that
ол дээрге	that is
ол эки-дир	that's good
оорлаары	theft
оларның	their
оларның	them
тема	theme
боттарын	themselves
оон	then
инчеш	then
теория	theory
түгдэ	there
ында	there
ында	there are
ынды	there is
ынчангаш	therefore
бо (хөйнүң саны)	these
олар	they
олар	they are
кылын	thick
оор	thief
дөңмек	thigh
чуга	thin
арган	thin
чүве	thing
эт-сеп	things
боданыыр	think
үш дугаар	third
сускаар	thirsty
он үш	thirteen
ужен	thirty
бо	this
бо дээрге	this is
хынамчалыг	thorough
хынамчалыг	thoroughly
олар	those
болза	though
бодал	thought
боданган шинчилиг	thoughtful
бодалдар	thoughts
муң	thousand
удазын	thread
кыжаның	threat
кыжаныр	threaten
үш	three
кызыгаар	threshold
сирилээр	thrilled
өзер	thrive
бооста	throat
өттүр	through
дургузунда	throughout
октаар	throw
улуг салаа	thumb
диңмирээшкин	thunder
четверг	Thursday
мынчангаш	thus
саргы	tick
далайның көдүрлүрү	tide
шевергин	tidy
галстук	tie
пар	tiger
тар	tight
Тигринья	Tigrinya
үе	time
тыртылчак	timid
арган	tiny
арга-сүме	tip
молдурук	tips
шина	tire
шылаан	tired
шылап калган	tired
пөс	tissue
эге	title
болур	to be
йөрээл	toast
бо хүн	today
өпея	toddler
бут салаалары	toes
кады	together
туалет	toilet
чугаалаттынган	told
негелде чогу	tolerance
шыдажып эртер	tolerate
помидор	tomato
эртен	tomorrow
даарта	tomorrow
дыл	tongue
бо кежээ	tonight
база	too
алган	took
инструмент	tool
инструментилер	tools
диш	tooth
үстүкү	top
тема	topic
орулган	torn
хилинчектээшкин	torture
ниити	total
дээр	touch
быжыг	tough
ээлчег	tour
өтүр	toward
этир	towards
аржыыл	towel
бичии хоорай	town
хоранныг	toxic
ис	trace
орук	track
садыглажыр	trade
чаңчыл	tradition
традициялыг	traditional
трафик	traffic
ис	trail
өөредиир	train
өөредилге	training
аажы-чаңының онза чүүлү	trait
аажы-чаңының онза чүүлдери	traits
өскээр тургузары	transfer
шилчиири	transition
очулдурар	translate
өттүр көстүр	transparent
транспорт	transport
дажыыры	transportation
какпа	trap
бок	trash
кемдээри	trauma
аян-чорук кылыр	travel
поднос	tray
эртине	treasure
эмнээр	treat
эмнээри	treatment
ыяш	tree
канчаар-даа аажок улуг	tremendous
угланыышкын	trend
шенелде	trial
кажар арга	trick
шенээн	tried
мажы	trigger
каасталга	trim
чорук	trip
берге байдал	trouble
чүгүр	trousers
чүък машиназы	truck
багажник	trunk
бузурел	trust
шын	truth
шенээр	try
Цонга	Tsonga
хоорза	tube
вторник	Tuesday
өөредилге	tuition
индюк	turkey
куркума	turmeric
корүнер	turn
языты-мелегей	turtle
репетитор	tutor
тыва	Tuvan
он ийи	twelve
чээрби	twenty
чээрби бир	twenty-one
Тви	Twi
ий катап	twice
дескиндирер	twist
ийи	two
хевир	type
ылаптыг	typical
чараш эвес	ugly
чүдек	ugly
сөөлгү	ultimate
хол майгыны	umbrella
шыдавас	unable
даайы	uncle
акызы	uncle
моорап калган	unconscious
адаанда	under
адаанда	underneath
чедир үнелеттинмээн	underrated
билип алыр	understand
билип алган	understood
хараадаан	unfortunately
униформа	uniform
эң ховар	unique
хемчээл	unit
университет	university
билдинмес	unknown
азы эвес	unless
чедир	until
бөдүүн эвес	unusual
өөрү	up
сен шили	up to you
чаартыыр	update
чаартыр	upgrade
кырында	upon
хөңнү баксыраан	upset
хоорайныың	urban
албадаар	urge
далаштыг	urgent
бисти	us
ажыглаар	use
ажыглаттынган	used
ажыктыг	useful
ажык чок	useless
анаа	usual
анаада	usually
ажык-дуза	utility
шөлээ	vacation
вакцина салыр	vaccination
вакцина	vaccine
вакум	vacuum
тода эвес	vague
күштүг	valid
узун чоога	valley
үнелиг	valuable
үне	value
янзы-бүрү	variety
янзы-бүрү	various
кончуг	vary
ваза	vase
алгыг-делгем	vast
ногаа	vegetable
ногаа аймаа	vegetables
транспорт	vehicle
садыгжы	vendor
хоран	venom
бүдүрүлге	venture
ужуражыр чер	venue
шынзыдар	verify
янзы-бүрү талалыг	versatile
версия	version
вертикальдыг	vertical
дыка	very
дыка эки	very good
сава	vessel
ажыр	via
сирлеңнээри	vibe
сирлеңнээри	vibes
бужар	vicious
өргүл	victim
видео	video
көстүрү	view
суур	village
өжээтен	villain
уксус	vinegar
эрги шагның	vintage
күчүлел	violence
күчүлел	violent
вирустуг	viral
бүдүн	virgin
виртуал	virtual
эки мөзү	virtue
көрүлге	vision
баар	visit
карак-биле кылыр	visual
эң чугула	vital
өңгүр	vivid
дылдың сөс байлаа	vocabulary
үн	voice
хос болуру	void
хемчээл	volume
эки турачы	volunteer
куску	vomit
суларгай	vulnerable
шалың	wage
ажыл төлевири	wages
бел	waist
манаар	wait
официант	waiter
манаашкын	waiting
оттур	wake
оттуп кээр	wake up
кылаштаар	walk
чорууру	walking
хана	wall
акша хавы	wallet
кезиир	wander
күзээр	wanna
күзээр	want
сураглап тыптырган	wanted
дайын	war
хеп шкавы	wardrobe
склад	warehouse
чылыг	warm
сагындырар	warn
сагындырары	warning
дайынчы	warrior
турган	was
чуурга	wash
артыңчы	waste
көөр	watch
суг	water
арбуз	watermelon
чалгыг	wave
орук	way
бис	we
бистер	we
бистер	we are
бистер шыдаар	we can
кошкаак	weak
шагзыргайы	weakness
байлак	wealth
шыырак	wealthy
кедер	wear
кедип турар	wearing
агаар бойдус	weather
куда	wedding
среда	Wednesday
чашпан	weed
неделя	week
дыштаныр хүн	weekend
кил	weight
элдептиг	weird
чиктиг	weird
кирип моорлаңар	welcome
чаагай байдал	welfare
Эки	Well
эки кылган	well done
чораан	went
болган	were
болганнар	were
барыын чүк	west
өл	wet
кит	whale
чүү	what
чүнү	what
харын сен	what about you
харын силер	what about you
Чүнү канчап тур сен	what are you doing
Чүнү кылып тур силер	what are you doing
Ам чүнү канчап тур силер	what are you doing now
Ам чүнү кылып тур сен	what are you doing now
сен ам чүнү кылып тур сен	what are you doing right now
силер ам чүнү кылып тур силер	what are you doing right now
чүнү канчап турар сен	what do you do
чүнү канчап турар силер	what do you do
чурталгада чүү-биле ажылдап ап тур сен	what do you do for a living
чурталгада чүү-биле ажылдап ап турсилер	what do you do for a living
чүү деп тур сен	what do you mean
чүү деп тур силер	what do you mean
чүнү күзеп тур сен	what do you want
чүү болган	what happened
бо дээрге	what is
ол дээрге	what is
бо чүү чувел	what is this
ажылың кандыг	what is your job
ажылыңар кандыг	what is your job
адыңар кым	what is your name
чүү-дүр	what's up
адың кым	what's your name
чүү-даа болза	whatever
кызыл-тас	wheat
дугуй	wheel
кажан	when
санында-ла	whenever
кайы	where
кайда	where
силер кайда силер	where are you
сен кайда сен	where are you
кайыын келген сен	where are you from
кайыын силер	where are you from
силер ам кайда силер	where are you now
сен ам кайда сен	where are you now
кайда чурттап тур сен	where do you live
кайда чурттап тур силер	where do you live
кайда	where is
ол үеде	whereas
ирги бе	whether
кайы	which
кайызы	which
үезинде	while
сымыраныр	whisper
сыгырар	whistle
ак	white
кым	who
силер кым силер	who are you
сен кым сен	who are you
кым деп	who is
бо кым чувел	who is this
бүдүн	whole
кым	whom
кымның	whose
чүге	why
чуге чок	why not
кара сагыштыг	wicked
калбак	wide
өөнүң ишти калган кижи	widow
калбаа	width
кадай	wife
черлик	wild
белен	willing
удар	win
хат	wind
соңга	window
хаттыг	windy
кызыл-арага	wine
кыш	winter
чодар	wipe
провод	wire
мерген угаан	wisdom
мерген угаанныг	wise
кузээр	wish
сеңээ эң эки чүвелерни күзеп тур мен	wish you all the best
азакадай	witch
биле	with
уштуур	withdraw
үндүрүлге	withdrawal
иштинде	within
чокта	without
көрген кижи	witness
чечен	witty
бөрү	wolf
херээжен	woman
херээжен кижи	women
удуп алган	won
чок боор	won't
кайгаар	wonder
кайгамчык чараш	wonderful
ыяш	wood
дүктен кылган пөс	wool
сөс	word
сөстер	words
ажыл	work
ажылдаар	work out
ажылдап турар	working
делегей	world
курт	worm
элээн	worn
сеткили дүүрээн	worried
дүвүрээр	worry
оон багай	worse
мөгеери	worship
эң багай	worst
үнези	worth
үне дүүшкен	worth it
хүндүлүг	worthy
балыг	wound
вау	Wow
ораар	wrap
ажынары	wrath
билек	wrist
бижиир	write
маңаа бижиир	Write here
бижиг	writing
бижээн	written
шын эвес	wrong
меге	wrong
бижип турган	wrote
бажың чаны	yard
эзээр	yawn
Ындыг	Yeah
чыл	year
чылдар	years
ажыткы	yeast
алгырар	yell
сарыг	yellow
Ийе	Yes
ийе ынаам	yes baby
ийе эргимим	yes dear
ийе сарыым	yes honey
Ийе мээң ынакшылым	yes my love
ийе ынчамайн	yes of course
дүүн	yesterday
амдыызында	yet
амда чок	yet
чайлап бээр	yield
сен	you
силер	you
силер дээрге	you are
сен дээрге	you are
силер чараш силер	you are beautiful
сен чараш сен	you are beautiful
силер дыка чараш силер	you are so beautiful
сен дыка чараш сен	you are so beautiful
моорлаңар	you are welcome
сен шыдаар сен	you can
силер шыдаар силер	you can
силер билир силер	You know
сен билир сен	You know
сен база	you too
силер база	you too
ажырбас	you're welcome
аныяк	young
сээң	your
силерниң	your
ажырбас	your welcome
бодуң	yourself
бодуңар	yourself
аныяктар	youth
ажырбас анаа	you’re welcome
чаагай	yummy
тик	zero
