ӧжыт	a little
уно	a lot
уно	a lot of
пумит	abandon
аналтэм	abandoned
одӥг кадь улыны	abide
быгатонлыкъёслы	ability
быгатӥсьлэн	able
котыр	about
ӝужыт	above
кунгож сьӧрын	abroad
ӧвӧлтэм луон	absence
ӧвӧлтэм луыны	absent
шабаш	absolutely
ньылыны	absorb
ёзэт	abstract
йырчукин пуктэм	absurd
ортчыт трос	abundance
узыр луись	abundant
злоупотреблять	abuse
акцент	accent
умоен лыдъяны	accept
доступ	access
шугадӟон	accident
интыяськон	accommodation
результатъёсыз	accomplish
ужез валась	accomplished
соя	according
банковской счет	account
точность	accuracy
ӝикыт	accurate
янгыше уськытоно мурт	accused
вӧсь	ache
висьыны	ache
вуыны	achieve
азинскон	achievement
шонерен лыдъяны	acknowledge
тодматскон	acquaintance
басьтыны	acquire
басьтэм	acquired
басьтон	acquisition
тӥ	across
актъёс	act
вашкала гуртын	action
активной	active
уж	activities
мыло-кыдо луон	activity
актёр	actor
зэмос	actual
уж вылын	actually
лэчыт	acute
дышыны	adapt
ватсаны	add
улсатэм	addicted
йылтон	addition
ватсам	additional
данакез	address
адекватной	adequate
бускель	adjacent
тодметним	adjective
корректировка	adjust
паймыны	admire
юнматыны	admit
вордыны басьтыны	adopt
очаровательной	adorable
авансовой	advance
азьланьтӥсько	advanced
ласянь	advantage
приключениос	adventure
сямкыл	adverb
реклама	advertisement
реклама	advertising
кенеш	advice
кенеш	advise
дурбасьтӥсь	advocate
эстетичный	aesthetic
уж	affair
быгатонлыкъёслы	affect
дышон	affection
аслыд лэзьыны	afford
доступной	affordable
кышкатэк	afraid
бӧрысь	after
нуназе бере	afternoon
бӧрысь	afterwards
эскерозы	again
пумит	against
арлыд	age
агентство	agency
агент	agent
агрессиё	aggressive
сэзь	agile
солэсь азьло	ago
согласной	agree
тупанкыл	agreement
гурт возёс	agriculture
азьпалан	ahead
юрттыны	aid
цель	aim
воздушной	air
аэропорт	airport
ортчон	aisle
куалектытыны	alarm
алкоголь	alcohol
сак кариськыны	alert
улэпкын	alive
быдэс	all
ваньмыз умой	all right
ваньзэ умойзэ	all the best
разрешить	allow
мозмытэм	allowed
öжыт гинэ	almost
оген	alone
валлин	along
ини	already
Яралоз	Alright
но	also
альтернативный	alternative
ке но	although
котьку	always
абдрамон	amazing
кык пӧртэм валан сётӥсь	ambiguous
амбициосын	ambition
амбициозный	ambitious
поправкаос лэсьтыны	amend
шораз	amid
пӧлын	among
ми пӧлын	among us
сумма	amount
тумошо	amusing
сэрттон-пертчон	analysis
вашкалаос	ancestors
якорь	anchor
вашкала	ancient
но	and
но тӥ	and you
кылчин	angel
лекъяськон	anger
сэрег	angle
лек	angry
лулос	animal
лодӥга	ankle
котырес лыдпус	anniversary
ялон	announcement
кужекъятыны	annoy
пӧсекъясь	annoyed
раздражающий	annoying
ежегодный	annual
нимтэм-тултэм	anonymous
мукет	another
ответ	answer
азьвылтыны	anticipate
тревожность	anxiety
бугырес	anxious
котькудӥныз	any
тросгес	anymore
кинлы кулэ	anyone
мар-ке	anything
котькыӵе учырын	anyway
котькыӵе учырын	anyways
быдэн	apart
юртъер	apartment
чӧлляськыны	apologize
адӟиськись	apparent
вылды	apparently
апелляция	appeal
лэся	appear
педпал	appearance
потыны	appeared
аппетит	appetite
улмо	apple
заявка	application
уже кутыны	apply
назначение	appointment
дунъяло	appreciate
тау карон	appreciation
подход	approach
ярась	appropriate
юнматон	approval
умоен лыдъяны	approve
юнматэмын	approved
вадескы	approximately
оштолэзь	april
эрказ	arbitrary
архитектор	architect
архитектура	architecture
архивировать	archive
тон	are you
тон ужаськод-а	are you busy
тон кышноё	are you married
бызиды яке тон	are you married or single
Тон весь отын-а?	Are you still there?
тон отын-а	are you there
территориослы	area
споръяськыны	argue
аргументъёс	argument
кылдыны	arise
ки	arm
армие	army
котыртӥ	around
куспын вераськыны	arrange
огазеяськон	arrangement
вуон	arrival
вуиз	arrive
вуиз	arrived
монъяськисесь	arrogant
ньӧл	arrow
искусство	art
статья	article
лэсьтэм	artificial
суредась	artist
кызьы	as
на	as long as
али	as long as
озьы ик	as well
озьы ик	as well as
ясень	ash
возьдаськись	ashamed
юало	ask
юам	asked
изьыны	asleep
тодослыко	aspect
Ассамской	Assamese
омырскон	assault
монтаж	assembly
ӝабырес	assertive
дунъяны	assess
дунъет	assessment
актив	asset
активъёс	assets
асэстыны	assign
назначение	assignment
юрттэт сётон	assist
юрттӥсь	assistant
ассоциировать	associate
думылэм	associated
огазеяськон	association
шуом	assume
эсэплан	assumption
ог	at
эсьмаса	at least
сиё	ate
атлет	athlete
юнматыны	attach
юнматӥзы	attached
ватсэт	attachment
урдскыны	attack
оскалтон	attempt
султэм	attend
пумиськылон	attendance
саклык	attention
кусып	attitude
кыскыны	attract
аттракцион	attraction
притягательный	attractive
атрибут	attribute
аудиториослы	audience
гудырикошкон	august
кенак	aunt
апай	aunty
зэмос	authentic
авторлэн	author
кивалтӥсь ёзэт	authority
сӥзьыл	autumn
интыяз луись	available
ын среднее	average
палэнтыны	avoid
сайканы	awake
данъет	award
ивортылӥм	aware
яратэм	awareness
палэнэ	away
потрясающий	awesome
шимес	awful
неловкость	awkward
Аймара	Aymara
нылпи	baby
бакалавр	bachelor
берлань	back
инъет	background
урод	bad
мешокъёс	bag
пӧет	bait
пыжыны	bake
нянь-булки вузан	bakery
сиён сода	baking soda
балансаз	balance
туп	ball
Бамбара	Bambara
банан	banana
группа	band
пуштон	bang
банк	bank
бар	bar
мырдэм	barely
пайдаё сделкаос	bargain
утон	bark
йыдылэсь	barley
могӟет	barrier
кылдытон	base
кылдэмын	based
мурӝол	basement
инъетъёзо	basic
самой кулэез	basically
базилик	basil
кӧтвеськантэм мурт	bastard
вуз партия	batch
ванна	bath
ванная	bathroom
батарейкаен	battery
жугиськон	battle
вукож	bay
луыны	be
сак кариськы	be careful
пляжной	beach
балка	beam
фасоль	beans
гондыр	bear
туш	beard
подшипниковой	bearing
пӧйшур	beast
зӥръяса	beat
чебер	beautiful
чеберлык	beauty
луиз	became
малы ке шуоно	because
луыны	become
кровать	bed
кӧлон висъет	bedroom
муш	bee
скал сӥль	beef
вал	been
сур	beer
озь	before
кутскиз	began
кутскыны	begin
кутскиз	beginning
ним	behalf
астэ умой возьыны	behave
выросъёсыз	behavior
вырос	behaviour
бӧрсязы	behind
вань дыръя	being
оскон	belief
оскыны	believe
кӧт	belly
киын луыны	belong
яратоно	beloved
ма лапег	below
кускерттон	belt
выж	bench
куасалляськыны	bend
улэ	beneath
пайда	benefit
вылӥ луонъёс	benefits
артэ	beside
со сяна	besides
умойгес	best
ваньзэ умойзэ	best of luck
самой ӟеч сӥзёнъёс	best regards
умойгес	better
вискын	between
юон	beverage
вылтӥ	beyond
Бходжпури	Bhojpuri
предвзятость	bias
азьвыл ик малпам	biased
велосипед	bicycle
дун пуктон	bid
бадӟым дыр	big
байк	bike
счет	bill
думылыны	bind
тылобурдо	bird
вордӥськем нунал	birthday
ӧжытак	bit
куртче	bite
курытэз	bitter
сьӧд	black
лезвие	blade
янгышъёссэ	blame
тырмытымтэ	blank
шобретъёс	blanket
пуштон	blast
тöдьыян	bleach
сурет	blend
данъясько	bless
данъямын	blessed
синтэм	blind
майбыр улон	bliss
блок	block
вир	blood
сяськаяны	bloom
шуккет	blow
лыз	blue
ныж	blunt
пулэсь	board
пыж	boat
мугорыз	body
пӧсьтыны	boil
кышкасьтэм	bold
вань	bold
герӟет	bond
лы	bone
заказ	book
будэтон	boost
усилительёс	booster
башмак	boot
ботинка	boots
кунгож	border
акыльтыны	bore
мӧзмыт	bored
мӧзмыт	boring
вордскем	born
пунэманы	borrow
босс	boss
кыкназы	both
исаллязы	bother
бутылка	bottle
пыдэссэ	bottom
басьтӥз	bought
тэтчаны	bounce
герӟаськем	bound
кунгож	boundaries
йыбыртты	bow
чаша	bowl
коробка	box
пи	boy
пияш	boy
пияш	boyfriend
поскес	bracelet
йырвимлэн	brain
вай	branch
бренд	brand
кышкасьтэм	brave
тӥян	breach
нянь	bread
перерыв	break
ӵук	breakfast
гадь	breast
шокан	breath
шоканы	breathe
йыло	breed
кирпичной	brick
кузпалъёс	bride
выж	bridge
вакчи	brief
яркыт	bright
кисьтаськись	brilliant
вуттыны	bring
агай	bro
паськыт	broad
возьматыны	broadcast
пилем	broke
чигты	broken
ӵужон	broom
нюня	brother
вармайпи	brother in law
вайиз	brought
курень	brown
щётка	brush
кобы	bucket
ведра	bucket
уром	buddy
бюджет	budget
янгыш	bug
кильымъёс	build
юри	building
пуктыны	built
валтӥсь масса	bulk
ош	bull
керетӥсь	bully
мыжгем	bump
пуры	bunch
керттэт	bundle
секыт ныпъетэз	burden
ватэм	buried
сутыны	burn
пуштыны	burst
ватыны	bury
автобус	bus
куак	bush
ужбергатон	business
бюст	bust
ваньмисьтэм	busy
нош	but
нӧкы	butter
бубыли	butterfly
кнопка	button
октыны	buy
ог	by
кылпумысь	by the way
пока	bye
кубиста	cabbage
министръёслэн кабинетсы	cabinet
клетка	cage
торт	cake
кунян	calf
жингыртӥз	call
чорты монэ	call me
нимаське	called
чалмыт	calm
лыкто	came
кампания	campaign
корт банка	can
быгатыны	can
кужымезъя öвöл	can't
берланьтыны	Cancel
кисло-кусло	cancer
быгатӥсьлэн	capable
быгатонлыкъёслы	capacity
бадӟым	capital
гожтӥськем	caption
киултыны	capture
машина	car
карьер	career
вал каллен	careful
пыр-поч	carefully
чакласькисьтэм	careless
сюлмаськись	caring
ӵуписькись	carpenter
выжлёгет	carpet
ӵужкушман	carrot
нуллыны	carry
азьланьтыны	carry on
сётэм кылэз быдэстыны	carry out
кейс	case
наличной	cash
кӧчырет	cast
замок	castle
случайной	casual
коӵыш	cat
кутыны	catch
категория	category
гурт пудоживот	cattle
кутэм	caught
мугез	cause
эскериськон	caution
чакласькись	cautious
мугыркын улӥсь	cave
дугдытыны	cease
вӧлдэтын	ceiling
праздник	celebrate
ёзэт	cell
центр	center
даур	century
тысё юос	cereal
церемония	ceremony
шонерак	certain
безусловно	certainly
сертификат	certificate
жильы	chain
пукон	chair
вызовъёсы	challenge
луонлык	chance
вошъям	change
радтэм	chaos
сямзылы	character
характеристика	characteristics
зарядить	charge
ӟечен юрттон	charity
синмаськытӥсь кужым	charming
диаграмма	chart
уйиськон	chase
вераськыны	chat
вераськон	chat
дунтэм	cheap
йыртэмась	cheat
эрекчаськон	cheating
эскерон	check
бам	cheek
мылкыд ӝутыны	cheer
шулдыр	cheerful
ӟечкылазы	cheers
сыр	cheese
химия	chemistry
нуныяны	cherish
шахмат	chess
гадь клетка	chest
сыскыны	chew
курег	chicken
азьветлӥсь	chief
нылпиоc	child
пинал дыр	childhood
нылпиос	children
кезьыт	chill
гумыос	chimneys
ангес	chin
шоколад	chocolate
быръён	choice
быръе	choose
кораны	chop
ӵыжы	chores
быгылес	chubby
черк	church
корица	cinnamon
берганы	circle
югдурез	circumstances
кунмурт	citizen
город	city
верало	claim
валамон карыны	clarify
класс	class
гордсюй	clay
чылкыт	clean
шараяськиз	clear
ужась	clerk
визьмо	clever
клиент	client
изъяр	cliff
климат	climate
тубон	climb
ӝабырес	clingy
час	clock
ворсано	close
чулан	closet
пустол	cloth
дӥськут	clothes
ӝожомытыны	cloud
пильмо	cloudy
маскаръяськись	clown
лушкем веран	clue
ын лук-лак	clumsy
люкаськем	cluster
тренер	coach
эгыр	coal
ярдур	coast
сӥен-сӥен	coat
кофе	coffee
когнитивной	cognitive
тупан	coincidence
кезьыт	cold
бинялтэмын	collapse
чырты е	collar
ужъюлтошъёсыз	colleague
ужъюлтошъёс	colleagues
люкам	collect
кенеш	collection
колледжъёсын	college
буёл	color
буёлтэм вож малпанъёс вожпотыса изизы	colorless green ideas slept furiously
буёл	colour
столбик	column
корманы	comb
герӟан	combination
сочетать карыны	combine
вуылыны	come
лык татчы	come here
азьлань!	come on
ойдо	come on
комфорт	comfort
вӧл	comfortable
вуон	coming
ӝоген луоз	coming soon
тӧрояськыны	command
комментарий	comment
коммерческой	commercial
комиссия	commission
ортчиз	commit
обязательствоос	commitment
сётэм	committed
вуз	commodity
вöлмем	common
вераськыны	communicate
сюрес	communication
сообщество	community
ветлыны	commute
юлтош	companion
юнда	company
ӵошатыса	compare
ӵошатон	comparison
жалян	compassion
жалясь	compassionate
огазеясь	compatible
ӵошатскыны	compete
умой тодӥсь	competent
вожвылъяськонлэн	competition
вожвылъяськыны быгатӥсь	competitive
урттылӥськиз	complain
чагиськон	complaint
ватсаны	complement
йылтон	complement
тырмоз	complete
быдэсак	completely
огъет	complex
сётскыны дась луон	compliance
сложный	complicated
комплимент	compliment
гожтӥськыны	comply
пушсузьет	composition
состав	compound
валан	comprehension
котькуд ласянь	comprehensive
компромисс	compromise
курегпузэз питыръяса	compulsory
компьютер	computer
концентрат	concentrate
концепциез	concept
шугъяськонэ	concern
сюлэмшугъяськись	concerned
концерт	concert
заключение	conclusion
членъёсыз	concrete
инэт	condition
луонлыкъёс	conditions
вал нуисько	conduct
конференция	conference
зэмзэ вераны	confess
ас кужымедлы оскон	confidence
оскизы	confident
возьматон	confirm
конфликтысь	conflict
сурам	confused
абдран	confusion
ӟечкыласько	congrats
ӟечкылан	congratulation
ӟечкыланъёс	congratulations
огазеян	conjunction
герӟаны	connect
вормыны	conquer
сознательной	conscious
визь	consciousness
вераськыны	consent
бервылъёсыз	consequences
утялтон	conservation
консервативной	conservative
астэ лыдъяны	consider
малпам	considered
пӧрмыны	consist
радлык	consistency
согласованный	consistent
ялан	constant
весь	constantly
запор	constipation
лэсьтӥськон	construction
уже кутыны	consume
потребление	consumption
кусып возён	contact
кутскись	contagious
будэмзэ возьыны	contain
возе	contains
туала адями	contemporary
адӟемпотостэм карон	contempt
содержимое	content
вожвылъяськон	contest
котыркуэт	context
ярмувыр	continent
кыстӥськыны	continue
контракт	contract
контраст	contrast
юрттэткузьым карыны	contribute
тырон	contribution
чакланы	control
споръяськон	controversial
каньыллык	convenience
вӧл	convenient
вераськон	conversation
выльдоно	convert
пӧрмиз	convert
передача	convey
оскытӥз	convince
оскытэм	convinced
повар	cook
пӧзьтон	cooking
ыркыт	cool
ӵош ужан	cooperation
быдэстыны быгатыны	cope
ыргон	copper
основной	core
кукуруза	corn
сэрег	corner
шонер	correct
стоимость	cost
костюм	costume
коттедж	cottage
хлопок	cotton
диван	couch
кызон	cough
быгатысал	could
дэмлам	council
лыдъяны	count
прилавок	counter
шаерамы	country
гурт	countryside
мар кузэн	couple
мужество	courage
курслэн	course
суд	court
гажан	courtesy
двоюродной	cousin
обложка	cover
скал	cow
кышкась	coward
лякыт	cozy
краб	crab
пилиськем	crack
киуж-ӧнерлык	craft
ӧвӧлтэм	crap
куашкан	crash
юэм потон	craving
ныж ветлыны	crawl
шузимем	crazy
кылдӥз	create
кылдытон	creative
кредитъёсыз	credit
куашкан	creep
нюжтӥськись	creepy
экипажлэн ёзчиез	crew
йыруж	crime
куалектыны	cringe
ёрмон	crisis
кризис	crisis
дунъян мертэтъёс	criteria
критической	critical
дунъетбур	criticism
удалтэм	crop
киземъёс	crops
гопо	cross
куака	crow
калык	crowd
трос калыко	crowded
корона	crown
валтӥсь	crucial
туж секыт	cruel
круиз	cruise
донгаськон	crush
бöрдыны	cry
кияр	cucumber
ӟыгыръяськыны	cuddle
культура	culture
кескич	cunning
чашка	cup
шкаф	cupboard
кортнаны	curb
эмъюм	cure
комендантской час	curfew
котьмае тодыны турттон	curiosity
тунсыко	curious
бабылес	curly
валюта	currency
текущей	current
туала	currently
вегнан	curse
катанчи	curtain
миндэр	cushion
нестандартный	custom
клиент	customer
вузэскерет	customs
вандэм	cut
муспотон	cute
цикл	cycle
велоспорт	cycling
атай	dad
атае	daddy
быдэ	daily
йӧллэсь	dairy
дамба	dam
сöрон	damage
каргам	damn
нюр	damp
эктон	dance
кышкытлык	danger
кышкыт	dangerous
пеймыт	dark
мусо	darling
кузьгож	dash
сётэтъёс	data
дата	date
нылъёс	daughter
нунал	day
кулэм	dead
берпум дыр	deadline
пельтэм	deaf
сделкаос	deal
дуно	dear
Ӟечкыласько ваньдэсты	Dear All
Гажано клиент	Dear Customer
Дуно анай-атайёс	Dear Parents
Гажано	Dear Sir
Гажано дышетскисьёс	Dear students
Гажано команда	Dear Team
кулон	death
ченгешыны	debate
дебет	debit
силё	debris
долг	debt
дас ар	decade
куашкан	decay
кулэм	deceased
пӧяны	deceive
толсур	december
гольтрес	decent
лэсьтыны	decide
решение	decided
решение	decision
палубной	deck
кулэсмыны	decline
ичиёмыны	decrease
висъяны	dedicated
вань сэлэмез сётон	dedication
поступок	deed
мур	deep
пужей	deer
ватон	default
вормон	defeat
утьыны	defend
определение	define
определённо	definitely
определение	definition
степеньын	degree
ӝегатсконъёс	delay
кылем	delayed
ӵушылон	delete
кенешыны	deliberate
ненег	delicate
ческыт	delicious
шумпотон	delight
синмаськытэм	delighted
вайыны	deliver
ваем	delivered
доставка	delivery
юан	demand
рос-прос эскерись	demanding
демократи	democracy
шайтан	demon
адӟытэ	demonstrate
танӥськем	denied
юнлык	density
пинь эмъясь	dentist
отказ	deny
люкет	department
отъезд	departure
киулскыны	depend
сэрттыны	deploy
депозитъёс	deposit
зӥбем кадь	depressed
ляб	depressed
депрессия	depression
мурдала	depth
валэктыны	describe
описание	description
пустыня	desert
элькун	deserve
дизайн	design
пус	designation
ылкыд	desire
потыны	desire
ӝӧк	desk
пумтэмлык	despair
бертэме	desperate
учкытэк	despite
десерт	dessert
пуктэм инты	destination
адӟон	destiny
куашкатыны	destroy
куашкам	destruction
пыр-поч возьматыны	detail
чыры-пырыос	details
шедьтыны	detect
юн	determination
тодыны	determine
дӥсьтӥсь	determined
куашкатэм	devastated
азинто	develop
азинскись	developed
азинскон	development
устройствоос	device
шайтан	devil
оскымон	devoted
Дивехи	Dhivehi
сакырвисён	diabetes
кӧтвиян	diarrhea
дневник	diary
кыллюкам	dictionary
кариз	did
кулыны	die
кулӥз	died
рацион	diet
вис	difference
мукет	different
секыт	difficult
копалтыны	dig
дан	dignity
тыршись	diligent
сиськон	dinner
гудыны	dip
шонер	direct
мынон сюрес	direction
режиссёр	director
дэри	dirt
пож	dirty
кысыны	disable
сӧсыр	disabled
ышыны	disappear
разочарован	disappointed
катастрофически	disaster
сэрпалтыны	discard
разрядить карем	discharge
дисциплинаез	discipline
скидка	discount
шедьтыны	discover
ултӥян	discrimination
эскерыны	discuss
эскерем	discussion
висён	disease
висёнъёс	diseases
ватон	disguise
юрӟым	disgusting
тусьты	dish
сиёнъёс	dishes
инты ужлэсь мозмытыны	dismiss
кулэстыны	dispatch
дисплей	display
косон	disposal
ченгешонъёс	dispute
дистанциез	distance
сайтэ	distinct
висъяны	distinguish
курадӟон	distress
люкон	distribution
ёрос	district
сюлмаськытыны	disturb
гу	ditch
зымылыны	dive
пӧртэм	diverse
турлы	diversity
люкыны	divide
абдрамон чебер	divine
люкиськон	divorce
люкиськымтэ	divorce
берга	dizzy
карыны	do
тон	do you
тон монэ яратӥськод-а	do you love me
доктор	doctor
ужкагаз	document
со карэ	does
уг	doesn't
пуны	dog
Догри	Dogri
лэсьтэмын	doing
мунё	doll
домен	domain
асьме кунлэн	domestic
валтӥсь	dominant
уг	don't
Уг бугыръяськиськы	Don't worry
коньдонэн юрттӥськыны	donate
карем	done
ишак	donkey
усыкмет	dope
кыктос	double
полэстӥськыса	double
шекланыса	doubt
ыльнянь	dough
улӥе	down
тырмытыны	download
уськытъяз	draft
гыж кыскыса нуыны	drag
начармонзы	drain
драма	drama
суредаллям	draw
ничья	draw
ящик	drawer
гожсуред	drawing
кышкан	dread
малпанъёс	dream
дэрем	dress
пасялляны	drill
юон	drink
приводэн	drive
усён	drop
уськытыны	dropped
кӧс куазь	drought
удмуртарня	drunk
кӧс	dry
ӵӧж	duck
чувак	dude
нуиськизы	due
бӧрсе	due to
мöзмыт	dull
кылтэм-ымтэм	dumb
куяськон	dump
мынон дыр	duration
дыр	during
тузон	dust
долг	duty
улыны	dwell
кулон	dying
котькудӥз	each
ог-огдэс	each other
чидасьтэм	eager
кырныж	eagle
пель	ear
вазьгес	earlier
вазь	early
медъям	earn
пельёс	ears
музъем	earth
музъемзуркан	earthquake
каньыллык	ease
лякыт	easily
восточной	east
капчи	easy
сиыны	eat
сиськон	eating
экономической	economic
экономика	economy
преимущество	edge
тупатъяны	edit
дышетон	education
эффект	effect
эффективной	effective
ужаны быгатон	efficiency
эффективный	efficient
тыршемез	effort
пуз	egg
баклажан	eggplant
астэ яратонлык	ego
тямыс	eight
дас тямыс	eighteen
тямыстон	eighty
люба	either
разработка	elaborate
пыдес	elbow
бадӟымез	elder
арлыдо	elderly
чильтро	elegant
стихия	element
слон	elephant
дас одӥг	eleven
приемлемый	eligible
палэнтыны	eliminate
мукет-а	else
кепырась	embarrassed
сумбырес	embarrassing
ӟыгырскон	embrace
уродъяськыны	emerge
экстренной	emergency
эмоциональной	emotional
сюлмаськыны	empathy
акцент	emphasis
акцент лэсьтыны	emphasize
ужасьёс	employee
ужасьёс	employees
уж сётӥсь	employer
уже кутскон	employment
тырттэм	empty
луонлык сётыны	enable
геред	encounter
уломе	encourage
пум	end
бырись	endangered
кужым	endeavor
чидан	endurance
чиданы	endure
вормыны	endure
тушмон	enemy
кужым	energy
кутскон	engage
помолвлен	engaged
вовлеченность	engagement
вырӟытӥсь	engine
инженер	engineer
Англи	English
умоятэмын	enhance
куаныны	enjoy
туж бадӟым	enormous
тырмыт	enough
ванё карыны	ensure
пырыны	enter
развлекательный	entertainment
энтузиазм	enthusiasm
тунсыкъяськись	enthusiastic
быдэс	entire
нимам	entitled
дэменлык	entity
пырон	entrance
ужбергатӥсьёсты	entrepreneur
конверт	envelope
окружение	environment
вожъяськыса	envy
эпической	epic
висёнкыль	epidemic
огкадь	equal
оборудование	equipment
со шонер	equity
огвыллем валатон	equivalent
ӵушет	eraser
Янгыш	error
бырыны	escape
тужгес ик	especially
улонверос	essay
пуштрос	essence
шӧдскымон	essential
пуктон	establish
тупатскоз	established
сословие	estate
дунъян	estimate
лыдӟем	estimated
но солы укшась	etc
ноку быронтэм	eternal
этика	ethics
лыдъяны	evaluate
дунъет	evaluation
но	even
озьы ке но	even though
ӝыт	evening
ужрад	event
конкурсэ	eventually
куке ке	ever
котькудӥз	every
ваньзы	everybody
ваньмыз	everyone
ваньмыз	everything
янгыш	evidence
лек	evil
эволюция	evolution
азинтыны	evolve
Овца	Ewe
азьвыл	ex
точной	exact
мар зэмзэ пыӵато	exactly
экзамен	exam
эскерыны	examine
пример	example
мултэс быдэстыны	exceed
усто	excellent
сяна	except
йӧспӧртэм луон	exception
кулэтэм	excess
мултэс трос	excessive
воштос	exchange
тунсыкъяськись	excited
лӧптон	excitement
басьтылӥзы	exciting
огполэс	exclusive
эксклюзивной	exclusive
кариськыны	excuse
мыным вождэ эн вай	excuse me
косэмез быдэстон	execute
быдэсмытон	execution
исполнительной	executive
упражнениос	exercise
ӵын потэм	exhaust
начар	exhausted
экспонат	exhibit
адӟытон	exhibition
луыны	exist
улон	existence
улӥсь	existing
потон	exit
паськытатыны	expand
витьыны	expect
возьмалэ	expected
быдтонъёс	expenses
дуно	expensive
опыт	experience
экспееримент	experiment
тодӥсь	expert
карем	expired
валэктыны	explain
валэктон	explanation
эксплуатировать карыны	exploit
эскерыны	explore
кунгож сьӧры поттон	export
шараян	expose
гольык	exposed
экспозиция	exposure
экспресс	express
выражениосты	expression
вӧлскыны	extend
паськытатэмын	extended
азьланьтон	extension
степеньын	extent
выл	external
бырыны	extinct
ватсам	extra
поттон	extract
экстраординарной	extraordinary
экстремальной	extreme
туж	extremely
син	eye
син	eyes
басма	fabric
выжыкыл	fabulous
ымныр	face
валамон карыны	facilitate
объектъёссэ	facilities
объект	facility
факт	fact
уг	factor
фабрика	factory
зэмослык	facts
кысыны	fade
уз пӧрмы	fail
ӝегатскон	fail
пӧрмымтэ	failed
куашкатон	failure
ляб	faint
зэмлыко	fair
окмымон	fairly
тунаськись	fairy
оскон	faith
оскымон	faithful
алда	fake
сӥзьыл	fall
усе	fall
ӦРЕКЧАСЬКОН	false
дан	fame
тодмо	familiar
семья	family
сютэм улон	famine
дано	famous
вентиляторъёс	fan
мар зэрпаллык	fancy
фантастичной	fantastic
кыдёке	far
прощальный	farewell
ферма	farm
му ужась	farmer
заук	fascinating
мода	fashion
ӝог	fast
кӧй	fat
роковой	fatal
адӟон	fate
атае	father
жадем	fatigue
неисправность	fault
яратоно	favorite
юрттон	favour
яратон	favourite
кышкан	fear
кышканы	fear
кунояськон	feast
тылы	feather
пӧртэмлык	feature
ымныр тус	features
тулыспал	february
акыльтыны	fed up
взнос	fee
сиён	feed
отзыв	feedback
шӧдӥське	feel
шӧдӥсько	feeling
пыд	feet
усе	fell
пияш	fellow
ощущаться	felt
нылкышно	female
забор	fence
удалтоно	fertile
фестиваль	festival
потӥз	fetch
лихорадка	fever
ӧжытак	few
пичигес	fewer
дусым	fiance
малпам	fiction
бусы	field
ожесточенный	fierce
дас вить	fifteen
витьтон	fifty
нюръяськон	fight
ожмаськон	fighting
фигураос	figure
радъяны	figure out
файл	file
заполнение	fill
тырмытэм	filled
пленка	film
курмем	filthy
бератаз	finally
финансъёс	finance
коньдонбур	financial
шедьтыны	find
тодыны	find out
витьлы	fine
чиньы	finger
быдтыны	finish
быдтэм	finished
тыл	fire
фирма	firm
нырысетӥ	first
нимаз	first name
чорыг кулэлыко	fish
шобыртэм	fit
вить	five
тупалоз	fix
пусъемын	fixed
кункышет	flag
кыньыръяны	flash
чеберъяськыса	flat
изъян	flaw
пыкылонтэм	flawless
марлэсь ке бызьыны	flee
быгыт	flesh
лобӟыны	flew
лэйкыт	flex
лэйкыт	flexible
лобӟон	flight
берыктыны	flip
мынчыръяськон	flirt
мынчыръяськон	flirting
пукы	float
вутудӟон	flood
этажаз	floor
пызь	flour
шур сярысь	flow
сяська	flower
грипп	flu
чылкыт	fluent
пыкылонтэм	fluent
шаплы	fluently
лӧбырес	fluffy
жидкость	fluid
лобась	fly
сосредоточивать	focus
бус	fog
бусо	foggy
шымыри	fold
матысь адямиос	folks
азьланьын	follow
чакланы	follow up
вуоноосыз	following
сиён	food
шузи	fool
визьтэм	foolish
пыд	foot
футбол	football
понна	for
Шуом	For example
кылсярысь	for instance
тӥ понна	for you
ужъёс быдэстон	forbidden
кужым	force
прогноз	forecast
кымес	forehead
кунгожсьӧр	foreign
тэль	forest
пыраклы	forever
вунэты	forget
курыны	forgive
вунэтӥ	forgot
вилка	fork
формаез	form
официальной	formal
ысь	former
шудлы	fortunately
шуд	fortune
удалтон	fortune
ньыльдон	forty
ньыльдон кык	forty-two
азьлань	forward
дышетыны	foster
нюръяськиз	fought
шедьтӥз	found
фундамент	foundation
ньыль	four
дас ньыль	fourteen
ӟичы	fox
пызырес	fragile
ортчиз	frame
инъет	framework
мошенничество	fraud
чудак	freak
дунтэк	free
эрик	freedom
кынмыны	freeze
ӵемлык	frequency
ӵем	frequent
ӵемгес	frequently
выль	fresh
удмуртарня	friday
холодильник	fridge
тусбуйын	friend
эшлыко	friendly
эшъёс	friends
эшъяськон	friendship
шушектэм	frightened
кышкатӥсь	frightening
эбек	frog
со бöрдысь кутскыса	from
фронт	front
кынтэм	frozen
емыш	fruit
разочарованный	frustrated
топливо	fuel
Фульфульд	Fulfulde
тырмоз	full
шулдыр	fun
анда	function
валтӥсь	fundamental
похороны	funeral
серемес	funny
гоно	fur
вожомем	furious
мебель	furniture
на	further
солэсь трос	furthermore
кайта	future
басьтыны	gain
шудон	game
пробел	gap
гараж	garage
жуг-жаг	garbage
бакча	garden
чеснок	garlic
капка	gate
люканы	gather
люкам	gathering
размер	gauge
калибр	gauge
сётъяны	gave
шестерёнка	gear
редуктор	gear
пол	gender
огъя	general
котьку сямен ик	generally
кылдытыны	generate
выжыполэс	generation
шырыт сямо	generous
нодлык	genius
жанр	genre
небыт	gentle
тась	genuine
вырос	gesture
вуыны	get
дӥсяськыны	get dressed
султыны	get up
ӝоген бурмыны	get well soon
басьтон	getting
сётытон	ghost
син азьын кык адӟиськон	ghosting
гигант	giant
подарочный	gift
имбирь	ginger
тусыз нылыдлы	girl
эш	girlfriend
курадӟытыса	give
тросаз	give up
сётэм	given
шумпотӥсько	glad
учкон	glance
пияла	glass
очкиос	glasses
югытак луон	glimpse
глобальной	global
шимес	gloomy
чиньыё-пӧлыё пӧзь	gloves
ӝуаны	glow
шуак кенжыны	glow up
клей	glue
мыныны	go
азьлань!	go ahead
кошкыны	go away
изьыны выдыны	go to bed
цель	goal
цельёс	goals
кечтака	goat
инмар	god
таза лу	god bless you
мынэ	goes
мынӥсь	going
ветлон	going to
зарни	gold
кошкиз	gone
дасяськыны	gonna
дыльк	goo
умой	good
бур нунал	good afternoon
ӟеч лу	good bye
бур нуналэн	good day
ӟеч ӝыт	good evening
умой уж	good job
умой адӟиське	good looking
удалтон	good luck
ӟеч ӵукнаен	good morning
яратонэ	good morning my love
бур ӵукнаен	good morning my love
ӟеч кӧл	good night
кушын	goodbye
бур уен	goodnight
вуз	goods
гуглить карыны	Google
Google переводчик	Google Translate
ӟазег	goose
шукырес чебер	gorgeous
супыльтыны	gossip
басьтӥз	got
валай	got it
правительстволэн	government
реакцизы	grab
сорт	grade
калленэн	gradually
быдтыны	graduate
тысь	grain
юрттэт	grant
сётэм	granted
виноград	grapes
валаны	grasp
турын	grass
благодарный	grateful
тау	gratitude
шайгу	grave
пурысь	gray
усто	great
кӧттырмостэм луон	greed
аксым	greedy
вож	green
чырткемьяськыны	greet
ӟечъяськон	greeting
ӟечкылан	greetings
пурысь	grey
сетка	grid
сак	grid
куректон-кайгу	grief
изон	grind
ваче кырмиськон	grip
бакалея вузан магазин	grocery
вал сюдӥсь	groom
зуркак	gross
соку вылын	ground
группа	group
ӝужда	grow
ӝуждала	growth
керӟег	grumpy
Гуарани	Guarani
оскетбур	guarantee
возьмаськись	guard
валатскон	guess
куноос	guest
огазеян	guidance
кивалтонни	guide
янгышам	guilty
пияш	guy
пиналъёс	guys
тренажёрной зал	gym
йылол	habit
улон инты	habitat
вал	had
йӧзор	hail
йырсиез	hair
ӝыны	half
пыронни дор	hall
ки	hand
каль	handle
чебер	handsome
ошыны	hang
шулдыръяськыны	hang out
учыраны	happen
пӧрмиз	happened
шуд	happiness
шудо	happy
вордӥськем нуналаз улон	happy birthday
вордӥськем нуналыд тонэ	happy birthday to you
выль ар	happy new year
чурытоме	hard
меда	hardly
почти ноку но	hardly ever
изъян	harm
кышкыт	harmful
чебер чузъяськем	harmony
лек	harsh
урожай	harvest
вань	has
адӟемпотостэм	hate
вань	have
умой нуналэн	have a good day
ӟеч нуналъёс	have a nice day
ӵукназэ сиськыны	have breakfast
шулдыръяськыны	have fun
тон сиськид	have you eaten
вань	having
кышкытлык	hazard
бус	haze
со	he
солэн вань	he has
со вань	he is
йыр	head
йыр висён	headache
йӧнатон	heal
йӧнатон	healing
тазалыксэс	health
тазалыко	healthy
иворъёс	hear
кылӥзы	heard
сюлэм	heart
вӧзаз	heat
инбам	heaven
секыт	heavy
сюлмаськись	hectic
ӝужыт	height
кельтосчи	heir
вораськон	heist
возёно	held
чидантэм	hell
чырткем	Hello
ӟечбуресь дуно	hello dear
ӟечбур	hello how are you
ӟечбур кыӵе мар	hello how are you doing
шлем	helmet
юрттэт	help
пайдаё	helpful
следовательно	hence
сое	her
уллё	herd
татын	here
люкетэз	heritage
куалекъясь	hesitate
Эй	Hey
ӟечбур	Hi
ӟечбур кыӵе мар	hi how are you
Ваньзылы чырткем	Hi there
ватэм	hidden
ватыны	hide
инъетрад	hierarchy
инмар	high
пусйыны	highlight
поход	hike
походэ	hiking
шулдыр	hilarious
выр	hill
солэн	him
подсказка	hint
макес	hip
макесъёс	hips
найм	hire
медъян	hiring
сое	his
история	history
нюртылэм	hit
Хмм	Hmm
яратоно уж	hobby
возёно	hold
вителэ	hold on
пась	hole
шулдыръяськон	holiday
тырттэм	hollow
корка	home
гуртэ уж	homework
шонерлыко	honest
зэм	honestly
чечы	Honey
дан	honor
капюшон	hood
курик	hook
тэтчон	hop
оскыны	hope
оскон	hope
шудлы	hopefully
осконтэм	hopeless
ӵошкинэс	horizontal
рожок	horn
кӧшкемыт	horrible
кышкан	horror
вал	horse
эмъяськонни	hospital
утялтыны яратон	hospitality
хост	host
басьтыны	host
тушмон луись	hostile
ӟырдыт	hot
кунокуа	hotel
час	hour
час	hours
корка	house
гурт возёс	household
кызьы	how
мар нош тӥ сярысь	how about you
тӥляд кызьы	how are you
уж-а кадь	how are you doing
туннэ тӥляд кадь ужъёс	how are you doing today
кызьы тон туннэ	how are you today
кыӵе мар	how do you do
кыӵе улэ	how is
кӧня ваньмыз	how many
кӧня	how much
кыӵе ӵем	how often
кӧня тыныд арес	how old are you
кызьы тынад нуналыд ортчиз	how was your day
кызьы ортчиз уед	how was your night
озьы	however
тул	hub
карт	hubby
ӟыгыръяськыса	hug
туж юн бадӟым	huge
адями	human
лякыт	humble
нюр	humid
кот	humidity
сю	hundred
сютэм	hungry
пӧйшураны	hunt
ураган	hurricane
дыртон	hurry
дыртыны	hurry up
вӧсь	hurt
карт	husband
вырисько	hustle
пичи корка	hut
чылкыт луон	hygiene
Мон	I
Мон	I am
Мынам ваньмыз радызъя	I am fine
Мон быгатӥсько	I can
Мон уг быгаты	I can't
бен	I do
мон уг тодӥськы	I do not know
Мон уг тодӥськы	I do not understand
Мон уг	I don't
Мон уг тодӥськы.	I don't know
уг вала монэ	I don't understand
Мон уг валаськы	I don't understand what you mean
ма сярысь тон	I don't understand what you mean
Мон тонэ уг валаськы	I don't understand you
Мон уг тодӥськы	I don’t know
Мон уг валаськы	I don’t understand
малпаны	i guess
Мынам вал	I had
Мынам луоз	I have
Мон вал	I have been
Мон оскисько талы	I hope so
Мон тодӥсько	I know
Мыным кельше	I like
Яратӥ мон тонэ	I like you
Мон яратӥсько	I love
мон яратӥсько агайме	I love my big brother
мон яратӥсько апайме	I love my big sister
мон яратӥсько атайме	I love my father
мон яратӥсько вынме	I love my little brother
мон яратӥсько сузэрме	I love my little sister
мон яратӥсько анайме	I love my mother
Мон тонэ яратӥсько	I love you
Озьы мон тӥледыз туж яратӥсько	I love you so much
мон но тонэ яратӥсько	I love you too
Мыным басьтӥзы	I mean
Тон мыным мӧзмыт	I miss you
Мон туж мӧзмисько тынэсьтыд	I miss you so much
Мон адӟи	I see
мон малпасько	I think
Мон валай	I understand
Мыным потэ	I want
Мынам тонэ адӟеме потэ	I want to see you
Мынам тонэ потэ	I want you
Мон вал	I was
Мон луо	I will
Мон луысал	I would be
Мон	I'm
Мон радъямын	I'm fine
Мон умой	I'm good
Мон татын	I'm here
Вождэс эн вае	I'm sorry
йӧ	ice
кынтэмйӧл	ice cream
малпан	idea
идеальной	ideal
огкадь луись	identical
идентифицировать	identify
быдэсак огкадь луон	identity
идиот	idiot
буш мынэм	idle
ке	if
игнорирование	ignore
висись	ill
катрадтэм	illegal
висён	illness
Илокано	Ilocano
вылтус	image
малпаны	imagine
ӝегатскытэк	immediate
ӝегатскытэк	immediately
син сузёнтэм	immense
быгатонлыкъёслы	impact
чидасьтэм	impatient
реализовать	implement
вайыны	import
йӧно-буро	important
пыртыны	impose
луонтэм	impossible
паймытыны	impress
адӟем	impression
впечатляющий	impressive
умоятӥзы	improve
умоятон	improvement
пушкы	in
со сяна	in addition
Зэмзэ вераса	In fact
азьын	in front of
со понна мед	in order to
корректной луисьтэм	inappropriate
мылкыд сётон	incentive
учыр	incident
ӝуатыны	include
пыртыса	including
доход	income
пайда	income
ярантэмлык	inconvenience
бадӟыматэм	increase
будэтэм	increased
луонтэм	incredible
зэмзэ	indeed
эрико	independent
Индия	India
возьмалэ	indicate
коренной	indigenous
индивидуальной	individual
промышленность	industry
неизбежной	inevitable
нуны	infant
черлан	infection
пумтэмлык	infinity
азон	inflammation
инфляция	inflation
влияние	influence
ивортыны	inform
Ивортодэт	information
кылдытӥсь люкетъёс	ingredients
наследовать карон	inheritance
нырысь	initial
та кичӧлтонэз	initiative
сӧсырмем	injured
сӧриськем	injury
янгыштэм	innocent
выльдэт	innovation
запросъёсылы	inquiry
сураськем	insane
нымы-кибы	insect
неуверенный	insecure
пыртыны	insert
пушсэ	inside
ӝог валатсконлык	insight
кыл вылын сылыны	insist
умме усьыны луытэк улон	insomnia
ӝутскем мылкыд	inspiration
мылкыд сётыны	inspire
инсталлировать карыны	install
тусъет	instance
шуак	instant
инты	instead
интые	instead of
инструкциос	instructions
тӥрлык	instrument
сантэманы	insult
страховка	insurance
исамтэ	intact
быдэслыкез	integrity
интеллигентной	intellectual
визьнод	intelligence
интеллигентный	intelligent
медыны	intend
лыдъямын	intended
кужмо	intense
медон	intention
ог-оген герӟаськыны	interact
вачекусыпъяськон	interaction
тунсык	interest
заинтересованный	interested
тунсыко	interesting
пырскыны	interfere
шорысез	intermediate
пуш	internal
калыккуспо	international
стаж ортчён	internship
валэктыны	interpret
валэктӥсь	interpreter
дугдытыны	interrupt
интервью	interview
интимной	intimate
пушказ	into
пыртыны	introduce
азькыл	introduction
пытсаськизы	introvert
сюлэмшӧдон	intuition
сӧсыр	invalid
малпаны	invent
ваньбурез эскерон	inventory
коньдонэз поныны	invest
сэрттыны-пертчыны	investigate
ӧтён	invitation
ӧтем	invite
фактураез	invoice
пыртылыны	involve
кыскиллям	involved
кортлэсь	iron
шормуӵ	island
нимаз висъям	isolated
юан сётыны	issue
поттыны	issue
ужпумъёс	issues
со	it
та	it is
со вал	it was
со	it's
ваньмыз умой	it's ok
Ваньмыз умой	It's okay
артикул	item
позициос	items
сое	its
Мон вань	I’m
пиджак	jacket
тюрьма	jail
толшор	January
банка	jar
анлыос	jaw
вожась	jealous
донгем	jerk
ювелир лэсьтосъёс	jewelry
уж	job
тэк каллен бызьылыны	jogging
огазеяськыса	join
дэмен	joint
серемкыл	joke
газетчи	journalist
мынон-ветлон	journey
шумпотон	joy
судья	judge
сок	juice
пӧсьтолэзь	july
тэтчыны	jump
инвожо	june
лугыр-лагыр котыр	junk
гинэ	just
тае гинэ лэсьты	just do it
судсӧзнет	justice
шонере поттыны	justify
Калааллисут	Kalaallisut
ырдыт	keen
уть	keep
сыӵе ик мылкыдэн азьланьтыны	keep it up
сюдыны	kept
чайник	kettle
усьтонъёсты	key
ӵыжон	kick
пинал	kid
пинал мурт сямен вырон	kidding
пекля	kidney
пиналъёс	kids
виыны	kill
умой	kind
сям	kind
кызьы ке	kinda
гажаса	kindly
лякыт луон	kindness
король	king
чупаны	kiss
кухня	kitchen
душес	kite
коӵышпи	kitten
пыдес	knee
тодӥ	knew
пурт	knife
рыцарь	knight
тодӥсько	know
тодон-валан	knowledge
тодмо	known
Конкани	Konkani
Крио	Krio
лейбл	label
ужан	labor
ужан	labour
уг тырмо	lack
пагӟаос	ladder
леди	lady
понэм	laid
ты	lake
ыжпи	lamb
чутэ	lame
лампа	lamp
приземлять	land
пейзаж	landscape
кыл	language
котырес	lap
бадӟым	large
быдэс	last
берпуметӥез	last but not least
фамилиосты	last name
бергес	late
берпум дыръёсы	lately
бергес	later
самой берпуметӥез	latest
берпуметӥез	latter
серекъяны	laugh
серекъян	laughing
серекъян	laughter
запуск	launch
мисьтаськон висъет	laundry
закон	law
газон	lawn
юристъёс	lawyer
кыллись	lay
сӥ	layer
макет	layout
азьтэм	lazy
кивалтыны	lead
тӧро	leader
куар	leaf
потон	leak
мыкыръяськыны	lean
кырем	leap
тодӥсько	learn
дышетон	learning
арендовать карыны	lease
самой ӧжытэз	least
сурон	leather
кошкыны	leave
кошкон	leave
кельтӥз	leaves
светодиод	led
паллян	left
пыд	leg
люкетэз	legacy
катлыко	legal
легенда	legend
катрадлыко	legit
ваньмон	leisure
пунэмаськытэк	lend
кузьдалаезъя	length
пичи	less
урок	lesson
лэзьыса	let
гожтэт	letter
салат	lettuce
ӵоштала	level
пельпум	leverage
пассивъёс	liability
библиотека	library
нюлыны	lick
пӧяськон	lie
пӧяськыны	lie
ӧрекчаськон	lies
улон	life
ӝутэмын	lift
югыт	light
чилектэм кадь ӝог	lightning
яра	like
зэмос	likely
аналогично	likewise
гож	line
Лингала	Lingala
валче карон	link
лев	lion
кизермет	liquid
лыдмет	list
кыл	listen
кылзон	listening
кылысь кылэ	literally
литература доры	literature
силё	litter
пичи	little
ас	live
улыны	live
мус	liver
улонъёс	lives
улон	living
куновисъет	living room
кенӟали	lizard
тырыны	load
нянь	loaf
кредит	loan
интыысь	local
интыяськем	location
ворсаны	lock
чурыт куронъёсъя нимаз висъян	lockdown
кор	log
серем	lol
огназ	lonely
кема	long
кемалась ӧм адскылэ	long time no see
учкон	look
учкыны	look
кыӵес	loop
лябӟытыны	loose
кузё	lord
ыштыны	lose
ыштон	loss
ыштод	lost
парти	lot
кужмо	loud
шутэтскон висъет	lounge
яратыны	love
яратон	love
яра-а тӥляд	love you
туж юн чебер	lovely
лапег	low
лэзьыны	lower
лояльной	loyal
лояльной луон	loyalty
шуд усён	luck
удалтӥсь	lucky
Луганда	Luganda
багаж	luggage
юдэс	lump
ланч	lunch
тыос	lungs
шукырес чебер	luxury
ӧрекчаськон	lying
станок	machine
укылтэм	mad
госпожа	madam
лэсьтэм	made
журнал	magazine
шукырес чебер	magnificent
горничная	maid
кутскон бам	main
ӧз юрттэ	maintain
эскерон-чаклан	maintenance
Майтхили	Maithili
майор	major
тросэз	majority
лэсьтыны	make
кылдытыны	make up
пиосмурт	male
вузкарон центр	mall
адями	man
кивалтон	manage
кивалтон	management
менеджер	manager
курегпузэз питыръяса	mandatory
возьматыны	manifest
манипулировать карыны	manipulate
лад	manner
ас кие дышетэм	manual
трос	many
трос-трос нуналаз шудо бертонъёс	many many happy returns of the day
маршировать карыны	march
маржа	margin
базар	market
кузпалъяськон	marriage
кышнояськи	married
карыны	mask
ас массово	mass
массивной	massive
мастер	master
матч	match
родственной	mate
материал	material
математика	math
юан	matter
басьтыны	matter
быдэ вуон	maturity
быгатыны	may
куартолэзь	may
оло	maybe
монэ	me
мон но	me too
сиён	meal
возьматэ	mean
сяська возьматэ	meaning
средство	means
возьматэ	meant
со вискын	meanwhile
ужрад	measure
мераос	measures
сӥль	meat
медицинской	medical
эмъюм	medicine
медитация	meditation
шорыз	medium
пумитаз	meet
пумиськон	meeting
Мейтейлон	Meiteilon
шунаны	melt
тодэ ваён	memories
йырсазь	memory
ментальной	mental
тодэ вайытон	mention
тодэ вайытэм	mentioned
визьнодась	mentor
вузаськись	merchant
жалян	mercy
ваньмыз-ӧвӧлэз	merely
Ымусьтонэн	merry christmas
базар	mess
сообщение	message
сӧрыны	messy
корт	metal
метод	method
шыръёс	mice
шор	middle
уйшор	midnight
луонлык	might
небыт-а	mild
век	milestone
ожгар	military
йӧл	milk
миллион	million
визь	mind
малпан	mindset
мынам	mine
сураськыны	mingle
тэшкылиос	minor
минут	minute
пукетлэн протоколэз	minutes
чудо	miracle
синучкон	mirror
пӧртэм	miscellaneous
лякыттэм	mischievous
куанер	miserable
ёрмон	misery
мыным	miss
ӥледлы мӧзмыт	miss you
кельтэм	missing
миссия	mission
бус	mist
янгышаны	mistake
Мизо	Mizo
мобильной	mobile
серем карыны	mock
модель	model
возиськись	moderate
туала	modern
зӥбыт	modest
нюр	moist
нюр	moisture
пурысьтам	mold
лепить карыны	mold
мень	mole
анай	mom
вакыт	moment
понедельник	monday
коньдон	money
монитор	monitor
маймыл	monkey
толэзь	month
мылкыд	mood
вогъяськись	moody
толэзь	moon
моральной	moral
тросгес	more
со гинэ öвöл	moreover
ӵукна	morning
залог	mortgage
тросэз	most
валтӥсез	mostly
анай	mother
вырӟылон	motion
муг	motivation
гурезь	mountain
шыр	mouse
ымысь	mouth
выжылы	move
вырӟылон	movement
кино	movie
миссис	mrs
трос	much
дэри	mud
кружка	mug
сӥльвир	muscle
музей	museum
губи	mushroom
крезьгур	music
кулэ	must
кылтэм-ымтэм	mute
ог-огдэ	mutual
мынам	my
Мынам дуное	My dear
мынам эше	my friend
воздушной миндэрен пыже тырмемын угорен	My hovercraft is full of eels
мынам яратонэ	my love
монэ ӧтизы	my name is
пожалуйста	my pleasure
асме	myself
лушкем	mysterious
мадиськон	mystery
миф	myth
гижы	nail
оскись	naive
уноезлэн	name
мадён	narrative
сюбег	narrow
шöтэм	nasty
калыккуспо	national
йӧскалык	nationality
та интыын вордӥськем адями	native
естественной	natural
инкуазь	nature
юрӟым луон	nausea
кыдёкын ик ӧвӧл	near
матын	nearby
ӧжыт гинэ	nearly
ӝикыт	neat
кулэ луись	necessary
чырты	neck
чыртывесь	necklace
ёрмыны	need
негативной	negative
ултӥяны	neglect
вачевераськонъёсты нуыны	negotiate
бускель	neighbor
котыръёс	neighborhood
озьы ик уг	neither
вынъёстылэсь	nephew
визьтэм	nerd
нервной	nervous
кар	nest
нетто	net
нюжаос	network
нейтральной	neutral
ноку	never
ноку но ӧвӧл сётсконо	never give up
уг саклык висъяны	never mind
ноку	nevermind
сое чаклатэк	nevertheless
выль	new
иворъёс	news
вуоно	next
бордын	next to
синмаськымон	nice
туж умой	nice to meet you
племянницае	niece
уй	night
кӧшкемыт	nightmare
укмыс	nine
дас укмыс	nineteen
укмыстон	ninety
ӧвӧл	No
ужпумтэм	no problem
номыр понна но	no way
нокин	nobody
ӵашетэм	noise
ӵаш	noisy
огез но	none
лымшор	noon
ӧвӧл	nope
озьы ик уг	nor
нормальной	normal
уй пал	north
нырыныз	nose
мӧзмон	nostalgic
ӧвӧл	not
номыр понна	not at all
урод ӧвӧл	not bad
Али уг яра	Not now
ӧвӧл на	not yet
гожтэт	note
пусъем	noted
номыр	nothing
саклык висъяны	notice
шӧдӥз	noticed
существительнойлэн	noun
макеним	nouns
роман	novel
шуркынмон	november
али	now
туннэ нуналъёсы	nowadays
ӝож	nuisance
буш пуштросэн	null
жӧломем	numb
номер	number
медсестра	nurse
гайка	nut
мускатной пушмульы	nutmeg
питание	nutrition
кылсётон	oath
кӧйомон	obesity
дыр тэрытскыса	obey
объектъёссэ	object
ужпум	objective
обязательствоос	obligation
пеймытатыны	obscure
чаклан	observation
чакламын	observe
одержимый	obsessed
йырысь кошкисьтэм малпан	obsession
вужмеме	obsolete
инъет	obstacle
басьтыны	obtain
басьтэм	obtained
веранэз ӧвӧл	obvious
веранэз ӧвӧл	obviously
куддыръя	occasionally
кужмысь басьтон	occupation
ужась	occupied
кылдыны	occur
кылдэм	occurred
потыны	occurs
океан	ocean
коньывуон	october
паймымон	odd
луонлыкъёс	odds
со пӧлын	of
сюлэмо	of course
питыртӥз	off
мыскыллян	offensive
ӵектыны	offer
ӵектон	offer
офис	office
нимысьтыз	official
ӵемгес	often
Ах	Oh
о, зэм	oh really
мувӧй	oil
окей	ok
умой, мусое	ok dear
ярам ческыт	ok honey
умой луоз, мынам яратонэ	ok my love
окей	okay
окей пичие	okay baby
умой, дуно	okay dear
умой-а, мусо	okay honey
я мынам яратонэ	okay my love
пересь	old
вылтӥ	on
одӥг пол	once
одӥг	one
одӥг кылэн ноку но тырмыт ӧвӧл	one language is never enough
сугонлэсь	onion
онлайн	online
гинэ	only
усьтыны	open
операциос	operation
малпанъёс	opinion
быгатонлыкъёс	opportunities
луонлык	opportunity
ваче беринэ	opposite
оптимистичной	optimistic
опция	option
факультативной	optional
яке	or
оранжевый	orange
порядок	order
огшоры	ordinary
огазеяськон	organization
мынон сюресэз валан	orientation
кылдон	origin
зэмосэз	original
Оромо	Oromo
сирота	orphan
мукет	other
озьытэк	otherwise
кулэ	ought
милям	our
Милям миссиямы:коткинлы луонлык сётыны, котькытын улонэз валаны но астэ пӧртэм кылъёсын возьматыны	Our mission: to enable everyone, everywhere to understand the world and express themselves across languages.
Милям миссиямы:дунне сярысь ивортодэтэз радъяны но сое общедоступной но пайдаё карыны	Our mission: to organize the world's information and make it universally accessible and useful.
сьӧрын	out
йылпум	outcome
тӥрлык	outfit
кошкон	outgoing
потон	outlet
набросок	outline
кунгож	outside
тонкӧлан	outstanding
духовка	oven
кызьы ӵоже	over
тини отын	over there
огъя	overall
вормон	overcome
умой-умой малпан	overthinking
сöрем	overwhelmed
зӥбись	overwhelming
пунэманы	owe
душес	owl
возьыны	own
асъетаны	own
кузё	owner
ош	ox
темп	pace
биньылыны	pack
пакет	package
дун тырытэк	paid
вӧсь	pain
буямын	paint
роспись	painting
куз	pair
ӟаректыны	pale
пальма	palm
кастрюляе	pan
пандемия	pandemic
паника	panic
штани	pants
кагаз	paper
рай	paradise
валлингож	parallel
лэзем	parcel
кылкутонлэсь мозмытыны	pardon
анай-атайёс	parents
парк	park
попугай	parrot
петрушка	parsley
люкет	part
пыриськизы	participate
нимысьтыз	particular
тужгес ик	particularly
партнерез	partner
ӝытпукон	party
ветлыны	pass
ветлон	passage
кельтылыны	passed
ӟырдыт	passion
ӟырдыт	passionate
пассивной	passive
лушкемкыл	password
ортчем	past
пластырь	patch
сюрес	path
мискинь	pathetic
чидан	patience
пациент	patient
мурт	pattern
вис	pause
тротуар	pavement
оплата	pay
тырон	payment
дунне	peace
тупаса улон	peaceful
персиковой	peach
пик	peak
груша	pear
кӧжы	peas
аспӧртэмлыко	peculiar
кызь	pee
кызяны	pee
сузяны	peel
ровня	peer
огъёзо	peers
ручкаез	pen
карандаш	pencil
витёнын	pending
адями	people
перец	pepper
асъяны-валаны	perceive
шӧдон	perception
шектэм	perfect
быдэстыны	perform
выступление	performance
быгатэмзыя	perhaps
дыр	period
яланлыко	permanent
юаське	permission
лэзён	permit
мыр-мыр луон	perseverance
кыл вылаз сылӥсь	persistent
адями	person
ас	personal
личность	personality
мурт	personality
луонлык	perspective
зӥбиз	persuade
отступник	pervert
гурт	pet
фаза	phase
феномен	phenomenon
философи	philosophy
телефон	phone
туспуктэм	photo
фраза	phrase
физический	physical
быръе	pick
ӝутыны	pick up
суред	picture
шоро	piece
юдэсъёс	pieces
парсь	pig
дыдык	pigeon
свай	pile
миндэр	pillow
самолётэз валтыны	pilot
бышкалтыны	pin
ананас	pineapple
льӧль	pink
гоп	pit
гу	pit
звенолэн	pitch
жаль	pity
инты	place
интыос	places
сьӧдкыль	plague
ӵошал	plain
план	plan
ӵошкыт	plane
будосъёсын	plant
будосъёс	plants
тэркы	plate
платформа	platform
шудыны.	play
шудон	playing
усто	pleasant
пожалуйста	please
куанӥсько	pleased
майбыр	pleasure
верам тырон	pledge
трос	plenty
сюжетлэн	plot
штекерной	plug
сливапу	plum
водопроводчик	plumber
трос лыд	plural
подкаст	podcast
поэма	poem
кылбурет	poetry
точка	point
яд	poison
полиция	police
политика	policy
вазиськись	polite
кырсёмытон	pollution
тымет	pond
бассейн	pool
сюдон	poop
куанер	poor
поп	pop
тодмо	popular
калык	population
парсь сӥль	pork
ӝук	porridge
порт	port
положение	position
позитивной	positive
кузёяськыны	possess
люкетэ	possession
вормытъяськись	possessive
луымон	possible
почта пыр келян	post
почта	post
ужъёс	postpone
картофка	potato
потенциалэз	potential
йыгаськыны	pound
куанер улон	poverty
власть	power
кужымлыко	powerful
практической	practical
ужвыл	practical
практика	practice
ушъяськытэк	praise
розыгрыш	prank
вӧсяськыса	pray
дунолыко	precious
точной	precise
ӵапак	precisely
азьпала вераны	predict
азьбур сётыны	prefer
азьбур сётон	preference
кӧто	pregnant
малпанъёс	prejudice
корка	premises
премиум	premium
дасяськон	preparation
дасяськон	prepare
дасям	prepared
нимазь	preposition
гожтэт	presence
солэсь	present
презентация	presentation
утьыны	preserve
президент	president
зӥбыны	press
давление	pressure
шӧдымтэ улэ аналскыны	pretend
синмаськымон	pretty
утялтыны	prevent
азьвыл	previous
шедьтэм	prey
дун	price
вылтӥяськон	pride
вöсьбурчи	priest
основной	primary
валтӥсь	prime
принцесса	princess
принцип	principal
азьын	prior
приоритетъёсы	priority
пытсэт	prison
огнын улон	privacy
частной	private
капчиятон	privilege
приз	prize
кузьым	prize
вылды	probably
ужпумъёс понна	problem
процедура	procedure
азинтон	proceed
процесс	process
продукт	produce
лэсьтос	product
производство	production
профессия	profession
профессиональной	professional
профильной	profile
пайдазэ	profit
мур	profound
азинскемез	progress
проект	project
кӧто	prominent
ӵектэм	promise
юрттыны	promote
азьланьтон	promotion
шаплы	prompt
быгатонлык	prone
нимвоштосъёс	pronouns
веран	pronunciation
зэматон	proof
кулэезъя	proper
янгыштэк	properly
аслыкъёс	properties
асъетсэс	property
ӵектон	proposal
азьланяз	prospect
сяськаяськон	prosperity
сяськаясь	prosperous
утьыны	protect
вылтӥяськись	proud
доказать	prove
ванё карыны	provide
чаклам	provided
провинци	province
снабжение	provision
ныл-пи быдэ вуон	puberty
публика	public
кыскыны	pull
тыква	pumpkin
каун	pumpkin
дырыз дыръя	punctual
дышетскись	pupil
басьтон	purchase
чылкыт	pure
бусӥр	purple
пуктэм ужпум	purpose
уксё пуйы	purse
сьӧры уйиськыны	pursue
уйылон	pursuit
донганы	push
пуктыны	put
интые	qualification
качество	quality
лыдпусъёс	quantity
карантин	quarantine
куара	quarrel
копаськыны	quarrel
ньыльмос люкет	quarter
кечуа кыл	Quechua
королева	queen
йӧспӧртэм	queer
курон	query
юан	question
черодъёсты	queue
шаплыесь	quick
ӝог	quickly
каллен	quiet
шобрет	quilt
ужысь кошкыны	quit
тырмоз	quite
викторина	quiz
басьтэмкыл	quotation
текст	quote
котировкаос	quotes
кролик	rabbit
ӵошатскон	race
туж ян вожпотон	rage
зор	rain
ӝутэмын	raise
ӝутэм	raised
бызиз	ran
случайной	random
диапазонэз	range
чупырес	rapid
ӝог	rapidly
шер	rare
шер	rarely
пужы	rash
комак	rat
ставка	rate
ӝогес	rather
ваче кусып	ratio
шонер малпам	rational
зуркак	raw
вуиз	reach
басьтыны быгатэм	reached
реакци	reaction
лыдӟыны	read
лыдӟиськон	reading
дась	ready
туала	real
зэмзэлык	reality
валалляз	realize
лэсьтэм	realized
зэмзэ	really
мышпалыз	rear
мугез	reason
йырвизьмо	reasonable
чортыны	recall
вӧсь басьтон	receipt
басьтыны	receive
басьтэм	received
недавний	recent
берпуметӥяз	recently
пумитан	reception
рецептъёс	recipe
визьзэ ыштэ	reckless
тодман	recognition
тодмаллязы	recognize
дэмламын	recommend
ӵектыны	recommended
гожъян	record
сайкан	recover
выльдон	recovery
шонерсэрег	rectangle
горд	red
басьтон	redeem
янгышысь потон	redemption
пичиятыны	reduce
мултэс	redundant
келяны	refer
чӧлсконъёс	reference
возьматыны	reflect
малпаськон	reflection
возиськыны	refrain
йӧкана	refrigerator
возмещение	refund
отказ	refuse
куронэз палэнтон	refused
гажан	regard
кусыпын	regarding
эриктэмлык	regardless
ӟечкылан	regards
регион	region
регистрация	register
жаляса	regret
эсэпрадо	regular
регулярно	regularly
куронэз палэнтыны	reject
радъяськытыны	relate
тупась	related
кусыпъёс	relationship
ӵыжы-выжы	relative
относительной	relative
ӵыжы-выжыос	relatives
лябӟытӥськод	relax
выпуск	release
лэзем	released
поттэм	released
лэсясь	relevant
осконо	reliable
капчи	relief
капчиятыны	relieve
мозмытэм	relieved
осконзэ	religion
инмарлы оскись	religious
мылкыдтэк	reluctant
оскисько	rely
кыльыны	remain
кылем	remaining
вунэтонтэм	remarkable
суд утиськон амалъёс	remedy
тодын возьыны	remember
тодэ вайытыны	remind
тодэ вайытон	reminder
палэнтыны	remote
палэнтыны	remove
лэсьтыны услугаос	render
арендае	rent
ремонт	repair
тодэ ваён	repeat
асэныд воштыны	replace
ответ	reply
вераны	report
укшась	represent
репутация	reputation
курон сётыны	request
курон	request
курыны	require
кулэ	required
спасательный	rescue
эскерыны	research
тодэ вайытыны	resemble
куатаськон	resentment
юнматыны	reservation
ваньбурет	reserve
резидент	resident
отставкае сётон	resign
юнлык	resilience
юнлыко	resilient
пумитъяськыны	resist
пумитъяськон	resistance
решение	resolution
быдэстыны	resolve
курорт	resort
ужъюгдур	resources
гажан	respect
вазён	respond
реакция	response
кылкутон	responsibility
ответственной	responsible
шутэтскон	rest
каньылэн кылльыны	rest in peace
ресторан	restaurant
выльдыны	restore
сюбегатыны	restrict
результатъёсыз	result
йылпумъянъёс	results
выльысь кутскыны	resume
нимаз вузан	retail
возьыны	retain
возён	retention
пенсиын	retired
чигнаны	retreat
поттыны	retrieve
берыктэ	return
усё	reveal
шараям	revealed
йыркурез берыктыны	revenge
доход	revenue
берен	reverse
лыдӟон	review
выльысь учкыны	revise
выльысь учкон	revision
революция	revolution
кузьым	reward
ритм	rhythm
урдлы	rib
рис	rice
узыр	rich
мозмытыны	rid
мынон	ride
кельыштэм формаез	ridiculous
эрикрадъя	right
ӵапак али	right now
чурыт	rigid
кульчолы	ring
гылатон	rinse
бунт	riot
кесем	rip
вуэм	ripe
ӝужда	rise
дӥсьтон	risk
вожмаськыны	rival
шур	river
сюрес	road
пыжыны	roast
оскымон	robust
кӧльы	rock
стержень	rod
рольёсты	role
рулон	roll
липет	roof
висъет	room
выжы	root
гозы	rope
сисьмем	rotten
зуркак	rough
лек	roughly
котырес	round
мынон маршрут	route
огдышем сямъя ужан	routine
рад	row
зыраны	rub
резинка	rubber
жаг	rubbish
зуркак	rude
коврик	rug
таркамын	ruin
шонеррад	rule
линейка	ruler
шонеррад	rules
бызьыса	run
бызись	running
сельской	rural
дыртэммы	rush
мешок	sack
вӧсяськон	sacred
юрттэткузьым сётыны	sacrifice
кышкыттэм	safe
курдантэм лобӟон	safe flight
кышкыттэмлык	safety
визьбурчи	sage
шуо	said
уяны	sail
уяса кошкон	sailing
муг	sake
уждун	salary
вузан сярысь	sale
лосось	salmon
сылал	salt
нош	same
Татын но сыӵе ик	Same here
тусъет	sample
луо	sand
Санскрит	Sanskrit
мыскылляса серекъян	sarcastic
кӧбертэм	sassy
бусы кутон эскеронъёс	sat
кӧт каньыл луон	satisfaction
огназэс	satisfied
быдэстыны	satisfy
кӧт каньыл луон	satisfying
кӧснунал	Saturday
векчи сӥльтырем	sausage
дикарьёслэн	savage
возьыны	save
адӟыны	saw
шуо	say
масштаб	scale
мошенничество	scam
вурыс	scar
тырмымтэ	scarce
шурдыт	scared
шарфик	scarf
кышкыт	scary
пасьтана зӥръям	scattered
сцена	scene
инкуазь тус	scenery
зын	scent
планировать	schedule
школа	school
наука	science
тодосчи	scientist
тодосчиос	scientists
качы	scissors
тышкаськыны	scold
дась	scope
лыдъян	score
куштӥськем корт	scrap
ӵабтӥськем	scratch
кесяськыны	scream
экран	screen
винт	screw
сценарий	script
зарезь	sea
печать	seal
утчан	search
вакыт	season
пукон	seat
кыкетӥ	second
лушкес	secret
висъет	section
кышкыттэмлык кылдытыны	secure
кышка	security
адӟыны	see
адӟиськом	see you
адӟиськом	see you later
вуоно пумиськытозь	see you soon
ӵуказеозь	see you tomorrow
тысь	seed
утчаны	seek
адӟисько	seem
лэся	seems
адӟем	seen
пытсэтаны	seize
кулыса усён	seizure
шер	seldom
октыны	select
ачим	self
ачиз бурмон	self healing
эгоистичной	selfish
продажа	sell
келяны	send
ысты мыным фотодэ	send me your picture
бадӟымез	senior
пуштрос	sense
визьмо	sensible
ӧбылес	sensitive
келям	sent
пумкыл	sentence
шуосъёс	sentences
нимаз	separate
Сепиде	Sepedi
куарусён	september
радыз	sequence
сузьет	series
серьёзной	serious
йӧн-йӧн	seriously
обслуживать	serve
утялтон	service
сессия	session
зуркатыны	set
кылдытыны	set up
тупатон	setting
интыяны	settle
сизьым	seven
дас сизьым	seventeen
сизьымдон	seventy
кӧня	several
йӧн-йӧн	severe
вуриськыны	sew
вужер	shade
вужер	shadow
курткыны	shake
кулэ	shall
лазег	shallow
аслэсьтыззэ	shame
формаос	shape
люкетэз	share
лэчыт	sharp
со	she
солэн вань	she has
со	she is
сбрасывать	shed
ыжъёс	sheep
куар	sheet
ӝажы	shelf
дыж	shell
ватӥськон-пегӟон	shelter
щит	shield
смена	shift
пиштыны	shine
корабль	ship
судно ветлон	shipping
дэрем	shirt
быгатӥсьлэн	shoes
ыбылыны	shoot
вузаськонни	shop
бичаськем	shopping
ярдур	shore
вакчи	short
ёрмон	shortage
ыбылыны	shot
кулэ	should
пельпум	shoulder
кесяськыны	shout
шоу	show
мыным возьматыны	show me
лул	shower
креветка	shrimp
ичиомыны	shrink
пытсаны	shut
ӵоксаськиз	shut up
востэмак	shy
агай-вынъёс	sibling
сузэр-вынъёс	siblings
висись	sick
пал	side
шокчыны	sigh
ужрад	sight
дано интыосты учкон	sightseeing
пусъёс	sign
гожтӥськем	signature
шӧдскымон	significant
шыпыт	silence
чалмыт	silent
буртчин	silk
шузи	silly
азвесь	silver
огвыллем	similar
огшоры адями	simp
огшоры	simple
огвакытэ	simultaneously
со дырысь	since
усьтэм сюлмо	sincere
сэлмысь ик	sincerely
кырӟаны	sing
кырӟась	singer
огназ	single
куалемъёсысь	sink
Сэр	Sir
сузэр	sister
вылькен	sister in law
пуктыны	sit
сайт	site
ситуация	situation
куать	six
дас куать	sixteen
куатьтон	sixty
быдӟала	size
ӧнер	skill
быгатэм	skills
ку	skin
векчи	skinny
чильпыра	skip
юбкаен	skirt
инбам	sky
вар	slave
уйвӧтын	sleep
ум	sleeping
кӧлэм потӥсь	sleepy
тул	sleeve
втулка	sleeve
юдоно	slice
юдэс	slice
слайд	slide
кыньыръяса	slightly
веськрес	slim
гылӟыны	slip
бамал	slope
слот	slot
каллен	slow
каллен	slowly
пичи	small
визьмо	smart
зын	smell
пальпотон	smile
ӵын	smoke
вольыт	smooth
закуска	snack
куалялюльы	snail
кый	snake
шлач карем	snap
лымы	snow
озьы	so
сыӵе мусо	so cute
улыны	so far
коттыны	soak
майтал	soap
сазь	sober
футбол	soccer
пумитан	social
мерлык	society
носки	socks
небыт	soft
софтверной	software
музъем	soil
вузамон	sold
вузаны	sold out
солдат	soldier
нимаз	sole
юн	solid
решение	solution
лэсьтыны	solve
куд-огъёсыз	some
кин ке	somebody
озь но тазь но	somehow
кин ке	someone
мар-ке	something
кытӥ	sometimes
кырӟан	song
ӝоген	soon
сложной	sophisticated
Сорани	Sorani
висись	sore
висись чырты	sore throat
куректон	sorrow
вождэс эн вае	Sorry
шертон	sort
утчаны	sought
лул	soul
родственной	soulmate
куара	sound
шыд	soup
чырс	sour
дор ошмес	source
лымшор	south
инты	space
спам	spam
вӧлмыны	span
испан кышно	Spanish
шыръям	spare
верало	speak
аспӧртэмлыко	special
видъёс	species
аспӧртэмлыко	specific
эффектной	spectacular
вераськон	speech
вераськисьтэм	speechless
ӝоглык	speed
пелляськон	spell
арам	spend
быдтэм	spent
лэчыт	spicy
шеп	spike
бергатыса	spin
шпинат	spinach
духовной	spirit
сяланы	spit
син мальдымон	splendid
вайяса	split
сӧрыны	spoil
уродмем	spoiled
шуак	spontaneous
пуньы	spoon
инты	spot
кышно	spouse
вӧлмем	spread
тулыс	spring
квадратлы	square
пачкатыны	squeeze
кальмар	squid
коньы	squirrel
бышкалтыны	stab
вошъяськисьтэм	stable
штабеле тырыны	stack
персонал	staff
этапаз	stage
вишты	stain
тубат	stairs
лэсьтыны ставка	stake
ныд	stalk
партер	stall
штамповать карыны	stamp
киоскысь	stand
standart	standard
кизили	star
кутскыны	start
кутскиз	started
сютэм	starving
штат	state
заявление	statement
станция	station
статуя	statue
инлыкез	status
кыльыны	stay
кышкыттэмлыкын луыны	stay safe
юн	steady
стейк	steak
лушканы	steal
пар	steam
андан	steel
луонтэм	steep
модос	stem
вамыш	step
боды	stick
чурыт	stiff
вань на-а	still
леканы	sting
чурыт	stingy
сураны	stir
запассэ	stock
лушкам	stolen
ӝуш	stomach
из	stone
сылӥз	stood
пукон	stool
остановка	stop
утён	storage
люкаськизы	store
штурмовать карыны	storm
мадёс	story
гур	stove
прямой	straight
огшоры	straightforward
напряжение	strain
валантэм	strange
тодмотэм мурт	stranger
стратегия	strategy
куро	straw
боры	strawberry
гож	streak
ӧръёсъя	stream
ульчаез	street
кужым	strength
стресс	stress
золъяськыны	stretch
строгой	strict
бугыръяськемзы	strike
чур	string
гож	strip
тыршыны	strive
инсульт	stroke
кужмо	strong
вормем	struck
пушсузьетэз	structure
нюръяськон	struggle
жугиськон	struggling
ваменэс	stubborn
ёрмись	stuck
ученический	student
дышетскон	study
дышетскыны	study
дышетон	studying
пушказ тырыны	stuff
кушектымон	stunning
шузи	stupid
стиль	style
тема	subject
возьматон	submission
эскерыны сётыны	submit
тырмет	substance
вошъяны	substitute
векчи	subtle
мыныны	succeed
азинлык	success
азинлыко	successful
дорын сыӵе	such
таӵе кадь	such as
сюпсьыны	suck
шуак	sudden
шуак	suddenly
курадӟонъёс	suffer
курадӟон	suffering
ваньмыз	sufficient
сахар	sugar
ӵектӥзы	suggest
предложение	suggestion
костюм	suit
тупаны	suit
тупась	suitable
чемодан	suitcase
огъя лыд	sum
резюме	summary
гужем	summer
кенешонзы	summit
шунды	sun
арня	sunday
шундыё	sunny
шунды пуксён	sunset
шундылэн югытэз	sunshine
супер	super
вылӥ	superior
инспектор	supervisor
ӝытазезэ сиськон	supper
тырмыт сётон	supply
юрттыны	support
поныны	suppose
азьмалпам	supposed
веран	sure
вылыз	surface
жомбыляк	surge
операция	surgery
фамилия	surname
витьымтэ	surprise
паймем	surprised
сётон	surrender
котыртӥсь	surrounding
чаклан	surveillance
юан-веран	survey
улэп кыльыны	survive
шекланы	suspect
ошоно	suspended
подозрительной	suspicious
юрттэт сётыны	sustain
йыг-йыг азинтон	sustainability
йыгмыт	sustainable
котыр	swag
ньылӥз	swallow
кыскон	swap
кыл сётыны	swear
пӧсяны	sweat
свитер	sweater
ӵужыны	sweep
голькыт	sweet
ческыт уйвӧтъёс	sweet dreams
ческыт сиись	sweet tooth
мусо	sweetheart
пельтӥськыны	swell
пыктэм	swelling
уяны	swim
уян	swimming
сэзъяса	swing
переключатель	switch
тӧрнам	swollen
меч	sword
символ	symbol
жалян	sympathy
тодметъёс	symptoms
система	system
ӝӧк	table
быдэстыны	tackle
пус	tag
быжзэ	tail
кутыны	take
басьтыны	take away
астэ уть	take care
лобӟем	take off
кутэм	taken
верало	talk
вераськись	talkative
ӝужыт	tall
кранысь	tap
лякыны	tape
целевой	target
олo	task
шӧмыз	taste
ческыт	tasty
дышетэм	taught
чай	tea
дышетоно	teach
дышетӥсь	teacher
команда	team
слезоточивой	tear
синвуос	tears
пышкылыны	tease
технологиос	technology
пиньысь	teeth
верало	tell
мон верасько	tell me
отпускной	temper
температура	temperature
черк	temple
огдырлы	temporary
дас	ten
дас сюрс	ten thousand
арендатор	tenant
утялтэ	tend
тенденция	tendency
тендер	tender
дыр	tense
вань кужымез поттон	tension
палатка	tent
азьлосез	tentative
срок	term
нимкылъёс	terms
шимес	terrible
туж кышкыт	terrific
улосвыл	territory
тестовые	test
кылкуэт	text
мар	than
тау	thank
тау	thank you
Тон понна, тыныд тау кариз чиданмылы, келян дыръёсыз мон тэкшыры	Thank you for your patience while we investigate shipment
бадӟым тау тӥледлы	thank you so much
бадӟым тау тӥледлы	thank you very much
тау	thanks
Тау приложенимез уже кутэмды понна	Thanks for using our app
ма	that
со луоз	that is
со умой	that's good
лушкам	theft
соосты	their
соослы	them
тема	theme
соос асьсэос	themselves
собере	then
малпан	theory
отын	there
вань	there are
пумиськизы	there is
малы ке шуоно	therefore
таосыз	these
соос	they
соос вань	they are
кыз	thick
лушкаськись	thief
макес	thigh
векчи	thin
штука	thing
ваньбур	things
малпаны	think
куинетӥез	third
сюкуасьмем адями	thirsty
дас куинь	thirteen
куамын	thirty
таиз	this
со сыӵе	this is
пыр-поч	thorough
пыр-поч	thoroughly
таос	those
ке но	though
малпанъёс	thought
мур малпаськись	thoughtful
малпаъёс	thoughts
сюрс	thousand
шорт	thread
кышкытлыклэсь	threat
кышкатыны	threaten
куинь	three
ӧс	threshold
сюлэмшугъяськись	thrilled
узырмизы	thrive
гуньдӥсько	throat
пыр	through
котькытын	throughout
лэзяськыны	throw
пӧлы	thumb
гудыри	thunder
Покчиарня	Thursday
образ	thus
клещ	tick
вуӝутскон	tide
ӝикыт	tidy
галстук	tie
тигр	tiger
ӝикыт	tight
Тигринья	Tigrinya
ортчытэм дыр	time
кöберась	timid
пичи	tiny
кенеш	tip
валэктонъёс	tips
катьтэммытыны	tire
жади	tired
басма	tissue
нимыз	title
вылын	to
луоно	to be
тост	toast
туннэ	today
пичильтык	toddler
пыдчиньы	toes
ӵош	together
туалет	toilet
верам	told
чидан	tolerance
чиданы	tolerate
помидор	tomato
ӵуказе	tomorrow
кыл	tongue
туннэ ӝыт	tonight
ортчыт	too
кутӥз	took
тӥрлык	tool
уж тӥрлыкъёс	tools
пинь	tooth
вылӥ	top
вылӥысь	top
тема	topic
кесям	torn
курадӟытыны	torture
огъя лыдъям	total
йӧтэ	touch
чурытоме	tough
тур	tour
пала	toward
доры	towards
ӵушкон	towel
город	town
токсичной	toxic
пытьы	trace
трек	track
вузкарыны	trade
сям-йылол	tradition
котьку	traditional
ветлон	traffic
пытьы	trail
тренироваться	train
тренировочной	training
сям	trait
астодметъёс	traits
сётыны	transfer
потон	transition
берыктыны	translate
пырадӟиськись	transparent
нуыны-вайыны	transport
нуллон-ворттон	transportation
нальык	trap
жуг-жагзэс	trash
сӧсырмем	trauma
мыныны-ветлыны	travel
лоток	tray
дуно ваньбур	treasure
шыд	treat
эмъян	treatment
писпуос	tree
омабыдӟа	tremendous
тенденция	trend
пробный	trial
трюк	trick
веръяны	tried
триггер	trigger
чеберъян	trim
мынон	trip
умойтэм ужъёс	trouble
брюки	trousers
грузовик	truck
ЗЭМЛЫКЕЗ	true
багажниказ	trunk
оскыны	trust
оскон	trust
зэм	truth
утчаны	try
Тсонга	Tsonga
чильым	tube
Вторник	Tuesday
дышетскон	tuition
курка	turkey
куркума	turmeric
биниське	turn
избака	turtle
репетитор	tutor
дас кык	twelve
кызь	twenty
кызь одӥг	twenty-one
Тви	Twi
кык пол	twice
позыръяны	twist
кык	two
тип	type
типичной	typical
Удмурт кыл	Udmurt
шуш	ugly
пумозяз	ultimate
зорвозъет	umbrella
уг быгаты	unable
дядя	uncle
йырсазьтэк	unconscious
улын	under
улын	underneath
ӧжытгес лыдъяны	underrated
валаны	understand
валамон	understood
шудтэм учырын	unfortunately
униформа	uniform
уникальный	unique
огмет	unit
университет	university
тодмотэм	unknown
только	unless
со дырозь	until
аспӧртэмлыко	unusual
солань	up
тыныд бырйоно	up to you
выльдӥськон	update
ӟеч карыны	upgrade
умоятӥзы	upgrade
бöрысь	upon
шуген	upset
кар	urban
сайкатон	urge
срочной	urgent
милемыз	us
ужатонъя	use
уже кутыны	used
пайдаё	useful
кулэтэм	useless
огшоры	usual
котьку	usually
кулэлык	utility
отпуск	vacation
вакцинация	vaccination
вакцинация	vaccine
вакуум	vacuum
расплывчатый	vague
действительный	valid
нёжал	valley
кулэлыко	valuable
дунлыкъёсыз	value
сям турлы	variety
пӧртэм	various
висъяськыны	vary
ваза	vase
паськыт	vast
бакча сиён	vegetable
бакча сиён	vegetables
транспорт	vehicle
вузкарись	vendor
яд	venom
ужбергатонни	venture
нуон инты	venue
эскерыны	verify
троспӧртэмлыко	versatile
пӧртэмлык	version
валланет	vertical
туж	very
но туж умой	very good
сосуд	vessel
вамен	via
мар атмосфера	vibe
дырекъян	vibes
сьӧлыко	vicious
бырем	victim
видео	video
тусызъя	view
гурт	village
лек мурт	villain
уксус	vinegar
виноград октон вакыт	vintage
кужмысь карон	violence
сэлэм чигиськись	violent
вирусной	viral
исамтэ ныл	virgin
виртуальной	virtual
ӟеч сямо адями	virtue
синадӟон	vision
лыктон	visit
адӟон	visual
жизненно	vital
яркыт	vivid
словарной	vocabulary
куара сётыны	voice
кужымтэм	void
громкость	volume
асмылкыдчи	volunteer
ӧскон	vomit
ӧсконы	vomit
уязвимый	vulnerable
уждун	wage
уждун	wages
талия	waist
витьыны	wait
официант	waiter
витён	waiting
сайкатыны	wake
сайкатскиз	wake up
ветлыны	walk
ветлон	walking
борддор	wall
янчик	wallet
калгыса ветлыны	wander
потыны	wanna
потыны	want
утчаськыса	wanted
ож	war
гардероб	wardrobe
склад	warehouse
шуныт	warm
алыны	warn
алон	warning
ожгарчи	warrior
вал	was
миськыны	wash
сюре	waste
час	watch
ву	water
арбуз	watermelon
шонтыны	wave
образ	way
ми	we
ми	we are
ми быгатӥськом	we can
ляб-а	weak
лябӟем	weakness
узырлык	wealth
узыр	wealthy
матын	wear
нуллон	wearing
куазь	weather
сюан	wedding
вирнунал	Wednesday
жуг-жаг	weed
арня	week
шутэтскон	weekend
секталазыя	weight
йӧспӧртэм	weird
ӟеч-а	welcome
улон ӟечлык	welfare
Ярам	Well
молодец	well done
мынӥз	went
вал	were
шундыпуксён	west
мускытсэ	wet
кит	whale
мар	what
мар тон сярысь	what about you
ма тон кариськод	what are you doing
али мар тон лэсьтӥд	what are you doing now
мар тон али кариськод	what are you doing right now
мар тӥ ужаськоды	what do you do
кызьы тон улыны коньдон поттӥськод	what do you do for a living
мар тӥляд вань	what do you mean
мар тынад потэ	what do you want
мар луиз	what happened
мар	what is
мар со сыӵе	what is this
кыӵе тынад ужед	what is your job
кызьы тӥляд нимтулды	what is your name
мар луиз	what's up
кызьы тынад нимыд	what's your name
мед	whatever
чабей	wheat
питыран	wheel
ку	when
куке	whenever
кытын	where
кытын тон	where are you
кытысь тон	where are you from
кытын али тон	where are you now
кытын тон улиськод	where do you live
кытын	where is
со дыре	whereas
сотэк но	whether
кыӵе	which
дыр	while
сипыртыны	whisper
шултэм	whistle
кисьтаськись	white
кинлэн	who
кин тон	who are you
кин	who is
кин та	who is this
копак	whole
кинлэн	whom
кинлэн	whose
a ма	why
Малы бы ум	why not
кышка	wicked
паськыт	wide
пал кышно	widow
пасьталаез	width
кышноез	wife
кыр	wild
эрик	will
потыны	will
мылкыд карись	willing
вормон	win
тӧл	wind
укно	window
тӧло	windy
вина	wine
тол	winter
ӵушылыны	wipe
провод	wire
визьлыксэс	wisdom
визьмо	wise
мылкыд карисьёс	wish
сӥзисько тӥледлы ваньзэ умойзэ	wish you all the best
вегин	witch
юрттэтэн	with
отзывать	withdraw
басьтон	withdrawal
пушкын	within
сотэк	without
адӟыны	witness
лэчыт визьмо	witty
кион	wolf
нылъёс	woman
нылъёс	women
вормем	won
уз луы	won't
тунсыко	wonder
усто	wonderful
писпуос	wood
гон	wool
кыл	word
кылъёс	words
уж	work
ужаны	work
дасяны	work out
ужась	working
дунне	world
нумыр	worm
нуллэм	worn
сюлэмшугъяськись	worried
сюлмаськыны	worry
уродмем	worse
йыбыртон	worship
самой урод	worst
сылэ	worth
кулэ вылэм	worth it
ярамон	worthy
потэ вал	would
эмъяськон	wound
Вау	Wow
обертка	wrap
пуромон	wrath
суйпоскес	wrist
гожъяны	write
гожтоно татчы	Write here
гожтон	writing
письменной	written
умойтэм	wrong
гожтэм	wrote
азбар	yard
вушйылон	yawn
вушйылыны	yawn
Мед	Yeah
ар	year
аръёс	years
маял	yeast
кесяськыны	yell
ӵуж	yellow
мед	Yes
бен пичие	yes baby
бен, дуное	yes dear
мед, мусо	yes honey
мед кыскоз, мынам яратон	yes my love
бен одно ик	yes of course
толло доры	yesterday
на	yet
кожалод	yield
тӥледыз	you
тӥ	you are
тон туж чебер	you are beautiful
тон сыӵе чебер	you are so beautiful
тон ӟечкылазы	you are welcome
тон быгатӥськод	you can
Тодӥськоды-а	You know
но тон	you too
пожалуйста	you're welcome
егитъёс	young
мар тон	your
ӟечкылан	your welcome
астэ	yourself
пинал дыр	youth
гажаса витиськом	you’re welcome
ческыт	yummy
нулевой	zero
