un	a
un poco	a little
assè	a lot
tanto	a lot
un mucio de	a lot of
sbandonar	abandon
sbandonà	abandoned
convìvar	abide
abilità	ability
bon	able
calche	about
scuasi	about
sora	above
foresto	abroad
estero	abroad
assensa	absence
assente	absent
assolutamente	absolutely
supar	absorb
astrato	abstract
assurdo	absurd
bondansa	abundance
bobana	abundance
sósega	abundance
gajardo	abundant
bondante	abundant
violensa	abuse
assento	accent
assetar	accept
acesso	access
insidente	accident
aloso	accommodation
far	accomplish
rivà	accomplished
fato	accomplished
secondo	according
conto	account
pressision	accuracy
pressiso	accurate
acusà	accused
dolor	ache
otegner	achieve
conchista	achievement
riconossar	acknowledge
conossente	acquaintance
otegner	acquire
otegnesto	acquired
acuisission	acquisition
traverso	across
ato	act
assion	action
ativo	active
atività	activities
atività	activity
ator	actor
reale	actual
in realtà	actually
agudo	acute
adatar	adapt
zontar	add
dipendente	addicted
dipendensa	addition
in zonta	additional
indirisso	address
adeguà	adequate
vissin	adjacent
petà	adjacent
ajetivo	adjective
regolar	adjust
amirar	admire
ametar	admit
adotar	adopt
còcolo	adorable
antìssipo	advance
avansà	advanced
vantajo	advantage
aventura	adventure
averbio	adverb
reclan	advertisement
publissisàr	advertising
consejo	advice
consejar	advise
sostenidore	advocate
estèdego	aesthetic
sunto	affair
roba	affair
considerar	affect
controlar	affect
rivardar	affect
tacamento	affection
parmétarse	afford
conveniente	affordable
spaventà	afraid
dopo	after
dopo mesodì	afternoon
pomerijo	afternoon
dopo	afterwards
po'	afterwards
da novo	again
contro	against
età	age
ajensia	agency
ajente	agent
rapresentante	agent
agressivo	aggressive
svelto	agile
fa	ago
concordar	agree
acordo	agreement
agricoltura	agriculture
davanti	ahead
ajuto	aid
mirar	aim
aria	air
aeroporto	airport
coridoio	aisle
sveja	alarm
alcol	alcohol
avertensa	alert
aviso	alert
vivo	alive
tuti	all
va ben	all right
mejo auguri	all the best
parmétar	allow
parmesso	allowed
scuasi	almost
solo	alone
longo	along
zà	already
Va ben	Alright
anca	also
alternativa	alternative
seben	although
senpre	always
i xe	am
le xe	am
son	am
incredibile	amazing
anbiguo	ambiguous
anbission	ambition
anbissioso	ambitious
modifegar	amend
fra	amid
fra	among
fra de noialtri	among us
inporto	amount
divertente	amusing
un	an
analisi	analysis
avi	ancestors
àncora	anchor
oncora	anchor
antigo	ancient
e	and
e ti	and you
anzolo	angel
furia	anger
rabia	anger
angolo	angle
inrabià	angry
animale	animal
caìcia	ankle
aniversario	anniversary
anuncio	announcement
fastidiar	annoy
dar fastidio	annoy
fastidià	annoyed
fastidioso	annoying
anuale	annual
anonimo	anonymous
un altro	another
risposta	answer
antissipar	anticipate
intivar	anticipate
ansia	anxiety
ansioso	anxious
afanà	anxious
cualsiasi	any
pi'	anymore
tuti cueli che	anyone
chi che	anyone
calcossa	anything
par altro	anyway
parò	anyway
in ogni caso	anyway
par altro	anyways
parò	anyways
in ogni caso	anyways
separà	apart
diviso	apart
apartamento	apartment
scusa	apologize
aparente	apparent
pararia	apparently
aparentemente	apparently
ricorso	appeal
conparir	appear
aparir	appear
speto	appearance
siera	appearance
conparso	appeared
petito	appetite
pomo	apple
aplicassion	application
aplicar	apply
refa	appointment
randevù	appointment
apressar	appreciate
riconossensa	appreciation
metodo	approach
abordo	approach
vissinamento	approach
aproprià	appropriate
aprovassion	approval
aprovar	approve
avprovà	approved
ben o mal	approximately
scuasi	approximately
avril	april
april	april
arbitrario	arbitrary
architeto	architect
architetura	architecture
archiviar	archive
i xe	are
le xe	are
son	are
te si	are you
ti te si	are you
sie	are you
te si inpegnà	are you busy
sito maridà	are you married
sito maridà o no	are you married or single
Ghe sito oncora?	Are you still there?
sito là	are you there
zona	area
area	area
discùtar	argue
dibàtar	argue
discussion	argument
levar	arise
levarse	arise
brasso	arm
armada	army
torno	around
sistemar	arrange
sistemassion	arrangement
arivo	arrival
rivo	arrival
traguardo	arrival
rivar	arrive
rivà	arrived
rogante	arrogant
altero	arrogant
frecia	arrow
arte	art
artìgolo	article
artifissial	artificial
artista	artist
come	as
purché	as long as
anca	as well
e anca	as well as
senare	ash
vergognarse	ashamed
dimandar	ask
dimandà	asked
indormensà	asleep
speto	aspect
siera	aspect
Assamese	Assamese
ataco	assault
assalto	assault
raduno	assembly
assertivo	assertive
valutar	assess
valutassion	assessment
ben	asset
beni	assets
assegnar	assign
mestiero	assignment
assistar	assist
assistente	assistant
colega	associate
associà	associated
associassion	association
metar che	assume
suponer	assume
assunsion	assumption
a	at
almanco	at least
magnà	ate
atleta	athlete
alegar	attach
alegà	attached
alegà	attachment
ataco	attack
prova	attempt
assistar	attend
presensa	attendance
atension	attention
ocio	attention
sèsto	attitude
senejamento	attitude
inpostadura	attitude
tirar	attract
atrassion	attraction
interessante	attractive
atributo	attribute
piòvego	audience
pùblico	audience
agosto	august
àmia	aunt
amieta	aunty
vero	authentic
auténtego	authentic
autor	author
autorità	authority
otuno	autumn
disponibile	available
media	average
evitar	avoid
svejo	awake
premio	award
consapevole	aware
consapevolessa	awareness
via	away
grandioso	awesome
tremendo	awful
intrigà	awkward
insanpà	awkward
Aymara	Aymara
putelo	baby
scapolo	bachelor
madègo	bachelor
schena	back
fondo	background
cativo	bad
borsa	bag
esca	bait
cusinar	bake
panetaria	bakery
bicarbonà	baking soda
ecuilìbrio	balance
bala	ball
Bambara	Bambara
banana	banana
grupo	band
banda	band
colpo	bang
susta	bang
banca	bank
bar	bar
ostaria	bar
apena	barely
apena apena	barely
afare	bargain
sbajamento	bark
sbajada	bark
orzo	barley
bariera	barrier
base	base
basà	based
soteràneo	basement
basilare	basic
praticamente	basically
basegò	basil
basìlico	basil
bastardo	bastard
loto	batch
bagno	bath
bagno	bathroom
batarìa	battery
bataja	battle
calanca	bay
atento	be careful
spiaja	beach
rajo	beam
fasoli	beans
sostegner	bear
barba	beard
portamento	bearing
bestia	beast
bàtito	beat
belo	beautiful
belessa	beauty
deventà	became
parché	because
deventar	become
leto	bed
camara da leto	bedroom
ava	bee
manzo	beef
xe stà	been
bira	beer
prima	before
scomissià	began
scomissiar	begin
prinsìpio	beginning
conportarse	behave
conportamento	behavior
conportamento	behaviour
drio	behind
credensa	belief
crédar	believe
pansa	belly
apartegner	belong
spetar	belong
amà	beloved
soto	below
sintura	belt
sengia	belt
panchina	bench
piegar	bend
soto	beneath
vantajo	benefit
vantaji	benefits
inazonta	beside
in pi'	beside
infinamente	beside
inazonta	besides
in pi'	besides
infinamente	besides
mejo	best
bona fortuna	best of luck
cordiali saludi	best regards
mejo	better
fra	between
bevanda	beverage
oltre	beyond
Bhojpuri	Bhojpuri
propension	bias
parsiale	biased
bicecreta	bicycle
ofrir	bid
grando	big
bici	bike
banconota	bill
ligar	bind
oselo	bird
conpleano	birthday
tocheto	bit
morsegon	bite
amaro	bitter
nero	black
lama	blade
colpa	blame
vodo	blank
coverta	blanket
sciopo	blast
sciopada	blast
candejina	bleach
smissiar	blend
benedission	bless
benedìo	blessed
cioro	blind
zoja	bliss
bloco	block
sangue	blood
fiore	bloom
supion	blow
blu	blue
celeste	blue
spontà	blunt
sgussà	blunt
asse	board
barca	boat
corpo	body
bojar	boil
temerario	bold
sbrenà	bold
francon	bold
ligame	bond
ligamento	bond
osso	bone
libro	book
urton	boost
amplifegador	booster
stivale	boot
stivali	boots
confin	border
insustar	bore
smonar	bore
stufar	bore
smonà	bored
insustà	bored
stufà	bored
noioso	boring
nassesto	born
tore in prèstio	borrow
cao	boss
testa	boss
tuti do	both
fastidiar	bother
butilia	bottle
fondo	bottom
cronpà	bought
rinbalsar	bounce
direto	bound
limiti	boundaries
repeton	bow
prostinò	bow
scuela	bowl
scòfina	bowl
scatola	box
toso	boy
conpagno	boyfriend
stesso	boyfriend
moroso	boyfriend
brassaleto	bracelet
servelo	brain
rama	branch
marca	brand
corajoso	brave
sbrego	breach
vèrta	breach
pan	bread
pausa	break
colassion	breakfast
sen	breast
fià	breath
respiro	breath
fià	breathe
respiro	breathe
rassa	breed
maton	brick
sposa	bride
ponte	bridge
curto	brief
slusente	bright
fantàstego	brilliant
fenomenale	brilliant
portar	bring
frà	bro
largo	broad
trasmétar	broadcast
roto	broke
spacà	broke
roto	broken
spacà	broken
scoa	broom
fradelo	brother
cognà	brother in law
portà	brought
maron	brown
spàssola	brush
secia	bucket
conpagno	buddy
stesso	buddy
moroso	buddy
stansiamento	budget
pian finansiario	budget
fabisogno	budget
bao	bug
costruir	build
stabile	building
costruìo	built
sfuso	bulk
toro	bull
bulo	bully
goba	bump
grupo	bunch
pacheto	bundle
fardelo	burden
interà	buried
sepelìo	buried
brusada	burn
scotada	burn
sciopar	burst
interar	bury
sepelir	bury
coriera	bus
savàsco	bush
javascaro	bush
afari	business
busto	bust
ocupà	busy
ma	but
butiro	butter
paveja	butterfly
pavejo	butterfly
pavela	butterfly
boton	button
cronpar	buy
da	by
par via	by the way
a proposito	by the way
ciao	bye
cavolo	cabbage
armareto	cabinet
gabia	cage
torta	cake
pupola	calf
ciamada	call
ciamame	call me
ciamà	called
calma	calm
vegnesto	came
canpagna	campaign
pol	can
Anula	Cancel
cancaro	cancer
bon	capable
capassità	capacity
capitale	capital
didascalia	caption
caturar	capture
machina	car
cariera	career
atento	careful
co atension	carefully
sensa cura	careless
premuroso	caring
scuérariolo	carpenter
muraro	carpenter
tapeo	carpet
carota	carrot
trasportar	carry
continua	carry on
far	carry out
custodia	case
contanti	cash
cast	cast
castelo	castle
informale	casual
gato	cat
ciapar	catch
tor	catch
categoria	category
bestian	cattle
ciapà	caught
tolesto	caught
causa	cause
atension	caution
ocio	caution
retenùdo	cautious
retegnesto	cautious
grota	cave
covolo	cave
finir	cease
sofito	ceiling
selebrar	celebrate
sélula	cell
sentro	center
secolo	century
sereale	cereal
serimònia	ceremony
serto	certain
serto	certainly
sertiffegà	certificate
cadena	chain
carega	chair
sfida	challenge
possibilità	chance
modifegar	change
casin	chaos
caos	chaos
personajo	character
caraterìsteghe	characteristics
carga	charge
beneficensa	charity
un incanto	charming
fassinante	charming
gràfego	chart
ndar drio	chase
corar drio	chase
conversassion	chat
econòmego	cheap
tradir	cheat
inbrojar	cheating
controlo	check
massela	cheek
tifar	cheer
soridente	cheerful
grassie	cheers
formajo	cheese
chìmega	chemistry
apressar	cherish
scachi	chess
peto	chest
mastegar	chew
polastro	chicken
cao	chief
testa	chief
putelo	child
infànsia	childhood
puteli	children
fredo	chill
camini	chimneys
sbèssola	chin
ciocolata	chocolate
sielta	choice
dessidar	choose
sérnir	choose
tajar	chop
mestieri	chores
paciocoto	chubby
cesa	church
canela	cinnamon
sercio	circle
circostanse	circumstances
sitadin	citizen
sità	city
afermassion	claim
ciarir	clarify
classe	class
creda	clay
neto	clean
ciaro	clear
comesso	clerk
furbo	clever
cliente	client
scojera	cliff
clima	climate
ranpegar	climb
rovegar	climb
aderente	clingy
relojo	clock
sarà	close
armaro	closet
mantelo	cloth
vestidi	clothes
nuvola	cloud
nuvoloso	cloudy
pajasso	clown
indissio	clue
magogo	clumsy
gofo	clumsy
pantalon	clumsy
recin	cluster
carossa	coach
carbon	coal
costa	coast
paltò	coat
jubeto	coat
cafè	coffee
cognitivo	cognitive
coincidensa	coincidence
fredo	cold
colassar	collapse
coleto	collar
colega	colleague
coleghi	colleagues
colessionar	collect
colession	collection
università	college
color	color
idee ecolojiche sensa color dorme furiosamente	colorless green ideas slept furiously
color	colour
colona	column
pètane	comb
conbinassion	combination
conbinà	combine
vegner	come
vien qua	come here
dè	come on
dai	come on
comodità	comfort
còmodo	comfortable
confortevole	comfortable
rivar	coming
drio rivar	coming soon
comando	command
comento	comment
reclan	commercial
comission	commission
inpegnarse	commit
inpegno	commitment
inpegnà	committed
marcansìa	commodity
comun	common
comunegar	communicate
comunicassion	communication
comunità	community
far el pendolare	commute
conpagno	companion
stesso	companion
moroso	companion
asienda	company
confrontar	compare
confronto	comparison
conpassion	compassion
conpassionevole	compassionate
conpatibile	compatible
conpètar	compete
conpetente	competent
conpetission	competition
conpetitivo	competitive
reclamar	complain
lamento	complaint
conpletamento	complement
conpletar	complete
finir	complete
conpletamente	completely
banda	complex
elaborà	complex
difissile	complex
rispeto	compliance
conplicà	complicated
conplimento	compliment
otenperar	comply
conposission	composition
conposto	compound
conprension	comprehension
finìo	comprehensive
conpromesso	compromise
obligatorio	compulsory
computer	computer
consentrar	concentrate
idea	concept
preocupassion	concern
preocupà	concerned
banda	concert
conclusion	conclusion
fine	conclusion
semento	concrete
condission	condition
condission	conditions
portar	conduct
conferensa	conference
confessar	confess
fiducia	confidence
seguro	confident
confermar	confirm
conflito	conflict
scontro	conflict
inocà	confused
inturbià	confused
stranìo	confused
confusion	confusion
congratulassion	congrats
congratulassion	congratulation
congratulassion	congratulations
conjunsion	conjunction
conétar	connect
conchistar	conquer
cossiente	conscious
cossiensa	consciousness
parmesso	consent
conseguense	consequences
conservassion	conservation
conservativo	conservative
càlcola	consider
consìdera	consider
considerà	considered
calcolà	considered
èssar fato	consist
coerensa	consistency
coerente	consistent
costante	constant
sensa fermarse	constantly
costipassion	constipation
costrussion	construction
consumar	consume
consumo	consumption
contato	contact
contajoso	contagious
contegner	contain
contien	contains
ga drento	contains
contenporaneo	contemporary
dispresso	contempt
contegnesto	content
concorso	contest
contesto	context
continente	continent
ndar vanti	continue
continuar	continue
contratto	contract
contrasto	contrast
contribuir	contribute
contributo	contribution
controlo	control
controverso	controversial
comodità	convenience
comodo	convenient
conversassion	conversation
convertìo	convert
comunegar	convey
convìnsar	convince
convinto	convinced
cogo	cook
cusinar	cooking
fresco	cool
coperassion	cooperation
superar	cope
rame	copper
sentro	core
formenton	corn
angolo	corner
coreto	correct
costo	cost
costume	costume
costumansa	costume
caseta	cottage
bombaso	cotton
divan	couch
tossir	cough
consejo	council
contejo	count
bancon	counter
Stado	country
canpagna	countryside
copia	couple
corajo	courage
rota	course
spacà	course
tribunale	court
cortesìa	courtesy
zentilessa	courtesy
zerman	cousin
covertura	cover
vaca	cow
vacon	coward
potifon	coward
comodo	cozy
ospitale	cozy
piassevole	cozy
granso	crab
crepa	crack
mestiero	craft
lavoro	craft
caca	crap
tonada	crash
scioco	crash
bramar	craving
gatonar	crawl
mato	crazy
crear	create
creativo	creative
credito	credit
slipegoso	creep
oribile	creepy
ecuipajo	crew
crimine	crime
ingropante	cringe
intrapelante	cringe
inbarassante	cringe
crisi	crisis
criterio	criteria
fondamentale	critical
crìdega	criticism
racolto	crop
sunà	crop
coltivassion	crops
crose	cross
corvo	crow
zente	crowd
folà	crowded
pien	crowded
corona	crown
sentrale	crucial
crudele	cruel
crosara	cruise
calca	crush
piànzar	cry
cocómaro	cucumber
còcola	cuddle
cultura	culture
infame	cunning
subdolo	cunning
copa	cup
credensa	cupboard
còrdolo	curb
cura	cure
sarada	curfew
curiosità	curiosity
curioso	curious
risso	curly
valuta	currency
atuale	current
al momento	currently
atualmente	currently
maledission	curse
tenda	curtain
cussin	cushion
personalisà	custom
cliente	customer
abitudini	customs
usi	customs
costumanse	customs
tajo	cut
còcolo	cute
siclo	cycle
siclismo	cycling
bissecreta	cycling
popà	dad
popà	daddy
zornaliero	daily
latesini	dairy
diga	dam
dano	damage
danà	damn
ùmedo	damp
balo	dance
pericolo	danger
pericoloso	dangerous
scuro	dark
caro	darling
còrar	dash
dati	data
dài	data
data	date
dà	date
fiola	daughter
zorno	day
dì	day
morto	dead
scadensa	deadline
sordo	deaf
afare	deal
caro	dear
Cari tuti	Dear All
Stimado cliente	Dear Customer
Cari pari	Dear Parents
Stimado sior	Dear Sir
Cari studenti	Dear students
Cari coleghi	Dear Team
Cara scuadra	Dear Team
morte	death
discùtar	debate
dibàtar	debate
adebito	debit
tochi	debris
debito	debt
dessènio	decade
deconposission	decay
morto	deceased
gabanar	deceive
busarar	deceive
zavajar	deceive
dissenbre	december
dessente	decent
dessidar	decide
dessiso	decided
dessision	decision
ponte	deck
refudar	decline
calar	decrease
dedicà	dedicated
dedission	dedication
ato	deed
fondo	deep
servo	deer
predefinìo	default
sconfita	defeat
difendar	defend
definir	define
dessìdar	define
seguro	definitely
definission	definition
làurea	degree
ritardo	delay
ritardà	delayed
canselar	delete
delibarar	deliberate
delicà	delicate
delissioso	delicious
piassere	delight
contentìssimo	delighted
consegnar	deliver
consegnà	delivered
consegna	delivery
dimanda	demand
fadigoso	demanding
democrassia	democracy
demònio	demon
dimostrar	demonstrate
negà	denied
densità	density
dentista	dentist
refudar	deny
departamento	department
partensa	departure
dipéndar	depend
scerar	deploy
deposito	deposit
magasin	deposit
depresso	depressed
depression	depression
profondità	depth
descrìvar	describe
descrission	description
deserto	desert
meritar	deserve
projeto	design
designassion	designation
desiderio	desire
voja	desire
tola	desk
desperassion	despair
desperà	desperate
anpò	despite
paraltro	despite
dolse	dessert
destinassion	destination
destin	destiny
desfar	destroy
distrussion	destruction
detajo	detail
detaji	details
individuar	detect
determinassion	determination
determinar	determine
determinà	determined
devastà	devastated
svilupar	develop
svilupà	developed
svilupo	development
dispositivo	device
demònio	devil
pio	devoted
Divehi	Dhivehi
diabete	diabetes
diarea	diarrhea
diario	diary
dissionario	dictionary
galepin	dictionary
colorar	die
morto	died
dieta	diet
difarensa	difference
difarente	different
difissile	difficult
scavar	dig
dignità	dignity
bravo	diligent
coreto	diligent
dilijente	diligent
sena	dinner
vale	dip
direto	direct
diression	direction
rejista	director
tera	dirt
onto	dirty
disativar	disable
disabile	disabled
sparir	disappear
deluso	disappointed
desastro	disaster
scartar	discard
descargar	discharge
dissiplina	discipline
sconto	discount
scuajar	discover
descovèrzar	discover
discriminassion	discrimination
discùtar	discuss
discussion	discussion
malano	disease
malatia	disease
malatie	diseases
malani	diseases
travestirse	disguise
desgustante	disgusting
piato	dish
piati	dishes
licensiar	dismiss
inviar	dispatch
schermo	display
eliminassion	disposal
canselassion	disposal
barufa	dispute
bega	dispute
distansa	distance
difarente	distinct
diferensià	distinct
diferensiar	distinguish
sernir	distinguish
pericolo	distress
distribussion	distribution
distreto	district
disturbar	disturb
fosso	ditch
tufo	dive
difarente	diverse
diversità	diversity
divìdar	divide
divin	divine
divòrsio	divorce
stordìo	dizzy
ti te fè	do you
te me voli ben	do you love me
te me ami	do you love me
dotor	doctor
documento	document
can	dog
Dogri	Dogri
far	doing
banbola	doll
piàvola	doll
domìnio	domain
doméstego	domestic
dominante	dominant
no	don't
non	don't
No sta preocuparte	Don't worry
donar	donate
fato	done
musso	donkey
figo	dope
dopio	double
dubio	doubt
inpasto	dough
zo	down
descargar	download
bossa	draft
strassinar	drag
susto	drain
descargo	drain
descarga	drain
drama	drama
pata	draw
parejo	draw
casseto	drawer
disegnar	drawing
timore	dread
insònio	dream
vestido	dress
àbito	dress
tràpano	drill
bevanda	drink
guida	drive
jossa	drop
lassà cascar	dropped
secura	drought
arsura	drought
inbriago	drunk
ciuco	drunk
seco	dry
arna	duck
tipo	dude
dovesto	due
dovesto a	due to
par via de	due to
monòtono	dull
mona	dumb
bauco	dumb
semo	dumb
descargar	dump
durada	duration
durante	during
polvare	dust
aver da	duty
dovere	duty
ripensar	dwell
morir	dying
ogni	each
uno co chelaltro	each other
inpassiente	eager
àgola	eagle
recia	ear
prima	earlier
presto	early
bonora	early
guadagnar	earn
recie	ears
tera	earth
teremoto	earthquake
fassilità	ease
senplissità	ease
fàssile	easily
levante	east
est	east
fàssile	easy
magnar	eat
magnar	eating
econòmego	economic
economia	economy
bordo	edge
modìfega	edit
educassion	education
efeto	effect
eficasse	effective
eficensa	efficiency
eficente	efficient
sforso	effort
vovo	egg
melansana	eggplant
ego	ego
oto	eight
disdoto	eighteen
otanta	eighty
gnanca	either
elaborar	elaborate
gòmio	elbow
pi' vecio	elder
vecioti	elderly
ansiani	elderly
fin	elegant
stilè	elegant
elegante	elegant
elemento	element
liofante	elephant
ùndese	eleven
adato	eligible
bon	eligible
eliminar	eliminate
canselar	eliminate
altro	else
intrapelà	embarrassed
inbarassà	embarrassed
ingropà	embarrassed
ingropante	embarrassing
intrapelante	embarrassing
inbarassante	embarrassing
inbrassar	embrace
strucar	embrace
vegner fora	emerge
vegner su	emerge
emerjensa	emergency
emotivo	emotional
enpatia	empathy
ènfasi	emphasis
enfatisar	emphasize
dipendente	employee
dipendenti	employees
paron	employer
lavoro	employment
inpiego	employment
vodo	empty
abilitare	enable
incontro	encounter
incorajar	encourage
fin	end
fine	end
in via de estinsion	endangered
inpresa	endeavor
resistensa	endurance
soportar	endure
nemigo	enemy
enerjia	energy
interessar	engage
moroso	engaged
trasporto	engagement
motore	engine
ingegnero	engineer
inglese	English
mejorar	enhance
divèrtate	enjoy
enorme	enormous
assè	enough
segurarse	ensure
ndar drento	enter
entrar	enter
intratenimento	entertainment
entusiasmo	enthusiasm
entusiasta	enthusiastic
intiero	entire
co dirito	entitled
entità	entity
entrà	entrance
entrada	entrance
inprenditore	entrepreneur
busta	envelope
anbiente	environment
àstio	envy
invidia	envy
èpico	epic
epidemia	epidemic
conpagno	equal
atressadura	equipment
capitale	equity
ecuivalente	equivalent
goma	eraser
eror	error
scanpar	escape
spessialmente	especially
savio	essay
sostansa	essence
essensiale	essential
stabilir	establish
dessìdar	establish
consolidà	established
canpagnona	estate
tegnesta	estate
stima	estimate
stimà	estimated
ec.	etc
eterno	eternal
etica	ethics
valutar	evaluate
valutassion	evaluation
pari	even
anca se	even though
sera	evening
evento	event
ala fine	eventually
par ultimo	eventually
mai	ever
ogni	every
tuti	everybody
tuti	everyone
tuto	everything
prova	evidence
cativo	evil
evolussion	evolution
evòlvar	evolve
Ewe	Ewe
passà	ex
ex	ex
vecio	ex
esato	exact
justo	exact
esato	exactly
justo	exactly
esame	exam
esaminar	examine
esenpio	example
esajerar	exceed
speciale	excellent
esselente	excellent
via che	except
via	except
fora che	except
ecession	exception
esajerassion	excess
esajerà	excessive
scanbio	exchange
emossionà	excited
ajitassion	excitement
emossionante	exciting
esclusivo	exclusive
scusa	excuse
el me scusa	excuse me
la me scusa	excuse me
far	execute
esecussion	execution
dirijente	executive
esercissio	exercise
marmita	exhaust
stratolto	exhausted
opera	exhibit
mostra	exhibition
esìstar	exist
esistensa	existence
esistente	existing
ussida	exit
svodo	exit
slargar	expand
spetarse	expect
spetà	expected
spese	expenses
caro	expensive
esperiensa	experience
esperimento	experiment
prova	experiment
esperto	expert
scadesto	expired
spiegar	explain
spiegassion	explanation
sfrutar	exploit
esplorar	explore
esportar	export
mostrar	expose
mostrà	exposed
esposission	exposure
esprìmar	express
espression	expression
slongar	extend
largo	extended
estension	extension
entità	extent
fora	external
esterno	external
estinto	extinct
extra	extra
estrato	extract
fenomenale	extraordinary
maravejoso	extraordinary
estremo	extreme
estremamente	extremely
ocio	eye
oci	eyes
tesùo	fabric
felpa	fabric
fantàstego	fabulous
favoloso	fabulous
fenomenale	fabulous
facia	face
muso	face
fassilitar	facilitate
stabili	facilities
struture	facilities
stabile	facility
strutura	facility
fato	fact
fator	factor
fàbrica	factory
fati	facts
sbiavir	fade
falimento	fail
falìo	failed
falimento	failure
svegner	faint
justo	fair
ecuamente	fairly
fada	fairy
fede	faith
fedele	faithful
finto	fake
calo	fall
tónbola	fall
rabalton	fall
fama	fame
famejar	familiar
fameja	family
fame	famine
famoso	famous
tifoso	fan
fin	fancy
stilè	fancy
elegante	fancy
fantàstego	fantastic
fenomenale	fantastic
lontan	far
licensiamento	farewell
fatoria	farm
contadin	farmer
agricoltor	farmer
un incanto	fascinating
fassinante	fascinating
moda	fashion
rapido	fast
sèlere	fast
grasso	fat
mortale	fatal
destin	fate
pare	father
fadiga	fatigue
colpa	fault
preferìo	favorite
piasser	favour
preferìo	favourite
paura	fear
bancheto	feast
piuma	feather
caraterìstega	feature
funsionalità	features
febraro	february
esasperà	fed up
tarifa	fee
varnar	feed
nudrir	feed
nudrigar	feed
opinion	feedback
sentir	feel
sensassion	feeling
pie	feet
tirar xo	fell
desmoralisar	fell
conpagno	fellow
stesso	fellow
moroso	fellow
feltro	felt
fémena	female
sarajo	fence
fèrtile	fertile
festival	festival
ciapar	fetch
tor	fetch
fevre	fever
pochi	few
manco	fewer
moroso	fiance
finsion	fiction
canpo	field
cativo	fierce
cuìndase	fifteen
sincuanta	fifty
conbatimento	fight
conbatar	fighting
sifra	figure
capir	figure out
àlbun	file
inpienar	fill
inpienà	filled
pelicola	film
lurido	filthy
ala fine	finally
par ultimo	finally
finansa	finance
finansiario	financial
catar	find
scuajar	find out
descovèrzar	find out
fin	fine
sotile	fine
deo	finger
finir	finish
finìo	finished
fogo	fire
dita	firm
primo	first
nome	first name
pesse	fish
in forma	fit
sincue	five
solussionar	fix
risolvar	fix
fissà	fixed
gonfalon	flag
bandiera	flag
sciantiso	flash
apartamento	flat
difeto	flaw
inpecabile	flawless
scanpar	flee
carne	flesh
còcia	flew
rede	flew
baligoto	flew
flètar	flex
flessibile	flexible
volo	flight
roversar	flip
farghe amor	flirt
farghe amor	flirting
galesar	float
galejar	float
aluvion	flood
pavimento	floor
farina	flour
flusso	flow
fiore	flower
fevre	flu
fluente	fluent
fluentemente	fluently
mòrbio	fluffy
molesin	fluffy
delicà	fluffy
fluido	fluid
lisso	fluid
volar	fly
fulcro	focus
sentro	focus
caligo	fog
burana	fog
nebia	fog
caligoso	foggy
piega	fold
zente	folks
sevitar	follow
ndar drio	follow
visita de controlo	follow up
sevitar	following
ndar drio	following
magnar	food
mona	fool
bauco	fool
semo	fool
bauco	foolish
pandolo	foolish
senpio	foolish
pie	foot
scarpà	football
balon	football
par	for
Par esenpio	For example
par esenpio	for instance
par ti	for you
proibìo	forbidden
forsa	force
prevision	forecast
fronte	forehead
foresto	foreign
foresta	forest
bosco	forest
par senpre	forever
desmentegar	forget
perdonar	forgive
desmentegà	forgot
piron	fork
modulo	form
formale	formal
passà	former
ex	former
vecio	former
fortunadamente	fortunately
fortuna	fortune
cuaranta	forty
cuaranta do	forty-two
vanti	forward
adotivo	foster
conbatù	fought
conbatesto	fought
catà	found
fondassion	foundation
cuatro	four
cuatòrdese	fourteen
volpe	fox
tènaro	fragile
sfràsolo	fragile
cornisa	frame
stabile	framework
strutura	framework
ladrada	fraud
mato	freak
lìbaro	free
libartà	freedom
injelar	freeze
conjelar	freeze
frecuensa	frequency
frecuente	frequent
spesso	frequently
fresco	fresh
venare	friday
frigo	fridge
amigo	friend
benvojente	friendly
amigo	friendly
amighi	friends
amistà	friendship
spaventà	frightened
spaventoso	frightening
rana	frog
da	from
fronte	front
injelà	frozen
conjelà	frozen
fruta	fruit
frustrà	frustrated
carburante	fuel
Fulah	Fulfulde
pien	full
divertente	fun
funsion	function
fondamentale	fundamental
funerale	funeral
divertente	funny
pelissa	fur
furioso	furious
mobili	furniture
pi' lontan	further
inazonta	furthermore
in pi'	furthermore
infinamente	furthermore
futuro	future
crèssita	gain
zogo	game
spàssio	gap
garaje	garage
refudi	garbage
vansaure	garbage
zardin	garden
ajo	garlic
cancelo	gate
rancurar	gather
tor su	gather
tirar su	gather
raduno	gathering
calibro	gauge
dato	gave
dà	gave
atressadura	gear
zénare	gender
zenerale	general
in zenerale	generally
zenerar	generate
zenerassion	generation
zeneroso	generous
jenio	genius
zénare	genre
zentile	gentle
vero	genuine
sesto	gesture
ciapar	get
tor	get
vestirse	get dressed
alsarse	get up
riciàpate presto	get well soon
stame ben	get well soon
ciapar	getting
tor	getting
fantasma	ghost
imàjine fantasma	ghosting
mirajo	ghosting
enorme	giant
regalo	gift
pensiero	gift
tàmaro	ginger
zenzaro	ginger
tosa	girl
conpagna	girlfriend
morosa	girlfriend
stessa	girlfriend
dar	give
molar	give up
réndarse	give up
dato	given
dà	given
contento	glad
ociada	glance
vero	glass
ociali	glasses
luse	glimpse
penonbra	glimpse
globale	global
fastidioso	gloomy
biso	gloomy
piovoso	gloomy
guanti	gloves
lusor	glow
rilùser	glow up
cola	glue
va'	go
va vanti	go ahead
va via	go away
va in leto	go to bed
obietivo	goal
obietivi	goals
càvara	goat
dio	god
dio te benediga	god bless you
va	goes
ndar	going
ndar	going to
oro	gold
assente	gone
sta par	gonna
sostansa slìpega	goo
ben	good
bona jornada	good afternoon
ciao	good bye
bon dì	good day
bona jornada	good day
bonasera	good evening
bel lavoro	good job
belo	good looking
bona fortuna	good luck
bondì	good morning
bonjorno	good morning
bondì amor mio	good morning my love
bona note	good night
ciao	goodbye
sani	goodbye
bonanote	goodnight
beni	goods
Google	Google
Google tradutor	Google Translate
oca	goose
spetacolar	gorgeous
ciàcole	gossip
finisso	got it
capìo	got it
governo	government
guantar	grab
brincar	grab
grado	grade
gradualmente	gradually
laureà	graduate
granela	grain
consédar	grant
serto	granted
ua	grapes
guantar	grasp
brincar	grasp
erba	grass
otenudo	grateful
gratitudine	gratitude
tonba	grave
biso	gray
fantàstego	great
fenomenale	great
peociaria	greed
tegnaria	greed
peòcio	greedy
verde	green
saludar	greet
saludar	greeting
saludi	greetings
biso	grey
grela	grid
luto	grief
polverisar	grind
pìssego	grip
presa	grip
guantada	grip
alimentari	grocery
sposo	groom
lordo	gross
teren	ground
grupo	group
cressar	grow
créssita	growth
iritabile	grumpy
Guaranì	Guarani
garantir	guarantee
vardian	guard
vàrdia	guard
indovinar	guess
ospite	guest
guida	guidance
guida	guide
colpevole	guilty
tipo	guy
tosi	guys
palestra	gym
abitudine	habit
uso	habit
costumansa	habit
habitat	habitat
anbiente	habitat
avesto	had
tenpesta	hail
brisa	hail
caveji	hair
mesa	half
metà	half
coridoio	hall
man	hand
manisa	handle
maneta	handle
belo	handsome
picar	hang
passar del tenpo insieme	hang out
nàssar	happen
sucédar	happen
capitar	happen
resultado	happened
fortuna	happened
vitòria	happened
felissità	happiness
contentessa	happiness
contento	happy
bon conpleano	happy birthday
tanti auguri a ti	happy birthday to you
bon ano	happy new year
difissile	hard
difissilmente	hardly
scuasi mai	hardly ever
dano	harm
danoso	harmful
armonia	harmony
duro	harsh
racolto	harvest
sunà	harvest
ga	has
odio	hate
ver	have
bon dì	have a good day
bona jornada	have a good day
bon dì	have a nice day
bona jornada	have a nice day
far colassion	have breakfast
divertirse	have fun
gheto magnà	have you eaten
ver	having
pericolo	hazard
foschia	haze
elo	he
elo el ga	he has
el ga	he has
elo el xe	he is
el xe	he is
testa	head
mal de testa	headache
guarir	heal
guarir	healing
sanità	health
salute	health
sanacapàna	health
saludar	healthy
sentir	hear
sentì	heard
core	heart
calor	heat
paradiso	heaven
pesante	heavy
farnèdego	hectic
altessa	height
erede	heir
ladrada	heist
tegner	held
inferno	hell
Ciao	Hello
ciao, caro	hello dear
ciao come steto	hello how are you
ciao, come steto	hello how are you doing
casco	helmet
ajuto	help
utile	helpful
cuindi	hence
ela	her
ciapo	herd
cuà	here
eredità	heritage
spetar	hesitate
esitar	hesitate
Ou	Hey
Ciao	Hi
ciao, come steto	hi how are you
Ou	Hi there
sconto	hidden
scondar	hide
jerarchia	hierarchy
alto	high
evidensiar	highlight
escursion	hike
escursionismo	hiking
spassoso	hilarious
cole	hill
elo	him
consejo	hint
anca	hip
anca	hips
assumar	hire
assumar	hiring
so	his
soo	his
storia	history
colpo	hit
susta	hit
Mmm	Hmm
passatenpo	hobby
tegner	hold
spetar	hold on
buso	hole
vacansa	holiday
vodo	hollow
casa	home
mestieri	homework
onesto	honest
galantomo	honest
a dirla tuta	honestly
miele	Honey
onore	honor
capusso	hood
ganso	hook
saltussar	hop
saltelar	hop
speransa	hope
se tuto va ben	hopefully
sensa speransa	hopeless
orisontale	horizontal
corno	horn
oribile	horrible
orore	horror
cavalo	horse
ospedale	hospital
ospitalità	hospitality
condutor	host
ostile	hostile
caldo	hot
albergo	hotel
ora	hour
ore	hours
casa	house
fameja	household
come	how
e ti	how about you
come steto	how are you
come xela	how are you doing
come vala	how are you doing
come steto ancuo	how are you doing today
come steto ancuo	how are you today
come feto	how do you do
come xe	how is
cuanti	how many
cuanto	how much
ogni cuanto	how often
cuanti ani gheto	how old are you
come xela ndà la to jornada	how was your day
come xela ndà la to serada	how was your night
parò	however
sentro	hub
maridin	hubby
strucon	hug
enorme	huge
uman	human
umile	humble
ùmedo	humid
umidità	humidity
sento	hundred
famà	hungry
cassar	hunt
uragan	hurricane
pressa	hurry
mòvate	hurry up
far mal	hurt
marido	husband
trufa	hustle
salvanela	hut
resseto	hut
ijene	hygiene
Mi	I
mi son	I am
sto ben	I am fine
mi posso	I can
no posso	I can't
Mi vojo	I do
no lo so	I do not know
no capisso	I do not understand
mi no	I don't
no so	I don't know
no capisso	I don't understand
no capisso cossa che te intendi	I don't understand what you mean
no te capisso	I don't understand you
no lo so	I don’t know
no capisso	I don’t understand
credo	i guess
mi gavevo	I had
mi go	I have
mi son stà	I have been
lo spero	I hope so
lo so	I know
me piase	I like
te me piasi	I like you
mi amo	I love
mi ghe vojo ben a me fradelo grando	I love my big brother
mi ghe vojo ben a me sorela granda	I love my big sister
mi ghe vojo ben a me pare	I love my father
mi ghe vojo ben a me fradelo picolo	I love my little brother
mi ghe vojo ben a me sorela picola	I love my little sister
mi ghe vojo ben a me mama	I love my mother
Te vojo ben	I love you
te vojo tanto ben	I love you so much
te amo tanto	I love you so much
te vojo ben anca mi	I love you too
te amo anca mi	I love you too
capisso	I mean
vojo dir	I mean
te me manchi	I miss you
te me manchi assè	I miss you so much
capisso	I see
penso	I think
capisso	I understand
vojo	I want
vojo védarte	I want to see you
te vojo	I want you
mi jero	I was
lo farò	I will
mi saria	I would be
mi son	I'm
sto ben	I'm fine
sto ben	I'm good
son cuà	I'm here
me despiase	I'm sorry
jasso	ice
injelà	ice cream
jelato	ice cream
idea	idea
parfeto	ideal
conpagno	identical
identifegar	identify
identità	identity
bauco	idiot
piajon	idle
pegro	idle
scansafadighe	idle
se	if
ignorar	ignore
malà	ill
ilegale	illegal
malano	illness
malatia	illness
Ilocano	Ilocano
imàjine	image
imajinar	imagine
midiato	immediate
midiatamente	immediately
de boto	immediately
imenso	immense
enorme	immense
bota	impact
urto	impact
paca	impact
inpassiente	impatient
inplementar	implement
inportassion	import
inportante	important
inponer	impose
obligar	impose
inpossibile	impossible
inpressionar	impress
inpression	impression
notevole	impressive
mejorar	improve
mejoramento	improvement
inte	in
in	in
inazonta	in addition
in pi'	in addition
infinamente	in addition
efetivamente	In fact
davanti	in front of
par	in order to
al fin de	in order to
inaproprià	inappropriate
insentivo	incentive
insidente	incident
zontar	include
zontar	including
redito	income
inconveniente	inconvenience
crèssita	increase
cressesto	increased
incredibile	incredible
difati	indeed
indipendente	independent
India	India
mostrar	indicate
indicar	indicate
locale	indigenous
indìjeno	indigenous
individuale	individual
setor	industry
inevitabile	inevitable
putelo	infant
infession	infection
infinio	infinity
infiamassion	inflammation
inflassion	inflation
influensa	influence
informar	inform
informassion	information
ingredienti	ingredients
eredità	inheritance
inissiale	initial
inissiativa	initiative
infortunà	injured
infortunio	injury
inossente	innocent
inovassion	innovation
sondajo	inquiry
mato	insane
bao	insect
inseguro	insecure
inpirar	insert
rento	inside
drento	inside
conossensa	insight
tintonar	insist
sevitar	insist
svejarola	insomnia
ispirassion	inspiration
ispirà	inspire
instalar	install
cason	instance
momento	instant
atimo	instant
invesse	instead
invesse de	instead of
istrussion	instructions
meso	instrument
strumento	instrument
insolensa	insult
azenada	insult
seguransa	insurance
intiero	intact
integrità	integrity
inteletuale	intellectual
intelijensa	intelligence
intelijente	intelligent
voler dir	intend
capir	intend
pianifegà	intended
intenso	intense
intension	intention
interajir	interact
interassion	interaction
interesse	interest
interessà	interested
interessante	interesting
interferir	interfere
intermeso	intermediate
interno	internal
internassionale	international
esperiensa	internship
prova	internship
interpretar	interpret
intèrprete	interpreter
interonpar	interrupt
intervista	interview
intimo	intimate
inte	into
in	into
presentar	introduce
presentassion	introduction
introverso	introvert
sarà	introvert
intuission	intuition
no xe valido	invalid
inventar	invent
conta	inventory
inventario	inventory
investir	invest
investigar	investigate
invito	invitation
invito	invite
fatura	invoice
interessar	involve
involto	involved
fero	iron
xe	is
isola	island
isolà	isolated
problema	issue
problemi	issues
elo	it
xe	it is
jera	it was
xe	it's
va ben	it's ok
va ben	It's okay
afare	item
strafanto	item
roba	item
robe	items
strafanti	items
afari	items
so	its
soo	its
Mi son	I’m
jaca	jacket
preson	jail
camaroto	jail
galera	jail
zenaro	January
baràtolo	jar
massela	jaw
zeloso	jealous
bauco	jerk
zojeria	jewelry
lavoro	job
còrar	jogging
unifegar	join
unir	join
artigolassion	joint
scherso	joke
zornalista	journalist
viajo	journey
zoja	joy
zùdese	judge
sugo	juice
lujo	july
salto	jump
zugno	june
scarto	junk
pena	just
falo e basta	just do it
justissia	justice
justifegar	justify
Groenlandese	Kalaallisut
bravo	keen
coreto	keen
dilijente	keen
tegner	keep
continua cossì	keep it up
tegnesto	kept
bojador	kettle
ciave	key
scarpà	kick
balon	kick
putelo	kid
schersar	kidding
rene	kidney
puteli	kids
copar	kill
zénare	kind
ben o male	kinda
zentilmente	kindly
zentilessa	kindness
re	king
baso	kiss
cusina	kitchen
svolanda	kite
bandiera	kite
gatelo	kitten
zanocio	knee
saveva	knew
cortelo	knife
cavaliero	knight
saver	know
conossensa	knowledge
savesto	known
Konkani	Konkani
Krio	Krio
eticheta	label
adesivo	label
bon ton	label
lavoro	labor
fadiga	labour
mancansa	lack
scala	ladder
siora	lady
stesso	laid
lago	lake
gnelo	lamb
lasco	lame
debole	lame
lanpada	lamp
teren	land
panorama	landscape
léngua	language
ghèa	lap
grando	large
ultimo	last
ultimo ma no par inportansa	last but not least
cognome	last name
tardi	late
ultimamente	lately
pi' tardi	later
pi' novo	latest
ultimo	latter
rìdar	laugh
rìdar	laughing
ridada	laughter
sganassada	laughter
tiro	launch
slanso	launch
sbusà	laundry
lìssia	laundry
lese	law
prà	lawn
avogador	lawyer
colegarse	lay
butarse	lay
strato	layer
capa	layer
disposission	layout
piajon	lazy
pegro	lazy
scansafadighe	lazy
portar	lead
cao	leader
testa	leader
foja	leaf
perdita	leak
magro	lean
salto	leap
inparar	learn
inparar	learning
fito	lease
manco	least
pele	leather
foja	leave
foje	leaves
tubo	led
portà	led
sanca	left
ganba	leg
lasso	legacy
eredità	legacy
legale	legal
lesenda	legend
legale	legit
divertimento	leisure
prestar	lend
longhessa	length
manco	less
lession	lesson
lassar	let
létara	letter
latuga	lettuce
livelo	level
leva	leverage
responsabilità	liability
bibioteca	library
lecar	lick
busia	lie
busie	lies
vita	life
assensor	lift
luse	light
saeta	lightning
sciantiso	lightning
piassere	like
probabile	likely
lo stesso	likewise
linea	line
Lingala	Lingala
colegamento	link
leon	lion
lìcuido	liquid
elenco	list
scoltar	listen
scoltar	listening
leteralmente	literally
letaradura	literature
refudi	litter
vansaure	litter
picolo	little
vivar	live
fegato	liver
visela	lives
vivar	living
saloto	living room
sojorno	living room
lusèrtola	lizard
borétola	lizard
risàrdola	lizard
cargo	load
ciopa	loaf
prèstio	loan
locale	local
posission	location
saradura	lock
lasareto	lockdown
confinamento	lockdown
tronco	log
solo	lonely
longo	long
xe tanto che no se vedemo	long time no see
ociada	look
sciara	loop
anelo	loop
sciona	loop
smolà	loose
desfà	loose
sior	lord
pèrdar	lose
perdita	loss
perso	lost
loto	lot
bacanoso	loud
ciassoso	loud
rumoroso	loud
saloto	lounge
amor	love
te vojo ben	love you
te amo	love you
benvojente	lovely
amorevole	lovely
basso	low
inferior	lower
fedele	loyal
lealtà	loyalty
fortuna	luck
fortunà	lucky
Luganda	Luganda
valisa	luggage
bagajo	luggage
grumo	lump
pranso	lunch
polmoni	lungs
lusso	luxury
mentir	lying
màchina	machine
mato	mad
siora	madam
fato	made
revista	magazine
fantàstego	magnificent
fenomenale	magnificent
doméstega	maid
prinsipale	main
mantegner	maintain
manutension	maintenance
Maithili	Maithili
pì che	major
pi' grando	major
majoransa	majority
far	make
truco	make up
mascio	male
sentro comersiale	mall
omo	man
zestir	manage
zestion	management
diretor	manager
obligatorio	mandatory
manifesto	manifest
manipolar	manipulate
maniere	manner
manuale	manual
tanti	many
tante restitussion ndà ben de la jornada	many many happy returns of the day
marcia	march
bordo	margin
possibilità	margin
marcà	market
sposalissio	marriage
maridà	married
màscara	mask
messa	mass
enorme	massive
patronisar	master
fuminante	match
conpagno	mate
stesso	mate
moroso	mate
materiale	material
matemàdega	math
materia	matter
maduressa	maturity
farinela	may
bronbiolar	may
forse	maybe
mi	me
anca mi	me too
pasto	meal
vol dir	mean
senso	meaning
vol dir	means
voleva dir	meant
intanto	meanwhile
mesurar	measure
mesure	measures
carne	meat
dotore	medical
mèdego	medical
medisìna	medicine
meditassion	meditation
meso	medium
medio	medium
incontrar	meet
incontro	meeting
Manipuri	Meiteilon
smolar	melt
desfar	melt
ricordi	memories
memoria	memory
mato	mental
mension	mention
cità	mentioned
mentore	mentor
negossiante	merchant
pietà	mercy
solamente	merely
bon Nadale	merry christmas
casin	mess
caos	mess
messajo	message
disordenà	messy
metalo	metal
maniera	method
sorzi	mice
meso	middle
medio	middle
mesanote	midnight
lisiero	mild
piera miliare	milestone
militare	military
late	milk
milion	million
mente	mind
mentalità	mindset
mio	mine
sossialisar	mingle
minorene	minor
menudo	minute
menudi	minutes
miracolo	miracle
specio	mirror
vario	miscellaneous
malissioso	mischievous
tristo	miserable
trista	miserable
tristessa	misery
mancar	miss
te me manchi	miss you
mancante	missing
mission	mission
caligheto	mist
svarion	mistake
falansa	mistake
sgaro	mistake
Mizo	Mizo
mobile	mobile
rìdar drio	mock
modelo	model
moderà	moderate
moderno	modern
sàvio	modest
ùmedo	moist
umidità	moisture
mufa	mold
rùmola	mole
topinara	mole
ciopinara	mole
mama	mom
momento	moment
atimo	moment
luni	monday
schei	money
schermo	monitor
simia	monkey
mese	month
umor	mood
lunàdego	moody
luna	moon
morale	moral
pi'	more
inazonta	moreover
in pi'	moreover
infinamente	moreover
matina	morning
mutuo	mortgage
pì che	most
pi' grando	most
soratuto	mostly
mare	mother
mossion	motion
motivassion	motivation
montagna	mountain
sorze	mouse
boca	mouth
mossa	move
movimento	movement
cinema	movie
s.ra	mrs
assè	much
tanto	much
fango	mud
cìcara	mug
scoela	mug
muscolo	muscle
museo	museum
fungo	mushroom
mùsica	music
necessità	must
bisogno	must
muto	mute
ressìproco	mutual
mio	my
Caro	My dear
amigo mio	my friend
El me aeroscafo xe pien de bisati	My hovercraft is full of eels
amor mio	my love
me ciamo	my name is
piassere mio	my pleasure
mi stesso	myself
misterioso	mysterious
mistero	mystery
mito	myth
onja	nail
fassiloto	naive
panin	naive
nome	name
conto	narrative
streto	narrow
odioso	nasty
nassionale	national
nassionalità	nationality
locale	native
indìjeno	native
naturale	natural
natura	nature
afano	nausea
fracore	nausea
stomegada	nausea
vissin	near
rente	near
vissin	nearby
rente	nearby
scuasi	nearly
ordenà	neat
comandà	neat
necessario	necessary
colo	neck
colana	necklace
bisogno	need
negativo	negative
sbandonar	neglect
negossiar	negotiate
vissin	neighbor
rente	neighbor
contrà	neighborhood
nissun	neither
nevodo	nephew
sfigà	nerd
nervoso	nervous
gnaro	nest
làsara	net
rede	net
làsara	network
rede	network
neutrale	neutral
mai	never
mai molar	never give up
lassa star	never mind
lassa perdar	never mind
epur	nevertheless
parò	nevertheless
novo	new
notissie	news
prossimo	next
vissin de	next to
rente de	next to
còcolo	nice
piassere de conossarte	nice to meet you
nevodo	niece
note	night
incubo	nightmare
nove	nine
disnove	nineteen
novanta	ninety
No	No
nissun problema	no problem
inpossibile	no way
nissun	nobody
rumore	noise
bacanoso	noisy
ciassoso	noisy
rumoroso	noisy
nissun	none
mesodì	noon
no	nope
né	nor
normale	normal
nord	north
naso	nose
smarà	nostalgic
no	not
non	not
par gnente	not at all
gnanca male	not bad
No desso	Not now
no gnancora	not yet
aponto	note
famoso	noted
gnente	nothing
avertensa	notice
aviso	notice
notà	noticed
nome	noun
nomi	nouns
romanso	novel
novenbre	november
desso	now
al dì de ancuo	nowadays
fastidio	nuisance
nulo	null
insensibile	numb
nùmaro	number
infermiero	nurse
nosa	nut
nosa moscà	nutmeg
nutrission	nutrition
juramento	oath
obesità	obesity
obedir	obey
afare	object
strafanto	object
roba	object
obietivo	objective
obligo	obligation
scuro	obscure
osservassion	observation
osservar	observe
ossessionà	obsessed
ossession	obsession
obsoleto	obsolete
ostacolo	obstacle
otegner	obtain
otegnesto	obtained
ovio	obvious
oviamente	obviously
ogni tanto	occasionally
ocasionalmente	occasionally
mestier	occupation
ocupà	occupied
nassar	occur
capitar	occur
resultado	occurred
fortuna	occurred
vitòria	occurred
càpita	occurs
nasse	occurs
sucede	occurs
mar grando	ocean
ossèano	ocean
otobre	october
strano	odd
dispari	odds
de	of
serto	of course
stuà	off
ofensivo	offensive
oferta	offer
ofìssio	office
ofissiale	official
spesso	often
Oh	Oh
an davero	oh really
petrojo	oil
va ben	ok
bon	ok
va ben, caro	ok dear
va ben, caro	ok honey
va ben amor mio	ok my love
va ben	okay
bon	okay
va ben, caro	okay baby
va ben caro	okay dear
va ben, caro	okay honey
va ben, amor mio	okay my love
vecio	old
so	on
na volta	once
un	one
uno	one
na lengua sola no basta mai	one language is never enough
ségola	onion
in linea	online
solo	only
verto	open
operassion	operation
opinion	opinion
oportunità	opportunities
oportunità	opportunity
oposto	opposite
otimista	optimistic
opsion	option
facoltativo	optional
opur	or
naransa	orange
comanda	order
ordene	order
ordenario	ordinary
organisassion	organization
orientamento	orientation
orìsene	origin
orisenale	original
Oromo	Oromo
orfano	orphan
altro	other
senò	otherwise
aver da	ought
dovere	ought
nostro	our
La nostra mission: permétarghe a chi che sia, ndove che el sia, de capir el mondo e esprìmarse co le lengue.	Our mission: to enable everyone, everywhere to understand the world and express themselves across languages.
La nostra mission: organisar l'informassion mondiale e réndarla utile e acessibile a tutti.	Our mission: to organize the world's information and make it universally accessible and useful.
fora	out
resultado	outcome
canpagnona	outfit
tegnesta	outfit
estroverso	outgoing
pìssego	outlet
presa	outlet
guantada	outlet
contorno	outline
fora	outside
sorprendente	outstanding
forno	oven
pi'	over
là	over there
conplessivamente	overall
superar	overcome
ripensar	overthinking
sorafato	overwhelmed
inarestabile	overwhelming
iresistibile	overwhelming
prepotente	overwhelming
aver da	owe
dovere	owe
aloco	owl
soleta	owl
proprio	own
proprietario	owner
bove	ox
ritmo	pace
paco	pack
pacheto	package
pagà	paid
dolor	pain
pitura	paint
piturà	painting
copia	pair
biso	pale
palido	pale
sbasio	pale
palmo	palm
padela	pan
pandemia	pandemic
panico	panic
braghe	pants
carta	paper
paradiso	paradise
paralelo	parallel
pacheto	parcel
scusa	pardon
zenitori	parents
parco	park
papagà	parrot
parsimolo	parsley
parte	part
partissipar	participate
particolare	particular
particolarmente	particularly
conpagno	partner
festa	party
passar	pass
passajo	passage
superà	passed
passion	passion
passionà	passionate
passivo	passive
parola d'ordene	password
passà	past
tacon	patch
percorso	path
patetico	pathetic
passiensa	patience
passiente	patient
motivo	pattern
pausa	pause
strada	pavement
paga	pay
pagamento	payment
pase	peace
calmo	peaceful
pesca	peach
pèrsego	peach
pico	peak
pera	pear
bisi	peas
particolare	peculiar
pissin	pee
scorsa	peel
pari	peer
pari	peers
pena	pen
làpis	pencil
drio spetar	pending
persone	people
pévaro	pepper
sentir	perceive
percepir	perceive
percession	perception
parfeto	perfect
ressitar	perform
prestassion	performance
forse	perhaps
ponto	period
permanente	permanent
autorisassion	permission
licensa	permit
perseveransa	perseverance
insistente	persistent
persona	person
personale	personal
personalità	personality
prospetiva	perspective
convìnsar	persuade
pervertìo	pervert
animale domèstego	pet
fase	phase
fenòmeno	phenomenon
filosofia	philosophy
telefono	phone
someja	photo
frase	phrase
fìsico	physical
sielta	pick
solevar	pick up
tirar su	pick up
alsar	pick up
imàjine	picture
toco	piece
tochi	pieces
porselo	pig
mascio	pig
toresan	pigeon
colonbo	pigeon
mucio	pile
scafa	pile
pigna	pile
cussin	pillow
pilota	pilot
singanela	pin
pomolin	pin
gucin	pin
ànanas	pineapple
rosa	pink
posso	pit
canpo	pitch
pena	pity
posto	place
posti	places
peste	plague
pian	plain
pian	plan
aereo	plane
pianta	plant
piante	plants
piato	plate
piataforma	platform
opera	play
zugar	playing
piasevole	pleasant
par piassere	please
contento	pleased
piassere	pleasure
inpegno	pledge
assè	plenty
tanto	plenty
trama	plot
spina	plug
àmolo	plum
bronba	plum
fontanaro	plumber
plurale	plural
podcast	podcast
poesia	poem
poesia	poetry
ponto	point
velen	poison
polissia	police
polìdega	policy
educà	polite
incuinamento	pollution
stagno	pond
pissina	pool
caca	poop
poareto	poor
sciopar	pop
popolare	popular
popolassion	population
porselo	pork
mascio	pork
porridge	porridge
porto	port
posission	position
positivo	positive
gaver	possess
possession	possession
possessivo	possessive
possibile	possible
palo	post
rinviar	postpone
patata	potato
potensiale	potential
libra	pound
povertà	poverty
ristretésa	poverty
podere	power
potente	powerful
pratico	practical
pratica	practice
lodar	praise
scherso	prank
pregar	pray
pressioso	precious
pressiso	precise
pressisamente	precisely
antivédar	predict
prevédar	predict
preferir	prefer
preferensa	preference
insinta	pregnant
in stato	pregnant
gràvia	pregnant
prejudissio	prejudice
premesse	premises
premio	premium
preparassion	preparation
pareciar	prepare
parecià	prepared
preposission	preposition
presensa	presence
presente	present
presentassion	presentation
preservar	preserve
presidente	president
pressa	press
pression	pressure
far finta	pretend
còcolo	pretty
prevegner	prevent
pressedente	previous
preda	prey
presso	price
orgojo	pride
prete	priest
prinsipale	primary
prima	prime
prinsipessa	princess
prinsipale	principal
pressedente	prior
priorità	priority
preson	prison
camaroto	prison
galera	prison
intimità	privacy
vita privà	privacy
privà	private
privilejo	privilege
premio	prize
probabilmente	probably
problema	problem
procedura	procedure
ndar vanti	proceed
processo	process
produr	produce
prodoto	product
produssion	production
profession	profession
professionista	professional
profilo	profile
profito	profit
fondo	profound
progresso	progress
projeto	project
noto	prominent
promessa	promise
promovar	promote
promossion	promotion
midiato	prompt
favorevole	prone
propenso	prone
pronomi	pronouns
pronùnsia	pronunciation
prova	proof
aproprià	proper
coretamente	properly
proprietà	properties
proprietà	property
proposta	proposal
prospeto	prospect
prosperità	prosperity
sior	prosperous
protèsare	protect
orgojoso	proud
provar	prove
fornissi	provide
fornìo	provided
provìnsia	province
fornidura	provision
adolessensa	puberty
pubertà	puberty
piòvego	public
pùblico	public
tirar	pull
suca	pumpkin
puntuale	punctual
arlevo	pupil
studiante	pupil
conpra	purchase
puro	pure
viola	purple
fin	purpose
fine	purpose
borsa	purse
ndar drio	pursue
corar drio	pursue
cassa	pursuit
spénzar	push
urtar	push
metar	put
cualificassion	qualification
cualità	quality
cuantità	quantity
cuarantena	quarantine
barufa	quarrel
bega	quarrel
cuarto	quarter
Quechua	Quechua
resina	queen
queer	queer
dimanda	query
dùbio	query
dimanda	question
coa	queue
rapido	quick
sèlere	quick
rapidamente	quickly
trancuilo	quiet
colsara	quilt
piumin	quilt
molar	quit
assè	quite
tanto	quite
zogo a premi	quiz
prova	quiz
citassion	quotation
preventivo	quote
citassion	quotes
conejo	rabbit
conicio	rabbit
gara	race
còlara	rage
fumana	rage
piova	rain
crèssita	raise
cressesto	raised
coresto	ran
corso	ran
casuale	random
gama	range
rapido	rapid
rapidamente	rapidly
raro	rare
raramente	rarely
sfogo	rash
sorze	rat
tasso	rate
pitosto	rather
raporto	ratio
rassionale	rational
crùo	raw
calche	re
scuasi	re
portada	reach
rivà	reached
fato	reached
reassion	reaction
lèsar	read
lèsar	reading
pronto	ready
vero	real
realtà	reality
realisar	realize
realisà	realized
davero	really
posterior	rear
dadrio	rear
rason	reason
rasonevole	reasonable
riciamar	recall
scontrin	receipt
rissevar	receive
rissevesto	received
ressente	recent
ultimamente	recently
ressentemente	recently
ospitalità	reception
asseto	reception
ziera	reception
rèssipe	recipe
risseta	recipe
spericolà	reckless
riconossimento	recognition
riconossar	recognize
consejar	recommend
consejà	recommended
record	record
recuperar	recover
guaria	recovery
retangolo	rectangle
rosso	red
riscatar	redeem
redension	redemption
ridure	reduce
ridondante	redundant
riferir	refer
riferimento	reference
riflètar	reflect
riflesso	reflection
astegnerse	refrain
frigo	refrigerator
rinborso	refund
refudar	refuse
refudà	refused
considerar	regard
calcolar	regard
rispeto	regarding
scrupolo	regarding
attension	regarding
indipendentemente	regardless
rispeti	regards
scrupoli	regards
attension	regards
rejon	region
rejistrar	register
rinpianto	regret
regolar	regular
regolarmente	regularly
refudar	reject
capir	relate
colegà	related
relassion	relationship
parente	relative
parenti	relatives
rilassar	relax
liberatoria	release
rilassà	released
rilevante	relevant
inportante	relevant
afidabile	reliable
solevo	relief
sgravada	relief
aliviar	relieve
alsà	relieved
solevà	relieved
tirà su	relieved
relijon	religion
relijoso	religious
resistente	reluctant
contrario	reluctant
fidarse	rely
restar	remain
che resta	remaining
notevole	remarkable
rimedio	remedy
ricordar	remember
ricordar	remind
promemoria	reminder
distante	remote
remoto	remote
cavar	remove
réndar	render
ritornar	render
fitar	rent
reparar	repair
justar	repair
consar	repair
ripètar	repeat
sostituir	replace
canbiar	replace
risposta	reply
raporto	report
rapresentar	represent
reputassion	reputation
dimanda	request
dimandar	require
obligatorio	required
salvar	rescue
risserca	research
parer	resemble
risentimento	resentment
prenotassion	reservation
prenotar	reserve
residente	resident
dimétarse	resign
resiliensa	resilience
resiliente	resilient
resìstar	resist
resistensa	resistance
proposito	resolution
solussionar	resolve
risolvar	resolve
vilajo turìstego	resort
risorse	resources
rispeto	respect
rispondar	respond
risposta	response
responsabilità	responsibility
responsabile	responsible
resto	rest
riposa in pase	rest in peace
ristorante	restaurant
reparar	restore
justar	restore
consar	restore
limitar	restrict
resultado	result
resultadi	results
curriculum	resume
al detajo	retail
tegner	retain
mantenimento	retention
in pension	retired
retirada	retreat
riportar	retrieve
restituir	return
ritornar	return
pàndar	reveal
revelar	reveal
revelà	revealed
pandesto	revealed
vendeta	revenge
entrà	revenue
entrade	revenue
vegnì drento	revenue
contrario	reverse
recension	review
rivédar	revise
revision	revision
revolussion	revolution
riconpensa	reward
ritmo	rhythm
costola	rib
riso	rice
rìdar	rice
sior	rich
libarar	rid
passajo	ride
ridicolo	ridiculous
coreto	right
desso	right now
trincà	rigid
inbachetà	rigid
duro	rigid
sciara	ring
anelo	ring
sciona	ring
rasentar	rinse
revolta	riot
sbrego	rip
maduro	ripe
crèssar	rise
riscio	risk
rivale	rival
rio	river
fiume	river
strada	road
rosto	roast
stagno	robust
forte	robust
taruso	robust
piera	rock
bara	rod
parte	role
rodolar	roll
teto	roof
stansa	room
raìsa	root
corda	rope
sartìa	rope
marso	rotten
rùspio	rough
calche	roughly
scuasi	roughly
tondo	round
itinerario	route
dindin	routine
cotidianità	routine
fila	row
fregar	rub
russar	rub
goma	rubber
scoasse	rubbish
spassadura	rubbish
maleducà	rude
tapeo	rug
malora	ruin
ruina	ruin
regola	rule
righelo	ruler
regole	rules
còrar	run
còrar	running
rurale	rural
pressa	rush
saco	sack
sacro	sacred
sacrifìssio	sacrifice
seguro	safe
bon volo	safe flight
sicuressa	safety
salvia	sage
dito	said
vela	sail
navegar	sailing
amor	sake
stipendio	salary
vendita	sale
salmon	salmon
sale	salt
stesso	same
Lo stesso cuà	Same here
canpion	sample
rena	sand
sabia	sand
Sanscrito	Sanskrit
sarcàstego	sarcastic
spiritoso	sassy
se ga sentà	sat
sodisfassion	satisfaction
sodisfà	satisfied
incontentà	satisfied
incontentar	satisfy
sodisfar	satisfy
sodisfante	satisfying
sabo	Saturday
lugànega	sausage
selvàdego	savage
salvar	save
vedesto	saw
visto	saw
dir	say
balansa	scale
inbrojesso	scam
incantonada	scam
inbrojada	scam
secatrisse	scar
scarso	scarce
spaventà	scared
sierpa	scarf
spaventoso	scary
sparpagnà	scattered
destirà	scattered
palco	scene
sena	scene
panorama	scenery
fragransa	scent
programa	schedule
scola	school
siensa	science
siensa	scientist
siensadi	scientists
fòrbese	scissors
sigar drio	scold
criar drio	scold
fin	scope
vista	scope
scoo	scope
puntejo	score
toco	scrap
scesa	scrap
sgrafon	scratch
sigar	scream
schermo	screen
visela	screw
copion	script
mar	sea
bolo	seal
sijilo	seal
sercar	search
stajon	season
sentare	seat
secondo	second
segreto	secret
session	section
proteto	secure
sicuressa	security
vedar	see
se vedemo	see you
a dopo	see you later
ciao	see you soon
sani	see you soon
se vedemo doman	see you tomorrow
samensa	seed
sercar	seek
parer	seem
pare	seems
vedesto	seen
visto	seen
guantar	seize
brincar	seize
crisi epiletica	seizure
raramente	seldom
sernir	select
selessionar	select
sì	self
guarisse da solo	self healing
egoista	selfish
vendar	sell
inviar	send
spedir	send
invìame na to someja	send me your picture
vecioto	senior
ansian	senior
senso	sense
rasonevole	sensible
sensibile	sensitive
invià	sent
frase	sentence
frase	sentences
separar	separate
divìdar	separate
Sotho del nord	Sepedi
setenbre	september
secuensa	sequence
serie	series
serio	serious
seriamente	seriously
servir	serve
servissio	service
session	session
insieme	set
assenblà	set up
senografia	setting
solussionar	settle
risolvar	settle
sete	seven
dissete	seventeen
setanta	seventy
racuanti	several
rigoroso	severe
aspro	severe
duro	severe
cusir	sew
onbra	shade
onbra	shadow
scorlar	shake
sachetar	shake
sburatar	shake
gavaria da	shall
superfissiale	shallow
vergogna	shame
forma	shape
condivìdar	share
gussà	sharp
usà	sharp
ela	she
ela ga	she has
ela xe	she is
cason	shed
piégora	sheep
fojo	sheet
scafale	shelf
capa	shell
sgusso	shell
salvanela	shelter
resseto	shelter
scudo	shield
turno	shift
rilùser	shine
nave	ship
spedission	shipping
majeta	shirt
scarpe	shoes
sparar	shoot
negossio	shop
far cronpe	shopping
cronpar	shopping
provédar	shopping
riva	shore
curto	short
mancansa	shortage
carensa	shortage
sparo	shot
spala	shoulder
sigo	shout
spetacolo	show
fame vedar	show me
docia	shower
braschijo	shrimp
gànbaro	shrimp
strénzar	shrink
sarà	shut
tasi	shut up
vergognin	shy
spàvio	shy
zemeli	siblings
malà	sick
lato	side
sospiro	sigh
vista	sight
vedesta	sight
visitar	sightseeing
cartelo	sign
firma	signature
inportante	significant
silensio	silence
silensioso	silent
seda	silk
inseminìo	silly
baluco	silly
mona	silly
arzento	silver
somejante	similar
simile	similar
sénplise	simple
sìnpio	simple
fàssile	simple
al stesso tenpo	simultaneously
contenporaneamente	simultaneously
intanto	simultaneously
da	since
franco	sincere
sceto	sincere
sinsero	sincere
francamente	sincerely
sinceramente	sincerely
cantar	sing
cantante	singer
singolo	single
ugnolo	single
lavandin	sink
Sior	Sir
sorela	sister
cognà	sister in law
dadrio	sit
sentar	sit
sito	site
situassion	situation
te si	six
ti te si	six
sie	six
sédase	sixteen
sessanta	sixty
dimension	size
abilità	skill
abilità	skills
pele	skin
magro	skinny
saltar	skip
còtola	skirt
sielo	sky
sciavo	slave
dormir	sleep
dormir	sleeping
indormensà	sleepy
mànega	sleeve
feta	slice
slisarola	slide
scalo	slide
snolo	slide
lisieramente	slightly
magro	slim
sbrissar	slip
calada	slope
fessura	slot
lento	slow
lentamente	slowly
picolo	small
intelijente	smart
odore	smell
soriso	smile
fumo	smoke
lisso	smooth
marendin	snack
rebechin	snack
bóvolo	snail
bissa	snake
serpente	snake
scavessar	snap
neve	snow
alora	so
cuindi	so
cussì còcolo	so cute
fin cuà	so far
tociar	soak
negar	soak
saon	soap
sensier	sober
scarpà	soccer
balon	soccer
sossiale	social
sossietà	society
calse	socks
tènaro	soft
molesin	soft
software	software
aplicativo	software
teren	soil
tera	soil
vendesto	sold
esaurìo	sold out
soldà	soldier
sola	sole
solido	solid
duro	solid
solussion	solution
solussionar	solve
risolvar	solve
serti	some
calchedun	somebody
calche maniera	somehow
calchedun	someone
calcossa	something
serte volte	sometimes
a volte	sometimes
canson	song
presto	soon
sofistegà	sophisticated
Curdo sorani	Sorani
dolente	sore
mal de gola	sore throat
tristessa	sorrow
Scusa	Sorry
ordenar	sort
comandar	sort
sercà	sought
ànema	soul
ànema zemela	soulmate
son	sound
supa	soup
agro	sour
rùspio	sour
fonte	source
sud	south
spàssio	space
posta indesiderà	spam
spam	spam
arco	span
Spagnolo	Spanish
lesinar	spare
parlar	speak
spessiale	special
rassa	species
sorte	species
spèssie	species
spessìfego	specific
spetacolare	spectacular
discorso	speech
sensa parole	speechless
selerità	speed
rapidità	speed
incantesimo	spell
injarmadura	spell
spendar	spend
speso	spent
pissighin	spicy
ponta	spike
jirar	spin
spinassi	spinach
spirito	spirit
spuar	spit
spetacolare	splendid
maravejoso	splendid
separà	split
diviso	split
marsipar	spoil
ruinar	spoil
sassinar	spoil
vissià	spoiled
spontàneo	spontaneous
cuciaro	spoon
sculiero	spoon
màcia	spot
sposo	spouse
spalmar	spread
verta	spring
piassa	square
torciar	squeeze
strucar	squeeze
calamaro	squid
schirato	squirrel
cortelar	stab
incortelar	stab
stabile	stable
catasta	stack
personale	staff
palco	stage
màcia	stain
scale	stairs
palo	stake
ganbo	stalk
banco	stall
bolo	stamp
posission	stand
standard	standard
stela	star
scomissiar	start
scomissià	started
famà	starving
stà	state
dichiarassion	statement
stassion	station
statua	statue
stà	status
saloto	stay
sojorno	stay
stà tento	stay safe
stabile	steady
bisteca	steak
robar	steal
vapore	steam
asale	steel
erto	steep
ganbo	stem
passo	step
bacheto	stick
trincà	stiff
inbachetà	stiff
duro	stiff
àncora	still
oncora	still
basavejo	sting
tirà	stingy
cagnin	stingy
smissiar	stir
assion	stock
robà	stolen
stomego	stomach
piera	stone
alsà	stood
scagnelo	stool
fermar	stop
deposito	storage
magasin	storage
negossio	store
tenpesta	storm
storia	story
fornelo	stove
drito	straight
onesto	straightforward
galantomo	straightforward
tension	strain
strano	strange
sconossesto	stranger
stratejia	strategy
piva	straw
fragola	strawberry
strissa	streak
rio	stream
strada	street
forsa	strength
stress	stress
slongar	stretch
rigoroso	strict
aspro	strict
duro	strict
bàtar	strike
ciapar	strike
corda	string
sartìa	string
strissa	strip
inpegnarse	strive
ictus	stroke
forte	strong
ciapà	struck
batù	struck
stabile	structure
strutura	structure
sforso	struggle
in dificoltà	struggling
teston	stubborn
blocà	stuck
studente	student
studio	study
studiar	studying
cossa	stuff
spetacolare	stunning
maravejoso	stunning
inseminìo	stupid
baluco	stupid
mona	stupid
stile	style
sojeto	subject
sotomission	submission
inviar	submit
sostansa	substance
canbio	substitute
sostituto	substitute
fin	subtle
sotile	subtle
essar bon	succeed
essar boni	succeed
resultado	success
fortuna	success
vitòria	success
de sucesso	successful
cussì	such
come	such as
ciuciar	suck
de boto	sudden
de boto	suddenly
sofrir	suffer
soferensa	suffering
bastante	sufficient
che basta	sufficient
sùcaro	sugar
sujerir	suggest
inboconar	suggest
consejo	suggestion
sujerimento	suggestion
vestido	suit
àbito	suit
adato	suitable
bon	suitable
valisa	suitcase
somar	sum
zontar	sum
riassunto	summary
istà	summer
sima	summit
sole	sun
doménega	sunday
belivo	sunny
solejà	sunny
tramonto	sunset
sole	sunshine
otimo	super
superiore	superior
supervisor	supervisor
sena	supper
scorta	supply
assistensa	support
ajuto	support
metar che	suppose
suponer	suppose
ipotèdego	supposed
seguro	sure
superfissie	surface
area	surface
inpenada	surge
chirurjia	surgery
cognome	surname
sorpresa	surprise
sorprendesto	surprised
molar	surrender
réndarse	surrender
torno	surrounding
sorvejansa	surveillance
sondajo	survey
soraviver	survive
sospeto	suspect
sospeso	suspended
sospeto	suspicious
sostegner	sustain
sostenibilità	sustainability
sostenibile	sustainable
fagoto	swag
parar basso	swallow
parar zo	swallow
scanbio	swap
zurar	swear
sudore	sweat
majon	sweater
spassar	sweep
dolse	sweet
dormi pulito	sweet dreams
goloso de dolsi	sweet tooth
tesoro	sweetheart
gonfiarse	swell
gonfior	swelling
noada	swim
noar	swimming
brìscolo	swing
interutore	switch
boton	switch
gonfio	swollen
spada	sword
sinbolo	symbol
conpassion	sympathy
sìntomi	symptoms
sistema	system
tola	table
frotejar	tackle
eticheta	tag
adesivo	tag
bon ton	tag
coa	tail
ciapa	take
portar via	take away
stame ben	take care
decolo	take off
ciapà	taken
tolesto	taken
conferensa	talk
ciacolon	talkative
alto	tall
rubin	tap
spina	tap
nastro	tape
obietivo	target
atività	task
gusto	taste
gustoso	tasty
insegnà	taught
tè	tea
ti	tea
insegnar	teach
mestro	teacher
scuadra	team
làgrema	tear
làgreme	tears
rìdar drio	tease
tecnolojia	technology
denti	teeth
dir	tell
dime	tell me
caràtere	temper
natura	temper
tenperadura	temperature
tenpio	temple
tenporaneo	temporary
diese	ten
diesemila	ten thousand
incuilin	tenant
tendensa	tendency
tènaro	tender
teso	tense
tension	tension
tenda	tent
prova	tentative
condission	term
fine	term
condission	terms
teribile	terrible
incredibile	terrific
teritorio	territory
prova	test
teston	text
rispeto	than
grassie	thank
grassie	thank you
Grassie par la to passiensa fin che serchemo la spedission	Thank you for your patience while we investigate shipment
tante grassie	thank you so much
tante grassie	thank you very much
grassie	thanks
Grassie par aver doparà la nostra aplicassion	Thanks for using our app
che	that
che xe	that is
va ben	that's good
el	the
ladrada	theft
furto	theft
lori	their
suo	them
lori	them
lore	them
tema	theme
lori stessi	themselves
dopo	then
po'	then
teoria	theory
là	there
ghe son	there are
ghe xe	there is
cuindi	therefore
sti	these
so'	they
lori	they
i xe	they are
lori i xe	they are
assè	thick
spesso	thick
ladro	thief
pecosso	thigh
cossa	thigh
fin	thin
sotile	thin
cossa	thing
robe	things
pensar	think
terso	third
arsurà	thirsty
sidià	thirsty
trèdese	thirteen
trenta	thirty
sto	this
sta roba xe	this is
acurà	thorough
scrupolosamente	thoroughly
cueli	those
difisile	though
pensiero	thought
premuroso	thoughtful
pensieri	thoughts
mile	thousand
filo	thread
menassa	threat
menassar	threaten
tre	three
erta	threshold
soja	threshold
emossionà	thrilled
prosperar	thrive
gola	throat
traverso	through
traverso	throughout
lansar	throw
trar	throw
deolon	thumb
deo grosso	thumb
deon	thumb
tonesa	thunder
zoba	Thursday
cuindi	thus
sponta	tick
marea	tide
ordenar	tidy
comandar	tidy
matonela	tie
tigre	tiger
aderente	tight
Tigrina	Tigrinya
tenpo	time
timido	timid
picolo	tiny
mància	tip
conseji	tips
stufar	tire
stufo	tired
nissioleto	tissue
fassoleto	tissue
titolo	title
a	to
èssar	to be
prìndese	toast
ancuo	today
fantolin	toddler
dei dei pie	toes
insieme	together
bagno	toilet
dito	told
toleransa	tolerance
tolerar	tolerate
pomodoro	tomato
doman	tomorrow
léngua	tongue
stassera	tonight
anca	too
ciapà	took
tolesto	took
meso	tool
strumento	tool
strumenti	tools
mesi	tools
dente	tooth
superar	top
argomento	topic
sbregà	torn
tortura	torture
totale	total
toco	touch
duro	tough
jiro	tour
verso	toward
verso	towards
sugaman	towel
sità	town
tòssego	toxic
trassa	trace
trassar	track
comercio	trade
tradission	tradition
tradissionale	traditional
tràfego	traffic
sia	trail
tren	train
alenamento	training
trato	trait
trati	traits
trasferir	transfer
transission	transition
tradure	translate
trasparente	transparent
trasporto	transport
trasporto	transportation
trapola	trap
scoasse	trash
spassadura	trash
tràuma	trauma
viajar	travel
vantiera	tray
tesoro	treasure
sorpresa	treat
tratamento	treatment
albaro	tree
tremendo	tremendous
tendensa	trend
processo	trial
truco	trick
provà	tried
grileto	trigger
passarin	trigger
spontar	trim
viajo	trip
dificoltà	trouble
braghe	trousers
camio	truck
baule	trunk
fidarse	trust
verità	truth
provar	try
Tsonga	Tsonga
tubo	tube
marti	Tuesday
reta	tuition
dìndio	turkey
pai	turkey
pito	turkey
curcuma	turmeric
svolta	turn
canbio	turn
bissascuela	turtle
gajandra	turtle
galana	turtle
tutore	tutor
dodese	twelve
vinti	twenty
vintiun	twenty-one
Ci	Twi
do volte	twice
inpegolar	twist
intorcolar	twist
rovigolar	twist
do	two
tipo	type
tipico	typical
bruto	ugly
definitivo	ultimate
onbrela	umbrella
bon da gnente	unable
barba	uncle
svegnesto	unconscious
soto	under
soto	underneath
sotovalutà	underrated
capir	understand
capìo	understood
desfortunadamente	unfortunately
desgrassiadamente	unfortunately
uniforme	uniform
unico	unique
unità	unit
università	university
sconossesto	unknown
via che	unless
fin	until
insolito	unusual
so	up
te toca ti	up to you
ajornamento	update
ajornamento	upgrade
so	upon
sconvolto	upset
urban	urban
urjensa	urge
urjente	urgent
noialtri	us
fin	use
vista	use
scoo	use
doparà	used
utile	useful
inutile	useless
solito	usual
de solito	usually
utensa	utility
vacansa	vacation
vassinassion	vaccination
vassin	vaccine
spirapólvare	vacuum
vago	vague
vàlido	valid
bon	valid
vale	valley
pressioso	valuable
valor	value
varietà	variety
varie	various
variar	vary
vaso	vase
vasto	vast
verdura	vegetable
verdure	vegetables
veicolo	vehicle
fornidore	vendor
Veneto	Venetian
velen	venom
venturarse	venture
sede	venue
verifegar	verify
versatile	versatile
version	version
verticale	vertical
assè	very
tanto	very
tanto ben	very good
benìssimo	very good
vasselo	vessel
traverso	via
grassie a	via
atmosfera	vibe
atmosfera	vibes
cativo	vicious
vitima	victim
video	video
vista	view
vedesta	view
paese	village
cativo	villain
aséo	vinegar
vintage	vintage
violensa	violence
violento	violent
virale	viral
vèrsene	virgin
virtuale	virtual
virtù	virtue
vision	vision
visita	visit
visuale	visual
vitale	vital
vivido	vivid
vocabolario	vocabulary
vose	voice
nulo	void
volume	volume
volontario	volunteer
gòmito	vomit
vulnerabile	vulnerable
salario	wage
paga	wage
salari	wages
paghe	wages
vita	waist
speta	wait
camariero	waiter
spetar	waiting
svejarse	wake
svéjate	wake up
caminada	walk
caminar	walking
muro	wall
parete	wall
portafojo	wallet
passejar	wander
vuto	wanna
voler	want
rissercà	wanted
guera	war
vardaroba	wardrobe
camarin	wardrobe
magasin	warehouse
caldo	warm
avertir	warn
avertensa	warning
aviso	warning
gueriero	warrior
jera	was
lavar	wash
vansaura	waste
refudo	waste
vardar	watch
acua	water
ingùria	watermelon
onda	wave
maniera	way
noialtri	we
noialtri semo	we are
noialtri podemo	we can
lasco	weak
debole	weak
debolessa	weakness
richessa	wealth
sior	wealthy
indossar	wear
indossar	wearing
clima	weather
sposalissio	wedding
mèrcore	Wednesday
erbassa	weed
setimana	week
fine setimana	weekend
peso	weight
strano	weird
benvegnesto	welcome
benèssar	welfare
Ben	Well
fato ben	well done
ndà	went
jera	were
ponente	west
ovest	west
mojo	wet
balena	whale
cossa	what
e ti	what about you
cossa sito drio far	what are you doing
cossa sito drio far desso	what are you doing now
cossa sito drio far desso	what are you doing right now
cossa feto	what do you do
che lavoro feto	what do you do for a living
cossa vuto dir	what do you mean
cossa vuto	what do you want
cossa xe sucesso	what happened
cossa xe nato	what happened
cossa xe	what is
cossa xe sta roba	what is this
che lavoro feto	what is your job
come te ciamito	what is your name
come xela	what's up
come vala	what's up
come te ciamito	what's your name
cualsiasi roba	whatever
formento	wheat
gran	wheat
roda	wheel
co'	when
co che sia	whenever
ndove	where
ndove sito	where are you
da ndove viento	where are you from
ndove sito desso	where are you now
ndove stèto	where do you live
ndove xe	where is
fin che	whereas
se	whether
che	which
fin che	while
sussuro	whisper
fiscio	whistle
bianco	white
chi	who
chi sito ti	who are you
chi xela	who is
chi xelo	who is
chi xela	who is this
chi xelo	who is this
intiero	whole
chi	whom
al cual	whose
parché	why
parché no	why not
cativo	wicked
largo	wide
vedova	widow
larghessa	width
mojere	wife
selvàdego	wild
voler	will
che vole	willing
vìnsar	win
vento	wind
fenestra	window
ventoso	windy
vin	wine
inverno	winter
fregar	wipe
russar	wipe
filo	wire
saviessa	wisdom
savio	wise
desiderio	wish
voja	wish
te auguro el mejo	wish you all the best
striga	witch
co	with
retirar	withdraw
prelievo	withdrawal
rento	within
drento	within
sensa	without
testimone	witness
agudo	witty
lovo	wolf
dona	woman
done	women
vinto	won
maraveja	wonder
fantàstego	wonderful
spetacolare	wonderful
maravejoso	wonderful
legna	wood
legno	wood
lana	wool
parola	word
parole	words
lavoro	work
alenamento	work out
lavorar	working
mondo	world
verme	worm
consumà	worn
preocupà	worried
preocupassion	worry
peso	worse
venerar	worship
peso	worst
valor	worth
valeva la pena	worth it
vàlido	worthy
bon	worthy
ferida	wound
Ostia	Wow
incartar	wrap
còlara	wrath
fumana	wrath
polso	wrist
scrivar	write
Scrivi cuà	Write here
scrivar	writing
scrito	written
sbalià	wrong
falà	wrong
corte	yard
sbadajo	yawn
Sì	Yeah
ano	year
ani	years
levà	yeast
sigar	yell
zalo	yellow
Sì	Yes
sì, caro	yes baby
sì, caro	yes dear
sì caro	yes honey
sì, amor	yes my love
eh ciò	yes of course
par forsa	yes of course
jeri	yesterday
àncora	yet
oncora	yet
molar	yield
ti	you
ti te sì	you are
te si bela	you are beautiful
te si proprio belo	you are so beautiful
prego	you are welcome
ti te poli	you can
Te lo sè	You know
anca ti	you too
prego	you're welcome
zovane	young
to	your
prego	your welcome
ti	yourself
zoventù	youth
prego	you’re welcome
gustoso	yummy
zero	zero
