ti	a
caadxi huiini'	a little
stale	a lot
stale	a lot of
rusaana	abandon
ma' bisaana	abandoned
runi obedecer	abide
ruzuhuaa diidxa'	abide
abilidá	ability
randa	able
de	about
luguiá'	above
sti guidxi ró'	abroad
cayaadxa	absence
qui guinni	absent
nga pué	absolutely
ricaa	absorb
ni cadi ca ique binni	absurd
stalepe'	abundance
stale	abundant
guendariguite	abuse
riguite	abuse
gadxé modo rini'	accent
ricaa	accept
runi aceptar	accept
accesu	access
accidente	accident
ra guiaana tobi	accommodation
rizaa	accomplish
rusaa	accomplish
ma biza'cabe	accomplished
ma bi'ni'cabe	accomplished
ni ná tuuxa'	according
cuenta	account
biá' si	accuracy
bia'si	accurate
gudxiiba' donda	accused
yuuba'	ache
riuuba'	ache
naná	ache
rugaanda	achieve
biluxe xiixa'	achievement
runi reconocer	acknowledge
runibiá' tuuxa	acquaintance
rizí'	acquire
guzi'	acquired
guzí'	acquisition
frente	across
lade neza	across
runi	act
acción	action
riuu actibu	active
yanna'	actual
ni dxandí la?	actually
runi adaptar	adapt
runi sumar	add
riguu	add
riula'dxi droga	addicted
suma	addition
ñapa	additional
dirección	address
cué'	adjacent
adjetivo	adjective
runi chaahui	adjust
ridxagayaa	admire
runi admitir	admit
guicou xiixa' o tuuxa casi stiu'	adopt
sicarú	adorable
avance	advance
bi'ni' avanzar	advanced
ventaja	advantage
ni ruchaa verbu	adverb
anunciu	advertisement
cayuni anunciu	advertising
rudii conseju	advice
conseju	advise
abogadu	advocate
galán rihuini ni	aesthetic
rizané tuuxa ni cadi xheela'	affair
ranaxhii	affect
guendaranaxhii'	affection
randa sí	afford
zanda quíxelu	affordable
ridxibi	afraid
despué	after
huadxí	afternoon
oraqué	afterwards
sti biaje	again
iza	age
agencia	agency
agente	agent
naduxhu'	aggressive
nasisi	agile
ma naca	ago
riuu de acuerdu	agree
acuerdu	agreement
rizá niru	ahead
niru	ahead
racané	aid
runi apuntar	aim
bi	air
aeropuerto	airport
pasillu	aisle
rucaa ridxi	alarm
nisa dxuuni'	alcohol
guyuu cuidadu	alert
gupa lii	alert
nabani	alive
guirá'	all
neza	all right
sicaru chelu'	all the best
rudii lugar	allow
bidii permisu	allowed
bidii lugar	allowed
casi biá'	almost
stubi	alone
ne	along
ma'	already
galán	Alright
laaca	also
sti modo	alternative
necapé'	although
guirá ora	always
ridxagayaa	amazing
guendarachelú	ambition
ambicioso	ambitious
runichaahui'	amend
lade laatu	amid
lade	among
ládedu	among us
ládenu	among us
pabiá'	amount
ti	an
análisis	analysis
binni dxiqué	ancestors
ancla	anchor
nayooxho'	ancient
ne	and
ne lii	and you
ángel	angel
guendaridxiichi	anger
ángulo	angle
nadxiichi	angry
mani'	animal
dxita porra ñee	ankle
yanni ñee	ankle
laní	anniversary
anunciu	announcement
riziñe	annoy
bixhacala'dxi' xiixa'	annoyed
ruchiichi	annoying
guirá iza	annual
sti	another
stobi	another
ricabi	answer
guendaricabi	answer
ansia	anxiety
ansia	anxious
intiisi	any
ma que	anymore
tutiisi	anyone
gasti'	anything
neca zacá	anyway
rilaa	apart
apartamentu	apartment
rinaba' perdón	apologize
rilui'	apparent
rilui'	appear
bihuinni	appeared
guendarindaana	appetite
manzana	apple
aplicación	application
cita	appointment
rudii xquixe pé'	appreciate
guendarusisaca	appreciation
modo guni tobi xiixa'	approach
jneza	appropriate
riaba ni	appropriate
runi aprobar	approval
runi aprobar	approve
guca aprobar	approved
bia'	approximately
abril	april
arquitecto	architect
arquitectura	architecture
runi archivar	archive
ñee nuutu	are you
ñee nuulu'	are you
nuu ni gu'nu la'?	are you busy
nuulu ocupado la'?	are you busy
napalu xheela lu la'	are you married
napu' xheelu' la	are you married
má bichaganalu la? o stubu siou'	are you married or single
¿Ñee nuu rou' raca la?	Are you still there?
nuulu' racá la	are you there
área	area
ridinde diidxa'	argue
guendaridinde ruaa	argument
riasa	arise
ná	arm
ejércitu	army
bieque	around
rusichaahui	arrange
ruquixhe	arrange
runichaahui	arrangement
bisichaahui	arrangement
redandá	arrive
bedandá	arrived
orgulloso	arrogant
raca tobi nayá	arrogant
flecha	arrow
arte	art
artículo	article
artificial	artificial
artista	artist
casi	as
laaca	as well
dé	ash
bituilú	ashamed
rinabadiidxa'	ask
gunabadiidxa'	asked
cayasi	asleep
Assamese	Assamese
asaltu	assault
guendaridagulisaa	assembly
ruuya pabiá risaca xiixa'	assess
runi evaluar	assessment
propiedá	asset
ruseenda guni xiixa'	assign
xiixa' ni chigaca	assignment
racané	assist
asistente	assistant
rabi	assume
ra	at
neca	at least
gudobe	ate
atleta	athlete
ruquiidi'	attach
ricá	attach
cá	attached
gui'di'	attached
ca cué'	attachment
gui'di'	attachment
runi atacar	attack
finta	attempt
rie	attend
ra rie binni	attendance
ricaa atención	attention
ridxiichi	attitude
runi atraer	attract
moza pé'	attractive
sicarú pe'	attractive
guapu	attractive
guenda	attribute
ni cayuna diaga	audience
Agosto	august
tiá	aunt
tiá	aunty
handí'	authentic
ni bicaa xiixa'	author
ni runi mandar	authority
xaique guidxi	authority
nuu	available
promediu	average
qué runi xiixa'	avoid
ma bibani	awake
premiu	award
ranna nuu xiixa	aware
rudii cuenta	awareness
zitu	away
ridxagayaa	awesome
feu	awful
Aymara	Aymara
ba'du'	baby
ca'ru guichaganá	bachelor
solteru	bachelor
deche	back
deche	background
gupa'	bad
bolsa	bag
anzuelu	bait
ruquii	bake
panaderiá	bakery
bicarbonato	baking soda
balón	ball
Bambara	Bambara
biduaa'	banana
banda	band
rucuaagu'	bang
bancu	bank
cantina	bar
ti guisi huiini	barely
runi negociar	bargain
bandadi'	bark
riduxhu	bark
guidi ladi yaga	bark
le'	barrier
base	base
ra ruzuhuaa xiixa'	base
bizuhuaa	based
sótano	basement
básicu	basic
ndi nga ni	basically
albaca	basil
xiiñi' gui'xi'	bastard
lote	batch
bañu	bath
bañu	bathroom
bateriá'	battery
guendaridinde	battle
raca	be
laguuya ga	be careful
biiya ga	be careful
guriá nisado	beach
biaani'	beam
bizaa	beans
runi huantar	bear
guichaxhigui	beard
runihuantar	bearing
mani'	beast
guendariguiñe	beat
sicarú	beautiful
guendasicarú	beauty
guca	became
purti	because
raca	become
gupa'	bed
recámara	bedroom
bizuhuaa	bee
beela yuuze'	beef
huayuu	been
cerveza	beer
ante	before
bizulú	began
ruzulú	begin
ra ruzulú	beginning
guni xiixa' lugar sti binni	behalf
riuu dxí	behave
modo tobi	behavior
deche	behind
runi cré	belief
runi cré	believe
ndaani0	belly
sti	belong
guaxhii	beloved
xaguete'	below
cinturón	belt
bangu'	bench
ruzeechu'	bend
xa'na'	beneath
xaguete'	beneath
beneficiu	benefit
beneficiu	benefits
cue'	beside
ni jmá galán	best
sicaru guyé	best of luck
galán nga ridapa diuxe' lii	best regards
jmá sicarú	better
lade	between
nisa	beverage
dedepé'	beyond
Bhoipuri	Bhojpuri
maca cá ique ximodo laabe	biased
bicicleta	bicycle
naro'ba'	big
bicicleta	bike
recibu	bill
riliibi	bind
mani ripapa	bird
lanixpidó'	birthday
caadxi	bit
guendaroyaa	bite
nandá'	bitter
nayaase	black
gudxiu	blade
donda	blame
largueela'	blanket
rucuagu	blast
cloro	bleach
riguucha'	blend
riu ndaaya'	bless
guyuu ndaaya'	blessed
nache'pa lú	blind
guendanayeche'	bliss
bloque	block
rini	blood
rixele' guie'	bloom
ruchá bi	blow
nasiá	blue
natuumbu'	blunt
pizarrón	board
lancha	boat
ladi	body
rindaabi'	boil
runi huantar	bold
riguiidi	bond
dxita	bone
gui'chi'	book
guendaricaa bi	boost
bangu ro'	booster
bangu' para ba'du'	booster
ruladxi tuuxa	boot
bota	boot
bota	boots
ruaa	border
frontera guidxiró'	border
runi huecu	bore
bixhacala'dxi'	bored
guendarizacala'dxi'	boring
gule	born
rinaba' diiñe'	borrow
ni runi mandar	boss
xpixuaana	boss
guiropa'	both
riziñe	bother
ruchiiña'	bother
botella	bottle
xaguete'	bottom
guzié'	bought
liibi	bound
ra riluxe xiixa'	boundaries
corbata	bow
rucaa ridxi	bowl
caja	box
ba'du' nguiiu	boy
novio	boyfriend
esclava	bracelet
yuba	brain
tindaa yaga	branch
marca	brand
qué ridxibi	brave
qué ruzuhaa stiidxa'	breach
pan	bread
guendarizila'dxi'	break
guendaré'	breakfast
pechu	breast
xidxi	breast
ricaa bí	breath
ricá bí	breathe
ladriu'	brick
novia	bride
puente	bridge
naya'ni'	bright
ruzaani	brilliant
redané	bring
bi'chi'	bro
xhilaga	broad
ma gulaa	broke
gulaa	broken
gubaaya'	broom
bi'chi'	brother
cuñadu	brother in law
bedaniá'	brought
nayú	brown
ruzá begu	brush
cubeta	bucket
bichi	buddy
dxé	buddy
presupuestu	budget
mani' huiini'	bug
rucui	build
yoo	building
bizuhuaa	built
montón	bulk
gundisa'	bull
tope	bump
bultu	bump
bonche	bunch
stale	bunch
carga	burden
bigaachi'	buried
riaaqui'	burn
ruzaaqui'	burn
rucaachi'	bury
carru pasaje	bus
yagabiuxe	bush
negocio	business
rigaa	bust
dxi'ña	busy
peru	but
mantequiá	butter
biguidiguie'	butterfly
botón	button
rizí	buy
ti	by
ti guidu'yanu	bye
repollo	cabbage
gabinete	cabinet
pastel	cake
becerru	calf
ridxi	call
llamada	call
bicaa ti ridxi naa	call me
biree lá	called
riuu dxí	calm
beeda	came
campaña	campaign
stipa	can
qui ganda	can't
runi cancelar	Cancel
cáncer	cancer
zanda guni tuuxa xiixa'	capable
capacidad	capacity
guidxi	capital
bidxiichi	capital
letra ca xaguete pantalla	caption
rinaazecabe tuuxa	capture
carru	car
carrera	career
lagapa ga	careful
ne cuidadu	careful
la gapa chaahui	carefully
qué gapa xpiá'	careless
carpinteru	carpenter
alfombra	carpet
zanahoria	carrot
riné	carry
runi	carry on
runi	carry out
riné	carry out
casu	case
bueltu	cash
nezarindani gubidxa	cast
castillu	castle
mistú'	cat
rinaaze	catch
categoría	category
yuze	cattle
gunaaze'	caught
causa	cause
biiya gá	caution
gupa gá	caution
né cuidadu	cautious
cueva	cave
guiiru' ró'	cave
rucueeza	cease
ique yoo	ceiling
runi celebrar	celebrate
raca saa	celebrate
galaa	center
gayuaa	century
cereal	cereal
ceremonia	ceremony
seguru	certain
dxandípe'	certainly
certificadu	certificate
cadena	chain
bangu'	chair
rudii lugar	chance
guendaruchaa	change
modo tobi	character
rua'	charge
sicarú	charming
gráfica	chart
rinanda	chase
guendarini'	chat
baratu	cheap
runi trampa	cheat
runi trampa	cheating
guendarusiguii	cheating
cheque	check
xhaga	cheek
guendariguu gana	cheer
nayeche'	cheerful
salud	cheers
quesu	cheese
química	chemistry
ajedrez	chess
pechu	chest
ra'sa'	chew
bere	chicken
xaique	chief
ba'du'	child
xcuidi	child
dxi nahuiini binni	childhood
ca ba'du'	children
xcuidi	children
guendanananda	chill
rilasela'dxi'	chill
rianda	chill
chimeneá	chimneys
xhigui	chin
dxuladi	chocolate
ribí	choose
ruchuugu'	chop
dxiiña'	chores
naró'	chubby
yu'du'	church
canela	cinnamon
redondo	circle
ni cayaca	circumstances
guidxi	city
rusiene stiidxa'	clarify
clase	class
beñe	clay
nayá	clean
ra na pampa	clear
secretaria	clerk
nuu xpiaani'	clever
cliente	client
punta dani	cliff
clima	climate
rigui'ba'	climb
reló	clock
gaxha	close
rieegu'	close
riseegu'	close
clóset	closet
lari	cloth
ca lari	clothes
za	cloud
nuu stale za	cloudy
payasu	clown
grupu	cluster
buu	coal
guiriá nisadó'	coast
abrigu	coat
café	coffee
nananda	cold
riaba dede layú	collapse
bigá'	collar
compañeru	colleague
ca compañeru	colleagues
runi coleccionar	collect
yoo ndxó'	college
scuela ró'	college
color	color
color	colour
columna	column
begu	comb
combinación	combination
runi combinar	combine
reeda	come
guda' rarí'	come here
chuu	come on
cómodo	comfort
cayeeda'	coming
mayaca zeeda ni	coming soon
ruseenda	command
ni rini' binni	comment
comercial	commercial
gulee xcu ni, gulee comisión	commission
raca comprometer	commit
compromisu	commitment
nabé zanda guidxela ni	common
rini'	communicate
comunicación	communication
binni guidxi	community
rie sti ladu	commute
compañera	companion
ni nuu ne tuuxa'	companion
compañeru	companion
runi acompañar	company
ruchaaga	compare
guendariá miati'	compassion
guendariá' binni	compassionate
runi competir	compete
galán runi dxiiña'	competent
competencia	competition
raca quejar	complain
queja	complaint
bizaa ni	complement
guidubi	complete
guidubi naca	completely
nagana	complex
guendaruzuhuaa diidxa'	compliance
nabé nagana	complicated
felicitación	compliment
guni ni na tuuxa	comply
xi dé nga xiixa'	composition
guendariene	comprehension
guidubi	comprehensive
compromisu	compromise
computadora	computer
runi concentrar	concentrate
guendarusiene	concept
xizaa	concern
guyuu xizaa	concerned
biluxe	conclusion
concretu	concrete
condición	condition
condición	conditions
rusá	conduct
modo tobi	conduct
ruxhuba donda	confess
confianza	confidence
napa confianza	confident
ruuya' pa neza	confirm
guenda ridinde	conflict
qué gana xi guni	confused
qué riene	confused
guendaridxélu	confusion
guendanayeche'	congrats
felicidades	congratulation
felicidades	congratulations
runi conectar	connect
runi conquistar	conquer
rudii cuenta	conscious
xpiaani'	consciousness
consecuencia	consequences
guendarapa xiixa'	conservation
conservador	conservative
rica ique '	consider
bi'ni' considerar	considered
constante	constant
nabé seguidu	constantly
qué ganda xhuuna'	constipation
edificiu	construction
yoo	construction
rusirá	consume
contactu	contact
contagioso	contagious
rapa	contain
napa	contains
yana rí'	contemporary
nanala'dxi'	contempt
ni nuu ndaani xiixa	content
competencia	contest
continente	continent
runi seguir	continue
contratu	contract
rudii	contribute
racané	contribution
rudii bueltu	contribution
rudii xiixa'	contribution
runi controlar	control
rucueeza	control
riaba	convenient
rini' né tuuxa	conversation
bidxaa religión	convert
rusiene	convey
ricuudxi	convince
bicuudxi	convinced
runi guendaró	cook
cocineru	cook
cocinera	cook
caya'gui'	cooking
cayuni guendaró	cooking
nananda	cool
tequiu	cooperation
runi huantar	cope
cobre	copper
ladxidó'	core
xhuuba'	corn
esquina	corner
xneza	correct
neza	correct
guendarisaca	cost
disfraz	costume
xiaa	cotton
sofá	couch
rú	cough
ñanda	could
cnseju	council
rigaba'	count
mexá'	counter
guidxi ró'	country
ra ñaa	countryside
par	couple
rudxiilú	courage
cursu	course
HA	court
xprimu	cousin
ruchii	cover
baca	cow
namuxe'	coward
cómodo	cozy
jaiba	crab
cá bi	crack
ni runi binni ne ná	craft
gui'	crap
choque	crash
candaana' xhaata'	craving
riaadxa xpiaani'	crazy
nahuati	crazy
rizá'	create
runidxiiña' ne ique	creative
créditu	credit
equipu	crew
guendanadxaba'	crime
guenda ritui lú	cringe
nuu problema	crisis
nuu guendanagana	crisis
criteriu	criteria
nabé importante	critical
rini' binni	criticism
biní	crop
cruz	cross
bia'qui'	crow
stale binni	crowd
rí binni	crowd
nuu stale binni	crowded
la'pa'	crown
nabé importante	crucial
nabé malu	cruel
cruceru	cruise
guendarunitilú	crush
riula'dxi'	crush
ruuna'	cry
pepinu	cucumber
rata gaxha sti binni	cuddle
guendabiaani	culture
nexhená	cunning
xiga	cup
rucueeza	curb
rapa curiosidad	curiosity
racala'dxi' ganna	curious
nabidxu	curly
bueltu	currency
yanna	current
yanna	currently
riguu di	curse
cortina	curtain
almohada	cushion
costumbre	custom
cliente	customer
tradición	customs
corte	cut
mozo	cute
moza	cute
rusá bicicleta	cycling
bixhoze	dad
apá	dad
apá	daddy
guirá dxi	daily
presa	dam
ma feu ma' bixhiiñe'	damage
malu	damn
nagupa	damp
ruyaa	dance
naxoo	danger
nabé peligroso	dangerous
nacahui	dark
xhuncu stine'	darling
rireexhooñe' nagueenda'	dash
guión	dash
datu	data
dxí	date
xiiñi'	daughter
dxí	day
guti	dead
ra riluxe fecha	deadline
diaga cuaata'	deaf
nacuaata' diaga	deaf
tratu	deal
nadxiee'	dear
guendaguti	death
ni ruzaabi'	debit
dé	debris
binaba' diiñe'	debt
chii iza	decade
riuudxu'	decay
guti	deceased
rusiguii	deceive
diciembre	december
nacha'hui	decent
ribí	decide
bi'ni' decidir	decided
decisión	decision
riní' de que co'	decline
rihuiini	decrease
inauguración	dedication
gui'chi' sti yoo	deed
ziá'	deep
venadu	deer
rucaa lu	defend
rusiene diidxa'	define
ngape'	definitely
guendarusiene	definition
rusiene	definition
ma biluxe scuela ró'	degree
ma bindaa	delayed
rixá	delete
napa intención gun xiixa'	deliberate
nadá	delicate
nanixe	delicious
nanixe'	delight
guenda nayeche'	delighted
redasaana	deliver
beedasaana'	delivered
rusaana	delivery
rudii	delivery
demanda	demand
rinaba' stale	demanding
democracia	democracy
binidxaba'	demon
ruluí'	demonstrate
guiniu' de que có'	denied
pabiá' nana	density
dentista	dentist
guiniu' de que co'	deny
departamentu	department
ribi'	departure
runi depender	depend
riba'qui	deposit
depósito	deposit
runi depositar	deposit
nataaba' ladxidó'	depressed
depresión	depression
ra ziá'	depth
rini' xii nga xiixa'	describe
desiertu	desert
ra nabidxi	desert
raca tocar	deserve
gulee lá	designation
guendaracala'dxi'	desire
escritorio	desk
riuu triste	despair
riuu desesperadu	desperate
necape'	despite
postre	dessert
ra chindou'	destination
destinu	destiny
runitilú	destroy
runduuxe'	destroy
guendarunitilú	destruction
detalle	detail
ruuya' xiixa'	detect
rini' xi chigaca	determine
ma guni' ique xi guni	determined
runi desarrollar	develop
ximodo ze xiixa'	development
aparatu	device
binnidxaba'	devil
bi'ni dedicar	devoted
Dhivehi	Dhivehi
dxiña	diabetes
cadi'di' xha´na'	diarrhea
yuba ndaani	diarrhea
diccionario	dictionary
bi'ni'	did
rati	die
guti	died
dieta	diet
gadxé	difference
gadxé	different
nagana	difficult
rigaañe	dig
dignidad	dignity
runidxiiña' nagueenda	diligent
guendaré'	dinner
botana	dip
riguu ndaani nisa	dip
directu	direct
director	director
ribiidi'	dirt
nabiidi'	dirty
rusixhiiñe'	disable
qué zanda guni xiixa'	disabled
rinitilú	disappear
riaapa	disappear
runi decepcionar	disappointed
desastre	disaster
rilate	discharge
rudii descuentu	discount
ridxela xiixa cubi	discover
riní'	discuss
guendaridinde diidxa'	discussion
guendahuará	disease
ca guendahuará	diseases
bicaachilú tu lii	disguise
cosa yuudxu'	disgusting
guendanayuudxu'	disgusting
bladu'	dish
ca bladu'	dishes
ma que riquiiñe'	dismiss
ruseenda tuuxa	dispatch
pantalla	display
guendarusa'bi' xiixa'	disposal
ridinde	dispute
neza	distance
gadxé	distinct
rihuini	distinguish
distrito	district
ruchiiña'	disturb
zanja	ditch
ndaani yú	ditch
rixuuba'	dive
gadxé	diverse
variedá	diversity
runi dividir	divide
nandxó'	divine
divorcio	divorce
ridxé lú	dizzy
bi'ni'	do
nadxiilu naa la?	do you love me
doctor	doctor
gui'chi'	document
runibe	does
bi'cu'	dog
Dogri	Dogri
cayuni	doing
muñega	doll
muñegu	doll
buñega	doll
sti yoo	domestic
cadi	don't
que	don't
co'	don't
cadi chu'lu' xizaa	Don't worry
qué guiza'la'dxilu'	Don't worry
rusiga'de'	donate
biluxe	done
burru	donkey
guixi	dope
chupa	double
duda	doubt
cuba	dough
xaguete'	down
rundete'	download
gui'chi'	draft
riduba yu	drag
ruxubi yu	drag
rucaa raya	draw
gabeta	drawer
runi dibuju	drawing
ridxibi	dread
bacaanda	dream
vestidu	dress
nagaanda'	drink
rusá	drive
riaba gota	drop
gota	drop
bisaba	dropped
nabidxi	drought
gubiña	drought
naxhudxi	drunk
binnigüé'	drunk
nabidxi	dry
patu	duck
dxé	dude
runi	due to
nagu'xhu'	dull
qué gapa xpiaani	dumb
cadi guizá ique	dumb
nahuati	dumb
ruzaqbi'	dump
pabiá' rindaa ni	duration
ora	during
yudé	dust
dé	dust
obligación	duty
ribeza	dwell
cayati	dying
cada tobi	each
lade laatu	each other
riuu gana	eager
bisiá	eagle
diaga	ear
ante	earlier
siadó'	early
runi ganar bueltu	earn
diaga	ears
guidxilayú	earth
xu ró'	earthquake
cadi naganapé'	easily
neza ra rindani gubidxa	east
neza ra riree gubidxa	east
cadi nagana	easy
ró	eat
cayó	eating
cadi caru	economic
baratu	economic
economiá'	economy
punta xiixa'	edge
guriá	edge
rucaa chaahui ni ma bicácabe	edit
guendariziidi'	education
efectu	effect
eficiente	effective
eficiente	efficient
stipa	effort
dxita	egg
xhono	eight
dieciocho	eighteen
chii ne xhono	eighteen
tapa late gande	eighty
ochenta	eighty
ndí o ndica'	either
runi	elaborate
xibi na	elbow
xhuana	elder
binni gola	elderly
sicarú	elegant
elefante	elephant
chii ne tobi	eleven
xiixa ru jmá	else
bitui lú	embarrassed
natuílú	embarrassing
riguiidxi	embrace
riree	emerge
emergencia	emergency
naguudxi ladxidó'	emotional
guendarilasela'dxi'	empathy
ra runi dxiiña'	employment
gasti'	empty
rudii lugar gúni xiixa'	enable
ridxaaga	encounter
riguu gana	encourage
riluxe	end
asuntu	endeavor
runihuantar	endurance
runi huantar	endure
ni nanala'dxi' tuuxa	enemy
stipa	energy
runi comprometer	engage
chichaganá	engage
chichaganá	engaged
bidii stiidxa'	engagement
máquina	engine
ingeniera	engineer
ingenieru	engineer
inglés	English
runi mejorar	enhance
rieche	enjoy
nabé ngola	enormous
nangola	enormous
ngasi	enough
runi asegurar	ensure
riuu	enter
guendariguite	entertainment
ne guendanayeche'	enthusiasm
nayeche'	enthusiastic
guidubi	entire
entidad	entity
puertá'	entrance
empresario	entrepreneur
sobre	envelope
guirá ni nuu ladenu	environment
guendrachelú	envy
epidemia	epidemic
bia'ca	equal
zaquéca	equal
bia' quéca	equal
equipu	equipment
bia'ca	equity
zaquéca	equity
bia' quéca	equity
biá' quéca ni	equivalent
borrador	eraser
ruchee	error
rulá	escape
rilá	escape
especialmente	especially
laape'	especially
xo' naxhi	essence
naquiiñe	essential
riba'qui'	establish
bizuhuaa dxiichi'	established
herencia	estate
runi estimar	estimate
biá'	estimated
ne xiixa' zicacá	etc
ni qué ziuu dxí guiluxe	eternal
guendaruni jneza	ethics
runi evaluar	evaluate
runi examinar	evaluation
dede	even
néca	even though
huaxhinni	evening
rizaaca xiixa'	event
eventu	event
zadi'di tiempu	eventually
que ziuu dxi	ever
cada	every
guirá'	everybody
guirá binni	everyone
guirá	everyone
guidubi	everything
guirá'	everything
cahuini dxiichi'	evidence
guenda nadxaba'	evil
evolución	evolution
evolucionar	evolve
Ewe	Ewe
bia'si'	exact
zaqué	exactly
examen	exam
runi examinar	examine
ejemplu	example
ridi'di' xhaata0	exceed
ni jmá galán	excellent
ni jmá risaca	excellent
sin	except
nabé stalepe'	excess
nabé stale ni	excessive
ruchaa	exchange
nabé nayeche'	excited
ripapa ladxidó'	excitement
ripapa ladxidó'	exciting
para tobi si	exclusive
bitiidila'dxi'	excuse
permisu	excuse me
runi	execute
chi guutica	execution
ejecutibu	executive
runi ejerciciu	exercise
ejerciciu	exercise
ridxaga	exhaust
nabé ma bidxaga tobi	exhausted
rusihuinni	exhibit
ra rusihuinnicabe xiixa'	exhibition
riuu	exist
nuu	existence
nuu ni	existing
riree	exit
ruchiaa	expand
rusi rooba'	expand
guendaribeza	expect
gulezabe	expected
gastu	expenses
caru	expensive
experiencia	experience
experimentu	experiment
nanna stale xhiiñabe	expert
ma udi'di' dxí	expired
rusiene	explain
bisiene	explanation
ricaa ventaja	exploit
rutoo xiixa' sti guidxiró'	export
rusihuinni	expose
bihuinni xii nga xiixa'	exposed
ma bihuinni xhiini	exposed
runi exponer	exposure
bisihuini	exposure
nagueenda'	express
ridaa	extend
ribiaa	extend
ruchiá	extend
bireeche	extended
extensión	extension
ruchiaa	extent
rusi rooba'	extent
fuera	external
birá	extinct
sti	extra
ribee	extract
guendaridxagayaa	extraordinary
lú	eye
lú	eyes
lari	fabric
rucaalú	face
cara	face
lú	face
rudii	facilitate
rutiiñe'	facilitate
instalación	facilities
ni dxandí	fact
fábrica	factory
ni dxandí'	facts
rité	fade
ruchee	fail
guenda ruchee	fail
bichee	failed
guendaruchee	failure
ridaagu	faint
xneza	fair
stale	fairly
runi cré	faith
dxandí	faithful
ni cadi dxandí'	fake
falsu	fake
guendariaba	fall
cadi dxandí	false
guendarusiguii	false
familia	familiar
xpinni lidxi	family
familia	family
gubiña	famine
famoso	famous
elegante	fancy
zitu	far
ti guidu'yanu	farewell
ti ca sti dxi	farewell
granja	farm
nabé interesante	fascinating
moda	fashion
nagueenda	fast
guiuba	fast
naro'	fat
riuu riesgu de gati tobi	fatal
destinu	fate
bixhoze	father
ridxaga	fatigue
ruchee	fault
ni riuladxi tobi	favorite
la'	favour
dxiibi	fear
saa	feast
duubi'	feather
característica	features
febreru	february
bixhacala'dxi	fed up
salariu	fee
riaxa	fee
rudii ni gó	feed
runi sentir	feel
sentimientu	feeling
ñee	feet
biaba	fell
bichi	fellow
compañeru	fellow
bi´'ni' sentir	felt
gunaa	female
le'	fence
nagudxa	fertile
saa	festival
ricaa	fetch
redané	fetch
xindxá'	fever
caadxi	few
jmá huaxié'	fewer
cadi dxandi'	fiction
ra ñaa	field
naduxhu'	fierce
chii ne gaayu'. quince	fifteen
cincuenta	fifty
chupa late gande ti de chii	fifty
guendaridinde	fight
guendaridinde	fighting
cantidad	figure
rudii cuenta	figure out
archivu	file
ridxá	fill
ruchii	fill
dxá	filled
bidxá	filled
película	film
nabé namucu	filthy
ridxela	find
riduuya' pa dxandí'	find out
galán	fine
buicuini	finger
riluxe	finish
biluxe	finished
guí	fire
firma	firm
nirudó'	first
primé	first
xapellidu	first name
benda	fish
riaana	fit
gaayu'	five
racacha'hui'	fix
runicha'hui'	fix
ma binichaahuica	fixed
bandera	flag
flash	flash
pampa	flat
ruchee	flaw
jneza	flawless
ruxooñe'	flee
beela	flesh
bipapa	flew
vuelu	flight
rutiixi	flip
riaahua	flood
pisu	floor
harina	flour
guie'	flower
guiidxa gá	flu
nagueenda rini'	fluent
nagueenda'	fluently
naxiaa	fluffy
nisa	fluid
nanisa	fluid
ripapa	fly
enfoque	focus
gupa	fog
nada'gu	foggy
rieechu'	fold
ruzeechu'	fold
compañeru	folks
rinanda	follow
sti'	following
guendaró	food
nahuati	fool
raca huati	fool
guendahuati	foolish
ñee	foot
fútbol	football
ti	for
casi pur ejemplu	For example
casi	for instance
stiu' ni	for you
para lii	for you
nuuni prohibidu	forbidden
stipa	force
lucua	forehead
dxú	foreign
ra nuu yaga nagá	forest
nabé	forever
riaanda'	forget
rusiaanda'	forget
rutiidila'dxi'	forgive
biaanda'	forgot
tenedor	fork
modo	form
formal	formal
ni uca'	former
bueltu	fortune
chupa late gande	forty
chupa late gande ne chupa	forty-two
cuarenta y dos	forty-two
delante	forward
rusiniisi' xiiñi' stobi	foster
gudinde	fought
bidxela	found
base	foundation
ra ruzuhuaa xiixa'	foundation
tapa	four
catorce	fourteen
chii ne tapa	fourteen
marcu	frame
runi raude	fraud
riuu libre	free
guendaruni ni gapa gana	freedom
seguidu	frequent
nabé seguidu	frequently
nayaa	fresh
Vierne	friday
imágen	fridge
amigu	friend
nabé amigu miati'	friendly
xhamigu	friends
guendaxamigu	friendship
bidxibi	frightened
dxiibi	frightening
bidxi'	frog
de	from
nezalú	front
cuananaxhi	fruit
gasolina	fuel
Fulfulde	Fulfulde
dxá'	full
riguite	fun
runi funcionar	function
nabé importante	fundamental
ra riga'chi' binni	funeral
nayaahui	funny
guidi	fur
nabé nadxiichi	furious
mueble	furniture
jma rusi	further
ne	furthermore
ni chiguizaaca	future
guendaruniganar	gain
guendariguite	game
riuu espaciu	gap
garage	garage
guixi	garbage
jardín	garden
aju	garlic
puertá'	gate
rutopa	gather
ridopa	gather
guendaridagulisaa	gathering
bidii	gave
velocidá	gear
runi	generate
generación	generation
rudii stale	generous
za xpiaani	genius
xi clase	genre
naguudxi ladxidó'	gentle
original	genuine
runi seña	gesture
ricaa	get
racu lari	get dressed
riasa	get up
guiándalu nagueenda	get well soon
chicaa	getting
espíritu	ghost
nabé nazoo	giant
regalu	gift
badudxaapa'	girl
novia	girlfriend
rudii	give
guiree tuuxa gana guni xiixa'	give up
nayeche'	glad
ruuya' nagueenda	glance
vidriu	glass
lente	glasses
ruuya nagueenda	glimpse
guidubi naca guidxilayú	global
zica nacahui	gloomy
guante	gloves
guendaruzaani	glow
ruzaa	glow up
ni ruquiidi'	glue
rie	go
rizá niru	go ahead
ridi'di	go ahead
riree	go away
rigasi	go to bed
yegasi	go to bed
meta	goal
ca meta	goals
chivu	goat
diuxi	god
diuxi cu' ndaaya' lii	god bless you
riebe	goes
chaa	going
oro	gold
ma zé'	gone
naoonde'	goo
xneza	good
padiuxi	good afternoon
adiós	good bye
tica sti dxi	good bye
sicarú dxi	good day
buenas noches	good evening
galán dxiiña'	good job
mozo	good looking
guapu	good looking
padiuxi	good morning
padiuxi xhunca	good morning my love
buenas noches	good night
adiós	goodbye
padiuxi	goodnight
buenas noches	goodnight
Google	Google
Google rini'	Google Translate
patu	goose
nabé sicarú	gorgeous
rini' binni	gossip
ruchaga ruaa	gossip
gucuaa	got
anjá'	got it
gobiernu	government
rinaaze	grab
calificación	grade
chaahui' chaahui'	gradually
biluxe scuela	graduate
biidxi	grain
rudii	grant
bidiee lugar	granted
bidiee permisu	granted
uva	grapes
riene	grasp
rinaaze	grasp
guixi ga'	grass
agradecida	grateful
agradeciudu	grateful
guenda rudii xquixe	gratitude
malu	grave
nayuu'	gray
nabé galán	great
rachelú	greed
rachelú	greedy
nagá'	green
ridapa diuxi	greet
cadapa' diuxi	greeting
guendaridapadiuxi	greetings
nayuu	grey
cuaqdru	grid
guendaruuna'	grief
guendayuuba ladxidó'	grief
ruutu'	grind
riuutu'	grind
rinaaze dxiichi'	grip
guendaró	grocery
novio	groom
nabé feu	gross
layú	ground
grupu	group
riniisi	grow
guendariniisi'	growth
naduxhu'	grumpy
Guaraní	Guarani
garantiá	guarantee
rapa	guard
runi adivinar	guess
invitadu	guest
rului' xi neza cheu'	guidance
donda	guilty
dxe	guy
bichi	guys
dxé	guys
ni rúninu guirá dxi	habit
gupa	had
guicha ique	hair
galaa	half
sala	hall
ná	hand
palanca	handle
manija	handle
guapu	handsome
rugaanda	hang
randa	hang
tidi tiempu juntu	hang out
rizaaca	happen
raca	happen
bizaaca	happened
guendanayeche'	happiness
nayeche'	happy
felicidades	happy birthday
feliz cumpleaños	happy birthday to you
feliz iza cubi	happy new year
naguidxi	hard
nachuga	hard
nabé huaxié'	hardly
nabé nagana	hardly
huaxié' pe	hardly ever
dañu	harm
nagidxi	harsh
cosecha	harvest
napa	has
guendarixhacala'dxi'	hate
rapa	have
sicaru cheu'	have a good day
gapu ti dxi galán	have a nice day
ré' café	have breakfast
rieche	have fun
ma udólo la?	have you eaten
cayápa	having
naxoo	hazard
gupa	haze
laabe	he
napabe	he has
laabe napabe	he has
laabe nga	he is
laabe	he is
ique	head
yuuba' ique	headache
nanda'	heal
cayanda	healing
riuu galán	health
nazaaca	health
nazaaca	healthy
runadiaga	hear
binadiaga	heard
ladxidó'	heart
nandá'	heat
paraísu	heaven
naná	heavy
nasoo	height
ni rcaa herencia	heir
gula'na'	heist
bi'ni ' huantar	held
byua'	held
gabiá	hell
Padiuxi	Hello
xi tal xa xhunca	hello dear
xi modo nuutu	hello how are you
padiuxi ximodo nuu lu	hello how are you
padiuxi xi nálu'	hello how are you doing
cascu	helmet
racané	help
ni racané	helpful
nga runi	hence
laabe	her
naguidi	herd
nachonga	herd
rarí'	here
runi dudar	hesitate
Nuu	Hey
Padiuxi	Hi
Xi tal xaa. Xi modo nuulu'	hi how are you
Xi nou' pue	Hi there
naga'chi'	hidden
rucaachi'	hide
rigaachi'	hide
tu runi mandar	hierarchy
nasoo	high
runi resaltar	highlight
rigui'ba dani	hike
rigui'ba dani	hiking
nabé nayaahui	hilarious
dani	hill
laa	him
dxita xa'na'	hip
dxita xha'na'	hips
runi contratar	hire
ruquixe	hire
cayuni contratar	hiring
stibe	his
historia	history
golpe	hit
guendaridapa.ridapa	hit
rigapa	hit
mmm	Hmm
ribeza	hold
guleza	hold on
guiiru'	hole
vacación	holiday
guiiru'	hollow
yoo	home
rayoo	home
tariá	homework
runi ni jneza	honest
dxiña yaga	Honey
rusisaca	honor
gorro	hood
gui'chi'	hook
richesa	hop
esperanza	hope
guendaribeza xiixa	hope
zandaca	hopefully
que gapa esperanza	hopeless
qué ganna xi guni	hopeless
cachu	horn
feu	horrible
guendaruchibi	horror
mani'	horse
hospital	hospital
guidxaagalú	hospitality
ñaduxhu'	hostile
nandá'	hot
hotel	hotel
ora	hour
ca hora	hours
yoo	house
xpinni lidxi	household
Ximodo	how
Lii ya'	how about you
xi modo nuulu'	how are you
xi nou'	how are you doing
xi modo nuulu' yannadxI rí'	how are you doing today
xi modo nuulu yannadxí	how are you today
Mucho gusto	how do you do
ximodo nuu	how is
panda	how many
pagala	how much
cada panda	how often
panda xhízalu'	how old are you
xi modo nuu dxi stiu'	how was your day
ximodo guyuu gueela' stiu'	how was your night
necasi	however
conector	hub
xheela'	hubby
guendariguiidxi	hug
nabé narooba	huge
binni	human
ni qué rudxiiba' laaca laa	humble
nadxe'	humid
guendanadxé'	humidity
gayuaa	hundred
rie guuze'	hunt
bi yooxho' ne nisaguie	hurricane
racapurá	hurry
janna	hurry up
gucapurá	hurry up
chixe	hurry up
racaná	hurt
xheela'	husband
yoo de ziña	hut
guendanayá	hygiene
Naa	I
naa nga	I am
Naa	I am
Nuaa nazaaca'	I am fine
zanda	I can
qué zanda	I can't
ya	I do
qué ganna diá'	I do not know
qué riene'	I do not understand
que	I don't
qui	I don't
Qué ganna diá'	I don't know
Qué riene'	I don't understand
que riene' xi caniu'	I don't understand what you mean
qué riene' lii	I don't understand you
qué riene' laatu	I don't understand you
qué ganna'	I don’t know
qué ganna diá'	I don’t know
qué riene'	I don’t understand
naa rabe'	i guess
gupa'	I had
napa'	I have
ma huayaa	I have been
cabeza nga	I hope so
Nanna'	I know
riuladxe'	I like
riuladxe' lii	I like you
Nadxiee'	I love
nadxiee bizana' ni huaniisi'	I love my big brother
nadxiee biche' ni huaniisi'	I love my big brother
nadxiee bizana' ni huaniisi'	I love my big sister
nadxiee benda' ni huaniisi'	I love my big sister
nadxiee bixhoze'	I love my father
nadxiee biche' huiine'	I love my little brother
nadxiee bizana' huiine'	I love my little brother
nadxiee benda huiine'	I love my little sister
nadxiee biche huiine'	I love my little sister
nadxiee bizana' huiine'	I love my little sister
ndxiee ñaa	I love my mother
Nadxiee' lii	I love you
Nabé nadxieeli stale	I love you so much
Laaca nadxiee li	I love you too
Naa rabe'	I mean
ribana' lii	I miss you
nabé ribana' lii	I miss you so much
riene'	I see
ruuya'	I see
cá ique'	I think
Naa rabe'	I think
riene'	I understand
racaladxe'	I want
Racaladxé' guuya' lii	I want to see you
ranaxhiee' lii	I want you
guca'	I was
guyuaa	I was
ñaca'	I would be
naa	I'm
Nuaa galán	I'm fine
Nuaa galán	I'm good
Nuaa nazaaca	I'm good
arí nuaa	I'm here
bitiidi'la'dxi' naa stonda'	I'm sorry
nia hielu	ice
nieve	ice cream
ngueca ni	identical
runibiá'	identify
tu lii	identity
dieta	idiot
ribeza	idle
pa	if
cadi guuya binni xiixa'	ignore
cadi gunadiaga binni xiixa'	ignore
huará	ill
guendahuará	illness
Ilocano	Ilocano
imagen	image
ruxuí'lu	imagine
nagasidú'	immediately
sombaya	immense
nabé ngoola	immense
nabé narooba'	immense
qué nuudxi	impatient
qué gapa gana cueza	impatient
sí de sti guidxiró'	import
guendarisaca	important
rabi binni guni ni ná	impose
nabé nagana	impossible
impresión	impression
rusichaahui'	improve
ndaani	in
ne	in addition
nga runi	In fact
ngue runi	In fact
mezalú	in front of
ti	in order to
cadi jneza	inappropriate
ni bizaaca	incident
riguu	include
ne	including
riaxa	income
runi ganar	income
bidale	increase
bi'ni' ni narooba	increased
ridxaga yaa	incredible
dxandí'	indeed
laasibe	independent
India	India
rusihuinni	indicate
laasi'	individual
tobi	individual
ba'du'	infant
rapa infección	infection
infinidá	infinity
dxá gui	inflammation
influencia	influence
runi reportar	inform
rudii información	information
ni ziné ni	ingredients
herencia	inheritance
gucaná	injured
gucaná	injury
qué gapa donda	innocent
guidxela ni nacubi	innovation
guendarinaba' diidxa'	inquiry
nahuati	insane
gasti xpiaani'	insane
biushi'	insect
cadi nuaa seguru	insecure
riguu	insert
ndaani'	inside
guendananna	insight
janna	insist
jora	insist
qué randa gasi'	insomnia
riguu gana	inspire
riba'qui'	install
nagasi	instant
lugar de	instead
lugar	instead of
rusaana diidxa' xi chiguni tobi	instructions
riguu dí	insult
seguru	insurance
nuu jneza	intact
guendaruni ni jneza	integrity
ni nuu xpiaani'	intellectual
guendabiaani'	intelligence
xpiaani'	intelligent
racala'dxi' guni xiixa'	intend
ni chicaa xiixa'	intended
nabé fuerte	intense
rapa gana tobi guni xiixa'	intention
interés	interest
interesadu	interested
bia guýu'	interesting
runi interferir	interfere
intermediu	intermediate
ndaani	internal
internacional	international
internado	internship
rutiixi diidxa'	interpret
ni rutiixi diidxa'	interpreter
ruchiiña'	interrupt
runi entrevistar	interview
riuu gaxha tobi	intimate
ratané tuuxa'	intimate
chu' ne tuuxa'	intimate
ndaani	into
runi presentar	introduce
ni zeeda' lúni	introduction
natui lú	introvert
qué vale ni	invalid
xiixa' nacubi	invent
inventario	inventory
runi invertir	invest
riguu bueltu negocio	invest
runi investigar	investigate
invitación	invitation
runi invitar	invite
factura	invoice
runi incluir	involve
nuaa involucradu	involved
fierru	iron
isla	island
biuu stubi si	isolated
guendanagana	issue
ca asuntu	issues
laani	it
laani	it is
gucani	it was
ndi nga	it's
ndi ni	it's
zaa naca	it's ok
galán nuuni	it's ok
zaa nuni	It's okay
xiixa'	item
artículo	items
sti	its
naa nga	I’m
naa	I’m
chamarra	jacket
lidxi guiiba'	jail
Enero	January
jarra	jar
dxitalaya	jaw
celosa	jealous
celoso	jealous
gasti' xpiaani	jerk
dxiiña'	job
ruxooñe'	jogging
riuu juntu	join
juntu	joint
gui'di'	joint
chiste	joke
periodista	journalist
guendarizá	journey
guendanayeche'	joy
juez	judge
jugu	juice
julio	july
richesa	jump
junio	june
guixi	junk
neza	just
bi'ni' si ni	just do it
guiaxa donda	justice
justicia	justice
Kalaalisut	Kalaallisut
rapa interés	keen
riuu interés	keen
rapa	keep
uyuu gana	keep it up
zacape' bi'ni' ni	keep it up
gupa	kept
huagapa	kept
jarra	kettle
llave	key
ruca ñee	kick
ba'du'	kid
caguite si	kidding
la'dxi'	kidney
xuidi	kids
ruuti	kill
clase	kind
casi	kinda
amable	kindly
guendariá binni	kindness
guendanachaahui	kindness
rey	king
bixhidu'	kiss
guzina	kitchen
papalote	kite
mistu' huiini'	kitten
xibi	knee
guna	knew
gudxiú	knife
ranna	know
xpiaani'	knowledge
huayunibiá'	known
Konkani	Konkani
Krio	Krio
etiqueta	label
dxiiña'	labor
dxiiña'	labour
riaadxa'	lack
escalera	ladder
na	lady
gula'qui'	laid
nexhe'	laid
nisadó yati	lake
dendxu'	lamb
lámpara	lamp
layú	land
paisaje	landscape
diidxa'	language
naziuula'	large
últimu	last
apellidu	last name
huadxí	late
cazipé'	lately
nagá	later
xqui'	latest
últimu	latter
ruxidxi	laugh
cuxidxi	laughing
guendarixidxi	laughter
ruzulú	launch
rigui'bi lari	laundry
ley	law
guixi gá	lawn
abogadu	lawyer
riguixhe	lay
reeche	layout
nachaaba'	lazy
riza niru	lead
líder	leader
bandaga	leaf
rixii	leak
careeche	leak
nalase'	lean
ratagudaa'	lean
richesa	leap
riziidi'	learn
caziide'	learning
ruquixe	lease
cine	leather
salida	leave
ribi'be	leaves
ziné	led
ladu bigá'	left
ñee	leg
legal	legal
cuentu	legend
dxandí	legit
rutiiñe'	lend
ziuula'	length
menu	less
lección	lesson
rudii lugar gúni xiixa'	let
gui'chi'	letter
lechuga	lettuce
nivel	level
riquiiñe palanca	leverage
responsabilidad	liability
lidxi gui'chi'	library
rixupi	lick
guendarusiguii	lie
guendarusiguii	lies
ribani	life
elevador	lift
biaani	light
rayu	lightning
riula'dxi'	like
zandaca	likely
zaqueca lii	likewise
ngueca lii	likewise
raya	line
Lingala	Lingala
cadena	link
lión	lion
nanisa	liquid
lista	list
rucaadiaga	listen
cayunadiaga	listening
zacape'	literally
literatura	literature
rusa'bi guixi	litter
nahuiini	little
nagasi cayácani	live
la'dxi'	liver
ca guendanabani	lives
nabani	living
cabeza	living
nabeza	living
sala	living room
gupayoo	lizard
rúa'	load
ndaa	loaf
rutiiñe'	loan
local	local
lugar	location
ruseegu'	lock
ridaagu'	lock
candadu	lock
rucaa	log
runi registrar	log
stubi si	lonely
ziuula'	long
ma xhidxi que huayuuya' lii	long time no see
ruuya'	look
buelta	loop
nachaacha	loose
señor	lord
riniti	lose
riniti	loss
riniti	lost
tindaa yú	lot
ruini stale ruidu	loud
riziila'dxi'	lounge
guendaranaxhii'	love
nadxiee lii	love you
sicarú	lovely
xaguete'	low
rinete'	lower
qué ruchee	loyal
rapa suerte	luck
napa suerte	lucky
Luganda	Luganda
maleta	luggage
bola	lump
guendaró	lunch
lujoso	luxury
cusiguiibe	lying
máquina	machine
nahuati	mad
na	madam
bi'ni'	made
revista	magazine
nabé sicarú	magnificent
criada	maid
risaca	main
rapa	maintain
Maithili	Maithili
presidente	major
casi guidubi	majority
runi	make
hombre	male
nguiuu	male
correu	mall
hombre	man
rapa	manage
maneju	management
gerente	manager
rapa xidé guni tuuxa xiixa	mandatory
lista	manifest
riguite ique tuuxa'	manipulate
modo	manner
manual	manual
stale	many
rizá	march
runi marchar	march
márgen	margin
luguiaa	market
guendaxheela'	marriage
ma bichaganabe	married
ma bichaganácabe	married
mbio'xho'	mask
misa	mass
nabé ngola	massive
partidu	match
bichi	mate
material	material
matemática	math
risaca	matter
asuntu	matter
ma huaniisi	maturity
mayo	may
zándaca	maybe
naa	me
naa laaca	me too
guendaró	meal
rini'	mean
xi rini'	meaning
rini'ni	means
rini' ni	meant
laga	meanwhile
runi medir	measure
medida	measure
medida	measures
beela'	meat
medecina	medicine
modo	medium
runibiá'	meet
guendaridagulisaa	meeting
Meiteilon	Meiteilon
ribiá hielu	melt
guendarietenala'dxi'	memories
guendarietenala'dxi'	memory
rini'	mention
biete la	mentioned
maestru	mentor
negociante	merchant
guendarilasela'dxi'	mercy
Feliz navidad	merry christmas
reeche	mess
diidxa'	message
na mucu	messy
rieeche' guirá cosa	messy
guiba'	metal
modo guni tobi xiixa'	method
ca biziña	mice
galahui'	middle
galaa gueela'	midnight
stipa	might
ni tan nandá' ni tan nagaanda'	mild
dxú	military
niidxi	milk
millón	million
ique	mind
modo rini' ique binni	mindset
stine'	mine
nahuiini'	minor
minutu	minute
minutu	minutes
milagru	miracle
espeju	mirror
gadxé gadxé cosa	miscellaneous
nadxi'ña'	mischievous
guenda zi'	misery
ribana' tuuxa	miss
runiti xiixa	miss
cabana' lii	miss you
biniti	missing
gupa	mist
guendaruchee	mistake
Mizo	Mizo
clular	mobile
runi burla	mock
modelo	model
modernu	modern
nacubi	modern
modestu	modest
nadxe'	moist
nadxe'	moisture
bé	mold
biuyaa	mole
amá	mom
ñaa	mom
ORA	moment
Lune	monday
bueltu	money
runi bigilar	monitor
migu	monkey
beeu	month
modo nuu tobi	mood
nabé ridxiichi'	moody
beu'	moon
xpiá'	moral
jmáru'	more
jmá	more
ne	moreover
siadó'	morning
hipoteca	mortgage
casi guirá'	most
casi guirá'	mostly
amá	mother
ñaa	mother
guendariniibi	motion
ni runiibi tobi gúni xiixa'	motivation
dani	mountain
biziña	mouse
ruaa	mouth
riniibi	move
caniibi	movement
bandaa ruzeete'	movie
na	mrs
stale	much
beñe	mud
músculo	muscle
museu	museum
saa	music
bigani	mute
stinne'	my
xhncu stinne'	My dear
xhamiguá'	my friend
dxá bendagali'aerodeslizador stinne'	My hovercraft is full of eels
xhuncu stinne'	my love
naa laaya'	my name is
xcustu stinne'	my pleasure
naa	myself
cuentu	myth
clavu	nail
qué gapa donda	naive
lá	name
nabé'	narrow
cadi nayá	nasty
nacional	national
nacionalidad	nationality
ra nagui'xi'	nature
bibixhila'dxi'	nausea
gaxha	near
gaxha	nearby
cadi zitu de rarí'	nearby
nabé casi	nearly
nayá	neat
naquiiñe'	necessary
malaya	neck
cadena	necklace
necesidá	need
que'	negative
co'	negative
qui	negative
qué rulabi tuuxa'	neglect
runi negociar	negotiate
rutoo	negotiate
vecinu	neighbor
barriu	neighborhood
nin	neither
sobrinu	nephew
ripapa ladxidó'	nervous
lidxi mani' huiini'	nest
guixhe	net
red	network
qué ribi partidu	neutral
qué ñuu dxí	never
cadi gaca rendirlu	never give up
gasti' naca	never mind
gasti' problema	never mind
zaa nuuni	nevermind
neca zacá	nevertheless
nacubi	new
nacubi	news
noticia	news
sti	next
cue'	next to
galán	nice
rieche' ladxiduá' gunebiaaya' lii	nice to meet you
sobrina	niece
gueela'	night
huaxhinni	night
ga'	nine
chii ne ga'	nineteen
tapa late gande ti de chii	ninety
noventa	ninety
cadi	No
qué	No
Có'	No
gasti' problema	no problem
zaa nuuni	no problem
co' dxe	no way
guiruti'	nobody
ruidu	noise
rixidxi	noise
nuu stale ruidu	noisy
nin tobi	none
galaa dxí	noon
co' xha	nope
co'	nope
nin	nor
normal	normal
guiá'	north
xii	nose
ribana'	nostalgic
qué	not
có'	not
qué	not at all
cadi nagasi di'	Not now
ca'ru' di'	not yet
ricá diidxa'	note
ma' biene'	noted
ma bicaa ni	noted
gasti'	nothing
rudii cuenta	notice
biiya' xiixa'	noticed
bidii cuenta	noticed
ni rini'	noun
la xiixa'	nouns
nacubi	novel
noviembre	november
nagasi	now
yanna	nowadays
guendahuati	nuisance
gasti'	null
qué runi sentir	numb
númeru	number
enfermera	nurse
nuez	nut
nuez	nutmeg
bañu	oath
guendanangoola	obesity
runi obedecer	obey
ruzuhuaa diidxa'	obey
xiixa' cosa	object
xiixa'	object
nacahui	obscure
guuya chaa'hui	observation
rundaachi'	observe
ruuya chaahui'	observe
nabé ca ique guni xiixa'	obsessed
guiaa	obsession
ma que iquiiñe'	obsolete
ma gudi'di stiempu	obsolete
ni qué rudii lugar tidi xiixa'	obstacle
runi conseguir	obtain
gucuaa	obtained
rihuini dxiichi'	obvious
rihuinni dxiichi'	obviously
nuu biaje	occasionally
dxiiña'	occupation
guyuu xiiña'	occupied
rizaaca	occur
guca'	occurred
racani	occurs
nisadó' ró'ba'	ocean
otubre	october
probabilidá	odds
sti	of
ya pué	of course
bisui'	off
nabé runiná	offensive
oferta	offer
oficina	office
nabé seguidu	often
ah	Oh
dxandí la	oh really
aceite	oil
ok	ok
buenu xhuncu	ok dear
buenu xhunca	ok honey
buenu xhunca	ok my love
buenu xhuncu	ok my love
okay	okay
zaa nuu xheela'	okay baby
Bueno xhuncu	okay dear
bueno xhuncu	okay honey
ya xhuncu	okay my love
rigola	old
nayooxho' yo'xho'	old
lu	on
ti biaje	once
ti tiru	once
tobi	one
naquiiñe' jmá de ti diidxa'	one language is never enough
cebolla	onion
en línea	online
si	only
rixele'	open
rixale'	open
operación	operation
opinión	opinion
oportunidad	opportunities
guenda rudii lugar gaca xiixa	opportunity
opción	option
o	or
naranja	orange
orden	order
cadi especial	ordinary
organización	organization
ladu ché tobi	orientation
ra ruzulú	origin
original	original
Cromo	Oromo
bizabi	orphan
stobi	other
pacaa	otherwise
stinu	our
Ni racala’dxidu: gudi’nu lugar guirá binni de guirá ladu guiene guirá ni nuu lu guidxilayú ne ganda guini’cabe nécape’ rini’cabe gadxé gadxé diidxa’.	Our mission: to enable everyone, everywhere to understand the world and express themselves across languages.
Ni racala’dxidu: Gusichaahuidu guirá información ni nuu lu guidxilayú ti ganda iquiiñe’ binni de guirá ladu ne guundacabeni.	Our mission: to organize the world's information and make it universally accessible and useful.
fuera	out
biree de rarí'	out
resultadu	outcome
traje	outfit
nabé amigueru	outgoing
nabé amiguera	outgoing
ra riree xiixa'	outlet
enchufe	outlet
guendarini' xii nga ti cosa	outline
fuera	outside
ridxaga yaa	outstanding
zuquii	oven
luguiá'	over
cherica'	over there
jmá rusi	overall
runi superar	overcome
qué ganna xi guni	overwhelmed
rusa'bi	owe
dama'	owl
stí	own
sti'	owner
buey	ox
pasu	pace
ridopa	pack
paquete	package
ma gudixe	paid
riuuba'	pain
rutiee	paint
pintura	painting
par	pair
nayati	pale
ziña	palm
pan	pan
pandemia	pandemic
ridxibi	panic
pantalón	pants
gui'chi'	paper
paraísu	paradise
paquete	parcel
rutiidila'dxi'	pardon
bixhoze ne ñaa miati'	parents
parque	park
loro	parrot
perejil	parsley
ndaa	part
riu parte	participate
particular	particular
especialmente	particularly
compañeru	partner
saa	party
ridi'di	pass
pasaje	passage
gudi'di'	passed
guti	passed
rati pur tobi	passion
nabé riula'dxi' xiixa'	passionate
qué runi gasti	passive
clave	password
ni ma' gudi'di'	past
runichaahui	patch
neza	path
naguundu ladxidó'	pathetic
rapa pacencia	patience
paciente	patient
rucueeza	pause
pavimentu	pavement
riguixe	pay
ra'ta dxí	peace
nuu dxí	peaceful
durazno	peach
ruaa mani' ripapa	peak
pera	pear
chícharo	peas
nisaxquixhi'	pee
rinesa	pee
riraa	peel
compañeru	peer
ca compañeru	peers
pluma	pen
lápiz	pencil
cayaadxa'	pending
binni	people
pimienta	pepper
rudii cuenta	perceive
rudii cuenta	perception
biasi ni	perfect
runi	perform
runi dxiiña'	performance
zánda ca	perhaps
tiempu	period
riaana	permanent
permisu	permission
rudii lugar	permit
permisu	permit
binni	person
cosa sti binni	personal
personalidá	personality
riguudxi	persuade
mani yoo	pet
fase	phase
filosofiá	philosophy
teléfono	phone
foto	photo
diidxa'	phrase
ribí	pick
rutopa	pick up
reda caa	pick up
ridopa	pick up
riree foto	picture
ndaa	piece
ca ndaa	pieces
bihui	pig
paloma	pigeon
nduni	pile
almohada	pillow
piloto	pilot
ridaabi	pin
rutaabi	pin
piña	pineapple
naxiña yati	pink
huecu	pit
pichar	pitch
riá	pity
lugar	place
ca lugar	places
guendahuará	plague
na pampa	plain
plan	plan
abión	plane
rudxiiba'	plant
ca yaga huiini'	plants
bladu'	plate
plataforma	platform
guendariguite	play
caguite	playing
nacha'hui	pleasant
lá'	please
nuaa nayeche'	pleased
rieche	pleasure
rudii stiidxa'	pledge
dxa'	plenty
enchufe	plug
biadxi	plum
plomero	plumber
ca	plural
programa	podcast
poema	poem
poesiá	poetry
puntu	point
venenu	poison
puliciá	police
política	policy
educadu	polite
namucu	pollution
nabiidi'	pollution
nisayati	pond
alberca	pool
gui'	poop
pobre	poor
rixele'	pop
binni sti guidxi	population
bihui	pork
avena	porridge
puertu	port
ra nuu xiixa'	position
rapa	possess
sti'	possession
sti	possessive
randaca	possible
poste	post
gúnicabe ni sti dxi	postpone
papa	potato
zandaca gacani	potential
riguiñe	pound
guenda na pobre	poverty
biaani'	power
nabé nadipa'	powerful
práctica	practice
rusisaca	praise
risaca	praise
guendariguite	prank
riguite	prank
rininé Diuxi	pray
nabé sicarú	precious
precisu	precise
bia'si	precise
ngape'	precisely
rini' xi chiguizaaca	predict
riula'dxi'	prefer
ribí	preference
naca xiiñi'	pregnant
prejuiciu	prejudice
modo raca xiixa'	preparation
Runi preparar	prepare
bi'ni' preparar	prepared
biu' listu'	prepared
riuu	presence
yanna	present
presentación	presentation
rapa	preserve
ni runi mandar ti guidxi	president
prensa	press
riguu stipa	pressure
riguu presión	pressure
runi pretender	pretend
rului'	pretend
sicarú	pretty
cadi gúnidu xiixa	prevent
ante	previous
mani rigaa	prey
risaca	price
riguiiba' laaca laa	pride
cura	priest
padre	priest
primaria	primary
nagüí	prime
princesa	princess
ni jma risaca	principal
ante	prior
rapa prioridad	priority
lidxi guiiba'	prison
privilegio	privilege
premiu	prize
zandaca	probably
guendanagana	problem
problema	problem
procedimiento	procedure
ridi'di'	proceed
modo gúnicabe xiixa'	process
runi	produce
producción	production
dxiiña'	profession
perfil	profile
ribee luni	profit
ziá'	profound
progresu	progress
proyecto	project
risaca	prominent
runi anunciar	promote
nagueeda'	prompt
tu cani'	pronouns
modo rini'	pronunciation
prueba	proof
neza	proper
sti'	properly
stí	property
propuesta	proposal
napa bueltu	prosperity
runi proteger	protect
rapa	protect
rudxiiba' laaca laa	proud
rusihuini	prove
rudii	provide
huadii	provided
provincia	province
riduba yu	pull
guitu	pumpkin
puntual	punctual
alumnu	pupil
rizí'	purchase
nayá	pure
nagugüí	purple
nuu xi pur	purpose
bolsa	purse
rinanda	pursue
riza nanda	pursuit
rucaná	push
guendariba'qui'	put
guendarucua'qui'	put
certificadu	qualification
calidá	quality
biá'	quantity
cuarentena	quarantine
guendaridinde	quarrel
uechúa	Quechua
reina	queen
muxe'	queer
guendarinaba' diidxa'	query
rinaba' diidxa'	question
fila	queue
nagueenda	quick
nagueenda nagueenda	quickly
chixhe	quickly
guiuba	quickly
riuudxí	quiet
rusaana dxiiña'	quit
guidubi naca	quite
stale guendarinaba' diidxa'	quiz
pabiá chisaca	quotation
lexu	rabbit
carrera	race
ridxiichi' xhaata'	rage
nisaguié	rain
guendaridale	raise
gundisa'	raised
bixooñe'	ran
de rarí' de rarica'	range
nagueenda	rapid
nagueenda'	rapidly
nabé huaxié'	rare
huaxié' biaje	rarely
roncha	rash
huaga	rat
mejor	rather
ne xpiaani'	rational
nayaa	raw
ca'ru gagui	raw
rugaanda	reach
ma bigaanda	reached
guendaruunda'	read
cayuunda'	reading
listu	ready
dxandí	real
ni cayaca nagasi	reality
rudii cuenta	realize
bidii cuenta	realized
nabé	really
rusiniisi	rear
razón	reason
redasilú	recall
rietenala'dxi	recall
recibu	receipt
ricaa	receive
ricaa	received
déru'	recent
cazipe'	recent
nacubi	recent
deru'	recently
recepción	reception
receta	recipe
nabé descuidadu	reckless
runibia'	recognize
rini' galán nga xiixa'	recommend
rini' galán xiixa'	recommended
cá lu gui'chi'	record
bianda	recovery
rectángulu	rectangle
naxiñá'	red
guilá	redemption
raca ni nahuiini'	reduce
rini' xiixa'	refer
ruisihuini casi espeju	reflect
ruzuhuaa	refrain
refri	refrigerator
rudxigeta' bueltu	refund
rini' de que co'	refuse
qué riná	refused
ridapa diuxi	regard
respetu	regard
rini' binni de xiixa'	regarding
nécape'	regardless
ridapa diuxi	regards
ladu	region
ricá lá	register
reda malaya	regret
regular	regular
seguidu	regularly
runi rechazar	reject
rabi	relate
rini'	relate
familia sti binni	related
guni'cabe xiixa'	related
familia	relatives
relax	relax
bindaa'	release
bindaa	released
risaca	relevant
guendaruni cré zúnicabe xiixa pur tobi	reliable
racané	relief
rusianda	relieve
ma bindaa	relieved
religión	religion
nabé rie yuudu'	religious
qué nadi guni xiixa'	reluctant
runi confiar	rely
riaana	remain
restu	remaining
nabé ridxaga yaa	remarkable
remediu	remedy
rietenala'dxi'	remember
riete nala'dxi'	remind
rusiete nala'dxi'	remind
guendarusietenalá'dxi'	reminder
zitu	remote
nabé zitu	remote
raxha	remove
riaaxha	remove
rudii serviciu	render
ruiquixe	rent
ruichaahui'	repair
rusiropa	repeat
ridxaa	replace
guendaricabi	reply
reporte	report
guini' pur tuuxa'	represent
runibiá' binni laabe	reputation
riquiiñe'	require
biquiiñe'	required
rulá	rescue
rilá	rescue
ruyubi	research
ruluí'	resemble
guendanala'dxi'	resentment
resevación	reservation
runi reservar	reserve
binni nabeza ti lugar	resident
rusaana dxiiña'	resign
runihuantar	resilience
runi huantar	resilient
runi huantar	resistance
runi resolver	resolve
respetu	respect
ricabi	respond
ricabi	response
obligación	responsibility
encargadu	responsible
responsable	responsible
rizila'dxi'	rest
Diuxi gu'ya' laa	rest in peace
restorán	restaurant
rusichaahui xiixa' sti biaje	restore
ruzuaa binni de guni xiixa'	restrict
resultadu	results
ruzulú sti biaje	resume
ridoo menudeu	retail
ma guca retirar	retired
ma guleeca xiixa'	retired
ricaani sti biaje	retrieve
rudxigueta0	return
ribigueta'	return
rusihuinni	reveal
bisihuinni	revealed
bihunni	revealed
ruquixhe	revenge
ganancia	revenue
rudii rebersa	reverse
ruuya chaahui'	revise
ridu'yaca pa neza xiixa'	revision
revolución	revolution
premiu	reward
saa	rhythm
custiá	rib
arroz	rice
ricu	rich
rusaabi'	rid
biaje	ride
rie lu carru	ride
camión	ride
avión	ride
xneza	right
nagásipe'	right now
nachonga	rigid
aniú	ring
ruzaa nisa	rinse
rizá nisa	rinse
yaya	riot
buya	riot
nagüí	ripe
rindisa'	rise
guendanagana	risk
enemigu	rival
guiigu'	river
neza	road
riguii	roast
ruquii	roast
ngola	robust
mboota	robust
guie	rock
tindaa yaga	rod
ruzeeque'	roll
techu	roof
cuartu	room
xcu	root
doo	rope
nayu'dxu'	rotten
narangu	rough
biá'	roughly
redondo	round
neza	route
ni runi binni quirá dxi	routine
fila	row
borrador	rubber
guixi	rubbish
nadipa' ruaa	rude
daa ziña	rug
alfombra	rug
runitilú	ruin
regla	rule
regla	ruler
ruxooñe'	run
cuxooñe'	running
gui'xhi'	rural
ruladxi	sack
sacu	sack
bisaca	sacred
runi sacrificiu	sacrifice
seguru	safe
sicaru cheu' lu avión	safe flight
binni nuu xpiaani	sage
guni'	said
rie lu lancha	sail
rie lu barcu	sail
sacrificiu	sake
sueldu	salary
bidoo	sale
zidi	salt
ngueca	same
lacaca ngueca rarí'	Same here
ejemplu	sample
yuxi	sand
Sánscrito	Sanskrit
runi burla	sarcastic
gurí	sat
nayeche'laadxi'	satisfaction
dxá	satisfied
ridxá	satisfy
Sábadu	Saturday
chorizu	sausage
du'xhu'	savage
rapa bueltu	save
biiya'	saw
rini'	say
escala	scale
riguite	scam
pesu	scar
huaxié'	scarce
ridxibe'	scared
bufanda	scarf
guendaridxibi	scary
rí'	scattered
escena	scene
xi'naxhi. xo'naxhi	scent
horariu	schedule
yoo scuela	school
scuela	school
ciencia	science
científicu	scientists
tijera	scissors
ridindene'	scold
rugaanda	scope
puntu	score
guixi	scrap
ribaba	scratch
riguuñe	scratch
rucaa' ridxi	scream
pantalla	screen
rudii buelta torniu	screw
nisadó'	sea
sellu	seal
ruyubi	search
asientu	seat
guiropa	second
guenda naga'chi¿	secret
sección	section
seguru	secure
runi asegurar	secure
seguridad	security
ruuya'	see
ti guidu'yanu	see you
tica nagá	see you later
ti guidu'yanu	see you soon
guidu'ya lii guixi'	see you tomorrow
rigui'ba'	seed
ruyubi	seek
rilui'	seem
rilui'	seems
huayuuya	seen
rapa ataque	seizure
nabé huaxié' biaje	seldom
ribí	select
laaca laa	self
ruyubi puru para si laa	selfish
rutoo	sell
ruseenda	send
biseenda naa foto stiu'	send me your picture
runi sentir	sense
nadá	sensible
nadá	sensitive
ma biseenda	sent
oración	sentence
oración	sentences
rindaa	separate
Sepedi	Sepedi
septiembre	september
secuencia	sequence
serie	series
seriu	serious
naxoo	serious
dxandí	seriously
runi servir	serve
servicio	service
juegu	set
riguixhe	set up
bizuchaahui	setting
riba'qui'	settle
gadxe	seven
chii ne gadxe	seventeen
chonna late gande ti de chii	seventy
setenta	seventy
stale	several
ridiiba'	sew
bigani	sh
bacaanda'	shade
baca'nda	shadow
ribiibi	shake
riniibi dxacha	shake
nandase	shallow
ritui' lú	shame
modo xiixa'	shape
bi'ni' compartir	share
nabé naduxhu'	sharp
laabe	she
napabe	she has
laabe napabe	she has
laabe	she is
dendxu'	sheep
yaza	sheet
estante	shelf
ridxela refugio	shelter
ni rulá	shield
cambiu	shift
ruchaa	shift
ruzaa	shine
barcu	ship
ruseendani lu avión o barcu	shipping
gamixa'	shirt
zapatu	shoes
guidiboco	shoes
runi disparar	shoot
tienda	shop
guriá nisadó'	shore
nachucu	short
huaxhié'	shortage
disparu	shot
ricuaagu	shot
xi'que'	shoulder
rucaa ridxi	shout
show	show
bilui' naa	show me
raze	shower
bendabuaa	shrimp
raca nahuiini'	shrink
da'gu'	shut
de'gu'	shut
bigani	shut up
natui lú	shy
benda	sibling
biza'na'	sibling
bi'chi'	sibling
benda	siblings
biza'na	siblings
bi'chi'	siblings
huará	sick
ladu	side
ricála'dxi'	sigh
bista	sight
tour	sightseeing
rucaa lá	sign
ricaa lá	signature
risaca	significant
dxidó'	silence
dxisi	silent
gasti ridxi	silent
seda	silk
nahuati	silly
plataforma	silver
casi ngueca	similar
nahuati	simp
cadi nagana	simple
dede	since
rini' ni dxandí	sincere
dxadí nga ni canié	sincerely
ruunda'	sing
ti	single
tobi	single
ta	Sir
benda	sister
bizana'	sister
cuñada	sister in law
ribi	sit
lugar	site
ni cayaca	situation
xhoopa'	six
dieciséis	sixteen
chii ne xhoopa'	sixteen
chonna late gande	sixty
paiá'	size
gracia	skill
rapa gracia	skills
guidi	skin
nalasw'	skinny
nisi dxita	skinny
richesa	skip
ridi'di laga	skip
bizuudi	skirt
guibá'	sky
esclavu	slave
rasi	sleep
cayasi	sleeping
ma cayasi	sleepy
manga	sleeve
ndaa	slice
riniibi ti ladu	slide
nalase'	slim
riree chui'	slip
nandagaa	slope
guiiru'	slot
nanene	slow
chaahui'	slow
chaahui dugá	slowly
nahuiini	small
xpiaani	smart
riuu xhii	smell
rinda'	smell
guendaruxidxi	smile
gu'xhu'	smoke
nagú	smooth
bicubé	snail
beenda'	snake
nisa hielu	snow
ne	so
nabé sicarú	so cute
de yanna	so far
rugadxe	soak
xabú	soap
cad naxhudxi	sober
futbol	soccer
sociedad	society
calcetín	socks
naguudxi	soft
software	software
layú	soil
ma' bidoo	sold
ma biráni	sold out
ma birácani	sold out
dxú	soldier
tobi lucha	sole
naguidxi	solid
solución	solution
runi resolver	solve
caadxi	some
tuuxa'	somebody
tu	someone
xiixa	something
nuu biaje	sometimes
guendaruunda'	song
canción	song
saa	song
mayaca	soon
Sorani	Sorani
yuuba'	sore
yuuba yanni	sore throat
guendananá	sorrow
Bitiidila'dxi'	Sorry
ribí	sort
biyube'	sought
huayube'	sought
guenda	soul
compañeru o compañera de vida	soulmate
ruidu	sound
caldu	soup
nadá'	sour
beedani de	source
rireeni de	source
guete'	south
espaciu	space
rindaa	span
diidxastiá	Spanish
refacción	spare
rini'	speak
especial	special
especie	species
laani	specific
guendaridxagayaa	spectacular
guenda rini'	speech
qué ganda ini'	speechless
qué ganda guini'	speechless
velocidá	speed
runi deletrear	spell
riguite bueltu	spend
bidubi xiixa'	spent
bisirá xiixa'	spent
nayana'	spicy
gui'chi'	spike
rudii bieque	spin
espinaca	spinach
espíritu	spirit
nisa xhinni	spit
nabé sicarú	splendid
má ndaa	split
nayuu'dxu'	spoil
biu'dxu'	spoiled
de repente si	spontaneous
gudxara	spoon
lugar	spot
xheela'	spouse
ruchiaa	spread
cuadradu	square
ruquiichi'	squeeze
chisa	squirrel
calle	st
rutaabi	stab
nuu dxiichi'	stable
ribi	stack
equipu	staff
raca manchar	stain
ne'	stain
escalera	stairs
yaga	stake
rizananda	stalk
cubículo	stall
estampilla	stamp
stán	stand
estándar	standard
bele guí	star
ruzulú	start
bizulu	started
candaana' xhaata'	starving
modo nuu xiixa	state
riní'	state
runi declarar	statement
estación	station
estatua	statue
modo nuu xiixa'	status
ra riaana tobi	stay
gupa lii	stay safe
bistec	steak
riba'na'	steal
gubá'	steam
guiiba'	steel
rasi	steep
reeda	stem
pasu	step
tindaa yaga	stick
naguidi	stiff
naguidxi dxita	stiff
ca'ru	still
ruquiichi	sting
naguibi'	stingy
ruchaahui	stir
almacén	stock
huaba'na	stolen
ndaani	stomach
guié	stone
zuhuaa	stood
bangu'	stool
gui'	stool
rizuhuaa	stop
rucueeza	stop
tienda	store
Bi yooxho	storm
ni guca' dxiqué	story
estufa	stove
derechu	straight
derechu	straightforward
rapa presión	strain
dxu'	strange
dxú	stranger
popote	straw
fresa	strawberry
gui'gu huiini'	stream
calle	street
nadipa'	strength
rapa estrés	stress
rusigaa	stretch
estrictu	strict
ridaapa	strike
doo	string
tindaa lari	strip
raxha lari	strip
rugaanda'	strive
rigapa	stroke
nadipa'	strong
ucuá golpe	struck
estructura	structure
guendanagana	struggle
napa guendanagana	struggling
neciu	stubborn
gu'ga'	stuck
estudiante	student
binni ruunda'	student
cayuunda'	studying
xiixa	stuff
ridxagayaa	stunning
nahuati	stupid
estilu	style
tu caní'	subject
runi entregar	submission
runi entregar	submit
sustancia	substance
ruchaa pur stobi	substitute
runi triunfar	succeed
gunda bi'ni' xiixa'	success
biree ni galán	successful
casi	such
por ejemplu	such as
casi	such as
radxi	suck
málasi	sudden
málasi	suddenly
runi sufrir	suffer
guendayuuba'	suffering
bia' cati'	sufficient
ma ngasi'	sufficient
dxiña	sugar
gabi tuuxa gúni xiixa'	suggest
runi sugerir	suggest
gabi tuuxa guni xiixa'	suggestion
TRAJE	suit
riaba ni	suitable
maleta	suitcase
suma	sum
guendaridagulisaa	summit
gubidxa	sun
domingu	sunday
nuu gubidxa	sunny
biaazi gubidxa	sunset
xtuxhu biaani gubidxa	sunshine
ni runi mandar	superior
xaique	superior
supervisor	supervisor
guendaroxhi	supper
guendaracané	support
runi suponer	suppose
runi suponer	supposed
seguru	sure
lu	surface
ridale	surge
rutale	surge
operación	surgery
apellidu	surname
sorpresa	surprise
raca rendir	surrender
guirá' ladu	surrounding
vigilancia	surveillance
runi examinar	survey
ruuya chaahui	survey
randa ribani	survive
gasti' serviciu	suspended
sospechoso	suspicious
rinaaze	sustain
rabi	swallow
ruchaa	swap
runi jurar	swear
rusunisa	sweat
suéter	sweater
rinduuba'	sweep
nadxiña	sweet
gasi nanixe'	sweet dreams
riula'dxi' dxiña huiini'	sweet tooth
xhuncu	sweetheart
ridxá guí	swell
bidxá guí	swelling
rixhuuba'	swim
csxuuba'	swimming
columpio	swing
ridxá gui	swollen
espada	sword
símbolo	symbol
riaba binni galán	sympathy
nayaahui	sympathy
sistema	system
mexá'	table
rindaa ique né	tackle
rucaa la	tag
tipi	tail
ricaa	take
raxha	take away
gupa lii	take care
raxha	take off
ma zinécabe xiixa'	taken
diidxa'	talk
guenda rui' diidxa'	talk
rini' diidxa'	talk
nabé rini' stale	talkative
cola	tall
runi grabar	tape
rugaanda rugaanda	target
ni racala'dxi' ugaanda tobi	target
meta	target
runi saborear	taste
sabor	taste
nanixe'	tasty
bisiidi'	taught
té	tea
rusiidi'	teach
ni rusiiti	teacher
maistra	teacher
equipu	team
rireza	tear
richeza	tear
nisalú	tears
runi finta si	tease
tecnologiá	technology
laya	teeth
rabi	tell
rini'	tell
gudxi naa	tell me
carácter	temper
temperatura	temperature
lucuá	temple
qué zandaa di' xiixa'	temporary
chii	ten
chii mil	ten thousand
ni ruquixe yoo	tenant
nari'ni'	tender
naguudxi	tender
yoo de lari	tent
bi'ini' intentu	tentative
xi tiempu	term
nabé feu	terrible
guidxi	territory
examen	test
rucaa diidxa'	text
que	than
rudii xquixe	thank
xquíxepe' lii	thank you
xquíxepe' lii purti cabézalu' ni beseendadu lii	Thank you for your patience while we investigate shipment
xquíxepe' lii	thank you so much
xquíxepé'	thank you very much
xquíxepe'	thanks
xquixepe' purti caquiiñelu' app stidu	Thanks for using our app
ndica'	that
nga nga	that is
nuuni galán	that's good
ca	the
guendariba'na'	theft
stícabe	their
laacabe	them
tema	theme
laacabe	themselves
óraque	then
teoriá	theory
rarica'	there
nuu	there are
nuu	there is
ngue runi	therefore
ca ndí'	these
laacabe	they
laacabe	they are
laacabe nga	they are
namboolo'	thick
nangola	thick
guba'na'	thief
co're'	thigh
nalase'	thin
xiixa	thing
xiixa cosa	thing
xiixa'	things
ricá ique	think
guionna	third
guendarati nisa	thirsty
chii ne chonna	thirteen
gande ne chii	thirty
ndí	this
ndí ni	this is
guidubi	thorough
guidubi naca	thorough
guidubi	thoroughly
ndica'	those
necape'	though
cá ique xi guni	thoughtful
guenda rica ique	thoughts
mil	thousand
hilu	thread
runi amenazar	threat
chonna	three
ra puerta'	threshold
nabé nayeche'	thrilled
yanni	throat
neza	through
enteru	throughout
guidubi	throughout
rusaa	throughout
rusaba	throw
.ruxii	throw
bicuini ró'	thumb
truenu	thunder
Febes	Thursday
zacá	thus
nayá	tidy
beedxe'	tiger
dxiichi'	tight
guiidxi'	tight
gui'chi'	tight
tigrinya	Tigrinya
tiempu	time
natuilú	timid
nabé nahuiini'	tiny
punta	tip
propina	tip
propina	tips
llanta	tire
bidxaga	tired
gui'chi' bañu	tissue
tindaa beela	tissue
títulu	title
pan	toast
yannadxí	today
ba'du'	toddler
buicuini ñee	toes
juntu	together
bañu	toilet
gudxibe	told
runi huantar	tolerance
qué ridxiichi nagueenda'	tolerate
bichooxe	tomato
guixí	tomorrow
ludxi	tongue
yannagueela'	tonight
laaca	too
biiya'	took
herramienta	tool
herramienta	tools
laya	tooth
punta	top
luguiá	top
asuntu	topic
nareza	torn
runinácabe tuuxa'	torture
pagala guirá ni	total
riga'na'	touch
naguidxi	tough
tour	tour
neza ra	toward
ra	towards
toalla	towel
guidxi	town
malu	toxic
rucaa raya	trace
neza	track
registru	track
guendarutoo	trade
tradición	tradition
tradicional	traditional
nuu stale carru lu neza	traffic
neza	trail
tren	train
entrenamientu	training
guendarusiidi' xi modo gúnicabe xiixa'	training
ruchaa	transfer
guendaruchaa	transition
rutiixhi diidxa'	translate
nayaguié'	transparent
riné	transport
modo rié binni sti ladu	transportation
ruchenda	trap
trampa	trap
guixi	trash
golpe	trauma
rizá	travel
rie sti guidxi	travel
bandeja	tray
tesoro	treasure
guenda ruyubi modo gúnidu xiixa'	treat
runi tratar	treat
yaga	tree
nabé tremendu	tremendous
juiciu	trial
guendarusiguii	trick
bi'ni' intentu	tried
disparu	trigger
runi disparar	trigger
ruchuugu'	trim
biaje	trip
salida	trip
problema	trouble
pantalón	trousers
camión	truck
dxandí'	true
confianza	trust
rapa confianza	trust
dxandí'	truth
runi prueba	try
tsonga	Tsonga
tubu	tube
marte	Tuesday
tou'	turkey
bieque	turn
ruzeeque	turn
rutiixhi	turn
bigu	turtle
maistru	tutor
doce	twelve
gande	twenty
gande ne tobi	twenty-one
twi	Twi
guiropa	twice
ricá bieque	twist
chupa	two
clase	type
feu	ugly
óraque ga	ultimate
paraguas	umbrella
qué ganda	unable
tiú	uncle
rideegu	unconscious
xaguete'	under
xa'na'	underneath
xaguete'	underneath
riene	understand
ma biene	understood
malhaya	unfortunately
uniforme	uniform
tobi si	unique
unidá	unit
scuela ró'	university
qué ganna xii ni	unknown
dede	until
luguiá'	up
ma de lii	up to you
xi cayaca	update
guendarusicubi xiixa'	upgrade
luguiá'	upon
lú	upon
guendaridxiichi	upset
naquiiñe gaca xiixa' nagueenda	urgent
laadu	us
modo riquiiñe xiixa	use
ni ma biquiiñe'	used
riquiiñe'	useful
qué iquiiñe'	useless
cas guirá	usual
dxi	usual
hora	usual
seguidu	usually
serviciu	utility
vacación	vacation
bacuna	vaccine
nisi riga	vacuum
gasti nuu ndaani	vacuum
cadi nayá	vague
raca baler	valid
lade dani	valley
nabé risaca	valuable
valor	value
gadxé gadxé	variety
gadxé gadxé	various
nabé	vary
ta'ta'	vary
dunabé	vary
xiga	vase
vasu	vase
vegetal	vegetable
carru	vehicle
ni rutoo	vendor
venenu	venom
negocio	venture
lugar	venue
ruuya chaahui	verify
runi checar	verify
zanda guni stale cosa	versatile
versión	version
nabé	very
nabé galán	very good
barcu	vessel
neza	via
runi sentir binni xiixa'	vibe
vicioso	vicious
víctima	victim
videu	video
guidxi huiini'	village
binni guendanadxaba'	villain
binni malu	villain
vinagre	vinegar
naooxho'	vintage
guendaridindené	violence
naduxhu'	violent
riula'dxi' tinde	violent
binnidxaapa'	virgin
lu pantalla	virtual
guenda	virtue
rixui'lu	vision
biuuza'	visit
naquiiñe' para guibáni	vital
diidxa'	vocabulary
voz	voice
gasti'	void
volumen	volume
binni racané binni	volunteer
guendaridxi'ba'	vomit
delicadu	vulnerable
guendaridinde	wage
bueltu runi ganar binni	wages
ti'xhi'	waist
ribeza	wait
meseru	waiter
cabeza	waiting
velorio	wake
ribani	wake
ribani	wake up
canazá	walking
pader	wall
cartera	wallet
rizá sin rumbu	wander
racaladxe'	wanna
racala'dxi'	want
naquiiñe'	wanted
guendaridinde	war
lari	wardrobe
bodega	warehouse
nandá'	warm
rulidxi	warn
la guiuu cuidadu	warning
lla guuya' gá	warning
guerreru	warrior
guca	was
riguiibi	wash
guixi	waste
ruuya'	watch
nisa	water
melón	watermelon
ruzabi ná	wave
neza	way
laadu	we
nácadu	we are
nácanu	we are
zanda gúninu	we can
zanda gúnidu	we can
natende	weak
natende	weakness
qué gapa stipa	weakness
stale bueltu	wealth
napa stale bueltu	wealthy
guendariba'qui xiixa	wear
guendaracu xiixa	wear
nacu	wearing
modo nuu dxi	weather
guendaxheela'	wedding
miércole	Wednesday
guixi	weed
semana	week
ra irá semana	weekend
pesa	weight
riguu bia'	weight
latiidi	welcome
chu' neza miati'	welfare
Galán	Well
galán dxiiña'	well done
guyaa	went
guyebe	went
guca	were
neza riaazi' gubidxa	west
nadxe'	wet
ballena	whale
xi	what
lii ya'	what about you
xi cayúnilu'	what are you doing
xi cayúnilu nagasi	what are you doing now
xi cayúnilu nagasi	what are you doing right now
xi cayu'nu' nagasi	what are you doing right now
xi dxiiña' napu'	what do you do
xi ru'nu'	what do you do
xi dxiiña' ru'nu'	what do you do for a living
xi modo nou'	what do you mean
xi racala'dxitu	what do you want
xi racala'dxu'	what do you want
xi guca	what happened
xi laa nga	what is
xiini'	what is
xii ndi'	what is this
xi dxiiña' napu'	what is your job
tu lá lu	what is your name
xi tal xaa	what's up
tu lálu	what's your name
intiisi	whatever
trigu	wheat
volante	wheel
ora	when
modo tiisi	whenever
paraa	where
paraa nuulu'	where are you
pa dé lii	where are you from
paraa nuulu' nagasi	where are you now
paraa nabézalu'	where do you live
paraa nabezu'	where do you live
paraa nuu	where is
purti'	whereas
pa	whether
guná	which
laga	while
riní' dxidxigá	whisper
rutiipi	whistle
naquichi'	white
tu	who
tu lii	who are you
tu nga	who is
tuu ndi'	who is this
guidubi	whole
ni	whom
ni	whose
xiñee	why
xhiñee co'	why not
nadxaba'	wicked
nalaga	wide
ma guti xheela'	widow
viuda	widow
nalaga	width
xheela'	wife
gui'xi'	wild
guendaracala'dxi'	will
racala'dxi'	willing
runi ganar	win
bi	wind
ventana	window
bi yooxho'	windy
vinu	wine
guedananda	winter
rusiá	wipe
alambre	wire
guenda biaani	wisdom
nuu xpiaani	wise
napa xpiaani'	wise
guendarizabila'dxi'	wish
sicaru guye	wish you all the best
bidxaa	witch
ne	with
ribee	withdraw
riaaxha	withdraw
guia'xha	withdrawal
ndaani	within
qué gapa	without
testigu	witness
nayaahui	witty
gueu'	wolf
gunaa	woman
ca gunaa	women
bi'ni ganar	won
rinaba' diixa'	wonder
guendaridxagayaa	wonderful
yaga	wood
lana	wool
ciidxa'	word
ca diidxa'	words
dxiiña	work
ejerciciu	work out
cayuni dxiiña'	working
guidxilayú	world
bicuti'	worm
ma' nayuxe	worn
nuube xizaa	worried
xizaa	worry
rusisaca	worship
ni jmá feu	worst
risaca	worth
risaca ni	worth it
nabér risaca	worthy
ni	would
racaná ladi binni	wound
Guau	Wow
rirenda	wrap
riree xhiana	wrath
riguiiba dí	wrath
yanni ná	wrist
dxita porra ná	wrist
ricá	write
bicaa rari'	Write here
ca' gui'chi'	writing
huacá	written
cadi jneza	wrong
bicaa	wrote
patiu	yard
ridxagaxcaanda'	yawn
anjá'	Yeah
iza	year
ca iza	years
rucaa ridxi	yell
naguchi	yellow
Ya	Yes
ma	Yes
ya xhuncu	yes baby
ya xhuncu	yes dear
ya xheela huiine'	yes honey
ya xhuncu	yes my love
xi modo có'	yes of course
zanda pue	yes of course
neegue'	yesterday
ca'ru	yet
ca'ru' dí'	yet
deru'	yet
rudii	yield
lii	you
lii nga	you are
nabé sicarúlu'	you are beautiful
nabé sicarúlu'	you are so beautiful
maca nannu'	you are welcome
lii zanda	you can
laatu nannatu	You know
lii nannu'	You know
laaca lii	you too
maca nannu'	you're welcome
nahuiini'	young
badu nguiu	young
badu dxaapa'	young
stilu'	your
maca nannu'	your welcome
lii	yourself
laatu	yourself
nahuiini'	youth
maca nannu'	you’re welcome
nanixe	yummy
Diidxazá	Zapotec
gasti'	zero
