tenê	a little
kerematêk	a lot
xeylê	a lot of
teriknayene	abandon
teriknaye	abandoned
mendene	abide
eşkayîş	ability
eşkayox	able
derheq de	about
cor	above
teberê welatî	abroad
çinbîyayîş	absence
çin	absent
eynî wina	absolutely
zere girewtene	absorb
antene zere	absorb
xulasa	abstract
razber	abstract
bêmana	absurd
bereket	abundance
bol	abundant
îstismar	abuse
îstismar kerdene	abuse
aksan	accent
qebul kerdene	accept
ciresayîş	access
cireştene	access
qeza	accident
cayê mendişî	accommodation
besekerdene	accomplish
resna peynî	accomplished
goreyê	according
hesab	account
bêkêmanîye	accuracy
raşt	accurate
suckerde	accused
ser kewtene	achieve
serkewtiş	achievement
qebul kerdene	acknowledge
nas	acquaintance
dest girewtene	acquire
girewte	acquired
destgirewtiş	acquisition
ser ra	across
kerdene	act
aksîyon	action
aktîf	active
aktîvîteyî	activities
aktîvîte	activity
kaybaz	actor
raştikên	actual
esasen	actually
giran	acute
yê xo kerdene	adapt
dest dayene	adapt
îlawe kerdene	add
tîryakî	addicted
îlawe	addition
îlawe	additional
adrese	address
xitab kerdene	address
cade	adequate
pêranîyaye	adjacent
sifet	adjective
eyar kerdene	adjust
ecibnayene	admire
qebul kerdene	admit
yê xo kerdene	adopt
qebul kerdene	adopt
zaf şîrin	adorable
averşîyayîş	advance
aver şîyene	advance
averşîyaye	advanced
avantaj	advantage
macera	adventure
zerfe	adverb
reklam	advertisement
reklam kerdene	advertising
şîret kerdene	advice
şîret	advise
pawitene	advocate
avûkat	advocate
estetîk	aesthetic
têkilî	affair
tesîr dayene	affect
sînayîş	affection
pê besekerdene	afford
hêrînbar	affordable
tersaye	afraid
dima	after
peyê perojî	afternoon
dima	afterwards
reyna	again
duşt de	against
serrî	age
ajans	agency
ajan	agent
hêrişkar	aggressive
vît	agile
ra ver	ago
hemfikr bîyene	agree
pêkerdiş	agreement
zîret	agriculture
raver	ahead
hetkarîye	aid
amanc	aim
hewa	air
teyarageh	airport
vîyar	aisle
alarm	alarm
alkol	alcohol
baldarî	alert
weş	alive
heme kes	all
temam	all right
qewet bo	all the best
verdayene	allow
bidestûr	allowed
hema-hema	almost
tena	alone
bi … ya	along
xora	already
Temam	Alright
zî	also
alternatîf	alternative
herçiqas ke	although
hertim	always
a	am
fewqelade	amazing
nedîyar	ambiguous
hewes	ambition
hewesdar	ambitious
raşt kerdene	amend
mîyan de	amid
mîyan de	among
mabênê ma de	among us
mîqdar	amount
komîk	amusing
analîz	analysis
bav û kal	ancestors
asinê keştîye	anchor
qedîm	ancient
û	and
ma ti	and you
melek	angel
hêrs	anger
hoke	angle
hêrsin	angry
heywan	animal
savoke	ankle
serrgêre	anniversary
vilaweke	announcement
hêrs kerdene	annoy
hêrsbîyaye	annoyed
tacizker	annoying
serrane	annual
anonîm	anonymous
yewna	another
cewab	answer
cewab dayene	answer
hêvî kerdene	anticipate
qisawete	anxiety
biqisawet	anxious
teba	any
êdî	anymore
kes	anyone
çîyêk	anything
welhasil	anyway
welhasil	anyways
ra ber	apart
qateban	apartment
ozrê xo waştene	apologize
eşkera	apparent
merdim vano qey	apparently
îtîraz kerdene	appeal
muracad kerdene	appeal
asayene	appear
asayîş	appearance
asaye	appeared
made	appetite
saye	apple
muracat	application
muracat kerdene	apply
randevu	appointment
qedrê ci zanayene	appreciate
sipasdarî	appreciation
helwêst	approach
nêzdî bîyene	approach
munasîb	appropriate
tesdîq	approval
tesdîq kerdene	approve
tesdîqbîyaye	approved
kêm-zêde	approximately
nîsane	april
keyfî	arbitrary
mîmar	architect
mîmarîye	architecture
arşîv	archive
ê	are
ti ya	are you
meşgul î	are you busy
ti zewicîyayî ya	are you married
ti zewicîyaya ya yan azeb a	are you married or single
Ti hîna uca yî?	Are you still there?
ti uca der a	are you there
herême	area
munaqeşe kerdene	argue
arguman	argument
weriştene	arise
harme	arm
artêşe	army
fekafek	around
eyar kerdene	arrange
eyarkerdiş	arrangement
resayîş	arrival
resayene	arrive
resaye	arrived
qure	arrogant
tîre	arrow
huner	art
meqale	article
viraşte	artificial
hunermend	artist
sey	as
heta ke	as long as
zî	as well
hem zî	as well as
wele	ash
şermezar	ashamed
persayene	ask
perskerde	asked
hewn de	asleep
het	aspect
Asameskî	Assamese
hêriş kerdene	assault
meclîs	assembly
xobawer	assertive
erjnayene	assess
erjnayîş	assessment
mal û milk	asset
mal û milk	assets
wezîfe dayene	assign
tayîn	assignment
hetkarîye kerdene	assist
hetkar	assistant
hemkar	associate
eleqedar	associated
yew kerdene	association
ferz kerdene	assume
ferzkerdiş	assumption
de	at
tewr tay	at least
werd	ate
atlet	athlete
îlawe kerdene	attach
pirakerde	attached
îlawe	attachment
hêriş kerdene	attack
teşebus kerdene	attempt
teşebus	attempt
beşdar bîyene	attend
beşdarîye	attendance
dîqet	attention
şêle	attitude
celb kerdene	attract
atraksîyon	attraction
cazîbedar	attractive
sifet	attribute
temaşewan û goşdarî	audience
tebaxe	august
eme	aunt
xalike	aunty
otantîk	authentic
nuştox	author
otorîte	authority
payîz	autumn
mewcûd	available
averaj	average
ci ra dûrî vindetene	avoid
hişyar bîyene	awake
xelate	award
hayîdar	aware
hişyarîye	awareness
dûrî	away
harîka	awesome
berbad	awful
bêeleqe	awkward
Aymara	Aymara
pit	baby
xorto azeb	bachelor
peyser	back
peyzemîn	background
xirabin	bad
çente	bag
alef	bait
pewtene	bake
firine	bakery
sodyum karbonat	baking soda
hemsencîye	balance
hemsencîye viraştene	balance
gude	ball
Bambara	Bambara
muze	banana
kome	band
req û teq	bang
reqayene	bang
banka	bank
bar	bar
bi zehmetî	barely
bazar kerdene	bargain
qafik	bark
lawayene	bark
cew	barley
sînor	barrier
bingeh	base
temelî	based
qatê erdî	basement
bingeyên	basic
eslê xo de	basically
rihan	basil
pinc	bastard
pêserîye	batch
awke	bath
awke	bathroom
baterya	battery
ceng	battle
kendawe	bay
bîyene	be
baldar be	be careful
plaj	beach
tîrêje	beam
lobîkî	beans
heş	bear
tebitîyayene	bear
erdîşe	beard
tewir	bearing
cinawir	beast
piro dayene	beat
pirodayîş	beat
rindek	beautiful
rindekîye	beauty
bî	became
çike	because
bîyene	become
cile	bed
odaya rakewtişî	bedroom
hinge	bee
goştê naxirî	beef
bî	been
bîra	beer
verê	before
dest pêkerd	began
dest pêkerdene	begin
destpêk	beginning
bi nameyê	behalf
hedê xo zanayene	behave
roniştiş weriştiş	behavior
hal û hereket	behaviour
pey de	behind
bîyayîş	being
bawerî	belief
bawer kerdene	believe
vêre	belly
aîd bîyene	belong
heskerde	beloved
cêrên	below
qayîş	belt
kursîya derge	bench
fetiloke	bend
bin de	beneath
feyde	benefit
feyde dayene	benefit
faydeyî	benefits
kîşte de	beside
yew zî	besides
tewr rind	best
bixeyr bo	best of luck
zaf selamî	best regards
rindêr	better
mabên de	between
çîyê şimitişî	beverage
ra dot	beyond
Bhojpurî	Bhojpuri
verhukm	bias
verhukmdar	biased
bîsîklete	bicycle
pêşnîyaze	bid
girs	big
bîsîklet	bike
fatura	bill
girê dayene	bind
mîlçike	bird
rojbîyayîş	birthday
vîçek	bit
gaj kerdene	bite
gaj	bite
tal	bitter
sîya	black
fekê kardî	blade
sucdar kerdene	blame
suc	blame
tal	blank
betanîya	blanket
teqayîş	blast
zewq	blast
awa çamaşirî	bleach
sipî kerdene	bleach
pêşanayîş	blend
pîroz kerdene	bless
şukur kerdene	bless
bimbarek	blessed
kor	blind
bextîyarî	bliss
asteng kerdene	block
gonî	blood
akerdene	bloom
puf kerdene	blow
kewe	blue
kon	blunt
heyetê îdareyî	board
keştîye	boat
leşe	body
girênayene	boil
qalind	bold
girê dayene	bond
este	bone
kitab	book
ca abirnayene	book
averberdiş	boost
aver berdene	boost
destek	booster
verbarkerdiş	boot
bot	boot
botî	boots
sînor	border
qule kerdene	bore
bêhêdîr	bored
acizker	boring
bîya	born
deyn kerdene	borrow
patron	boss
her di	both
nerehet kerdene	bother
şuşe	bottle
bin	bottom
hêrînaye	bought
xil dayene	bounce
girêdaye	bound
sînorî	boundaries
kemane	bow
tase	bowl
qutîye	box
lajek	boy
dost	boyfriend
bazin	bracelet
mezg	brain
şax	branch
marka	brand
çêr	brave
şikitene	breach
nan	bread
şikitene	break
mabên	break
arayîye	breakfast
çiçik	breast
nefes girewtene	breath
nefes girewtene	breathe
weyî kerdene	breed
tuxla	brick
veyveke	bride
pird	bridge
kilm	brief
roşt	bright
jîr	brilliant
ardene	bring
bira	bro
hîra	broad
weşan kerdene	broadcast
şikit	broke
îflas	broke
şikite	broken
gezî	broom
bira	brother
vistewre	brother in law
ard	brought
qeweyî	brown
firçe kerdene	brush
beroş	bucket
dosto	buddy
butçe	budget
lulik	bug
awan kerdene	build
awanî	building
ban	building
awanîye	built
govde	bulk
boxe	bull
zorbazîye kerdene	bully
pêro ginayene	bump
deste	bunch
qevde	bundle
barpişt	burden
barpişt kerdene	burden
wedarit	buried
veşnayene	burn
peqayîş	burst
wedardene	bury
otobuse	bus
leme	bush
kar	business
heykel	bust
meşgul	busy
la	but
rûno kele	butter
perperike	butterfly
gocege	button
hêrînayene	buy
bi	by
na esna de	by the way
oxir bo	bye
kelem	cabbage
dolabe	cabinet
hukmat	cabinet
qefes	cage
kek	cake
guk	calf
telefon kerdene	call
vengdayîş	call
mi rê telefon bike	call me
bi nameyê	called
aram	calm
ame	came
kampanya	campaign
eşkayene	can
qutî	can
Betal kerdene	Cancel
kanser	cancer
hêgin	capable
kapasîta	capacity
paytext	capital
manşet	caption
girewtene	capture
erebe	car
karîyer	career
baldar	careful
bi baldarî	carefully
bêxem	careless
zerrîvêşaye	caring
necar	carpenter
xalî	carpet
gizêr	carrot
kiriştene	carry
dewam kerdene	carry on
ardene ca	carry out
rewşe	case
pêşîn	cash
eştene	cast
qesir	castle
rojane	casual
pisînge	cat
tepiştene	catch
kategorî	category
naxir	cattle
tepişt	caught
sebeb bîyene	cause
sebeb	cause
îxtar	caution
baldar	cautious
eşkefte	cave
vindetene	cease
serke	ceiling
pîroz kerdene	celebrate
hucre	cell
merkez	center
seserre	century
heb	cereal
merasîm	ceremony
tayê	certain
eynen	certainly
sertîfîka	certificate
zincîre	chain
kursîye	chair
duşt de vejîyayene	challenge
zehmetîye	challenge
şans	chance
vurîyayene	change
kaos	chaos
karakter	character
taybetî	characteristics
şarj kerdene	charge
sucdar kerdene	charge
xeyrkarî	charity
efsûnên	charming
tablo	chart
plan	chart
fetilnayene	chase
terraqnayene	chat
xpşebere	chat
erjan	cheap
xapitene	cheat
hîle kerdene	cheating
kontrol	check
kontrol kerdene	check
alişke	cheek
şênî	cheer
şên	cheerful
noş	cheers
pênîr	cheese
kîmya	chemistry
ser o hêc bîyene	cherish
kişike	chess
sêne	chest
cutene	chew
kerge	chicken
serek	chief
doman	child
domanîye	childhood
domanî	children
honik	chill
qers … kewtene	chill
qers	chill
lojinî	chimneys
çene	chin
çîkolata	chocolate
tercîh	choice
weçînitene	choose
qesnayene	chop
kar û bar	chores
goştin	chubby
dêr	church
darçîn	cinnamon
dayîre	circle
şert û mercî	circumstances
hemwelatî	citizen
şaristan	city
îdîa kerdene	claim
îdîa	claim
zelal kerdene	clarify
sinife	class
kîle	clay
pak kerdene	clean
zelal kerdene	clear
zelal	clear
nuştox	clerk
rotox	clerk
jîr	clever
muşterî	client
tirr	cliff
îklîm	climate
ro vejîyayene	climb
zeliqok	clingy
saete	clock
girewtene	close
dolabe	closet
kinc	cloth
kincî	clothes
hewr	cloud
hewra	cloudy
palyaço	clown
îma	clue
xam	clumsy
kome	cluster
antrenor	coach
antrenorî kerdene	coach
komir	coal
qerax	coast
çakêt	coat
qewe	coffee
hişkî	cognitive
tesaduf	coincidence
serd	cold
rijîyayene	collapse
pêsîr	collar
hemkar	colleague
hemkarî	colleagues
arê dayene	collect
koleksyon	collection
unîversîte	college
reng	color
fikrê keskê bêrengî hêrsin kewenê ra	colorless green ideas slept furiously
reng	colour
kuncik	column
şane kerdene	comb
pêardiş	combination
pîya kerdene	combine
ameyene	come
bê tîya	come here
hayde	come on
rehet kerdene	comfort
rehet	comfortable
yeno	coming
demo nêzdî de	coming soon
ferman dayene	command
şîrove	comment
bazirganî	commercial
komîsyon	commission
kerdene	commit
wad	commitment
kerde	committed
mal	commodity
vilabîyaye	common
komunîkasyon	communicate
komunîkasyon	communication
komel	community
şîyene kar	commute
heval	companion
şîrkete	company
pêver şanayene	compare
pêveronayîş	comparison
zerrîvêşayîyîye	compassion
zerrîveşayîye	compassionate
ahengdar	compatible
temam	compete
ciraameye	competent
musabeqa	competition
hemberîker	competitive
gerre kerdene	complain
gerre	complaint
temam kerdene	complement
pesn	complement
temam kerdene	complete
temamen	completely
aloz	complex
îtaet	compliance
têmîyankewte	complicated
pesn	compliment
îtaet kerdene	comply
pêardiş	composition
pêrabeste	compound
fehm	comprehension
şumûldar	comprehensive
werê ameyene	compromise
werêameyîş	compromise
mecburî	compulsory
komputure	computer
konsantre bîyene	concentrate
konsept	concept
eleqe	concern
eleqedar bîyene	concern
eleqedar	concerned
endîşenak	concerned
konser	concert
peynîye	conclusion
şênber	concrete
şênber kerdene	concrete
beton	concrete
şert	condition
şertî	conditions
ca ardeene	conduct
kombîyayîş	conference
ro xo nayene	confess
xobawerîye	confidence
xobawer	confident
e kerdene	confirm
têkewtiş	conflict
şaşbîyaye	confused
şaşmendiş	confusion
pîroz bo	congrats
pîrozkerdiş	congratulation
çimê to roştî bê	congratulations
bestox	conjunction
girê dayene	connect
îşxal kerdene	conquer
hişyar	conscious
hişyarîye	consciousness
destûr	consent
razî bîyene	consent
netîceyî	consequences
muhafezekerdiş	conservation
muhafezakar	conservative
çiman ver girewtene	consider
fikrkerde	considered
pêra ameyene	consist
pêgirewtiş	consistency
pêgirewte	consistent
berdewam	constant
timûtim	constantly
qebz	constipation
awanîye	construction
serf kerdene	consume
serf	consumption
têkilî	contact
kewtene têkilîye	contact
serî	contagious
tede bîyene	contain
tede	contains
hemçax	contemporary
razî	contempt
tedeyî	content
musabeqe	contest
kontekst	context
qita	continent
dewam kerdene	continue
kontrat	contract
kontrat kerdene	contract
zid	contrast
têver nayene	contrast
beşdarîye	contribute
beşdarîye	contribution
kontrol	control
nîqaşbar	controversial
musaîdîye	convenience
musaîd	convenient
xoşebere	conversation
çarnayîş	convert
çarnayene	convert
resnayene	convey
îqna kerdene	convince
îqnakerde	convinced
pewtene	cook
werdpewj	cook
pewtiş	cooking
honik	cool
weş	cool
hemkarîye	cooperation
hal kerdene	cope
paxir	copper
dendik	core
lazut	corn
kuncik	corner
raşt	correct
mesref	cost
mal bîyene	cost
kisvet	costume
holike	cottage
peme	cotton
meqet	couch
kuxike	cough
konseye	council
hûmaritene	count
muqabele kerdene	counter
welat	country
dewan de	countryside
cite	couple
cesaret	courage
kurs	course
dadgeh	court
kibarîye	courtesy
dereza	cousin
nimitene	cover
manga	cow
tersonek	coward
rehet	cozy
kerkince	crab
qilaşîyayene	crack
qilaş	crack
huner	craft
gî	crap
qeza kerdene	crash
qeza	crash
vîyar kerdene	craving
kaş bîyene	crawl
xêx	crazy
afirnayene	create
viraştox	creative
kredî	credit
kaş bîyene	creep
tersnak	creepy
muretebat	crew
suc	crime
şermdar	cringe
rokewtene	cringe
krîz	crisis
krîterî	criteria
krîtîk	critical
rexnegerî	criticism
ber	crop
mehsul	crops
xaç	cross
visîyayene bover	cross
qijike	crow
qelebalix	crowd
qelebalix	crowded
tac	crown
girîng	crucial
zorbaz	cruel
raywanîya deryayî	cruise
pelçiqnayene	crush
pelçiqnayîş	crush
bermayene	cry
xîyar	cucumber
xo verare kerdene	cuddle
kultur	culture
qurnaz	cunning
fîncane	cup
dolabe	cupboard
sînor kerdene	curb
kemerê peyerayîrî	curb
weşkerdiş	cure
weş kerdene	cure
qedexeyê vejîyayîşê teberî	curfew
meraq	curiosity
meraqdar	curious
gijikin	curly
dovîz	currency
nikayin	current
nika	currently
milqî dayene	curse
perde	curtain
mînder	cushion
adet	custom
muşterî	customer
urf û adetî	customs
gumrik	customs
birnayene	cut
birnaye	cut
şîrin	cute
dewr	cycle
bîsîklet raimtene	cycling
bakil	dad
bawo	daddy
rojane	daily
qatix	dairy
awbend	dam
zerar	damage
zerar dayene	damage
lanet kerdene	damn
tênin	damp
reqisîyayene	dance
tehluke	danger
tehlukeyin	dangerous
tarî	dark
waştî	darling
tîre	dash
pirodayîş	dash
data	data
randevu	date
tarîx	date
kêna	daughter
roje	day
merde	dead
tarîxo peyên	deadline
kerr	deaf
pêameyîş	deal
pê ameyene	deal
sînaye	dear
hevalê delalî	Dear All
Muşterîyo Erjaye	Dear Customer
May û pîyê erjayeyî	Dear Parents
Efendîyo erjaye	Dear Sir
Wendekarê erjayeyî	Dear students
Ekîpa erjayîye	Dear Team
merdene	death
nîqaş	debate
deyndar	debit
debî	debit
enkaz	debris
deyn	debt
desserre	decade
xeripîyayene	decay
rijîyayene	decay
dinya xo vurna	deceased
xapênayene	deceive
kanûne	december
cade	decent
qerar dayene	decide
qerar da	decided
qerar	decision
deste	deck
red kerdene	decline
kêm bîyene	decrease
ser o hêc	dedicated
îthaf	dedication
çalakî	deed
tapû	deed
xorîn	deep
gakovî	deer
standard	default
mexlubîye	defeat
mexlub kerdene	defeat
seveknayene	defend
terîf kerdene	define
qetîyen	definitely
pênas	definition
derece	degree
peyde eştene	delay
peydeeştiş	delay
taloq bî	delayed
estiritene	delete
bi zanayîş	deliberate
nazik	delicate
tehmweş	delicious
keyf	delight
keyfweş	delighted
teslîm kerdene	deliver
verdayene	deliver
reşte	delivered
ciresnayîş	delivery
waştene	demand
waştiş	demand
çetin	demanding
israrker	demanding
demokrasî	democracy
cîn	demon
numayîş kerdene	demonstrate
betalkerde	denied
sixletîye	density
didansaz	dentist
înkar kerdene	deny
beş	department
rayemendiş	departure
girêdaye bîyene	depend
dayene hereketkerdene	deploy
depozîto dayene	deposit
depozîto	deposit
depresîf	depressed
depresyon	depression
xorînîye	depth
pênas kerdene	describe
pênas	description
çol	desert
heq kerdene	deserve
dîzayn	design
dîzayn kerdene	design
tayîn	designation
waştene	desire
waştiş	desire
masa	desk
hêvîya xo ra bîyene	despair
bêhêvî	desperate
herçiqas ke	despite
şîranîye	dessert
hedef	destination
çarenus	destiny
çin kerdene	destroy
xeripnayîş	destruction
teferuat	detail
detayî	details
kifş kerdene	detect
qerardarîye	determination
belî kerdene	determine
qerardar	determined
xirabe	devastated
mafbîyaye	devastated
aver kerdene	develop
averşîyaye	developed
averşîyayîş	development
hacete	device
şeytan	devil
merbut	devoted
Dhîvehî	Dhivehi
dîyabet	diabetes
emel	diarrhea
rojnuşte	diary
ferheng	dictionary
kerd	did
merdene	die
merd	died
parêz	diet
cîyayîye	difference
cîya	different
zehmet	difficult
kinitene	dig
şeref	dignity
xeyretkêş	diligent
şamîye	dinner
tirokerdiş	dip
tiroşîyayîş	dip
raşteraşt	direct
het	direction
rejîsor	director
lêm	dirt
qilêrin	dirty
astengdar	disable
astengdar	disabled
çiman ver vîndî bîyene	disappear
zerrîşikite	disappointed
afate	disaster
vetene	discard
eştene	discard
tal kerdene	discharge
dîsîplîn	discipline
kêmîkerdiş	discount
keşf kerdene	discover
dîskrîmînasyon	discrimination
munaqeşe kerdene	discuss
werênayîş	discussion
nêweşîye	disease
nêweşî	diseases
kinctebdil bîyene	disguise
pîs	disgusting
werd	dish
firaqî	dishes
kar ra eştene	dismiss
ruşnayene	dispatch
musnayene	display
wedaritiş	disposal
îdare	disposal
rotiş	disposal
nîqaş	dispute
mesafe	distance
cîya	distinct
cêra vetene	distinguish
tenge	distress
vilakerdiş	distribution
taxe	district
nerehet kerdene	disturb
xendeq	ditch
kewtene awe	dive
zafrengin	diverse
bêjbibêjîye	diversity
pare kerdene	divide
homayî	divine
cîya bîyene	divorce
cîyabîyayîş	divorce
sewsî	dizzy
kerdene	do
ti mi ra hes kenî	do you love me
doktor	doctor
dokuman	document
keno	does
kutik	dog
Dogrî	Dogri
kerdiş	doing
veyveke	doll
bare	domain
war	domain
kedî	domestic
serdest	dominant
Meraq meke	Don't worry
bexiş kerdene	donate
temam	done
her	donkey
esrar	dope
çut	double
di qat kerdene	double
guman	doubt
guman kerdene	doubt
mîr	dough
devacêr	down
war ardene	download
verkar	draft
verkar viraştene	draft
kaş kerdene	drag
der kerdene	drain
drama	drama
xêz kerdene	draw
çekmece	drawer
resim	drawing
xewf	dread
hewn	dream
hewn dîyene	dream
fîstan	dress
lane kerdene	drill
çîyê şimitişî	drink
şimitene	drink
ramitene	drive
dilope kerdene	drop
dilope	drop
veradaye	dropped
xela	drought
serxoş	drunk
huşk	dry
ordege	duck
mêrik	dude
goreyê	due
semedê	due to
acizker	dull
ehmeq	dumb
rişnayene	dump
mudet	duration
wextê … de	during
tozê ci pak kerdene	dust
wezîfe	duty
ser o vindetene	dwell
mireno	dying
her	each
yewbînan	each other
zerrîwaz	eager
hêlî	eagle
goş	ear
hîna rew	earlier
rew	early
qezenc kerdene	earn
goşî	ears
dinya	earth
erdlerz	earthquake
rehetîye	ease
asan	easily
rojhelat	east
asan	easy
werdene	eat
werdiş	eating
ekonomîk	economic
ekonomî	economy
kobe	edge
sereraşt kerdene	edit
perwerde	education
tesîr	effect
bitesîr	effective
tesîrdarîye	efficiency
bitesîr	efficient
lebate	effort
hak	egg
balcane	eggplant
ego	ego
heşt	eight
heştês	eighteen
heştay	eighty
yan	either
bidetay	elaborate
henezik	elbow
pîl	elder
kokim	elderly
tîtikin	elegant
element	element
fîl	elephant
yewendes	eleven
munasib	eligible
vetene	eliminate
sewbîna	else
şermokin	embarrassed
şermezarker	embarrassing
qebul kerdene	embrace
vejîyayene	emerge
rewşa lezabezîye	emergency
hîssî	emotional
empatî	empathy
giranî dayene ser	emphasis
giranî dayene ser	emphasize
karker	employee
karkerî	employees
kardayox	employer
karkerdiş	employment
veng	empty
aktîf kerdene	enable
raşt ameyene	encounter
zerrî dayene	encourage
qedênayene	end
tehluke de	endangered
çalakî	endeavor
teşebus	endeavor
tehemul	endurance
tebitîyayene	endure
dişmen	enemy
enerjî	energy
meşgul	engage
meşxul	engaged
nîşan	engagement
motor	engine
muhendis	engineer
Îngilizkî	English
girs kerdene	enhance
ecibnayene	enjoy
zaf girs	enormous
bes	enough
garantî dayene	ensure
dekewtene	enter
keyf û kelebut	entertainment
hewesdarîye	enthusiasm
hewesdar	enthusiastic
heme	entire
selahîyetdar	entitled
estîye	entity
cikewtiş	entrance
muteşebis	entrepreneur
zerfe	envelope
dorûver	environment
celudîyayene	envy
destane	epic
epîdemî	epidemic
têduşt	equal
ekîpman	equipment
sermaye	equity
muqabil	equivalent
pakker	eraser
xeta	error
remayene	escape
bitaybetî	especially
meqale	essay
esl	essence
lazim	essential
pê şanayene	establish
ronaye	established
emlak	estate
texmîn kerdene	estimate
texmînî ser	estimated
ûêb	etc
bêpeynî	eternal
etîk	ethics
erjnayene	evaluate
erjnayîş	evaluation
hetta	even
herçend ke	even though
şan	evening
çalakîye	event
peynîye de	eventually
qet	ever
her	every
her kes	everybody
heme kes	everyone
her çî	everything
delîl	evidence
xirabin	evil
evolusyon	evolution
aver şîyene	evolve
Ewe	Ewe
verên	ex
tam	exact
aynen	exactly
ezmûn	exam
muayene kerdene	examine
nimûne	example
hed ra vîyartene	exceed
zaf weş	excellent
xeyrja	except
îstîsna	exception
hed ra vîyartene	excess
zêde	excess
bêhed	excessive
borsa	exchange
ravurnayîş	exchange
heyecandar	excited
heyecan	excitement
heyecandar	exciting
taybet	exclusive
mazeret	excuse
bibexşne	excuse me
bi kar ardene	execute
dardekerdiş	execution
caardox	executive
temrîn kerdene	exercise
temrîn	exercise
egzoz	exhaust
qefilnayene	exhaust
rincan	exhausted
nawneyene	exhibit
temaşegeh	exhibition
est bîyene	exist
estbîyayîş	existence
estbîyaye	existing
vejîyayene	exit
hîra kerdene	expand
pawitene	expect
pawîyaye	expected
şîyayeyî	expenses
vay	expensive
tecrube	experience
dîyene	experience
cerib	experiment
pispor	expert
mudetê ci vîyarte	expired
areze kerdene	explain
îzah	explanation
îstîsmar kerdene	exploit
keşf kerdene	explore
îhracad	export
maruz kerdene	expose
maruz	exposed
maruz bîyene	exposure
îfade kerdene	express
îfade	expression
hîra kerdene	extend
hîrakerde	extended
hîrakerdiş	extension
derece	extent
yê teberî	external
çinbîyaye	extinct
zêde ra	extra
vetene	extract
mustesna	extraordinary
ekstrem	extreme
xeylê zaf	extremely
çim	eye
çimî	eyes
qumaş	fabric
mikemel	fabulous
têrî ameyene	face
rî	face
asan kerdene	facilitate
tesîsî	facilities
tesîs	facility
raştîye	fact
faktor	factor
karxane	factory
raştî	facts
permelîyayene	fade
bin kewtene	fail
binkewtiş	fail
sernêkewte	failed
ser nêkewtene	failure
xeriqîyayene	faint
sivik	fair
heq	fair
xeylê	fairly
perî	fairy
bawerî	faith
wefadar	faithful
zurayin	fake
payîz	fall
war o ginayene	fall
XELET	false
namdarîye	fame
şinasî	familiar
keye	family
vêşanîye	famine
namdar	famous
heyran	fan
perwane	fan
hewes kerdene	fancy
fantastîk	fantastic
dûrî	far
xatirwaştiş	farewell
çewlîg	farm
rencber	farmer
balkêş	fascinating
moda	fashion
lez	fast
qelew	fat
ê mergî	fatal
çarenus	fate
pî	father
qefilîyayene	fatigue
xeta	fault
favorî	favorite
tehm	favour
favorî	favourite
tersayene	fear
ters	fear
şayîye	feast
purt	feather
taybetmendîye	feature
tede est bîyene	feature
taybetmendî	features
gucige	february
heridan	fed up
heq	fee
nan dayene	feed
apeyhayî	feedback
hîs kerdene	feel
hîs	feeling
lingî	feet
kewt	fell
heval	fellow
hîs kerd	felt
makî	female
percîn	fence
berhemdar	fertile
festîvale	festival
ardene	fetch
tewe	fever
tayê	few
kêmêr	fewer
waştî	fiance
fîkşin	fiction
war	field
xurt	fierce
pancês	fifteen
pancas	fifty
lej	fight
lej kerdene	fight
pêrodayîş	fighting
teswîr kerdene	figure
fîgure	figure
tede vetene	figure out
dosya	file
pirr kerdene	fill
pirrkerde	filled
fîlm	film
qilêrin	filthy
axirî	finally
fînansman	finance
ekonomîk	financial
dîyene	find
tey vetene	find out
hol	fine
ceza	fine
engişte	finger
temam kerdene	finish
qedîya	finished
adir	fire
fîrma	firm
pêt	firm
verên	first
name	first name
mase	fish
destdayî	fit
panc	five
tamîr kerdene	fix
sabît	fixed
bellî	fixed
ala	flag
flaş	flash
bilusk	flash
pan	flat
dayîre	flat
kêmasî	flaw
bêqusur	flawless
remayene	flee
goşt	flesh
pera	flew
kablo	flex
deardene	flex
nerm	flexible
raywanîya teyara	flight
dêm dayene	flip
raçarnayene	flip
flort kerdene	flirt
flort kerdene	flirting
awe ser o	float
laser	flood
qat	floor
ardî	flour
herikîyayene	flow
herik	flow
vîlike	flower
harîge	flu
herikbar	fluent
herikbar	fluently
nerm	fluffy
awî	fluid
fir dayene	fly
fokusê xo dayene ser	focus
fokus	focus
mij	fog
mijin	foggy
qat kerdene	fold
şar	folks
taqîb kerdene	follow
dewamê ci	follow up
ke dime ra yeno	following
werd	food
xapitene	fool
ehmeq	fool
xêxkî	foolish
linge	foot
futbol	football
seba	for
Sey nimûne	For example
mesela	for instance
seba to	for you
qedexe	forbidden
hêz	force
texmîn	forecast
çare	forehead
xerîb	foreign
daristan	forest
heta ebedî	forever
xo vîr ra kerdene	forget
ef kerdene	forgive
xovîrrakerde	forgot
çetale	fork
pêardene	form
form	form
resmî	formal
verên	former
şans o ke	fortunately
şans	fortune
çewres	forty
çewres û di	forty-two
aber	forward
xurt kerdene	foster
pêrodaye	fought
dozkerde	found
sazgeh	foundation
çar	four
çarês	fourteen
luye	fox
nazik	fragile
çarçewa	frame
çarçewa	framework
sextekarîye	fraud
gêj	freak
bêpere	free
azad	free
azadîye	freedom
cemidîyayene	freeze
frekans	frequency
rey-rey	frequent
rew-rew	frequently
teze	fresh
îne	friday
dolaba cemedî	fridge
embaz	friend
gonîgerm	friendly
embazî	friends
embazîye	friendship
tersaye	frightened
tersnak	frightening
beq	frog
ra	from
vernî	front
cemidîyaye	frozen
meywe	fruit
bêzar	frustrated
sotemenî	fuel
Fulfulde	Fulfulde
pirr	full
keyf û kelebut	fun
fonksîyon	function
bingeyên	fundamental
merasimê cenaza	funeral
komîk	funny
kurke	fur
hêrsin	furious
mobîlya	furniture
zêdêr	further
ey ra kî dot	furthermore
ameyox	future
destkewt	gain
qezenç kerdene	gain
kay	game
vengane	gap
garaj	garage
çop	garbage
baxçe	garden
sîr	garlic
ber	gate
kom bîyene	gather
kombîyayîş	gathering
peymitene	gauge
da	gave
vitês	gear
cinsîyet	gender
pêroyî	general
pêroyî	generally
viraştene	generate
ber	generation
comerd	generous
dahî	genius
tewirê edebîyatî	genre
nazik	gentle
raştkên	genuine
jest	gesture
girewtene	get
kincanê xo pira bigîrê	get dressed
rawuştene	get up
berzînê xeyrî bo	get well soon
gêno	getting
xeyalet	ghost
cewabnêdayîş	ghosting
dêvane	giant
xelate	gift
zencefîl	ginger
kêneke	girl
doste	girlfriend
dayene	give
fek ci ra veradayene	give up
daye	given
keyfweş	glad
çim pira çarnayene	glance
bardaxe	glass
verçimikî	glasses
çim eştene	glimpse
global	global
tarî	gloomy
teng	gloomy
lepikî	gloves
beriqîyayîş	glow up
zeloq	glue
şîyene	go
raşt şo	go ahead
şo	go away
rakewe	go to bed
amanc	goal
hedefî	goals
bize	goat
homa	god
hende ke raşt	god bless you
şono	goes
şono	going
şono bi	going to
zerrn	gold
şîyaye	gone
lincin	goo
rind	good
rindîye	good
peroj bixeyr	good afternoon
xatir bi to	good bye
roje bixeyr	good day
şan bixeyr	good evening
aferîn	good job
semt	good looking
bextweş be	good luck
şodir bixeyr	good morning
şodirê to weş bo, canê mi	good morning my love
şewe bixeyr	good night
xatirê şima	goodbye
şewbaş	goodnight
berî	goods
Google	Google
Google Translate	Google Translate
qaze	goose
muhteşem	gorgeous
zem	gossip
girewt	got
fam kerd	got it
hukmat	government
girewtene	grab
darax	grade
vera-vera	gradually
mezun bîyene	graduate
heb	grain
bexş	grant
biîmtîyaz	granted
engurî	grapes
tepiştene	grasp
vaş	grass
sipasdar	grateful
sipasdarîye	gratitude
gore	grave
gewr	gray
hol	great
çimveşanîye	greed
çimeveşan	greedy
kesk	green
selam dayene	greet
selamdayîş	greeting
selamdayîşî	greetings
gewr	grey
caxike	grid
efkar	grief
tehnayene	grind
pêguretene	grip
dikan	grocery
zama	groom
girs	gross
erd	ground
grûbe	group
pîl bîyene	grow
girsbîyayîş	growth
zirt	grumpy
Guarankî	Guarani
garantî	guarantee
pawitene	guard
texmîn kerdene	guess
mêman	guest
rayberîye	guidance
rayberîye kerdene	guide
rayber	guide
sucdar	guilty
mêrik	guy
mêrikî	guys
salonê sporî	gym
adet	habit
cugeh	habitat
torge	hail
por	hair
nême	half
çardaxe	hall
dest	hand
destik	handle
semt	handsome
darde kerdene	hang
hedîra xo ardene	hang out
bîyene	happen
bî	happened
şayîye	happiness
şa	happy
rojbîyayîşê to pîroz bo	happy birthday
rojbîyayîşê to bimbarek bo	happy birthday to you
serrnewe pîroz bo	happy new year
zehmet	hard
nadîr	hardly
hema-hema qet rey	hardly ever
zerar	harm
zerar dayene	harm
zerardar	harmful
aheng	harmony
sext	harsh
ber girewtene	harvest
nefret kerdene	hate
roja to xeyr bo	have a good day
roja to xeyr bo	have a nice day
arayîya xo bike	have breakfast
rind bixejilîye	have fun
to nan werd	have you eaten
mal	having
tehluke	hazard
mij	haze
o	he
ey de est o	he has
o yo	he is
sere	head
seredej	headache
weş kerdene	heal
weşkerdiş	healing
weşîye	health
weş	healthy
eşnawitene	hear
eşnawit	heard
zerrî	heart
germîye	heat
germ kerdene	heat
cenet	heaven
giran	heavy
biheyecan	hectic
berzîye	height
mîrasdar	heir
dizdîye	heist
pêgirewte	held
cehenem	hell
Ma bixeyr dî	Hello
selam delalo	hello dear
ma bixeyr dî, ti senîn a	hello how are you
ma bixeyr dî, ti se kena?	hello how are you doing
kask	helmet
hetkarî kerdene	help
destegêr	helpful
coka	hence
aye	her
pes	herd
tîya	here
mîras	heritage
didil mendene	hesitate
Hey	Hey
Merheba	Hi
selam, senîn î	hi how are you
Selam	Hi there
nimitik	hidden
nimitene	hide
hîyerarşî	hierarchy
berz	high
beşo muhîm	highlight
fetilîyayene	hike
fetilîyayîş	hiking
zaf komîk	hilarious
pul	hill
ey	him
îma kerdene	hint
qineste	hip
qorrik	hips
kîra kerdene	hire
kar rê girewtiş	hiring
yê ey	his
tarîx	history
piro dayene	hit
Hmm	Hmm
hobî	hobby
pê girewtene	hold
pîtene	hold on
pê girewtene	hold on
lane	hole
tehtîl	holiday
kinitene	hollow
keye	home
wezîfeyê keyeyî	homework
rastvaj	honest
bi raştî	honestly
Hingimên	Honey
Cano	Honey
şeref	honor
kapuşone	hood
çengal	hook
çing dayene	hop
hêvî kerdene	hope
hêvî	hope
boka	hopefully
bêhêvî	hopeless
bêîmkan	hopeless
verardkî	horizontal
estrî	horn
xewfin	horrible
ters	horror
estor	horse
nêweşxane	hospital
mêmanperwerîye	hospitality
mêmandarîye kerdene	host
mêmandar	host
dişmenkî	hostile
germ	hot
otêle	hotel
saete	hour
saetî	hours
keye	house
keye	household
senî	how
ma ti	how about you
ti senîn î	how are you
ti se kenî	how are you doing
ti ewro senîn î	how are you doing today
ti ewro senîn î	how are you today
ti se kenî	how do you do
senîn o	how is
çend	how many
çend	how much
çend rey	how often
ti çend serrî yî	how old are you
roja to senî bîye	how was your day
şewa to senî bîye	how was your night
labelê	however
merkez	hub
caniko	hubby
verare	hug
verare kerdene	hug
girs	huge
merdim	human
nefsqij	humble
tênin	humid
tênî	humidity
se	hundred
vêşan	hungry
seyd kerdene	hunt
hurîkan	hurricane
lez kerdene	hurry
lerze bike	hurry up
dejayene	hurt
mêrde	husband
lebitîyayene	hustle
lebitîyayîş	hustle
koxe	hut
hîjyen	hygiene
ez	I
Ez a	I am
ez rind a	I am fine
ez eşkena	I can
ez nêeşkena	I can't
Ez kena	I do
ez nêzana	I do not know
Ez fehm nêkena	I do not understand
Ez nêkena	I don't
Ez nêzana	I don't know
ez fehm nêkena	I don't understand
ez fehm nêkena ke ti se vanî	I don't understand what you mean
Ez to fehm nêkena	I don't understand you
ez nêzana	I don’t know
Ez fehm nêkena	I don’t understand
ez texmîn kena	i guess
mi de est bî	I had
mi de est o	I have
ez bîya	I have been
ez hêvî kena	I hope so
Ez zana	I know
ez ecibnena	I like
ez to ra hes kena	I like you
ez hes kena	I love
ez birayê xo yê pîlî ra hes kena	I love my big brother
ez waya xo ya pîle ra hes kena	I love my big sister
ez pîyê xo ra hes kena	I love my father
ez birayê xo yê qijî ra hes kena	I love my little brother
ez waya xo ya qije ra hes kena	I love my little sister
ez maya xo ra hes kena	I love my mother
ez to ra hes kena	I love you
Ez to ra zaf hes kena	I love you so much
ez zî to ra hes kena	I love you too
yanî	I mean
Mi bêrîya to kerda	I miss you
mi zaf bêrîya to kerda	I miss you so much
Mi fam kerd	I see
goreyê mi	I think
Ez fehm kena	I understand
ez wazena	I want
ez wazena to bivînî	I want to see you
ez to wazena	I want you
Ez bîya	I was
ez bibîyêne	I would be
Ez a	I'm
Ez rind a	I'm fine
ez rind a	I'm good
Ez tîya ya	I'm here
ez ozrê xo wazena	I'm sorry
cemed	ice
qeşaşit	ice cream
fikr	idea
îdeal	ideal
eynî	identical
pênas kerdene	identify
kamîye	identity
bom	idiot
veradaye	idle
eke	if
peygoş kerdene	ignore
nêweş	ill
îlegal	illegal
nêweşîye	illness
Îlocano	Ilocano
resim	image
xeyal kerdene	imagine
desinde	immediate
desinde	immediately
zaf girs	immense
tesîr kerdene	impact
tesîr	impact
bêsebir	impatient
ca ardene	implement
îdxal	import
îdxal kerdene	import
muhîm	important
zor ra dayene kerdene	impose
bar kerdene	impose
nemumkin	impossible
tesîr ro ci kerdene	impress
tesîr	impression
balkêş	impressive
aver berdene	improve
rindêrkerdiş	improvement
de	in
ser o zî	in addition
raşta ci	In fact
verê … de	in front of
seba ke	in order to
bêmunasebet	inappropriate
teşwîq	incentive
hedîse	incident
tede bîyene	include
tede	including
ameye	income
nerehetîye	inconvenience
zêdnayene	increase
zêdîyayîş	increase
zêde	increased
acêba girane	incredible
xora raşt	indeed
xoser	independent
Hîndîstan	India
nîşan dayene	indicate
cayî	indigenous
şexs	individual
endustrî	industry
îllamkî	inevitable
pit	infant
îltîhab	infection
bêpeynîyîye	infinity
îltîhab	inflammation
enflasyon	inflation
tesîr kerdene	influence
tesîr	influence
dayîşzanayîş	inform
melumat	information
tedeyî	ingredients
mîras	inheritance
sifteyên	initial
înîsîyatîf	initiative
birîndar	injured
birîne	injury
bêguna	innocent
îcad	innovation
pers	inquiry
tirrexêx	insane
lulik	insect
bêasayîş	insecure
dekerdene	insert
zere	inside
îzan	insight
israr kerdene	insist
bêhewnîye	insomnia
îlham	inspiration
îlham dayene	inspire
saz kerdene	install
nimûne	instance
desinde	instant
herinda ci de	instead
herind de	instead of
telîmatî	instructions
enstruman	instrument
heqeret kerdene	insult
sîgorta	insurance
tam	intact
temamîye	integrity
roşnvîr	intellectual
aqil	intelligence
jîr	intelligent
nîyet kerdene	intend
nîyetkerde	intended
xurt	intense
nîyet	intention
yewbînan ser tesîr kerdene	interact
yewbînansertesîrkerdiş	interaction
eleqe	interest
eleqedar	interested
balkêş	interesting
mudaxele kerdene	interfere
mabênkar	intermediate
yê zereyî	internal
mîyanneteweyî	international
stajyerîye	internship
tefsîr kerdene	interpret
çarnayox	interpreter
birnayene	interrupt
roportaj	interview
semîmî	intimate
bi	into
dayene naskerdene	introduce
daşinasnayiş	introduction
hîs	intuition
nevîyartbar	invalid
îcad kerdene	invent
envanter	inventory
sermaye kerdene	invest
tehqîqat	investigate
silayî	invitation
silaynayene	invite
fatura kerdene	invoice
fatura	invoice
tewrê . bîyene	involve
tede	involved
utî kerdene	iron
asin	iron
o	is
girawe	island
îzolekerde	isolated
vetene	issue
mesela	issue
problemî	issues
o yo	it is
bî	it was
temam o	it's ok
Hol o	It's okay
çî	item
çî	items
yê ey	its
Ez a	I’m
çakêt	jacket
hepisxane	jail
Çele	January
qawanoz	jar
çene	jaw
çimesîya	jealous
serserî	jerk
mucewher	jewelry
meslek	job
vaştiş	jogging
tewr bîyene	join
muşterek	joint
pêragirêdaye	joint
yaranîye	joke
rojnameger	journalist
raywanîye	journey
keyf	joy
dadger	judge
muhakeme kerdene	judge
awa meyweyan	juice
temmuze	july
xil dayene	jump
hezîrane	june
keş-peş	junk
tena	just
heq	just
de bike	just do it
edalet	justice
heq dayene	justify
pawitene	justify
Kalalîsut	Kalaallisut
hewesdar	keen
dewam kerdene	keep
pê girewtene	keep
dewam ke	keep it up
çaydane	kettle
lên	kettle
kilît	key
pasqule piro dayene	kick
doman	kid
yarenî	kidding
velik	kidney
domanî	kids
kiştene	kill
nazik	kind
tewir	kind
seke	kinda
nazîkane	kindly
kibarîye	kindness
qiral	king
lew pira nayene	kiss
kulinde	kitchen
firfiroke	kite
pisînge	kitten
zanî	knee
zana	knew
kardî	knife
şovalye	knight
zanayene	know
zanayîş	knowledge
zanaye	known
Konkanî	Konkani
Krîo	Krio
etîket	label
etîket kerdene	label
kar	labor
kar	labour
kêmanîye	lack
nêrdîwane	ladder
xanime	lady
merredîya ra	laid
gole	lake
vereke	lamb
kung	lame
kêmî	lame
lamba	lamp
erd	land
niştene	land
menzere	landscape
ziwan	language
verare	lap
girs	large
peyên	last
peynîya peyêne de	last but not least
peyname	last name
erey	late
demo peyên de	lately
dima	later
tewr peyên	latest
peyên	latter
huyayene	laugh
huyayîş	laughing
huyayîş	laughter
pernayene	launch
kincşuxane	laundry
qanûn	law
çere	lawn
avûkat	lawyer
rameridîyayene	lay
qat	layer
arê dayene	layout
tembel	lazy
qerşune	lead
rayberî kerdene	lead
serek	leader
pel	leaf
dilope kerdene	leak
aznayene	lean
perrayene	leap
musayene	learn
museno	learning
kîra kerdene	lease
tewr tay	least
çerme	leather
teriknayene	leave
teriknayîş	leave
terikneno	leaves
pelî	leaves
rayberîkerde	led
çep	left
pêtik	leg
mîras	legacy
qanûnî	legal
efsane	legend
meşrû	legit
wexto veng	leisure
deyn dayene	lend
dergîye	length
kêmî	less
derse	lesson
raverdayene	let
mektube	letter
xas	lettuce
darax	level
berzker	leverage
berpirsîyarîye	liability
kitabxane	library
lîştene	lick
zurî kerdene	lie
zure	lie
zurî	lies
cuye	life
wedardene	lift
asansor	lift
roştî	light
veşnayene	light
sivik	light
bilusk	lightning
hes kerdene	like
muhtemel	likely
aynen	likewise
xêze	line
Lîngala	Lingala
lînk	link
şêr	lion
awî	liquid
lîste	list
goşdarî kerdene	listen
goşdarî keno	listening
herfîyen	literally
edebîyat	literature
qilêrin kerdene	litter
şenik	little
ganî	live
ciwîyayene	live
cîgere	liver
cuyî	lives
ciwîyeno	living
odaya roniştişî	living room
marula	lizard
bar bîyene	load
nane	loaf
deyn	loan
cayî	local
ca	location
kilît kerdene	lock
qedexeyê vejîyayîşê teberî	lockdown
qirm	log
ez zaf huyaya	lol
tek û tena	lonely
derg	long
xeylê wext o ke ma yewbînî nêdîyo	long time no see
ewnîyayene	look
awir	look
girê dayene	loop
vîndî kerdene	loose
sist	loose
lord	lord
vîndî kerdene	lose
zerar	loss
vîndîbîyaye	lost
keremate	lot
bi vengêko berz	loud
salone	lounge
hes kerdene	love
eşq	love
ez to ra hes kena	love you
şîrin	lovely
nizm	low
nizm kerdene	lower
wefadar	loyal
sedaqet	loyalty
bext	luck
şans	luck
bişans	lucky
Luganda	Luganda
bagaj	luggage
kome	lump
perojîye	lunch
cîgerî	lungs
luks	luxury
zurîkerdiş	lying
makîna	machine
xêx	mad
hêrsin	mad
xanime	madam
viraşte	made
kovare	magazine
muhteşem	magnificent
xizmetkare	maid
sereke	main
ramitene	maintain
dewam kerdene	maintain
berdewamîye	maintenance
Maîthîlî	Maithili
pîl	major
sergord	major
zafêrî	majority
viraştene	make
makyaj kerdene	make up
nêr	male
merkezê axsata	mall
merdim	man
îdare kerdene	manage
îdarekarî	management
îdarekar	manager
mecburî	mandatory
manîfesto	manifest
eşkera kerdene	manifest
manîpule kerdene	manipulate
uslûb	manner
dest a	manual
zaf	many
xeylê xeylê ameyeyê roje	many many happy returns of the day
adare	march
şîyene	march
kenar	margin
pîyase	market
zewac	marriage
zewicîyaye	married
maske	mask
girse	mass
zaf girs	massive
westa	master
pêardene	match
duşt	match
kel werdene	mate
heval	mate
materyal	material
matematîk	math
muhîm bîyene	matter
mesele	matter
deresayîş	maturity
gulane	may
eşkayene	may
beno ke	maybe
mi	me
ez zî	me too
werd	meal
averaj	mean
vatene	mean
mana	meaning
îmkan	means
qesd o bî ke	meant
no mabên de	meanwhile
peymitene	measure
peymî	measures
goşt	meat
tibî	medical
derman	medicine
medîtasyon	meditation
wasita	medium
mîyanên	medium
nas kerdene	meet
kombîyayîş	meeting
Meîteîlon	Meiteilon
rovilêşîyayene	melt
xatîrayî	memories
vîr	memory
aqlî	mental
qalê ci kerdene	mention
vate	mentioned
şêwirmend	mentor
bazirgan	merchant
merhemet	mercy
ancax	merely
Noel pîroz bo	merry christmas
alozî	mess
peyame	message
virtûvila	messy
metal	metal
metod	method
merreyî	mice
mîyanên	middle
şewlete	midnight
eşkayene	might
nermik	mild
hedef	milestone
leşkerîye	military
şit	milk
mîlyon	million
ehemîyet dayene	mind
aqil	mind
zîhnîyet	mindset
maden	mine
yê mi	mine
werê fîtene	mingle
qijkek	minor
deqa	minute
deqeyî	minutes
keramete	miracle
neynike	mirror
ê bînî	miscellaneous
têmîyan	miscellaneous
mixenet	mischievous
neçar	miserable
feqirîye	misery
bêrî kerdene	miss
mi bêrîya to kerda	miss you
vîndîbîyaye	missing
mîsyon	mission
mij	mist
xeletîye	mistake
Mîzo	Mizo
mobîl	mobile
henek kerdene	mock
henek	mock
model	model
îdare kerdene	moderate
maqul	moderate
modern	modern
nefsqij	modest
hît	moist
hîtî	moisture
kufikîyayene	mold
kufike	mold
herremuşk	mole
dayê	mom
game	moment
dişeme	monday
pere	money
monîtor	monitor
meymune	monkey
aşme	month
keyf	mood
eks	moody
aşme	moon
moral	moral
hîna zêde	more
ey ra zî wet	moreover
şodir	morning
îpotek	mortgage
zafê ci	most
zafane	mostly
maye	mother
hereket	motion
motîvasyon	motivation
ko	mountain
merre	mouse
fek	mouth
lewîyayene	move
hereket	movement
fîlm	movie
xanime	mrs
zaf	much
lince	mud
xesp kerdene	mug
tase	mug
masûlkeyî	muscle
muzexane	museum
sung	mushroom
muzîk	music
ganî	must
ganîyîye	must
bêveng	mute
dihetkî	mutual
mi	my
Delalê mi	My dear
embazê mi	my friend
Hovercraftê mi pirrê marmasan o	My hovercraft is full of eels
zerrîya mi	my love
nameyê mi … o	my name is
seran ser	my pleasure
bi xo	myself
sirdar	mysterious
sirr	mystery
mîtos	myth
nenûg	nail
naşî	naive
name	name
hîkaye	narrative
qalkerdiş	narrative
teng	narrow
qefçil	nasty
neteweyî	national
netewe	nationality
cayî	native
xozayî	natural
xoza	nature
werêkewtişê zereyî	nausea
nêzdî de	near
nêzdî	nearby
hema-hema	nearly
biîhtîmam	neat
hewce	necessary
mil	neck
kolye	necklace
lazim bîyene	need
îhtîyac	need
negatîf	negative
îhmal kerdene	neglect
muzakerde kerdene	negotiate
cîran	neighbor
dorûver	neighborhood
ne … ne zî	neither
biraza	nephew
hêrsin	nervous
halîn	nest
torre	net
torre	network
bêteref	neutral
caran	never
caran metexilîye	never give up
fek ci ra verade	never mind
wa bo	nevermind
ancîya	nevertheless
newe	new
xeberî	news
verên	next
hetê … de	next to
weş	nice
ez memnun bîya	nice to meet you
werezaye	niece
şewe	night
kapos	nightmare
new	nine
newês	nineteen
neway	ninety
Ney	No
problem çin o	no problem
mumkin nîyo	no way
qet kes	nobody
hayleme	noise
hermeleyin	noisy
çi .	none
peroj	noon
niç	nope
ne	nor
normal	normal
bakûr	north
pirnike	nose
nostaljîk	nostalgic
ney	not
çiman ser	not at all
xirab nîyo	not bad
Nika ney	Not now
hîna ney	not yet
not kerdene	note
notkerde	noted
qet çî	nothing
pêhesîyayîş	notice
ferqkerde	noticed
name	noun
nameyî	nouns
roman	novel
teşrîna peyêne	november
nika	now
nê deman	nowadays
problem	nuisance
sifir	null
kung	numb
hûmare	number
hemşîra	nurse
findiqe	nut
muskat	nutmeg
werdiş	nutrition
sond	oath
qelewîye	obesity
tede kerdene	obey
çî	object
amanc	objective
ganîyîye	obligation
nimite	obscure
nîyadarîye	observation
qayît kerdene	observe
obsesîf	obsessed
obsesyon	obsession
kehen	obsolete
asteng	obstacle
girewtene	obtain
destkewte	obtained
eşkera	obvious
bi hawayêde eşkera	obviously
ge-gane	occasionally
meslek	occupation
îşxalkerde	occupied
qewimîyayene	occur
bî	occurred
aseno	occurs
okyanûs	ocean
teşrîna verêne	october
temaşe	odd
îhtîmal	odds
ra	of
helbet	of course
girewte	off
hêrişkar	offensive
pêşnîyaze kerdene	offer
pêşnîyaze	offer
ofîs	office
fermî	official
zaf rey	often
Ah	Oh
xora raşt	oh really
rûn	oil
temam	ok
temam, cano	ok dear
temam, canê	ok honey
temam delala mi	ok my love
temam	okay
temam cano	okay baby
temam şîrina mi	okay dear
temam cano	okay honey
temam zerrîya mi	okay my love
kan	old
ser o	on
reyêk	once
yew	one
yew ziwan caran bes nîyo	one language is never enough
pîyaz	onion
girêdaye	online
tena	only
akerdene	open
operasyon	operation
fikir	opinion
îmkanî	opportunities
firsend	opportunity
duşt	opposite
weşvîn	optimistic
weçînek	option
nemecburî	optional
yan	or
narincî	orange
porteqale	orange
sîparîş	order
siparîş kerdene	order
sade	ordinary
organîzasyon	organization
meyl	orientation
esl û fesl	origin
eslî	original
Oromo	Oromo
sêwî	orphan
bîn	other
nêke	otherwise
ganî	ought
yê ma	our
Mîsyonê ma: her kesî rê mumkin bikerîme ke her ca de dinya fehm bikero û her ziwan de xo îfade bikero	Our mission: to enable everyone, everywhere to understand the world and express themselves across languages.
Mîsyonê ma: zanayîşê dinya organîzekerdiş û her kesî rê akerde û bifaydekerdiş	Our mission: to organize the world's information and make it universally accessible and useful.
teber	out
netîce	outcome
kinc û kol	outfit
gonîgerm	outgoing
rotişgeh	outlet
fîş	outlet
xulasa	outline
teber	outside
mukemmel	outstanding
firine	oven
ser a	over
ha uca	over there
pêro pîya	overall
bin ra rawuştene	overcome
zêde fikirîyayîş	overthinking
şaşmende	overwhelmed
deyndar bîyene	owe
kund	owl
wayî bîyene	own
yê xo	own
wayîr	owner
ga	ox
game	pace
paket kerdene	pack
paket kerdene	package
daye	paid
dej	pain
boyax kerdene	paint
boyax keno	painting
cite	pair
bêreng	pale
palmîye	palm
lep	palm
tawe	pan
pandemîye	pandemic
panîk	panic
pantolî	pants
kaxide	paper
cenet	paradise
parelel	parallel
parsel	parcel
pardon	pardon
may û pî	parents
parke	park
tûtî	parrot
maydanoz	parsley
beş	part
beşdar bîyene	participate
taybet	particular
bitaybetî	particularly
heval	partner
partî	party
ravîyartene	pass
pasaj	passage
vîyarte	passed
hewes	passion
hewesdar	passionate
pasîf	passive
şîfre	password
vîyarte	past
pîne	patch
rêçe	path
perîşan	pathetic
sebir	patience
bisebr	patient
nêweş	patient
desen	pattern
mabên	pause
peyerayîr	pavement
heq dayene	pay
heqdayîş	payment
aştî	peace
aştîwaz	peaceful
şeftalîye	peach
tîtik	peak
murîye	pear
nuke	peas
xas	peculiar
mîze	pee
mîze kerdene	pee
serde kerdene	peel
duşt	peer
hemendamî	peers
qeleme	pen
qeleme	pencil
paweno	pending
merdimî	people
îsot	pepper
fehm kerdene	perceive
feraset	perception
bêqusur	perfect
ca ardene	perform
performans	performance
beno ke	perhaps
serdem	period
timkî	permanent
destûr	permission
destûr	permit
destûr dayene	permit
tebat	perseverance
israrker	persistent
merdim	person
şexsî	personal
şexsîyet	personality
hoke	perspective
îqna kerdene	persuade
xirabkar	pervert
heywanê keyeyî	pet
cumle	phase
fenomen	phenomenon
felsefe	philosophy
telefon kerdene	phone
telefon	phone
fotograf	photo
îfade	phrase
fîzîkî	physical
weçînitene	pick
arê dayene	pick up
bi erebe girewtene	pick up
resim	picture
parçe	piece
parçeyî	pieces
xoz	pig
borane	pigeon
lode	pile
balişna	pillow
pîlot	pilot
reptîya	pin
ananase	pineapple
pembe	pink
bîr	pit
war	pitch
heyf	pity
ca	place
bi ca kerdene	place
cayî	places
bela	plague
deşte	plain
plan kerdene	plan
plan	plan
teyara	plane
ronayene	plant
nebatî	plants
tebaxe	plate
platform	platform
kay kerdene	play
kay	play
kaykerdiş	playing
weş	pleasant
kerem kerdene	please
keremê xo ra	please
keyfweş	pleased
keyfweşîye	pleasure
wad kerdene	pledge
keremat	plenty
dek û dolab	plot
qapax	plug
alunça	plum
tesîsatkarê awe	plumber
zafhûmar	plural
podcast	podcast
şîîre	poem
şîîrî	poetry
nuqte	point
jehr	poison
polîs	police
polîtîka	policy
kîbar	polite
gemarinîye	pollution
hope	pond
hope	pool
gî kerdene	poop
feqîr	poor
pop	pop
populer	popular
nufus	population
goştê xozî	pork
lepe	porridge
port	port
lîman	port
pozîsyon	position
pozîtîf	positive
wayîr bîyene	possess
mal	possession
wayîrîye	possessive
mumkin	possible
erşawitene	post
poste	post
peyde eştene	postpone
kartole	potato
potansîyel	potential
pound	pound
xizanîye	poverty
hêz	power
hêzdar	powerful
pratîk	practical
pratîk	practice
pratîk kerdene	practice
goynayene	praise
heneke	prank
dua kerdene	pray
qîymetin	precious
tam	precise
tam	precisely
vervînîye kerdene	predict
tercîh kerdene	prefer
tercîh	preference
diganî	pregnant
verhukm	prejudice
warê sazgehî	premises
prim	premium
amadekarîye	preparation
amade kerdene	prepare
hazir	prepared
veredat	preposition
estbîyayîş	presence
hazir	present
demo nikayin	present
xelate	present
pêşkêş	presentation
pawitene	preserve
serek	president
çapemenîye	press
çap kerdene	press
tezyîq	pressure
rol kay kerdene	pretend
xeylê	pretty
semt	pretty
vernî girewtene	prevent
verên	previous
nêçîr	prey
vaya	price
serberzîye	pride
keşîş	priest
verên	primary
serek	prime
prensese	princess
sereke	principal
verên	prior
vernîyîye	priority
hepisxane	prison
nimiteyîye	privacy
şexsî	private
îmtîyaz	privilege
xelate	prize
îhtîmalen	probably
problem	problem
prosedur	procedure
radayene	proceed
dewam kerdene	process
proses	process
afirnayene	produce
berhem	product
viraştiş	production
meslek	profession
profesyonel	professional
profîl	profile
kar	profit
xorîn	profound
averşîyayîş	progress
aver şîyayene	progress
proje	project
nandar	prominent
wad kerdene	promise
wad	promise
teşwîq kerdene	promote
teşwîq kerdene	promotion
lezabez	prompt
waştiş	prompt
meyîldar	prone
zamîrî	pronouns
telafuz	pronunciation
delîl	proof
raşt	proper
raşt û rind	properly
taybetmendî	properties
mal û milk	property
pêşnîyaze	proposal
ewnîyayîş	prospect
hêvî	prospect
dewletîye	prosperity
zengîn	prosperous
seveknayene	protect
sereberz	proud
îsbat kerdene	prove
peyda kerdene	provide
bi şertê	provided
qeza	province
zad	provision
balixîye	puberty
pêroyî	public
antene	pull
kundir	pumpkin
deqîq	punctual
wendekar	pupil
hêrînayene	purchase
zelal	pure
menewşî	purple
armanc	purpose
cizdan	purse
taqîb kerdene	pursue
taqîb kerdene	pursuit
tehn dayene	push
ronayene	put
cikerdene	put
kalîfîkasyon	qualification
senînîye	qualification
senînîye	quality
mîqdar	quantity
karantîna	quarantine
werê nayene	quarrel
werênayîş	quarrel
çarîge	quarter
Qeçua	Quechua
qiralîça	queen
hemcînsger	queer
persayene	query
perse	question
rêze	queue
rêze kewtene	queue
lez	quick
bilez	quickly
bêveng	quiet
orxan	quilt
ca verdayene	quit
ezmûn	quiz
neql	quotation
neql kerdene	quote
neql	quote
neqlî	quotes
harguşe	rabbit
musabeqa	race
nîjad	race
hêrs	rage
varan	rain
zêdîyayîş	raise
resnayene	raise
resnaye	raised
vaşt	ran
tesadufî	random
silsile	range
lez	rapid
lez	rapidly
nadîr	rare
nadîr	rarely
germij	rash
merre	rat
nîsbet	rate
hîna zaf	rather
rêje	ratio
bimantiq	rational
kal	raw
reyna	re
reştene	reach
resaye	reached
reaksîyon	reaction
wendene	read
wendiş	reading
amade	ready
raştkên	real
raştîye	reality
pê hesîyayene	realize
temamkerde	realized
raştiko	really
resnayene	rear
sebeb	reason
bimantiq	reasonable
ardene xo vîr	recall
fîşe	receipt
girewtene	receive
resa dest	received
peyên	recent
na peydo	recently
resepsîyon	reception
terîfê werdî	recipe
bêperwa	reckless
naskerdiş	recognition
nas kerdene	recognize
tewsîye kerdene	recommend
pêşnîyazkerde	recommended
qeyd kerdene	record
qeyd	record
weş bîyene	recover
weşbîyayîş	recovery
reyayîş	recovery
çargoşe	rectangle
sûr	red
dayene	redeem
raxelişnayene	redeem
îtfa	redemption
kêmî kerdene	reduce
bêluzim	redundant
etif kerdene	refer
referans	reference
olan dayene	reflect
refleksîyon	reflection
apey vindetene	refrain
neqeret	refrain
dolaba cemedî	refrigerator
heqê ci apey dayene	refund
red kerdene	refuse
betalkerde	refused
rêz û silam	regard
derheqê	regarding
bê ke	regardless
silamî	regards
herême	region
qeyd bîyene	register
poşman bîyene	regret
biserûber	regular
biserûber	regularly
red kerdene	reject
qisey kerdene	relate
eleqedar	related
têkilîye	relationship
merdim	relative
nisbî	relative
merdimî	relatives
boya xo dayene	relax
raverdayîş	release
raverdayene	release
azadkerde	released
eleqedar	relevant
biîtîbar	reliable
rehet kerdene	relief
rehet bîyene	relieve
rehet	relieved
dîn	religion
dînî	religious
bêzerrî	reluctant
bawer bîyene	rely
mendene	remain
mendene	remaining
balkêş	remarkable
derman	remedy
xo vîr ameyene	remember
xo vîr ardene	remind
vîrardox	reminder
dûrî	remote
wedaritene	remove
viraştene	render
cenayene	render
çarnayene	render
kîra kerdene	rent
tamîr kerdene	repair
tekrar kerdene	repeat
avurnayene	replace
cewab	reply
cewab dayene	reply
rapor	report
rapor kerdene	report
temsîl kerdene	represent
şohret	reputation
rica kerdene	request
waştiş	request
hewce kerdene	require
hewce	required
raxelisnayene	rescue
cigêrayîş	research
ro mendene	resemble
kîn	resentment
caabirnayîş	reservation
abirnayene	reserve
roniştox	resident
îstîfa kerdene	resign
deyax	resilience
pêt	resilient
xo ver o dayene	resist
xoverrodayîş	resistance
çareserîye	resolution
zelalîye	resolution
çareser kerdene	resolve
tehtîlgeh	resort
çimeyî	resources
hurmet kerdene	respect
hurmet	respect
cewab dayene	respond
cewab	response
berpirsîyarîye	responsibility
berpirsîyar	responsible
aresîyayene	rest
ruhê ci şad bo	rest in peace
restoran	restaurant
restore kerdene	restore
sînor kerdene	restrict
netîce	result
netîceyî	results
dewam kerdene	resume
perakende	retail
ramitene	retain
muhafeze kerdene	retain
tepîştiş	retention
teqawut	retired
xo peyser antene	retreat
peyser girewtene	retrieve
ameye	return
agêrayene	return
peyser dayene	return
eşkera kerdene	reveal
eşkera	revealed
heyf	revenge
qezenc	revenue
tînapeykî	reverse
çim çarnayene	review
çimçarnayîş	review
çim pira çarnayene	revise
çimçarnayîş	revision
şoreş	revolution
xelat dayene	reward
rîtîm	rhythm
parsû	rib
birinc	rice
dewlemend	rich
qewirnayene	rid
ciniştiş	ride
ciniştene	ride
mesxere	ridiculous
raşt	right
raştîye	right
anika	right now
terrik	rigid
engiştane	ring
tira çarnayene	rinse
serewedaritiş	riot
dirnayene	rip
dirate	rip
resaye	ripe
berzbîyayîş	rise
berz bîyene	rise
rîsk	risk
rîsk bîyene	risk
reqib	rival
çem	river
rayîr	road
sûr kerdene	roast
zixm	robust
kerre	rock
uşîre	rod
rol	role
gindir kerdene	roll
gindir bîyene	roll
serban	roof
oda	room
ristim	root
resen	rope
poyaye	rotten
xirtikin	rough
qebe	roughly
teqrîben	roughly
gilover	round
xeta şîyayîşî	route
rutîn	routine
rêze	row
pira kerdene	rub
pakker	rubber
çop	rubbish
çors	rude
xalîçe	rug
maf kerdene	ruin
qayde	rule
cetwel	ruler
hukimdar	ruler
qeydeyî	rules
vazdayene	run
vazdano	running
neşaristanî	rural
lerze kerdene	rush
lerze	rush
turik	sack
bimbarek	sacred
qurban kerdene	sacrifice
biasayîş	safe
asayîş	safety
budela	sage
vat	said
vaverik	sail
sporê vaverikî	sailing
xatir	sake
meaş	salary
rotiş	sale
somon	salmon
sole	salt
eynî	same
Tîya zî	Same here
nimûne	sample
qum	sand
Sanskrîtkî	Sanskrit
sarkastîk	sarcastic
kustex	sassy
ronişt	sat
tetmîn	satisfaction
memnun	satisfied
razî kerdene	satisfy
tetmînkar	satisfying
Şeme	Saturday
sosîs	sausage
wehşî	savage
seveknayene	save
dî	saw
vatene	say
sentene	scale
dek û dolab	scam
rêçe	scar
nadîr	scarce
tersaye	scared
milpêşe	scarf
tersnak	scary
vilabîyaye	scattered
sehne	scene
manzara	scenery
boye	scent
plan kerdene	schedule
program	schedule
mekteb	school
îlm	science
zanyar	scientist
zanyarî	scientists
meqes	scissors
pede vajîyayene	scold
war	scope
gol eştene	score
xurde	scrap
kinitene	scratch
qîrayene	scream
ekran	screen
vîda	screw
destnuşte	script
derya	sea
mor	seal
ro ci gêrayene	search
demserre	season
qoltuxe	seat
dîyin	second
sirr	secret
beş	section
emîn	secure
asayîş	security
dîyene	see
pê vînenîme	see you
pê vînenîme	see you later
pê vînenîme	see you soon
ez to meşe vînena	see you tomorrow
toxum	seed
ro ci gêrayene	seek
asayene	seem
aseno	seems
dîyaye	seen
îşgal kerdene	seize
dest eştene ser	seize
destsernayîş	seizure
felç	seizure
zaf kêmî	seldom
vijnayene	select
xo	self
xoweşkerdox	self healing
ezez	selfish
rotene	sell
erşawitene	send
resimê xo mi rê birusne	send me your picture
pîl	senior
hîs	sense
mentiqin	sensible
hesas	sensitive
erşawîya	sent
cumle	sentence
cumleyî	sentences
cîya	separate
Sepedî	Sepedi
êlule	september
rêze	sequence
rêzefîlm	series
cidî	serious
cîdî	seriously
xizmet kerdene	serve
îkram kerdene	serve
xizmet	service
roniştiş	session
saz kerdene	set
taxim	set
saz kerdene	set up
eyar	setting
bi ca bîyene	settle
hewt	seven
hewtês	seventeen
hewtay	seventy
çend	several
giran	severe
deştene	sew
sîye	shade
sîye	shadow
raşanayene	shake
tenik	shallow
şerm	shame
şekil	shape
pare kerdene	share
tuj	sharp
a	she
aye de est o	she has
a ya	she is
rişnayene	shed
mîye	sheep
çarşefe	sheet
ref	shelf
qaşik	shell
sitare	shelter
mertal	shield
nobe	shift
beriqîyayene	shine
keştîye	ship
kargo	shipping
îşlîge	shirt
solî	shoes
pana	shoot
dikan	shop
axsate	shopping
qerax	shore
kilm	short
kêmasîye	shortage
panayene	shot
panayîş	shot
doşe	shoulder
zirçayene	shout
musnayene	show
şow	show
mi rê binawne	show me
duş	shower
karîdes	shrimp
kilm antene	shrink
girewtene	shut
huş	shut up
şermokin	shy
way û bira	sibling
way û birayî	siblings
nêweş	sick
het	side
ax	sigh
dîmen	sight
manzara	sightseeing
îşaret	sign
îmza	signature
zaf muhîm	significant
bêvengîye	silence
bêveng	silent
birîsim	silk
gêj	silly
sêm	silver
sey	similar
ehmaq	simp
basît	simple
hemdemkî	simultaneously
ra nat	since
zerrîpak	sincere
zerrî ra	sincerely
kilame vatene	sing
deyîrbaz	singer
azeb	single
binê awe şîyayene	sink
binê awe şîyayîş	sink
Beg	Sir
waye	sister
veyve	sister in law
ronîştene	sit
sîte	site
rewşe	situation
şeş	six
şîyês	sixteen
seştî	sixty
girsîye	size
qabîlîyet	skill
qabîlîyetî	skills
çerme	skin
zar	skinny
ravîyartene	skip
eteg	skirt
asmên	sky
kole	slave
rakewtene	sleep
rakewtiş	sleeping
bêhewn	sleepy
astî	sleeve
lete kerdene	slice
lete	slice
şemitene	slide
sivikek	slightly
barî	slim
şemitîyayene	slip
kaş	slope
ca	slot
lane	slot
hêdî	slow
hêdî-hêdî	slowly
qijkek	small
biaqil	smart
boye dayene	smell
beşirîyayîş	smile
beşirîyayene	smile
dû	smoke
bêxirtik	smooth
werdo sivik	snack
şeytanok	snail
mar	snake
cira kerdene	snap
vewre	snow
wina	so
çiqas şîrin	so cute
heta nika	so far
hît kerdene	soak
sabun	soap
hişyar	sober
gudlinge	soccer
komelkî	social
komel	society
puçî	socks
nerm	soft
çîynermê komputure	software
herre	soil
roşîya	sold
temamen rote	sold out
leşker	soldier
binpa	sole
pêt	solid
çareserîye	solution
çareser kerdene	solve
tayê	some
kes	somebody
bi yew hewa	somehow
kesêk	someone
çîyêk	something
ge-ge	sometimes
deyîre	song
demêde nêzdî de	soon
têmîyankewte	sophisticated
Sorankî	Sorani
dej	sore
bidej	sore
qirikdej	sore throat
huzn	sorrow
Qusurî ra meewnî	Sorry
tewir	sort
ro gêra	sought
ruh	soul
hemruh	soulmate
veng	sound
şorbike	soup
tirş	sour
çime	source
başûr	south
ca	space
feza	space
spam	spam
dergîye	span
mudet	span
Spankî	Spanish
bexşnayene	spare
cagir	spare
qisey kerdene	speak
taybet	special
tewirî	species
taybet	specific
muhteşem	spectacular
qiseykerdiş	speech
bêziwan	speechless
lezîye	speed
herf bi herfe vatene	spell
xerc kerd	spend
xerckerde	spent
tuj	spicy
pîj	spike
çarnayene	spin
îspenax	spinach
ruh	spirit
tu kerdene	spit
harîja	splendid
parçe	split
parçe kerdene	split
herimnayene	spoil
rîgirewte	spoiled
spontane	spontaneous
koçike	spoon
nuqta	spot
mulxit	spouse
pişqitene	spread
wisar	spring
çime	spring
kare	square
pelixnayene	squeeze
kalamar	squid
simore	squirrel
kardî kerdene	stab
stabîl	stable
lodike	stack
xebatkarî	staff
sehne	stage
leke	stain
nêrdîwanî	stairs
pîj	stake
rîsk	stake
taqîb kerdene	stalk
axur	stall
pul	stamp
damxe	stamp
stand	stand
pay ra vindetene	stand
standard	standard
estare	star
dest pêkerdene	start
dest pêkerd	started
gestemerde	starving
rewşe	state
îfade kerdene	state
beyan	statement
dinge	station
heykel	statue
statu	status
mendiş	stay
mendene	stay
qayîtê xo ke	stay safe
biîstiqrar	steady
bîftek	steak
tirawitene	steal
bux	steam
polat	steel
tîk	steep
kok	stem
game	step
zeliqnayene	stick
huşk	stiff
sakîn	still
hîna	still
pede dayene	sting
tamakar	stingy
têv dayene	stir
hîse	stock
tirawite	stolen
pîze	stomach
kemere	stone
vindete	stood
tabura	stool
vindetene	stop
embar	storage
pêser kerdene	store
puk	storm
çîroke	story
ocaxe	stove
raşteraşt	straight
raşteraşt	straightforward
tengijîyayene	strain
temaşe	strange
xerîb	stranger
stratejîye	strategy
pîpet	straw
çîlege	strawberry
serî	streak
rêçe	streak
herik	stream
kuçe	street
hêz	strength
stres	stress
derg kerdene	stretch
pêt	strict
piro dayene	strike
la	string
xo rut kerdene	strip
cehd kerdene	strive
felc	stroke
hêzdar	strong
tengekewte	struck
dêsman	structure
mucadele	struggle
mucadele kerdene	struggle
cehd keno	struggling
serehuşk	stubborn
tenganîyekewte	stuck
wendekar	student
wendiş	study
wendene	study
wendiş	studying
kar û gure	stuff
cazîbedar	stunning
gêj	stupid
terz	style
babete	subject
pêşnîyaze, pêşkêş, vileçewtîye	submission
cirusnayene	submit
made	substance
cagir	substitute
narîn	subtle
ser kewtene	succeed
serkewtiş	success
serkewte	successful
winasî	such
sey	such as
lîtene	suck
xafil de	sudden
xafil de	suddenly
dej antene	suffer
cewr	suffering
bes	sufficient
şeker	sugar
pêşnîyaz kerdene	suggest
pêşnîyaze	suggestion
qatlix	suit
ro ci ameyene	suit
munasib	suitable
valîze	suitcase
kome	sum
kilmnus	summary
hamnan	summer
gil	summit
tîje	sun
roj	sun
yewşeme	sunday
tîje	sunny
koroşîyayîşê tîje	sunset
tîje	sunshine
super	super
serek	superior
rindêr	superior
teftîşker	supervisor
şamî	supper
tedarik	supply
tedarik kerdene	supply
paştîdayîş	support
paştî dayene	support
bawer kerdene	suppose
ferzkerde	supposed
emîn	sure
rîverîye	surface
zêdîyayene	surge
emelîyet	surgery
peyname	surname
surprîz	surprise
surprîzbîyaye	surprised
teslîm bîyene	surrender
dorme de	surrounding
nezaret	surveillance
cigêrayîş kerdene	survey
cigêrayîş	survey
weş mendene	survive
verguman	suspect
guman kerdene	suspect
vindarnaye	suspended
gumandar	suspicious
domnayene	sustain
dewambarîye	sustainability
dewambar	sustainable
talan	swag
raqulotnayene	swallow
pêvurîn	swap
sond werdene	swear
ereq dayene	sweat
fanîla	sweater
derutene	sweep
şîrin	sweet
şewa to sivike bo	sweet dreams
şîranîhes	sweet tooth
waştîye	sweetheart
masayene	swell
masayîş	swelling
asnawe kerdene	swim
ajnekerdiş	swimming
hêlaneke	swing
raşanayene	swing
ravurnayîş	switch
ravurnayene	switch
masaye	swollen
şimşêr	sword
nîşan	symbol
sempatî	sympathy
nîşaneyî	symptoms
pergale	system
masa	table
mucadele kerdene	tackle
etîket kerdene	tag
doçik	tail
girewtene	take
berdene	take away
qayîtê xo be	take care
vetene	take off
gêrîya	taken
qisey kerdene	talk
qiseykerdiş	talk
fekbaz	talkative
derg	tall
çirre	tap
tiknayene	tap
qeyd kerdene	tape
qeyd	tape
hedef	target
hedef kerdene	target
wezîfe	task
tehm	taste
tehm kerdene	taste
tehmweş	tasty
ame musnayene	taught
çay	tea
musnayene	teach
mamosta	teacher
taxim	team
hesire	tear
hesirî	tears
pê tinaz kerdene	tease
teknolojî	technology
didanî	teeth
vatene	tell
mi ra vaje	tell me
cigir	temper
germîye	temperature
qaşik	temple
îbadetxane	temple
demkî	temporary
des hezar	ten
des hezar	ten thousand
kîradar	tenant
meyl kerdene	tend
meyl	tendency
pixok	tender
dem	tense
nerehetîye	tension
çadire	tent
neqetî	tentative
termîn	term
şertî	terms
termî	terms
berbad	terrible
harîka	terrific
herême	territory
ezmûn kerdene	test
ezmûn	test
metn	text
ra	than
sipas	thank
weş be	thank you
Ma ro kargoyî gêrenîme	Thank you for your patience while we investigate shipment
keremê xo ra sebir bike	Thank you for your patience while we investigate shipment
zaf sipas	thank you so much
zaf sipas to rê	thank you very much
sipas	thanks
Seba ke appê ma xebitna, weş be	Thanks for using our app
o	that
yanî	that is
no rind o	that's good
tirawitiş	theft
yê înan	their
înan	them
babete	theme
bi xo	themselves
o wext	then
teorî	theory
uca	there
est ê	there are
est o	there is
coka	therefore
nê	these
ê	they
ê yê	they are
qalind	thick
dizd	thief
çîp	thigh
barî	thin
çî	thing
çî-mî	things
fikirîyayene	think
hîrêyin	third
têşan	thirsty
hîrês	thirteen
hîris	thirty
no	this
no yo	this is
tîtîz	thorough
dergûdila	thoroughly
temamen	thoroughly
ê	those
herçiqas	though
fikirîyayene	thought
fikr	thought
fehmdar	thoughtful
fikrî	thoughts
hezar	thousand
la	thread
tehdîd	thread
tehluke	threat
tehdîd kerdene	threaten
hîrê	three
şêmûge	threshold
heyecandar	thrilled
aver şîyene	thrive
qirike	throat
pê	through
seranser	throughout
eştene	throw
bêçika pîle	thumb
gurrayîşê hewran	thunder
Pancşeme	Thursday
coka	thus
tiknayene	tick
nîşan	tick
meddûcezîr	tide
biserûber	tidy
girê dayene	tie
kravate	tie
piling	tiger
teng	tight
Tîgrînya	Tigrinya
dem	time
şermokin	timid
hurdîkek	tiny
îma	tip
sere	tip
bexşîşî	tips
îmayî	tips
goger	tire
qefelîyaye	tired
destmale	tissue
qumaş	tissue
sernuşte	title
bîyene	to be
tost	toast
ewro	today
tute	toddler
bêçikê lingan	toes
pîya	together
destawxane	toilet
vat	told
tolerans	tolerance
tehemul kerdene	tolerate
tomatêse	tomato
meşte	tomorrow
ziwan	tongue
emşo	tonight
zî	too
girewt	took
hacete	tool
hacetî	tools
didan	tooth
ser	top
babete	topic
dirîyaye	torn
îşkence	torture
pêro pîya	total
dest pira nayene	touch
çetin	tough
pêt	tough
tur	tour
ver bi	toward
ver bi	towards
xewlîye	towel
bajar	town
toksîk	toxic
rêçe	trace
kamyone	track
bazirganîye	trade
bazirganîye kerdene	trade
tradîsyon	tradition
urf û adetî	traditional
trafîk	traffic
taqîb kerdene	trail
rêçe	trail
trêne	train
temrînkerdiş	training
taybetî	trait
xususîyetî	traits
transfer	transfer
vurîyayîş	transition
vîyartiş	transition
çarnayene	translate
transparan	transparent
neql kerdene	transport
neqlîye	transportation
dame	trap
qirş	trash
trawna	trauma
raywanîye kerdene	travel
tepsî	tray
xezîne	treasure
muamele kerdene	treat
muamele	treatment
dare	tree
zaf girs	tremendous
moda	trend
ceribnayîş	trial
hîle	trick
ceribnaye	tried
linga tifingî	trigger
sebeb bîyene	trigger
qesnayene	trim
raywanîye	trip
bela	trouble
pantolî	trousers
kamyone	truck
RAŞT	true
bagaj	trunk
îtîbar ardene	trust
îtîbar	trust
raştîye	truth
ceribnayene	try
Tsonga	Tsonga
lulî	tube
Sêşeme	Tuesday
xercê mektebî	tuition
kerga şamî	turkey
zerdeçal	turmeric
dore	turn
kesa	turtle
malimo taybetî	tutor
diwês	twelve
vîst	twenty
vîst û yew	twenty-one
Twî	Twi
di reyî	twice
deardiş	twist
di	two
tewir	type
tîpîk	typical
qefçil	ugly
tewr peyên	ultimate
sîwane	umbrella
nêşeno	unable
ap	uncle
bêhiş	unconscious
bin de	under
bin de	underneath
şenikkerde	underrated
fehm kerdene	understand
fehm kerd	understood
çi heyf ke	unfortunately
unîforma	uniform
yewek	unique
unîte	unit
unîversîte	university
nêzanaye	unknown
heta	until
îstîsnayî	unusual
veracor	up
ti zanî	up to you
aktuelkerdiş	update
aktuel kerdene	update
başêrkerdiş	upgrade
başêr kerdene	upgrade
ser o	upon
xemgîn	upset
şaristanî	urban
hewes	urge
zor dayene	urge
lezabez	urgent
ma	us
xebitnayîş	use
xebitnayene	use
xebitnaye	used
musaye	used
feydedar	useful
bêfeyde	useless
normal	usual
normal de	usually
havildarîye	utility
betlane	vacation
vaksîn	vaccination
derzîne	vaccine
sipitene	vacuum
nezelal	vague
vîyartbar	valid
newale	valley
erjaye	valuable
erje	value
erjnayene	value
tewir	variety
tewir-tewir	various
vurîyayene	vary
vazo	vase
girs	vast
tarrûtur	vegetable
sebzeyî	vegetables
wesyît	vehicle
rotox	vendor
jehr	venom
teşebus	venture
cayê hedîseyî	venue
tesdîq kerdene	verify
zafhetin	versatile
versîyon	version
tîkane	vertical
zaf	very
zaf weş	very good
keştîye	vessel
pê	via
enerjî	vibe
enerjî	vibes
zerardar	vicious
nîyetxirab	vicious
mexdur	victim
vîdeo	video
menzere	view
dewe	village
xirab	villain
xayîn	villain
sîrke	vinegar
kan	vintage
şîdet	violence
bişîdet	violent
vîral	viral
bakîre	virgin
vîrtuel	virtual
fezîlet	virtue
vîn	vision
şîyene dîyarî	visit
zîyaret	visit
dîyayîşkî	visual
heyatî	vital
ganî	vivid
xezîna çekuyan	vocabulary
veng	voice
vengane	void
hecm	volume
berzîya vengî	volume
zerrîwaz	volunteer
hesas	vulnerable
destmiz	wage
meaşî	wages
mîyane	waist
pîtene	wait
garson	waiter
pîtiş	waiting
hişyar	wake
hişyar bîyene	wake up
raye ra şîyene	walk
rayraşîyayîş	walk
şîyayox	walking
dês	wall
cizdan	wallet
fetilîyayene	wander
waştene	want
waşte	wanted
ceng	war
dolaba kincan	wardrobe
embar	warehouse
germ	warm
germ kerdene	warm
baldar kerdene	warn
îxtar	warning
lejker	warrior
bî	was
şutene	wash
îsraf kerdene	waste
îsraf	waste
temaşe kerdene	watch
saete	watch
awe	water
zebeşe	watermelon
pêl	wave
rayîr	way
ma	we
ma yîme	we are
ma eşkenîme	we can
bêhêz	weak
bêhêzîye	weakness
dewlemendîye	wealth
dewletî	wealthy
pira girewtene	wear
pay keno	wearing
hewa	weather
veyve	wedding
Çarşeme	Wednesday
gonce	weed
hewte	week
peynîya hewteyî	weekend
giranîye	weight
bar pira kerdene	weight
terre-turre	weird
ti bixeyr ameyî	welcome
çiman ser	welcome
bextewarîye	welfare
Yanî	Well
aferîn	well done
şî	went
bîyî	were
rojawan	west
hît	wet
balîna	whale
çi	what
ma ti	what about you
ti se kenî	what are you doing
ti nika se kenî	what are you doing now
ti nika se kenî	what are you doing right now
ti se kenî	what do you do
ti çi kar kena	what do you do for a living
qesdê to çi yo	what do you mean
ti çi wazenî	what do you want
se bî	what happened
çi yo	what is
no çi yo	what is this
karê to çi yo?	what is your job
nameyê to çi yo	what is your name
çi est o	what's up
çi çin o	what's up
nameyê to çi yo	what's your name
her çi	whatever
çi beno wa bibo	whatever
genim	wheat
goger	wheel
key	when
çi wext ke	whenever
kotî	where
ti kotî yî	where are you
ti kotî ra yî	where are you from
ti nika kotî der a	where are you now
ti kotî de ciwîyena	where do you live
kotî yo	where is
ti nêvanê ke	whereas
eke	whether
kamcîn	which
wexto ke	while
pispisnayene	whisper
fîtnayene	whistle
sipî	white
kam	who
ti kam î	who are you
kam o	who is
no kam o	who is this
pêro	whole
kamî	whom
yê kamî	whose
çira	why
çira ney	why not
xirabin	wicked
hîra	wide
vîyaye	widow
hîrayîye	width
cinî	wife
kovî	wild
îrade	will
waştene	will
zerrîwaz	willing
qezenc kerdene	win
va	wind
pencera	window
va	windy
şerab	wine
zimistan	winter
esteritene	wipe
têl	wire
aqildarîye	wisdom
aqildar	wise
hêvî kerdene	wish
hêvîye	wish
her çîyê to bixeyr bo	wish you all the best
cazuye	witch
bi	with
weancîyayene	withdraw
peyserantiş	withdrawal
zere de	within
bê	without
şahîd	witness
şahîd bîyene	witness
hazircewab	witty
verg	wolf
cinî	woman
cinîkî	women
qezenc kerdene	won
meraq kerdene	wonder
zaf weş	wonderful
texte	wood
pirç	wool
çekuye	word
çekuyî	words
kar	work
kar kerdene	work
antreman kerdene	work out
gureyeno	working
dinya	world
kerm	worm
werîyaye	worn
biqesawet	worried
efkar kerdene	worry
xirabêr	worse
îbadet kerdene	worship
tewr xirabin	worst
erje	worth
erjeno	worth it
biqîymet	worthy
birîne	wound
Waw	Wow
pîştene	wrap
xezeb	wrath
zende	wrist
nuştene	write
Tîya binuse	Write here
nuseno	writing
nuşte	writing
nuşte	written
xelet	wrong
nuşt	wrote
hewşe	yard
bawişkanê xo weardene	yawn
bawişke	yawn
Ya	Yeah
serre	year
serrî	years
mîraz	yeast
amên	yeast
zirçayene	yell
zerd	yellow
Heya	Yes
heya lê	yes baby
heya heyran	yes dear
heya caniko	yes honey
heya delala mi	yes my love
heya tabî	yes of course
vizêr	yesterday
hema	yet
ber dayene	yield
ti	you
ti ya	you are
ti rindek a	you are beautiful
ti zaf rindek a	you are so beautiful
çiman ser	you are welcome
ti eşkena	you can
Ti zana	You know
ti zî	you too
çiman ser	you're welcome
ciwan	young
yê to	your
çiman ser	your welcome
bi xo	yourself
ciwanî	youth
çiman ser	you’re welcome
weş	yummy
Kirdkî	Zaza
Kirmanckî	Zaza
Dimilî	Zaza
sifir	zero
